Nr.;"Darželio pavadinimas";"Grupės pavadinimas";"Vaiko Identifikacinis Nr.";"Deklaruotas mieste";"Pateisintos dėl ligos";"Pateisintos dėl kitų priežasčių";"Nepateisintos dienos";"Praleistos dienos Viso"
1;Aitvaras;"VIJURKAI (ALERG.)";8610723991;Taip;0;1;0;1
2;Aitvaras;"VIJURKAI (ALERG.)";82386048619;Taip;21;0;0;21
3;Aitvaras;"VIJURKAI (ALERG.)";86008218554;Taip;1;6;0;7
4;Aitvaras;"VIJURKAI (ALERG.)";44900473149;Taip;0;1;0;1
5;Aitvaras;"VIJURKAI (ALERG.)";9065712699;Taip;0;9;0;9
6;Aitvaras;"VIJURKAI (ALERG.)";63345306760;Taip;12;0;0;12
7;Aitvaras;"VIJURKAI (ALERG.)";84623684490;Taip;0;1;0;1
8;Aitvaras;"VIJURKAI (ALERG.)";16402806518;Taip;5;0;1;6
9;Aitvaras;"VIJURKAI (ALERG.)";74266054705;Taip;5;0;0;5
10;Aitvaras;"VIJURKAI (ALERG.)";40455080945;Taip;0;7;0;7
11;Aitvaras;"VIJURKAI (ALERG.)";1156348512;Taip;0;2;0;2
12;Aitvaras;"VIJURKAI (ALERG.)";3724722474;Taip;0;2;0;2
13;Aitvaras;"VIJURKAI (ALERG.)";33729670803;Taip;3;0;1;4
14;Aitvaras;"SMALSUČIAI (ALERG.)";1396233353;Taip;0;6;0;6
15;Aitvaras;"SMALSUČIAI (ALERG.)";28583194438;Taip;13;0;0;13
16;Aitvaras;"SMALSUČIAI (ALERG.)";1286577536;Taip;9;0;0;9
17;Aitvaras;"SMALSUČIAI (ALERG.)";63572158244;Taip;0;2;0;2
18;Aitvaras;"SMALSUČIAI (ALERG.)";2259914595;Taip;0;6;0;6
19;Aitvaras;"SMALSUČIAI (ALERG.)";33421843741;Taip;5;0;0;5
20;Aitvaras;"SMALSUČIAI (ALERG.)";56144623807;Taip;0;1;0;1
21;Aitvaras;"SMALSUČIAI (ALERG.)";35714998920;Taip;0;1;0;1
22;Aitvaras;"SMALSUČIAI (ALERG.)";35989222658;Taip;0;1;0;1
23;Aitvaras;"SMALSUČIAI (ALERG.)";38025877986;Taip;6;2;0;8
24;Aitvaras;"SMALSUČIAI (ALERG.)";64844875547;Taip;5;0;0;5
25;Aitvaras;"SMALSUČIAI (ALERG.)";909566870;Taip;5;1;0;6
26;Aitvaras;"SMALSUČIAI (ALERG.)";91112093978;Taip;5;1;0;6
27;Aitvaras;PADAUŽIUKAI;891634233;Taip;12;5;0;17
28;Aitvaras;PADAUŽIUKAI;37239090522;Taip;3;0;0;3
29;Aitvaras;PADAUŽIUKAI;51360850840;Taip;8;2;5;15
30;Aitvaras;PADAUŽIUKAI;8487865580;Taip;6;1;2;9
31;Aitvaras;PADAUŽIUKAI;56549255312;Taip;0;2;1;3
32;Aitvaras;PADAUŽIUKAI;83870816281;Taip;0;2;0;2
33;Aitvaras;PADAUŽIUKAI;98187921839;Taip;0;0;1;1
34;Aitvaras;PADAUŽIUKAI;76493460153;Taip;0;7;0;7
35;Aitvaras;PADAUŽIUKAI;2910005555;Taip;0;2;0;2
36;Aitvaras;PADAUŽIUKAI;18037655336;Taip;5;2;0;7
37;Aitvaras;PADAUŽIUKAI;7240754055;Taip;0;2;0;2
38;Aitvaras;PADAUŽIUKAI;44035041676;Taip;0;2;0;2
39;Aitvaras;PADAUŽIUKAI;80728374682;Taip;0;0;2;2
40;Aitvaras;PADAUŽIUKAI;81647038853;Taip;0;0;1;1
41;Aitvaras;PADAUŽIUKAI;57489495125;Taip;0;1;0;1
42;Aitvaras;PADAUŽIUKAI;86739069318;Taip;0;13;0;13
43;Aitvaras;PADAUŽIUKAI;33594031405;Taip;0;0;3;3
44;Aitvaras;"AITVARIUKAI (ALERG.)";37391225613;Taip;3;4;0;7
45;Aitvaras;"AITVARIUKAI (ALERG.)";85103026654;Taip;0;2;0;2
46;Aitvaras;"AITVARIUKAI (ALERG.)";76280361479;Taip;0;2;0;2
47;Aitvaras;"AITVARIUKAI (ALERG.)";36359228257;Taip;0;1;0;1
48;Aitvaras;"AITVARIUKAI (ALERG.)";13670186807;Taip;21;0;0;21
49;Aitvaras;"AITVARIUKAI (ALERG.)";31074942686;Taip;0;5;0;5
50;Aitvaras;"AITVARIUKAI (ALERG.)";12962784212;Ne;0;7;0;7
51;Aitvaras;"AITVARIUKAI (ALERG.)";1223627682;Taip;0;5;0;5
52;Aitvaras;"AITVARIUKAI (ALERG.)";3471031093;Taip;14;1;0;15
53;Aitvaras;"AITVARIUKAI (ALERG.)";9810370596;Taip;11;0;0;11
54;Aitvaras;"AITVARIUKAI (ALERG.)";34735287315;Taip;6;2;2;10
55;Aitvaras;"AITVARIUKAI (ALERG.)";4833313373;Taip;7;0;0;7
56;Aitvaras;"AITVARIUKAI (ALERG.)";84919478493;Taip;7;0;0;7
57;Aitvaras;"AITVARIUKAI (ALERG.)";9745864667;Taip;17;0;0;17
58;Aitvaras;"AITVARIUKAI (ALERG.)";5389627560;Taip;5;0;0;5
59;Aitvaras;"AITVARIUKAI (ALERG.)";1636794584;Taip;6;0;0;6
60;Aitvaras;"AITVARIUKAI (ALERG.)";2953536545;Taip;0;1;0;1
61;Aitvaras;"AITVARIUKAI (ALERG.)";3535659630;Taip;2;0;4;6
62;Aitvaras;"AITVARIUKAI (ALERG.)";2566375128;Taip;0;2;0;2
63;Aitvaras;"AITVARIUKAI (ALERG.)";6356432078;Taip;6;0;0;6
64;Aitvaras;"SAULĖS ZUIKUČIAI  (ALERG.)";1019661577;Taip;0;4;0;4
65;Aitvaras;"SAULĖS ZUIKUČIAI  (ALERG.)";55369747065;Taip;21;0;0;21
66;Aitvaras;"SAULĖS ZUIKUČIAI  (ALERG.)";5204534227;Taip;0;1;3;4
67;Aitvaras;"SAULĖS ZUIKUČIAI  (ALERG.)";89623351867;Taip;0;1;3;4
68;Aitvaras;"SAULĖS ZUIKUČIAI  (ALERG.)";837021325;Taip;0;1;0;1
69;Aitvaras;"SAULĖS ZUIKUČIAI  (ALERG.)";1207249857;Taip;0;3;3;6
70;Aitvaras;"SAULĖS ZUIKUČIAI  (ALERG.)";1516018865;Taip;0;3;0;3
71;Aitvaras;"SAULĖS ZUIKUČIAI  (ALERG.)";1392528718;Taip;5;0;0;5
72;Aitvaras;"SAULĖS ZUIKUČIAI  (ALERG.)";1892295973;Taip;0;2;0;2
73;Aitvaras;"SAULĖS ZUIKUČIAI  (ALERG.)";1011446683;Taip;0;0;6;6
74;Aitvaras;"SAULĖS ZUIKUČIAI  (ALERG.)";3433178644;Taip;0;3;0;3
75;Aitvaras;"SAULĖS ZUIKUČIAI  (ALERG.)";69352006024;Taip;0;11;0;11
76;Aitvaras;"SAULĖS ZUIKUČIAI  (ALERG.)";2083332491;Taip;6;1;1;8
77;Aitvaras;"SAULĖS ZUIKUČIAI  (ALERG.)";61721665912;Taip;0;2;0;2
78;Aitvaras;"SAULĖS ZUIKUČIAI  (ALERG.)";6238828251;Taip;0;0;5;5
79;Aitvaras;"ŽEMYNUKAI (ALERG.)";1301667420;Taip;0;12;0;12
80;Aitvaras;"ŽEMYNUKAI (ALERG.)";47686798724;Taip;9;0;6;15
81;Aitvaras;"ŽEMYNUKAI (ALERG.)";94080483856;Taip;0;4;1;5
82;Aitvaras;"ŽEMYNUKAI (ALERG.)";1621302802;Taip;0;7;0;7
83;Aitvaras;"ŽEMYNUKAI (ALERG.)";7592535089;Taip;21;0;0;21
84;Aitvaras;"ŽEMYNUKAI (ALERG.)";5083382326;Taip;4;5;0;9
85;Aitvaras;"ŽEMYNUKAI (ALERG.)";3001619281;Taip;5;7;0;12
86;Aitvaras;"ŽEMYNUKAI (ALERG.)";4708741626;Taip;0;3;0;3
87;Aitvaras;"ŽEMYNUKAI (ALERG.)";85826303673;Taip;8;0;0;8
88;Aitvaras;"ŽEMYNUKAI (ALERG.)";44139920757;Taip;4;3;0;7
89;Aitvaras;"ŽEMYNUKAI (ALERG.)";9845539641;Taip;15;6;0;21
90;Aitvaras;"ŽEMYNUKAI (ALERG.)";1600657305;Taip;0;4;0;4
91;Aitvaras;"ŽEMYNUKAI (ALERG.)";1652681820;Taip;10;0;0;10
92;Aitvaras;"ŽEMYNUKAI (ALERG.)";1201862001;Taip;15;0;0;15
93;Aitvaras;"ŽEMYNUKAI (ALERG.)";5595233402;Taip;18;0;0;18
94;Aitvaras;"ŽEMYNUKAI (ALERG.)";2650483861;Taip;10;0;4;14
95;Aitvaras;"ŽEMYNUKAI (ALERG.)";5922357091;Taip;0;2;0;2
96;Aitvaras;"ŽEMYNUKAI (ALERG.)";4868552034;Taip;7;0;0;7
97;Aitvaras;"ŽEMYNUKAI (ALERG.)";8970519668;Taip;0;7;0;7
98;Aitvaras;"ŽEMYNUKAI (ALERG.)";84922258988;Taip;16;1;0;17
99;Aitvaras;"ŽEMYNUKAI (ALERG.)";1494094426;Taip;0;3;0;3
100;Aitvaras;"LINKSMUČIAI (ALERG.)";5238819066;Taip;6;1;0;7
101;Aitvaras;"LINKSMUČIAI (ALERG.)";7109001184;Taip;4;0;3;7
102;Aitvaras;"LINKSMUČIAI (ALERG.)";5378212904;Taip;16;0;5;21
103;Aitvaras;"LINKSMUČIAI (ALERG.)";3655710511;Taip;10;0;0;10
104;Aitvaras;"LINKSMUČIAI (ALERG.)";1091372798;Taip;10;0;0;10
105;Aitvaras;"LINKSMUČIAI (ALERG.)";6572235324;Taip;11;10;0;21
106;Aitvaras;"LINKSMUČIAI (ALERG.)";8666824607;Taip;0;1;1;2
107;Aitvaras;"LINKSMUČIAI (ALERG.)";5330618557;Taip;15;0;0;15
108;Aitvaras;"LINKSMUČIAI (ALERG.)";5504431748;Taip;10;0;0;10
109;Aitvaras;"LINKSMUČIAI (ALERG.)";8206046301;Taip;9;0;0;9
110;Aitvaras;"LINKSMUČIAI (ALERG.)";4480921300;Taip;11;7;0;18
111;Aitvaras;"LINKSMUČIAI (ALERG.)";8178703988;Taip;16;0;0;16
112;Aitvaras;"LINKSMUČIAI (ALERG.)";1532588441;Taip;8;0;0;8
113;Aitvaras;"LINKSMUČIAI (ALERG.)";7260577885;Taip;10;0;0;10
114;Aitvaras;"LINKSMUČIAI (ALERG.)";1599183050;Taip;5;0;1;6
115;Aitvaras;"LINKSMUČIAI (ALERG.)";3944373116;Taip;18;0;0;18
116;Aitvaras;"LINKSMUČIAI (ALERG.)";1115202169;Taip;11;1;0;12
117;Aitvaras;"LINKSMUČIAI (ALERG.)";7029464687;Taip;3;0;4;7
118;Aitvaras;"LINKSMUČIAI (ALERG.)";4613894944;Taip;12;0;0;12
119;Aitvaras;"LINKSMUČIAI (ALERG.)";4120515569;Taip;11;0;0;11
120;Aitvaras;NAMINUKAI;40344230133;Taip;0;0;2;2
121;Aitvaras;NAMINUKAI;1493048970;Taip;16;0;5;21
122;Aitvaras;NAMINUKAI;59572108690;Taip;0;1;0;1
123;Aitvaras;NAMINUKAI;74628671065;Taip;0;1;1;2
124;Aitvaras;NAMINUKAI;70367340825;Taip;0;0;4;4
125;Aitvaras;NAMINUKAI;62126044317;Taip;0;8;0;8
126;Aitvaras;NAMINUKAI;1790437467;Taip;0;2;0;2
127;Aitvaras;NAMINUKAI;46021715174;Taip;0;1;1;2
128;Aitvaras;NAMINUKAI;26906648835;Taip;0;3;0;3
129;Aitvaras;NAMINUKAI;1681260995;Taip;0;13;0;13
130;Aitvaras;NAMINUKAI;42556460388;Taip;0;2;0;2
131;Aitvaras;NAMINUKAI;1487264184;Taip;3;0;0;3
132;Aitvaras;NAMINUKAI;97382092851;Taip;10;1;0;11
133;Aitvaras;NAMINUKAI;1886917840;Taip;11;0;0;11
134;Aitvaras;NAMINUKAI;3836513736;Taip;0;0;2;2
135;Aitvaras;ŠELMIAI;9332771711;Taip;11;0;0;11
136;Aitvaras;ŠELMIAI;6550426644;Taip;15;3;0;18
137;Aitvaras;ŠELMIAI;44046627149;Taip;8;0;2;10
138;Aitvaras;ŠELMIAI;43711349817;Taip;7;0;0;7
139;Aitvaras;ŠELMIAI;2408952971;Taip;0;1;0;1
140;Aitvaras;ŠELMIAI;47875842134;Taip;7;2;0;9
141;Aitvaras;ŠELMIAI;40799643122;Taip;6;3;0;9
142;Aitvaras;ŠELMIAI;2601983670;Taip;0;1;0;1
143;Aitvaras;ŠELMIAI;1387254053;Taip;0;0;1;1
144;Aitvaras;ŠELMIAI;2034293999;Taip;18;0;0;18
145;Aitvaras;ŠELMIAI;2804106417;Taip;7;1;0;8
146;Aitvaras;ŠELMIAI;2711888522;Taip;7;1;0;8
147;Aitvaras;ŠELMIAI;1996524718;Taip;0;1;4;5
148;Aitvaras;ŠELMIAI;4110585744;Taip;0;2;0;2
149;Aitvaras;ŠELMIAI;6010324894;Taip;6;0;0;6
150;Aitvaras;KODĖLČIUKAI;403821197;Taip;0;3;0;3
151;Aitvaras;KODĖLČIUKAI;64683090780;Taip;0;1;0;1
152;Aitvaras;KODĖLČIUKAI;12216502128;Taip;0;5;0;5
153;Aitvaras;KODĖLČIUKAI;46998364516;Taip;0;3;0;3
154;Aitvaras;KODĖLČIUKAI;45833790181;Taip;3;1;0;4
155;Aitvaras;KODĖLČIUKAI;89194677727;Taip;0;2;0;2
156;Aitvaras;KODĖLČIUKAI;69145890005;Taip;0;1;0;1
157;Aitvaras;KODĖLČIUKAI;24017694836;Taip;0;0;2;2
158;Aitvaras;KODĖLČIUKAI;64205113506;Taip;0;1;0;1
159;Aitvaras;KODĖLČIUKAI;54438500410;Taip;0;1;0;1
160;Aitvaras;KODĖLČIUKAI;2136550853;Taip;0;2;4;6
161;Aitvaras;KODĖLČIUKAI;1355296093;Taip;0;7;0;7
162;Aitvaras;KODĖLČIUKAI;1850900990;Taip;0;2;0;2
163;Aitvaras;KODĖLČIUKAI;30517554931;Taip;0;2;0;2
164;Aitvaras;KODĖLČIUKAI;2092431875;Taip;0;2;0;2
165;Aitvaras;KODĖLČIUKAI;1371102633;Taip;2;2;0;4
166;Aitvaras;KODĖLČIUKAI;1641140396;Taip;21;0;0;21
167;Aitvaras;KODĖLČIUKAI;9649742132;Taip;0;10;0;10
168;Aitvaras;KODĖLČIUKAI;1315081684;Taip;0;0;1;1
169;Aitvaras;PABIRUČIAI;1288810999;Taip;0;0;5;5
170;Aitvaras;PABIRUČIAI;8065540507;Taip;10;0;0;10
171;Aitvaras;PABIRUČIAI;6501943902;Taip;0;0;18;18
172;Aitvaras;PABIRUČIAI;7777235021;Taip;0;17;0;17
173;Aitvaras;PABIRUČIAI;5641224483;Taip;0;3;0;3
174;Aitvaras;PABIRUČIAI;1830134108;Taip;0;15;0;15
175;Aitvaras;PABIRUČIAI;2452780076;Taip;0;0;1;1
176;Aitvaras;PABIRUČIAI;5905456814;Taip;7;0;0;7
177;Aitvaras;PABIRUČIAI;1761446849;Taip;6;0;0;6
178;Aitvaras;PABIRUČIAI;6739827530;Taip;6;0;3;9
179;Aitvaras;PABIRUČIAI;2807595769;Taip;0;16;0;16
180;Aitvaras;PABIRUČIAI;1252145346;Taip;12;0;3;15
181;Aitvaras;PABIRUČIAI;7455895024;Taip;2;0;5;7
182;Aitvaras;PABIRUČIAI;8043062737;Taip;0;0;1;1
183;Aitvaras;"SVAJOKLIAI  (ALERG.)";2159901439;Taip;0;1;0;1
184;Aitvaras;"SVAJOKLIAI  (ALERG.)";1553462849;Taip;0;8;0;8
185;Aitvaras;"SVAJOKLIAI  (ALERG.)";8366627546;Taip;8;5;0;13
186;Aitvaras;"SVAJOKLIAI  (ALERG.)";1398792964;Taip;0;2;0;2
187;Aitvaras;"SVAJOKLIAI  (ALERG.)";1834535594;Taip;7;1;0;8
188;Aitvaras;"SVAJOKLIAI  (ALERG.)";7083046536;Taip;7;1;0;8
189;Aitvaras;"SVAJOKLIAI  (ALERG.)";3716313515;Taip;6;1;0;7
190;Aitvaras;"SVAJOKLIAI  (ALERG.)";1606267845;Taip;4;1;0;5
191;Aitvaras;"SVAJOKLIAI  (ALERG.)";5856250605;Taip;11;10;0;21
192;Aitvaras;"SVAJOKLIAI  (ALERG.)";2004112424;Taip;17;0;0;17
193;Aitvaras;"SVAJOKLIAI  (ALERG.)";6084096300;Taip;0;2;0;2
194;Aitvaras;"SVAJOKLIAI  (ALERG.)";5750154036;Taip;12;0;0;12
195;Aitvaras;"SVAJOKLIAI  (ALERG.)";6201118021;Taip;7;1;0;8
196;Aitvaras;"SVAJOKLIAI  (ALERG.)";1773366241;Taip;15;0;0;15
197;Aitvaras;"SVAJOKLIAI  (ALERG.)";1940545723;Taip;11;1;0;12
198;Aitvaras;"SVAJOKLIAI  (ALERG.)";3133031845;Taip;9;1;0;10
199;Aitvaras;"SVAJOKLIAI  (ALERG.)";1275561645;Taip;0;4;0;4
200;Aitvaras;"SVAJOKLIAI  (ALERG.)";1481849611;Taip;14;0;0;14
201;Aitvaras;"SVAJOKLIAI  (ALERG.)";1090979323;Taip;5;1;0;6
202;Aitvaras;"SVAJOKLIAI  (ALERG.)";1879540041;Taip;10;0;0;10
203;Aitvaras;"SVAJOKLIAI  (ALERG.)";1347364985;Taip;8;0;0;8
204;Aitvaras;"SVAJOKLIAI  (ALERG.)";5425259260;Taip;17;0;0;17
205;Atžalėlės;Gėlytės;63065430971;Taip;0;0;2;2
206;Atžalėlės;Gėlytės;42516348711;Ne;0;1;5;6
207;Atžalėlės;Gėlytės;91973899274;Taip;0;1;10;11
208;Atžalėlės;Gėlytės;67614970563;Taip;0;6;0;6
209;Atžalėlės;Gėlytės;23898319471;Ne;0;1;1;2
210;Atžalėlės;Gėlytės;92549162266;Ne;0;7;0;7
211;Atžalėlės;Gėlytės;46113919448;Taip;0;0;1;1
212;Atžalėlės;Gėlytės;28334054013;Taip;0;1;1;2
213;Atžalėlės;Gėlytės;84635439691;Taip;0;0;2;2
214;Atžalėlės;Gėlytės;20861477621;Taip;3;0;3;6
215;Atžalėlės;Gėlytės;5980426022;Ne;0;1;1;2
216;Atžalėlės;Gėlytės;6248765693;Taip;0;1;7;8
217;Atžalėlės;Gėlytės;74767205037;Taip;0;0;1;1
218;Atžalėlės;Gėlytės;45220122220;Taip;6;0;0;6
219;Atžalėlės;Gėlytės;13645371813;Taip;3;0;0;3
220;Atžalėlės;Gėlytės;16280202740;Taip;0;1;0;1
221;Atžalėlės;Gėlytės;67950853185;Taip;0;1;0;1
222;Atžalėlės;Gėlytės;95195013544;Taip;0;11;0;11
223;Atžalėlės;Gėlytės;74821213130;Taip;3;0;0;3
224;Atžalėlės;Gėlytės;2004639307;Taip;0;12;0;12
225;Atžalėlės;Gėlytės;7157406678;Taip;5;1;0;6
226;Atžalėlės;Gėlytės;98084870071;Taip;0;1;4;5
227;Atžalėlės;Drugeliai;4643154006;Taip;0;1;0;1
228;Atžalėlės;Drugeliai;6903666624;Taip;4;8;0;12
229;Atžalėlės;Drugeliai;4902947406;Taip;0;10;3;13
230;Atžalėlės;Drugeliai;6570245757;Taip;13;0;1;14
231;Atžalėlės;Drugeliai;9491132884;Taip;7;0;0;7
232;Atžalėlės;Drugeliai;2315790531;Taip;5;0;1;6
233;Atžalėlės;Drugeliai;6782007470;Taip;0;8;0;8
234;Atžalėlės;Drugeliai;8393217418;Taip;0;5;0;5
235;Atžalėlės;Drugeliai;1805496887;Taip;10;3;0;13
236;Atžalėlės;Drugeliai;5417971068;Taip;5;0;0;5
237;Atžalėlės;Drugeliai;9463215947;Taip;10;2;0;12
238;Atžalėlės;Drugeliai;7953922166;Taip;5;3;0;8
239;Atžalėlės;Drugeliai;9222670655;Taip;0;7;0;7
240;Atžalėlės;Drugeliai;77261118958;Taip;0;1;4;5
241;Atžalėlės;Drugeliai;1429493246;Taip;0;4;0;4
242;Atžalėlės;Drugeliai;6114426973;Taip;10;7;0;17
243;Atžalėlės;Drugeliai;1456979448;Taip;0;7;0;7
244;Atžalėlės;Drugeliai;3571134734;Taip;0;8;0;8
245;Atžalėlės;Gandriukai;28910361902;Taip;0;1;0;1
246;Atžalėlės;Gandriukai;93452036571;Taip;10;2;0;12
247;Atžalėlės;Gandriukai;4483002806;Taip;5;0;11;16
248;Atžalėlės;Gandriukai;16442821393;Taip;0;1;0;1
249;Atžalėlės;Gandriukai;1197205716;Taip;8;0;0;8
250;Atžalėlės;Gandriukai;70694002130;Taip;17;0;0;17
251;Atžalėlės;Gandriukai;87334806437;Taip;0;2;0;2
252;Atžalėlės;Gandriukai;1204800605;Taip;0;6;0;6
253;Atžalėlės;Gandriukai;1074259644;Taip;4;8;0;12
254;Atžalėlės;Gandriukai;66107666615;Taip;3;4;0;7
255;Atžalėlės;Gandriukai;2124150483;Taip;3;1;0;4
256;Atžalėlės;Gandriukai;1011601294;Taip;0;4;0;4
257;Atžalėlės;Gandriukai;1299048195;Taip;0;1;1;2
258;Atžalėlės;Gandriukai;54869610865;Taip;5;0;0;5
259;Atžalėlės;Gandriukai;80500800894;Taip;9;0;0;9
260;Atžalėlės;Gandriukai;519493490;Taip;0;6;0;6
261;Atžalėlės;Gandriukai;82777644548;Taip;4;1;6;11
262;Atžalėlės;Gandriukai;23453799177;Taip;0;12;0;12
263;Atžalėlės;Voveriukai;70223507658;Taip;2;0;0;2
264;Atžalėlės;Voveriukai;21599916055;Taip;0;1;1;2
265;Atžalėlės;Voveriukai;52803011399;Taip;0;0;5;5
266;Atžalėlės;Voveriukai;30370285022;Taip;0;3;0;3
267;Atžalėlės;Voveriukai;1447259034;Taip;0;1;0;1
268;Atžalėlės;Voveriukai;64596277701;Taip;15;0;2;17
269;Atžalėlės;Voveriukai;84392505831;Taip;0;3;0;3
270;Atžalėlės;Voveriukai;3379307367;Taip;0;0;1;1
271;Atžalėlės;Voveriukai;1312772153;Taip;0;7;0;7
272;Atžalėlės;Voveriukai;53559306492;Taip;0;3;0;3
273;Atžalėlės;Voveriukai;2488405485;Taip;0;2;4;6
274;Atžalėlės;Voveriukai;39714182342;Taip;0;10;0;10
275;Atžalėlės;Voveriukai;1865339755;Taip;9;0;1;10
276;Atžalėlės;Voveriukai;8138683218;Taip;0;2;0;2
277;Atžalėlės;Voveriukai;4467364336;Taip;7;1;0;8
278;Atžalėlės;Voveriukai;1804802235;Taip;5;1;0;6
279;Atžalėlės;Voveriukai;1316154666;Taip;10;1;1;12
280;Atžalėlės;Voveriukai;9699811980;Taip;0;10;0;10
281;Atžalėlės;Voveriukai;8847754477;Taip;0;9;0;9
282;Atžalėlės;Voveriukai;7689394485;Taip;5;0;1;6
283;Atžalėlės;Žirniukai;4098210138;Taip;0;0;4;4
284;Atžalėlės;Žirniukai;1500456945;Taip;0;0;4;4
285;Atžalėlės;Žirniukai;1450609695;Taip;4;3;0;7
286;Atžalėlės;Žirniukai;1844980319;Taip;1;8;2;11
287;Atžalėlės;Žirniukai;5997958773;Taip;0;9;2;11
288;Atžalėlės;Žirniukai;6177038838;Taip;10;1;4;15
289;Atžalėlės;Žirniukai;1722233272;Taip;10;6;0;16
290;Atžalėlės;Žirniukai;5310990513;Taip;0;1;1;2
291;Atžalėlės;Žirniukai;8524244526;Taip;10;0;6;16
292;Atžalėlės;Žirniukai;1704679306;Taip;8;0;4;12
293;Atžalėlės;Žirniukai;7702502252;Taip;5;10;0;15
294;Atžalėlės;Žirniukai;9189223222;Taip;0;1;3;4
295;Atžalėlės;Žirniukai;3283415814;Taip;10;0;0;10
296;Atžalėlės;Žirniukai;1146492807;Taip;6;0;4;10
297;Atžalėlės;Žirniukai;3870758086;Taip;6;0;0;6
298;Atžalėlės;Žirniukai;7356877676;Taip;5;4;0;9
299;Atžalėlės;Ežiukai;5432433423;Taip;0;3;0;3
300;Atžalėlės;Ežiukai;8819893830;Taip;4;0;13;17
301;Atžalėlės;Ežiukai;8695865604;Taip;3;13;0;16
302;Atžalėlės;Ežiukai;4284673729;Taip;16;0;2;18
303;Atžalėlės;Ežiukai;1431197358;Taip;7;0;5;12
304;Atžalėlės;Ežiukai;4177753994;Taip;0;0;3;3
305;Atžalėlės;Ežiukai;5742471497;Taip;9;0;1;10
306;Atžalėlės;Ežiukai;2385614957;Taip;0;0;1;1
307;Atžalėlės;Ežiukai;9715625283;Taip;11;0;10;21
308;Atžalėlės;Ežiukai;6202250600;Taip;16;0;5;21
309;Atžalėlės;Ežiukai;6024189665;Taip;1;0;2;3
310;Atžalėlės;Ežiukai;4238773173;Taip;7;0;0;7
311;Atžalėlės;Ežiukai;2131592139;Taip;0;0;3;3
312;Atžalėlės;Ežiukai;8201582382;Taip;7;1;0;8
313;Atžalėlės;Ežiukai;4362058013;Taip;7;1;0;8
314;Atžalėlės;Ežiukai;3191066669;Taip;3;0;0;3
315;Atžalėlės;Ežiukai;1137741059;Taip;5;0;1;6
316;Atžalėlės;Paukšteliai;77693032830;Ne;10;4;0;14
317;Atžalėlės;Paukšteliai;99097316080;Taip;0;0;2;2
318;Atžalėlės;Paukšteliai;1576891322;Taip;0;0;5;5
319;Atžalėlės;Paukšteliai;72360139252;Taip;10;6;0;16
320;Atžalėlės;Paukšteliai;89028851257;Taip;0;11;1;12
321;Atžalėlės;Paukšteliai;54417643140;Taip;0;1;1;2
322;Atžalėlės;Paukšteliai;91411809951;Taip;0;7;0;7
323;Atžalėlės;Paukšteliai;88525056192;Taip;0;10;3;13
324;Atžalėlės;Paukšteliai;30452835434;Taip;0;1;0;1
325;Atžalėlės;Paukšteliai;1046971571;Taip;0;1;6;7
326;Atžalėlės;Paukšteliai;71490200980;Taip;0;1;0;1
327;Atžalėlės;Paukšteliai;50283267330;Taip;0;1;4;5
328;Atžalėlės;Paukšteliai;93709702327;Taip;6;0;0;6
329;Atžalėlės;Paukšteliai;90664899396;Taip;0;0;11;11
330;Atžalėlės;Paukšteliai;93762990685;Taip;2;0;0;2
331;Atžalėlės;Paukšteliai;42752976301;Taip;5;0;1;6
332;Atžalėlės;Paukšteliai;27330226432;Taip;0;1;5;6
333;Atžalėlės;Paukšteliai;1714011798;Taip;6;0;0;6
334;Atžalėlės;Paukšteliai;57459192709;Taip;8;7;0;15
335;Atžalėlės;Paukšteliai;5438129052;Taip;0;0;3;3
336;Atžalėlės;Meškiukai;26878092629;Taip;11;4;0;15
337;Atžalėlės;Meškiukai;1083996834;Taip;0;9;0;9
338;Atžalėlės;Meškiukai;53385285795;Taip;5;6;1;12
339;Atžalėlės;Meškiukai;57197465236;Taip;0;1;0;1
340;Atžalėlės;Meškiukai;96954269567;Taip;0;1;0;1
341;Atžalėlės;Meškiukai;91094623082;Taip;0;6;0;6
342;Atžalėlės;Meškiukai;52163840804;Taip;8;0;0;8
343;Atžalėlės;Meškiukai;97667536161;Taip;0;8;0;8
344;Atžalėlės;Meškiukai;59994970570;Taip;10;0;0;10
345;Atžalėlės;Meškiukai;60841336326;Taip;0;5;0;5
346;Atžalėlės;Meškiukai;83433461267;Taip;0;12;0;12
347;Atžalėlės;Meškiukai;46263888918;Taip;0;6;0;6
348;Atžalėlės;Meškiukai;7315734265;Taip;0;1;0;1
349;Atžalėlės;Meškiukai;30776087985;Taip;8;0;0;8
350;Atžalėlės;Meškiukai;74153703568;Taip;0;8;0;8
351;Atžalėlės;Meškiukai;939302682;Taip;0;1;0;1
352;Atžalėlės;Meškiukai;40388417436;Taip;0;2;0;2
353;Atžalėlės;Meškiukai;45860181171;Taip;0;12;0;12
354;Atžalėlės;Meškiukai;1512766841;Taip;6;0;2;8
355;Atžalėlės;Meškiukai;76280495364;Taip;5;3;0;8
356;Atžalėlės;Meškiukai;1448431632;Taip;0;7;0;7
357;Atžalėlės;Meškiukai;4702130326;Taip;0;4;0;4
358;Aušrelė;PASAKIUKAI;94997479625;Taip;0;2;0;2
359;Aušrelė;PASAKIUKAI;66290556450;Taip;2;2;0;4
360;Aušrelė;PASAKIUKAI;83702416388;Ne;6;1;0;7
361;Aušrelė;PASAKIUKAI;9759865004;Ne;0;1;8;9
362;Aušrelė;PASAKIUKAI;1552951030;Taip;0;1;1;2
363;Aušrelė;PASAKIUKAI;73000891950;Taip;0;1;0;1
364;Aušrelė;PASAKIUKAI;93192830033;Taip;8;0;0;8
365;Aušrelė;PASAKIUKAI;31870837550;Taip;0;2;4;6
366;Aušrelė;PASAKIUKAI;89564834407;Taip;9;2;0;11
367;Aušrelė;PASAKIUKAI;4475401842;Taip;10;0;0;10
368;Aušrelė;PASAKIUKAI;2771851348;Taip;0;9;0;9
369;Aušrelė;PASAKIUKAI;4988271727;Taip;0;0;6;6
370;Aušrelė;PASAKIUKAI;5713243418;Taip;6;1;1;8
371;Aušrelė;PASAKIUKAI;41231905740;Ne;0;4;0;4
372;Aušrelė;PASAKIUKAI;58007820848;Taip;0;1;0;1
373;Aušrelė;PASAKIUKAI;4631390072;Taip;0;1;0;1
374;Aušrelė;PASAKIUKAI;9221298641;Taip;0;0;2;2
375;Aušrelė;BORUŽĖLĖS;87964799762;Taip;0;11;0;11
376;Aušrelė;BORUŽĖLĖS;61325054660;Taip;0;21;0;21
377;Aušrelė;BORUŽĖLĖS;83835736230;Taip;0;7;0;7
378;Aušrelė;BORUŽĖLĖS;59306871998;Taip;0;1;0;1
379;Aušrelė;BORUŽĖLĖS;48228818029;Taip;0;20;1;21
380;Aušrelė;BORUŽĖLĖS;1392484369;Taip;5;1;0;6
381;Aušrelė;BORUŽĖLĖS;4180888362;Taip;0;8;0;8
382;Aušrelė;BORUŽĖLĖS;20968351121;Taip;0;9;0;9
383;Aušrelė;BORUŽĖLĖS;18340420698;Taip;0;3;0;3
384;Aušrelė;BORUŽĖLĖS;1380454183;Taip;7;0;3;10
385;Aušrelė;BORUŽĖLĖS;1155372704;Taip;0;0;1;1
386;Aušrelė;BORUŽĖLĖS;48794175299;Taip;0;1;14;15
387;Aušrelė;BORUŽĖLĖS;1578867221;Taip;2;0;3;5
388;Aušrelė;BORUŽĖLĖS;18863314278;Ne;0;0;2;2
389;Aušrelė;BORUŽĖLĖS;58941591666;Taip;6;3;0;9
390;Aušrelė;BORUŽĖLĖS;93138986438;Taip;0;2;0;2
391;Aušrelė;BORUŽĖLĖS;1985405666;Taip;5;0;0;5
392;Aušrelė;BORUŽĖLĖS;26547524160;Taip;6;8;0;14
393;Aušrelė;BORUŽĖLĖS;9818954496;Taip;7;1;6;14
394;Aušrelė;BORUŽĖLĖS;6109287607;Taip;0;1;0;1
395;Aušrelė;SMALSUČIAI;76459345433;Ne;0;2;0;2
396;Aušrelė;SMALSUČIAI;17931731597;Taip;11;0;0;11
397;Aušrelė;SMALSUČIAI;8572216200;Taip;0;6;0;6
398;Aušrelė;SMALSUČIAI;74365190360;Taip;0;2;0;2
399;Aušrelė;SMALSUČIAI;3392276890;Taip;5;1;4;10
400;Aušrelė;SMALSUČIAI;14080739740;Taip;0;8;0;8
401;Aušrelė;SMALSUČIAI;73050137188;Taip;0;13;0;13
402;Aušrelė;SMALSUČIAI;49563719275;Taip;0;1;0;1
403;Aušrelė;SMALSUČIAI;7859894371;Taip;0;4;0;4
404;Aušrelė;SMALSUČIAI;1883795851;Taip;5;1;0;6
405;Aušrelė;SMALSUČIAI;68223308125;Ne;0;1;12;13
406;Aušrelė;SMALSUČIAI;90185478786;Taip;0;8;0;8
407;Aušrelė;SMALSUČIAI;95035102498;Taip;0;3;0;3
408;Aušrelė;SMALSUČIAI;42158121278;Taip;9;1;0;10
409;Aušrelė;SMALSUČIAI;78823564616;Taip;0;12;0;12
410;Aušrelė;SMALSUČIAI;1944021609;Taip;10;0;0;10
411;Aušrelė;SMALSUČIAI;1322089393;Taip;1;0;1;2
412;Aušrelė;KODĖLČIUKAI;12032618723;Taip;0;8;0;8
413;Aušrelė;KODĖLČIUKAI;18676216802;Taip;3;0;0;3
414;Aušrelė;KODĖLČIUKAI;75580617180;Taip;0;3;0;3
415;Aušrelė;KODĖLČIUKAI;24202090947;Taip;0;6;0;6
416;Aušrelė;KODĖLČIUKAI;50864528673;Ne;19;0;0;19
417;Aušrelė;KODĖLČIUKAI;76302896259;Taip;0;13;0;13
418;Aušrelė;KODĖLČIUKAI;2427329184;Taip;3;1;1;5
419;Aušrelė;KODĖLČIUKAI;24201363476;Taip;0;9;0;9
420;Aušrelė;KODĖLČIUKAI;1535153901;Taip;0;1;0;1
421;Aušrelė;KODĖLČIUKAI;46259963888;Taip;0;9;0;9
422;Aušrelė;KODĖLČIUKAI;63497657826;Taip;0;1;0;1
423;Aušrelė;KODĖLČIUKAI;8837069458;Taip;0;1;1;2
424;Aušrelė;KODĖLČIUKAI;36096756485;Taip;0;6;0;6
425;Aušrelė;KODĖLČIUKAI;1058114795;Taip;17;0;1;18
426;Aušrelė;KODĖLČIUKAI;19415824416;Taip;0;1;0;1
427;Aušrelė;KODĖLČIUKAI;4476948928;Taip;6;1;0;7
428;Aušrelė;KODĖLČIUKAI;44971525276;Taip;5;0;0;5
429;Aušrelė;KODĖLČIUKAI;26185247513;Taip;0;20;1;21
430;Aušrelė;PELĖDŽIUKAI;34891640909;Taip;0;1;0;1
431;Aušrelė;PELĖDŽIUKAI;1792774415;Taip;5;1;1;7
432;Aušrelė;PELĖDŽIUKAI;5955421544;Ne;0;2;0;2
433;Aušrelė;PELĖDŽIUKAI;1706417053;Taip;12;0;0;12
434;Aušrelė;PELĖDŽIUKAI;31441512644;Taip;8;2;0;10
435;Aušrelė;PELĖDŽIUKAI;2030362509;Taip;0;12;0;12
436;Aušrelė;PELĖDŽIUKAI;1160772086;Taip;8;7;0;15
437;Aušrelė;PELĖDŽIUKAI;1352195876;Taip;0;0;3;3
438;Aušrelė;PELĖDŽIUKAI;1599595256;Taip;0;3;0;3
439;Aušrelė;PELĖDŽIUKAI;1539176090;Taip;0;3;0;3
440;Aušrelė;PELĖDŽIUKAI;1868818387;Taip;0;1;8;9
441;Aušrelė;PELĖDŽIUKAI;2987088389;Ne;0;0;4;4
442;Aušrelė;PELĖDŽIUKAI;6909708079;Taip;0;0;1;1
443;Aušrelė;PELĖDŽIUKAI;1506444915;Taip;4;8;0;12
444;Aušrelė;PELĖDŽIUKAI;5304765447;Taip;10;1;0;11
445;Aušrelė;PELĖDŽIUKAI;85739624682;Taip;5;0;0;5
446;Aušrelė;AITVARIUKAI;49583107808;Taip;7;0;0;7
447;Aušrelė;AITVARIUKAI;2045076279;Taip;0;1;5;6
448;Aušrelė;AITVARIUKAI;1153416324;Taip;0;21;0;21
449;Aušrelė;AITVARIUKAI;1340754039;Taip;1;2;4;7
450;Aušrelė;AITVARIUKAI;42721248496;Taip;0;6;0;6
451;Aušrelė;AITVARIUKAI;79695989966;Taip;0;13;0;13
452;Aušrelė;AITVARIUKAI;1045290039;Taip;0;17;0;17
453;Aušrelė;AITVARIUKAI;1511069809;Taip;5;4;0;9
454;Aušrelė;AITVARIUKAI;51119593813;Taip;8;0;1;9
455;Aušrelė;AITVARIUKAI;5813735533;Taip;10;2;1;13
456;Aušrelė;AITVARIUKAI;18117725053;Taip;7;0;0;7
457;Aušrelė;AITVARIUKAI;1036752305;Taip;1;6;0;7
458;Aušrelė;AITVARIUKAI;27629722512;Taip;0;7;0;7
459;Aušrelė;AITVARIUKAI;65369497777;Taip;0;21;0;21
460;Aušrelė;AITVARIUKAI;1388327674;Taip;10;0;0;10
461;Aušrelė;AITVARIUKAI;1750555187;Taip;4;0;1;5
462;Aušrelė;AITVARIUKAI;8221635058;Taip;0;1;4;5
463;Aušrelė;AITVARIUKAI;1163757003;Taip;6;10;0;16
464;Aušrelė;AITVARIUKAI;4865289474;Taip;8;8;0;16
465;Aušrelė;BITUTĖS;2096291405;Taip;0;5;0;5
466;Aušrelė;BITUTĖS;6519246290;Taip;0;18;0;18
467;Aušrelė;BITUTĖS;54807413055;Taip;0;8;0;8
468;Aušrelė;BITUTĖS;7915176432;Taip;0;1;0;1
469;Aušrelė;BITUTĖS;2085252423;Taip;0;8;0;8
470;Aušrelė;BITUTĖS;1039658170;Taip;0;11;0;11
471;Aušrelė;BITUTĖS;7887450828;Taip;8;2;0;10
472;Aušrelė;BITUTĖS;1496680911;Taip;0;15;0;15
473;Aušrelė;BITUTĖS;1680740501;Taip;0;2;0;2
474;Aušrelė;BITUTĖS;1666951645;Taip;0;2;0;2
475;Aušrelė;BITUTĖS;1372660806;Taip;5;1;0;6
476;Aušrelė;BITUTĖS;1958425979;Taip;0;12;0;12
477;Aušrelė;BITUTĖS;1561253093;Taip;0;3;0;3
478;Aušrelė;BITUTĖS;72441793163;Taip;0;14;0;14
479;Aušrelė;ŽIRNIUKAI;6761263775;Taip;5;1;4;10
480;Aušrelė;ŽIRNIUKAI;8503309819;Taip;5;3;0;8
481;Aušrelė;ŽIRNIUKAI;3553233149;Taip;11;0;0;11
482;Aušrelė;ŽIRNIUKAI;2827216981;Taip;8;0;0;8
483;Aušrelė;ŽIRNIUKAI;2852596989;Taip;0;17;4;21
484;Aušrelė;ŽIRNIUKAI;7930717076;Taip;6;1;0;7
485;Aušrelė;ŽIRNIUKAI;4942168388;Taip;0;15;6;21
486;Aušrelė;ŽIRNIUKAI;6507218940;Taip;9;0;0;9
487;Aušrelė;ŽIRNIUKAI;2266390402;Taip;0;4;0;4
488;Aušrelė;ŽIRNIUKAI;8032661062;Taip;0;0;1;1
489;Aušrelė;ŽIRNIUKAI;4262596104;Taip;3;3;0;6
490;Aušrelė;ŽIRNIUKAI;2390128933;Taip;1;0;0;1
491;Aušrelė;ŽIRNIUKAI;9443641849;Taip;0;4;0;4
492;Aušrelė;ŽIRNIUKAI;1556010005;Taip;17;0;0;17
493;Aušrelė;ŽIRNIUKAI;7609339123;Taip;7;1;0;8
494;Aušrelė;ŽIRNIUKAI;7070013052;Taip;0;7;0;7
495;Aušrelė;GRYBUKAI;6002434911;Taip;0;6;0;6
496;Aušrelė;GRYBUKAI;3807967685;Taip;0;2;0;2
497;Aušrelė;GRYBUKAI;5312189552;Taip;1;5;0;6
498;Aušrelė;GRYBUKAI;7327544406;Taip;0;2;0;2
499;Aušrelė;GRYBUKAI;5046027475;Taip;15;6;0;21
500;Aušrelė;GRYBUKAI;9566144610;Taip;0;0;3;3
501;Aušrelė;GRYBUKAI;3320399046;Taip;0;1;3;4
502;Aušrelė;GRYBUKAI;7723159748;Taip;18;0;0;18
503;Aušrelė;GRYBUKAI;7367268748;Taip;2;0;0;2
504;Aušrelė;GRYBUKAI;6109859056;Taip;17;1;0;18
505;Aušrelė;GRYBUKAI;2030555139;Taip;0;9;0;9
506;Aušrelė;GRYBUKAI;1976613166;Taip;4;0;0;4
507;Aušrelė;GRYBUKAI;8338569001;Taip;17;1;0;18
508;Aušrelė;GRYBUKAI;6186758486;Taip;1;0;1;2
509;Aušrelė;DRUGELIAI;1502146844;Taip;0;2;0;2
510;Aušrelė;DRUGELIAI;1408751702;Taip;0;9;0;9
511;Aušrelė;DRUGELIAI;5055972872;Taip;6;1;0;7
512;Aušrelė;DRUGELIAI;2974714806;Taip;5;4;0;9
513;Aušrelė;DRUGELIAI;5935579452;Taip;0;14;0;14
514;Aušrelė;DRUGELIAI;8960462835;Taip;0;7;1;8
515;Aušrelė;DRUGELIAI;7682402576;Taip;0;13;0;13
516;Aušrelė;DRUGELIAI;5478028396;Taip;21;0;0;21
517;Aušrelė;DRUGELIAI;8372554796;Taip;0;1;0;1
518;Aušrelė;DRUGELIAI;8230362307;Taip;10;1;0;11
519;Aušrelė;DRUGELIAI;2751501830;Taip;0;2;0;2
520;Aušrelė;DRUGELIAI;1327431679;Taip;0;9;0;9
521;Aušrelė;DRUGELIAI;9555255381;Ne;9;0;1;10
522;Aušrelė;DRUGELIAI;9440600785;Taip;6;6;0;12
523;Aušrelė;DRUGELIAI;6037757548;Taip;0;2;0;2
524;Aušrelė;DRUGELIAI;6995749373;Taip;6;3;0;9
525;Aušrelė;NYKŠTUKAI;7861208185;Taip;6;0;0;6
526;Aušrelė;NYKŠTUKAI;6886505025;Taip;0;6;0;6
527;Aušrelė;NYKŠTUKAI;6673034329;Taip;0;6;0;6
528;Aušrelė;NYKŠTUKAI;3206495858;Taip;6;0;0;6
529;Aušrelė;NYKŠTUKAI;8243716759;Taip;0;21;0;21
530;Aušrelė;NYKŠTUKAI;5777214701;Taip;0;1;0;1
531;Aušrelė;NYKŠTUKAI;3165692699;Taip;3;0;0;3
532;Aušrelė;NYKŠTUKAI;91282753561;Taip;17;4;0;21
533;Aušrelė;NYKŠTUKAI;4306578299;Taip;5;5;0;10
534;Aušrelė;NYKŠTUKAI;6084682084;Taip;0;3;0;3
535;Aušrelė;NYKŠTUKAI;3682523696;Taip;21;0;0;21
536;Aušrelė;NYKŠTUKAI;1928260563;Taip;0;8;0;8
537;Aušrelė;NYKŠTUKAI;4957581753;Taip;1;0;0;1
538;Aušrelė;NYKŠTUKAI;6277405405;Taip;0;7;0;7
539;Aušrelė;NYKŠTUKAI;1543314096;Taip;0;2;0;2
540;Aušrelė;NYKŠTUKAI;1549962200;Taip;0;9;0;9
541;Aušrelė;NYKŠTUKAI;2626569015;Taip;0;8;0;8
542;Aušrelė;NYKŠTUKAI;2574681867;Taip;7;3;3;13
543;Beržynėlis;SVIRPLIUKAI;29356394553;Taip;5;1;0;6
544;Beržynėlis;SVIRPLIUKAI;45685658789;Taip;0;2;0;2
545;Beržynėlis;SVIRPLIUKAI;74856278886;Taip;0;1;0;1
546;Beržynėlis;SVIRPLIUKAI;1207208151;Taip;5;0;0;5
547;Beržynėlis;SVIRPLIUKAI;6690309946;Taip;3;4;0;7
548;Beržynėlis;SVIRPLIUKAI;1895493234;Taip;0;1;0;1
549;Beržynėlis;SVIRPLIUKAI;1583090840;Taip;3;1;0;4
550;Beržynėlis;SVIRPLIUKAI;7289803632;Taip;4;2;0;6
551;Beržynėlis;SVIRPLIUKAI;1682929565;Taip;7;0;0;7
552;Beržynėlis;SVIRPLIUKAI;71505149611;Taip;7;0;0;7
553;Beržynėlis;SVIRPLIUKAI;5196910604;Taip;0;1;0;1
554;Beržynėlis;SVIRPLIUKAI;1395819329;Taip;6;0;0;6
555;Beržynėlis;SVIRPLIUKAI;7248602510;Taip;12;0;0;12
556;Beržynėlis;SVIRPLIUKAI;3641421009;Taip;1;0;0;1
557;Beržynėlis;SVIRPLIUKAI;2791734213;Taip;0;8;0;8
558;Beržynėlis;SVIRPLIUKAI;9566341884;Taip;16;0;0;16
559;Beržynėlis;SVIRPLIUKAI;3278699117;Taip;0;1;0;1
560;Beržynėlis;SVIRPLIUKAI;1639928056;Taip;10;2;0;12
561;Beržynėlis;SVIRPLIUKAI;2681482042;Taip;2;0;0;2
562;Beržynėlis;SVIRPLIUKAI;1136091326;Taip;5;0;0;5
563;Beržynėlis;SVIRPLIUKAI;1516309509;Taip;0;1;0;1
564;Beržynėlis;PELEDŽIUKAI;2121542860;Taip;0;2;3;5
565;Beržynėlis;PELEDŽIUKAI;38733472229;Taip;0;2;0;2
566;Beržynėlis;PELEDŽIUKAI;10345838607;Ne;0;8;0;8
567;Beržynėlis;PELEDŽIUKAI;90464109575;Taip;3;0;0;3
568;Beržynėlis;PELEDŽIUKAI;12603200766;Taip;0;2;0;2
569;Beržynėlis;PELEDŽIUKAI;26390520766;Ne;0;2;1;3
570;Beržynėlis;PELEDŽIUKAI;38966821601;Taip;0;15;0;15
571;Beržynėlis;PELEDŽIUKAI;98803060215;Taip;0;0;11;11
572;Beržynėlis;PELEDŽIUKAI;18199829748;Ne;0;0;4;4
573;Beržynėlis;PELEDŽIUKAI;50307051477;Taip;0;1;0;1
574;Beržynėlis;PELEDŽIUKAI;45266242827;Taip;4;2;1;7
575;Beržynėlis;PELEDŽIUKAI;29838611902;Taip;5;1;0;6
576;Beržynėlis;PELEDŽIUKAI;32134295447;Taip;0;3;0;3
577;Beržynėlis;PELEDŽIUKAI;35916710802;Taip;0;5;0;5
578;Beržynėlis;ŽIOGELIAI;73555363332;Taip;0;12;0;12
579;Beržynėlis;ŽIOGELIAI;9737673167;Taip;0;0;2;2
580;Beržynėlis;ŽIOGELIAI;50686761208;Ne;5;0;2;7
581;Beržynėlis;ŽIOGELIAI;11586645391;Taip;0;0;2;2
582;Beržynėlis;ŽIOGELIAI;19892724367;Taip;6;2;0;8
583;Beržynėlis;ŽIOGELIAI;46844790286;Taip;5;0;0;5
584;Beržynėlis;ŽIOGELIAI;6082843533;Taip;0;15;0;15
585;Beržynėlis;ŽIOGELIAI;13290088644;Taip;0;1;0;1
586;Beržynėlis;ŽIOGELIAI;48258183822;Taip;12;2;0;14
587;Beržynėlis;ŽIOGELIAI;87966535672;Taip;0;1;0;1
588;Beržynėlis;ŽIOGELIAI;48768116923;Taip;0;0;1;1
589;Beržynėlis;ŽIOGELIAI;80418262829;Taip;0;1;0;1
590;Beržynėlis;ŽIOGELIAI;69508373227;Taip;11;3;2;16
591;Beržynėlis;ŽIOGELIAI;6002421623;Ne;0;14;0;14
592;Beržynėlis;ŽIOGELIAI;1893270997;Taip;0;7;0;7
593;Beržynėlis;ŽIOGELIAI;9035951859;Taip;0;1;0;1
594;Beržynėlis;ŽIOGELIAI;7929997884;Taip;4;0;0;4
595;Beržynėlis;ŽIOGELIAI;5114301953;Taip;0;6;0;6
596;Beržynėlis;ŽVIRBLIUKAI;95544821432;Taip;0;5;1;6
597;Beržynėlis;ŽVIRBLIUKAI;1426962644;Taip;0;1;0;1
598;Beržynėlis;ŽVIRBLIUKAI;1527942602;Taip;0;3;0;3
599;Beržynėlis;ŽVIRBLIUKAI;1910024785;Taip;8;2;1;11
600;Beržynėlis;ŽVIRBLIUKAI;1367442186;Taip;10;0;1;11
601;Beržynėlis;ŽVIRBLIUKAI;1823144276;Taip;0;1;0;1
602;Beržynėlis;ŽVIRBLIUKAI;1464556813;Taip;0;1;0;1
603;Beržynėlis;ŽVIRBLIUKAI;1945230630;Taip;13;0;3;16
604;Beržynėlis;ŽVIRBLIUKAI;1466742506;Taip;0;0;5;5
605;Beržynėlis;ŽVIRBLIUKAI;2023412985;Taip;0;3;2;5
606;Beržynėlis;ŽVIRBLIUKAI;1578089280;Taip;0;2;0;2
607;Beržynėlis;ŽVIRBLIUKAI;87592204193;Taip;0;2;0;2
608;Beržynėlis;ŽVIRBLIUKAI;62962970458;Taip;0;11;0;11
609;Beržynėlis;ŽVIRBLIUKAI;17743947386;Taip;0;1;0;1
610;Beržynėlis;ŽVIRBLIUKAI;80762814965;Taip;0;2;3;5
611;Beržynėlis;ŽVIRBLIUKAI;30539063473;Taip;5;0;0;5
612;Beržynėlis;ŽVIRBLIUKAI;75283423384;Taip;5;2;1;8
613;Beržynėlis;ŽVIRBLIUKAI;81022321678;Taip;12;0;0;12
614;Beržynėlis;ŽVIRBLIUKAI;1391844432;Taip;0;1;0;1
615;Beržynėlis;ŽVIRBLIUKAI;1014895926;Taip;0;1;0;1
616;Beržynėlis;ŽIRNIUKAI;6334152631;Taip;8;2;0;10
617;Beržynėlis;ŽIRNIUKAI;2971686368;Taip;9;1;0;10
618;Beržynėlis;ŽIRNIUKAI;8591800387;Taip;0;8;0;8
619;Beržynėlis;ŽIRNIUKAI;7589778533;Taip;0;1;0;1
620;Beržynėlis;ŽIRNIUKAI;4577837021;Taip;0;21;0;21
621;Beržynėlis;ŽIRNIUKAI;9409317403;Taip;0;1;0;1
622;Beržynėlis;ŽIRNIUKAI;5473666098;Taip;6;1;0;7
623;Beržynėlis;ŽIRNIUKAI;9503352345;Taip;6;0;0;6
624;Beržynėlis;ŽIRNIUKAI;5189335842;Taip;12;0;0;12
625;Beržynėlis;ŽIRNIUKAI;6293884233;Taip;12;0;0;12
626;Beržynėlis;ŽIRNIUKAI;3209966996;Taip;0;2;0;2
627;Beržynėlis;VIŠČIUKAI;9996171088;Taip;0;3;1;4
628;Beržynėlis;VIŠČIUKAI;3149966189;Taip;0;5;0;5
629;Beržynėlis;VIŠČIUKAI;6713134631;Taip;4;1;0;5
630;Beržynėlis;VIŠČIUKAI;5593146590;Taip;4;1;0;5
631;Beržynėlis;VIŠČIUKAI;9088059487;Taip;0;0;1;1
632;Beržynėlis;VIŠČIUKAI;9540292311;Taip;0;2;0;2
633;Beržynėlis;VIŠČIUKAI;8297427176;Taip;6;2;0;8
634;Beržynėlis;VIŠČIUKAI;1325972861;Taip;9;4;0;13
635;Beržynėlis;VIŠČIUKAI;4970999989;Taip;5;0;0;5
636;Beržynėlis;VIŠČIUKAI;4035764376;Taip;5;2;0;7
637;Beržynėlis;VIŠČIUKAI;5308596559;Taip;11;2;3;16
638;Beržynėlis;VIŠČIUKAI;8881566865;Taip;12;0;0;12
639;Beržynėlis;VIŠČIUKAI;5194416351;Taip;10;0;0;10
640;Beržynėlis;VIŠČIUKAI;9754455116;Taip;5;4;1;10
641;Beržynėlis;VIŠČIUKAI;5069929376;Taip;10;0;3;13
642;Bildukas;"Svetliački savaitinė";39959905586;Taip;0;9;0;9
643;Bildukas;"Svetliački savaitinė";40673143772;Taip;11;2;0;13
644;Bildukas;"Svetliački savaitinė";51199543540;Taip;0;2;0;2
645;Bildukas;"Svetliački savaitinė";10255936371;Taip;0;0;9;9
646;Bildukas;"Svetliački savaitinė";1882022060;Taip;21;0;0;21
647;Bildukas;"Svetliački savaitinė";80327840821;Taip;8;0;3;11
648;Bildukas;"Svetliački savaitinė";96874940646;Taip;0;1;1;2
649;Bildukas;"Svetliački savaitinė";27240409925;Taip;0;1;0;1
650;Bildukas;"Svetliački savaitinė";6441340680;Taip;7;1;0;8
651;Bildukas;"Svetliački savaitinė";5968419467;Taip;7;4;0;11
652;Bildukas;"Svetliački savaitinė";1029617146;Taip;4;3;0;7
653;Bildukas;"Svetliački savaitinė";1643122874;Taip;0;5;0;5
654;Bildukas;"Svetliački savaitinė";8968652761;Taip;0;16;0;16
655;Bildukas;"Svetliački savaitinė";70033583066;Taip;0;8;0;8
656;Bildukas;"Svetliački savaitinė";75301544496;Taip;6;0;0;6
657;Bildukas;"Svetliački savaitinė";1023163775;Ne;0;14;0;14
658;Bildukas;"Svetliački savaitinė";25050688839;Ne;0;9;0;9
659;Bildukas;"Svetliački savaitinė";57163941360;Taip;0;9;0;9
660;Bildukas;"Svetliački savaitinė";49294883079;Ne;0;1;0;1
661;Bildukas;"Svetliački savaitinė";1183272346;Taip;10;1;0;11
662;Bildukas;"Svetliački savaitinė";1165636981;Taip;12;0;0;12
663;Bildukas;"Zaičiata savaitinė ( keli alergiški vaikai)";9229489686;Ne;0;1;1;2
664;Bildukas;"Zaičiata savaitinė ( keli alergiški vaikai)";3531285331;Taip;0;1;0;1
665;Bildukas;"Zaičiata savaitinė ( keli alergiški vaikai)";2091204077;Taip;0;2;0;2
666;Bildukas;"Zaičiata savaitinė ( keli alergiški vaikai)";1047459617;Taip;5;1;0;6
667;Bildukas;"Zaičiata savaitinė ( keli alergiški vaikai)";5668878259;Taip;5;1;0;6
668;Bildukas;"Zaičiata savaitinė ( keli alergiški vaikai)";8382899180;Taip;10;1;0;11
669;Bildukas;"Zaičiata savaitinė ( keli alergiški vaikai)";1486878343;Taip;5;0;0;5
670;Bildukas;"Zaičiata savaitinė ( keli alergiški vaikai)";9756326725;Taip;0;0;4;4
671;Bildukas;"Zaičiata savaitinė ( keli alergiški vaikai)";4392299046;Taip;0;0;1;1
672;Bildukas;"Zaičiata savaitinė ( keli alergiški vaikai)";9835391223;Taip;21;0;0;21
673;Bildukas;"Zaičiata savaitinė ( keli alergiški vaikai)";9156801640;Taip;0;7;0;7
674;Bildukas;"Zaičiata savaitinė ( keli alergiški vaikai)";4112888719;Taip;0;1;5;6
675;Bildukas;Gnomiki;1113168085;Taip;8;0;0;8
676;Bildukas;Gnomiki;1125206576;Taip;0;12;0;12
677;Bildukas;Gnomiki;1502213914;Taip;0;0;1;1
678;Bildukas;Gnomiki;7898746258;Taip;0;0;1;1
679;Bildukas;Gnomiki;1376514473;Taip;0;15;0;15
680;Bildukas;Gnomiki;4014493868;Taip;8;4;0;12
681;Bildukas;Gnomiki;4623727349;Taip;0;1;5;6
682;Bildukas;Gnomiki;5217751936;Taip;12;6;0;18
683;Bildukas;Gnomiki;9569296370;Taip;12;0;0;12
684;Bildukas;Gnomiki;5844470373;Taip;14;0;3;17
685;Bildukas;Gnomiki;6548776238;Taip;6;1;0;7
686;Bildukas;Gnomiki;6388514464;Taip;0;7;0;7
687;Bildukas;Gnomiki;3226370339;Taip;5;0;8;13
688;Bildukas;Zvonočki;1475108434;Taip;0;1;6;7
689;Bildukas;Zvonočki;60443994539;Ne;0;2;13;15
690;Bildukas;Zvonočki;12186791267;Taip;8;1;1;10
691;Bildukas;Zvonočki;84771452636;Ne;0;4;1;5
692;Bildukas;Zvonočki;1180357950;Taip;13;2;0;15
693;Bildukas;Zvonočki;99302309410;Taip;0;3;1;4
694;Bildukas;Zvonočki;52281960273;Taip;0;0;1;1
695;Bildukas;Zvonočki;48069555680;Taip;0;1;4;5
696;Bildukas;Zvonočki;82932493433;Taip;12;6;0;18
697;Bildukas;Zvonočki;1409708149;Taip;0;9;3;12
698;Bildukas;Zvonočki;89499132098;Taip;0;0;1;1
699;Bildukas;Zvonočki;91777282521;Taip;0;5;2;7
700;Bildukas;Zvonočki;1713133196;Taip;6;0;0;6
701;Bildukas;Zvonočki;1956741726;Taip;11;0;1;12
702;Bildukas;Zvonočki;9575263475;Taip;9;0;0;9
703;Bildukas;Zvonočki;4404602365;Taip;6;7;0;13
704;Birutės;SKRUZDELIUKŲ;83624863787;Taip;9;2;0;11
705;Birutės;SKRUZDELIUKŲ;29496817352;Taip;0;4;0;4
706;Birutės;SKRUZDELIUKŲ;58791168169;Taip;0;1;0;1
707;Birutės;SKRUZDELIUKŲ;99346448051;Taip;4;1;0;5
708;Birutės;SKRUZDELIUKŲ;19076257808;Taip;1;0;0;1
709;Birutės;SKRUZDELIUKŲ;99534190736;Taip;2;3;0;5
710;Birutės;SKRUZDELIUKŲ;64883674106;Taip;3;2;0;5
711;Birutės;SKRUZDELIUKŲ;92392234959;Taip;0;6;0;6
712;Birutės;SKRUZDELIUKŲ;83120545528;Taip;10;1;0;11
713;Birutės;SKRUZDELIUKŲ;1227083798;Taip;0;1;0;1
714;Birutės;SKRUZDELIUKŲ;19555366863;Taip;0;1;0;1
715;Birutės;SKRUZDELIUKŲ;1517824834;Taip;0;7;0;7
716;Birutės;SKRUZDELIUKŲ;43601620086;Taip;0;6;0;6
717;Birutės;SKRUZDELIUKŲ;66276243365;Taip;6;1;0;7
718;Birutės;SKRUZDELIUKŲ;5360951559;Ne;2;0;0;2
719;Birutės;SKRUZDELIUKŲ;1123582705;Taip;16;1;0;17
720;Birutės;BITUČIŲ;1599159924;Taip;8;0;0;8
721;Birutės;BITUČIŲ;4427232735;Taip;3;0;3;6
722;Birutės;BITUČIŲ;33770983649;Taip;9;0;0;9
723;Birutės;BITUČIŲ;87693588654;Taip;6;0;0;6
724;Birutės;BITUČIŲ;1234596925;Taip;1;0;0;1
725;Birutės;BITUČIŲ;2975442228;Taip;8;0;3;11
726;Birutės;BITUČIŲ;98391790116;Taip;18;0;0;18
727;Birutės;BITUČIŲ;5947971037;Taip;0;7;0;7
728;Birutės;BITUČIŲ;3870702348;Taip;2;0;0;2
729;Birutės;BITUČIŲ;7149060118;Taip;0;11;0;11
730;Birutės;BITUČIŲ;1064449916;Taip;6;2;0;8
731;Birutės;BITUČIŲ;6748290604;Taip;9;0;1;10
732;Birutės;BITUČIŲ;9769645272;Taip;13;0;0;13
733;Birutės;BITUČIŲ;8465645434;Taip;16;0;0;16
734;Birutės;BITUČIŲ;6006110601;Taip;4;0;0;4
735;Birutės;BITUČIŲ;9722922540;Taip;7;0;0;7
736;Birutės;BITUČIŲ;5018151097;Taip;0;0;3;3
737;Birutės;BITUČIŲ;6115354862;Taip;16;0;0;16
738;Birutės;BITUČIŲ;7386694567;Taip;10;0;2;12
739;Birutės;BORUŽIUKAI;40376432941;Taip;0;3;0;3
740;Birutės;BORUŽIUKAI;83627433055;Taip;0;1;3;4
741;Birutės;BORUŽIUKAI;48493277224;Taip;0;1;0;1
742;Birutės;BORUŽIUKAI;1244627213;Taip;0;0;6;6
743;Birutės;BORUŽIUKAI;1228407191;Taip;3;1;0;4
744;Birutės;BORUŽIUKAI;76900751891;Taip;5;1;0;6
745;Birutės;BORUŽIUKAI;78441249067;Taip;9;0;0;9
746;Birutės;BORUŽIUKAI;1905393478;Taip;2;0;0;2
747;Birutės;BORUŽIUKAI;1427891290;Taip;6;4;0;10
748;Birutės;BORUŽIUKAI;44844176536;Taip;0;0;1;1
749;Birutės;BORUŽIUKAI;2014751710;Ne;3;2;0;5
750;Birutės;BORUŽIUKAI;22452517583;Taip;0;5;0;5
751;Birutės;BORUŽIUKAI;9450257904;Taip;5;4;0;9
752;Birutės;BORUŽIUKAI;1473662465;Taip;0;0;4;4
753;Birutės;BORUŽIUKAI;1596098119;Taip;5;0;4;9
754;Birutės;BORUŽIUKAI;60466633757;Taip;3;1;7;11
755;Birutės;BORUŽIUKAI;4217246188;Taip;10;7;0;17
756;Birutės;BORUŽIUKAI;70370187632;Taip;0;8;0;8
757;Birutės;DRUGELIAI;91202819016;Taip;0;2;0;2
758;Birutės;DRUGELIAI;1884820602;Taip;0;1;0;1
759;Birutės;DRUGELIAI;1447494370;Taip;0;1;0;1
760;Birutės;DRUGELIAI;77244600491;Taip;6;0;0;6
761;Birutės;DRUGELIAI;49162494334;Taip;10;0;0;10
762;Birutės;DRUGELIAI;3213573357;Taip;4;0;0;4
763;Birutės;DRUGELIAI;6880300182;Taip;0;1;0;1
764;Birutės;DRUGELIAI;23540610503;Taip;2;0;0;2
765;Birutės;DRUGELIAI;3490951066;Taip;4;0;0;4
766;Birutės;DRUGELIAI;1163666527;Taip;0;0;2;2
767;Birutės;DRUGELIAI;32780299044;Taip;3;0;0;3
768;Birutės;DRUGELIAI;1346957081;Taip;0;2;0;2
769;Birutės;DRUGELIAI;88939598407;Taip;0;1;0;1
770;Birutės;DRUGELIAI;1950295916;Taip;6;0;2;8
771;Birutės;DRUGELIAI;5272792732;Taip;1;0;1;2
772;Birutės;DRUGELIAI;9662009307;Taip;16;0;1;17
773;Birutės;DRUGELIAI;9860683556;Taip;1;0;0;1
774;Birutės;DRUGELIAI;32821891070;Taip;0;20;0;20
775;Birutės;DRUGELIAI;3682136019;Ne;2;0;1;3
776;Bitutė;Aitvariukų;6674923740;Taip;0;1;0;1
777;Bitutė;Aitvariukų;8394685672;Taip;2;1;0;3
778;Bitutė;Aitvariukų;3796188100;Taip;11;0;0;11
779;Bitutė;Aitvariukų;1564763789;Taip;0;3;0;3
780;Bitutė;Aitvariukų;1162903905;Taip;13;0;0;13
781;Bitutė;Aitvariukų;1560715159;Taip;5;2;2;9
782;Bitutė;Aitvariukų;7456328992;Taip;7;1;0;8
783;Bitutė;Aitvariukų;2518730247;Taip;20;1;0;21
784;Bitutė;Aitvariukų;5810344229;Taip;0;5;0;5
785;Bitutė;Aitvariukų;5895868876;Taip;21;0;0;21
786;Bitutė;Aitvariukų;8743734366;Taip;14;7;0;21
787;Bitutė;Aitvariukų;7036780275;Taip;21;0;0;21
788;Bitutė;Aitvariukų;2804203556;Taip;13;0;3;16
789;Bitutė;Aitvariukų;5455919343;Taip;7;0;0;7
790;Bitutė;Aitvariukų;6737174004;Taip;5;5;0;10
791;Bitutė;Aitvariukų;3432065233;Taip;13;0;0;13
792;Bitutė;Aitvariukų;5679397165;Taip;16;1;0;17
793;Bitutė;Ežiukų;78233050805;Taip;0;5;0;5
794;Bitutė;Ežiukų;25827361426;Taip;8;0;1;9
795;Bitutė;Ežiukų;43167655810;Taip;0;0;4;4
796;Bitutė;Ežiukų;38137764071;Taip;6;2;1;9
797;Bitutė;Ežiukų;40949937934;Taip;6;0;1;7
798;Bitutė;Ežiukų;67601917966;Taip;0;2;2;4
799;Bitutė;Ežiukų;89380579477;Taip;5;0;3;8
800;Bitutė;Ežiukų;99245885176;Taip;0;7;0;7
801;Bitutė;Ežiukų;63533171001;Taip;0;0;4;4
802;Bitutė;Ežiukų;75254163778;Taip;0;6;0;6
803;Bitutė;Ežiukų;1824939092;Taip;0;1;3;4
804;Bitutė;Ežiukų;21280284948;Taip;0;6;0;6
805;Bitutė;Ežiukų;1262030751;Taip;1;0;3;4
806;Bitutė;Ežiukų;57841590670;Taip;0;5;0;5
807;Bitutė;Ežiukų;56287634684;Taip;7;0;0;7
808;Bitutė;Ežiukų;4315172747;Taip;5;1;0;6
809;Bitutė;Ežiukų;9838379838;Taip;20;1;0;21
810;Bitutė;Ežiukų;80674416290;Taip;15;1;0;16
811;Bitutė;Ežiukų;42098027592;Taip;8;0;1;9
812;Bitutė;Ežiukų;17953339860;Taip;0;10;0;10
813;Bitutė;Žvirbliukų;5513662035;Taip;0;1;0;1
814;Bitutė;Žvirbliukų;76504719475;Taip;10;0;1;11
815;Bitutė;Žvirbliukų;40578882341;Taip;0;5;0;5
816;Bitutė;Žvirbliukų;73214901448;Taip;0;0;5;5
817;Bitutė;Žvirbliukų;239058855;Taip;0;0;12;12
818;Bitutė;Žvirbliukų;4311138099;Taip;7;0;4;11
819;Bitutė;Žvirbliukų;87682328632;Taip;8;0;0;8
820;Bitutė;Žvirbliukų;2004079473;Taip;5;1;0;6
821;Bitutė;Žvirbliukų;2045667491;Taip;6;1;0;7
822;Bitutė;Žvirbliukų;1342209916;Taip;2;1;0;3
823;Bitutė;Žvirbliukų;1086803168;Taip;6;4;0;10
824;Bitutė;Žvirbliukų;54838528906;Taip;0;7;0;7
825;Bitutė;Žvirbliukų;5365203210;Taip;6;1;3;10
826;Bitutė;Žvirbliukų;13826670333;Taip;0;0;1;1
827;Bitutė;Gandriukų;3966405515;Taip;0;0;4;4
828;Bitutė;Gandriukų;51971919596;Taip;5;1;0;6
829;Bitutė;Gandriukų;98415490683;Taip;0;12;0;12
830;Bitutė;Gandriukų;23567520688;Taip;15;1;0;16
831;Bitutė;Gandriukų;81321203386;Taip;14;1;0;15
832;Bitutė;Gandriukų;79414646688;Taip;5;3;4;12
833;Bitutė;Gandriukų;53324014378;Taip;3;6;6;15
834;Bitutė;Gandriukų;92442852696;Taip;0;5;0;5
835;Bitutė;Gandriukų;93924466303;Taip;0;3;0;3
836;Bitutė;Gandriukų;85983344716;Taip;0;2;0;2
837;Bitutė;Gandriukų;2144684074;Taip;0;1;0;1
838;Bitutė;Gandriukų;27322436232;Taip;0;5;0;5
839;Bitutė;Gandriukų;69158292877;Taip;0;5;0;5
840;Bitutė;Gandriukų;12362142191;Taip;0;10;0;10
841;Bitutė;Gandriukų;66620895469;Taip;0;5;0;5
842;Bitutė;Gandriukų;1131101584;Taip;0;2;9;11
843;Bitutė;Pelėdžiukai;33881269329;Taip;0;7;0;7
844;Bitutė;Pelėdžiukai;67449612148;Taip;0;2;0;2
845;Bitutė;Pelėdžiukai;1947476206;Taip;0;2;0;2
846;Bitutė;Pelėdžiukai;7262132445;Taip;0;1;1;2
847;Bitutė;Pelėdžiukai;69535700910;Taip;10;0;0;10
848;Bitutė;Pelėdžiukai;44798518501;Taip;3;0;4;7
849;Bitutė;Pelėdžiukai;83983037344;Taip;0;1;0;1
850;Bitutė;Pelėdžiukai;70745977571;Taip;0;1;0;1
851;Bitutė;Pelėdžiukai;63918223424;Taip;0;3;0;3
852;Bitutė;Pelėdžiukai;59961877984;Taip;0;2;0;2
853;Bitutė;Pelėdžiukai;3850772845;Taip;2;1;0;3
854;Bitutė;Pelėdžiukai;1347785713;Taip;2;1;0;3
855;Bitutė;Pelėdžiukai;43022564131;Taip;0;1;0;1
856;Bitutė;Pelėdžiukai;82195110042;Taip;0;3;1;4
857;Bitutė;Pelėdžiukai;53488410946;Taip;7;1;0;8
858;Bitutė;Pelėdžiukai;68998683110;Taip;5;2;0;7
859;Bitutė;Pelėdžiukai;38867323639;Taip;9;1;0;10
860;Bitutė;Boružėlių;8519978626;Taip;8;1;1;10
861;Bitutė;Boružėlių;6586888742;Taip;2;0;5;7
862;Bitutė;Boružėlių;5783154071;Taip;0;7;0;7
863;Bitutė;Boružėlių;37105491775;Taip;10;0;5;15
864;Bitutė;Boružėlių;50869152455;Taip;0;5;1;6
865;Bitutė;Boružėlių;1783776913;Taip;10;0;2;12
866;Bitutė;Boružėlių;7352524951;Taip;0;2;0;2
867;Bitutė;Boružėlių;27144303911;Taip;0;0;1;1
868;Bitutė;Boružėlių;6572832247;Taip;7;0;0;7
869;Bitutė;Boružėlių;1802887869;Taip;0;0;5;5
870;Bitutė;Boružėlių;51054491845;Taip;15;0;0;15
871;Bitutė;Boružėlių;5653055907;Taip;14;0;0;14
872;Bitutė;Boružėlių;1809034174;Taip;7;0;3;10
873;Bitutė;Boružėlių;5644789669;Taip;0;5;6;11
874;Bitutė;Boružėlių;2350260809;Taip;8;0;2;10
875;Bitutė;Boružėlių;1307749129;Taip;5;4;0;9
876;Bitutė;Boružėlių;3980455738;Taip;0;0;2;2
877;Bitutė;Boružėlių;6678928989;Taip;5;2;1;8
878;Bitutė;Šokliukų;2775304620;Taip;7;1;0;8
879;Bitutė;Šokliukų;8754340459;Taip;6;2;0;8
880;Bitutė;Šokliukų;22504941477;Taip;7;0;0;7
881;Bitutė;Šokliukų;84694903978;Taip;6;5;0;11
882;Bitutė;Šokliukų;1385876629;Taip;17;0;0;17
883;Bitutė;Šokliukų;4054959628;Taip;5;5;0;10
884;Bitutė;Šokliukų;71957147569;Taip;0;2;0;2
885;Bitutė;Šokliukų;74038944722;Taip;8;3;0;11
886;Bitutė;Šokliukų;9314363274;Taip;0;21;0;21
887;Bitutė;Šokliukų;1703630417;Taip;5;1;0;6
888;Bitutė;Šokliukų;80788107109;Taip;0;0;1;1
889;Bitutė;Šokliukų;11128936533;Taip;0;2;0;2
890;Bitutė;Šokliukų;26573486858;Taip;0;3;0;3
891;Bitutė;Šokliukų;1709788155;Taip;2;2;0;4
892;Bitutė;Šokliukų;6591291681;Taip;6;0;1;7
893;Bitutė;Šokliukų;86636444738;Taip;0;3;0;3
894;Bitutė;Šokliukų;1956718350;Taip;0;1;5;6
895;Bitutė;Drugelių;1861373542;Taip;5;4;0;9
896;Bitutė;Drugelių;2531472741;Taip;0;5;0;5
897;Bitutė;Drugelių;74525712637;Taip;3;2;0;5
898;Bitutė;Drugelių;56620848568;Taip;3;7;1;11
899;Bitutė;Drugelių;7236048627;Taip;1;0;0;1
900;Bitutė;Drugelių;2049938111;Taip;2;0;0;2
901;Bitutė;Drugelių;58668298206;Taip;0;4;0;4
902;Bitutė;Drugelių;1863634233;Taip;6;1;0;7
903;Bitutė;Drugelių;72872147664;Taip;0;0;4;4
904;Bitutė;Drugelių;9550491607;Taip;0;9;0;9
905;Bitutė;Drugelių;48695762145;Taip;0;7;0;7
906;Bitutė;Drugelių;3982159333;Taip;1;6;5;12
907;Bitutė;Drugelių;27461264704;Taip;3;0;0;3
908;Bitutė;Drugelių;29300327608;Taip;0;11;0;11
909;Bitutė;Drugelių;50605497381;Taip;10;6;0;16
910;Bitutė;Drugelių;1030677273;Taip;6;0;0;6
911;Bitutė;Drugelių;3319657847;Taip;0;3;0;3
912;Bitutė;Kiškučių;1926912966;Taip;3;3;0;6
913;Bitutė;Kiškučių;41598049089;Taip;0;4;0;4
914;Bitutė;Kiškučių;20823074269;Taip;16;0;1;17
915;Bitutė;Kiškučių;2004589442;Taip;0;9;0;9
916;Bitutė;Kiškučių;1514919519;Taip;7;0;0;7
917;Bitutė;Kiškučių;2007360730;Taip;6;0;0;6
918;Bitutė;Kiškučių;1756799209;Taip;11;0;0;11
919;Bitutė;Kiškučių;7858925572;Taip;2;0;0;2
920;Bitutė;Kiškučių;1946893053;Taip;13;2;0;15
921;Bitutė;Kiškučių;20308800957;Taip;0;2;0;2
922;Bitutė;Kiškučių;55394933894;Taip;0;4;0;4
923;Bitutė;Kiškučių;34076798361;Taip;0;5;2;7
924;Bitutė;Kiškučių;83034164893;Taip;0;1;0;1
925;Bitutė;Kiškučių;28698703670;Taip;0;5;0;5
926;Bitutė;Kiškučių;51014007755;Taip;0;8;0;8
927;Bitutė;Kiškučių;85845989245;Taip;0;6;0;6
928;Bitutė;Kiškučių;23952001143;Taip;0;2;0;2
929;Bitutė;Kiškučių;55763538285;Taip;11;0;5;16
930;Bitutė;Kiškučių;55722176820;Taip;6;4;0;10
931;Bitutė;Kiškučių;41836931870;Taip;0;1;0;1
932;Bitutė;Kiškučių;16096919364;Ne;0;8;0;8
933;Bitutė;"Viščiukų ";3723040682;Taip;6;5;0;11
934;Bitutė;"Viščiukų ";8545377054;Taip;6;1;0;7
935;Bitutė;"Viščiukų ";5406667195;Taip;0;3;0;3
936;Bitutė;"Viščiukų ";4458990772;Taip;9;1;0;10
937;Bitutė;"Viščiukų ";7113693496;Taip;15;0;0;15
938;Bitutė;"Viščiukų ";8186706520;Taip;0;21;0;21
939;Bitutė;"Viščiukų ";3688744506;Taip;15;0;0;15
940;Bitutė;"Viščiukų ";6044969600;Taip;5;3;0;8
941;Bitutė;"Viščiukų ";9602659259;Taip;0;5;4;9
942;Bitutė;"Viščiukų ";2190439190;Taip;3;0;0;3
943;Bitutė;"Viščiukų ";9855080887;Taip;1;0;0;1
944;Bitutė;"Viščiukų ";4177331531;Taip;4;0;0;4
945;Bitutė;"Viščiukų ";2483462846;Taip;14;1;0;15
946;Bitutė;"Viščiukų ";2886154457;Taip;3;0;0;3
947;Bitutė;"Viščiukų ";7678106084;Taip;0;5;0;5
948;Bitutė;"Skruzdėliukai ";37364063140;Taip;0;5;4;9
949;Bitutė;"Skruzdėliukai ";95252521365;Taip;6;0;4;10
950;Bitutė;"Skruzdėliukai ";1590580158;Taip;10;2;0;12
951;Bitutė;"Skruzdėliukai ";5910842956;Taip;4;0;0;4
952;Bitutė;"Skruzdėliukai ";1913421864;Taip;3;5;0;8
953;Bitutė;"Skruzdėliukai ";38436660859;Taip;0;1;2;3
954;Bitutė;"Skruzdėliukai ";2126118124;Taip;0;0;4;4
955;Bitutė;"Skruzdėliukai ";2031043488;Taip;0;14;0;14
956;Bitutė;"Skruzdėliukai ";1130379531;Taip;1;0;3;4
957;Bitutė;"Skruzdėliukai ";1064809221;Taip;17;0;0;17
958;Bitutė;"Skruzdėliukai ";1521753712;Taip;1;0;5;6
959;Bitutė;"Skruzdėliukai ";1354608761;Taip;6;3;0;9
960;Bitutė;"Skruzdėliukai ";1307910515;Taip;0;10;1;11
961;Bitutė;"Skruzdėliukai ";2311037144;Taip;2;1;0;3
962;Bitutė;"Skruzdėliukai ";41659768159;Taip;8;0;0;8
963;Bitutė;"Skruzdėliukai ";1878172874;Taip;7;0;1;8
964;Bitutė;"Skruzdėliukai ";61233878620;Taip;16;0;2;18
965;Bitutė;"Nykštukų ";1733189730;Taip;3;11;0;14
966;Bitutė;"Nykštukų ";2740656695;Taip;13;0;0;13
967;Bitutė;"Nykštukų ";3227252972;Taip;3;0;0;3
968;Bitutė;"Nykštukų ";4764586168;Taip;1;2;1;4
969;Bitutė;"Nykštukų ";5126303823;Taip;1;3;0;4
970;Bitutė;"Nykštukų ";1904108612;Taip;7;0;0;7
971;Bitutė;"Nykštukų ";5109258680;Taip;1;0;0;1
972;Bitutė;"Nykštukų ";2812580726;Taip;6;1;0;7
973;Bitutė;"Nykštukų ";4913483444;Taip;0;0;4;4
974;Bitutė;"Nykštukų ";7720798466;Taip;3;0;0;3
975;Bitutė;"Nykštukų ";1662815358;Taip;0;3;1;4
976;Bitutė;"Nykštukų ";9966437881;Taip;0;1;1;2
977;Bitutė;"Nykštukų ";6169426273;Taip;7;0;2;9
978;Bitutė;"Nykštukų ";9166624750;Taip;6;5;2;13
979;Coliukė;DRUGELIAI;4408284518;Taip;2;7;0;9
980;Coliukė;DRUGELIAI;3919482569;Taip;10;9;0;19
981;Coliukė;DRUGELIAI;1600495468;Taip;14;0;0;14
982;Coliukė;DRUGELIAI;9183391434;Taip;7;2;0;9
983;Coliukė;DRUGELIAI;2159103903;Taip;10;1;0;11
984;Coliukė;DRUGELIAI;1458763954;Taip;2;0;0;2
985;Coliukė;DRUGELIAI;7920728387;Taip;3;4;0;7
986;Coliukė;DRUGELIAI;6860757091;Taip;12;1;0;13
987;Coliukė;DRUGELIAI;6011110970;Ne;0;0;3;3
988;Coliukė;DRUGELIAI;1968467455;Taip;5;0;0;5
989;Coliukė;DRUGELIAI;1240946719;Taip;0;12;0;12
990;Coliukė;DRUGELIAI;4645245689;Taip;18;0;0;18
991;Coliukė;DRUGELIAI;1882520335;Taip;6;3;0;9
992;Coliukė;DRUGELIAI;8517128464;Taip;2;1;0;3
993;Coliukė;DRUGELIAI;1328505569;Ne;6;2;0;8
994;Coliukė;DRUGELIAI;5678858566;Taip;0;4;0;4
995;Coliukė;BITUTĖS;2006601280;Taip;0;7;0;7
996;Coliukė;BITUTĖS;44291325944;Taip;0;2;0;2
997;Coliukė;BITUTĖS;50210836203;Taip;5;1;0;6
998;Coliukė;BITUTĖS;8017702268;Ne;5;2;0;7
999;Coliukė;BITUTĖS;30220840133;Ne;5;2;0;7
1000;Coliukė;BITUTĖS;58282533952;Ne;9;6;0;15
1001;Coliukė;BITUTĖS;41174692847;Taip;3;6;0;9
1002;Coliukė;BITUTĖS;93361426448;Taip;2;5;0;7
1003;Coliukė;BITUTĖS;69258022561;Taip;7;4;0;11
1004;Coliukė;BITUTĖS;82989338835;Taip;2;4;0;6
1005;Coliukė;BITUTĖS;37161702858;Taip;0;0;2;2
1006;Coliukė;BITUTĖS;77967081365;Taip;10;1;0;11
1007;Coliukė;BITUTĖS;77204026281;Taip;4;8;0;12
1008;Coliukė;BITUTĖS;25298531632;Taip;12;0;0;12
1009;Coliukė;BITUTĖS;1199350941;Taip;0;18;0;18
1010;Coliukė;BITUTĖS;1960898805;Taip;3;6;0;9
1011;Coliukė;BITUTĖS;58421006265;Taip;0;8;0;8
1012;Coliukė;BITUTĖS;6926730624;Taip;9;4;0;13
1013;Coliukė;BITUTĖS;8457120425;Taip;10;0;0;10
1014;Coliukė;BITUTĖS;9311775782;Taip;14;2;0;16
1015;Coliukė;BITUTĖS;36554487034;Taip;5;3;0;8
1016;Coliukė;BITUTĖS;1423711475;Taip;9;2;0;11
1017;Coliukė;VABALIUKAI;43033055985;Taip;0;1;0;1
1018;Coliukė;VABALIUKAI;72663090608;Taip;16;0;0;16
1019;Coliukė;VABALIUKAI;51782207208;Taip;0;6;0;6
1020;Coliukė;VABALIUKAI;26012978171;Taip;6;0;0;6
1021;Coliukė;VABALIUKAI;18718511212;Taip;0;4;0;4
1022;Coliukė;VABALIUKAI;26698840369;Taip;0;10;0;10
1023;Coliukė;VABALIUKAI;78760440826;Taip;5;11;0;16
1024;Coliukė;VABALIUKAI;6025281817;Taip;0;3;0;3
1025;Coliukė;VABALIUKAI;22951260339;Taip;6;6;0;12
1026;Coliukė;VABALIUKAI;33158793202;Taip;0;1;0;1
1027;Coliukė;VABALIUKAI;33587152454;Taip;0;10;0;10
1028;Coliukė;VABALIUKAI;82064520362;Taip;11;0;0;11
1029;Coliukė;VABALIUKAI;57504928606;Taip;0;6;0;6
1030;Coliukė;VABALIUKAI;1654628972;Taip;3;0;1;4
1031;Coliukė;VABALIUKAI;5944299310;Taip;0;3;0;3
1032;Coliukė;VABALIUKAI;4649987214;Taip;11;0;0;11
1033;Coliukė;VABALIUKAI;63258983714;Taip;0;4;0;4
1034;Coliukė;VABALIUKAI;1476750428;Taip;14;0;0;14
1035;Coliukė;VABALIUKAI;6775470024;Taip;10;0;1;11
1036;Coliukė;VABALIUKAI;8323242104;Taip;0;7;0;7
1037;Coliukė;NYKŠTUKAI;1659532709;Taip;0;0;1;1
1038;Coliukė;NYKŠTUKAI;88866481329;Taip;0;5;0;5
1039;Coliukė;NYKŠTUKAI;1812071213;Taip;0;3;0;3
1040;Coliukė;NYKŠTUKAI;43313407836;Taip;0;0;1;1
1041;Coliukė;NYKŠTUKAI;3738703854;Taip;6;2;0;8
1042;Coliukė;NYKŠTUKAI;1997515382;Taip;1;4;0;5
1043;Coliukė;NYKŠTUKAI;1625018276;Taip;16;1;0;17
1044;Coliukė;NYKŠTUKAI;1267427191;Taip;7;0;0;7
1045;Coliukė;NYKŠTUKAI;1963122314;Taip;0;21;0;21
1046;Coliukė;NYKŠTUKAI;4917899323;Taip;0;2;0;2
1047;Coliukė;NYKŠTUKAI;4747481676;Taip;5;2;0;7
1048;Coliukė;NYKŠTUKAI;83027842354;Taip;2;7;0;9
1049;Coliukė;NYKŠTUKAI;2168987649;Taip;5;0;0;5
1050;Coliukė;NYKŠTUKAI;2684151591;Taip;0;5;0;5
1051;Coliukė;NYKŠTUKAI;4499924331;Taip;6;3;0;9
1052;Coliukė;NYKŠTUKAI;9383567339;Taip;1;3;0;4
1053;Coliukė;NYKŠTUKAI;4806478786;Taip;3;0;0;3
1054;Coliukė;NYKŠTUKAI;7566429633;Taip;0;1;0;1
1055;Coliukė;NYKŠTUKAI;9542366183;Taip;11;1;0;12
1056;Coliukė;NYKŠTUKAI;7670166244;Taip;7;0;0;7
1057;Coliukė;NYKŠTUKAI;1166820133;Taip;12;0;0;12
1058;Coliukė;NYKŠTUKAI;7622526793;Taip;0;0;2;2
1059;Coliukė;GĖLYTĖS;8835394030;Taip;0;3;0;3
1060;Coliukė;GĖLYTĖS;3427704550;Taip;5;6;0;11
1061;Coliukė;GĖLYTĖS;7248705010;Taip;18;0;0;18
1062;Coliukė;GĖLYTĖS;1318558913;Taip;5;0;0;5
1063;Coliukė;GĖLYTĖS;3318808813;Taip;18;0;0;18
1064;Coliukė;GĖLYTĖS;4498253271;Taip;14;0;0;14
1065;Coliukė;GĖLYTĖS;3323738649;Taip;6;3;0;9
1066;Coliukė;GĖLYTĖS;9331485675;Taip;11;0;0;11
1067;Coliukė;GĖLYTĖS;8149118599;Taip;13;0;0;13
1068;Coliukė;GĖLYTĖS;8209209881;Taip;16;0;0;16
1069;Coliukė;GĖLYTĖS;9885547263;Taip;10;0;0;10
1070;Coliukė;GĖLYTĖS;5139645108;Taip;9;5;0;14
1071;Coliukė;"BORUŽĖLĖS (SPEC.)";1988394967;Taip;5;8;0;13
1072;Coliukė;"BORUŽĖLĖS (SPEC.)";3746858489;Taip;8;4;0;12
1073;Coliukė;"BORUŽĖLĖS (SPEC.)";3101380476;Taip;7;0;0;7
1074;Coliukė;"BORUŽĖLĖS (SPEC.)";92299314212;Taip;0;1;0;1
1075;Coliukė;"BORUŽĖLĖS (SPEC.)";8070499557;Taip;0;18;0;18
1076;Coliukė;"BORUŽĖLĖS (SPEC.)";2617816991;Taip;5;0;2;7
1077;Coliukė;"BORUŽĖLĖS (SPEC.)";9368334915;Taip;0;1;0;1
1078;Coliukė;"BORUŽĖLĖS (SPEC.)";1644303265;Taip;3;8;0;11
1079;Coliukė;"BORUŽĖLĖS (SPEC.)";60578936717;Taip;0;8;0;8
1080;Čiauškutis;BITUTĖS;78373250443;Taip;0;5;0;5
1081;Čiauškutis;BITUTĖS;7755428393;Taip;10;2;0;12
1082;Čiauškutis;BITUTĖS;3499391608;Taip;7;3;0;10
1083;Čiauškutis;BITUTĖS;1443155220;Taip;8;5;0;13
1084;Čiauškutis;BITUTĖS;2012201854;Taip;0;0;4;4
1085;Čiauškutis;BITUTĖS;38387916428;Taip;2;0;2;4
1086;Čiauškutis;BITUTĖS;1804509009;Taip;18;0;0;18
1087;Čiauškutis;BITUTĖS;22717947028;Taip;0;10;0;10
1088;Čiauškutis;BITUTĖS;3917667527;Taip;7;0;3;10
1089;Čiauškutis;BITUTĖS;4600623461;Taip;0;2;0;2
1090;Čiauškutis;BITUTĖS;27158851138;Taip;0;2;0;2
1091;Čiauškutis;BITUTĖS;8030685444;Taip;8;0;0;8
1092;Čiauškutis;ŽVIRBLIUKAI;2554011985;Ne;4;1;3;8
1093;Čiauškutis;ŽVIRBLIUKAI;2044220236;Taip;19;0;0;19
1094;Čiauškutis;ŽVIRBLIUKAI;5900996969;Taip;15;0;0;15
1095;Čiauškutis;ŽVIRBLIUKAI;6170362846;Taip;0;0;4;4
1096;Čiauškutis;ŽVIRBLIUKAI;1036358147;Taip;16;1;0;17
1097;Čiauškutis;ŽVIRBLIUKAI;9072764004;Taip;13;0;1;14
1098;Čiauškutis;ŽVIRBLIUKAI;8690876173;Ne;5;0;2;7
1099;Čiauškutis;SAULUTĖS;4267461379;Taip;0;1;0;1
1100;Čiauškutis;SAULUTĖS;2976888531;Taip;0;1;0;1
1101;Čiauškutis;SAULUTĖS;1798962981;Taip;0;1;1;2
1102;Čiauškutis;SAULUTĖS;4248760802;Taip;1;1;3;5
1103;Čiauškutis;SAULUTĖS;6279678482;Taip;9;1;0;10
1104;Čiauškutis;SAULUTĖS;35965163532;Taip;0;1;0;1
1105;Čiauškutis;SAULUTĖS;2312273972;Taip;21;0;0;21
1106;Čiauškutis;EŽIUKAI;32462147501;Taip;0;15;1;16
1107;Čiauškutis;EŽIUKAI;54848304991;Taip;5;0;1;6
1108;Čiauškutis;EŽIUKAI;1824372731;Taip;2;1;0;3
1109;Čiauškutis;EŽIUKAI;1960094598;Taip;11;0;2;13
1110;Čiauškutis;EŽIUKAI;1575387912;Taip;4;0;1;5
1111;Čiauškutis;EŽIUKAI;37100318588;Taip;0;0;3;3
1112;Čiauškutis;EŽIUKAI;32956407401;Taip;0;8;0;8
1113;Čiauškutis;DRUGELIAI;1332686904;Taip;3;1;0;4
1114;Čiauškutis;DRUGELIAI;1404146538;Taip;0;0;8;8
1115;Čiauškutis;DRUGELIAI;1417978731;Taip;18;0;0;18
1116;Čiauškutis;DRUGELIAI;7011763860;Taip;0;0;11;11
1117;Čiauškutis;DRUGELIAI;1503190001;Taip;11;0;0;11
1118;Čiauškutis;DRUGELIAI;55539901360;Taip;5;0;0;5
1119;Čiauškutis;DRUGELIAI;47625081475;Taip;15;0;0;15
1120;Čiauškutis;DRUGELIAI;45303538716;Taip;17;0;0;17
1121;Čiauškutis;DRUGELIAI;8375416027;Taip;0;0;4;4
1122;Čiauškutis;DRUGELIAI;1480363762;Taip;0;0;2;2
1123;Čiauškutis;GENELIAI;3888278518;Taip;0;0;1;1
1124;Čiauškutis;GENELIAI;4442345827;Taip;10;0;3;13
1125;Čiauškutis;GENELIAI;6476417522;Taip;21;0;0;21
1126;Čiauškutis;GENELIAI;9679979305;Taip;8;0;5;13
1127;Čiauškutis;GENELIAI;32342661810;Taip;0;0;3;3
1128;Čiauškutis;GENELIAI;76993441149;Taip;0;2;0;2
1129;Čiauškutis;GENELIAI;48375767334;Taip;3;0;0;3
1130;Čiauškutis;GENELIAI;34341858813;Taip;2;0;0;2
1131;Čiauškutis;GENELIAI;29844230217;Taip;0;1;0;1
1132;Čiauškutis;GENELIAI;48881709481;Taip;4;0;0;4
1133;Čiauškutis;GENELIAI;47866559654;Taip;3;4;0;7
1134;Čiauškutis;LINKSMUČIAI;3127896063;Ne;6;5;0;11
1135;Čiauškutis;LINKSMUČIAI;1691137830;Taip;0;1;6;7
1136;Čiauškutis;LINKSMUČIAI;75421786315;Taip;0;5;2;7
1137;Čiauškutis;LINKSMUČIAI;70507237430;Taip;0;1;3;4
1138;Čiauškutis;LINKSMUČIAI;65948673886;Taip;7;3;0;10
1139;Čiauškutis;LINKSMUČIAI;5587488205;Taip;0;0;1;1
1140;Čiauškutis;LINKSMUČIAI;32426102534;Taip;0;5;3;8
1141;Čiauškutis;LINKSMUČIAI;9722014294;Taip;5;1;0;6
1142;Čiauškutis;LINKSMUČIAI;54471558189;Taip;0;1;4;5
1143;Čiauškutis;LINKSMUČIAI;13187502295;Taip;0;10;1;11
1144;Čiauškutis;LINKSMUČIAI;1452900014;Taip;0;0;1;1
1145;Čiauškutis;LINKSMUČIAI;2049302005;Taip;0;0;1;1
1146;Čiauškutis;KIŠKUČIAI;1380571576;Taip;0;9;0;9
1147;Čiauškutis;KIŠKUČIAI;4817007142;Taip;5;5;0;10
1148;Čiauškutis;KIŠKUČIAI;1474355889;Taip;0;1;1;2
1149;Čiauškutis;KIŠKUČIAI;26779062894;Taip;0;2;2;4
1150;Čiauškutis;KIŠKUČIAI;1109018212;Taip;10;1;0;11
1151;Čiauškutis;KIŠKUČIAI;72264057427;Taip;0;1;0;1
1152;Čiauškutis;KIŠKUČIAI;8808041204;Taip;10;0;0;10
1153;Čiauškutis;KIŠKUČIAI;3080441515;Taip;0;2;3;5
1154;Čiauškutis;KIŠKUČIAI;8884708945;Taip;21;0;0;21
1155;Čiauškutis;KIŠKUČIAI;2099735647;Taip;14;0;0;14
1156;Čiauškutis;LAPIUKAI;1849532875;Ne;0;0;4;4
1157;Čiauškutis;LAPIUKAI;1938531597;Ne;6;2;0;8
1158;Čiauškutis;LAPIUKAI;31203540590;Taip;15;0;0;15
1159;Čiauškutis;LAPIUKAI;8857039064;Taip;0;2;0;2
1160;Čiauškutis;MEŠKUČIAI;6193581306;Taip;8;0;0;8
1161;Čiauškutis;MEŠKUČIAI;1923832961;Taip;0;0;1;1
1162;Čiauškutis;MEŠKUČIAI;9240896780;Taip;7;0;0;7
1163;Čiauškutis;MEŠKUČIAI;95088279233;Taip;6;0;0;6
1164;Čiauškutis;MEŠKUČIAI;4341825486;Taip;4;0;0;4
1165;Čiauškutis;PELĖDŽIUKAI;7060197354;Taip;0;2;0;2
1166;Čiauškutis;PELĖDŽIUKAI;1253449294;Taip;0;1;0;1
1167;Čiauškutis;PELĖDŽIUKAI;82575455120;Taip;0;0;3;3
1168;Čiauškutis;PELĖDŽIUKAI;6165710260;Taip;0;0;1;1
1169;Čiauškutis;PELĖDŽIUKAI;1546096184;Taip;4;0;0;4
1170;Čiauškutis;PELĖDŽIUKAI;4135020826;Taip;0;0;2;2
1171;Čiauškutis;PELĖDŽIUKAI;1422589887;Taip;0;0;1;1
1172;Čiauškutis;PELĖDŽIUKAI;30480486366;Taip;0;0;1;1
1173;Čiauškutis;NYKŠTUKAI;6258150407;Taip;7;0;0;7
1174;Čiauškutis;NYKŠTUKAI;1621605644;Taip;3;0;0;3
1175;Čiauškutis;NYKŠTUKAI;1778900145;Taip;14;0;0;14
1176;Čiauškutis;NYKŠTUKAI;4846025153;Taip;10;0;0;10
1177;Čiauškutis;NYKŠTUKAI;1413414774;Taip;6;0;0;6
1178;Čiauškutis;NYKŠTUKAI;4917339896;Taip;6;0;0;6
1179;Čiauškutis;NYKŠTUKAI;8346845876;Taip;6;0;0;6
1180;Delfinukas;Boružėlių;1873630966;Taip;1;0;0;1
1181;Delfinukas;Boružėlių;6531930806;Taip;0;2;0;2
1182;Delfinukas;Boružėlių;8076961367;Taip;0;0;1;1
1183;Delfinukas;Boružėlių;8439204095;Taip;0;1;0;1
1184;Delfinukas;Boružėlių;5783537897;Taip;10;0;0;10
1185;Delfinukas;Boružėlių;2010703982;Taip;0;3;0;3
1186;Delfinukas;Boružėlių;8728791932;Taip;5;4;0;9
1187;Delfinukas;Boružėlių;5794346039;Taip;5;0;0;5
1188;Delfinukas;Boružėlių;1153948822;Taip;0;1;0;1
1189;Delfinukas;Boružėlių;6700068320;Taip;21;0;0;21
1190;Delfinukas;Boružėlių;7277680544;Taip;18;0;0;18
1191;Delfinukas;Boružėlių;9099945815;Taip;9;0;0;9
1192;Delfinukas;Saulytės;1293348150;Taip;0;1;0;1
1193;Delfinukas;Saulytės;65798709244;Taip;6;0;0;6
1194;Delfinukas;Saulytės;76643778833;Taip;0;2;0;2
1195;Delfinukas;Saulytės;35058841521;Taip;1;2;0;3
1196;Delfinukas;Saulytės;9918028862;Taip;15;1;0;16
1197;Delfinukas;Saulytės;1260108624;Taip;8;1;0;9
1198;Delfinukas;Saulytės;79934072325;Taip;5;0;0;5
1199;Delfinukas;Saulytės;5912904296;Taip;5;0;0;5
1200;Delfinukas;Saulytės;2009324145;Taip;16;2;0;18
1201;Delfinukas;Saulytės;27140729689;Taip;4;2;1;7
1202;Delfinukas;Saulytės;46847640903;Taip;13;0;0;13
1203;Delfinukas;Saulytės;4142864015;Taip;0;2;0;2
1204;Delfinukas;Saulytės;86601289023;Taip;12;1;0;13
1205;Delfinukas;Saulytės;16785309188;Taip;1;5;0;6
1206;Delfinukas;Saulytės;34563800372;Taip;9;3;0;12
1207;Delfinukas;Saulytės;2074439295;Taip;0;1;0;1
1208;Delfinukas;Saulytės;1364873935;Taip;3;0;0;3
1209;Delfinukas;Saulytės;1939499375;Taip;9;2;0;11
1210;Delfinukas;Saulytės;1813240176;Taip;3;0;0;3
1211;Delfinukas;Pelėdžiukų;9520598359;Taip;11;0;0;11
1212;Delfinukas;Pelėdžiukų;5018815345;Taip;0;0;21;21
1213;Delfinukas;Pelėdžiukų;8938997208;Taip;16;0;0;16
1214;Delfinukas;Pelėdžiukų;6572690788;Taip;5;1;0;6
1215;Delfinukas;Pelėdžiukų;7487111570;Taip;7;0;0;7
1216;Delfinukas;Pelėdžiukų;4631456002;Taip;8;0;0;8
1217;Delfinukas;Pelėdžiukų;3397350274;Taip;0;1;0;1
1218;Delfinukas;Pelėdžiukų;3804996594;Taip;11;0;0;11
1219;Delfinukas;Pelėdžiukų;1136182876;Taip;0;2;0;2
1220;Delfinukas;Pelėdžiukų;7873373923;Taip;2;0;0;2
1221;Delfinukas;Pelėdžiukų;8936645508;Taip;0;4;0;4
1222;Delfinukas;Pelėdžiukų;2066127119;Taip;0;6;0;6
1223;Delfinukas;Pelėdžiukų;2869506388;Taip;6;0;1;7
1224;Delfinukas;Pelėdžiukų;6844500395;Taip;2;0;0;2
1225;Delfinukas;Pelėdžiukų;9074294473;Taip;2;2;0;4
1226;Delfinukas;Varliukų;1153333591;Taip;0;4;0;4
1227;Delfinukas;Varliukų;1251961268;Taip;0;2;0;2
1228;Delfinukas;Varliukų;1789047913;Taip;0;11;0;11
1229;Delfinukas;Varliukų;3678131609;Taip;0;0;1;1
1230;Delfinukas;Varliukų;9347513042;Taip;1;2;1;4
1231;Delfinukas;Varliukų;8875479631;Taip;10;8;0;18
1232;Delfinukas;Varliukų;3344476309;Taip;18;0;0;18
1233;Delfinukas;Varliukų;3955783379;Taip;9;3;0;12
1234;Delfinukas;Varliukų;9502789660;Taip;0;1;0;1
1235;Delfinukas;Varliukų;3489297719;Taip;0;4;0;4
1236;Delfinukas;Varliukų;1948438336;Taip;1;2;4;7
1237;Delfinukas;Varliukų;9266646602;Taip;20;0;0;20
1238;Delfinukas;Varliukų;3674481373;Taip;0;8;0;8
1239;Delfinukas;Varpelių;1201971467;Taip;5;0;0;5
1240;Delfinukas;Varpelių;16192036601;Taip;0;0;5;5
1241;Delfinukas;Varpelių;17472648959;Taip;10;0;0;10
1242;Delfinukas;Varpelių;73187227229;Taip;0;1;0;1
1243;Delfinukas;Varpelių;89455376961;Taip;15;0;0;15
1244;Delfinukas;Varpelių;62769117892;Taip;0;10;0;10
1245;Delfinukas;Varpelių;46792667256;Taip;0;1;0;1
1246;Delfinukas;Varpelių;70985723823;Ne;0;2;0;2
1247;Delfinukas;Varpelių;8855690221;Taip;20;0;0;20
1248;Delfinukas;Varpelių;6393090675;Taip;9;1;0;10
1249;Delfinukas;Varpelių;1268754720;Taip;7;3;0;10
1250;Delfinukas;Varpelių;1959331544;Taip;5;0;0;5
1251;Delfinukas;Varpelių;3718612458;Taip;21;0;0;21
1252;Delfinukas;Varpelių;43859975789;Taip;5;0;0;5
1253;Delfinukas;Varpelių;91028452879;Taip;11;0;0;11
1254;Delfinukas;Varpelių;1325054642;Taip;0;5;0;5
1255;Delfinukas;Varpelių;7163839896;Taip;1;1;0;2
1256;Delfinukas;Varpelių;7493037613;Taip;1;1;0;2
1257;Delfinukas;Varpelių;4239224971;Taip;8;0;0;8
1258;Delfinukas;Varpelių;1650166115;Taip;10;1;0;11
1259;Delfinukas;Varpelių;5123666058;Taip;5;0;0;5
1260;Delfinukas;Delfinukai;6190642132;Taip;0;12;0;12
1261;Delfinukas;Delfinukai;17266052771;Taip;0;1;0;1
1262;Delfinukas;Delfinukai;57676205527;Taip;0;4;0;4
1263;Delfinukas;Delfinukai;71523999168;Taip;0;4;0;4
1264;Delfinukas;Delfinukai;46276990963;Taip;0;1;0;1
1265;Delfinukas;Delfinukai;7528505426;Taip;5;4;0;9
1266;Delfinukas;Delfinukai;6561536457;Taip;5;0;0;5
1267;Delfinukas;Delfinukai;29449834997;Taip;0;0;21;21
1268;Delfinukas;Delfinukai;545765924;Taip;6;0;0;6
1269;Delfinukas;Delfinukai;1517834246;Taip;6;0;0;6
1270;Delfinukas;Delfinukai;1430155044;Taip;2;1;0;3
1271;Delfinukas;Delfinukai;7886801955;Taip;0;0;21;21
1272;Delfinukas;Delfinukai;1160537966;Taip;16;0;0;16
1273;Delfinukas;Delfinukai;26626004000;Taip;0;0;21;21
1274;Delfinukas;Drugeliai;83704349624;Taip;0;3;0;3
1275;Delfinukas;Drugeliai;86042798636;Taip;0;1;5;6
1276;Delfinukas;Drugeliai;74847760830;Taip;7;0;0;7
1277;Delfinukas;Drugeliai;35812802830;Taip;4;6;0;10
1278;Delfinukas;Drugeliai;2960662435;Taip;0;8;0;8
1279;Delfinukas;Drugeliai;11940207202;Taip;4;0;0;4
1280;Delfinukas;Drugeliai;94713648240;Taip;0;1;0;1
1281;Delfinukas;Drugeliai;2402204674;Taip;4;0;0;4
1282;Delfinukas;Drugeliai;1882976317;Taip;9;0;0;9
1283;Delfinukas;Drugeliai;9168812609;Taip;11;0;6;17
1284;Delfinukas;Drugeliai;5024726028;Taip;0;2;2;4
1285;Delfinukas;Drugeliai;88370692635;Taip;3;0;0;3
1286;Delfinukas;Drugeliai;4435982727;Taip;2;1;4;7
1287;Delfinukas;Drugeliai;2135364149;Taip;1;2;5;8
1288;Delfinukas;Drugeliai;33466088300;Taip;0;2;0;2
1289;Delfinukas;Drugeliai;8782782031;Taip;0;1;0;1
1290;Delfinukas;Žuvytės;31776667512;Taip;0;4;0;4
1291;Delfinukas;Žuvytės;47377556072;Taip;13;3;0;16
1292;Delfinukas;Žuvytės;82176273307;Taip;6;0;0;6
1293;Delfinukas;Žuvytės;53152433196;Taip;4;1;0;5
1294;Delfinukas;Žuvytės;29959372638;Taip;1;0;0;1
1295;Delfinukas;Žuvytės;21095307036;Taip;0;0;21;21
1296;Delfinukas;Žuvytės;94392092103;Ne;15;0;0;15
1297;Delfinukas;Žuvytės;57461575212;Taip;0;6;0;6
1298;Delfinukas;Žuvytės;40665480700;Taip;7;0;1;8
1299;Delfinukas;Žuvytės;3310208029;Taip;0;11;0;11
1300;Delfinukas;Žuvytės;1693121016;Taip;0;3;0;3
1301;Delfinukas;Žuvytės;31006890017;Taip;0;6;0;6
1302;Delfinukas;Žuvytės;29649846186;Taip;1;5;0;6
1303;Delfinukas;Žuvytės;24363585231;Taip;0;2;4;6
1304;Delfinukas;Žuvytės;30064453011;Taip;13;5;0;18
1305;Delfinukas;Žuvytės;1238188049;Taip;0;2;1;3
1306;Delfinukas;Žuvytės;2141617594;Taip;0;1;0;1
1307;Delfinukas;Žuvytės;59541249199;Taip;5;0;0;5
1308;Delfinukas;Delfinai;8335398345;Taip;9;0;0;9
1309;Delfinukas;Delfinai;37530814188;Taip;1;2;0;3
1310;Delfinukas;Delfinai;1435104895;Taip;8;1;0;9
1311;Delfinukas;Delfinai;1876110301;Taip;14;0;0;14
1312;Delfinukas;Delfinai;1101237825;Taip;16;0;0;16
1313;Delfinukas;Delfinai;11528618044;Taip;8;2;0;10
1314;Delfinukas;Delfinai;26554152266;Taip;6;2;0;8
1315;Delfinukas;Delfinai;51442842468;Taip;0;6;0;6
1316;Delfinukas;Delfinai;84024727184;Taip;8;0;0;8
1317;Delfinukas;Delfinai;1382754985;Taip;6;1;0;7
1318;Delfinukas;Delfinai;1515422367;Taip;14;0;0;14
1319;Delfinukas;Delfinai;71828460624;Taip;4;0;0;4
1320;Delfinukas;Delfinai;4549364929;Taip;0;1;0;1
1321;Delfinukas;Delfinai;4497323553;Taip;0;1;0;1
1322;Delfinukas;Delfinai;1037795359;Taip;5;0;0;5
1323;Delfinukas;Delfinai;83920976768;Taip;0;1;0;1
1324;Delfinukas;Delfinai;1963422247;Taip;12;0;0;12
1325;Delfinukas;Delfinai;9821969586;Taip;5;6;0;11
1326;Delfinukas;Delfinai;4569691896;Taip;10;0;0;10
1327;Delfinukas;Paukšteliai;6047881184;Taip;11;0;0;11
1328;Delfinukas;Paukšteliai;2784942324;Taip;6;1;0;7
1329;Delfinukas;Paukšteliai;8038737019;Taip;4;0;0;4
1330;Delfinukas;Paukšteliai;9628317328;Taip;1;1;0;2
1331;Delfinukas;Paukšteliai;5797308373;Taip;6;2;0;8
1332;Delfinukas;Paukšteliai;5241426445;Taip;16;0;0;16
1333;Delfinukas;Paukšteliai;8099120371;Taip;0;0;21;21
1334;Delfinukas;Paukšteliai;3108430680;Taip;1;1;0;2
1335;Delfinukas;Paukšteliai;7663934825;Taip;5;2;0;7
1336;Delfinukas;Paukšteliai;2382077576;Taip;1;4;0;5
1337;Delfinukas;Paukšteliai;1200205376;Taip;9;1;0;10
1338;Delfinukas;Paukšteliai;4347116918;Taip;10;0;0;10
1339;Delfinukas;Paukšteliai;1922513830;Taip;11;1;0;12
1340;Delfinukas;Paukšteliai;7629622746;Taip;5;1;0;6
1341;Delfinukas;Paukšteliai;8335034956;Taip;21;0;0;21
1342;Delfinukas;Paukšteliai;6337962165;Taip;5;2;1;8
1343;Delfinukas;Kiškučiai;7766292005;Taip;0;3;0;3
1344;Delfinukas;Kiškučiai;1498120150;Taip;5;2;0;7
1345;Delfinukas;Kiškučiai;7920401664;Taip;10;4;0;14
1346;Delfinukas;Kiškučiai;1767369189;Taip;10;2;0;12
1347;Delfinukas;Kiškučiai;1495145663;Taip;0;9;0;9
1348;Delfinukas;Kiškučiai;1301231548;Taip;10;1;1;12
1349;Delfinukas;Kiškučiai;1613911039;Taip;6;1;0;7
1350;Delfinukas;Kiškučiai;1477374660;Taip;12;0;0;12
1351;Delfinukas;Kiškučiai;2993704795;Taip;0;1;0;1
1352;Delfinukas;Kiškučiai;1487082744;Taip;0;2;0;2
1353;Delfinukas;Kiškučiai;1011101007;Ne;11;1;0;12
1354;Delfinukas;Kiškučiai;2063259303;Taip;0;5;0;5
1355;Delfinukas;Kiškučiai;1166370228;Taip;17;0;0;17
1356;Delfinukas;Kiškučiai;60320557464;Taip;4;2;0;6
1357;Delfinukas;Kiškučiai;1594700604;Taip;0;6;0;6
1358;Dobilėlis;"I grupė";28814860843;Taip;9;3;0;12
1359;Dobilėlis;"I grupė";8709039752;Taip;13;4;0;17
1360;Dobilėlis;"I grupė";6561825173;Ne;12;5;0;17
1361;Dobilėlis;"I grupė";7122041826;Taip;0;5;0;5
1362;Dobilėlis;"II grupė";1186330934;Taip;4;0;0;4
1363;Dobilėlis;"II grupė";17440499472;Taip;1;0;0;1
1364;Dobilėlis;"II grupė";92147631467;Taip;3;2;0;5
1365;Dobilėlis;"II grupė";68068847689;Taip;0;6;2;8
1366;Dobilėlis;"II grupė";1173849791;Taip;5;12;0;17
1367;Drevinukas;ZUIKUČIAI;8180027849;Taip;0;5;1;6
1368;Drevinukas;ZUIKUČIAI;5686116320;Taip;0;3;0;3
1369;Drevinukas;ZUIKUČIAI;85288014888;Taip;0;4;0;4
1370;Drevinukas;ZUIKUČIAI;2070374746;Taip;0;0;3;3
1371;Drevinukas;ZUIKUČIAI;16952164778;Taip;5;0;0;5
1372;Drevinukas;ZUIKUČIAI;7632515230;Taip;14;3;0;17
1373;Drevinukas;ZUIKUČIAI;1019214451;Taip;2;0;0;2
1374;Drevinukas;ZUIKUČIAI;5046355276;Taip;3;0;0;3
1375;Drevinukas;ZUIKUČIAI;6304169257;Taip;0;1;2;3
1376;Drevinukas;ZUIKUČIAI;3657451903;Taip;5;1;0;6
1377;Drevinukas;ZUIKUČIAI;4332606643;Taip;0;0;1;1
1378;Drevinukas;ZUIKUČIAI;1123115847;Taip;17;1;0;18
1379;Drevinukas;ZUIKUČIAI;9336227821;Taip;0;0;2;2
1380;Drevinukas;ZUIKUČIAI;6425268903;Taip;0;5;0;5
1381;Drevinukas;AŽUOLIUKŲ;4980076288;Taip;0;0;1;1
1382;Drevinukas;AŽUOLIUKŲ;64560340218;Taip;0;6;0;6
1383;Drevinukas;AŽUOLIUKŲ;13638194271;Taip;0;2;0;2
1384;Drevinukas;AŽUOLIUKŲ;17456144256;Taip;0;1;1;2
1385;Drevinukas;AŽUOLIUKŲ;3066586415;Taip;0;1;2;3
1386;Drevinukas;AŽUOLIUKŲ;1250033881;Taip;8;0;0;8
1387;Drevinukas;AŽUOLIUKŲ;22050717457;Taip;0;7;0;7
1388;Drevinukas;AŽUOLIUKŲ;74690633233;Taip;0;1;0;1
1389;Drevinukas;AŽUOLIUKŲ;73923305630;Taip;7;0;1;8
1390;Drevinukas;AŽUOLIUKŲ;1254845545;Taip;5;1;0;6
1391;Drevinukas;AŽUOLIUKŲ;46006802320;Taip;0;5;0;5
1392;Drevinukas;AŽUOLIUKŲ;1978599912;Taip;0;0;2;2
1393;Drevinukas;AŽUOLIUKŲ;9657606451;Taip;0;9;0;9
1394;Drevinukas;AŽUOLIUKŲ;4150306697;Taip;13;3;0;16
1395;Drevinukas;AŽUOLIUKŲ;71447591085;Taip;11;1;0;12
1396;Drevinukas;AŽUOLIUKŲ;2483043689;Taip;0;1;0;1
1397;Drevinukas;PELĖDŽIUKAI;4694536057;Taip;0;0;1;1
1398;Drevinukas;PELĖDŽIUKAI;67211396910;Taip;0;1;0;1
1399;Drevinukas;PELĖDŽIUKAI;49359528680;Taip;0;1;9;10
1400;Drevinukas;PELĖDŽIUKAI;98918406807;Taip;0;0;2;2
1401;Drevinukas;PELĖDŽIUKAI;13716365912;Taip;0;3;0;3
1402;Drevinukas;PELĖDŽIUKAI;24866634007;Taip;0;1;5;6
1403;Drevinukas;PELĖDŽIUKAI;98431492077;Taip;8;0;0;8
1404;Drevinukas;PELĖDŽIUKAI;54578654099;Taip;6;0;0;6
1405;Drevinukas;PELĖDŽIUKAI;62264151217;Taip;0;5;0;5
1406;Drevinukas;PELĖDŽIUKAI;53607306428;Taip;4;1;2;7
1407;Drevinukas;PELĖDŽIUKAI;45489453961;Ne;0;1;5;6
1408;Drevinukas;PELĖDŽIUKAI;11985365230;Taip;4;1;0;5
1409;Drevinukas;PELĖDŽIUKAI;83204594508;Taip;0;1;3;4
1410;Drevinukas;PELĖDŽIUKAI;78255352251;Taip;1;0;1;2
1411;Drevinukas;PELĖDŽIUKAI;59835545517;Taip;11;2;0;13
1412;Drevinukas;PELĖDŽIUKAI;12709943846;Taip;0;10;0;10
1413;Drevinukas;PELĖDŽIUKAI;69217298162;Taip;0;1;1;2
1414;Drevinukas;PELĖDŽIUKAI;47576956459;Taip;0;0;1;1
1415;Drevinukas;PELĖDŽIUKAI;61881364454;Taip;0;0;2;2
1416;Drevinukas;BORUŽĖLĖS;24300552411;Taip;0;0;1;1
1417;Drevinukas;BORUŽĖLĖS;39014589824;Taip;0;1;0;1
1418;Drevinukas;BORUŽĖLĖS;3625661236;Taip;0;6;0;6
1419;Drevinukas;BORUŽĖLĖS;41776089342;Taip;0;11;0;11
1420;Drevinukas;BORUŽĖLĖS;46323011887;Taip;0;5;0;5
1421;Drevinukas;BORUŽĖLĖS;17722412785;Taip;11;2;1;14
1422;Drevinukas;BORUŽĖLĖS;1437074990;Taip;0;0;2;2
1423;Drevinukas;BORUŽĖLĖS;8325320616;Taip;4;0;2;6
1424;Drevinukas;BORUŽĖLĖS;1577311253;Taip;0;1;4;5
1425;Drevinukas;BORUŽĖLĖS;6539595624;Taip;8;0;1;9
1426;Drevinukas;BORUŽĖLĖS;7570410899;Taip;21;0;0;21
1427;Drevinukas;BORUŽĖLĖS;1929303009;Taip;5;0;2;7
1428;Drevinukas;BORUŽĖLĖS;64093448834;Taip;0;0;3;3
1429;Drevinukas;BORUŽĖLĖS;59090501289;Taip;0;0;3;3
1430;Drevinukas;BORUŽĖLĖS;1585468549;Taip;1;13;0;14
1431;Drevinukas;BORUŽĖLĖS;1276720097;Taip;4;1;0;5
1432;Drevinukas;BORUŽĖLĖS;47549756124;Taip;0;0;2;2
1433;Drevinukas;BORUŽĖLĖS;3604979285;Taip;0;0;1;1
1434;Drevinukas;BORUŽĖLĖS;78348414683;Taip;12;0;0;12
1435;Drevinukas;BORUŽĖLĖS;1970787957;Taip;0;5;0;5
1436;Drevinukas;BORUŽĖLĖS;30667895560;Taip;0;0;2;2
1437;Drevinukas;BORUŽĖLĖS;83194462453;Taip;0;2;0;2
1438;Drevinukas;BITUTĖS;81036035477;Taip;0;3;0;3
1439;Drevinukas;BITUTĖS;96688324084;Taip;0;3;0;3
1440;Drevinukas;BITUTĖS;30808032808;Taip;0;1;0;1
1441;Drevinukas;BITUTĖS;24223024745;Taip;0;1;2;3
1442;Drevinukas;BITUTĖS;7088781332;Taip;0;12;0;12
1443;Drevinukas;BITUTĖS;67343152327;Taip;6;7;0;13
1444;Drevinukas;BITUTĖS;79654459964;Taip;0;1;3;4
1445;Drevinukas;BITUTĖS;13511159834;Taip;0;1;0;1
1446;Drevinukas;BITUTĖS;7874030637;Taip;0;1;0;1
1447;Drevinukas;BITUTĖS;86268382049;Taip;0;1;0;1
1448;Drevinukas;BITUTĖS;91352351942;Taip;0;14;0;14
1449;Drevinukas;BITUTĖS;43573400232;Taip;0;2;0;2
1450;Drevinukas;BITUTĖS;43087053446;Taip;9;0;0;9
1451;Drevinukas;BITUTĖS;81362980445;Taip;0;2;0;2
1452;Drevinukas;BITUTĖS;66058660804;Taip;5;2;0;7
1453;Drevinukas;BITUTĖS;56016757119;Taip;7;5;0;12
1454;Drevinukas;BITUTĖS;62294117396;Taip;4;0;2;6
1455;Drevinukas;BITUTĖS;71273092994;Taip;0;5;0;5
1456;Drevinukas;NYKŠTUKAI;1720464417;Taip;11;3;0;14
1457;Drevinukas;NYKŠTUKAI;6095020718;Taip;0;0;2;2
1458;Drevinukas;NYKŠTUKAI;7753238387;Taip;9;0;1;10
1459;Drevinukas;NYKŠTUKAI;5679723776;Taip;0;9;0;9
1460;Drevinukas;NYKŠTUKAI;2857797268;Taip;5;0;2;7
1461;Drevinukas;NYKŠTUKAI;3875062228;Taip;0;0;3;3
1462;Drevinukas;NYKŠTUKAI;8479979176;Taip;17;1;0;18
1463;Drevinukas;NYKŠTUKAI;2531207946;Taip;17;1;0;18
1464;Drevinukas;NYKŠTUKAI;1152161183;Taip;0;4;4;8
1465;Drevinukas;NYKŠTUKAI;6256572875;Taip;12;0;0;12
1466;Drevinukas;NYKŠTUKAI;8936058501;Taip;0;0;4;4
1467;Drevinukas;NYKŠTUKAI;8130416781;Taip;5;3;0;8
1468;Drevinukas;NYKŠTUKAI;3972897839;Taip;0;0;4;4
1469;Drevinukas;NYKŠTUKAI;9772484901;Taip;0;1;0;1
1470;Drevinukas;NYKŠTUKAI;7520907833;Taip;0;10;0;10
1471;Drevinukas;NYKŠTUKAI;8625382465;Taip;5;0;1;6
1472;Drevinukas;NYKŠTUKAI;5521378389;Taip;0;0;1;1
1473;Drevinukas;SMALSUČIAI;3032536983;Taip;16;0;0;16
1474;Drevinukas;SMALSUČIAI;8556218971;Taip;5;0;1;6
1475;Drevinukas;SMALSUČIAI;5524567803;Taip;4;0;2;6
1476;Drevinukas;SMALSUČIAI;9016985238;Taip;0;1;2;3
1477;Drevinukas;SMALSUČIAI;2929598743;Taip;4;1;0;5
1478;Drevinukas;SMALSUČIAI;6373230526;Taip;6;0;10;16
1479;Drevinukas;SMALSUČIAI;4404254932;Taip;0;0;3;3
1480;Drevinukas;SMALSUČIAI;2378493422;Taip;2;0;0;2
1481;Drevinukas;SMALSUČIAI;8984653958;Taip;6;2;0;8
1482;Drevinukas;SMALSUČIAI;5620887702;Taip;8;6;0;14
1483;Drevinukas;SMALSUČIAI;2281463885;Taip;9;0;0;9
1484;Drevinukas;SMALSUČIAI;3725760478;Taip;1;0;1;2
1485;Drevinukas;SMALSUČIAI;4662426451;Taip;9;0;0;9
1486;Drevinukas;SMALSUČIAI;7218201733;Taip;10;0;0;10
1487;Drevinukas;ŽVIRBLIUKAI;5348609358;Taip;12;0;0;12
1488;Drevinukas;ŽVIRBLIUKAI;2312241894;Taip;16;0;0;16
1489;Drevinukas;ŽVIRBLIUKAI;5394143000;Taip;8;4;0;12
1490;Drevinukas;ŽVIRBLIUKAI;3871506691;Taip;8;1;0;9
1491;Drevinukas;ŽVIRBLIUKAI;6914111231;Taip;8;1;0;9
1492;Drevinukas;ŽVIRBLIUKAI;3377957769;Taip;8;0;0;8
1493;Drevinukas;ŽVIRBLIUKAI;3779983775;Taip;8;0;0;8
1494;Drevinukas;ŽVIRBLIUKAI;1343431478;Taip;8;0;0;8
1495;Drevinukas;ŽVIRBLIUKAI;1829421385;Taip;7;1;0;8
1496;Drevinukas;ŽVIRBLIUKAI;8262224710;Taip;15;2;0;17
1497;Drevinukas;ŽVIRBLIUKAI;2935175014;Taip;7;0;7;14
1498;Drevinukas;ŽVIRBLIUKAI;5754055310;Taip;0;0;2;2
1499;Drevinukas;ŽVIRBLIUKAI;3046196006;Taip;8;0;0;8
1500;Drevinukas;ŽVIRBLIUKAI;4134729710;Taip;0;0;4;4
1501;Drevinukas;ŽVIRBLIUKAI;4260123123;Taip;6;6;0;12
1502;Drugelis;NYKŠTUKŲ;17059982861;Taip;0;0;1;1
1503;Drugelis;NYKŠTUKŲ;86452076401;Taip;0;1;0;1
1504;Drugelis;NYKŠTUKŲ;182843897;Taip;0;2;0;2
1505;Drugelis;NYKŠTUKŲ;9263055716;Taip;0;0;4;4
1506;Drugelis;NYKŠTUKŲ;91204781931;Taip;5;2;0;7
1507;Drugelis;NYKŠTUKŲ;85144628483;Taip;0;2;0;2
1508;Drugelis;NYKŠTUKŲ;53978775822;Taip;0;1;0;1
1509;Drugelis;NYKŠTUKŲ;90197519022;Taip;0;1;0;1
1510;Drugelis;NYKŠTUKŲ;9923093174;Taip;0;2;2;4
1511;Drugelis;NYKŠTUKŲ;67195315804;Taip;0;1;0;1
1512;Drugelis;NYKŠTUKŲ;2593184133;Taip;0;2;0;2
1513;Drugelis;NYKŠTUKŲ;40524667913;Taip;6;1;0;7
1514;Drugelis;NYKŠTUKŲ;14998254512;Taip;0;2;0;2
1515;Drugelis;NYKŠTUKŲ;67097500323;Taip;5;1;0;6
1516;Drugelis;NYKŠTUKŲ;62834741685;Taip;0;2;0;2
1517;Drugelis;NYKŠTUKŲ;88553764001;Taip;0;1;0;1
1518;Drugelis;NYKŠTUKŲ;69762633803;Taip;0;1;0;1
1519;Drugelis;SMALSUČIŲ;3479833265;Taip;6;1;0;7
1520;Drugelis;SMALSUČIŲ;1217635751;Taip;0;0;1;1
1521;Drugelis;SMALSUČIŲ;1288160341;Taip;14;1;0;15
1522;Drugelis;SMALSUČIŲ;27569805506;Taip;0;9;0;9
1523;Drugelis;SMALSUČIŲ;1856912386;Taip;0;6;0;6
1524;Drugelis;SMALSUČIŲ;1576853049;Taip;0;0;2;2
1525;Drugelis;SMALSUČIŲ;1901608445;Taip;14;1;0;15
1526;Drugelis;SMALSUČIŲ;3096906506;Taip;1;3;0;4
1527;Drugelis;SMALSUČIŲ;7406396614;Taip;0;2;0;2
1528;Drugelis;SMALSUČIŲ;1255315664;Taip;7;0;0;7
1529;Drugelis;SMALSUČIŲ;1160161173;Taip;0;1;0;1
1530;Drugelis;SMALSUČIŲ;1843605624;Taip;0;3;0;3
1531;Drugelis;SMALSUČIŲ;1506988472;Taip;0;2;0;2
1532;Drugelis;SMALSUČIŲ;1991420008;Taip;0;2;0;2
1533;Drugelis;SMALSUČIŲ;1421438458;Taip;0;4;0;4
1534;Drugelis;SMALSUČIŲ;53874036107;Taip;4;2;0;6
1535;Drugelis;SMALSUČIŲ;1961898730;Taip;0;2;0;2
1536;Drugelis;SMALSUČIŲ;4788423265;Taip;0;0;5;5
1537;Drugelis;SMALSUČIŲ;1541276266;Taip;5;3;0;8
1538;Drugelis;SMALSUČIŲ;5954059321;Taip;14;0;0;14
1539;Drugelis;SMALSUČIŲ;1888002607;Taip;3;1;0;4
1540;Drugelis;MUMINUKŲ;51963723965;Taip;0;1;0;1
1541;Drugelis;MUMINUKŲ;89109375373;Taip;0;1;0;1
1542;Drugelis;MUMINUKŲ;10841811704;Taip;0;1;0;1
1543;Drugelis;MUMINUKŲ;55662263930;Taip;0;1;0;1
1544;Drugelis;MUMINUKŲ;78391738678;Taip;4;1;0;5
1545;Drugelis;MUMINUKŲ;63076864410;Taip;0;1;0;1
1546;Drugelis;MUMINUKŲ;44627668646;Taip;1;7;1;9
1547;Drugelis;MUMINUKŲ;78311619943;Taip;0;5;0;5
1548;Drugelis;MUMINUKŲ;35386244403;Taip;11;2;0;13
1549;Drugelis;MUMINUKŲ;37910900277;Ne;0;2;0;2
1550;Drugelis;MUMINUKŲ;88073976875;Taip;0;1;0;1
1551;Drugelis;MUMINUKŲ;13989264253;Taip;0;3;1;4
1552;Drugelis;MUMINUKŲ;25002448923;Taip;0;1;0;1
1553;Drugelis;MUMINUKŲ;55339135155;Taip;0;1;0;1
1554;Drugelis;MUMINUKŲ;82465836364;Taip;6;0;0;6
1555;Drugelis;MUMINUKŲ;1761079726;Taip;0;3;0;3
1556;Drugelis;MUMINUKŲ;29713921940;Taip;0;1;0;1
1557;Drugelis;MUMINUKŲ;82441447907;Taip;0;1;0;1
1558;Drugelis;MUMINUKŲ;70288969200;Taip;10;0;0;10
1559;Drugelis;PŪKUOTUKAI;49035429728;Taip;3;1;0;4
1560;Drugelis;PŪKUOTUKAI;3156382280;Taip;3;1;0;4
1561;Drugelis;PŪKUOTUKAI;59819126556;Taip;0;0;10;10
1562;Drugelis;PŪKUOTUKAI;4989130624;Taip;16;1;0;17
1563;Drugelis;PŪKUOTUKAI;26436464504;Taip;0;1;0;1
1564;Drugelis;PŪKUOTUKAI;1657445173;Taip;1;0;2;3
1565;Drugelis;PŪKUOTUKAI;91538620813;Taip;0;5;0;5
1566;Drugelis;PŪKUOTUKAI;57217727711;Taip;0;0;5;5
1567;Drugelis;PŪKUOTUKAI;1240607928;Taip;3;2;0;5
1568;Drugelis;PŪKUOTUKAI;1162058481;Taip;0;2;0;2
1569;Drugelis;PŪKUOTUKAI;3161396176;Taip;0;5;0;5
1570;Drugelis;PŪKUOTUKAI;5649225445;Taip;0;5;0;5
1571;Drugelis;PŪKUOTUKAI;1060282804;Taip;3;5;0;8
1572;Drugelis;PŪKUOTUKAI;1667056936;Taip;13;0;0;13
1573;Drugelis;PŪKUOTUKAI;63777226415;Taip;0;1;0;1
1574;Drugelis;PŪKUOTUKAI;49678120281;Taip;9;0;0;9
1575;Drugelis;PŪKUOTUKAI;1651512363;Taip;10;2;0;12
1576;Drugelis;PŪKUOTUKAI;1546655542;Taip;10;1;0;11
1577;Drugelis;SPINDULIUKAI;6594452094;Taip;1;7;2;10
1578;Drugelis;SPINDULIUKAI;4523513611;Taip;0;1;0;1
1579;Drugelis;SPINDULIUKAI;5122256823;Taip;5;0;0;5
1580;Drugelis;SPINDULIUKAI;7609530453;Taip;4;0;0;4
1581;Drugelis;SPINDULIUKAI;1142209285;Taip;5;0;0;5
1582;Drugelis;SPINDULIUKAI;4158475365;Taip;0;2;2;4
1583;Drugelis;SPINDULIUKAI;9510744779;Taip;0;0;10;10
1584;Drugelis;SPINDULIUKAI;8717445483;Taip;15;0;0;15
1585;Drugelis;SPINDULIUKAI;9836193857;Taip;16;1;0;17
1586;Drugelis;SPINDULIUKAI;4825232236;Taip;6;0;3;9
1587;Drugelis;SPINDULIUKAI;5515894973;Taip;0;1;3;4
1588;Drugelis;SPINDULIUKAI;7447519502;Taip;3;1;0;4
1589;Drugelis;SPINDULIUKAI;7590759136;Taip;18;0;0;18
1590;Drugelis;SPINDULIUKAI;8752459733;Taip;11;0;0;11
1591;Drugelis;SPINDULIUKAI;7719697394;Taip;0;0;8;8
1592;Drugelis;SPINDULIUKAI;5692743298;Taip;4;8;0;12
1593;Drugelis;KIŠKUČIAI;3551095669;Taip;0;1;0;1
1594;Drugelis;KIŠKUČIAI;9316073597;Taip;3;5;0;8
1595;Drugelis;KIŠKUČIAI;9612696781;Taip;13;0;0;13
1596;Drugelis;KIŠKUČIAI;5691833295;Taip;0;0;11;11
1597;Drugelis;KIŠKUČIAI;3037496936;Taip;0;0;10;10
1598;Drugelis;KIŠKUČIAI;1785724340;Taip;0;4;0;4
1599;Drugelis;KIŠKUČIAI;9345527734;Taip;6;0;0;6
1600;Drugelis;KIŠKUČIAI;6038184222;Taip;0;1;0;1
1601;Drugelis;KIŠKUČIAI;6321332888;Taip;6;1;0;7
1602;Drugelis;KIŠKUČIAI;6632884258;Taip;0;6;0;6
1603;Drugelis;KIŠKUČIAI;8591548746;Taip;5;0;0;5
1604;"Du gaideliai";Uodelių;1758546983;Taip;6;1;3;10
1605;"Du gaideliai";Uodelių;94639433266;Taip;0;1;0;1
1606;"Du gaideliai";Uodelių;1230622413;Taip;4;2;0;6
1607;"Du gaideliai";Uodelių;6715434585;Taip;0;1;0;1
1608;"Du gaideliai";Uodelių;1500684755;Taip;0;2;0;2
1609;"Du gaideliai";Uodelių;4387568448;Taip;0;0;3;3
1610;"Du gaideliai";Uodelių;2601122166;Taip;20;1;0;21
1611;"Du gaideliai";Uodelių;5430986033;Taip;0;5;0;5
1612;"Du gaideliai";Uodelių;1876870081;Taip;0;6;0;6
1613;"Du gaideliai";Uodelių;1962859229;Taip;0;1;0;1
1614;"Du gaideliai";Uodelių;1557413692;Taip;0;8;0;8
1615;"Du gaideliai";Uodelių;3560637865;Taip;8;0;0;8
1616;"Du gaideliai";Uodelių;7783203480;Taip;0;1;0;1
1617;"Du gaideliai";Uodelių;9324740716;Taip;2;0;3;5
1618;"Du gaideliai";Uodelių;1211005513;Taip;5;0;1;6
1619;"Du gaideliai";Uodelių;1549762923;Taip;0;1;2;3
1620;"Du gaideliai";Uodelių;2159833613;Taip;2;10;0;12
1621;"Du gaideliai";OŽIUKŲ;25738622801;Taip;12;0;2;14
1622;"Du gaideliai";OŽIUKŲ;50087080642;Taip;12;0;2;14
1623;"Du gaideliai";OŽIUKŲ;91470338843;Taip;4;0;0;4
1624;"Du gaideliai";OŽIUKŲ;1479672134;Taip;0;2;0;2
1625;"Du gaideliai";OŽIUKŲ;88801178853;Taip;0;1;15;16
1626;"Du gaideliai";OŽIUKŲ;1128234653;Taip;0;2;0;2
1627;"Du gaideliai";OŽIUKŲ;14681393632;Taip;8;2;0;10
1628;"Du gaideliai";OŽIUKŲ;13384312035;Taip;6;0;0;6
1629;"Du gaideliai";OŽIUKŲ;30562958921;Taip;1;0;2;3
1630;"Du gaideliai";OŽIUKŲ;1291620608;Taip;0;1;0;1
1631;"Du gaideliai";OŽIUKŲ;1628346439;Taip;4;8;0;12
1632;"Du gaideliai";OŽIUKŲ;1304400387;Taip;0;2;0;2
1633;"Du gaideliai";OŽIUKŲ;80297570999;Taip;0;0;1;1
1634;"Du gaideliai";OŽIUKŲ;1261678548;Taip;0;10;0;10
1635;"Du gaideliai";OŽIUKŲ;1791530261;Taip;0;1;0;1
1636;"Du gaideliai";OŽIUKŲ;73447542654;Taip;1;1;0;2
1637;"Du gaideliai";OŽIUKŲ;1906486044;Taip;0;1;0;1
1638;"Du gaideliai";OŽIUKŲ;6161829923;Taip;2;10;0;12
1639;"Du gaideliai";OŽIUKŲ;1923863232;Taip;1;0;0;1
1640;"Du gaideliai";Vištyčių;1888402861;Taip;0;3;0;3
1641;"Du gaideliai";Vištyčių;31139048776;Taip;8;3;0;11
1642;"Du gaideliai";Vištyčių;25898248315;Taip;0;6;0;6
1643;"Du gaideliai";Vištyčių;56826255179;Taip;0;6;0;6
1644;"Du gaideliai";Vištyčių;10516676378;Taip;0;3;0;3
1645;"Du gaideliai";Vištyčių;11621795110;Taip;0;5;0;5
1646;"Du gaideliai";Vištyčių;59558745879;Taip;6;0;3;9
1647;"Du gaideliai";Vištyčių;14599820571;Taip;0;1;0;1
1648;"Du gaideliai";Vištyčių;8087660692;Taip;20;0;0;20
1649;"Du gaideliai";Vištyčių;46193129936;Taip;0;2;0;2
1650;"Du gaideliai";Vištyčių;82205925738;Taip;3;4;0;7
1651;"Du gaideliai";Vištyčių;9173656753;Taip;11;2;0;13
1652;"Du gaideliai";Vištyčių;1277603882;Taip;0;1;0;1
1653;"Du gaideliai";Vištyčių;73654636959;Taip;0;1;0;1
1654;"Du gaideliai";Vištyčių;1850550387;Taip;0;4;0;4
1655;"Du gaideliai";Vištyčių;1258859998;Taip;0;1;0;1
1656;"Du gaideliai";Vištyčių;2157315097;Taip;0;1;0;1
1657;"Du gaideliai";Vištyčių;1823681047;Taip;0;12;0;12
1658;"Du gaideliai";GAIDŽIUKŲ;13544785168;Taip;0;2;0;2
1659;"Du gaideliai";GAIDŽIUKŲ;98790674632;Taip;8;2;0;10
1660;"Du gaideliai";GAIDŽIUKŲ;94409399599;Taip;0;3;0;3
1661;"Du gaideliai";GAIDŽIUKŲ;67678569738;Taip;0;1;15;16
1662;"Du gaideliai";GAIDŽIUKŲ;10671107948;Taip;0;6;0;6
1663;"Du gaideliai";GAIDŽIUKŲ;62233928653;Taip;1;0;0;1
1664;"Du gaideliai";GAIDŽIUKŲ;24753427184;Taip;4;5;0;9
1665;"Du gaideliai";GAIDŽIUKŲ;63476686143;Ne;0;1;0;1
1666;"Du gaideliai";GAIDŽIUKŲ;65144471076;Taip;10;2;0;12
1667;"Du gaideliai";GAIDŽIUKŲ;83990613379;Taip;0;1;0;1
1668;"Du gaideliai";GAIDŽIUKŲ;1016464081;Taip;0;1;0;1
1669;"Du gaideliai";GAIDŽIUKŲ;74161177222;Taip;15;1;0;16
1670;"Du gaideliai";GAIDŽIUKŲ;97364620242;Ne;0;7;0;7
1671;"Du gaideliai";GAIDŽIUKŲ;8471369515;Taip;0;1;0;1
1672;"Du gaideliai";GAIDŽIUKŲ;79558840364;Taip;8;1;0;9
1673;"Du gaideliai";GAIDŽIUKŲ;71411267197;Taip;3;0;0;3
1674;"Du gaideliai";GAIDŽIUKŲ;87984135142;Taip;0;1;0;1
1675;"Du gaideliai";GAIDŽIUKŲ;40776415914;Taip;0;4;0;4
1676;"Du gaideliai";Musyčių;4144269068;Taip;15;1;0;16
1677;"Du gaideliai";Musyčių;3370029981;Taip;0;1;0;1
1678;"Du gaideliai";Musyčių;7373413569;Taip;8;2;0;10
1679;"Du gaideliai";Musyčių;6783206132;Taip;12;0;0;12
1680;"Du gaideliai";Musyčių;3507387826;Taip;11;6;0;17
1681;"Du gaideliai";Musyčių;2921485707;Taip;5;0;0;5
1682;"Du gaideliai";Musyčių;5894974508;Taip;1;0;0;1
1683;"Du gaideliai";Musyčių;1135098595;Taip;0;4;0;4
1684;"Du gaideliai";Musyčių;5652662610;Taip;10;2;0;12
1685;"Du gaideliai";Musyčių;6348951959;Taip;14;0;0;14
1686;"Du gaideliai";Musyčių;3854355215;Taip;0;8;0;8
1687;"Du gaideliai";Musyčių;3849899284;Taip;0;2;0;2
1688;"Du gaideliai";Musyčių;2262425557;Taip;8;0;0;8
1689;"Du gaideliai";Musyčių;6417648753;Taip;16;0;1;17
1690;"Du gaideliai";MALŪNO;6247706405;Taip;8;0;0;8
1691;"Du gaideliai";MALŪNO;6870356241;Taip;0;3;0;3
1692;"Du gaideliai";MALŪNO;7033276798;Taip;6;1;0;7
1693;"Du gaideliai";MALŪNO;6053941133;Taip;6;0;0;6
1694;"Du gaideliai";MALŪNO;1268479215;Taip;13;0;0;13
1695;"Du gaideliai";MALŪNO;5728374219;Taip;11;1;0;12
1696;"Du gaideliai";MALŪNO;6015360076;Taip;0;9;0;9
1697;"Du gaideliai";MALŪNO;7726490359;Taip;21;0;0;21
1698;"Du gaideliai";MALŪNO;5998344519;Taip;9;0;0;9
1699;"Du gaideliai";MALŪNO;8043896286;Taip;12;0;0;12
1700;"Du gaideliai";MALŪNO;2240947701;Taip;12;0;0;12
1701;"Du gaideliai";MALŪNO;6120647567;Taip;1;11;0;12
1702;"Du gaideliai";MALŪNO;6522707709;Taip;0;1;1;2
1703;"Du gaideliai";MALŪNO;4798503931;Taip;11;0;0;11
1704;"Du gaideliai";MALŪNO;3247101840;Taip;10;0;1;11
1705;Eglutė;RAMUNĖ;58949721375;Taip;0;3;0;3
1706;Eglutė;RAMUNĖ;86332858914;Taip;0;3;0;3
1707;Eglutė;RAMUNĖ;90728032521;Taip;7;1;3;11
1708;Eglutė;RAMUNĖ;71905692638;Taip;0;1;0;1
1709;Eglutė;RAMUNĖ;48107118284;Taip;0;1;0;1
1710;Eglutė;RAMUNĖ;18336619115;Taip;0;1;0;1
1711;Eglutė;RAMUNĖ;99937268711;Taip;0;1;0;1
1712;Eglutė;RAMUNĖ;42898142937;Taip;0;0;1;1
1713;Eglutė;RAMUNĖ;48271429590;Taip;0;8;0;8
1714;Eglutė;RAMUNĖ;60233622647;Taip;0;1;0;1
1715;Eglutė;RAMUNĖ;9492889889;Taip;0;3;0;3
1716;Eglutė;RAMUNĖ;45851193886;Taip;0;1;0;1
1717;Eglutė;RAMUNĖ;54671481514;Taip;0;2;0;2
1718;Eglutė;RAMUNĖ;87045022282;Taip;0;0;7;7
1719;Eglutė;RAMUNĖ;26590185216;Taip;0;2;0;2
1720;Eglutė;RAMUNĖ;60500002903;Taip;8;1;0;9
1721;Eglutė;RAMUNĖ;59228063911;Taip;8;1;0;9
1722;Eglutė;RAMUNĖ;89786711506;Taip;0;1;0;1
1723;Eglutė;RAMUNĖ;12750056416;Taip;6;1;0;7
1724;Eglutė;RAMUNĖ;49380660477;Ne;0;8;0;8
1725;Eglutė;RAMUNĖ;51769852427;Taip;0;0;1;1
1726;Eglutė;RAMUNĖ;65706339440;Taip;0;2;1;3
1727;Eglutė;PELĖDŽIUKAI;72590410220;Taip;0;7;0;7
1728;Eglutė;PELĖDŽIUKAI;97114358697;Taip;3;0;0;3
1729;Eglutė;PELĖDŽIUKAI;1668758645;Taip;0;1;2;3
1730;Eglutė;PELĖDŽIUKAI;5625034056;Taip;0;0;2;2
1731;Eglutė;PELĖDŽIUKAI;46538092543;Taip;7;0;2;9
1732;Eglutė;PELĖDŽIUKAI;2092342476;Taip;15;0;0;15
1733;Eglutė;PELĖDŽIUKAI;70857129908;Taip;0;1;2;3
1734;Eglutė;PELĖDŽIUKAI;77689530230;Taip;0;1;0;1
1735;Eglutė;PELĖDŽIUKAI;584301494;Taip;0;11;1;12
1736;Eglutė;PELĖDŽIUKAI;14576118725;Taip;6;0;1;7
1737;Eglutė;PELĖDŽIUKAI;66053397092;Taip;5;1;14;20
1738;Eglutė;PELĖDŽIUKAI;41303920332;Taip;0;1;10;11
1739;Eglutė;PELĖDŽIUKAI;4857192691;Taip;0;0;5;5
1740;Eglutė;PELĖDŽIUKAI;1909791840;Taip;6;0;1;7
1741;Eglutė;PELĖDŽIUKAI;2045454657;Taip;6;0;1;7
1742;Eglutė;PELĖDŽIUKAI;50552087321;Taip;0;1;1;2
1743;Eglutė;PELĖDŽIUKAI;87481211277;Taip;0;1;8;9
1744;Eglutė;PELĖDŽIUKAI;74449042391;Taip;0;1;1;2
1745;Eglutė;PELĖDŽIUKAI;1553160829;Taip;9;2;0;11
1746;Eglutė;PELĖDŽIUKAI;6248194593;Taip;8;3;0;11
1747;Eglutė;PELĖDŽIUKAI;80113201617;Taip;0;8;0;8
1748;Eglutė;PELĖDŽIUKAI;90430489503;Taip;0;5;0;5
1749;Eglutė;KODĖLČIUKAI;85964105325;Taip;0;1;10;11
1750;Eglutė;KODĖLČIUKAI;6403410879;Taip;0;2;0;2
1751;Eglutė;KODĖLČIUKAI;1939447097;Taip;0;4;0;4
1752;Eglutė;KODĖLČIUKAI;1881111005;Taip;0;4;0;4
1753;Eglutė;KODĖLČIUKAI;1100326735;Taip;8;1;1;10
1754;Eglutė;KODĖLČIUKAI;1398611395;Taip;0;0;4;4
1755;Eglutė;KODĖLČIUKAI;1814357743;Taip;5;0;0;5
1756;Eglutė;KODĖLČIUKAI;1356175751;Taip;0;0;1;1
1757;Eglutė;KODĖLČIUKAI;2147042152;Taip;5;0;5;10
1758;Eglutė;KODĖLČIUKAI;63268716266;Taip;10;0;1;11
1759;Eglutė;KODĖLČIUKAI;1418516444;Taip;0;1;0;1
1760;Eglutė;KODĖLČIUKAI;2112417439;Taip;0;0;3;3
1761;Eglutė;KODĖLČIUKAI;64360778537;Taip;5;1;0;6
1762;Eglutė;KODĖLČIUKAI;1426211949;Taip;4;2;0;6
1763;Eglutė;KODĖLČIUKAI;1120848949;Taip;0;0;2;2
1764;Eglutė;KODĖLČIUKAI;1882915662;Taip;0;1;1;2
1765;Eglutė;KODĖLČIUKAI;1747424609;Taip;6;0;0;6
1766;Eglutė;KODĖLČIUKAI;1485521357;Taip;0;1;1;2
1767;Eglutė;KODĖLČIUKAI;1227167233;Taip;0;0;2;2
1768;Eglutė;KODĖLČIUKAI;1187563631;Taip;4;0;1;5
1769;Eglutė;KODĖLČIUKAI;90878878800;Taip;0;5;0;5
1770;Eglutė;OBUOLIUKAI;7354260503;Taip;0;4;0;4
1771;Eglutė;OBUOLIUKAI;5731355126;Taip;3;0;0;3
1772;Eglutė;OBUOLIUKAI;7629424045;Taip;0;0;2;2
1773;Eglutė;OBUOLIUKAI;9527732584;Taip;0;3;0;3
1774;Eglutė;OBUOLIUKAI;9771473322;Taip;17;0;0;17
1775;Eglutė;OBUOLIUKAI;7307564177;Taip;0;4;2;6
1776;Eglutė;OBUOLIUKAI;3856651647;Taip;16;0;0;16
1777;Eglutė;OBUOLIUKAI;1265463853;Taip;0;0;4;4
1778;Eglutė;OBUOLIUKAI;8364693548;Taip;1;0;3;4
1779;Eglutė;OBUOLIUKAI;8162972897;Taip;8;0;1;9
1780;Eglutė;OBUOLIUKAI;8703243352;Taip;0;0;3;3
1781;Eglutė;OBUOLIUKAI;6891834971;Taip;0;4;0;4
1782;Eglutė;OBUOLIUKAI;1712276393;Ne;4;0;1;5
1783;Eglutė;OBUOLIUKAI;8523618773;Taip;0;0;5;5
1784;Eglutė;OBUOLIUKAI;9554672460;Taip;0;0;8;8
1785;Eglutė;OBUOLIUKAI;1321901982;Taip;0;12;0;12
1786;Eglutė;OBUOLIUKAI;8421062747;Taip;0;11;0;11
1787;Eglutė;OBUOLIUKAI;3775081619;Taip;0;0;1;1
1788;Eglutė;OBUOLIUKAI;9992438336;Taip;10;0;6;16
1789;Eglutė;OBUOLIUKAI;1908835124;Taip;0;11;0;11
1790;Eglutė;OBUOLIUKAI;1436966647;Taip;0;0;1;1
1791;Eglutė;KAŠTONAS;1565149756;Taip;14;0;0;14
1792;Eglutė;KAŠTONAS;92489023262;Taip;8;0;2;10
1793;Eglutė;KAŠTONAS;55334393780;Taip;0;15;0;15
1794;Eglutė;KAŠTONAS;40880035310;Taip;15;0;0;15
1795;Eglutė;KAŠTONAS;82988135134;Taip;4;3;0;7
1796;Eglutė;KAŠTONAS;93427464717;Taip;7;1;0;8
1797;Eglutė;KAŠTONAS;96041043843;Taip;0;11;0;11
1798;Eglutė;KAŠTONAS;37576322876;Taip;0;2;0;2
1799;Eglutė;KAŠTONAS;46002742287;Ne;0;1;4;5
1800;Eglutė;KAŠTONAS;95597529215;Taip;0;5;1;6
1801;Eglutė;KAŠTONAS;3997033;Taip;0;13;0;13
1802;Eglutė;KAŠTONAS;83912035659;Taip;0;8;0;8
1803;Eglutė;KAŠTONAS;44421461989;Taip;0;3;0;3
1804;Eglutė;KAŠTONAS;96140363702;Taip;2;0;0;2
1805;Eglutė;KAŠTONAS;40325923876;Taip;0;1;0;1
1806;Eglutė;KAŠTONAS;91896736509;Taip;5;3;0;8
1807;Eglutė;KAŠTONAS;50471207849;Taip;0;7;0;7
1808;Eglutė;KAŠTONAS;6542189095;Taip;5;4;0;9
1809;Eglutė;KAŠTONAS;75229333120;Ne;0;2;0;2
1810;Eglutė;KAŠTONAS;10122792768;Taip;0;12;0;12
1811;Eglutė;KAŠTONAS;77296894224;Taip;0;0;3;3
1812;Eglutė;KAŠTONAS;2029176205;Taip;13;1;0;14
1813;Eglutė;KAŠTONAS;69979676570;Taip;0;2;1;3
1814;Eglutė;EŽIUKAI;2808806070;Taip;0;1;0;1
1815;Eglutė;EŽIUKAI;15852252535;Taip;0;5;0;5
1816;Eglutė;EŽIUKAI;20502611523;Taip;0;1;0;1
1817;Eglutė;EŽIUKAI;27038409488;Taip;0;4;0;4
1818;Eglutė;EŽIUKAI;58521679969;Ne;0;5;0;5
1819;Eglutė;EŽIUKAI;16522997461;Ne;0;1;1;2
1820;Eglutė;EŽIUKAI;70702928356;Ne;5;3;0;8
1821;Eglutė;EŽIUKAI;95955544121;Ne;4;1;0;5
1822;Eglutė;EŽIUKAI;6066756372;Taip;0;1;0;1
1823;Eglutė;EŽIUKAI;9976231692;Taip;0;1;1;2
1824;Eglutė;EŽIUKAI;33254488808;Ne;0;10;0;10
1825;Eglutė;EŽIUKAI;11010335171;Taip;0;1;0;1
1826;Eglutė;EŽIUKAI;93769554398;Taip;0;2;0;2
1827;Eglutė;EŽIUKAI;619528177;Taip;0;7;0;7
1828;Eglutė;EŽIUKAI;39537089288;Taip;0;1;0;1
1829;Eglutė;EŽIUKAI;84721839602;Taip;10;0;0;10
1830;Eglutė;EŽIUKAI;9318501404;Taip;0;4;0;4
1831;Eglutė;EŽIUKAI;6570561861;Taip;0;1;0;1
1832;Eglutė;EŽIUKAI;8213137021;Taip;0;1;0;1
1833;Eglutė;EŽIUKAI;87191303145;Taip;0;2;0;2
1834;Eglutė;EŽIUKAI;3642438432;Taip;0;6;3;9
1835;Eglutė;GILĖ;1308252968;Taip;5;0;0;5
1836;Eglutė;GILĖ;2053316445;Taip;0;0;4;4
1837;Eglutė;GILĖ;1954232966;Taip;2;0;0;2
1838;Eglutė;GILĖ;70203658097;Ne;0;1;20;21
1839;Eglutė;GILĖ;62257831469;Taip;0;2;1;3
1840;Eglutė;GILĖ;18202528233;Taip;0;0;14;14
1841;Eglutė;GILĖ;9375046883;Taip;2;0;0;2
1842;Eglutė;GILĖ;60257242941;Taip;0;0;9;9
1843;Eglutė;GILĖ;1125331552;Ne;0;0;3;3
1844;Eglutė;GILĖ;75731523422;Taip;0;0;1;1
1845;Eglutė;GILĖ;82910530417;Taip;0;4;0;4
1846;Eglutė;GILĖ;7035023835;Ne;0;1;1;2
1847;Eglutė;GILĖ;51884188642;Taip;0;0;3;3
1848;Eglutė;GILĖ;67038463806;Taip;0;1;1;2
1849;Eglutė;GILĖ;61256135116;Taip;1;1;0;2
1850;Eglutė;GILĖ;2138306323;Taip;0;0;3;3
1851;Eglutė;GILĖ;32102678081;Taip;0;0;3;3
1852;Eglutė;GILĖ;65593915933;Ne;5;1;0;6
1853;Eglutė;GILĖ;15019818974;Taip;0;8;0;8
1854;Eglutė;GILĖ;9169758481;Taip;0;0;11;11
1855;Eglutė;GILĖ;92526575353;Taip;0;0;3;3
1856;Eglutė;GILĖ;24785196945;Taip;11;0;1;12
1857;Eglutė;GILĖ;95274378693;Taip;0;0;1;1
1858;Eglutė;GILĖ;64518610112;Taip;0;1;0;1
1859;Eglutė;GILĖ;3725462135;Taip;0;4;0;4
1860;Eglutė;GILĖ;6323002362;Taip;2;0;2;4
1861;Eglutė;GILĖ;26716650724;Taip;0;8;0;8
1862;Eglutė;SAULUTĖ;9369442479;Taip;0;0;1;1
1863;Eglutė;SAULUTĖ;72153018644;Taip;0;10;0;10
1864;Eglutė;SAULUTĖ;27441180688;Taip;0;2;0;2
1865;Eglutė;SAULUTĖ;2395506996;Ne;1;0;2;3
1866;Eglutė;SAULUTĖ;37487292437;Taip;0;1;0;1
1867;Eglutė;SAULUTĖ;1935089263;Taip;1;0;1;2
1868;Eglutė;SAULUTĖ;1555843610;Taip;6;0;0;6
1869;Eglutė;SAULUTĖ;1864153865;Taip;6;0;3;9
1870;Eglutė;SAULUTĖ;2547404429;Taip;0;1;0;1
1871;Eglutė;SAULUTĖ;49268076669;Taip;0;0;1;1
1872;Eglutė;SAULUTĖ;65985749472;Taip;0;0;1;1
1873;Eglutė;SAULUTĖ;20582720349;Taip;0;11;3;14
1874;Eglutė;SAULUTĖ;7744905325;Taip;21;0;0;21
1875;Eglutė;SAULUTĖ;1533889475;Taip;0;1;0;1
1876;Eglutė;SAULUTĖ;1306820123;Taip;4;0;1;5
1877;Eglutė;SAULUTĖ;2109443590;Taip;0;0;1;1
1878;Eglutė;SAULUTĖ;1272418234;Taip;1;0;5;6
1879;Eglutė;SAULUTĖ;1753853153;Taip;11;0;0;11
1880;Eglutė;SAULUTĖ;1180482309;Taip;0;0;5;5
1881;Eglutė;SAULUTĖ;4248739383;Taip;0;4;0;4
1882;Eglutė;SAULUTĖ;2087083722;Taip;10;0;0;10
1883;Eglutė;SAULUTĖ;1859052313;Taip;0;1;2;3
1884;Eglutė;ŠARKELĖ;2082716398;Taip;4;0;2;6
1885;Eglutė;ŠARKELĖ;1324622835;Taip;21;0;0;21
1886;Eglutė;ŠARKELĖ;9173875647;Taip;11;0;5;16
1887;Eglutė;ŠARKELĖ;6518497374;Taip;17;0;1;18
1888;Eglutė;ŠARKELĖ;1209962222;Taip;6;0;0;6
1889;Eglutė;ŠARKELĖ;3203786388;Taip;0;0;7;7
1890;Eglutė;ŠARKELĖ;8033370429;Taip;9;0;0;9
1891;Eglutė;ŠARKELĖ;3616979217;Taip;0;15;3;18
1892;Eglutė;ŠARKELĖ;7148210944;Ne;0;12;0;12
1893;Eglutė;ŠARKELĖ;9066178904;Taip;0;12;0;12
1894;Eglutė;ŠARKELĖ;9488150450;Taip;15;1;0;16
1895;Eglutė;ŠARKELĖ;3393414294;Taip;0;5;0;5
1896;Eglutė;ŠARKELĖ;7823828202;Taip;1;0;6;7
1897;Eglutė;ŠARKELĖ;3178489517;Taip;0;0;5;5
1898;Eglutė;ŠARKELĖ;1004866224;Taip;12;0;0;12
1899;Eglutė;ŠARKELĖ;2638807860;Taip;6;0;0;6
1900;Eglutė;ŠARKELĖ;6835296034;Taip;0;1;0;1
1901;Eglutė;ŠARKELĖ;9950953029;Taip;15;0;0;15
1902;Eglutė;NYKŠTUKAI;5943856319;Taip;0;0;6;6
1903;Eglutė;NYKŠTUKAI;9402686801;Taip;0;21;0;21
1904;Eglutė;NYKŠTUKAI;2783338563;Taip;0;1;1;2
1905;Eglutė;NYKŠTUKAI;6544877723;Taip;0;12;0;12
1906;Eglutė;NYKŠTUKAI;1050313582;Taip;6;0;0;6
1907;Eglutė;NYKŠTUKAI;1534556744;Taip;5;0;1;6
1908;Eglutė;NYKŠTUKAI;6093932811;Taip;14;1;0;15
1909;Eglutė;NYKŠTUKAI;4489150480;Taip;0;0;7;7
1910;Eglutė;NYKŠTUKAI;3006381069;Taip;0;0;1;1
1911;Eglutė;NYKŠTUKAI;5563593953;Taip;0;0;1;1
1912;Eglutė;NYKŠTUKAI;2597978713;Taip;10;0;4;14
1913;Eglutė;NYKŠTUKAI;6105927493;Taip;9;0;0;9
1914;Eglutė;NYKŠTUKAI;4230594049;Taip;4;12;0;16
1915;Eglutė;NYKŠTUKAI;5505398901;Taip;0;0;18;18
1916;Eglutė;NYKŠTUKAI;2651867769;Taip;5;0;1;6
1917;Eglutė;NYKŠTUKAI;8493750509;Taip;0;0;4;4
1918;Eglutė;NYKŠTUKAI;7491022301;Taip;0;4;1;5
1919;Eglutė;NYKŠTUKAI;3985929379;Taip;15;0;0;15
1920;Eglutė;NYKŠTUKAI;3483007385;Taip;0;0;12;12
1921;Eglutė;ŽIRNIUKAI;3390360525;Taip;7;1;0;8
1922;Eglutė;ŽIRNIUKAI;1759383841;Taip;0;2;0;2
1923;Eglutė;ŽIRNIUKAI;4348313801;Taip;11;0;0;11
1924;Eglutė;ŽIRNIUKAI;9967488317;Taip;0;5;0;5
1925;Eglutė;ŽIRNIUKAI;7758643349;Taip;11;6;0;17
1926;Eglutė;ŽIRNIUKAI;5924994736;Taip;0;18;1;19
1927;Eglutė;ŽIRNIUKAI;3883122650;Taip;11;0;0;11
1928;Eglutė;ŽIRNIUKAI;1550045866;Taip;9;6;1;16
1929;Eglutė;ŽIRNIUKAI;3605053253;Taip;10;1;9;20
1930;Eglutė;ŽIRNIUKAI;7404631298;Taip;16;0;5;21
1931;Eglutė;ŽIRNIUKAI;7446423510;Taip;19;0;0;19
1932;Eglutė;ŽIRNIUKAI;6362265057;Taip;10;1;0;11
1933;Eglutė;ŽIRNIUKAI;1842517164;Taip;2;0;17;19
1934;Eglutė;ŽIRNIUKAI;2240154775;Taip;0;2;3;5
1935;Eglutė;ŽIRNIUKAI;7047262367;Taip;8;4;0;12
1936;Eglutė;ŽIRNIUKAI;4176597208;Taip;10;0;0;10
1937;Eglutė;ŽIRNIUKAI;3584247594;Taip;0;16;0;16
1938;Eglutė;ŽIRNIUKAI;8797889347;Taip;8;0;0;8
1939;Eglutė;ŽIRNIUKAI;1835565594;Taip;10;0;6;16
1940;Eglutė;ŽIRNIUKAI;9728550000;Taip;1;0;0;1
1941;Eglutė;BORUŽIUKAI;9439309687;Taip;0;0;5;5
1942;Eglutė;BORUŽIUKAI;8943684351;Taip;1;0;1;2
1943;Eglutė;BORUŽIUKAI;6597261061;Taip;0;2;0;2
1944;Eglutė;BORUŽIUKAI;1932785408;Taip;4;0;0;4
1945;Eglutė;BORUŽIUKAI;4490295754;Taip;0;0;3;3
1946;Eglutė;BORUŽIUKAI;6328900251;Taip;6;2;0;8
1947;Eglutė;BORUŽIUKAI;7859815752;Taip;12;1;1;14
1948;Eglutė;BORUŽIUKAI;1422631723;Taip;0;15;0;15
1949;Eglutė;BORUŽIUKAI;1531942494;Taip;0;5;2;7
1950;Eglutė;BORUŽIUKAI;9661883776;Taip;16;5;0;21
1951;Eglutė;BORUŽIUKAI;8165126017;Taip;0;0;7;7
1952;Eglutė;BORUŽIUKAI;4451772812;Taip;3;0;2;5
1953;Eglutė;BORUŽIUKAI;8933416279;Taip;11;5;0;16
1954;Eglutė;BORUŽIUKAI;9046652370;Taip;0;0;19;19
1955;Aušrinė;Varpeliai;40427909744;Taip;0;8;0;8
1956;Aušrinė;Varpeliai;73663919787;Taip;0;2;0;2
1957;Aušrinė;Varpeliai;1182643102;Taip;6;0;4;10
1958;Aušrinė;Varpeliai;2030227606;Taip;8;1;0;9
1959;Aušrinė;Varpeliai;51725342242;Ne;0;0;1;1
1960;Aušrinė;Varpeliai;1448250372;Taip;10;1;0;11
1961;Aušrinė;Varpeliai;68192824475;Taip;4;0;2;6
1962;Aušrinė;Varpeliai;69919525470;Taip;2;7;0;9
1963;Aušrinė;Varpeliai;11187944085;Taip;3;0;0;3
1964;Aušrinė;Varpeliai;1988534889;Taip;5;0;0;5
1965;Aušrinė;Varpeliai;1278319590;Taip;11;0;0;11
1966;Aušrinė;Varpeliai;3356127625;Taip;11;0;0;11
1967;Aušrinė;Varpeliai;1148796296;Taip;0;9;0;9
1968;Aušrinė;Varpeliai;1927141701;Taip;6;0;1;7
1969;Aušrinė;Varpeliai;1515536619;Taip;5;1;0;6
1970;Aušrinė;Varpeliai;1996032555;Taip;1;0;6;7
1971;Aušrinė;Varpeliai;9989277772;Taip;9;0;1;10
1972;Aušrinė;Varpeliai;1000417905;Taip;7;3;0;10
1973;Aušrinė;Bitutės;58768831540;Taip;0;7;0;7
1974;Aušrinė;Bitutės;1303589037;Ne;6;3;0;9
1975;Aušrinė;Bitutės;10370673775;Taip;6;0;0;6
1976;Aušrinė;Bitutės;1601648171;Taip;7;0;2;9
1977;Aušrinė;Bitutės;17061806895;Taip;12;0;1;13
1978;Aušrinė;Bitutės;6443602669;Taip;2;0;0;2
1979;Aušrinė;Bitutės;7796318812;Taip;0;5;0;5
1980;Aušrinė;Bitutės;6318538591;Taip;15;0;0;15
1981;Aušrinė;Bitutės;9605160359;Taip;6;0;4;10
1982;Aušrinė;Bitutės;5090847702;Taip;11;0;0;11
1983;Aušrinė;Bitutės;1399518471;Taip;2;0;0;2
1984;Aušrinė;Bitutės;25590576293;Taip;0;9;0;9
1985;Aušrinė;Bitutės;7507448059;Taip;9;5;0;14
1986;Aušrinė;Bitutės;1291308838;Taip;0;5;0;5
1987;Aušrinė;Bitutės;63299644698;Taip;6;2;0;8
1988;Aušrinė;Bitutės;2526585854;Taip;0;0;1;1
1989;Aušrinė;Drugeliai;2043278242;Taip;1;0;2;3
1990;Aušrinė;Drugeliai;32489318287;Taip;3;0;0;3
1991;Aušrinė;Drugeliai;1343667707;Taip;0;2;0;2
1992;Aušrinė;Drugeliai;96010737590;Taip;0;8;0;8
1993;Aušrinė;Drugeliai;1133359254;Taip;2;8;0;10
1994;Aušrinė;Drugeliai;30244366906;Taip;0;1;0;1
1995;Aušrinė;Drugeliai;1974161463;Taip;6;4;0;10
1996;Aušrinė;Drugeliai;1184543607;Taip;5;0;0;5
1997;Aušrinė;Drugeliai;1573790467;Taip;15;1;0;16
1998;Aušrinė;Drugeliai;1944291082;Taip;0;0;1;1
1999;Aušrinė;Drugeliai;48118825872;Taip;6;0;1;7
2000;Aušrinė;Drugeliai;2069277030;Taip;0;1;1;2
2001;Aušrinė;Drugeliai;1065470806;Taip;7;0;0;7
2002;Aušrinė;Drugeliai;1206863546;Taip;8;0;1;9
2003;Aušrinė;Drugeliai;2022412040;Taip;6;0;0;6
2004;Aušrinė;Drugeliai;1501614270;Taip;5;0;0;5
2005;Aušrinė;Drugeliai;6265909152;Taip;13;0;1;14
2006;Aušrinė;Drugeliai;1532235421;Taip;5;0;0;5
2007;Aušrinė;Drugeliai;2212814026;Taip;21;0;0;21
2008;Aušrinė;Boružėlės;7052024709;Taip;5;0;1;6
2009;Aušrinė;Boružėlės;8364033602;Taip;18;0;0;18
2010;Aušrinė;Boružėlės;1151612627;Taip;0;1;0;1
2011;Aušrinė;Boružėlės;1009453682;Taip;9;2;0;11
2012;Aušrinė;Boružėlės;3544848804;Taip;6;0;3;9
2013;Aušrinė;Boružėlės;6136579994;Taip;11;0;1;12
2014;Aušrinė;Boružėlės;8463758715;Taip;5;2;0;7
2015;Aušrinė;Boružėlės;4579700769;Taip;0;1;0;1
2016;Aušrinė;Boružėlės;7268811782;Taip;11;2;0;13
2017;Aušrinė;Boružėlės;3042409414;Taip;7;0;1;8
2018;Aušrinė;Boružėlės;1831094707;Taip;0;2;0;2
2019;Aušrinė;Boružėlės;3593323270;Taip;9;1;0;10
2020;Aušrinė;Boružėlės;3795927209;Taip;5;1;1;7
2021;Aušrinė;Boružėlės;5283207520;Taip;0;0;2;2
2022;Aušrinė;Boružėlės;1116822936;Taip;0;0;1;1
2023;Aušrinė;Boružėlės;6226967695;Taip;20;0;0;20
2024;Aušrinė;Boružėlės;9226214856;Taip;15;0;0;15
2025;Aušrinė;Boružėlės;4562536818;Taip;4;0;0;4
2026;Aušrinė;Zuikučiai;5776170550;Taip;10;0;1;11
2027;Aušrinė;Zuikučiai;9641020899;Taip;6;1;0;7
2028;Aušrinė;Zuikučiai;5277217733;Taip;17;0;1;18
2029;Aušrinė;Zuikučiai;6375484280;Taip;11;0;0;11
2030;Aušrinė;Zuikučiai;1502013942;Taip;14;2;0;16
2031;Aušrinė;Zuikučiai;2190583964;Taip;7;0;1;8
2032;Aušrinė;Zuikučiai;3920229653;Taip;17;0;0;17
2033;Aušrinė;Zuikučiai;5563356449;Taip;6;0;0;6
2034;Aušrinė;Zuikučiai;9501262918;Taip;0;0;1;1
2035;Aušrinė;Zuikučiai;8756465854;Taip;0;7;2;9
2036;Aušrinė;Zuikučiai;6756184787;Taip;8;1;0;9
2037;Aušrinė;Zuikučiai;4288487063;Taip;11;0;0;11
2038;Aušrinė;Zuikučiai;5768470608;Taip;1;0;1;2
2039;Aušrinė;Zuikučiai;7194803557;Taip;5;1;2;8
2040;Aušrinė;Zuikučiai;2309358870;Taip;11;0;2;13
2041;Aušrinė;Zuikučiai;2304972692;Taip;17;0;0;17
2042;Aušrinė;Meškiukai;5204445760;Taip;0;7;0;7
2043;Aušrinė;Meškiukai;3269357241;Taip;10;0;0;10
2044;Aušrinė;Meškiukai;2583331243;Taip;12;0;1;13
2045;Aušrinė;Meškiukai;2948716989;Taip;10;2;0;12
2046;Aušrinė;Meškiukai;3346154143;Taip;0;1;0;1
2047;Aušrinė;Meškiukai;2778931038;Taip;10;4;5;19
2048;Aušrinė;Meškiukai;8092890260;Taip;0;1;0;1
2049;Aušrinė;Meškiukai;8465864375;Taip;17;0;2;19
2050;Aušrinė;Meškiukai;7089883250;Taip;0;2;0;2
2051;Aušrinė;Meškiukai;6525761466;Taip;17;0;1;18
2052;Aušrinė;Meškiukai;3998988004;Taip;0;21;0;21
2053;Aušrinė;Meškiukai;7358925256;Taip;9;1;0;10
2054;Aušrinė;Meškiukai;5128863532;Taip;9;0;1;10
2055;"Geniukų kalvė";SAULUTĖS;97391898211;Ne;0;0;2;2
2056;"Geniukų kalvė";SAULUTĖS;50484102538;Taip;0;5;0;5
2057;"Geniukų kalvė";SAULUTĖS;22439864337;Taip;0;1;0;1
2058;"Geniukų kalvė";SAULUTĖS;71971614175;Taip;13;1;0;14
2059;"Geniukų kalvė";SAULUTĖS;19739642721;Taip;0;2;0;2
2060;"Geniukų kalvė";SAULUTĖS;87723170266;Taip;0;4;0;4
2061;"Geniukų kalvė";SAULUTĖS;88770807216;Taip;0;4;0;4
2062;"Geniukų kalvė";SAULUTĖS;22867530415;Ne;0;2;0;2
2063;"Geniukų kalvė";SAULUTĖS;80569810851;Taip;0;6;0;6
2064;"Geniukų kalvė";SAULUTĖS;68771652481;Taip;0;5;0;5
2065;"Geniukų kalvė";SAULUTĖS;88828238496;Taip;0;7;0;7
2066;"Geniukų kalvė";SAULUTĖS;50839305875;Taip;0;3;0;3
2067;"Geniukų kalvė";SAULUTĖS;66371314129;Taip;0;2;0;2
2068;"Geniukų kalvė";SAULUTĖS;54754447084;Taip;0;11;0;11
2069;"Geniukų kalvė";SAULUTĖS;35212920132;Taip;0;3;0;3
2070;"Geniukų kalvė";SAULUTĖS;95119267553;Taip;0;7;0;7
2071;"Geniukų kalvė";SAULUTĖS;75895159280;Taip;0;0;1;1
2072;"Geniukų kalvė";SAULUTĖS;89508036774;Taip;0;1;2;3
2073;"Geniukų kalvė";BITUTĖS;7745656622;Taip;0;1;0;1
2074;"Geniukų kalvė";BITUTĖS;6466912385;Taip;0;5;0;5
2075;"Geniukų kalvė";BITUTĖS;2718961466;Taip;0;1;0;1
2076;"Geniukų kalvė";BITUTĖS;4967513360;Taip;1;2;0;3
2077;"Geniukų kalvė";BITUTĖS;2016254460;Taip;0;5;0;5
2078;"Geniukų kalvė";BITUTĖS;1897809684;Taip;0;1;1;2
2079;"Geniukų kalvė";BITUTĖS;4105170344;Taip;0;10;0;10
2080;"Geniukų kalvė";BITUTĖS;6511955882;Taip;1;2;0;3
2081;"Geniukų kalvė";BITUTĖS;6500641378;Taip;0;8;0;8
2082;"Geniukų kalvė";BITUTĖS;7081093742;Taip;0;1;3;4
2083;"Geniukų kalvė";BITUTĖS;3984265624;Taip;6;0;1;7
2084;"Geniukų kalvė";BITUTĖS;4813232640;Taip;4;0;0;4
2085;"Geniukų kalvė";BITUTĖS;9676782662;Taip;2;1;0;3
2086;"Geniukų kalvė";BITUTĖS;4647433927;Taip;15;0;6;21
2087;"Geniukų kalvė";BITUTĖS;5257713434;Taip;15;0;6;21
2088;"Geniukų kalvė";BITUTĖS;9666918437;Taip;0;2;0;2
2089;"Geniukų kalvė";BITUTĖS;2031800114;Taip;0;2;0;2
2090;"Geniukų kalvė";KIŠKUČIAI;1568133009;Taip;16;1;0;17
2091;"Geniukų kalvė";KIŠKUČIAI;4758435835;Taip;0;0;3;3
2092;"Geniukų kalvė";KIŠKUČIAI;4661051023;Taip;0;0;5;5
2093;"Geniukų kalvė";KIŠKUČIAI;23023070502;Taip;2;0;4;6
2094;"Geniukų kalvė";KIŠKUČIAI;8668696743;Ne;1;0;3;4
2095;"Geniukų kalvė";KIŠKUČIAI;2262014110;Taip;5;0;0;5
2096;"Geniukų kalvė";KIŠKUČIAI;43097490633;Taip;0;0;1;1
2097;"Geniukų kalvė";KIŠKUČIAI;2043786151;Taip;6;2;0;8
2098;"Geniukų kalvė";KIŠKUČIAI;1460456166;Taip;3;5;0;8
2099;"Geniukų kalvė";KIŠKUČIAI;8939171238;Taip;8;0;1;9
2100;"Geniukų kalvė";KIŠKUČIAI;7839383630;Taip;11;0;0;11
2101;"Geniukų kalvė";KIŠKUČIAI;2140334255;Taip;12;0;0;12
2102;"Geniukų kalvė";KIŠKUČIAI;2301758912;Taip;5;0;1;6
2103;"Geniukų kalvė";KIŠKUČIAI;8635708009;Taip;21;0;0;21
2104;"Geniukų kalvė";KIŠKUČIAI;9081596975;Taip;1;0;0;1
2105;"Geniukų kalvė";KIŠKUČIAI;30932565379;Taip;10;2;0;12
2106;"Geniukų kalvė";VYTURĖLIAI;91633670390;Taip;0;1;0;1
2107;"Geniukų kalvė";VYTURĖLIAI;27433933081;Taip;0;4;0;4
2108;"Geniukų kalvė";VYTURĖLIAI;83612705234;Taip;0;1;0;1
2109;"Geniukų kalvė";VYTURĖLIAI;92967424590;Taip;0;8;0;8
2110;"Geniukų kalvė";VYTURĖLIAI;91532192571;Taip;0;1;0;1
2111;"Geniukų kalvė";VYTURĖLIAI;60793380826;Taip;0;1;1;2
2112;"Geniukų kalvė";VYTURĖLIAI;71553800692;Taip;0;2;0;2
2113;"Geniukų kalvė";VYTURĖLIAI;24599003355;Ne;0;1;0;1
2114;"Geniukų kalvė";VYTURĖLIAI;32731577118;Taip;0;1;0;1
2115;"Geniukų kalvė";VYTURĖLIAI;2088336409;Taip;11;0;0;11
2116;"Geniukų kalvė";VYTURĖLIAI;1648595304;Taip;8;1;2;11
2117;"Geniukų kalvė";VYTURĖLIAI;21213070417;Ne;0;1;0;1
2118;"Geniukų kalvė";VYTURĖLIAI;28229850220;Taip;0;1;0;1
2119;"Geniukų kalvė";VYTURĖLIAI;92776604959;Taip;0;1;0;1
2120;"Geniukų kalvė";VYTURĖLIAI;77639318512;Taip;1;0;0;1
2121;"Geniukų kalvė";VYTURĖLIAI;1131917679;Taip;0;4;0;4
2122;"Geniukų kalvė";DRUGELIAI;1974481974;Taip;0;0;1;1
2123;"Geniukų kalvė";DRUGELIAI;46050191161;Taip;1;1;0;2
2124;"Geniukų kalvė";DRUGELIAI;11531299319;Taip;0;2;0;2
2125;"Geniukų kalvė";DRUGELIAI;37570191268;Taip;0;1;1;2
2126;"Geniukų kalvė";DRUGELIAI;80173832943;Ne;0;8;1;9
2127;"Geniukų kalvė";DRUGELIAI;21387794128;Taip;0;4;1;5
2128;"Geniukų kalvė";DRUGELIAI;72591209415;Taip;4;2;0;6
2129;"Geniukų kalvė";DRUGELIAI;89253663707;Taip;0;4;0;4
2130;"Geniukų kalvė";DRUGELIAI;56872543521;Taip;0;0;2;2
2131;"Geniukų kalvė";DRUGELIAI;90336374948;Taip;0;1;6;7
2132;"Geniukų kalvė";DRUGELIAI;23422495596;Taip;15;1;0;16
2133;"Geniukų kalvė";DRUGELIAI;20968739747;Taip;6;2;3;11
2134;"Geniukų kalvė";DRUGELIAI;64035235105;Ne;0;1;0;1
2135;"Geniukų kalvė";DRUGELIAI;59483867231;Taip;10;0;1;11
2136;"Geniukų kalvė";DRUGELIAI;1395993314;Taip;0;10;0;10
2137;"Geniukų kalvė";DRUGELIAI;1318135788;Taip;0;1;3;4
2138;"Geniukų kalvė";DRUGELIAI;6553877473;Taip;12;0;0;12
2139;"Geniukų kalvė";"SAULĖS ZUIKUČIAI";49352255237;Taip;0;2;0;2
2140;"Geniukų kalvė";"SAULĖS ZUIKUČIAI";90227736128;Taip;0;8;0;8
2141;"Geniukų kalvė";"SAULĖS ZUIKUČIAI";54856843273;Taip;3;1;0;4
2142;"Geniukų kalvė";"SAULĖS ZUIKUČIAI";1806626063;Taip;0;6;0;6
2143;"Geniukų kalvė";"SAULĖS ZUIKUČIAI";88504194684;Taip;0;0;4;4
2144;"Geniukų kalvė";"SAULĖS ZUIKUČIAI";1776042329;Taip;0;0;4;4
2145;"Geniukų kalvė";"SAULĖS ZUIKUČIAI";1716204178;Taip;1;11;1;13
2146;"Geniukų kalvė";"SAULĖS ZUIKUČIAI";2120890722;Taip;0;9;0;9
2147;"Geniukų kalvė";"SAULĖS ZUIKUČIAI";1415719190;Taip;0;0;6;6
2148;"Geniukų kalvė";"SAULĖS ZUIKUČIAI";83443339743;Taip;0;0;1;1
2149;"Geniukų kalvė";"SAULĖS ZUIKUČIAI";26215340428;Taip;0;0;2;2
2150;"Geniukų kalvė";"SAULĖS ZUIKUČIAI";1084055203;Taip;0;0;8;8
2151;"Geniukų kalvė";"SAULĖS ZUIKUČIAI";75791398203;Taip;5;0;0;5
2152;"Geniukų kalvė";"SAULĖS ZUIKUČIAI";1810973279;Taip;0;1;0;1
2153;"Geniukų kalvė";"SAULĖS ZUIKUČIAI";2094764804;Taip;0;0;1;1
2154;"Geniukų kalvė";"SAULĖS ZUIKUČIAI";3553253934;Taip;0;7;0;7
2155;"Geniukų kalvė";"SAULĖS ZUIKUČIAI";2056340856;Ne;2;0;0;2
2156;"Geniukų kalvė";"SAULĖS ZUIKUČIAI";9669281441;Taip;1;1;1;3
2157;"Geniukų kalvė";SMALSUČIAI;1684481833;Taip;4;0;0;4
2158;"Geniukų kalvė";SMALSUČIAI;14939415217;Taip;5;0;0;5
2159;"Geniukų kalvė";SMALSUČIAI;1990303616;Taip;0;6;0;6
2160;"Geniukų kalvė";SMALSUČIAI;62774512989;Taip;21;0;0;21
2161;"Geniukų kalvė";SMALSUČIAI;45542289762;Taip;0;0;1;1
2162;"Geniukų kalvė";SMALSUČIAI;23964009189;Taip;0;2;0;2
2163;"Geniukų kalvė";SMALSUČIAI;42328019754;Taip;0;1;0;1
2164;"Geniukų kalvė";SMALSUČIAI;84974376966;Taip;0;1;0;1
2165;"Geniukų kalvė";SMALSUČIAI;1031455575;Taip;0;1;0;1
2166;"Geniukų kalvė";SMALSUČIAI;67762121244;Ne;0;3;0;3
2167;"Geniukų kalvė";SMALSUČIAI;1663744490;Taip;0;2;0;2
2168;"Geniukų kalvė";SMALSUČIAI;2003986836;Taip;0;3;0;3
2169;"Geniukų kalvė";SMALSUČIAI;1248190435;Taip;0;2;0;2
2170;"Geniukų kalvė";SMALSUČIAI;5792552722;Taip;3;0;0;3
2171;"Geniukų kalvė";SMALSUČIAI;6253940549;Taip;0;1;0;1
2172;"Geniukų kalvė";RUDNOSIUKAI;2082749897;Taip;0;10;0;10
2173;"Geniukų kalvė";RUDNOSIUKAI;7352976665;Taip;6;1;0;7
2174;"Geniukų kalvė";RUDNOSIUKAI;6728268857;Taip;1;2;0;3
2175;"Geniukų kalvė";RUDNOSIUKAI;93360165202;Taip;7;0;0;7
2176;"Geniukų kalvė";RUDNOSIUKAI;36553641202;Taip;0;1;0;1
2177;"Geniukų kalvė";RUDNOSIUKAI;36295276899;Taip;0;2;0;2
2178;"Geniukų kalvė";RUDNOSIUKAI;16810843163;Taip;0;1;10;11
2179;"Geniukų kalvė";RUDNOSIUKAI;56705168000;Taip;0;0;1;1
2180;"Geniukų kalvė";RUDNOSIUKAI;75926614045;Taip;0;2;2;4
2181;"Geniukų kalvė";RUDNOSIUKAI;42849805342;Taip;0;0;4;4
2182;"Geniukų kalvė";RUDNOSIUKAI;51320722945;Ne;0;0;1;1
2183;"Geniukų kalvė";RUDNOSIUKAI;96448080708;Taip;0;2;1;3
2184;"Geniukų kalvė";RUDNOSIUKAI;1727967870;Taip;0;1;0;1
2185;"Geniukų kalvė";RUDNOSIUKAI;1794537433;Taip;0;0;1;1
2186;"Geniukų kalvė";RUDNOSIUKAI;29353737550;Taip;0;2;2;4
2187;"Geniukų kalvė";RUDNOSIUKAI;6928979691;Taip;0;1;4;5
2188;"Geniukų kalvė";RUDNOSIUKAI;73331235731;Taip;0;0;4;4
2189;"Geniukų kalvė";RUDNOSIUKAI;7269049874;Taip;0;5;4;9
2190;"Geniukų kalvė";PELĖDŽIUKAI;1933003833;Taip;0;0;2;2
2191;"Geniukų kalvė";PELĖDŽIUKAI;1829858221;Taip;9;0;0;9
2192;"Geniukų kalvė";PELĖDŽIUKAI;1624933726;Taip;9;0;1;10
2193;"Geniukų kalvė";PELĖDŽIUKAI;3599151643;Taip;15;0;0;15
2194;"Geniukų kalvė";PELĖDŽIUKAI;37670000746;Taip;0;4;3;7
2195;"Geniukų kalvė";PELĖDŽIUKAI;14839311346;Taip;19;0;0;19
2196;"Geniukų kalvė";PELĖDŽIUKAI;31140342871;Taip;16;0;0;16
2197;"Geniukų kalvė";PELĖDŽIUKAI;70097449722;Taip;0;6;0;6
2198;"Geniukų kalvė";PELĖDŽIUKAI;11476134327;Taip;6;0;0;6
2199;"Geniukų kalvė";PELĖDŽIUKAI;53385228310;Ne;0;6;0;6
2200;"Geniukų kalvė";PELĖDŽIUKAI;68752448767;Taip;1;0;1;2
2201;"Geniukų kalvė";PELĖDŽIUKAI;57595197116;Taip;1;3;0;4
2202;"Geniukų kalvė";PELĖDŽIUKAI;61225085978;Taip;0;7;0;7
2203;"Geniukų kalvė";PELĖDŽIUKAI;87751274075;Taip;5;0;3;8
2204;"Geniukų kalvė";PELĖDŽIUKAI;71884588832;Taip;6;0;0;6
2205;"Geniukų kalvė";PELĖDŽIUKAI;96267794763;Taip;0;0;3;3
2206;"Geniukų kalvė";PELĖDŽIUKAI;1658082075;Taip;0;5;3;8
2207;"Geniukų kalvė";PELĖDŽIUKAI;1239061261;Taip;8;3;0;11
2208;"Geniukų kalvė";BORUŽĖLĖS;1246234700;Taip;21;0;0;21
2209;"Geniukų kalvė";BORUŽĖLĖS;52431368754;Taip;2;0;0;2
2210;"Geniukų kalvė";BORUŽĖLĖS;30865528880;Taip;10;0;0;10
2211;"Geniukų kalvė";BORUŽĖLĖS;66632618838;Taip;0;2;0;2
2212;"Geniukų kalvė";BORUŽĖLĖS;35180545728;Taip;0;2;0;2
2213;"Geniukų kalvė";BORUŽĖLĖS;88543141650;Taip;0;2;0;2
2214;"Geniukų kalvė";BORUŽĖLĖS;96954076142;Taip;4;3;0;7
2215;"Geniukų kalvė";BORUŽĖLĖS;27479616927;Taip;16;0;0;16
2216;"Geniukų kalvė";BORUŽĖLĖS;30015301622;Taip;5;0;4;9
2217;"Geniukų kalvė";BORUŽĖLĖS;26912425905;Taip;0;0;2;2
2218;"Geniukų kalvė";BORUŽĖLĖS;38949678625;Taip;0;2;0;2
2219;"Geniukų kalvė";BORUŽĖLĖS;80957343774;Taip;0;1;2;3
2220;"Geniukų kalvė";BORUŽĖLĖS;99051569551;Taip;0;0;2;2
2221;"Geniukų kalvė";BORUŽĖLĖS;50218457812;Taip;20;0;0;20
2222;"Geniukų kalvė";BORUŽĖLĖS;7837682774;Taip;6;0;0;6
2223;"Geniukų kalvė";BORUŽĖLĖS;2038860438;Taip;10;11;0;21
2224;"Geniukų kalvė";BORUŽĖLĖS;74161080879;Taip;0;0;1;1
2225;"Geniukų kalvė";BORUŽĖLĖS;93542861144;Taip;6;0;2;8
2226;"Geniukų kalvė";BORUŽĖLĖS;1923449545;Taip;0;5;2;7
2227;"Geniukų kalvė";BORUŽĖLĖS;1073117547;Taip;0;0;8;8
2228;"Geniukų kalvė";PAGRANDUKAI;2938446054;Taip;9;1;0;10
2229;"Geniukų kalvė";PAGRANDUKAI;1237228692;Taip;15;0;0;15
2230;"Geniukų kalvė";PAGRANDUKAI;6737863183;Taip;0;10;0;10
2231;"Geniukų kalvė";PAGRANDUKAI;9990243525;Taip;2;0;1;3
2232;"Geniukų kalvė";PAGRANDUKAI;6174114461;Taip;13;0;0;13
2233;"Geniukų kalvė";PAGRANDUKAI;3826265557;Taip;7;0;0;7
2234;"Geniukų kalvė";PAGRANDUKAI;5704223824;Taip;0;1;0;1
2235;"Geniukų kalvė";PAGRANDUKAI;6024288147;Taip;0;1;0;1
2236;"Geniukų kalvė";PAGRANDUKAI;6070945557;Taip;6;0;0;6
2237;"Geniukų kalvė";PAGRANDUKAI;2659298240;Taip;9;2;0;11
2238;"Geniukų kalvė";PAGRANDUKAI;2217221922;Taip;10;0;0;10
2239;"Geniukų kalvė";PAGRANDUKAI;9976423099;Taip;7;0;0;7
2240;"Geniukų kalvė";PAGRANDUKAI;3762178533;Taip;13;0;0;13
2241;"Geniukų kalvė";PAGRANDUKAI;2426186771;Taip;7;0;0;7
2242;"Geniukų kalvė";NYKŠTUKAI;8095693657;Taip;0;0;2;2
2243;"Geniukų kalvė";NYKŠTUKAI;4958738745;Taip;0;0;1;1
2244;"Geniukų kalvė";NYKŠTUKAI;4271763719;Taip;11;0;2;13
2245;"Geniukų kalvė";NYKŠTUKAI;9069256760;Taip;11;0;0;11
2246;"Geniukų kalvė";NYKŠTUKAI;7501831333;Taip;9;0;0;9
2247;"Geniukų kalvė";NYKŠTUKAI;3493492581;Taip;0;1;0;1
2248;"Geniukų kalvė";NYKŠTUKAI;3180116136;Taip;0;2;1;3
2249;"Geniukų kalvė";NYKŠTUKAI;2904091819;Taip;5;0;0;5
2250;"Geniukų kalvė";NYKŠTUKAI;5245434552;Taip;0;6;0;6
2251;"Geniukų kalvė";NYKŠTUKAI;6794151223;Taip;5;0;0;5
2252;"Geniukų kalvė";NYKŠTUKAI;6674038058;Taip;2;0;0;2
2253;"Geniukų kalvė";NYKŠTUKAI;3085228868;Taip;3;0;0;3
2254;"Geniukų kalvė";NYKŠTUKAI;1037854104;Taip;0;3;1;4
2255;"Geniukų kalvė";NYKŠTUKAI;1499735818;Taip;11;0;0;11
2256;Gelvonėlis;ĄŽUOLIUKAI;36610437375;Taip;0;1;0;1
2257;Gelvonėlis;ĄŽUOLIUKAI;48593832088;Taip;4;0;0;4
2258;Gelvonėlis;ĄŽUOLIUKAI;71199691102;Taip;0;10;0;10
2259;Gelvonėlis;ĄŽUOLIUKAI;2218767947;Taip;0;0;3;3
2260;Gelvonėlis;ĄŽUOLIUKAI;5393404051;Taip;7;0;0;7
2261;Gelvonėlis;ĄŽUOLIUKAI;40127507796;Taip;0;1;0;1
2262;Gelvonėlis;ĄŽUOLIUKAI;98009116912;Taip;3;0;1;4
2263;Gelvonėlis;ĄŽUOLIUKAI;91507293029;Taip;0;3;0;3
2264;Gelvonėlis;ĄŽUOLIUKAI;79847096929;Taip;1;0;5;6
2265;Gelvonėlis;ĄŽUOLIUKAI;70550528579;Taip;11;1;1;13
2266;Gelvonėlis;ĄŽUOLIUKAI;51375531815;Taip;0;4;0;4
2267;Gelvonėlis;ĄŽUOLIUKAI;17021411833;Taip;0;11;0;11
2268;Gelvonėlis;ĄŽUOLIUKAI;9970883470;Taip;0;6;0;6
2269;Gelvonėlis;ĄŽUOLIUKAI;1902998389;Taip;0;2;0;2
2270;Gelvonėlis;ĄŽUOLIUKAI;7822842578;Taip;10;0;5;15
2271;Gelvonėlis;ĄŽUOLIUKAI;71076083278;Taip;10;0;3;13
2272;Gelvonėlis;ĄŽUOLIUKAI;1776015014;Taip;10;1;0;11
2273;Gelvonėlis;ĄŽUOLIUKAI;22201650331;Taip;0;3;0;3
2274;Gelvonėlis;ŽVIRBLIUKAI;1772713183;Taip;11;2;0;13
2275;Gelvonėlis;ŽVIRBLIUKAI;1801724527;Ne;11;2;0;13
2276;Gelvonėlis;ŽVIRBLIUKAI;83360239551;Taip;0;0;8;8
2277;Gelvonėlis;ŽVIRBLIUKAI;21250325232;Taip;0;1;1;2
2278;Gelvonėlis;ŽVIRBLIUKAI;5798439412;Taip;4;0;0;4
2279;Gelvonėlis;ŽVIRBLIUKAI;23181505838;Taip;0;13;1;14
2280;Gelvonėlis;ŽVIRBLIUKAI;2997738880;Taip;10;0;0;10
2281;Gelvonėlis;ŽVIRBLIUKAI;1373771258;Taip;0;7;1;8
2282;Gelvonėlis;ŽVIRBLIUKAI;92420286100;Taip;0;1;0;1
2283;Gelvonėlis;ŽVIRBLIUKAI;41610307448;Taip;6;0;0;6
2284;Gelvonėlis;ŽVIRBLIUKAI;87746258537;Taip;10;0;0;10
2285;Gelvonėlis;ŽVIRBLIUKAI;6635285387;Taip;1;0;7;8
2286;Gelvonėlis;ŽVIRBLIUKAI;1938913528;Taip;0;4;0;4
2287;Gelvonėlis;ŽVIRBLIUKAI;2096702999;Taip;6;2;1;9
2288;Gelvonėlis;ŽVIRBLIUKAI;17044138057;Taip;6;0;1;7
2289;Gelvonėlis;ŽVIRBLIUKAI;84863800926;Taip;10;1;0;11
2290;Gelvonėlis;ŽVIRBLIUKAI;1355742622;Taip;8;7;1;16
2291;Gelvonėlis;ŽVIRBLIUKAI;90961913967;Taip;8;0;0;8
2292;Gelvonėlis;ŽVIRBLIUKAI;1827511187;Taip;1;0;1;2
2293;Gelvonėlis;ŽVIRBLIUKAI;1835508505;Taip;11;0;0;11
2294;Gelvonėlis;ŽVIRBLIUKAI;9784762153;Taip;10;6;0;16
2295;Gelvonėlis;ŽVIRBLIUKAI;9919860358;Taip;4;0;0;4
2296;Gelvonėlis;RASELĖS;27296649662;Taip;9;2;0;11
2297;Gelvonėlis;RASELĖS;11994848859;Taip;0;0;3;3
2298;Gelvonėlis;RASELĖS;32532059858;Taip;9;0;0;9
2299;Gelvonėlis;RASELĖS;40035134521;Taip;0;7;0;7
2300;Gelvonėlis;RASELĖS;57163457394;Taip;0;12;0;12
2301;Gelvonėlis;RASELĖS;23568664214;Taip;0;0;3;3
2302;Gelvonėlis;RASELĖS;41750260566;Taip;6;0;0;6
2303;Gelvonėlis;RASELĖS;3461354329;Taip;0;4;0;4
2304;Gelvonėlis;RASELĖS;95413117888;Taip;0;6;0;6
2305;Gelvonėlis;RASELĖS;3325116198;Taip;5;0;3;8
2306;Gelvonėlis;RASELĖS;2153676615;Taip;4;11;0;15
2307;Gelvonėlis;RASELĖS;87254295179;Taip;5;3;0;8
2308;Gelvonėlis;RASELĖS;47302438188;Taip;6;0;5;11
2309;Gelvonėlis;RASELĖS;32893563601;Taip;0;1;0;1
2310;Gelvonėlis;RASELĖS;18324768783;Taip;4;0;0;4
2311;Gelvonėlis;RASELĖS;11697172905;Taip;0;4;0;4
2312;Gelvonėlis;RASELĖS;1221420212;Taip;10;3;0;13
2313;Gelvonėlis;RASELĖS;1396698456;Taip;7;0;0;7
2314;Gelvonėlis;RASELĖS;43145774484;Taip;0;0;3;3
2315;Gelvonėlis;RASELĖS;18237108866;Taip;0;6;0;6
2316;Gelvonėlis;RASELĖS;3271118581;Taip;8;0;0;8
2317;Gelvonėlis;RASELĖS;79607769503;Ne;5;1;0;6
2318;Gelvonėlis;RASELĖS;96792124844;Ne;0;4;0;4
2319;Gelvonėlis;SAULUTĖ;35428558838;Taip;0;1;0;1
2320;Gelvonėlis;SAULUTĖ;84202281636;Taip;0;2;0;2
2321;Gelvonėlis;SAULUTĖ;38629832653;Taip;0;9;0;9
2322;Gelvonėlis;SAULUTĖ;473144281;Taip;0;1;1;2
2323;Gelvonėlis;SAULUTĖ;81833782531;Taip;3;3;0;6
2324;Gelvonėlis;SAULUTĖ;72048682220;Taip;0;2;0;2
2325;Gelvonėlis;SAULUTĖ;33845988568;Taip;0;2;0;2
2326;Gelvonėlis;SAULUTĖ;66520207357;Taip;0;1;0;1
2327;Gelvonėlis;SAULUTĖ;45588179697;Taip;5;0;0;5
2328;Gelvonėlis;SAULUTĖ;4316492518;Taip;4;0;0;4
2329;Gelvonėlis;SAULUTĖ;17005717219;Taip;0;5;0;5
2330;Gelvonėlis;SAULUTĖ;59265250104;Taip;0;3;0;3
2331;Gelvonėlis;SAULUTĖ;6346945643;Taip;0;3;0;3
2332;Gelvonėlis;SAULUTĖ;34373469291;Taip;0;2;0;2
2333;Gelvonėlis;SAULUTĖ;35992063196;Taip;5;2;0;7
2334;Gelvonėlis;SAULUTĖ;11807134557;Taip;0;2;0;2
2335;Gelvonėlis;SAULUTĖ;80973545044;Taip;0;0;21;21
2336;Gelvonėlis;PELĖDŽIUKAI;72281404967;Taip;0;0;1;1
2337;Gelvonėlis;PELĖDŽIUKAI;58820730862;Taip;0;1;0;1
2338;Gelvonėlis;PELĖDŽIUKAI;94399276762;Taip;0;1;0;1
2339;Gelvonėlis;PELĖDŽIUKAI;59868339873;Taip;0;5;0;5
2340;Gelvonėlis;PELĖDŽIUKAI;91191192491;Taip;0;5;0;5
2341;Gelvonėlis;PELĖDŽIUKAI;2044305781;Taip;0;3;0;3
2342;Gelvonėlis;PELĖDŽIUKAI;54577279896;Taip;0;1;3;4
2343;Gelvonėlis;PELĖDŽIUKAI;71918920181;Taip;0;2;0;2
2344;Gelvonėlis;PELĖDŽIUKAI;90921912769;Ne;0;6;0;6
2345;Gelvonėlis;PELĖDŽIUKAI;45653629924;Taip;0;1;1;2
2346;Gelvonėlis;PELĖDŽIUKAI;16588607945;Taip;0;6;0;6
2347;Gelvonėlis;PELĖDŽIUKAI;10505090360;Taip;0;1;0;1
2348;Gelvonėlis;PELĖDŽIUKAI;9898346862;Taip;10;6;0;16
2349;Gelvonėlis;PELĖDŽIUKAI;15109448940;Taip;0;0;2;2
2350;Gelvonėlis;PELĖDŽIUKAI;75070203296;Taip;5;1;7;13
2351;Gelvonėlis;PELĖDŽIUKAI;1955777921;Taip;9;6;0;15
2352;Gelvonėlis;PELĖDŽIUKAI;24391920760;Taip;0;4;0;4
2353;Gelvonėlis;PELĖDŽIUKAI;83653321747;Taip;0;8;0;8
2354;Gelvonėlis;DRUGELIAI;5098282548;Taip;16;0;0;16
2355;Gelvonėlis;DRUGELIAI;50383394228;Ne;0;1;0;1
2356;Gelvonėlis;DRUGELIAI;68841073274;Taip;0;7;0;7
2357;Gelvonėlis;DRUGELIAI;1775227032;Taip;0;2;0;2
2358;Gelvonėlis;DRUGELIAI;67365224459;Taip;4;2;0;6
2359;Gelvonėlis;DRUGELIAI;1042715433;Ne;0;12;0;12
2360;Gelvonėlis;DRUGELIAI;59592904001;Taip;0;4;0;4
2361;Gelvonėlis;DRUGELIAI;6405741006;Taip;6;0;0;6
2362;Gelvonėlis;DRUGELIAI;9595350871;Taip;6;0;0;6
2363;Gelvonėlis;DRUGELIAI;1750552925;Taip;0;12;0;12
2364;Gelvonėlis;DRUGELIAI;19782508652;Taip;0;1;0;1
2365;Gelvonėlis;DRUGELIAI;3859776410;Taip;0;6;0;6
2366;Gelvonėlis;DRUGELIAI;19955601762;Taip;12;0;0;12
2367;Gelvonėlis;DRUGELIAI;71806077882;Taip;16;3;0;19
2368;Gelvonėlis;DRUGELIAI;8475204684;Taip;0;3;0;3
2369;Gelvonėlis;DRUGELIAI;4830374546;Taip;9;5;0;14
2370;Gelvonėlis;DRUGELIAI;2622967319;Taip;0;8;0;8
2371;Gelvonėlis;VARPELIAI;3059903126;Taip;1;0;0;1
2372;Gelvonėlis;VARPELIAI;9149117970;Taip;6;0;0;6
2373;Gelvonėlis;VARPELIAI;3483144401;Taip;0;0;5;5
2374;Gelvonėlis;VARPELIAI;1512245903;Taip;0;2;0;2
2375;Gelvonėlis;VARPELIAI;6451557430;Taip;12;5;0;17
2376;Gelvonėlis;VARPELIAI;6225854165;Taip;11;0;0;11
2377;Gelvonėlis;VARPELIAI;2638430817;Taip;2;0;4;6
2378;Gelvonėlis;VARPELIAI;9396676137;Taip;7;0;0;7
2379;Gelvonėlis;VARPELIAI;9353066785;Taip;7;0;0;7
2380;Gelvonėlis;VARPELIAI;1987204544;Taip;0;7;0;7
2381;Gelvonėlis;VARPELIAI;8515746171;Taip;6;1;0;7
2382;Gelvonėlis;VARPELIAI;9600526942;Taip;7;4;0;11
2383;Gelvonėlis;VARPELIAI;1387948936;Taip;11;3;0;14
2384;Gelvonėlis;VARPELIAI;9650922918;Taip;2;2;0;4
2385;Gelvonėlis;VARPELIAI;3121251271;Taip;5;0;1;6
2386;Gelvonėlis;VARPELIAI;1462716950;Taip;21;0;0;21
2387;Gelvonėlis;VARPELIAI;6949090250;Taip;5;16;0;21
2388;Gelvonėlis;BORUŽĖLĖS;1030246127;Taip;0;1;0;1
2389;Gelvonėlis;BORUŽĖLĖS;22575527531;Taip;0;1;0;1
2390;Gelvonėlis;BORUŽĖLĖS;1163833201;Taip;12;0;0;12
2391;Gelvonėlis;BORUŽĖLĖS;1236944078;Taip;1;7;0;8
2392;Gelvonėlis;BORUŽĖLĖS;3379601736;Taip;0;11;0;11
2393;Gelvonėlis;BORUŽĖLĖS;1597669426;Taip;1;0;0;1
2394;Gelvonėlis;BORUŽĖLĖS;31744699590;Taip;0;1;0;1
2395;Gelvonėlis;BORUŽĖLĖS;9108760720;Taip;0;7;0;7
2396;Gelvonėlis;BORUŽĖLĖS;9777094764;Taip;1;0;0;1
2397;Gelvonėlis;BORUŽĖLĖS;3936144045;Taip;0;2;0;2
2398;Gelvonėlis;BORUŽĖLĖS;12715604772;Taip;7;1;0;8
2399;Gelvonėlis;BORUŽĖLĖS;8050788182;Taip;15;4;0;19
2400;Gelvonėlis;BORUŽĖLĖS;30812081628;Taip;10;0;0;10
2401;Gelvonėlis;BORUŽĖLĖS;1183745610;Taip;8;5;0;13
2402;Gelvonėlis;BORUŽĖLĖS;1836155450;Taip;14;5;0;19
2403;Gelvonėlis;BORUŽĖLĖS;87693970225;Taip;0;7;0;7
2404;Gelvonėlis;BORUŽĖLĖS;69221565557;Taip;11;0;0;11
2405;Gelvonėlis;BORUŽĖLĖS;79899652046;Taip;16;0;0;16
2406;Gelvonėlis;BORUŽĖLĖS;7903272826;Taip;5;16;0;21
2407;Gelvonėlis;NYKŠTUKAI;6604992169;Taip;11;5;0;16
2408;Gelvonėlis;NYKŠTUKAI;6556472766;Taip;18;1;0;19
2409;Gelvonėlis;NYKŠTUKAI;7182180008;Taip;9;1;0;10
2410;Gelvonėlis;NYKŠTUKAI;8885088900;Taip;6;1;2;9
2411;Gelvonėlis;NYKŠTUKAI;8622621570;Taip;15;0;6;21
2412;Gelvonėlis;NYKŠTUKAI;2400289466;Taip;0;8;0;8
2413;Gelvonėlis;NYKŠTUKAI;5129492284;Taip;7;2;0;9
2414;Gelvonėlis;NYKŠTUKAI;9493536517;Taip;1;0;2;3
2415;Gelvonėlis;NYKŠTUKAI;2288951845;Taip;7;0;0;7
2416;Gelvonėlis;NYKŠTUKAI;2515471132;Taip;7;0;7;14
2417;Gelvonėlis;NYKŠTUKAI;6505814802;Taip;9;0;0;9
2418;Gelvonėlis;NYKŠTUKAI;6319058542;Taip;15;0;0;15
2419;Gelvonėlis;NYKŠTUKAI;9538571448;Taip;0;7;0;7
2420;Gelvonėlis;NYKŠTUKAI;9147186080;Taip;4;0;0;4
2421;Gelvonėlis;NYKŠTUKAI;7919814808;Taip;0;5;0;5
2422;Gelvonėlis;NYKŠTUKAI;7620280474;Taip;3;0;0;3
2423;Gelvonėlis;BITUTĖS;7759317220;Taip;0;3;0;3
2424;Gelvonėlis;BITUTĖS;2504468098;Taip;0;6;0;6
2425;Gelvonėlis;BITUTĖS;7983982378;Taip;0;2;0;2
2426;Gelvonėlis;BITUTĖS;5721858659;Taip;0;5;0;5
2427;Gelvonėlis;BITUTĖS;9667024635;Taip;8;2;0;10
2428;Gelvonėlis;BITUTĖS;2108690954;Taip;14;0;0;14
2429;Gelvonėlis;BITUTĖS;9323579468;Taip;10;0;0;10
2430;Gelvonėlis;BITUTĖS;4855800131;Taip;0;1;0;1
2431;Gelvonėlis;BITUTĖS;1753617545;Taip;9;0;0;9
2432;Gelvonėlis;BITUTĖS;6189110767;Taip;0;0;1;1
2433;Gelvonėlis;BITUTĖS;3843881329;Taip;9;0;0;9
2434;Gelvonėlis;BITUTĖS;9184192787;Taip;0;1;0;1
2435;Gelvonėlis;BITUTĖS;9369121356;Taip;5;0;0;5
2436;Gelvonėlis;BITUTĖS;2119550116;Taip;11;0;0;11
2437;Gelvonėlis;BITUTĖS;9286500887;Taip;0;0;4;4
2438;Gelvonėlis;BITUTĖS;5095782784;Taip;0;1;0;1
2439;Gelvonėlis;BITUTĖS;1516164123;Taip;0;3;0;3
2440;Gelvonėlis;BITUTĖS;7226051965;Taip;0;0;1;1
2441;Gelvonėlis;BITUTĖS;3788522708;Taip;0;3;0;3
2442;Gelvonėlis;RAMUNĖLĖS;5047022305;Taip;6;0;0;6
2443;Gelvonėlis;RAMUNĖLĖS;1085845218;Taip;6;0;0;6
2444;Gelvonėlis;RAMUNĖLĖS;5511174729;Taip;11;1;1;13
2445;Gelvonėlis;RAMUNĖLĖS;1284359362;Taip;6;1;0;7
2446;Gelvonėlis;RAMUNĖLĖS;8775661719;Taip;0;2;0;2
2447;Gelvonėlis;RAMUNĖLĖS;6255253658;Taip;0;2;0;2
2448;Gelvonėlis;RAMUNĖLĖS;29928181395;Taip;9;0;1;10
2449;Gelvonėlis;RAMUNĖLĖS;21684706944;Taip;0;2;0;2
2450;Gelvonėlis;RAMUNĖLĖS;75676389361;Taip;16;3;0;19
2451;Gelvonėlis;RAMUNĖLĖS;2140799517;Taip;10;6;1;17
2452;Gelvonėlis;RAMUNĖLĖS;3830940009;Taip;0;12;0;12
2453;Gelvonėlis;RAMUNĖLĖS;3089755141;Taip;2;6;0;8
2454;Gelvonėlis;RAMUNĖLĖS;2077783219;Taip;0;2;1;3
2455;Gelvonėlis;RAMUNĖLĖS;1408313697;Taip;7;0;0;7
2456;Gelvonėlis;RAMUNĖLĖS;1624125024;Taip;12;3;0;15
2457;Gelvonėlis;RAMUNĖLĖS;3147489259;Taip;19;0;0;19
2458;Gelvonėlis;RAMUNĖLĖS;9798684265;Taip;5;0;0;5
2459;Gervelė;ŽIRNIUKAI;3525060645;Taip;8;5;0;13
2460;Gervelė;ŽIRNIUKAI;94487630173;Taip;7;0;1;8
2461;Gervelė;ŽIRNIUKAI;2551280794;Taip;0;10;0;10
2462;Gervelė;ŽIRNIUKAI;7302238728;Taip;6;0;0;6
2463;Gervelė;ŽIRNIUKAI;5989713844;Taip;6;3;0;9
2464;Gervelė;ŽIRNIUKAI;4560752068;Taip;0;2;0;2
2465;Gervelė;ŽIRNIUKAI;87619285504;Taip;3;2;0;5
2466;Gervelė;ŽIRNIUKAI;1991238577;Taip;5;7;0;12
2467;Gervelė;ŽIRNIUKAI;9515308666;Taip;8;2;0;10
2468;Gervelė;ŽIRNIUKAI;1616949023;Taip;0;0;5;5
2469;Gervelė;ŽIRNIUKAI;4943974662;Taip;10;2;0;12
2470;Gervelė;ŽIRNIUKAI;8152446576;Taip;10;3;0;13
2471;Gervelė;ŽIRNIUKAI;6967078836;Taip;0;0;1;1
2472;Gervelė;ŽIRNIUKAI;3015424614;Taip;4;0;3;7
2473;Gervelė;ŽIRNIUKAI;1704033440;Taip;7;0;0;7
2474;Gervelė;ŽIRNIUKAI;89076506192;Taip;0;0;3;3
2475;Gervelė;ŽIRNIUKAI;2167744244;Taip;8;0;0;8
2476;Gervelė;ŽIRNIUKAI;3427400844;Taip;7;2;0;9
2477;Gervelė;ŽIRNIUKAI;7697761552;Taip;0;5;0;5
2478;Gervelė;LAŠIUKAI;52142182972;Taip;8;2;0;10
2479;Gervelė;LAŠIUKAI;73803372762;Taip;0;0;1;1
2480;Gervelė;LAŠIUKAI;1697536098;Taip;0;6;0;6
2481;Gervelė;LAŠIUKAI;1617055167;Taip;0;4;0;4
2482;Gervelė;LAŠIUKAI;3278950938;Taip;0;0;4;4
2483;Gervelė;LAŠIUKAI;49013139623;Taip;9;0;0;9
2484;Gervelė;LAŠIUKAI;2019214634;Taip;16;0;0;16
2485;Gervelė;LAŠIUKAI;1860333208;Taip;11;0;0;11
2486;Gervelė;LAŠIUKAI;8454703111;Taip;0;3;0;3
2487;Gervelė;LAŠIUKAI;1921567602;Taip;0;3;0;3
2488;Gervelė;LAŠIUKAI;8035942210;Taip;0;11;0;11
2489;Gervelė;LAŠIUKAI;2191126539;Taip;2;0;0;2
2490;Gervelė;LAŠIUKAI;2632272974;Taip;7;5;0;12
2491;Gervelė;LAŠIUKAI;62782512806;Taip;0;9;0;9
2492;Gervelė;LAŠIUKAI;85689668690;Taip;0;5;0;5
2493;Gervelė;LAŠIUKAI;1792726318;Ne;0;12;0;12
2494;Gervelė;PABIRUČIAI;81112128210;Taip;0;5;0;5
2495;Gervelė;PABIRUČIAI;48497142461;Ne;0;1;0;1
2496;Gervelė;PABIRUČIAI;1928679740;Taip;0;0;2;2
2497;Gervelė;PABIRUČIAI;24724452164;Taip;0;3;0;3
2498;Gervelė;PABIRUČIAI;30126718224;Taip;0;3;0;3
2499;Gervelė;PABIRUČIAI;15891512215;Taip;11;0;1;12
2500;Gervelė;PABIRUČIAI;65086547895;Taip;0;7;0;7
2501;Gervelė;PABIRUČIAI;32101040739;Taip;0;0;9;9
2502;Gervelė;PABIRUČIAI;97418410809;Ne;0;1;0;1
2503;Gervelė;PABIRUČIAI;4265845947;Taip;6;5;1;12
2504;Gervelė;PABIRUČIAI;44678807307;Ne;7;0;6;13
2505;Gervelė;PABIRUČIAI;65751519550;Taip;15;0;0;15
2506;Gervelė;PABIRUČIAI;1303396562;Taip;0;0;9;9
2507;Gervelė;PABIRUČIAI;2017094793;Taip;0;0;1;1
2508;Gervelė;PABIRUČIAI;76731434799;Taip;1;0;0;1
2509;Gervelė;PABIRUČIAI;8302493906;Ne;0;5;0;5
2510;Gervelė;PABIRUČIAI;1371549808;Taip;0;1;0;1
2511;Gervelė;PABIRUČIAI;27435616549;Taip;0;3;0;3
2512;Gervelė;PABIRUČIAI;1413157604;Taip;0;5;2;7
2513;Gervelė;BITUTĖS;98970443751;Taip;1;0;0;1
2514;Gervelė;BITUTĖS;47945657061;Taip;10;2;0;12
2515;Gervelė;BITUTĖS;64688647985;Taip;0;0;2;2
2516;Gervelė;BITUTĖS;1545499809;Taip;0;15;0;15
2517;Gervelė;BITUTĖS;73134084618;Taip;0;5;0;5
2518;Gervelė;BITUTĖS;59156024051;Taip;0;1;0;1
2519;Gervelė;BITUTĖS;12701715977;Taip;0;3;0;3
2520;Gervelė;BITUTĖS;29756975817;Taip;0;4;0;4
2521;Gervelė;BITUTĖS;33044536438;Ne;0;4;0;4
2522;Gervelė;BITUTĖS;1897895689;Taip;0;12;0;12
2523;Gervelė;BITUTĖS;84331024451;Taip;1;0;0;1
2524;Gervelė;BITUTĖS;85855349922;Taip;0;3;0;3
2525;Gervelė;BITUTĖS;75507305203;Taip;0;4;0;4
2526;Gervelė;BITUTĖS;4092917137;Taip;5;0;0;5
2527;Gervelė;BURATINO;54142931109;Taip;0;15;0;15
2528;Gervelė;BURATINO;1772051140;Taip;0;10;0;10
2529;Gervelė;BURATINO;1690867495;Taip;9;1;0;10
2530;Gervelė;BURATINO;1815418720;Taip;0;12;0;12
2531;Gervelė;BURATINO;1106442860;Taip;0;1;0;1
2532;Gervelė;BURATINO;80029915729;Taip;6;10;0;16
2533;Gervelė;BURATINO;6168558862;Taip;8;4;0;12
2534;Gervelė;BURATINO;1083567209;Taip;13;0;0;13
2535;Gervelė;BURATINO;3784549444;Taip;12;3;0;15
2536;Gervelė;BURATINO;3946391650;Taip;0;7;0;7
2537;Gervelė;BURATINO;7620764911;Taip;11;0;1;12
2538;Gervelė;BURATINO;5440557094;Taip;13;0;0;13
2539;Gervelė;BURATINO;9202293067;Taip;0;0;1;1
2540;Gervelė;BURATINO;8195558041;Taip;21;0;0;21
2541;Gervelė;BURATINO;9909794030;Taip;1;4;0;5
2542;Gervelė;BURATINO;3022690832;Taip;21;0;0;21
2543;Gervelė;BURATINO;3825101647;Ne;21;0;0;21
2544;Gervelė;BURATINO;9692128960;Taip;1;8;0;9
2545;Gervelė;VIŠČIUKŲ;4394752176;Taip;3;1;0;4
2546;Gervelė;VIŠČIUKŲ;7020599764;Taip;0;0;1;1
2547;Gervelė;VIŠČIUKŲ;5953552777;Taip;0;8;0;8
2548;Gervelė;VIŠČIUKŲ;6951455424;Taip;0;0;1;1
2549;Gervelė;VIŠČIUKŲ;8016341646;Taip;9;0;0;9
2550;Gervelė;VIŠČIUKŲ;6263562066;Ne;0;1;0;1
2551;Gervelė;VIŠČIUKŲ;9970293084;Taip;0;12;0;12
2552;Gervelė;VIŠČIUKŲ;1400044294;Taip;5;0;0;5
2553;Gervelė;VIŠČIUKŲ;8012122042;Taip;0;0;1;1
2554;Gervelė;VIŠČIUKŲ;7050837754;Taip;12;0;0;12
2555;Gervelė;VIŠČIUKŲ;2185853339;Taip;0;1;0;1
2556;Gervelė;VIŠČIUKŲ;8840658383;Taip;11;0;0;11
2557;Gervelė;VIŠČIUKŲ;5685222621;Taip;1;0;0;1
2558;Gilužis;Skruzdėliukų;35511006307;Taip;0;3;2;5
2559;Gilužis;Skruzdėliukų;44807904472;Taip;9;0;0;9
2560;Gilužis;Skruzdėliukų;1615293331;Taip;0;2;0;2
2561;Gilužis;Skruzdėliukų;5161095299;Taip;0;2;0;2
2562;Gilužis;Skruzdėliukų;8120898865;Taip;11;0;0;11
2563;Gilužis;Skruzdėliukų;8840822243;Taip;15;0;0;15
2564;Gilužis;Skruzdėliukų;4611735601;Taip;21;0;0;21
2565;Gilužis;Skruzdėliukų;5920357223;Taip;0;1;0;1
2566;Gilužis;Skruzdėliukų;8595541498;Taip;5;1;0;6
2567;Gilužis;Skruzdėliukų;5365582271;Taip;15;1;0;16
2568;Gilužis;Skruzdėliukų;7364297673;Taip;16;0;0;16
2569;Gilužis;Skruzdėliukų;4362244070;Taip;13;0;0;13
2570;Gilužis;Skruzdėliukų;2093487071;Taip;7;0;3;10
2571;Gilužis;Skruzdėliukų;2218793969;Taip;12;0;0;12
2572;Gilužis;Nykštukų;94828544657;Taip;7;2;0;9
2573;Gilužis;Nykštukų;65865096435;Taip;0;2;0;2
2574;Gilužis;Nykštukų;61579959201;Taip;3;1;0;4
2575;Gilužis;Nykštukų;41863620605;Taip;0;6;0;6
2576;Gilužis;Nykštukų;10456837723;Taip;0;1;0;1
2577;Gilužis;Nykštukų;18927429626;Taip;0;2;0;2
2578;Gilužis;Nykštukų;30714242097;Taip;0;0;8;8
2579;Gilužis;Nykštukų;72071736122;Taip;5;1;3;9
2580;Gilužis;Nykštukų;25086526218;Taip;7;2;0;9
2581;Gilužis;Nykštukų;37179053472;Taip;0;7;0;7
2582;Gilužis;Nykštukų;64182110384;Taip;0;10;0;10
2583;Gilužis;Nykštukų;51989833076;Taip;0;9;0;9
2584;Gilužis;Nykštukų;42894227994;Taip;0;1;0;1
2585;Gilužis;Nykštukų;36855170422;Taip;0;1;1;2
2586;Gilužis;Nykštukų;49638196733;Taip;0;1;0;1
2587;Gilužis;Nykštukų;21430317293;Taip;5;1;0;6
2588;Gilužis;Nykštukų;93696234277;Taip;5;1;1;7
2589;Gilužis;Nykštukų;36105195245;Taip;0;4;0;4
2590;Gilužis;Nykštukų;2330374550;Taip;9;1;0;10
2591;Gilužis;Nykštukų;38286886127;Taip;3;1;1;5
2592;Gilužis;Nykštukų;51801100240;Taip;5;1;0;6
2593;Gilužis;Bitučių;7667792304;Taip;5;0;0;5
2594;Gilužis;Bitučių;33601993265;Taip;0;3;0;3
2595;Gilužis;Bitučių;79835099585;Taip;3;2;0;5
2596;Gilužis;Bitučių;86856314276;Taip;0;5;0;5
2597;Gilužis;Bitučių;6761901941;Taip;0;0;1;1
2598;Gilužis;Bitučių;86204525039;Taip;13;1;0;14
2599;Gilužis;Bitučių;31841898314;Taip;0;3;0;3
2600;Gilužis;Bitučių;37713407129;Taip;0;9;0;9
2601;Gilužis;Bitučių;58788039263;Taip;2;0;0;2
2602;Gilužis;Bitučių;67925251330;Taip;0;4;0;4
2603;Gilužis;Bitučių;75877736009;Taip;3;0;1;4
2604;Gilužis;Bitučių;77265792587;Taip;5;2;0;7
2605;Gilužis;Bitučių;98929035480;Taip;0;1;0;1
2606;Gilužis;Bitučių;16441506448;Taip;0;1;0;1
2607;Gilužis;Bitučių;60029145569;Taip;0;2;0;2
2608;Gilužis;Bitučių;6748923923;Taip;6;0;0;6
2609;Gilužis;Bitučių;84012597609;Taip;0;9;0;9
2610;Gilužis;Bitučių;44591290522;Taip;0;2;0;2
2611;Gilužis;Kačiukų;64044950817;Taip;21;0;0;21
2612;Gilužis;Kačiukų;97044945526;Taip;5;0;2;7
2613;Gilužis;Kačiukų;2452430134;Taip;0;1;0;1
2614;Gilužis;Kačiukų;97366385111;Taip;0;1;0;1
2615;Gilužis;Kačiukų;98833692687;Taip;5;0;0;5
2616;Gilužis;Kačiukų;90653192774;Taip;6;0;0;6
2617;Gilužis;Kačiukų;43427840545;Taip;1;0;0;1
2618;Gilužis;Kačiukų;69179380194;Taip;7;0;0;7
2619;Gilužis;Kačiukų;27145205823;Taip;3;0;1;4
2620;Gilužis;Kačiukų;11999596704;Taip;0;2;0;2
2621;Gilužis;Kačiukų;40327951625;Taip;0;4;0;4
2622;Gilužis;Kačiukų;32385951346;Taip;3;4;0;7
2623;Gilužis;Kačiukų;69814504535;Ne;0;8;0;8
2624;Gilužis;Kačiukų;2826672081;Taip;0;2;0;2
2625;Gilužis;Kačiukų;71678818697;Taip;2;0;0;2
2626;Gilužis;Kačiukų;90150093965;Taip;9;0;0;9
2627;Gilužis;Kačiukų;88997906780;Taip;0;1;0;1
2628;Gilužis;Kačiukų;8442202778;Taip;0;0;3;3
2629;Gilužis;Kačiukų;1642252063;Taip;0;1;0;1
2630;Gilužis;Pelėdžiukų;5726426223;Taip;6;0;2;8
2631;Gilužis;Pelėdžiukų;67700612490;Taip;0;2;0;2
2632;Gilužis;Pelėdžiukų;51205862390;Taip;0;1;0;1
2633;Gilužis;Pelėdžiukų;61132410107;Taip;0;2;0;2
2634;Gilužis;Pelėdžiukų;62062383570;Taip;2;11;0;13
2635;Gilužis;Pelėdžiukų;79192054914;Taip;0;2;0;2
2636;Gilužis;Pelėdžiukų;53479123084;Taip;5;3;0;8
2637;Gilužis;Pelėdžiukų;22977705605;Taip;0;3;0;3
2638;Gilužis;Pelėdžiukų;22799444042;Taip;0;1;1;2
2639;Gilužis;Pelėdžiukų;60053609696;Taip;0;0;1;1
2640;Gilužis;Pelėdžiukų;58046857856;Taip;12;0;0;12
2641;Gilužis;Pelėdžiukų;89984610092;Taip;0;1;0;1
2642;Gilužis;Pelėdžiukų;23013185518;Taip;1;1;0;2
2643;Gilužis;Pelėdžiukų;50090534112;Taip;0;1;1;2
2644;Gilužis;Pelėdžiukų;48885794712;Taip;0;7;0;7
2645;Gilužis;Pelėdžiukų;68971431550;Taip;0;1;1;2
2646;Gilužis;Pelėdžiukų;55062344648;Taip;0;1;1;2
2647;Gilužis;Pelėdžiukų;4037228503;Taip;0;0;1;1
2648;Gilužis;Drugelių;9184268838;Taip;0;5;0;5
2649;Gilužis;Drugelių;48661024580;Taip;0;3;1;4
2650;Gilužis;Drugelių;23066248600;Taip;0;1;1;2
2651;Gilužis;Drugelių;1437220475;Taip;0;4;0;4
2652;Gilužis;Drugelių;32201401076;Taip;5;0;1;6
2653;Gilužis;Drugelių;88492331198;Taip;0;1;1;2
2654;Gilužis;Drugelių;49548271216;Taip;0;3;0;3
2655;Gilužis;Drugelių;70078053276;Taip;5;1;0;6
2656;Gilužis;Drugelių;34173898307;Taip;0;1;0;1
2657;Gilužis;Drugelių;67880087360;Taip;1;0;0;1
2658;Gilužis;Drugelių;28352939067;Taip;0;2;1;3
2659;Gilužis;Drugelių;73290159635;Taip;0;1;5;6
2660;Gilužis;Drugelių;86110181512;Taip;0;2;1;3
2661;Gilužis;Drugelių;21922874503;Taip;0;1;2;3
2662;Gilužis;Drugelių;44522730563;Taip;0;1;0;1
2663;Gilužis;Drugelių;1951561868;Taip;2;10;0;12
2664;Gilužis;Drugelių;1515789192;Taip;3;1;1;5
2665;Gilužis;Drugelių;3866604956;Taip;0;1;1;2
2666;Gilužis;Saulučių;17896774143;Taip;0;1;8;9
2667;Gilužis;Saulučių;9918995545;Taip;1;2;0;3
2668;Gilužis;Saulučių;4209000927;Taip;1;0;2;3
2669;Gilužis;Saulučių;4575619425;Taip;3;0;1;4
2670;Gilužis;Saulučių;8224691148;Taip;12;2;0;14
2671;Gilužis;Saulučių;4473810097;Taip;9;0;0;9
2672;Gilužis;Saulučių;1649256496;Taip;4;0;1;5
2673;Gilužis;Saulučių;96550272401;Taip;17;0;0;17
2674;Gilužis;Saulučių;69504888193;Taip;10;0;0;10
2675;Gilužis;Saulučių;2391630554;Taip;10;0;0;10
2676;Gilužis;Saulučių;18997894859;Taip;10;1;0;11
2677;Gilužis;Saulučių;7744997250;Taip;6;0;2;8
2678;Gilužis;Saulučių;32730847948;Taip;0;1;0;1
2679;Gilužis;Saulučių;3181765606;Taip;14;0;0;14
2680;Gilužis;Saulučių;5905237803;Taip;9;0;0;9
2681;Gilužis;Saulučių;79805583046;Taip;1;0;1;2
2682;Gilužis;Saulučių;2872439079;Taip;3;0;0;3
2683;Gilužis;Saulučių;87425898496;Taip;1;1;0;2
2684;Gilužis;Saulučių;35650138667;Taip;11;1;0;12
2685;Gilužis;Saulučių;9367673896;Taip;7;0;0;7
2686;Gilužis;Paukštelių;1911733577;Ne;7;1;0;8
2687;Gilužis;Paukštelių;1124568431;Ne;1;1;1;3
2688;Gilužis;Paukštelių;1120628451;Taip;0;3;0;3
2689;Gilužis;Paukštelių;1772207635;Taip;0;2;0;2
2690;Gilužis;Paukštelių;9252084783;Taip;10;1;0;11
2691;Gilužis;Paukštelių;4265465127;Taip;0;3;0;3
2692;Gilužis;Paukštelių;1797199356;Taip;6;2;0;8
2693;Gilužis;Paukštelių;93844800610;Taip;1;0;0;1
2694;Gilužis;Paukštelių;92163197528;Taip;5;1;0;6
2695;Gilužis;Paukštelių;1962922981;Taip;10;0;0;10
2696;Gilužis;Paukštelių;2769830772;Taip;4;0;0;4
2697;Gilužis;Paukštelių;91148708775;Taip;2;0;0;2
2698;Gilužis;Paukštelių;49114819476;Taip;2;0;1;3
2699;Gilužis;Paukštelių;1067512693;Taip;17;0;0;17
2700;Gilužis;Paukštelių;65698608589;Taip;2;0;0;2
2701;Gilužis;Paukštelių;1413931545;Taip;11;0;0;11
2702;Gilužis;Paukštelių;4754994261;Taip;12;0;0;12
2703;Gilužis;Obuoliukų;27834192987;Taip;0;1;0;1
2704;Gilužis;Obuoliukų;72582220264;Taip;0;1;0;1
2705;Gilužis;Obuoliukų;1840213846;Taip;8;0;0;8
2706;Gilužis;Obuoliukų;1637726675;Taip;0;1;0;1
2707;Gilužis;Obuoliukų;1404236599;Taip;0;21;0;21
2708;Gilužis;Obuoliukų;1847232194;Taip;0;2;0;2
2709;Gilužis;Obuoliukų;93652771548;Taip;10;0;0;10
2710;Gilužis;Obuoliukų;2031851095;Taip;0;1;0;1
2711;Gilužis;Obuoliukų;8015495924;Taip;2;0;0;2
2712;Gilužis;Obuoliukų;96799037695;Taip;6;0;0;6
2713;Gilužis;Obuoliukų;2138402546;Taip;0;1;0;1
2714;Gilužis;Obuoliukų;1236164928;Taip;5;1;0;6
2715;Gilužis;Obuoliukų;84834458261;Taip;9;0;0;9
2716;Gilužis;Obuoliukų;5121769570;Taip;0;4;0;4
2717;Gilužis;Obuoliukų;1428994411;Taip;5;0;0;5
2718;Gilužis;Obuoliukų;5899163275;Taip;11;0;0;11
2719;Gilužis;Obuoliukų;2126527730;Taip;0;4;0;4
2720;Gilužis;Obuoliukų;53388692764;Taip;5;0;1;6
2721;Gilužis;KIŠKUČIŲ;2118119414;Taip;0;0;5;5
2722;Gilužis;KIŠKUČIŲ;1017937594;Taip;3;0;1;4
2723;Gilužis;KIŠKUČIŲ;1191967409;Taip;16;1;0;17
2724;Gilužis;KIŠKUČIŲ;1025400197;Taip;0;0;1;1
2725;Gilužis;KIŠKUČIŲ;1841556598;Taip;6;0;0;6
2726;Gilužis;KIŠKUČIŲ;1452016675;Taip;3;0;0;3
2727;Gilužis;KIŠKUČIŲ;24558082285;Taip;18;1;0;19
2728;Gilužis;KIŠKUČIŲ;31157032738;Taip;0;2;0;2
2729;Gilužis;KIŠKUČIŲ;69205729963;Taip;10;1;0;11
2730;Gilužis;KIŠKUČIŲ;1869058578;Taip;8;0;0;8
2731;Gilužis;KIŠKUČIŲ;1464348972;Taip;3;0;0;3
2732;Gilužis;KIŠKUČIŲ;7740703388;Taip;0;1;3;4
2733;Gilužis;KIŠKUČIŲ;1589884646;Taip;0;0;2;2
2734;Gilužis;KIŠKUČIŲ;54636558233;Taip;4;0;0;4
2735;Gilužis;KIŠKUČIŲ;1453976300;Taip;0;1;0;1
2736;Gilužis;KIŠKUČIŲ;57074114440;Taip;0;4;0;4
2737;Gilužis;KIŠKUČIŲ;15192433393;Taip;0;0;1;1
2738;Gilužis;KIŠKUČIŲ;1307302669;Taip;0;0;1;1
2739;Gilužis;KIŠKUČIŲ;1569805585;Taip;3;0;0;3
2740;Gilužis;KIŠKUČIŲ;1211233315;Taip;6;0;1;7
2741;Gilužis;Meškučių;5008795520;Taip;0;1;0;1
2742;Gilužis;Meškučių;82153247890;Taip;0;5;0;5
2743;Gilužis;Meškučių;15672746324;Taip;0;1;0;1
2744;Gilužis;Meškučių;8278207628;Taip;0;2;0;2
2745;Gilužis;Meškučių;5988529284;Taip;2;0;7;9
2746;Gilužis;Meškučių;2144919007;Taip;4;0;0;4
2747;Gilužis;Meškučių;6840555273;Taip;0;5;0;5
2748;Gilužis;Meškučių;1664140841;Taip;7;0;0;7
2749;Gilužis;Meškučių;1201973661;Taip;11;3;0;14
2750;Gilužis;Meškučių;99889836604;Taip;4;2;0;6
2751;Gilužis;Meškučių;93541096118;Taip;0;2;0;2
2752;Gilužis;Meškučių;41791785706;Taip;0;21;0;21
2753;Gilužis;Meškučių;3104707033;Taip;6;2;0;8
2754;Gilužis;Meškučių;3884351522;Taip;0;1;0;1
2755;Gilužis;Meškučių;1003733551;Taip;0;3;1;4
2756;Gilužis;Meškučių;41887832166;Taip;2;0;0;2
2757;Gilužis;Meškučių;57285847418;Taip;7;0;0;7
2758;Gilužis;Meškučių;37771334557;Taip;4;12;0;16
2759;Gilužis;Meškučių;3451034791;Taip;0;21;0;21
2760;Gilužis;Pagrandukai;4956685016;Taip;0;1;0;1
2761;Gilužis;Pagrandukai;7937643339;Taip;0;1;0;1
2762;Gilužis;Pagrandukai;4147821853;Taip;7;0;0;7
2763;Gilužis;Pagrandukai;8899557365;Taip;10;1;0;11
2764;Gilužis;Pagrandukai;2661894041;Taip;18;0;0;18
2765;Gilužis;Pagrandukai;5109935385;Taip;5;9;0;14
2766;Gilužis;Pagrandukai;3335512812;Taip;5;2;0;7
2767;Gilužis;Pagrandukai;6093514885;Taip;0;21;0;21
2768;Gilužis;Pagrandukai;4156613717;Taip;11;0;0;11
2769;Gilužis;Pagrandukai;5713786735;Taip;21;0;0;21
2770;Gilužis;Pagrandukai;2784416935;Taip;7;0;0;7
2771;Gilužis;Pagrandukai;6315155554;Taip;1;0;0;1
2772;Gilužis;Pagrandukai;1146713023;Taip;4;2;0;6
2773;Gilužis;Pagrandukai;9362581908;Taip;1;11;0;12
2774;Gilužis;Pagrandukai;3473889426;Taip;1;11;0;12
2775;Gilužis;Pagrandukai;7228498662;Taip;0;2;0;2
2776;Gilužis;Pagrandukai;1459273692;Taip;4;6;0;10
2777;Gilužis;Boružėlių;9421351780;Taip;10;0;0;10
2778;Gilužis;Boružėlių;9332056404;Taip;0;21;0;21
2779;Gilužis;Boružėlių;7810223775;Taip;0;21;0;21
2780;Gilužis;Boružėlių;3258640163;Taip;0;21;0;21
2781;Gilužis;Boružėlių;7742783427;Taip;21;0;0;21
2782;Gilužis;Boružėlių;7998695149;Taip;21;0;0;21
2783;Gilužis;Boružėlių;9833451628;Taip;9;0;0;9
2784;Gilužis;Boružėlių;6404411477;Taip;7;1;0;8
2785;Gilužis;Boružėlių;1222370750;Taip;6;6;0;12
2786;Gilužis;Boružėlių;5217748032;Taip;11;0;0;11
2787;Gilužis;Boružėlių;7358572344;Taip;6;1;0;7
2788;Gilužis;Boružėlių;4617259961;Taip;7;0;0;7
2789;Gilužis;Boružėlių;9186274541;Taip;11;0;1;12
2790;Gilužis;Boružėlių;6121625070;Taip;0;21;0;21
2791;Gilužis;Boružėlių;3419281756;Taip;7;0;0;7
2792;Gilužis;Boružėlių;4403218878;Taip;10;0;0;10
2793;Gilužis;Boružėlių;5989314494;Taip;5;0;0;5
2794;Gilužis;Boružėlių;6270071724;Taip;0;1;0;1
2795;Gintarėlis;PAPŪGĖLĖS;32751650045;Taip;1;12;0;13
2796;Gintarėlis;PAPŪGĖLĖS;3100442808;Taip;0;8;0;8
2797;Gintarėlis;PAPŪGĖLĖS;36019373990;Ne;0;3;1;4
2798;Gintarėlis;PAPŪGĖLĖS;47480197789;Taip;3;5;0;8
2799;Gintarėlis;PAPŪGĖLĖS;77802363719;Taip;0;2;0;2
2800;Gintarėlis;PAPŪGĖLĖS;62371949439;Taip;0;4;0;4
2801;Gintarėlis;PAPŪGĖLĖS;25360163411;Taip;9;4;0;13
2802;Gintarėlis;PAPŪGĖLĖS;45279808861;Taip;0;11;0;11
2803;Gintarėlis;PAPŪGĖLĖS;58108486480;Taip;0;1;0;1
2804;Gintarėlis;PAPŪGĖLĖS;7610677403;Taip;0;2;0;2
2805;Gintarėlis;PAPŪGĖLĖS;43183534908;Taip;0;0;1;1
2806;Gintarėlis;PAPŪGĖLĖS;51243218101;Taip;0;0;2;2
2807;Gintarėlis;PAPŪGĖLĖS;85813209902;Taip;0;2;3;5
2808;Gintarėlis;PAPŪGĖLĖS;1943647795;Taip;0;19;0;19
2809;Gintarėlis;PAPŪGĖLĖS;10771368524;Taip;0;5;0;5
2810;Gintarėlis;PAPŪGĖLĖS;61739452519;Taip;0;0;1;1
2811;Gintarėlis;SPINDULIUKAI;96694096944;Taip;10;0;0;10
2812;Gintarėlis;SPINDULIUKAI;88552701503;Taip;3;1;0;4
2813;Gintarėlis;SPINDULIUKAI;33863655816;Taip;0;2;0;2
2814;Gintarėlis;SPINDULIUKAI;11384063236;Taip;0;6;0;6
2815;Gintarėlis;SPINDULIUKAI;27532374357;Taip;0;3;0;3
2816;Gintarėlis;SPINDULIUKAI;8112379741;Taip;0;1;3;4
2817;Gintarėlis;SPINDULIUKAI;37848651606;Taip;0;2;4;6
2818;Gintarėlis;SPINDULIUKAI;484847222;Taip;0;2;0;2
2819;Gintarėlis;SPINDULIUKAI;18570638516;Taip;0;2;5;7
2820;Gintarėlis;SPINDULIUKAI;29392171144;Taip;0;6;0;6
2821;Gintarėlis;SPINDULIUKAI;92436759875;Taip;5;1;0;6
2822;Gintarėlis;SPINDULIUKAI;1360843628;Taip;0;0;5;5
2823;Gintarėlis;SPINDULIUKAI;6452806962;Taip;3;1;0;4
2824;Gintarėlis;SPINDULIUKAI;63037561278;Taip;0;0;3;3
2825;Gintarėlis;SPINDULIUKAI;92996401082;Taip;0;2;1;3
2826;Gintarėlis;SPINDULIUKAI;77591601744;Taip;9;0;2;11
2827;Gintarėlis;SPINDULIUKAI;19506557567;Ne;0;4;0;4
2828;Gintarėlis;SPINDULIUKAI;24915581271;Taip;6;0;0;6
2829;Gintarėlis;SPINDULIUKAI;1076400051;Taip;0;10;0;10
2830;Gintarėlis;LAŠIUKAI;6893183889;Taip;0;1;0;1
2831;Gintarėlis;LAŠIUKAI;5880091191;Taip;0;1;0;1
2832;Gintarėlis;LAŠIUKAI;9584956349;Taip;0;0;13;13
2833;Gintarėlis;LAŠIUKAI;94354056029;Taip;2;2;0;4
2834;Gintarėlis;LAŠIUKAI;78359050717;Taip;0;0;6;6
2835;Gintarėlis;LAŠIUKAI;6457288028;Taip;0;1;0;1
2836;Gintarėlis;LAŠIUKAI;1002155392;Taip;6;1;0;7
2837;Gintarėlis;LAŠIUKAI;96416364735;Taip;0;1;0;1
2838;Gintarėlis;LAŠIUKAI;9130659549;Taip;6;1;0;7
2839;Gintarėlis;LAŠIUKAI;1809511815;Taip;0;0;1;1
2840;Gintarėlis;LAŠIUKAI;4660854883;Taip;0;0;4;4
2841;Gintarėlis;LAŠIUKAI;3799412062;Taip;0;7;0;7
2842;Gintarėlis;LAŠIUKAI;25210675029;Taip;0;13;0;13
2843;Gintarėlis;LAŠIUKAI;5024727902;Taip;0;6;0;6
2844;Gintarėlis;LAŠIUKAI;7644607132;Taip;6;0;4;10
2845;Gintarėlis;LAŠIUKAI;2088008759;Taip;0;0;5;5
2846;Gintarėlis;GAIDŽIUKAI;61360761151;Taip;0;1;0;1
2847;Gintarėlis;GAIDŽIUKAI;1230510614;Taip;1;0;2;3
2848;Gintarėlis;GAIDŽIUKAI;12332079305;Taip;1;5;0;6
2849;Gintarėlis;GAIDŽIUKAI;29645999843;Taip;0;4;0;4
2850;Gintarėlis;GAIDŽIUKAI;2099549218;Taip;0;2;0;2
2851;Gintarėlis;GAIDŽIUKAI;28514742083;Taip;0;3;0;3
2852;Gintarėlis;GAIDŽIUKAI;86948612054;Taip;0;2;0;2
2853;Gintarėlis;GAIDŽIUKAI;45480802894;Taip;0;2;0;2
2854;Gintarėlis;GAIDŽIUKAI;1539226211;Taip;0;16;0;16
2855;Gintarėlis;GAIDŽIUKAI;2043878016;Taip;11;0;0;11
2856;Gintarėlis;GAIDŽIUKAI;90891401453;Taip;0;2;0;2
2857;Gintarėlis;GAIDŽIUKAI;1770479969;Taip;0;2;0;2
2858;Gintarėlis;GAIDŽIUKAI;29331294396;Taip;0;10;0;10
2859;Gintarėlis;GAIDŽIUKAI;1799002086;Taip;5;5;0;10
2860;Gintarėlis;GAIDŽIUKAI;33786299764;Taip;0;2;0;2
2861;Gintarėlis;GAIDŽIUKAI;84375225995;Taip;5;1;0;6
2862;Gintarėlis;GAIDŽIUKAI;1441282039;Taip;0;2;2;4
2863;Gintarėlis;GAIDŽIUKAI;5835437020;Taip;0;2;2;4
2864;Gintarėlis;MEŠKUČIAI;46036221870;Taip;0;2;0;2
2865;Gintarėlis;MEŠKUČIAI;72954464555;Taip;3;0;0;3
2866;Gintarėlis;MEŠKUČIAI;74741949593;Taip;0;1;1;2
2867;Gintarėlis;MEŠKUČIAI;1684735692;Taip;0;1;0;1
2868;Gintarėlis;MEŠKUČIAI;92253181137;Taip;0;2;0;2
2869;Gintarėlis;MEŠKUČIAI;37758004138;Taip;0;1;0;1
2870;Gintarėlis;MEŠKUČIAI;89600903751;Taip;0;5;0;5
2871;Gintarėlis;MEŠKUČIAI;26403359331;Taip;0;1;0;1
2872;Gintarėlis;MEŠKUČIAI;33678587696;Taip;0;4;0;4
2873;Gintarėlis;MEŠKUČIAI;77834528801;Taip;0;7;0;7
2874;Gintarėlis;MEŠKUČIAI;49921116417;Taip;0;1;0;1
2875;Gintarėlis;MEŠKUČIAI;49473761753;Taip;0;3;0;3
2876;Gintarėlis;MEŠKUČIAI;94996622631;Taip;0;2;1;3
2877;Gintarėlis;MEŠKUČIAI;89450049559;Taip;4;2;0;6
2878;Gintarėlis;MEŠKUČIAI;6242733673;Taip;6;3;0;9
2879;Gintarėlis;MEŠKUČIAI;49079274803;Taip;0;1;0;1
2880;Gintarėlis;MEŠKUČIAI;16507384915;Taip;0;1;0;1
2881;Gintarėlis;MEŠKUČIAI;58918505824;Taip;0;4;0;4
2882;Gintarėlis;MEŠKUČIAI;40605918843;Ne;0;2;0;2
2883;Gintarėlis;DRUGELIAI;2127877544;Taip;0;1;0;1
2884;Gintarėlis;DRUGELIAI;14840692502;Taip;1;10;0;11
2885;Gintarėlis;DRUGELIAI;1462949250;Taip;0;21;0;21
2886;Gintarėlis;DRUGELIAI;9737200226;Taip;0;2;2;4
2887;Gintarėlis;DRUGELIAI;6655809299;Taip;7;0;0;7
2888;Gintarėlis;DRUGELIAI;2614258442;Taip;0;10;0;10
2889;Gintarėlis;DRUGELIAI;4217329880;Taip;0;1;0;1
2890;Gintarėlis;DRUGELIAI;1759217543;Taip;0;0;1;1
2891;Gintarėlis;DRUGELIAI;7571352126;Taip;5;0;0;5
2892;Gintarėlis;DRUGELIAI;50896429585;Taip;3;2;0;5
2893;Gintarėlis;DRUGELIAI;1042222561;Taip;0;1;0;1
2894;Gintarėlis;DRUGELIAI;9687974376;Taip;19;0;0;19
2895;Gintarėlis;DRUGELIAI;8704248985;Taip;0;7;0;7
2896;Gintarėlis;DRUGELIAI;8419453060;Taip;0;0;1;1
2897;Gintarėlis;DRUGELIAI;6655645997;Taip;16;0;0;16
2898;Gintarėlis;DRUGELIAI;6080108998;Taip;16;0;0;16
2899;Gintarėlis;DRUGELIAI;7449437199;Taip;0;1;0;1
2900;Gintarėlis;DRUGELIAI;4076421692;Taip;0;1;0;1
2901;Gintarėlis;DRUGELIAI;5355691986;Taip;0;11;0;11
2902;Gintarėlis;KAČIUKAI;5451653510;Taip;0;0;3;3
2903;Gintarėlis;KAČIUKAI;63243392161;Taip;0;2;0;2
2904;Gintarėlis;KAČIUKAI;37612987791;Taip;0;2;0;2
2905;Gintarėlis;KAČIUKAI;26259581924;Taip;0;4;0;4
2906;Gintarėlis;KAČIUKAI;70787488885;Taip;5;3;1;9
2907;Gintarėlis;KAČIUKAI;1159773367;Taip;5;0;0;5
2908;Gintarėlis;KAČIUKAI;1124481108;Ne;4;0;0;4
2909;Gintarėlis;KAČIUKAI;2050020230;Taip;0;9;0;9
2910;Gintarėlis;KAČIUKAI;54145290842;Taip;0;21;0;21
2911;Gintarėlis;KAČIUKAI;98684742007;Taip;0;21;0;21
2912;Gintarėlis;KAČIUKAI;2000986290;Taip;0;15;1;16
2913;Gintarėlis;KAČIUKAI;8860898577;Taip;0;0;3;3
2914;Gintarėlis;KAČIUKAI;6421537455;Taip;0;21;0;21
2915;Gintarėlis;KAČIUKAI;1595816431;Taip;0;3;0;3
2916;Gintarėlis;KAČIUKAI;30446888177;Taip;5;0;0;5
2917;Gintarėlis;KAČIUKAI;63221497564;Taip;0;8;0;8
2918;Gintarėlis;KAČIUKAI;81135362098;Taip;0;0;1;1
2919;Gintarėlis;KAČIUKAI;58701768194;Taip;0;3;0;3
2920;Gintarėlis;KAČIUKAI;29480359781;Taip;0;1;8;9
2921;Gintarėlis;KIŠKUČIAI;8665467175;Taip;6;2;1;9
2922;Gintarėlis;KIŠKUČIAI;83754732536;Taip;0;3;0;3
2923;Gintarėlis;KIŠKUČIAI;89051269756;Taip;0;1;0;1
2924;Gintarėlis;KIŠKUČIAI;1593455162;Taip;0;7;0;7
2925;Gintarėlis;KIŠKUČIAI;2043405414;Taip;0;10;0;10
2926;Gintarėlis;KIŠKUČIAI;3828845515;Taip;0;1;0;1
2927;Gintarėlis;KIŠKUČIAI;1069395570;Taip;5;0;0;5
2928;Gintarėlis;KIŠKUČIAI;19402011412;Taip;0;2;0;2
2929;Gintarėlis;KIŠKUČIAI;96211766919;Taip;0;2;0;2
2930;Gintarėlis;KIŠKUČIAI;78697777550;Taip;0;0;1;1
2931;Gintarėlis;KIŠKUČIAI;85557344192;Taip;5;1;0;6
2932;Gintarėlis;KIŠKUČIAI;2970527490;Taip;0;2;0;2
2933;Gintarėlis;KIŠKUČIAI;4279681763;Taip;0;0;1;1
2934;Gintarėlis;KIŠKUČIAI;1868431609;Taip;0;2;6;8
2935;Gintarėlis;KIŠKUČIAI;2032900352;Taip;13;0;0;13
2936;Gintarėlis;KIŠKUČIAI;3292572563;Taip;5;5;0;10
2937;Gintarėlis;KIŠKUČIAI;1543013649;Taip;9;5;0;14
2938;Gintarėlis;KIŠKUČIAI;1028456578;Taip;1;0;1;2
2939;Gintarėlis;VYTURIUKAI;1553747935;Taip;11;3;0;14
2940;Gintarėlis;VYTURIUKAI;22394648690;Taip;0;0;2;2
2941;Gintarėlis;VYTURIUKAI;4902086873;Taip;10;0;0;10
2942;Gintarėlis;VYTURIUKAI;56124970238;Taip;5;0;1;6
2943;Gintarėlis;VYTURIUKAI;34606130829;Taip;3;2;0;5
2944;Gintarėlis;VYTURIUKAI;18715625324;Taip;15;0;0;15
2945;Gintarėlis;VYTURIUKAI;1191846491;Taip;2;0;0;2
2946;Gintarėlis;VYTURIUKAI;9740239182;Taip;0;2;0;2
2947;Gintarėlis;VYTURIUKAI;2036488789;Taip;10;0;1;11
2948;Gintarėlis;VYTURIUKAI;2721386855;Taip;5;0;1;6
2949;Gintarėlis;BORUŽĖLĖS;6277010268;Taip;0;10;0;10
2950;Gintarėlis;BORUŽĖLĖS;1771868868;Taip;0;5;0;5
2951;Gintarėlis;BORUŽĖLĖS;39372328122;Taip;5;0;0;5
2952;Gintarėlis;BORUŽĖLĖS;25451522701;Taip;4;2;1;7
2953;Gintarėlis;BORUŽĖLĖS;90216120878;Taip;0;19;0;19
2954;Gintarėlis;BORUŽĖLĖS;1929900615;Taip;10;6;0;16
2955;Gintarėlis;BORUŽĖLĖS;82344200095;Taip;0;5;0;5
2956;Gintarėlis;BORUŽĖLĖS;1168158494;Taip;0;2;0;2
2957;Gintarėlis;BORUŽĖLĖS;9255623049;Taip;0;17;0;17
2958;Gintarėlis;BORUŽĖLĖS;88451515187;Taip;0;6;0;6
2959;Gintarėlis;BORUŽĖLĖS;2145479870;Taip;1;1;0;2
2960;Gintarėlis;BORUŽĖLĖS;10001742134;Taip;6;0;0;6
2961;Gintarėlis;BORUŽĖLĖS;63146841406;Taip;0;21;0;21
2962;Gintarėlis;BORUŽĖLĖS;30334064319;Taip;0;2;0;2
2963;Gintarėlis;BORUŽĖLĖS;91798408335;Taip;6;14;0;20
2964;Gintarėlis;BORUŽĖLĖS;25684002087;Taip;0;5;0;5
2965;Gintarėlis;BORUŽĖLĖS;10826255781;Taip;0;6;0;6
2966;Gintarėlis;BORUŽĖLĖS;1505703905;Taip;5;0;0;5
2967;Gintarėlis;EŽIUKAI;1793785936;Taip;8;0;1;9
2968;Gintarėlis;EŽIUKAI;96812991513;Taip;11;1;0;12
2969;Gintarėlis;EŽIUKAI;27890184523;Taip;5;6;0;11
2970;Gintarėlis;EŽIUKAI;1841482183;Taip;0;0;1;1
2971;Gintarėlis;EŽIUKAI;8074941282;Taip;1;2;2;5
2972;Gintarėlis;EŽIUKAI;2040989572;Taip;0;2;3;5
2973;Gintarėlis;EŽIUKAI;18008015227;Taip;3;0;0;3
2974;Gintarėlis;EŽIUKAI;1312688961;Taip;13;0;1;14
2975;Gintarėlis;EŽIUKAI;1672037617;Taip;0;3;3;6
2976;Gintarėlis;EŽIUKAI;1398810524;Taip;1;0;0;1
2977;Gintarėlis;EŽIUKAI;74295947670;Taip;0;1;0;1
2978;Gintarėlis;EŽIUKAI;52644122529;Taip;0;1;0;1
2979;Gintarėlis;EŽIUKAI;2732338838;Taip;0;1;0;1
2980;Gintarėlis;EŽIUKAI;7731823367;Taip;0;1;0;1
2981;Gintarėlis;EŽIUKAI;56834651967;Taip;6;15;0;21
2982;Gintarėlis;EŽIUKAI;9705808868;Taip;0;1;0;1
2983;Gintarėlis;EŽIUKAI;13416505188;Taip;1;0;0;1
2984;Gintarėlis;EŽIUKAI;36350623756;Taip;0;13;2;15
2985;Gintarėlis;EŽIUKAI;96404879029;Taip;0;7;0;7
2986;Gintarėlis;EŽIUKAI;1725007540;Ne;5;0;1;6
2987;Gintarėlis;VIŠČIUKAI;7494884360;Taip;0;8;0;8
2988;Gintarėlis;VIŠČIUKAI;5783939567;Taip;0;0;2;2
2989;Gintarėlis;VIŠČIUKAI;8064521864;Taip;2;0;1;3
2990;Gintarėlis;VIŠČIUKAI;8913652291;Taip;5;0;2;7
2991;Gintarėlis;VIŠČIUKAI;1033624080;Taip;6;0;2;8
2992;Gintarėlis;VIŠČIUKAI;2919700367;Taip;0;0;21;21
2993;Gintarėlis;VIŠČIUKAI;1768789948;Taip;14;0;0;14
2994;Gintarėlis;VIŠČIUKAI;9494521554;Taip;0;14;0;14
2995;Gintarėlis;VIŠČIUKAI;7147842224;Taip;0;0;9;9
2996;Gintarėlis;VIŠČIUKAI;2485750596;Taip;7;0;1;8
2997;Gintarėlis;VIŠČIUKAI;2595566032;Taip;0;1;0;1
2998;Gintarėlis;VIŠČIUKAI;9141438560;Taip;0;1;0;1
2999;Gintarėlis;VIŠČIUKAI;9648982613;Taip;9;0;4;13
3000;Gintarėlis;VIŠČIUKAI;6292664833;Taip;0;0;2;2
3001;Gintarėlis;"SAULĖS ZUIKUČIAI";8287685690;Taip;0;10;0;10
3002;Gintarėlis;"SAULĖS ZUIKUČIAI";6914904213;Taip;10;2;0;12
3003;Gintarėlis;"SAULĖS ZUIKUČIAI";1696337909;Taip;10;2;0;12
3004;Gintarėlis;"SAULĖS ZUIKUČIAI";1778573935;Taip;6;1;0;7
3005;Gintarėlis;"SAULĖS ZUIKUČIAI";5796729245;Taip;1;4;0;5
3006;Gintarėlis;"SAULĖS ZUIKUČIAI";9915887420;Taip;1;4;0;5
3007;Gintarėlis;"SAULĖS ZUIKUČIAI";3398936974;Taip;5;0;0;5
3008;Gintarėlis;"SAULĖS ZUIKUČIAI";5153948767;Taip;0;2;1;3
3009;Gintarėlis;"SAULĖS ZUIKUČIAI";9675201979;Taip;6;0;1;7
3010;Gintarėlis;"SAULĖS ZUIKUČIAI";7971810025;Taip;3;0;0;3
3011;Gintarėlis;"SAULĖS ZUIKUČIAI";2814569415;Taip;0;0;4;4
3012;Gintarėlis;"SAULĖS ZUIKUČIAI";6862629244;Taip;10;0;0;10
3013;Gintarėlis;"SAULĖS ZUIKUČIAI";9279399214;Taip;1;2;0;3
3014;Gintarėlis;"SAULĖS ZUIKUČIAI";8000297636;Taip;3;1;1;5
3015;Gintarėlis;"SAULĖS ZUIKUČIAI";6142819210;Taip;0;0;5;5
3016;Gintarėlis;"SAULĖS ZUIKUČIAI";3359584322;Taip;0;12;0;12
3017;Gintarėlis;"SAULĖS ZUIKUČIAI";7815317644;Taip;0;0;8;8
3018;Giraitė;Aviliukas;67009533810;Taip;0;1;0;1
3019;Giraitė;Aviliukas;62525988158;Taip;0;3;0;3
3020;Giraitė;Aviliukas;68804588518;Taip;0;14;0;14
3021;Giraitė;Aviliukas;809734624;Taip;10;2;0;12
3022;Giraitė;Aviliukas;44396075745;Taip;0;5;0;5
3023;Giraitė;Aviliukas;42330865487;Taip;0;1;0;1
3024;Giraitė;Aviliukas;1139666539;Ne;13;0;1;14
3025;Giraitė;Aviliukas;39627499338;Taip;0;1;0;1
3026;Giraitė;Aviliukas;86412433313;Taip;0;0;3;3
3027;Giraitė;Aviliukas;10778161174;Taip;0;1;0;1
3028;Giraitė;Aviliukas;90920588960;Taip;0;1;0;1
3029;Giraitė;Aviliukas;6449275481;Taip;10;0;2;12
3030;Giraitė;Aviliukas;12568042778;Taip;9;0;0;9
3031;Giraitė;Aviliukas;45633008605;Taip;0;11;0;11
3032;Giraitė;Aviliukas;24903085449;Taip;0;2;0;2
3033;Giraitė;Aviliukas;7868564343;Taip;13;0;0;13
3034;Giraitė;Aviliukas;6084454238;Taip;0;17;0;17
3035;Giraitė;LapiukaI;1285310492;Taip;1;0;0;1
3036;Giraitė;LapiukaI;17883856522;Taip;7;1;1;9
3037;Giraitė;LapiukaI;1690407683;Taip;9;0;0;9
3038;Giraitė;LapiukaI;87139343254;Taip;0;1;0;1
3039;Giraitė;LapiukaI;1146337878;Taip;6;0;4;10
3040;Giraitė;LapiukaI;1424661991;Taip;0;0;1;1
3041;Giraitė;LapiukaI;9710265790;Taip;9;0;0;9
3042;Giraitė;LapiukaI;26202357668;Taip;3;1;0;4
3043;Giraitė;LapiukaI;260305509;Taip;8;0;0;8
3044;Giraitė;LapiukaI;84373081236;Taip;11;0;0;11
3045;Giraitė;LapiukaI;89948210310;Taip;0;3;0;3
3046;Giraitė;Voveriukai;83995022535;Taip;0;1;2;3
3047;Giraitė;Voveriukai;62684217934;Taip;0;0;1;1
3048;Giraitė;Voveriukai;19151459055;Taip;0;0;3;3
3049;Giraitė;Voveriukai;70629522964;Taip;21;0;0;21
3050;Giraitė;Voveriukai;10070775660;Taip;0;1;0;1
3051;Giraitė;Voveriukai;68502311448;Taip;0;0;1;1
3052;Giraitė;Voveriukai;34413917793;Taip;0;1;0;1
3053;Giraitė;Voveriukai;482311593;Taip;21;0;0;21
3054;Giraitė;Voveriukai;19218675078;Ne;5;0;0;5
3055;Giraitė;Voveriukai;61477798910;Taip;0;0;3;3
3056;Giraitė;Voveriukai;20082610200;Taip;0;5;0;5
3057;Giraitė;Voveriukai;98106730833;Taip;0;1;4;5
3058;Giraitė;Voveriukai;2107606245;Taip;0;1;1;2
3059;Giraitė;Voveriukai;2816941652;Taip;0;1;0;1
3060;Giraitė;Voveriukai;1313395982;Taip;0;5;0;5
3061;Giraitė;Voveriukai;5824936903;Taip;0;1;1;2
3062;Giraitė;Voveriukai;6159111262;Taip;3;0;0;3
3063;Giraitė;Voveriukai;1965752607;Taip;0;0;2;2
3064;Giraitė;Voveriukai;70668076883;Taip;0;1;2;3
3065;Giraitė;Grybukai;82326314822;Taip;0;1;6;7
3066;Giraitė;Grybukai;64804371570;Taip;4;1;1;6
3067;Giraitė;Grybukai;54865651920;Taip;0;1;1;2
3068;Giraitė;Grybukai;2088558056;Taip;0;0;8;8
3069;Giraitė;Grybukai;47716066947;Taip;0;0;2;2
3070;Giraitė;Grybukai;61377720550;Taip;7;0;0;7
3071;Giraitė;Grybukai;70833551710;Taip;5;1;0;6
3072;Giraitė;Grybukai;40223017870;Taip;0;1;4;5
3073;Giraitė;Grybukai;98893791966;Taip;0;5;0;5
3074;Giraitė;Grybukai;90085776538;Taip;0;1;0;1
3075;Giraitė;Grybukai;38156994332;Taip;0;2;0;2
3076;Giraitė;Grybukai;1791880914;Taip;0;0;12;12
3077;Giraitė;Grybukai;17033130522;Taip;0;0;1;1
3078;Giraitė;Grybukai;47131903191;Taip;0;3;0;3
3079;Giraitė;Grybukai;16962877902;Taip;0;3;0;3
3080;Giraitė;Grybukai;1878433552;Taip;2;0;0;2
3081;Giraitė;Grybukai;43596280059;Taip;10;0;0;10
3082;Giraitė;Riešutėliai;3683700626;Taip;12;0;0;12
3083;Giraitė;Riešutėliai;8596389737;Taip;0;0;1;1
3084;Giraitė;Riešutėliai;5167002022;Taip;1;0;3;4
3085;Giraitė;Riešutėliai;2425354598;Taip;8;0;0;8
3086;Giraitė;Riešutėliai;5892950503;Taip;5;1;0;6
3087;Giraitė;Riešutėliai;4336519836;Taip;5;0;1;6
3088;Giraitė;Riešutėliai;9026736929;Taip;5;0;0;5
3089;Giraitė;Riešutėliai;9882372025;Taip;8;0;1;9
3090;Giraitė;Riešutėliai;5721669627;Taip;0;0;2;2
3091;Giraitė;Riešutėliai;5029839281;Ne;10;0;0;10
3092;Giraitė;Riešutėliai;3091067158;Taip;0;0;1;1
3093;Giraitė;Riešutėliai;23319979302;Taip;5;0;4;9
3094;Giraitė;Riešutėliai;4785524898;Taip;6;0;1;7
3095;Giraitė;Riešutėliai;8869728241;Taip;5;0;0;5
3096;Giraitė;Riešutėliai;4839351300;Taip;10;2;4;16
3097;Giraitė;Riešutėliai;1817075429;Taip;7;0;5;12
3098;Giraitė;Riešutėliai;6836412890;Taip;14;0;0;14
3099;Giraitė;Riešutėliai;9224845723;Taip;9;0;0;9
3100;Giraitė;Riešutėliai;4687228561;Taip;20;0;0;20
3101;Giraitė;Riešutėliai;9652807467;Taip;3;0;0;3
3102;Giraitė;Meškiukai;27501094616;Taip;5;7;0;12
3103;Giraitė;Meškiukai;2513312448;Taip;0;3;0;3
3104;Giraitė;Meškiukai;5367392810;Taip;10;0;0;10
3105;Giraitė;Meškiukai;1608876140;Taip;2;0;0;2
3106;Giraitė;Meškiukai;5461837332;Taip;4;0;0;4
3107;Giraitė;Meškiukai;1355594003;Taip;12;0;0;12
3108;Giraitė;Meškiukai;1560868105;Taip;0;1;0;1
3109;Giraitė;Meškiukai;1050699551;Taip;16;0;0;16
3110;Giraitė;Meškiukai;1876815077;Taip;0;1;0;1
3111;Giraitė;Meškiukai;1063628206;Taip;8;0;0;8
3112;Giraitė;Meškiukai;1318214394;Taip;10;0;0;10
3113;Giraitė;Meškiukai;1846118720;Taip;0;3;0;3
3114;Giraitė;Meškiukai;9195735923;Taip;10;0;2;12
3115;Giraitė;Meškiukai;1704154980;Taip;6;1;0;7
3116;Giraitė;Meškiukai;1512384599;Taip;8;0;0;8
3117;Giraitė;Meškiukai;2571892050;Taip;14;0;2;16
3118;Giraitė;Meškiukai;5544613599;Taip;15;0;0;15
3119;Giraitė;Meškiukai;6156715234;Taip;0;0;4;4
3120;Giraitė;Meškiukai;1594965200;Taip;21;0;0;21
3121;Giraitė;Meškiukai;9723242940;Taip;11;0;0;11
3122;Giraitė;Meškiukai;5726182600;Taip;12;0;0;12
3123;Giraitė;Meškiukai;1772790396;Taip;13;0;0;13
3124;Giraitė;Uogelės;3031181239;Taip;11;0;0;11
3125;Giraitė;Uogelės;99494458394;Taip;0;4;0;4
3126;Giraitė;Uogelės;1103462199;Taip;0;1;0;1
3127;Giraitė;Uogelės;1447893912;Taip;0;2;0;2
3128;Giraitė;Uogelės;49193108666;Ne;10;2;0;12
3129;Giraitė;Uogelės;1312761239;Taip;0;1;0;1
3130;Giraitė;Uogelės;30804922053;Taip;11;4;0;15
3131;Giraitė;Uogelės;2083472940;Taip;16;0;0;16
3132;Giraitė;Uogelės;5378240128;Taip;5;8;0;13
3133;Giraitė;Uogelės;40696452801;Taip;0;2;0;2
3134;Giraitė;Uogelės;43468579365;Taip;1;0;1;2
3135;Giraitė;Uogelės;74256775397;Taip;9;0;0;9
3136;Giraitė;Uogelės;65392345188;Taip;0;3;0;3
3137;Giraitė;Uogelės;7779733510;Taip;7;1;0;8
3138;Giraitė;Uogelės;1110792632;Taip;5;0;2;7
3139;Giraitė;Šaltinėlis;83173577451;Taip;0;3;0;3
3140;Giraitė;Šaltinėlis;89112366792;Taip;5;0;0;5
3141;Giraitė;Šaltinėlis;29823126743;Ne;1;0;0;1
3142;Giraitė;Šaltinėlis;85943562009;Taip;0;10;0;10
3143;Giraitė;Šaltinėlis;8636782322;Taip;0;1;0;1
3144;Giraitė;Šaltinėlis;29419658963;Taip;0;2;0;2
3145;Giraitė;Šaltinėlis;23443952589;Taip;6;0;6;12
3146;Giraitė;Šaltinėlis;75752125046;Taip;0;1;0;1
3147;Giraitė;Šaltinėlis;13537474624;Taip;0;8;0;8
3148;Giraitė;Šaltinėlis;74821326426;Taip;3;2;0;5
3149;Giraitė;Šaltinėlis;78338863066;Taip;0;1;0;1
3150;Giraitė;Šaltinėlis;5106092595;Taip;5;0;0;5
3151;Giraitė;Šaltinėlis;18070708999;Taip;0;1;0;1
3152;Giraitė;Šaltinėlis;83199904684;Taip;0;2;0;2
3153;Giraitė;Šaltinėlis;72098612565;Taip;0;2;1;3
3154;Giraitė;Šaltinėlis;55816174362;Taip;0;1;1;2
3155;Giraitė;Šaltinėlis;94197982724;Taip;0;5;0;5
3156;Giraitė;Šaltinėlis;25319015890;Taip;0;1;4;5
3157;Giraitė;Boružėlės;5438716880;Taip;11;1;0;12
3158;Giraitė;Boružėlės;4055450300;Taip;11;0;0;11
3159;Giraitė;Boružėlės;4387282125;Taip;0;2;0;2
3160;Giraitė;Boružėlės;2074303013;Taip;11;0;0;11
3161;Giraitė;Boružėlės;7354834895;Taip;12;0;0;12
3162;Giraitė;Boružėlės;4822168634;Taip;1;0;1;2
3163;Giraitė;Boružėlės;2088867630;Taip;5;0;0;5
3164;Giraitė;Boružėlės;3875214088;Taip;14;0;0;14
3165;Giraitė;Boružėlės;7481895278;Taip;2;0;0;2
3166;Giraitė;Boružėlės;3607198556;Taip;0;2;0;2
3167;Giraitė;Boružėlės;1945918102;Taip;6;0;0;6
3168;Giraitė;Boružėlės;2699984170;Taip;1;3;0;4
3169;Giraitė;Boružėlės;6265908751;Taip;1;0;0;1
3170;Giraitė;Boružėlės;5202562049;Taip;6;0;0;6
3171;Giraitė;Gandriukai;69883334049;Taip;11;0;0;11
3172;Giraitė;Gandriukai;1025627643;Taip;0;5;2;7
3173;Giraitė;Gandriukai;7547897354;Taip;5;0;0;5
3174;Giraitė;Gandriukai;26032013284;Taip;6;1;0;7
3175;Giraitė;Gandriukai;36650870278;Taip;10;1;0;11
3176;Giraitė;Gandriukai;82915040164;Taip;6;1;0;7
3177;Giraitė;Gandriukai;18968645937;Taip;0;0;1;1
3178;Giraitė;Gandriukai;64357457379;Taip;10;0;1;11
3179;Giraitė;Gandriukai;1022899992;Taip;5;0;0;5
3180;Giraitė;Gandriukai;1238299747;Taip;16;0;0;16
3181;Giraitė;Gandriukai;2016939046;Taip;0;1;0;1
3182;Giraitė;Gandriukai;1054132082;Taip;0;0;1;1
3183;Giraitė;Gandriukai;5081903157;Taip;6;5;0;11
3184;Giraitė;Gandriukai;8941330547;Taip;0;5;0;5
3185;Giraitė;Gandriukai;5759367884;Taip;0;2;2;4
3186;Giraitė;Gandriukai;1111614295;Taip;10;4;0;14
3187;Giraitė;Gandriukai;1434737480;Taip;11;0;0;11
3188;Giraitė;ŽVIRBLIUKAI;4444292550;Taip;6;0;1;7
3189;Giraitė;ŽVIRBLIUKAI;1958553421;Taip;0;0;6;6
3190;Giraitė;ŽVIRBLIUKAI;77765768952;Taip;5;3;0;8
3191;Giraitė;ŽVIRBLIUKAI;56380808064;Taip;5;7;0;12
3192;Giraitė;ŽVIRBLIUKAI;1730588815;Taip;0;1;0;1
3193;Giraitė;ŽVIRBLIUKAI;1641872824;Taip;9;0;0;9
3194;Giraitė;ŽVIRBLIUKAI;1234136698;Taip;0;0;2;2
3195;Giraitė;ŽVIRBLIUKAI;2065944230;Taip;4;0;0;4
3196;Giraitė;ŽVIRBLIUKAI;1858146807;Taip;0;0;1;1
3197;Giraitė;ŽVIRBLIUKAI;1464444782;Taip;5;0;2;7
3198;Giraitė;ŽVIRBLIUKAI;1435017557;Taip;7;0;1;8
3199;Giraitė;ŽVIRBLIUKAI;1149254911;Taip;5;3;0;8
3200;Giraitė;ŽVIRBLIUKAI;1284187551;Taip;0;1;0;1
3201;Giraitė;ŽVIRBLIUKAI;48291239027;Taip;16;0;0;16
3202;Giraitė;ŽVIRBLIUKAI;3628448974;Taip;11;3;0;14
3203;Giraitė;ŽVIRBLIUKAI;8020051188;Taip;0;0;1;1
3204;Giraitė;ŽVIRBLIUKAI;6197641912;Taip;11;0;0;11
3205;Giraitė;Kiškeliai;4076402180;Taip;4;0;0;4
3206;Giraitė;Kiškeliai;5902161665;Taip;9;2;0;11
3207;Giraitė;Kiškeliai;7551981095;Taip;7;0;0;7
3208;Giraitė;Kiškeliai;5532639133;Taip;0;1;0;1
3209;Giraitė;Kiškeliai;4296449093;Taip;10;1;0;11
3210;Giraitė;Kiškeliai;1974159110;Taip;3;0;0;3
3211;Giraitė;Kiškeliai;1583733838;Taip;10;0;0;10
3212;Giraitė;Kiškeliai;4009092043;Taip;3;2;1;6
3213;Giraitė;Kiškeliai;7919088987;Taip;15;0;0;15
3214;Giraitė;Kiškeliai;8376809208;Taip;10;0;0;10
3215;Giraitė;Kiškeliai;5616242311;Taip;5;0;0;5
3216;Giraitė;Kiškeliai;9728453316;Taip;0;0;1;1
3217;Giraitė;Kiškeliai;4272999339;Taip;5;0;1;6
3218;Giraitė;Kiškeliai;9392127689;Taip;11;0;1;12
3219;Gudrutis;Gandriukų;38591847769;Taip;0;2;0;2
3220;Gudrutis;Gandriukų;33123804925;Taip;10;0;0;10
3221;Gudrutis;Gandriukų;21999129886;Taip;0;1;0;1
3222;Gudrutis;Gandriukų;69437346100;Taip;0;5;0;5
3223;Gudrutis;Gandriukų;71306450171;Taip;4;0;0;4
3224;Gudrutis;Gandriukų;85886111222;Taip;4;0;0;4
3225;Gudrutis;Gandriukų;1261390117;Taip;13;1;0;14
3226;Gudrutis;Gandriukų;15665148606;Taip;0;8;0;8
3227;Gudrutis;Gandriukų;1013150817;Taip;0;1;0;1
3228;Gudrutis;Gandriukų;1174040508;Taip;0;1;2;3
3229;Gudrutis;Gandriukų;13755502342;Taip;0;2;0;2
3230;Gudrutis;Gandriukų;1436950588;Taip;3;0;0;3
3231;Gudrutis;Gandriukų;35401545938;Taip;6;0;0;6
3232;Gudrutis;Gandriukų;3363640861;Taip;0;2;0;2
3233;Gudrutis;Gandriukų;70107420346;Taip;0;1;0;1
3234;Gudrutis;Gandriukų;62735575539;Taip;0;9;0;9
3235;Gudrutis;Gandriukų;6824283429;Taip;5;0;0;5
3236;Gudrutis;"Saulės zuikučių";2453989647;Taip;5;0;0;5
3237;Gudrutis;"Saulės zuikučių";1434565790;Taip;4;0;1;5
3238;Gudrutis;"Saulės zuikučių";1204945185;Taip;0;5;1;6
3239;Gudrutis;"Saulės zuikučių";1389133303;Taip;0;1;0;1
3240;Gudrutis;"Saulės zuikučių";77776725399;Taip;0;2;0;2
3241;Gudrutis;"Saulės zuikučių";21494647270;Taip;0;5;0;5
3242;Gudrutis;"Saulės zuikučių";87981934125;Taip;5;0;0;5
3243;Gudrutis;"Saulės zuikučių";1998630017;Taip;0;0;5;5
3244;Gudrutis;"Saulės zuikučių";1823786522;Taip;0;2;0;2
3245;Gudrutis;"Saulės zuikučių";74605225026;Taip;5;0;0;5
3246;Gudrutis;"Saulės zuikučių";4392872175;Taip;0;1;2;3
3247;Gudrutis;"Saulės zuikučių";11383212272;Taip;0;3;0;3
3248;Gudrutis;"Saulės zuikučių";1156575830;Taip;0;1;1;2
3249;Gudrutis;"Saulės zuikučių";1490739175;Taip;6;0;8;14
3250;Gudrutis;"Saulės zuikučių";8128313792;Taip;0;0;4;4
3251;Gudrutis;"Saulės zuikučių";8768627605;Taip;5;1;5;11
3252;Gudrutis;"Saulės zuikučių";18320321051;Taip;6;0;0;6
3253;Gudrutis;Pelėdžiukų;2012092629;Taip;0;0;16;16
3254;Gudrutis;Pelėdžiukų;28075147728;Taip;0;0;5;5
3255;Gudrutis;Pelėdžiukų;21178331458;Taip;5;0;1;6
3256;Gudrutis;Pelėdžiukų;46232665673;Taip;0;0;3;3
3257;Gudrutis;Pelėdžiukų;18813895572;Taip;0;1;0;1
3258;Gudrutis;Pelėdžiukų;14779917423;Taip;6;0;0;6
3259;Gudrutis;Pelėdžiukų;2579697941;Taip;4;0;2;6
3260;Gudrutis;Pelėdžiukų;54019097027;Taip;0;11;0;11
3261;Gudrutis;Pelėdžiukų;79189562476;Ne;0;1;6;7
3262;Gudrutis;Pelėdžiukų;77718940253;Taip;0;1;0;1
3263;Gudrutis;Pelėdžiukų;3970404528;Taip;0;7;0;7
3264;Gudrutis;Pelėdžiukų;98473509715;Taip;0;0;4;4
3265;Gudrutis;Pelėdžiukų;1049398501;Taip;1;0;0;1
3266;Gudrutis;Pelėdžiukų;16404432728;Taip;0;0;6;6
3267;Gudrutis;Pelėdžiukų;81252457503;Taip;6;1;0;7
3268;Gudrutis;Pelėdžiukų;1340947103;Taip;14;0;0;14
3269;Gudrutis;Pelėdžiukų;7632549677;Ne;0;0;2;2
3270;Gudrutis;Pelėdžiukų;1464768624;Taip;5;0;1;6
3271;Gudrutis;BITUČIŲ;4125420913;Taip;0;1;2;3
3272;Gudrutis;BITUČIŲ;35630338758;Taip;0;1;0;1
3273;Gudrutis;BITUČIŲ;13495334557;Taip;4;2;0;6
3274;Gudrutis;BITUČIŲ;29816980468;Taip;0;1;0;1
3275;Gudrutis;BITUČIŲ;59378091248;Taip;0;5;0;5
3276;Gudrutis;BITUČIŲ;26020212688;Taip;0;0;1;1
3277;Gudrutis;BITUČIŲ;84586752341;Taip;3;0;0;3
3278;Gudrutis;BITUČIŲ;47141496535;Taip;0;0;2;2
3279;Gudrutis;BITUČIŲ;1264146375;Taip;0;1;0;1
3280;Gudrutis;BITUČIŲ;7838753258;Taip;0;0;2;2
3281;Gudrutis;BITUČIŲ;83200430763;Taip;0;1;0;1
3282;Gudrutis;BITUČIŲ;1042589663;Taip;0;3;0;3
3283;Gudrutis;BITUČIŲ;41945603137;Taip;0;5;0;5
3284;Gudrutis;BITUČIŲ;58999949883;Taip;0;2;0;2
3285;Gudrutis;BITUČIŲ;65712774270;Taip;0;0;2;2
3286;Gudrutis;BITUČIŲ;61452187923;Taip;4;0;0;4
3287;Gudrutis;BITUČIŲ;30787734143;Taip;3;0;0;3
3288;Gudrutis;BITUČIŲ;36492561410;Taip;0;0;2;2
3289;Gudrutis;Boružėlių;6747372184;Taip;5;0;1;6
3290;Gudrutis;Boružėlių;3888849808;Taip;0;0;5;5
3291;Gudrutis;Boružėlių;1190408818;Taip;0;0;16;16
3292;Gudrutis;Boružėlių;2431077357;Taip;0;1;0;1
3293;Gudrutis;Boružėlių;4193661251;Taip;3;0;0;3
3294;Gudrutis;Boružėlių;7116979528;Taip;0;0;3;3
3295;Gudrutis;Boružėlių;3363824185;Taip;0;2;0;2
3296;Gudrutis;Boružėlių;3359028602;Taip;0;6;2;8
3297;Gudrutis;Boružėlių;1693306014;Taip;0;6;0;6
3298;Gudrutis;Boružėlių;9042793284;Taip;0;11;1;12
3299;Gudrutis;Boružėlių;4945755164;Taip;5;3;1;9
3300;Gudrutis;Boružėlių;2074151024;Taip;0;0;4;4
3301;Gudrutis;Boružėlių;1445657342;Taip;0;1;0;1
3302;Gudrutis;Boružėlių;5574287734;Taip;0;0;3;3
3303;Gudrutis;Boružėlių;9841172472;Taip;13;0;1;14
3304;Gudrutis;Drugeliai;5580618896;Taip;0;0;10;10
3305;Gudrutis;Drugeliai;7871991275;Taip;0;0;10;10
3306;Gudrutis;Drugeliai;4612995336;Taip;2;0;1;3
3307;Gudrutis;Drugeliai;2197278086;Taip;0;0;1;1
3308;Gudrutis;Drugeliai;6731806925;Taip;3;1;0;4
3309;Gudrutis;Drugeliai;9701111916;Taip;0;9;0;9
3310;Gudrutis;Drugeliai;1228190677;Taip;0;0;2;2
3311;Gudrutis;Drugeliai;6198012431;Taip;6;1;4;11
3312;Gudrutis;Drugeliai;3646335609;Taip;0;0;4;4
3313;Gudrutis;Drugeliai;3625838131;Taip;0;5;0;5
3314;Gudrutis;Drugeliai;5097101097;Taip;5;0;0;5
3315;Gudrutis;Drugeliai;2337493193;Taip;0;5;0;5
3316;Gudrutis;Drugeliai;2764843216;Taip;9;0;0;9
3317;Jurginėlis;Ąžuoliukai;8217773164;Taip;0;7;0;7
3318;Jurginėlis;Ąžuoliukai;29155768493;Taip;9;0;0;9
3319;Jurginėlis;Ąžuoliukai;1591501789;Taip;0;9;0;9
3320;Jurginėlis;Ąžuoliukai;75192831969;Taip;0;11;0;11
3321;Jurginėlis;Ąžuoliukai;67578476769;Taip;0;17;0;17
3322;Jurginėlis;Ąžuoliukai;10095155757;Taip;0;3;0;3
3323;Jurginėlis;Ąžuoliukai;7798931951;Taip;15;2;0;17
3324;Jurginėlis;Ąžuoliukai;92559573466;Taip;0;12;0;12
3325;Jurginėlis;Ąžuoliukai;29601247012;Taip;0;1;0;1
3326;Jurginėlis;Ąžuoliukai;56382554421;Taip;0;5;0;5
3327;Jurginėlis;Ąžuoliukai;75958769515;Taip;0;3;0;3
3328;Jurginėlis;Ąžuoliukai;59618430487;Taip;0;4;0;4
3329;Jurginėlis;Ąžuoliukai;51856181602;Taip;0;3;0;3
3330;Jurginėlis;Ąžuoliukai;64852957209;Taip;0;1;0;1
3331;Jurginėlis;Ąžuoliukai;23049094719;Taip;0;5;0;5
3332;Jurginėlis;Ąžuoliukai;1742217696;Taip;12;0;0;12
3333;Jurginėlis;Ąžuoliukai;8423424896;Taip;0;8;0;8
3334;Jurginėlis;Žiogeliai;1421681717;Taip;6;0;1;7
3335;Jurginėlis;Žiogeliai;64524305038;Taip;0;7;0;7
3336;Jurginėlis;Žiogeliai;60988201430;Taip;0;1;0;1
3337;Jurginėlis;Žiogeliai;85888481045;Taip;2;0;1;3
3338;Jurginėlis;Žiogeliai;96017651718;Taip;5;1;0;6
3339;Jurginėlis;Žiogeliai;92688596347;Taip;0;17;0;17
3340;Jurginėlis;Žiogeliai;84691244839;Taip;0;2;0;2
3341;Jurginėlis;Žiogeliai;87566883270;Taip;0;6;0;6
3342;Jurginėlis;Žiogeliai;1175198086;Taip;0;5;0;5
3343;Jurginėlis;Žiogeliai;1058274970;Taip;0;0;21;21
3344;Jurginėlis;Žiogeliai;53783266582;Taip;0;1;0;1
3345;Jurginėlis;Žiogeliai;24615714793;Taip;10;6;0;16
3346;Jurginėlis;Žiogeliai;90786336005;Taip;6;0;0;6
3347;Jurginėlis;Žiogeliai;1041294212;Taip;8;0;0;8
3348;Jurginėlis;Žiogeliai;1191021311;Taip;0;0;1;1
3349;Jurginėlis;Pelėdžiukų;49181526821;Taip;1;0;0;1
3350;Jurginėlis;Pelėdžiukų;35653034443;Taip;0;1;0;1
3351;Jurginėlis;Pelėdžiukų;59935106302;Taip;0;0;2;2
3352;Jurginėlis;Pelėdžiukų;91317327949;Taip;0;0;1;1
3353;Jurginėlis;Pelėdžiukų;52877525045;Taip;0;5;0;5
3354;Jurginėlis;Pelėdžiukų;97726131559;Taip;3;0;0;3
3355;Jurginėlis;Pelėdžiukų;2544904907;Taip;21;0;0;21
3356;Jurginėlis;Pelėdžiukų;8414893303;Taip;0;5;0;5
3357;Jurginėlis;Pelėdžiukų;7449558199;Taip;4;0;0;4
3358;Jurginėlis;Pelėdžiukų;54494144846;Taip;7;6;0;13
3359;Jurginėlis;Pelėdžiukų;6072633581;Taip;0;14;0;14
3360;Jurginėlis;Pelėdžiukų;57340494605;Taip;20;0;0;20
3361;Jurginėlis;Pelėdžiukų;7278855565;Taip;0;0;5;5
3362;Jurginėlis;Pelėdžiukų;1295024976;Taip;5;0;0;5
3363;Jurginėlis;Pelėdžiukų;85293469079;Taip;3;0;1;4
3364;Jurginėlis;Boružėlių;63355660135;Taip;0;5;0;5
3365;Jurginėlis;Boružėlių;64840404890;Taip;3;2;0;5
3366;Jurginėlis;Boružėlių;39360122004;Taip;5;1;0;6
3367;Jurginėlis;Boružėlių;82216478040;Ne;0;3;0;3
3368;Jurginėlis;Boružėlių;86967421380;Taip;0;5;0;5
3369;Jurginėlis;Boružėlių;10360871447;Taip;0;3;0;3
3370;Jurginėlis;Boružėlių;81519067874;Taip;0;3;0;3
3371;Jurginėlis;Boružėlių;2588167364;Taip;0;2;0;2
3372;Jurginėlis;Boružėlių;88889021693;Taip;0;8;0;8
3373;Jurginėlis;Boružėlių;26247261025;Taip;0;1;0;1
3374;Jurginėlis;Boružėlių;12869519580;Taip;0;2;0;2
3375;Jurginėlis;Boružėlių;65042659099;Taip;0;1;0;1
3376;Jurginėlis;Boružėlių;32999311928;Taip;7;9;0;16
3377;Jurginėlis;Boružėlių;53414286952;Taip;0;2;0;2
3378;Jurginėlis;Boružėlių;38238082314;Taip;0;7;0;7
3379;Jurginėlis;Boružėlių;11327131918;Taip;0;1;0;1
3380;Jurginėlis;Boružėlių;19813742281;Taip;0;3;0;3
3381;Jurginėlis;Boružėlių;96095068634;Taip;0;1;0;1
3382;Jurginėlis;Bitučių;41492483889;Taip;0;2;0;2
3383;Jurginėlis;Bitučių;47471788525;Ne;0;2;3;5
3384;Jurginėlis;Bitučių;9063688205;Taip;0;1;0;1
3385;Jurginėlis;Bitučių;3788255853;Taip;8;2;0;10
3386;Jurginėlis;Bitučių;82962903099;Taip;0;7;0;7
3387;Jurginėlis;Bitučių;25564914064;Taip;0;2;0;2
3388;Jurginėlis;Bitučių;20339209794;Taip;15;1;0;16
3389;Jurginėlis;Bitučių;84958379689;Taip;0;5;0;5
3390;Jurginėlis;Bitučių;50656028856;Taip;0;7;0;7
3391;Jurginėlis;Bitučių;10179464570;Taip;0;1;3;4
3392;Jurginėlis;Bitučių;87615798332;Taip;7;0;4;11
3393;Jurginėlis;Bitučių;56127406092;Taip;0;1;0;1
3394;Jurginėlis;Bitučių;57002585818;Taip;1;5;0;6
3395;Jurginėlis;Bitučių;1196957598;Taip;0;7;0;7
3396;Jurginėlis;Bitučių;1698001579;Taip;0;1;0;1
3397;Jurginėlis;Skruzdeliukų;92602685294;Taip;0;1;0;1
3398;Jurginėlis;Skruzdeliukų;1710682615;Taip;0;0;6;6
3399;Jurginėlis;Skruzdeliukų;1485725580;Taip;7;0;0;7
3400;Jurginėlis;Skruzdeliukų;20527253593;Taip;0;1;0;1
3401;Jurginėlis;Skruzdeliukų;51685299187;Ne;0;3;0;3
3402;Jurginėlis;Skruzdeliukų;1881790340;Taip;0;8;0;8
3403;Jurginėlis;Skruzdeliukų;31143311410;Taip;0;1;0;1
3404;Jurginėlis;Skruzdeliukų;94107758268;Taip;0;6;0;6
3405;Jurginėlis;Skruzdeliukų;1258821883;Taip;8;0;0;8
3406;Jurginėlis;Skruzdeliukų;1868080361;Taip;0;4;0;4
3407;Jurginėlis;Skruzdeliukų;38755774035;Taip;9;0;0;9
3408;Jurginėlis;Skruzdeliukų;68109772993;Taip;0;2;2;4
3409;Jurginėlis;Skruzdeliukų;1329203545;Taip;0;1;0;1
3410;Jurginėlis;Skruzdeliukų;86427848578;Taip;0;2;0;2
3411;Jurginėlis;Skruzdeliukų;81064432153;Taip;0;3;0;3
3412;Jurginėlis;Skruzdeliukų;12659496203;Taip;0;0;5;5
3413;Jurginėlis;Skruzdeliukų;1828295769;Taip;0;1;0;1
3414;Jurginėlis;Skruzdeliukų;17286700686;Ne;3;0;0;3
3415;Jurginėlis;Drugelių;1758862051;Taip;6;0;0;6
3416;Jurginėlis;Drugelių;9589394406;Taip;5;0;3;8
3417;Jurginėlis;Drugelių;47243459592;Taip;10;0;1;11
3418;Jurginėlis;Drugelių;8972814655;Taip;1;0;5;6
3419;Jurginėlis;Drugelių;8784076886;Taip;18;0;0;18
3420;Jurginėlis;Drugelių;7753784918;Taip;0;0;14;14
3421;Jurginėlis;Drugelių;1829089083;Taip;10;0;0;10
3422;Jurginėlis;Drugelių;6111863896;Taip;0;0;2;2
3423;Jurginėlis;Drugelių;3068120316;Taip;4;0;0;4
3424;Jurginėlis;Drugelių;1361108271;Taip;4;0;0;4
3425;Jurginėlis;Drugelių;4852619394;Taip;0;0;3;3
3426;Jurginėlis;Drugelių;1563317396;Taip;0;0;1;1
3427;Jurginėlis;Drugelių;1701720412;Taip;4;0;0;4
3428;Jurginėlis;Drugelių;8920304044;Taip;0;0;1;1
3429;Jurginėlis;Drugelių;1954364886;Taip;16;0;0;16
3430;Jurginėlis;Drugelių;1467200002;Taip;13;0;0;13
3431;Jurginėlis;Drugelių;1974388885;Taip;9;0;2;11
3432;Jurginėlis;Drugelių;2171115974;Taip;8;0;0;8
3433;Jurginėlis;Drugelių;3027573572;Taip;10;0;0;10
3434;Jurginėlis;Žibučių;4806248290;Taip;2;11;0;13
3435;Jurginėlis;Žibučių;2624313807;Taip;9;6;0;15
3436;Jurginėlis;Žibučių;2710889915;Taip;0;4;0;4
3437;Jurginėlis;Žibučių;1547101731;Taip;9;1;0;10
3438;Jurginėlis;Žibučių;2639125463;Taip;1;1;0;2
3439;Jurginėlis;Žibučių;2535601005;Taip;7;0;0;7
3440;Jurginėlis;Žibučių;7297672386;Taip;5;1;0;6
3441;Jurginėlis;Žibučių;5242359650;Taip;1;2;0;3
3442;Jurginėlis;Žibučių;1175441410;Taip;4;4;0;8
3443;Jurginėlis;Žibučių;1343532870;Taip;0;1;0;1
3444;Jurginėlis;Žibučių;5892180334;Taip;1;0;0;1
3445;Jurginėlis;Žibučių;1759218238;Taip;6;0;0;6
3446;Jurginėlis;Žibučių;3708774681;Taip;5;6;0;11
3447;Jurginėlis;Žibučių;7928799065;Taip;0;2;0;2
3448;Jurginėlis;Žibučių;9646318532;Taip;4;0;0;4
3449;Jurginėlis;Žibučių;1082593212;Taip;0;1;0;1
3450;Jurginėlis;Žibučių;8144038013;Taip;17;0;0;17
3451;Jurginėlis;Žibučių;1787311340;Taip;0;6;0;6
3452;Jurginėlis;Žibučių;6413324051;Taip;0;4;0;4
3453;Jurginėlis;Zuikučių;6217229672;Taip;0;7;0;7
3454;Jurginėlis;Zuikučių;1762685527;Taip;5;5;0;10
3455;Jurginėlis;Zuikučių;1649208522;Taip;0;0;1;1
3456;Jurginėlis;Zuikučių;8084970770;Taip;11;0;0;11
3457;Jurginėlis;Zuikučių;87991288027;Taip;2;0;0;2
3458;Jurginėlis;Zuikučių;1400142372;Taip;0;1;0;1
3459;Jurginėlis;Zuikučių;1416995981;Taip;6;0;1;7
3460;Jurginėlis;Zuikučių;1759031589;Taip;0;5;0;5
3461;Jurginėlis;Zuikučių;1945098580;Taip;5;0;0;5
3462;Jurginėlis;Zuikučių;1409480187;Taip;0;5;4;9
3463;Jurginėlis;Zuikučių;1780106633;Taip;0;1;0;1
3464;Jurginėlis;Zuikučių;2106937059;Taip;0;2;0;2
3465;Jurginėlis;Zuikučių;1535907893;Ne;0;13;0;13
3466;Jurginėlis;Zuikučių;8793129805;Taip;0;4;0;4
3467;Jurginėlis;Zuikučių;74303787465;Taip;0;6;0;6
3468;Jurginėlis;Zuikučių;60128913543;Taip;0;7;0;7
3469;Jurginėlis;Zuikučių;9320841905;Taip;0;17;0;17
3470;Jurginėlis;Zuikučių;7293372539;Taip;6;0;0;6
3471;Jurginėlis;Viščiukų;1656335765;Taip;5;2;0;7
3472;Jurginėlis;Viščiukų;6579565337;Taip;3;0;0;3
3473;Jurginėlis;Viščiukų;6729212950;Taip;21;0;0;21
3474;Jurginėlis;Viščiukų;4827340942;Taip;14;0;0;14
3475;Jurginėlis;Viščiukų;6806704355;Taip;10;0;0;10
3476;Jurginėlis;Viščiukų;7990015623;Taip;0;6;0;6
3477;Jurginėlis;Viščiukų;3699180485;Taip;0;6;0;6
3478;Jurginėlis;Viščiukų;9882919290;Taip;0;1;0;1
3479;Jurginėlis;Viščiukų;2548920722;Taip;5;0;0;5
3480;Jurginėlis;Viščiukų;4536086996;Taip;7;0;0;7
3481;Jurginėlis;Viščiukų;3284464951;Taip;11;5;0;16
3482;Jurginėlis;Viščiukų;5921714669;Taip;5;1;0;6
3483;Jurginėlis;Viščiukų;4158502752;Taip;6;0;0;6
3484;Jurginėlis;Viščiukų;4463258777;Taip;6;0;0;6
3485;Jurginėlis;Meškiukų;8443412187;Taip;13;0;1;14
3486;Jurginėlis;Meškiukų;7809274980;Taip;0;5;4;9
3487;Jurginėlis;Meškiukų;4292932046;Taip;2;1;0;3
3488;Jurginėlis;Meškiukų;2221708420;Taip;6;0;1;7
3489;Jurginėlis;Meškiukų;5984893389;Taip;0;15;0;15
3490;Jurginėlis;Meškiukų;3079495897;Taip;0;0;3;3
3491;Jurginėlis;Meškiukų;1455749921;Taip;3;17;0;20
3492;Jurginėlis;Meškiukų;9946892497;Taip;11;0;7;18
3493;Jurginėlis;Meškiukų;2417314519;Taip;14;0;0;14
3494;Jurginėlis;Meškiukų;6968528293;Taip;1;5;0;6
3495;Jurginėlis;Meškiukų;9507571301;Taip;0;0;3;3
3496;Jurginėlis;Meškiukų;8779807396;Taip;0;7;7;14
3497;Jurginėlis;Meškiukų;8161347781;Taip;21;2;0;23
3498;Jurginėlis;Meškiukų;4967548277;Taip;0;15;8;23
3499;Jurginėlis;Meškiukų;2925253653;Taip;15;0;0;15
3500;Jurginėlis;Meškiukų;1340689348;Taip;0;16;0;16
3501;Jurginėlis;Meškiukų;6181547354;Taip;11;12;1;24
3502;Jurginėlis;Meškiukų;4113264904;Taip;13;0;0;13
3503;Jurginėlis;Gandriukų;7419836868;Taip;8;0;0;8
3504;Jurginėlis;Gandriukų;51603579121;Ne;0;7;0;7
3505;Jurginėlis;Gandriukų;87444065733;Taip;5;5;0;10
3506;Jurginėlis;Gandriukų;2179884441;Taip;0;16;0;16
3507;Jurginėlis;Gandriukų;2264351097;Taip;3;0;1;4
3508;Jurginėlis;Gandriukų;78496894090;Taip;0;0;3;3
3509;Jurginėlis;Gandriukų;99523320519;Taip;0;0;5;5
3510;Jurginėlis;Gandriukų;1498351759;Taip;2;0;1;3
3511;Jurginėlis;Gandriukų;1159550277;Taip;0;1;0;1
3512;Jurginėlis;Gandriukų;75383941896;Taip;0;0;1;1
3513;Jurginėlis;Gandriukų;1508705709;Taip;0;1;0;1
3514;Jurginėlis;Gandriukų;1773100970;Taip;0;1;0;1
3515;Jurginėlis;Gandriukų;1500087367;Taip;0;1;0;1
3516;Jurginėlis;Gandriukų;43368987046;Taip;14;1;0;15
3517;Jurginėlis;Gandriukų;6707289955;Taip;2;0;4;6
3518;Jurginėlis;Gandriukų;1927843089;Taip;1;0;3;4
3519;Jurginėlis;Gandriukų;8178112926;Taip;1;1;3;5
3520;Jurginėlis;Gandriukų;6475508583;Taip;11;0;5;16
3521;Jurginėlis;Gandriukų;91517951071;Taip;0;0;1;1
3522;Jurginėlis;Gandriukų;9714764714;Taip;9;0;2;11
3523;Jurginėlis;Gandriukų;5756997642;Taip;2;1;4;7
3524;Karusėlė;PAGRANDUKAS;3660843696;Taip;10;3;0;13
3525;Karusėlė;PAGRANDUKAS;1412890120;Taip;0;14;0;14
3526;Karusėlė;PAGRANDUKAS;8967704928;Taip;6;7;0;13
3527;Karusėlė;PAGRANDUKAS;5132581245;Taip;10;2;0;12
3528;Karusėlė;PAGRANDUKAS;2160071272;Taip;12;1;0;13
3529;Karusėlė;PAGRANDUKAS;9996567374;Taip;1;6;0;7
3530;Karusėlė;PAGRANDUKAS;9462242426;Taip;11;0;2;13
3531;Karusėlė;PAGRANDUKAS;2412418335;Taip;8;4;0;12
3532;Karusėlė;PAGRANDUKAS;7393434659;Taip;4;0;0;4
3533;Karusėlė;PAGRANDUKAS;8678437720;Taip;8;0;1;9
3534;Karusėlė;PAGRANDUKAS;6826455161;Taip;6;0;0;6
3535;Karusėlė;PAGRANDUKAS;5695697634;Taip;16;0;0;16
3536;Karusėlė;PAGRANDUKAS;8127218866;Taip;0;0;3;3
3537;Karusėlė;PAGRANDUKAS;6062361348;Taip;6;0;0;6
3538;Karusėlė;PAGRANDUKAS;3620722907;Taip;21;0;0;21
3539;Karusėlė;PAGRANDUKAS;7013765804;Taip;0;7;0;7
3540;Karusėlė;NYKŠTUKAS;82963400142;Taip;0;3;0;3
3541;Karusėlė;NYKŠTUKAS;1567290218;Taip;0;2;0;2
3542;Karusėlė;NYKŠTUKAS;77290004668;Taip;9;0;0;9
3543;Karusėlė;NYKŠTUKAS;64652121316;Taip;2;0;0;2
3544;Karusėlė;NYKŠTUKAS;1250530261;Taip;0;1;0;1
3545;Karusėlė;NYKŠTUKAS;4568159355;Taip;18;0;0;18
3546;Karusėlė;NYKŠTUKAS;1397009220;Taip;0;10;0;10
3547;Karusėlė;NYKŠTUKAS;62938709605;Taip;0;0;1;1
3548;Karusėlė;NYKŠTUKAS;2064301292;Taip;0;0;1;1
3549;Karusėlė;NYKŠTUKAS;96150256487;Taip;9;0;0;9
3550;Karusėlė;NYKŠTUKAS;1680275369;Taip;13;0;0;13
3551;Karusėlė;NYKŠTUKAS;17728195505;Taip;0;1;0;1
3552;Karusėlė;NYKŠTUKAS;1534689679;Taip;0;0;1;1
3553;Karusėlė;NYKŠTUKAS;1226371512;Taip;0;0;6;6
3554;Karusėlė;NYKŠTUKAS;45634061915;Taip;0;7;0;7
3555;Karusėlė;NYKŠTUKAS;9377426384;Taip;0;3;0;3
3556;Karusėlė;NYKŠTUKAS;1311631554;Ne;9;0;4;13
3557;Karusėlė;NYKŠTUKAS;5481354767;Taip;11;0;0;11
3558;Karusėlė;NYKŠTUKAS;1798723081;Ne;3;0;3;6
3559;Karusėlė;NYKŠTUKAS;8419242504;Taip;8;0;4;12
3560;Karusėlė;BITUTĖ;34233236889;Taip;0;12;0;12
3561;Karusėlė;BITUTĖ;59360129103;Taip;0;6;0;6
3562;Karusėlė;BITUTĖ;73632076815;Taip;2;2;0;4
3563;Karusėlė;BITUTĖ;79818913523;Taip;6;3;0;9
3564;Karusėlė;BITUTĖ;49030870029;Taip;0;1;0;1
3565;Karusėlė;BITUTĖ;3136722375;Taip;5;6;0;11
3566;Karusėlė;BITUTĖ;61949196545;Ne;5;0;0;5
3567;Karusėlė;BITUTĖ;92696158075;Taip;0;5;0;5
3568;Karusėlė;BITUTĖ;53518197256;Taip;0;7;0;7
3569;Karusėlė;BITUTĖ;32652681132;Taip;0;1;0;1
3570;Karusėlė;BITUTĖ;50671265678;Taip;0;1;0;1
3571;Karusėlė;BITUTĖ;93257316270;Taip;0;1;0;1
3572;Karusėlė;BITUTĖ;5205096259;Taip;0;4;0;4
3573;Karusėlė;BITUTĖ;75225376723;Taip;11;1;0;12
3574;Karusėlė;BITUTĖ;57323585520;Taip;0;4;0;4
3575;Karusėlė;BITUTĖ;14967055322;Ne;0;9;0;9
3576;Karusėlė;BITUTĖ;2582494071;Taip;0;5;0;5
3577;Karusėlė;BITUTĖ;49680859319;Taip;8;0;0;8
3578;Karusėlė;BITUTĖ;28039124654;Taip;5;6;0;11
3579;Karusėlė;BITUTĖ;13158075075;Taip;0;6;0;6
3580;Karusėlė;BITUTĖ;92236920191;Taip;4;4;0;8
3581;Karusėlė;BITUTĖ;8302185030;Taip;5;5;0;10
3582;Karusėlė;BITUTĖ;58784706592;Taip;1;1;0;2
3583;Karusėlė;BITUTĖ;8079425267;Taip;8;6;0;14
3584;Karusėlė;BITUTĖ;1688616471;Taip;0;1;0;1
3585;Karusėlė;BITUTĖ;85881177597;Taip;7;1;0;8
3586;Karusėlė;BORUŽĖLĖ;1705790474;Taip;1;1;0;2
3587;Karusėlė;BORUŽĖLĖ;4890393582;Taip;0;3;0;3
3588;Karusėlė;BORUŽĖLĖ;1311907441;Taip;10;1;0;11
3589;Karusėlė;BORUŽĖLĖ;1593728369;Taip;1;7;0;8
3590;Karusėlė;BORUŽĖLĖ;6313010762;Taip;5;0;0;5
3591;Karusėlė;BORUŽĖLĖ;5859827168;Taip;3;0;0;3
3592;Karusėlė;BORUŽĖLĖ;37349219339;Taip;14;1;0;15
3593;Karusėlė;BORUŽĖLĖ;49110267692;Taip;6;0;0;6
3594;Karusėlė;BORUŽĖLĖ;1809033214;Taip;14;1;0;15
3595;Karusėlė;BORUŽĖLĖ;9065247151;Taip;0;0;8;8
3596;Karusėlė;BORUŽĖLĖ;6811862463;Taip;6;4;0;10
3597;Karusėlė;BORUŽĖLĖ;5471989295;Taip;9;1;0;10
3598;Karusėlė;BORUŽĖLĖ;9753876554;Taip;18;0;0;18
3599;Karusėlė;BORUŽĖLĖ;1204919995;Taip;21;0;0;21
3600;Karusėlė;BORUŽĖLĖ;8717484092;Taip;21;0;0;21
3601;Karusėlė;BORUŽĖLĖ;5351690991;Taip;8;1;0;9
3602;Karusėlė;BORUŽĖLĖ;1994682683;Taip;8;0;0;8
3603;Karusėlė;BORUŽĖLĖ;1350744949;Taip;15;1;0;16
3604;Karusėlė;BORUŽĖLĖ;5632697184;Taip;3;1;0;4
3605;Karusėlė;UOGELĖ;3053539045;Taip;0;2;2;4
3606;Karusėlė;UOGELĖ;9992989896;Taip;0;2;1;3
3607;Karusėlė;UOGELĖ;2084276906;Taip;6;0;0;6
3608;Karusėlė;UOGELĖ;1098106063;Taip;0;2;1;3
3609;Karusėlė;UOGELĖ;8665314366;Taip;0;6;0;6
3610;Karusėlė;UOGELĖ;5651238035;Taip;6;0;0;6
3611;Karusėlė;UOGELĖ;4121668687;Taip;1;0;0;1
3612;Karusėlė;UOGELĖ;8316147204;Taip;0;16;0;16
3613;Karusėlė;UOGELĖ;5504719953;Taip;0;16;0;16
3614;Karusėlė;UOGELĖ;5919009583;Taip;0;6;0;6
3615;Karusėlė;UOGELĖ;4199597984;Taip;9;4;0;13
3616;Karusėlė;UOGELĖ;2383023280;Taip;7;3;0;10
3617;Karusėlė;UOGELĖ;1575408822;Taip;21;0;0;21
3618;Karusėlė;UOGELĖ;3917113787;Taip;10;2;0;12
3619;Karusėlė;UOGELĖ;1428516421;Taip;0;8;5;13
3620;Karusėlė;UOGELĖ;4638918427;Taip;0;1;0;1
3621;Karusėlė;UOGELĖ;3615957761;Taip;16;1;0;17
3622;Karusėlė;UOGELĖ;3514026443;Taip;0;3;0;3
3623;Karusėlė;GINTARĖLIS;75574841532;Taip;0;1;1;2
3624;Karusėlė;GINTARĖLIS;89669425763;Taip;7;0;0;7
3625;Karusėlė;GINTARĖLIS;1058129883;Taip;0;1;0;1
3626;Karusėlė;GINTARĖLIS;1625704473;Taip;0;12;0;12
3627;Karusėlė;GINTARĖLIS;5267055924;Taip;0;5;0;5
3628;Karusėlė;GINTARĖLIS;17254955427;Taip;0;2;2;4
3629;Karusėlė;GINTARĖLIS;1467237683;Taip;0;5;0;5
3630;Karusėlė;GINTARĖLIS;33935704865;Taip;0;4;0;4
3631;Karusėlė;GINTARĖLIS;92286460424;Taip;9;7;0;16
3632;Karusėlė;GINTARĖLIS;80377577910;Taip;0;14;0;14
3633;Karusėlė;GINTARĖLIS;7794899167;Taip;7;1;0;8
3634;Karusėlė;GINTARĖLIS;1302846796;Taip;12;3;0;15
3635;Karusėlė;GINTARĖLIS;65387251381;Taip;8;1;0;9
3636;Karusėlė;GINTARĖLIS;90635580825;Taip;0;1;0;1
3637;Karusėlė;GINTARĖLIS;93635113154;Taip;5;6;0;11
3638;Karusėlė;GINTARĖLIS;2386140324;Taip;5;1;0;6
3639;Karusėlė;GINTARĖLIS;90731574209;Taip;0;7;0;7
3640;Karusėlė;GINTARĖLIS;1248828581;Taip;0;16;0;16
3641;Karusėlė;GINTARĖLIS;6596029324;Taip;1;0;1;2
3642;Karusėlė;GINTARĖLIS;1477282992;Taip;0;1;0;1
3643;Karusėlė;GINTARĖLIS;1487641646;Taip;11;0;0;11
3644;Karusėlė;SAULUTĖ;1705251019;Taip;0;2;0;2
3645;Karusėlė;SAULUTĖ;64855471225;Taip;7;1;0;8
3646;Karusėlė;SAULUTĖ;45701480267;Taip;15;1;0;16
3647;Karusėlė;SAULUTĖ;35910852843;Taip;11;1;0;12
3648;Karusėlė;SAULUTĖ;1198992954;Taip;0;9;0;9
3649;Karusėlė;SAULUTĖ;1223992311;Taip;0;3;0;3
3650;Karusėlė;SAULUTĖ;6702329224;Taip;9;0;0;9
3651;Karusėlė;SAULUTĖ;1239411995;Taip;0;1;0;1
3652;Karusėlė;SAULUTĖ;4806666157;Taip;11;2;0;13
3653;Karusėlė;SAULUTĖ;10539595272;Taip;10;0;0;10
3654;Karusėlė;SAULUTĖ;52452661421;Taip;9;3;0;12
3655;Karusėlė;SAULUTĖ;2606829789;Ne;0;2;0;2
3656;Karusėlė;SAULUTĖ;91676265927;Taip;0;1;0;1
3657;Karusėlė;SAULUTĖ;39088931809;Taip;3;2;3;8
3658;Karusėlė;SAULUTĖ;63044693440;Taip;0;1;0;1
3659;Karusėlė;SAULUTĖ;23662916408;Taip;0;9;0;9
3660;Karusėlė;SAULUTĖ;99462674291;Taip;0;3;2;5
3661;Karusėlė;SAULUTĖ;59790578013;Taip;7;0;0;7
3662;Karusėlė;SAULUTĖ;2025180617;Taip;15;0;0;15
3663;Karusėlė;SAULUTĖ;7977835762;Taip;21;0;0;21
3664;Karusėlė;SAULUTĖ;1273810363;Taip;0;6;0;6
3665;Karusėlė;SAULUTĖ;25328680614;Taip;1;2;0;3
3666;Karusėlė;SAULUTĖ;2038274137;Taip;4;0;0;4
3667;Karusėlė;TIGRIUKAS;1277422207;Taip;6;4;0;10
3668;Karusėlė;TIGRIUKAS;1982126099;Taip;11;0;0;11
3669;Karusėlė;TIGRIUKAS;1799128848;Taip;0;4;0;4
3670;Karusėlė;TIGRIUKAS;1292576152;Taip;11;0;0;11
3671;Karusėlė;TIGRIUKAS;95430039864;Taip;0;4;0;4
3672;Karusėlė;TIGRIUKAS;68279619421;Taip;6;3;0;9
3673;Karusėlė;TIGRIUKAS;86870088150;Taip;0;6;0;6
3674;Karusėlė;TIGRIUKAS;25581881402;Taip;0;9;0;9
3675;Karusėlė;TIGRIUKAS;60785707116;Taip;10;4;0;14
3676;Karusėlė;TIGRIUKAS;19906965254;Taip;0;0;1;1
3677;Karusėlė;TIGRIUKAS;1817869518;Taip;0;1;0;1
3678;Karusėlė;TIGRIUKAS;1193711193;Taip;0;9;0;9
3679;Karusėlė;TIGRIUKAS;1773362652;Taip;0;7;0;7
3680;Karusėlė;TIGRIUKAS;3752570475;Taip;0;9;0;9
3681;Karusėlė;TIGRIUKAS;8946147763;Taip;0;0;1;1
3682;Karusėlė;TIGRIUKAS;4426462711;Taip;12;0;0;12
3683;Karusėlė;TIGRIUKAS;3960354989;Taip;14;0;0;14
3684;Karusėlė;TIGRIUKAS;1947403400;Taip;0;7;0;7
3685;Karusėlė;TIGRIUKAS;2036366726;Taip;0;4;0;4
3686;Karusėlė;VAIVORYKŠTĖ;1653601923;Ne;0;1;0;1
3687;Karusėlė;VAIVORYKŠTĖ;1979913722;Taip;0;7;0;7
3688;Karusėlė;VAIVORYKŠTĖ;89727334417;Taip;8;7;0;15
3689;Karusėlė;VAIVORYKŠTĖ;88371238657;Taip;8;0;0;8
3690;Karusėlė;VAIVORYKŠTĖ;21474974272;Taip;0;2;0;2
3691;Karusėlė;VAIVORYKŠTĖ;2092642601;Taip;0;5;0;5
3692;Karusėlė;VAIVORYKŠTĖ;2083974132;Taip;0;3;0;3
3693;Karusėlė;VAIVORYKŠTĖ;1945164524;Taip;0;11;0;11
3694;Karusėlė;VAIVORYKŠTĖ;1915396083;Taip;0;1;0;1
3695;Karusėlė;VAIVORYKŠTĖ;1094853107;Taip;0;14;0;14
3696;Karusėlė;VAIVORYKŠTĖ;40499469616;Taip;0;6;0;6
3697;Karusėlė;VAIVORYKŠTĖ;94058192792;Taip;3;2;2;7
3698;Karusėlė;VAIVORYKŠTĖ;78971949838;Taip;6;0;0;6
3699;Karusėlė;VAIVORYKŠTĖ;25859211954;Taip;13;0;0;13
3700;Karusėlė;VAIVORYKŠTĖ;47751458940;Taip;0;1;0;1
3701;Karusėlė;VAIVORYKŠTĖ;68537797465;Taip;0;11;0;11
3702;Karusėlė;VAIVORYKŠTĖ;50904986408;Taip;0;15;0;15
3703;Karusėlė;VAIVORYKŠTĖ;11336671763;Taip;3;14;0;17
3704;Karusėlė;VAIVORYKŠTĖ;9482894921;Taip;0;6;0;6
3705;Karusėlė;"AUKSINĖ ŽUVELĖ";77212719456;Taip;0;7;0;7
3706;Karusėlė;"AUKSINĖ ŽUVELĖ";4888730297;Taip;0;7;0;7
3707;Karusėlė;"AUKSINĖ ŽUVELĖ";1048086957;Taip;1;2;0;3
3708;Karusėlė;"AUKSINĖ ŽUVELĖ";1709733062;Taip;17;0;0;17
3709;Karusėlė;"AUKSINĖ ŽUVELĖ";26710882757;Taip;0;6;0;6
3710;Karusėlė;"AUKSINĖ ŽUVELĖ";47542882134;Taip;0;1;0;1
3711;Karusėlė;"AUKSINĖ ŽUVELĖ";6580115367;Taip;0;7;0;7
3712;Karusėlė;"AUKSINĖ ŽUVELĖ";27958836709;Taip;0;6;0;6
3713;Karusėlė;"AUKSINĖ ŽUVELĖ";76108591835;Taip;0;4;0;4
3714;Karusėlė;"AUKSINĖ ŽUVELĖ";23369021638;Ne;0;1;0;1
3715;Karusėlė;"AUKSINĖ ŽUVELĖ";2216383015;Taip;0;2;0;2
3716;Karusėlė;"AUKSINĖ ŽUVELĖ";58031363722;Taip;1;2;0;3
3717;Karusėlė;"AUKSINĖ ŽUVELĖ";41390857064;Taip;12;2;0;14
3718;Karusėlė;"AUKSINĖ ŽUVELĖ";44475356094;Taip;0;1;0;1
3719;Karusėlė;"AUKSINĖ ŽUVELĖ";1462103488;Taip;2;8;0;10
3720;Karusėlė;"AUKSINĖ ŽUVELĖ";2038901113;Taip;0;1;0;1
3721;Karusėlė;"AUKSINĖ ŽUVELĖ";1948979039;Taip;0;3;0;3
3722;Karusėlė;"AUKSINĖ ŽUVELĖ";1982350605;Taip;11;1;0;12
3723;Karusėlė;"AUKSINĖ ŽUVELĖ";4878805177;Taip;0;1;0;1
3724;Karusėlė;RAMUNĖ;5951045233;Taip;13;1;0;14
3725;Karusėlė;RAMUNĖ;9868386182;Taip;4;0;0;4
3726;Karusėlė;RAMUNĖ;2381566229;Taip;17;1;0;18
3727;Karusėlė;RAMUNĖ;9344514262;Taip;17;0;0;17
3728;Karusėlė;RAMUNĖ;2215367063;Taip;0;21;0;21
3729;Karusėlė;RAMUNĖ;6495631086;Taip;0;1;2;3
3730;Karusėlė;RAMUNĖ;1698478530;Taip;14;0;0;14
3731;Karusėlė;RAMUNĖ;5146709341;Taip;4;0;0;4
3732;Karusėlė;RAMUNĖ;8331985564;Taip;7;0;0;7
3733;Karusėlė;RAMUNĖ;5803808409;Taip;5;1;0;6
3734;Karusėlė;RAMUNĖ;5855430678;Taip;7;0;0;7
3735;Karusėlė;RAMUNĖ;9400171357;Taip;0;14;0;14
3736;Karusėlė;RAMUNĖ;5766390337;Taip;8;1;0;9
3737;Karusėlė;RAMUNĖ;6413701823;Taip;13;0;0;13
3738;Karusėlė;RAMUNĖ;2007411601;Taip;10;3;0;13
3739;Kaštonas;NYKŠTUKAI;41926955433;Taip;3;0;0;3
3740;Kaštonas;NYKŠTUKAI;81834426663;Taip;0;5;0;5
3741;Kaštonas;NYKŠTUKAI;1626798162;Taip;16;2;0;18
3742;Kaštonas;NYKŠTUKAI;46191613797;Taip;0;8;0;8
3743;Kaštonas;NYKŠTUKAI;76576870173;Taip;0;1;0;1
3744;Kaštonas;NYKŠTUKAI;1313119270;Taip;8;0;0;8
3745;Kaštonas;NYKŠTUKAI;1152555202;Taip;10;1;0;11
3746;Kaštonas;NYKŠTUKAI;1023364928;Taip;21;0;0;21
3747;Kaštonas;NYKŠTUKAI;1186956315;Taip;0;4;0;4
3748;Kaštonas;NYKŠTUKAI;1931800904;Taip;0;20;0;20
3749;Kaštonas;NYKŠTUKAI;1781481896;Taip;0;2;0;2
3750;Kaštonas;NYKŠTUKAI;6701145026;Taip;6;0;0;6
3751;Kaštonas;NYKŠTUKAI;9287426151;Taip;0;3;0;3
3752;Kaštonas;NYKŠTUKAI;55052021468;Taip;7;0;0;7
3753;Kaštonas;NYKŠTUKAI;6560054869;Taip;0;9;0;9
3754;Kaštonas;NYKŠTUKAI;9168456496;Taip;0;2;0;2
3755;Kaštonas;NYKŠTUKAI;3059036526;Taip;0;14;0;14
3756;Kaštonas;NYKŠTUKAI;8990194475;Taip;0;6;0;6
3757;Kaštonas;NYKŠTUKAI;9702914628;Taip;0;5;0;5
3758;Kaštonas;NYKŠTUKAI;41221846403;Taip;12;1;0;13
3759;Kaštonas;NYKŠTUKAI;3773227028;Taip;4;0;0;4
3760;Kaštonas;DRUGELIAI;1547554662;Taip;5;2;0;7
3761;Kaštonas;DRUGELIAI;25534865569;Ne;9;0;0;9
3762;Kaštonas;DRUGELIAI;91745369760;Ne;0;1;0;1
3763;Kaštonas;DRUGELIAI;78786250725;Taip;0;2;0;2
3764;Kaštonas;DRUGELIAI;7641793210;Taip;6;1;0;7
3765;Kaštonas;DRUGELIAI;46419017842;Taip;19;0;0;19
3766;Kaštonas;DRUGELIAI;59413506728;Taip;0;3;0;3
3767;Kaštonas;DRUGELIAI;1641976468;Taip;2;8;0;10
3768;Kaštonas;DRUGELIAI;2825343274;Taip;2;0;0;2
3769;Kaštonas;DRUGELIAI;54580238237;Taip;6;3;0;9
3770;Kaštonas;DRUGELIAI;8748600333;Taip;0;1;0;1
3771;Kaštonas;DRUGELIAI;87941682538;Taip;17;0;0;17
3772;Kaštonas;DRUGELIAI;17123843027;Taip;0;6;0;6
3773;Kaštonas;DRUGELIAI;75540345287;Taip;0;3;0;3
3774;Kaštonas;DRUGELIAI;23319023639;Taip;0;2;0;2
3775;Kaštonas;DRUGELIAI;52064859848;Taip;5;1;0;6
3776;Kaštonas;DRUGELIAI;16395082273;Taip;0;3;0;3
3777;Kaštonas;DRUGELIAI;7229267783;Taip;12;0;0;12
3778;Kaštonas;DRUGELIAI;2120469277;Taip;0;11;0;11
3779;Kaštonas;DRUGELIAI;61557505110;Taip;13;0;0;13
3780;Kaštonas;KIŠKUČIAI;1859126564;Taip;0;13;0;13
3781;Kaštonas;KIŠKUČIAI;4449017708;Ne;0;9;0;9
3782;Kaštonas;KIŠKUČIAI;3638565578;Taip;0;4;0;4
3783;Kaštonas;KIŠKUČIAI;5153948802;Taip;5;8;0;13
3784;Kaštonas;KIŠKUČIAI;4956177048;Taip;20;0;0;20
3785;Kaštonas;KIŠKUČIAI;2165890763;Taip;5;13;0;18
3786;Kaštonas;KIŠKUČIAI;5610113641;Taip;6;4;0;10
3787;Kaštonas;KIŠKUČIAI;2797443202;Taip;7;4;0;11
3788;Kaštonas;KIŠKUČIAI;3039980710;Taip;0;2;0;2
3789;Kaštonas;KIŠKUČIAI;3507672150;Taip;12;0;0;12
3790;Kaštonas;KIŠKUČIAI;3131712783;Taip;6;5;0;11
3791;Kaštonas;KIŠKUČIAI;1747580231;Ne;4;4;0;8
3792;Kaštonas;KIŠKUČIAI;1826015013;Taip;0;1;0;1
3793;Kaštonas;KIŠKUČIAI;7553024183;Taip;0;19;0;19
3794;Kaštonas;KIŠKUČIAI;5630659056;Taip;3;6;0;9
3795;Kaštonas;KIŠKUČIAI;8151333699;Taip;10;2;0;12
3796;Kaštonas;KIŠKUČIAI;2007064959;Taip;0;18;0;18
3797;Kaštonas;KIŠKUČIAI;7841179083;Taip;0;21;0;21
3798;Kaštonas;KIŠKUČIAI;3649329598;Taip;7;7;0;14
3799;Kaštonas;KIŠKUČIAI;8906976150;Taip;6;2;0;8
3800;Kaštonas;KIŠKUČIAI;7508357392;Taip;8;0;0;8
3801;Kaštonas;BITUTĖS;51558463647;Taip;0;6;0;6
3802;Kaštonas;BITUTĖS;8377601628;Ne;6;3;0;9
3803;Kaštonas;BITUTĖS;2062489205;Taip;11;2;0;13
3804;Kaštonas;BITUTĖS;78535860714;Taip;0;6;0;6
3805;Kaštonas;BITUTĖS;2146285017;Taip;0;11;0;11
3806;Kaštonas;BITUTĖS;98526928421;Taip;0;4;0;4
3807;Kaštonas;BITUTĖS;1292350264;Taip;0;3;0;3
3808;Kaštonas;BITUTĖS;39974835155;Taip;3;1;0;4
3809;Kaštonas;BITUTĖS;18542160352;Taip;0;13;0;13
3810;Kaštonas;BITUTĖS;1459614385;Taip;0;4;0;4
3811;Kaštonas;BITUTĖS;4250816034;Taip;0;4;0;4
3812;Kaštonas;BITUTĖS;2801321116;Taip;0;3;0;3
3813;Kaštonas;BITUTĖS;9967553882;Taip;0;2;0;2
3814;Kaštonas;BITUTĖS;27082059521;Taip;6;3;0;9
3815;Kaštonas;BITUTĖS;1465714333;Taip;0;15;0;15
3816;Kaštonas;BITUTĖS;1252815477;Taip;6;6;0;12
3817;Kaštonas;BITUTĖS;7557437205;Taip;0;5;0;5
3818;Kaštonas;BITUTĖS;92533370070;Taip;0;5;0;5
3819;Kaštonas;BITUTĖS;9215070593;Taip;15;5;0;20
3820;Kaštonas;BITUTĖS;2149717496;Ne;21;0;0;21
3821;Kaštonas;BITUTĖS;6511223066;Taip;5;0;0;5
3822;Kaštonas;BITUTĖS;2504312724;Taip;0;4;0;4
3823;Kaštonas;MEŠKIUKAI;13105582649;Taip;12;7;0;19
3824;Kaštonas;MEŠKIUKAI;1420929477;Taip;2;16;0;18
3825;Kaštonas;MEŠKIUKAI;2764004779;Taip;11;0;0;11
3826;Kaštonas;MEŠKIUKAI;12354635231;Taip;5;0;0;5
3827;Kaštonas;MEŠKIUKAI;94748215851;Taip;0;18;0;18
3828;Kaštonas;MEŠKIUKAI;66717201099;Taip;6;4;0;10
3829;Kaštonas;MEŠKIUKAI;12358360731;Taip;14;0;0;14
3830;Kaštonas;MEŠKIUKAI;97106889191;Taip;0;15;0;15
3831;Kaštonas;MEŠKIUKAI;8042807487;Taip;4;5;0;9
3832;Kaštonas;MEŠKIUKAI;2711819539;Taip;0;8;0;8
3833;Kaštonas;MEŠKIUKAI;1294879767;Taip;0;10;0;10
3834;Kaštonas;MEŠKIUKAI;1367704050;Taip;16;0;0;16
3835;Kaštonas;MEŠKIUKAI;5722934228;Taip;0;2;0;2
3836;Kaštonas;MEŠKIUKAI;65960895249;Taip;10;0;0;10
3837;Kaštonas;MEŠKIUKAI;69883785412;Taip;0;3;0;3
3838;Kaštonas;MEŠKIUKAI;1049699735;Taip;10;2;0;12
3839;Kaštonas;MEŠKIUKAI;1385352925;Taip;0;6;0;6
3840;Kaštonas;MEŠKIUKAI;3863015751;Ne;6;0;0;6
3841;Kaštonas;MEŠKIUKAI;2760501432;Ne;6;5;0;11
3842;Kaštonas;MEŠKIUKAI;70838449788;Ne;3;2;0;5
3843;Kaštonas;MEŠKIUKAI;1249299633;Taip;0;1;0;1
3844;Kaštonas;MEŠKIUKAI;1196590128;Taip;0;3;0;3
3845;Kaštonas;BORUŽĖLĖS;5099098185;Taip;0;2;0;2
3846;Kaštonas;BORUŽĖLĖS;6967725663;Taip;0;15;0;15
3847;Kaštonas;BORUŽĖLĖS;5478395437;Taip;21;0;0;21
3848;Kaštonas;BORUŽĖLĖS;6606094891;Taip;6;3;0;9
3849;Kaštonas;BORUŽĖLĖS;1364391105;Taip;6;3;0;9
3850;Kaštonas;BORUŽĖLĖS;2125410714;Taip;5;0;0;5
3851;Kaštonas;BORUŽĖLĖS;7956422880;Taip;0;21;0;21
3852;Kaštonas;BORUŽĖLĖS;8564586014;Taip;8;2;0;10
3853;Kaštonas;BORUŽĖLĖS;5328263421;Taip;0;4;0;4
3854;Kaštonas;BORUŽĖLĖS;4033866425;Taip;0;2;0;2
3855;Kaštonas;BORUŽĖLĖS;3961661158;Taip;21;0;0;21
3856;Kaštonas;BORUŽĖLĖS;6251564828;Taip;0;9;0;9
3857;Kaštonas;BORUŽĖLĖS;7291448857;Taip;0;4;0;4
3858;Kaštonas;BORUŽĖLĖS;3105500733;Taip;0;5;0;5
3859;Kaštonas;BORUŽĖLĖS;6175014441;Taip;6;1;0;7
3860;Kaštonas;BORUŽĖLĖS;4450146424;Taip;8;7;0;15
3861;Kaštonas;BORUŽĖLĖS;5548875714;Taip;8;0;0;8
3862;Kaštonas;BORUŽĖLĖS;3333990952;Taip;8;0;0;8
3863;Kaštonas;BORUŽĖLĖS;8166925991;Taip;0;6;0;6
3864;Krivūlė;SPINDULIUKAI;59978148537;Taip;1;0;3;4
3865;Krivūlė;SPINDULIUKAI;55356606791;Taip;12;0;0;12
3866;Krivūlė;SPINDULIUKAI;10728010124;Taip;4;0;0;4
3867;Krivūlė;SPINDULIUKAI;45328749559;Taip;5;0;1;6
3868;Krivūlė;SPINDULIUKAI;88714209343;Taip;6;0;1;7
3869;Krivūlė;SPINDULIUKAI;50715118246;Taip;12;1;0;13
3870;Krivūlė;SPINDULIUKAI;88645409146;Taip;3;0;0;3
3871;Krivūlė;SPINDULIUKAI;43180342657;Taip;9;0;0;9
3872;Krivūlė;SPINDULIUKAI;78895964424;Taip;0;1;2;3
3873;Krivūlė;SPINDULIUKAI;9864428506;Taip;0;0;1;1
3874;Krivūlė;SPINDULIUKAI;58431942;Taip;0;1;0;1
3875;Krivūlė;SPINDULIUKAI;48514609257;Taip;0;1;2;3
3876;Krivūlė;SPINDULIUKAI;49698343392;Taip;7;1;0;8
3877;Krivūlė;SPINDULIUKAI;1361647836;Taip;0;0;5;5
3878;Krivūlė;SPINDULIUKAI;3157698386;Taip;4;0;5;9
3879;Krivūlė;SPINDULIUKAI;91823213506;Taip;10;0;7;17
3880;Krivūlė;SPINDULIUKAI;52632731467;Taip;0;1;3;4
3881;Krivūlė;SPINDULIUKAI;1443815293;Taip;5;1;0;6
3882;Krivūlė;SPINDULIUKAI;1980001276;Taip;6;0;2;8
3883;Krivūlė;SPINDULIUKAI;14824959974;Taip;0;3;0;3
3884;Krivūlė;BORUŽĖLĖS;4969782237;Taip;8;0;0;8
3885;Krivūlė;BORUŽĖLĖS;3605506478;Taip;0;0;1;1
3886;Krivūlė;BORUŽĖLĖS;4896656209;Taip;0;0;1;1
3887;Krivūlė;BORUŽĖLĖS;4845515196;Taip;0;1;0;1
3888;Krivūlė;BORUŽĖLĖS;5676562063;Taip;12;0;0;12
3889;Krivūlė;BORUŽĖLĖS;6935969502;Taip;7;0;0;7
3890;Krivūlė;BORUŽĖLĖS;4972360440;Taip;20;0;0;20
3891;Krivūlė;BORUŽĖLĖS;7318064702;Taip;0;1;0;1
3892;Krivūlė;BORUŽĖLĖS;3912620138;Taip;2;0;0;2
3893;Krivūlė;BORUŽĖLĖS;3246787504;Taip;7;0;0;7
3894;Krivūlė;BORUŽĖLĖS;5531566792;Taip;2;0;0;2
3895;Krivūlė;BORUŽĖLĖS;2386053480;Taip;1;0;2;3
3896;Krivūlė;BORUŽĖLĖS;8586287004;Taip;7;0;4;11
3897;Krivūlė;BORUŽĖLĖS;4540069843;Taip;12;0;3;15
3898;Krivūlė;BORUŽĖLĖS;4297876008;Taip;0;10;0;10
3899;Krivūlė;BORUŽĖLĖS;2138125571;Taip;1;0;0;1
3900;Krivūlė;BORUŽĖLĖS;4257468922;Taip;11;2;0;13
3901;Krivūlė;BORUŽĖLĖS;4177660973;Taip;5;3;0;8
3902;Krivūlė;BORUŽĖLĖS;2517785727;Taip;0;0;11;11
3903;Krivūlė;BORUŽĖLĖS;2711010212;Taip;13;0;0;13
3904;Krivūlė;BORUŽĖLĖS;4025821636;Taip;20;0;0;20
3905;Krivūlė;DRUGELIŲ;23648162135;Taip;0;2;1;3
3906;Krivūlė;DRUGELIŲ;1061891147;Taip;0;0;9;9
3907;Krivūlė;DRUGELIŲ;61141298766;Taip;0;1;1;2
3908;Krivūlė;DRUGELIŲ;3203271448;Taip;6;0;2;8
3909;Krivūlė;DRUGELIŲ;56163922565;Taip;0;0;5;5
3910;Krivūlė;DRUGELIŲ;29375281615;Taip;9;1;0;10
3911;Krivūlė;DRUGELIŲ;10583191450;Taip;10;0;0;10
3912;Krivūlė;DRUGELIŲ;13434120023;Taip;8;1;0;9
3913;Krivūlė;DRUGELIŲ;5825154729;Taip;0;0;2;2
3914;Krivūlė;DRUGELIŲ;54700834388;Taip;0;1;4;5
3915;Krivūlė;DRUGELIŲ;1465116151;Taip;3;0;1;4
3916;Krivūlė;DRUGELIŲ;97176703854;Taip;0;4;0;4
3917;Krivūlė;DRUGELIŲ;3594180341;Ne;0;0;1;1
3918;Krivūlė;DRUGELIŲ;7042541581;Taip;0;0;1;1
3919;Krivūlė;"BITUTĖS (VALDOFRO)";73736799724;Taip;9;0;2;11
3920;Krivūlė;"BITUTĖS (VALDOFRO)";60958909807;Taip;0;1;0;1
3921;Krivūlė;"BITUTĖS (VALDOFRO)";66552145067;Taip;0;1;0;1
3922;Krivūlė;"BITUTĖS (VALDOFRO)";66555601736;Taip;0;0;4;4
3923;Krivūlė;"BITUTĖS (VALDOFRO)";99074500749;Taip;0;0;4;4
3924;Krivūlė;"BITUTĖS (VALDOFRO)";46337826378;Taip;0;7;0;7
3925;Krivūlė;"BITUTĖS (VALDOFRO)";98620856056;Taip;3;10;0;13
3926;Krivūlė;"BITUTĖS (VALDOFRO)";1588621536;Taip;0;0;2;2
3927;Krivūlė;"BITUTĖS (VALDOFRO)";97075230746;Taip;0;1;0;1
3928;Krivūlė;"BITUTĖS (VALDOFRO)";91939517475;Taip;0;0;1;1
3929;Krivūlė;"BITUTĖS (VALDOFRO)";97859012083;Taip;0;1;1;2
3930;Krivūlė;"BITUTĖS (VALDOFRO)";37704437957;Taip;0;0;6;6
3931;Krivūlė;"BITUTĖS (VALDOFRO)";2425023811;Taip;0;0;2;2
3932;Krivūlė;"BITUTĖS (VALDOFRO)";4838666934;Taip;0;0;1;1
3933;Krivūlė;"BITUTĖS (VALDOFRO)";3994278221;Taip;0;0;1;1
3934;Krivūlė;"BITUTĖS (VALDOFRO)";3868507751;Taip;0;0;2;2
3935;Krivūlė;"BITUTĖS (VALDOFRO)";18486357195;Taip;10;1;0;11
3936;Krivūlė;"BITUTĖS (VALDOFRO)";1851097789;Taip;5;0;0;5
3937;Krivūlė;"BITUTĖS (VALDOFRO)";7789248863;Taip;4;0;0;4
3938;Krivūlė;"BITUTĖS (VALDOFRO)";4823819882;Taip;0;0;21;21
3939;Krivūlė;"BITUTĖS (VALDOFRO)";5113297248;Taip;9;0;2;11
3940;Krivūlė;EŽIUKAI;10433396718;Taip;11;0;0;11
3941;Krivūlė;EŽIUKAI;80991786508;Taip;0;1;0;1
3942;Krivūlė;EŽIUKAI;44741515819;Taip;5;0;0;5
3943;Krivūlė;EŽIUKAI;2099607493;Taip;10;0;0;10
3944;Krivūlė;EŽIUKAI;1989923269;Taip;0;0;2;2
3945;Krivūlė;EŽIUKAI;1290759541;Taip;6;0;2;8
3946;Krivūlė;EŽIUKAI;28308524979;Taip;0;1;0;1
3947;Krivūlė;EŽIUKAI;1699961817;Taip;4;0;5;9
3948;Krivūlė;EŽIUKAI;96319752378;Taip;5;0;2;7
3949;Krivūlė;EŽIUKAI;66981981114;Taip;0;9;9;18
3950;Krivūlė;EŽIUKAI;50967415904;Taip;0;1;5;6
3951;Krivūlė;EŽIUKAI;1265788772;Taip;5;0;0;5
3952;Krivūlė;EŽIUKAI;1113101710;Taip;0;0;1;1
3953;Krivūlė;EŽIUKAI;8463621294;Taip;0;0;3;3
3954;Krivūlė;EŽIUKAI;86659723162;Taip;7;0;0;7
3955;Krivūlė;EŽIUKAI;2125078552;Taip;0;1;0;1
3956;Krivūlė;EŽIUKAI;2903062788;Ne;0;10;2;12
3957;Krivūlė;EŽIUKAI;81401012140;Taip;0;0;11;11
3958;Krivūlė;NYKŠTUKAI;37502093836;Taip;5;1;7;13
3959;Krivūlė;NYKŠTUKAI;83840444975;Taip;5;1;7;13
3960;Krivūlė;NYKŠTUKAI;19674882649;Taip;0;4;0;4
3961;Krivūlė;NYKŠTUKAI;701438210;Taip;6;0;1;7
3962;Krivūlė;NYKŠTUKAI;1657452686;Taip;9;0;0;9
3963;Krivūlė;NYKŠTUKAI;73760357378;Taip;7;0;0;7
3964;Krivūlė;NYKŠTUKAI;3015266398;Taip;5;9;4;18
3965;Krivūlė;NYKŠTUKAI;2109315338;Taip;6;0;0;6
3966;Krivūlė;NYKŠTUKAI;7873123757;Taip;5;0;0;5
3967;Krivūlė;NYKŠTUKAI;97398901468;Taip;5;0;0;5
3968;Krivūlė;NYKŠTUKAI;10005041572;Taip;3;0;0;3
3969;Krivūlė;NYKŠTUKAI;1515185307;Taip;5;1;3;9
3970;Krivūlė;NYKŠTUKAI;1217856292;Taip;11;0;1;12
3971;Krivūlė;NYKŠTUKAI;3064591570;Taip;4;0;1;5
3972;Krivūlė;NYKŠTUKAI;7922515745;Taip;12;0;1;13
3973;Krivūlė;NYKŠTUKAI;9311270695;Taip;0;0;2;2
3974;Krivūlė;NYKŠTUKAI;6861483854;Taip;13;0;0;13
3975;Krivūlė;NYKŠTUKAI;1283858948;Taip;21;0;0;21
3976;Krivūlė;NYKŠTUKAI;7052198958;Taip;6;0;2;8
3977;Krivūlė;NYKŠTUKAI;5818988913;Taip;0;0;1;1
3978;Kodėlčiukas;Saulutės;42540143229;Taip;0;2;0;2
3979;Kodėlčiukas;Saulutės;79090323340;Taip;0;1;0;1
3980;Kodėlčiukas;Saulutės;5922075420;Taip;1;0;1;2
3981;Kodėlčiukas;Saulutės;82725509126;Taip;0;5;1;6
3982;Kodėlčiukas;Saulutės;1905426469;Taip;6;2;4;12
3983;Kodėlčiukas;Saulutės;79742559803;Taip;4;0;0;4
3984;Kodėlčiukas;Saulutės;68236236113;Taip;0;1;1;2
3985;Kodėlčiukas;Saulutės;62309098505;Taip;11;1;0;12
3986;Kodėlčiukas;Saulutės;14611425618;Taip;0;5;0;5
3987;Kodėlčiukas;Saulutės;49784617790;Taip;0;1;0;1
3988;Kodėlčiukas;Saulutės;43335982030;Taip;6;1;0;7
3989;Kodėlčiukas;Saulutės;49731697380;Taip;0;2;3;5
3990;Kodėlčiukas;Saulutės;23065888472;Taip;0;9;0;9
3991;Kodėlčiukas;Saulutės;1730913401;Taip;0;0;2;2
3992;Kodėlčiukas;Saulutės;98738524708;Taip;0;1;2;3
3993;Kodėlčiukas;Saulutės;66109277013;Taip;0;7;0;7
3994;Kodėlčiukas;Saulutės;48669541733;Taip;0;0;1;1
3995;Kodėlčiukas;Saulutės;45910018746;Taip;0;9;0;9
3996;Kodėlčiukas;Saulutės;1608321100;Taip;5;2;1;8
3997;Kodėlčiukas;Saulutės;24024963204;Taip;0;0;4;4
3998;Kodėlčiukas;Saulutės;1290630625;Taip;3;0;0;3
3999;Kodėlčiukas;Saulutės;9323563664;Taip;0;0;1;1
4000;Kodėlčiukas;Nežiniukai;49317624340;Taip;11;0;3;14
4001;Kodėlčiukas;Nežiniukai;69860272843;Taip;0;5;0;5
4002;Kodėlčiukas;Nežiniukai;52040715568;Taip;0;2;0;2
4003;Kodėlčiukas;Nežiniukai;37852137155;Taip;0;0;2;2
4004;Kodėlčiukas;Nežiniukai;86134523927;Taip;5;0;4;9
4005;Kodėlčiukas;Nežiniukai;47677246360;Taip;2;0;0;2
4006;Kodėlčiukas;Nežiniukai;46307870009;Taip;2;4;6;12
4007;Kodėlčiukas;Nežiniukai;35337024913;Taip;0;0;1;1
4008;Kodėlčiukas;Nežiniukai;82927457803;Taip;0;2;0;2
4009;Kodėlčiukas;Nežiniukai;33432780322;Taip;11;3;0;14
4010;Kodėlčiukas;Nežiniukai;96270550335;Taip;0;0;2;2
4011;Kodėlčiukas;Nežiniukai;30874603769;Taip;0;0;16;16
4012;Kodėlčiukas;Nežiniukai;50411894014;Ne;0;0;3;3
4013;Kodėlčiukas;Nežiniukai;93698504377;Taip;0;0;6;6
4014;Kodėlčiukas;Nežiniukai;1518135854;Ne;0;1;1;2
4015;Kodėlčiukas;Nežiniukai;41664027247;Taip;7;0;0;7
4016;Kodėlčiukas;Nežiniukai;35779814505;Taip;15;0;0;15
4017;Kodėlčiukas;Nežiniukai;1614088526;Taip;9;0;1;10
4018;Kodėlčiukas;Nežiniukai;1951603132;Taip;11;0;1;12
4019;Kodėlčiukas;Nežiniukai;15211280060;Taip;6;0;0;6
4020;Kodėlčiukas;Gintarėliai;58406224468;Taip;6;0;2;8
4021;Kodėlčiukas;Gintarėliai;1485012710;Taip;7;4;2;13
4022;Kodėlčiukas;Gintarėliai;5520128823;Taip;1;0;1;2
4023;Kodėlčiukas;Gintarėliai;2062878300;Taip;11;3;0;14
4024;Kodėlčiukas;Gintarėliai;20084022099;Taip;15;0;0;15
4025;Kodėlčiukas;Gintarėliai;1950934087;Taip;11;0;0;11
4026;Kodėlčiukas;Gintarėliai;9686497547;Taip;5;0;0;5
4027;Kodėlčiukas;Gintarėliai;4884104023;Taip;2;0;4;6
4028;Kodėlčiukas;Gintarėliai;9332136116;Taip;4;0;0;4
4029;Kodėlčiukas;Gintarėliai;4944791330;Taip;1;0;3;4
4030;Kodėlčiukas;Gintarėliai;8219424737;Taip;13;0;0;13
4031;Kodėlčiukas;Gintarėliai;4849314647;Taip;5;0;1;6
4032;Kodėlčiukas;Gintarėliai;1923835699;Taip;6;0;1;7
4033;Kodėlčiukas;Gintarėliai;3758606327;Taip;1;0;2;3
4034;Kodėlčiukas;Gintarėliai;8647609373;Taip;19;0;0;19
4035;Kodėlčiukas;Gintarėliai;5093139270;Taip;5;0;0;5
4036;Kodėlčiukas;Gintarėliai;4738357524;Taip;0;0;2;2
4037;Kodėlčiukas;Gintarėliai;8075591032;Taip;5;0;0;5
4038;Kodėlčiukas;Gintarėliai;8873629130;Taip;8;0;0;8
4039;Kodėlčiukas;Gintarėliai;2765869141;Taip;0;0;6;6
4040;Kodėlčiukas;Šnekučiai;1844016431;Taip;6;0;1;7
4041;Kodėlčiukas;Šnekučiai;1550915654;Taip;0;0;2;2
4042;Kodėlčiukas;Šnekučiai;1935757837;Taip;0;5;0;5
4043;Kodėlčiukas;Šnekučiai;41123326737;Taip;0;2;0;2
4044;Kodėlčiukas;Šnekučiai;8114859362;Taip;8;0;5;13
4045;Kodėlčiukas;Šnekučiai;1666743304;Taip;7;0;0;7
4046;Kodėlčiukas;Šnekučiai;1432342305;Taip;0;0;1;1
4047;Kodėlčiukas;Šnekučiai;1584936719;Taip;0;0;2;2
4048;Kodėlčiukas;Šnekučiai;9178209049;Taip;10;0;2;12
4049;Kodėlčiukas;Šnekučiai;5988863934;Taip;7;6;0;13
4050;Kodėlčiukas;Šnekučiai;2742365461;Taip;0;9;0;9
4051;Kodėlčiukas;Šnekučiai;76164689333;Taip;1;0;0;1
4052;Kodėlčiukas;Šnekučiai;5386820408;Taip;5;1;0;6
4053;Kodėlčiukas;Šnekučiai;6194726931;Taip;11;3;0;14
4054;Kodėlčiukas;Šnekučiai;6327741830;Taip;19;0;0;19
4055;Kodėlčiukas;Šnekučiai;7074381835;Taip;14;0;2;16
4056;Kodėlčiukas;Šnekučiai;7757494295;Taip;11;0;0;11
4057;Kodėlčiukas;Šnekučiai;5827455834;Taip;0;5;0;5
4058;Kodėlčiukas;Šnekučiai;2988674717;Taip;6;2;4;12
4059;Kodėlčiukas;Pabiručiai;2108297221;Taip;4;0;0;4
4060;Kodėlčiukas;Pabiručiai;39617728687;Taip;0;0;2;2
4061;Kodėlčiukas;Pabiručiai;81633973264;Taip;0;0;6;6
4062;Kodėlčiukas;Pabiručiai;58428282965;Ne;20;0;0;20
4063;Kodėlčiukas;Pabiručiai;51185323645;Taip;0;5;0;5
4064;Kodėlčiukas;Pabiručiai;48423906431;Taip;0;0;2;2
4065;Kodėlčiukas;Pabiručiai;87708953660;Taip;0;0;3;3
4066;Kodėlčiukas;Pabiručiai;53418429595;Taip;0;2;0;2
4067;Kodėlčiukas;Pabiručiai;88106769076;Taip;0;0;9;9
4068;Kodėlčiukas;Pabiručiai;62762045244;Taip;0;0;2;2
4069;Kodėlčiukas;Pabiručiai;5333383758;Taip;0;0;1;1
4070;Kodėlčiukas;Pabiručiai;63558518927;Taip;0;0;1;1
4071;Kodėlčiukas;Pabiručiai;6878848127;Taip;9;0;0;9
4072;Kodėlčiukas;Pabiručiai;78294320340;Taip;0;3;0;3
4073;Kodėlčiukas;Pabiručiai;87517377176;Taip;0;0;2;2
4074;Kodėlčiukas;Pabiručiai;94058317569;Taip;0;0;4;4
4075;Kodėlčiukas;Pabiručiai;77935011738;Taip;0;1;2;3
4076;Kodėlčiukas;Pabiručiai;2315513519;Taip;0;0;1;1
4077;Kodėlčiukas;Pabiručiai;1833960742;Taip;0;7;0;7
4078;Kodėlčiukas;Pabiručiai;5421835194;Taip;6;1;0;7
4079;Kodėlčiukas;Pabiručiai;60728060670;Taip;0;2;0;2
4080;Kodėlčiukas;Smalsučiai;83992508203;Taip;1;0;0;1
4081;Kodėlčiukas;Smalsučiai;67642708813;Taip;0;1;0;1
4082;Kodėlčiukas;Smalsučiai;20612460521;Taip;1;1;0;2
4083;Kodėlčiukas;Smalsučiai;5708143211;Taip;0;0;2;2
4084;Kodėlčiukas;Smalsučiai;36383021317;Ne;0;11;0;11
4085;Kodėlčiukas;Smalsučiai;67870841376;Taip;0;2;0;2
4086;Kodėlčiukas;Smalsučiai;9551387327;Taip;0;0;6;6
4087;Kodėlčiukas;Smalsučiai;14856898838;Taip;10;0;5;15
4088;Kodėlčiukas;Smalsučiai;4126338806;Taip;0;2;2;4
4089;Kodėlčiukas;Smalsučiai;96798716829;Taip;0;5;0;5
4090;Kodėlčiukas;Smalsučiai;30131221448;Taip;2;0;2;4
4091;Kodėlčiukas;Smalsučiai;84863948327;Taip;20;0;1;21
4092;Kodėlčiukas;Smalsučiai;85578471272;Taip;10;0;0;10
4093;Kodėlčiukas;Smalsučiai;74068673680;Taip;0;1;0;1
4094;Kodėlčiukas;Smalsučiai;70047045302;Ne;6;4;0;10
4095;Kodėlčiukas;Smalsučiai;83002620619;Taip;0;4;0;4
4096;Kodėlčiukas;Smalsučiai;39818301789;Taip;7;9;0;16
4097;Kodėlčiukas;Smalsučiai;83838177418;Taip;0;2;0;2
4098;Kodėlčiukas;Smalsučiai;32715685481;Taip;7;0;0;7
4099;Kodėlčiukas;Smalsučiai;90639838215;Taip;5;1;3;9
4100;Kodėlčiukas;Smalsučiai;76998539095;Taip;1;9;2;12
4101;Kodėlčiukas;Smalsučiai;10616561892;Taip;0;0;7;7
4102;Kodėlčiukas;Smalsučiai;59447524564;Taip;0;1;0;1
4103;Kodėlčiukas;Giliukai;26010333641;Taip;0;0;2;2
4104;Kodėlčiukas;Giliukai;90443995599;Taip;0;1;0;1
4105;Kodėlčiukas;Giliukai;1782784297;Taip;10;2;0;12
4106;Kodėlčiukas;Giliukai;97902789189;Taip;2;0;0;2
4107;Kodėlčiukas;Giliukai;99164081259;Taip;7;1;1;9
4108;Kodėlčiukas;Giliukai;93684599166;Taip;1;1;0;2
4109;Kodėlčiukas;Giliukai;88371652763;Taip;4;1;1;6
4110;Kodėlčiukas;Giliukai;80767435810;Taip;5;0;3;8
4111;Kodėlčiukas;Giliukai;62063291384;Taip;0;2;1;3
4112;Kodėlčiukas;Giliukai;1825630143;Taip;10;0;11;21
4113;Kodėlčiukas;Giliukai;11130172902;Taip;4;0;7;11
4114;Kodėlčiukas;Giliukai;29830674331;Taip;0;1;0;1
4115;Kodėlčiukas;Giliukai;1330761392;Taip;5;0;1;6
4116;Kodėlčiukas;Giliukai;24138056567;Taip;0;5;0;5
4117;Kodėlčiukas;Giliukai;84905680496;Taip;0;1;0;1
4118;Kodėlčiukas;Giliukai;58893099621;Taip;0;1;2;3
4119;Kodėlčiukas;Giliukai;2637712514;Taip;9;0;0;9
4120;Kodėlčiukas;Giliukai;1354133871;Taip;0;0;5;5
4121;Kodėlčiukas;Giliukai;45393129631;Taip;5;0;2;7
4122;Kodėlčiukas;Giliukai;47667750562;Taip;1;2;0;3
4123;Kodėlčiukas;Giliukai;8204069897;Taip;0;0;1;1
4124;Kodėlčiukas;Giliukai;1938753417;Taip;0;0;2;2
4125;Kodėlčiukas;Giliukai;29319461634;Taip;0;2;0;2
4126;Kodėlčiukas;Gudručiai;20467065338;Taip;4;0;3;7
4127;Kodėlčiukas;Gudručiai;44431255380;Taip;1;0;3;4
4128;Kodėlčiukas;Gudručiai;32318234528;Taip;7;0;6;13
4129;Kodėlčiukas;Gudručiai;9315712284;Taip;7;0;1;8
4130;Kodėlčiukas;Gudručiai;93275059990;Taip;0;3;0;3
4131;Kodėlčiukas;Gudručiai;18557158044;Taip;0;0;1;1
4132;Kodėlčiukas;Gudručiai;3542081571;Taip;6;0;3;9
4133;Kodėlčiukas;Gudručiai;84450296241;Taip;3;1;0;4
4134;Kodėlčiukas;Gudručiai;1234971388;Taip;0;1;5;6
4135;Kodėlčiukas;Gudručiai;1048653620;Taip;0;3;1;4
4136;Kodėlčiukas;Gudručiai;1202105251;Taip;10;1;1;12
4137;Kodėlčiukas;Gudručiai;1251970125;Taip;0;0;1;1
4138;Kodėlčiukas;Gudručiai;70940790491;Taip;0;1;3;4
4139;Kodėlčiukas;Gudručiai;1106092960;Taip;0;0;6;6
4140;Kodėlčiukas;Gudručiai;8393750817;Taip;0;0;6;6
4141;Kodėlčiukas;Gudručiai;2061169442;Taip;1;0;0;1
4142;Kodėlčiukas;Gudručiai;1723716524;Taip;7;0;0;7
4143;Kodėlčiukas;Gudručiai;87784905691;Taip;3;1;1;5
4144;Kodėlčiukas;Žirniukai;7327247516;Taip;3;0;0;3
4145;Kodėlčiukas;Žirniukai;1725624698;Taip;0;0;1;1
4146;Kodėlčiukas;Žirniukai;6988515253;Taip;8;0;0;8
4147;Kodėlčiukas;Žirniukai;3385551650;Taip;5;0;1;6
4148;Kodėlčiukas;Žirniukai;7080578299;Taip;17;0;0;17
4149;Kodėlčiukas;Žirniukai;9865803714;Taip;0;0;14;14
4150;Kodėlčiukas;Žirniukai;7430239198;Taip;11;0;0;11
4151;Kodėlčiukas;Žirniukai;2464972409;Taip;10;1;4;15
4152;Kodėlčiukas;Žirniukai;7116594055;Taip;4;1;0;5
4153;Kodėlčiukas;Žirniukai;8890987483;Taip;0;0;1;1
4154;Kodėlčiukas;Žirniukai;7509476161;Taip;5;0;0;5
4155;Kodėlčiukas;Žirniukai;4687333060;Taip;8;1;0;9
4156;Kodėlčiukas;Žirniukai;1491160730;Taip;3;0;0;3
4157;Kodėlčiukas;Žirniukai;2216791610;Taip;10;1;0;11
4158;Kodėlčiukas;Katinėliai;6248137523;Taip;0;0;3;3
4159;Kodėlčiukas;Katinėliai;1233880820;Taip;8;0;4;12
4160;Kodėlčiukas;Katinėliai;5443377251;Taip;1;2;0;3
4161;Kodėlčiukas;Katinėliai;6045564826;Taip;15;0;0;15
4162;Kodėlčiukas;Katinėliai;7282579315;Taip;7;0;0;7
4163;Kodėlčiukas;Katinėliai;3150006441;Taip;0;0;1;1
4164;Kodėlčiukas;Katinėliai;7626940433;Taip;0;7;0;7
4165;Kodėlčiukas;Katinėliai;4917910801;Taip;0;1;0;1
4166;Kodėlčiukas;Katinėliai;1699358514;Taip;5;0;1;6
4167;Kodėlčiukas;Katinėliai;4038168647;Taip;0;0;3;3
4168;Kodėlčiukas;Katinėliai;8378295683;Taip;16;0;0;16
4169;Kodėlčiukas;Katinėliai;6000831611;Taip;5;0;6;11
4170;Kodėlčiukas;Nykštukai;7246243975;Taip;3;2;0;5
4171;Kodėlčiukas;Nykštukai;1906128091;Taip;0;0;4;4
4172;Kodėlčiukas;Nykštukai;8879977943;Taip;0;6;0;6
4173;Kodėlčiukas;Nykštukai;8140940288;Taip;0;0;8;8
4174;Kodėlčiukas;Nykštukai;2929946390;Taip;0;9;0;9
4175;Kodėlčiukas;Nykštukai;9528997865;Taip;16;5;0;21
4176;Kodėlčiukas;Nykštukai;3782714343;Taip;5;0;1;6
4177;Kodėlčiukas;Nykštukai;1600501494;Taip;0;0;1;1
4178;Kodėlčiukas;Nykštukai;9460792167;Taip;12;0;1;13
4179;Kodėlčiukas;Nykštukai;1256650715;Taip;0;0;2;2
4180;Kodėlčiukas;Nykštukai;4818678923;Taip;17;0;0;17
4181;Kodėlčiukas;Nykštukai;8302606312;Taip;11;0;1;12
4182;Kodėlčiukas;Nykštukai;1919722425;Taip;0;1;0;1
4183;Kodėlčiukas;Nykštukai;1218904283;Taip;5;0;1;6
4184;Kodėlčiukas;Nykštukai;3880019350;Taip;5;0;0;5
4185;Kodėlčiukas;Nykštukai;7630180473;Taip;12;0;5;17
4186;Kodėlčiukas;Nykštukai;9589692031;Taip;10;9;1;20
4187;Kodėlčiukas;Nykštukai;2593524511;Taip;0;0;1;1
4188;Kodėlčiukas;Nykštukai;9794875862;Taip;2;0;2;4
4189;Klevelis;Gėlytės;61178149504;Taip;0;3;0;3
4190;Klevelis;Gėlytės;36864673412;Taip;4;0;0;4
4191;Klevelis;Gėlytės;65540816272;Taip;0;7;0;7
4192;Klevelis;Gėlytės;8756257605;Taip;10;0;0;10
4193;Klevelis;Gėlytės;15615294726;Taip;0;0;7;7
4194;Klevelis;Gėlytės;3101947555;Taip;0;6;0;6
4195;Klevelis;Gėlytės;7829685182;Taip;0;0;7;7
4196;Klevelis;Gėlytės;1024982577;Ne;0;10;0;10
4197;Klevelis;Gėlytės;7309676894;Taip;0;10;0;10
4198;Klevelis;Gėlytės;1942666372;Taip;0;16;0;16
4199;Klevelis;Gėlytės;50441219517;Taip;0;1;0;1
4200;Klevelis;Gėlytės;8154620920;Ne;0;14;0;14
4201;Klevelis;Paukšteliai;1606294984;Taip;2;10;0;12
4202;Klevelis;Paukšteliai;1685710938;Taip;0;6;0;6
4203;Klevelis;Paukšteliai;1757321892;Taip;0;1;0;1
4204;Klevelis;Paukšteliai;88565114332;Taip;0;0;1;1
4205;Klevelis;Paukšteliai;7506522045;Taip;0;0;1;1
4206;Klevelis;Paukšteliai;8155136607;Ne;0;5;0;5
4207;Klevelis;Paukšteliai;6172016747;Taip;1;2;0;3
4208;Klevelis;Paukšteliai;1161906832;Taip;0;0;3;3
4209;Klevelis;Paukšteliai;4930308435;Taip;0;4;0;4
4210;Klevelis;Paukšteliai;3408705916;Taip;0;10;0;10
4211;Klevelis;Paukšteliai;2555810841;Taip;3;0;1;4
4212;Klevelis;Paukšteliai;5024289280;Taip;0;0;2;2
4213;Klevelis;Paukšteliai;9689230151;Taip;3;0;2;5
4214;Klevelis;Paukšteliai;3437712794;Taip;6;0;0;6
4215;Klevelis;Paukšteliai;2744433344;Taip;0;0;6;6
4216;Klevelis;Paukšteliai;5354831337;Ne;0;1;0;1
4217;Klevelis;Paukšteliai;1851385706;Taip;0;2;0;2
4218;Klevelis;Spindulėliai;8957321461;Taip;0;8;0;8
4219;Klevelis;Spindulėliai;72505352951;Ne;0;5;0;5
4220;Klevelis;Spindulėliai;36733972781;Ne;0;5;0;5
4221;Klevelis;Spindulėliai;1929138590;Taip;2;6;0;8
4222;Klevelis;Spindulėliai;71637673796;Taip;0;7;0;7
4223;Klevelis;Spindulėliai;49983865253;Taip;0;16;0;16
4224;Klevelis;Spindulėliai;85910214189;Taip;0;6;0;6
4225;Klevelis;Spindulėliai;2041814549;Taip;0;6;1;7
4226;Klevelis;Spindulėliai;1608781752;Taip;0;5;0;5
4227;Klevelis;Spindulėliai;32063805512;Taip;0;7;0;7
4228;Klevelis;Spindulėliai;5786557195;Taip;8;0;0;8
4229;Klevelis;Spindulėliai;1980755137;Taip;0;1;0;1
4230;Klevelis;Spindulėliai;8246422485;Taip;2;7;0;9
4231;Klevelis;Spindulėliai;58302265771;Taip;0;1;2;3
4232;Klevelis;Spindulėliai;4733970252;Taip;1;0;4;5
4233;Klevelis;Spindulėliai;1141466643;Taip;0;3;0;3
4234;Klevelis;Spindulėliai;9125827523;Taip;17;0;0;17
4235;Klevelis;Spindulėliai;3397741232;Taip;6;4;0;10
4236;Klevelis;Spindulėliai;1520846063;Taip;2;9;0;11
4237;Klevelis;Spindulėliai;3201144750;Taip;0;10;0;10
4238;Klevelis;BORUŽĖLĖS;8195584468;Taip;0;4;0;4
4239;Klevelis;BORUŽĖLĖS;8357021249;Taip;8;0;0;8
4240;Klevelis;BORUŽĖLĖS;4558350854;Ne;0;0;4;4
4241;Klevelis;BORUŽĖLĖS;3873345138;Ne;0;0;7;7
4242;Klevelis;BORUŽĖLĖS;1020095914;Taip;0;0;2;2
4243;Klevelis;BORUŽĖLĖS;1749117711;Taip;10;0;3;13
4244;Klevelis;BORUŽĖLĖS;5402403433;Taip;1;0;2;3
4245;Klevelis;BORUŽĖLĖS;4424095457;Taip;1;0;0;1
4246;Klevelis;BORUŽĖLĖS;2207041148;Taip;12;0;0;12
4247;Klevelis;BORUŽĖLĖS;9291855374;Taip;0;5;0;5
4248;Klevelis;BORUŽĖLĖS;7855598075;Taip;15;2;0;17
4249;Klevelis;BORUŽĖLĖS;2031118410;Taip;13;0;0;13
4250;Klevelis;BORUŽĖLĖS;6488139414;Taip;18;0;0;18
4251;Klevelis;BORUŽĖLĖS;7115198351;Taip;11;0;0;11
4252;Kurpaitė;Viščiukų;8669676262;Taip;5;0;0;5
4253;Kurpaitė;Viščiukų;2827617670;Taip;15;0;0;15
4254;Kurpaitė;Viščiukų;4168882748;Taip;0;8;0;8
4255;Kurpaitė;Viščiukų;9062514113;Taip;6;0;0;6
4256;Kurpaitė;Viščiukų;7546409044;Taip;0;19;0;19
4257;Kurpaitė;Viščiukų;4592795281;Taip;7;8;0;15
4258;Kurpaitė;Viščiukų;4964063637;Taip;16;0;0;16
4259;Kurpaitė;Viščiukų;5609161523;Taip;2;0;0;2
4260;Kurpaitė;Viščiukų;9480290430;Taip;0;1;0;1
4261;Kurpaitė;Viščiukų;8868415451;Taip;11;0;0;11
4262;Kurpaitė;Viščiukų;9655585527;Ne;4;1;0;5
4263;Kurpaitė;Viščiukų;4684525618;Taip;0;21;0;21
4264;Kurpaitė;Viščiukų;3634641300;Taip;11;0;0;11
4265;Kurpaitė;Viščiukų;9529949992;Taip;18;0;0;18
4266;Kurpaitė;Viščiukų;4602268315;Taip;21;0;0;21
4267;Kurpaitė;Gėlyčių;9435979008;Taip;11;0;0;11
4268;Kurpaitė;Gėlyčių;7431793716;Taip;0;21;0;21
4269;Kurpaitė;Gėlyčių;72710210157;Taip;0;8;0;8
4270;Kurpaitė;Gėlyčių;24410351286;Taip;0;13;0;13
4271;Kurpaitė;Gėlyčių;2359555461;Taip;11;1;0;12
4272;Kurpaitė;Gėlyčių;1505783589;Taip;13;2;0;15
4273;Kurpaitė;Gėlyčių;7249931704;Taip;0;10;0;10
4274;Kurpaitė;Gėlyčių;3102257512;Taip;6;2;0;8
4275;Kurpaitė;Gėlyčių;58127430940;Taip;5;5;0;10
4276;Kurpaitė;Gėlyčių;1606617694;Taip;0;19;0;19
4277;Kurpaitė;Gėlyčių;1660650556;Taip;2;8;0;10
4278;Kurpaitė;Gėlyčių;1151128660;Taip;6;0;0;6
4279;Kurpaitė;Gėlyčių;1457318954;Taip;0;2;0;2
4280;Kurpaitė;Gėlyčių;2116580903;Taip;0;7;0;7
4281;Kurpaitė;Gėlyčių;65434834152;Taip;7;4;0;11
4282;Kurpaitė;Gėlyčių;3660687688;Taip;0;10;0;10
4283;Kurpaitė;Gėlyčių;2890934301;Taip;6;0;0;6
4284;Kurpaitė;Gėlyčių;9063294667;Taip;0;2;0;2
4285;Kurpaitė;Drugelių;49970457589;Taip;0;11;0;11
4286;Kurpaitė;Drugelių;62959992605;Taip;0;14;0;14
4287;Kurpaitė;Drugelių;38605683298;Taip;0;1;0;1
4288;Kurpaitė;Drugelių;5394176979;Taip;12;0;0;12
4289;Kurpaitė;Drugelių;5442955475;Taip;0;1;0;1
4290;Kurpaitė;Drugelių;31201788860;Taip;0;15;0;15
4291;Kurpaitė;Drugelių;65418822653;Taip;0;1;0;1
4292;Kurpaitė;Drugelių;66920939967;Taip;0;7;0;7
4293;Kurpaitė;Drugelių;1730735673;Taip;0;1;0;1
4294;Kurpaitė;Drugelių;52852801754;Taip;1;0;0;1
4295;Kurpaitė;Drugelių;43247754405;Taip;5;12;0;17
4296;Kurpaitė;Drugelių;54840686231;Taip;0;7;0;7
4297;Kurpaitė;Drugelių;48526842780;Taip;0;4;0;4
4298;Kurpaitė;Drugelių;61993267223;Taip;0;8;0;8
4299;Kurpaitė;Drugelių;71716344368;Taip;0;3;0;3
4300;Kurpaitė;Drugelių;48538300542;Taip;5;1;0;6
4301;Kurpaitė;Drugelių;85698687930;Taip;9;0;0;9
4302;Kurpaitė;Drugelių;6826856088;Taip;1;0;0;1
4303;Kurpaitė;Pelyčių;9919068986;Taip;0;12;0;12
4304;Kurpaitė;Pelyčių;54413485607;Taip;0;5;0;5
4305;Kurpaitė;Pelyčių;41686757437;Taip;0;6;0;6
4306;Kurpaitė;Pelyčių;32817744462;Taip;0;1;3;4
4307;Kurpaitė;Pelyčių;1993159901;Taip;0;7;0;7
4308;Kurpaitė;Pelyčių;31034408890;Taip;10;7;0;17
4309;Kurpaitė;Pelyčių;42531654257;Taip;0;3;0;3
4310;Kurpaitė;Pelyčių;42230129130;Taip;0;7;0;7
4311;Kurpaitė;Pelyčių;28569380108;Taip;4;9;0;13
4312;Kurpaitė;Pelyčių;52350974867;Taip;0;1;0;1
4313;Kurpaitė;Pelyčių;86497821794;Taip;0;1;0;1
4314;Kurpaitė;Pelyčių;14193840490;Taip;6;0;0;6
4315;Kurpaitė;Pelyčių;34995551069;Taip;0;1;0;1
4316;Kurpaitė;Pelyčių;71783740325;Taip;1;0;0;1
4317;Kurpaitė;Pelyčių;1136113867;Taip;0;13;0;13
4318;Kurpaitė;Pelyčių;1936055251;Taip;0;1;0;1
4319;Kurpaitė;Pelyčių;3697560973;Taip;15;1;0;16
4320;Kurpaitė;Pelyčių;5902371603;Taip;0;8;0;8
4321;Kūlverstukas;Saulutės;1816105412;Taip;0;5;0;5
4322;Kūlverstukas;Saulutės;4028937969;Taip;6;6;4;16
4323;Kūlverstukas;Saulutės;1109035765;Taip;4;0;0;4
4324;Kūlverstukas;Saulutės;1570383265;Taip;5;0;1;6
4325;Kūlverstukas;Saulutės;46862868133;Taip;0;0;2;2
4326;Kūlverstukas;Saulutės;3737085009;Taip;0;0;5;5
4327;Kūlverstukas;Saulutės;49788909084;Taip;0;1;10;11
4328;Kūlverstukas;Saulutės;1009117653;Taip;1;0;0;1
4329;Kūlverstukas;Saulutės;8362459952;Taip;10;0;3;13
4330;Kūlverstukas;Saulutės;74829986958;Taip;5;1;5;11
4331;Kūlverstukas;Saulutės;22294704115;Taip;0;0;3;3
4332;Kūlverstukas;Saulutės;47399326083;Taip;5;0;2;7
4333;Kūlverstukas;Saulutės;21138396996;Taip;1;5;1;7
4334;Kūlverstukas;Saulutės;1000393691;Taip;0;0;7;7
4335;Kūlverstukas;Saulutės;2135571148;Taip;5;0;2;7
4336;Kūlverstukas;Saulutės;1987591278;Taip;16;0;5;21
4337;Kūlverstukas;Saulutės;1396533792;Taip;7;0;1;8
4338;Kūlverstukas;Peledžiukai;1399479148;Taip;9;0;0;9
4339;Kūlverstukas;Peledžiukai;85330859485;Taip;8;0;1;9
4340;Kūlverstukas;Peledžiukai;2179050825;Taip;3;0;0;3
4341;Kūlverstukas;Peledžiukai;81294065628;Taip;7;0;0;7
4342;Kūlverstukas;Peledžiukai;89965851223;Ne;1;1;0;2
4343;Kūlverstukas;Peledžiukai;2972422399;Taip;1;0;1;2
4344;Kūlverstukas;Peledžiukai;46254945540;Taip;1;0;0;1
4345;Kūlverstukas;Peledžiukai;80342796585;Taip;0;5;0;5
4346;Kūlverstukas;Peledžiukai;55515614021;Taip;3;0;0;3
4347;Kūlverstukas;Peledžiukai;61916609121;Taip;2;0;0;2
4348;Kūlverstukas;Peledžiukai;1260193245;Taip;21;0;0;21
4349;Kūlverstukas;Peledžiukai;29398080266;Taip;6;0;0;6
4350;Kūlverstukas;Peledžiukai;10716234461;Taip;0;3;0;3
4351;Kūlverstukas;Peledžiukai;9856560184;Taip;0;0;1;1
4352;Kūlverstukas;Peledžiukai;89179106633;Ne;0;5;0;5
4353;Kūlverstukas;Peledžiukai;79760811110;Taip;0;0;1;1
4354;Kūlverstukas;Gelytės;2130099456;Taip;0;0;2;2
4355;Kūlverstukas;Gelytės;1226883894;Taip;0;0;10;10
4356;Kūlverstukas;Gelytės;37991935289;Taip;14;1;0;15
4357;Kūlverstukas;Gelytės;2716194746;Taip;0;2;7;9
4358;Kūlverstukas;Gelytės;7440474403;Taip;9;0;0;9
4359;Kūlverstukas;Gelytės;8891671739;Taip;10;0;11;21
4360;Kūlverstukas;Gelytės;3991821717;Taip;8;5;0;13
4361;Kūlverstukas;Gelytės;5488011852;Taip;1;1;1;3
4362;Kūlverstukas;Gelytės;8092104136;Taip;0;0;12;12
4363;Kūlverstukas;Gelytės;7480593611;Ne;0;7;0;7
4364;Kūlverstukas;Gelytės;1699783763;Taip;4;2;0;6
4365;Kūlverstukas;Gelytės;1240006602;Taip;11;0;0;11
4366;Kūlverstukas;Gelytės;3162189859;Taip;6;0;11;17
4367;Kūlverstukas;Gelytės;5372936730;Taip;13;1;0;14
4368;Kūlverstukas;Gelytės;1452422691;Taip;14;0;0;14
4369;Kūlverstukas;Bitutės;3270176280;Taip;0;2;0;2
4370;Kūlverstukas;Bitutės;1932066021;Taip;4;0;0;4
4371;Kūlverstukas;Bitutės;4073233921;Taip;0;0;3;3
4372;Kūlverstukas;Bitutės;9427388681;Taip;0;8;0;8
4373;Kūlverstukas;Bitutės;5345423038;Taip;5;0;1;6
4374;Kūlverstukas;Bitutės;8853848991;Taip;5;0;0;5
4375;Kūlverstukas;Bitutės;4285624305;Taip;10;1;10;21
4376;Kūlverstukas;Bitutės;5103259175;Taip;0;1;15;16
4377;Kūlverstukas;Bitutės;9167460438;Taip;2;0;4;6
4378;Kūlverstukas;Bitutės;2087570702;Taip;9;0;1;10
4379;Kūlverstukas;Bitutės;5488852698;Taip;5;0;1;6
4380;Kūlverstukas;Bitutės;2419847093;Taip;0;1;2;3
4381;Kūlverstukas;Bitutės;1898905623;Taip;21;0;0;21
4382;Kūlverstukas;Bitutės;3069047204;Taip;8;0;8;16
4383;Kūlverstukas;Bitutės;2169480822;Taip;0;0;2;2
4384;Lakštingala;Saulutės;33332213331;Taip;3;1;0;4
4385;Lakštingala;Saulutės;35681729219;Ne;0;1;0;1
4386;Lakštingala;Saulutės;1416434491;Taip;12;1;0;13
4387;Lakštingala;Saulutės;17738218138;Taip;1;0;0;1
4388;Lakštingala;Saulutės;23753553201;Taip;0;0;7;7
4389;Lakštingala;Saulutės;31706572403;Taip;8;0;0;8
4390;Lakštingala;Saulutės;53652623242;Taip;0;1;0;1
4391;Lakštingala;Saulutės;51200162218;Taip;10;0;0;10
4392;Lakštingala;Saulutės;22211300772;Taip;2;0;0;2
4393;Lakštingala;Saulutės;18470272487;Taip;1;3;0;4
4394;Lakštingala;Saulutės;25804940619;Taip;0;1;0;1
4395;Lakštingala;Saulutės;35357852412;Taip;0;1;2;3
4396;Lakštingala;Saulutės;1914662837;Taip;4;1;0;5
4397;Lakštingala;Saulutės;87760794641;Taip;0;5;0;5
4398;Lakštingala;Saulutės;87223860105;Ne;0;9;0;9
4399;Lakštingala;Saulutės;1451425863;Taip;5;0;1;6
4400;Lakštingala;Saulutės;78156519200;Taip;0;0;1;1
4401;Lakštingala;Saulutės;98174553118;Taip;0;1;0;1
4402;Lakštingala;Nykštukai;45850246980;Taip;0;1;0;1
4403;Lakštingala;Nykštukai;74001349345;Taip;0;3;2;5
4404;Lakštingala;Nykštukai;51586922715;Taip;0;10;0;10
4405;Lakštingala;Nykštukai;31221126819;Taip;0;0;4;4
4406;Lakštingala;Nykštukai;95489864230;Taip;1;2;0;3
4407;Lakštingala;Nykštukai;10653315095;Ne;9;1;0;10
4408;Lakštingala;Nykštukai;96792864646;Taip;0;2;1;3
4409;Lakštingala;Nykštukai;43151626858;Taip;0;3;0;3
4410;Lakštingala;Nykštukai;79652151224;Ne;0;1;0;1
4411;Lakštingala;Nykštukai;5692087454;Taip;1;2;0;3
4412;Lakštingala;Nykštukai;780078103;Taip;0;1;0;1
4413;Lakštingala;Nykštukai;68037499606;Taip;0;2;1;3
4414;Lakštingala;Nykštukai;93222430249;Taip;2;0;0;2
4415;Lakštingala;Nykštukai;89747320378;Taip;0;5;0;5
4416;Lakštingala;Nykštukai;79583726414;Taip;11;3;0;14
4417;Lakštingala;Nykštukai;2430795418;Taip;0;0;1;1
4418;Lakštingala;Nykštukai;40682764019;Taip;0;1;0;1
4419;Lakštingala;Nykštukai;62866040506;Taip;0;2;0;2
4420;Lakštingala;Nykštukai;57836156450;Taip;0;2;0;2
4421;Lakštingala;Nykštukai;50868279016;Taip;0;6;2;8
4422;Lakštingala;Nykštukai;3426133948;Taip;0;7;0;7
4423;Lakštingala;Nykštukai;37722153251;Taip;12;0;0;12
4424;Lakštingala;Bitutės;81628046226;Taip;0;1;0;1
4425;Lakštingala;Bitutės;4915919195;Taip;5;0;0;5
4426;Lakštingala;Bitutės;63360792078;Taip;0;7;0;7
4427;Lakštingala;Bitutės;1150148262;Taip;0;1;0;1
4428;Lakštingala;Bitutės;88634927621;Taip;0;5;0;5
4429;Lakštingala;Bitutės;58670695979;Taip;0;3;0;3
4430;Lakštingala;Bitutės;1208496587;Taip;0;2;0;2
4431;Lakštingala;Bitutės;1478103633;Taip;5;1;0;6
4432;Lakštingala;Bitutės;5460505229;Taip;0;3;2;5
4433;Lakštingala;Bitutės;43764846549;Taip;0;1;0;1
4434;Lakštingala;Bitutės;41745695244;Taip;0;1;0;1
4435;Lakštingala;Bitutės;59776948588;Taip;8;1;2;11
4436;Lakštingala;Bitutės;7179277612;Taip;8;2;0;10
4437;Lakštingala;Bitutės;85722261846;Taip;0;3;0;3
4438;Lakštingala;Bitutės;1484725137;Taip;4;0;0;4
4439;Lakštingala;Bitutės;90557374701;Taip;6;0;0;6
4440;Lakštingala;Bitutės;70253545165;Taip;0;2;0;2
4441;Lakštingala;Bitutės;49381287243;Taip;0;1;0;1
4442;Lakštingala;Bitutės;96502788115;Taip;2;3;0;5
4443;Lakštingala;Bitutės;20671216208;Taip;0;1;2;3
4444;Lakštingala;Bitutės;3544861594;Taip;0;9;0;9
4445;Lakštingala;Bitutės;75081412082;Taip;1;2;0;3
4446;Lakštingala;Pūkeliai;95149875628;Taip;0;14;0;14
4447;Lakštingala;Pūkeliai;72834597919;Taip;0;1;0;1
4448;Lakštingala;Pūkeliai;82319560992;Taip;0;7;0;7
4449;Lakštingala;Pūkeliai;14826956710;Taip;20;0;0;20
4450;Lakštingala;Pūkeliai;1056248263;Taip;1;10;0;11
4451;Lakštingala;Pūkeliai;92129853333;Taip;8;0;0;8
4452;Lakštingala;Pūkeliai;19356167631;Taip;7;1;0;8
4453;Lakštingala;Pūkeliai;56646163756;Taip;0;10;0;10
4454;Lakštingala;Pūkeliai;33431377093;Taip;0;2;1;3
4455;Lakštingala;Pūkeliai;63698553352;Taip;0;1;0;1
4456;Lakštingala;Pūkeliai;16039738423;Taip;0;0;2;2
4457;Lakštingala;Pūkeliai;45199150020;Taip;0;4;0;4
4458;Lakštingala;Pūkeliai;24905526995;Taip;0;1;1;2
4459;Lakštingala;Pūkeliai;2106666739;Taip;5;0;0;5
4460;Lakštingala;Aitvariukai;36990696663;Taip;0;3;2;5
4461;Lakštingala;Aitvariukai;99780001413;Taip;21;0;0;21
4462;Lakštingala;Aitvariukai;20201679407;Taip;0;5;0;5
4463;Lakštingala;Aitvariukai;7857821609;Taip;0;3;0;3
4464;Lakštingala;Aitvariukai;8946285512;Ne;0;2;0;2
4465;Lakštingala;Aitvariukai;33957315145;Taip;0;6;0;6
4466;Lakštingala;Aitvariukai;19833280319;Taip;6;1;0;7
4467;Lakštingala;Aitvariukai;2088394089;Taip;10;1;0;11
4468;Lakštingala;Aitvariukai;15819827141;Taip;0;3;0;3
4469;Lakštingala;Aitvariukai;61122948431;Ne;0;1;0;1
4470;Lakštingala;Aitvariukai;84766974984;Taip;0;7;0;7
4471;Lakštingala;Aitvariukai;26675933922;Taip;0;1;0;1
4472;Lakštingala;Aitvariukai;70041878575;Taip;0;0;4;4
4473;Lakštingala;Aitvariukai;69176146563;Taip;0;0;4;4
4474;Lakštingala;Aitvariukai;8781225219;Taip;0;3;2;5
4475;Lakštingala;Aitvariukai;86429853759;Taip;0;2;0;2
4476;Lakštingala;Aitvariukai;78648398334;Taip;21;0;0;21
4477;Lakštingala;Boružiukai;9795993812;Taip;0;6;0;6
4478;Lakštingala;Boružiukai;3280380015;Taip;0;2;0;2
4479;Lakštingala;Boružiukai;43313173294;Taip;5;2;0;7
4480;Lakštingala;Boružiukai;9004336424;Taip;0;0;9;9
4481;Lakštingala;Boružiukai;8820053026;Taip;0;1;0;1
4482;Lakštingala;Boružiukai;8873445262;Taip;9;0;0;9
4483;Lakštingala;Boružiukai;4811759034;Taip;0;2;0;2
4484;Lakštingala;Boružiukai;1898853302;Taip;0;1;0;1
4485;Lakštingala;Boružiukai;7443563000;Taip;0;0;1;1
4486;Lakštingala;Boružiukai;2792618575;Taip;0;11;0;11
4487;Lakštingala;Boružiukai;55720630870;Taip;0;0;1;1
4488;Lakštingala;Boružiukai;4818524423;Taip;6;0;1;7
4489;Lakštingala;Boružiukai;1444534032;Taip;11;0;0;11
4490;Lakštingala;Boružiukai;6150013105;Taip;5;0;0;5
4491;Lakštingala;Boružiukai;2130767942;Taip;0;0;13;13
4492;Lakštingala;Boružiukai;9724531753;Taip;0;0;2;2
4493;Lakštingala;"KIŠKUČIAI (SAV.)";64992551832;Taip;0;7;0;7
4494;Lakštingala;"KIŠKUČIAI (SAV.)";1169891428;Taip;3;1;0;4
4495;Lakštingala;"KIŠKUČIAI (SAV.)";1409132656;Taip;0;1;0;1
4496;Lakštingala;"KIŠKUČIAI (SAV.)";1236087612;Taip;0;1;0;1
4497;Lakštingala;"KIŠKUČIAI (SAV.)";80762133625;Taip;0;2;0;2
4498;Lakštingala;"KIŠKUČIAI (SAV.)";1128658722;Taip;5;1;0;6
4499;Lakštingala;"KIŠKUČIAI (SAV.)";9862985913;Taip;6;0;0;6
4500;Lakštingala;"KIŠKUČIAI (SAV.)";8645237294;Taip;0;1;0;1
4501;Lakštingala;"KIŠKUČIAI (SAV.)";1538315501;Taip;2;2;1;5
4502;Lakštingala;"KIŠKUČIAI (SAV.)";1663637599;Taip;21;0;0;21
4503;Lakštingala;"KIŠKUČIAI (SAV.)";1716046309;Taip;0;2;0;2
4504;Lakštingala;"KIŠKUČIAI (SAV.)";3660645944;Taip;0;9;0;9
4505;Lakštingala;"KIŠKUČIAI (SAV.)";7038977283;Taip;0;1;0;1
4506;Lakštingala;"KIŠKUČIAI (SAV.)";80142440362;Taip;0;1;0;1
4507;Lakštingala;"KIŠKUČIAI (SAV.)";7623300327;Taip;2;1;0;3
4508;Lakštingala;"KIŠKUČIAI (SAV.)";2241000661;Taip;2;1;0;3
4509;Lakštingala;Žiogeliai;2104150466;Taip;3;0;0;3
4510;Lakštingala;Žiogeliai;9395512638;Taip;0;1;0;1
4511;Lakštingala;Žiogeliai;9689911725;Taip;1;1;0;2
4512;Lakštingala;Žiogeliai;8705627810;Taip;18;0;0;18
4513;Lakštingala;Žiogeliai;1832608585;Taip;11;0;0;11
4514;Lakštingala;Žiogeliai;9958821769;Taip;7;0;0;7
4515;Lakštingala;Žiogeliai;7953724873;Taip;0;3;0;3
4516;Lakštingala;Žiogeliai;9800992468;Taip;0;0;1;1
4517;Lakštingala;Žiogeliai;1411121466;Taip;5;2;0;7
4518;Lakštingala;Žiogeliai;8944088082;Taip;4;3;2;9
4519;Lakštingala;Žiogeliai;9897713625;Taip;0;1;0;1
4520;Lakštingala;Žiogeliai;70798601578;Taip;18;0;0;18
4521;Lakštingala;Žiogeliai;1736130324;Taip;1;1;0;2
4522;Lakštingala;Žiogeliai;2039579203;Taip;1;1;0;2
4523;Lakštingala;Žiogeliai;6576202365;Taip;11;0;1;12
4524;Lakštingala;Žiogeliai;89044575245;Taip;0;0;17;17
4525;Lakštingala;Žiogeliai;9497327995;Taip;4;0;0;4
4526;Lakštingala;Žiogeliai;8016552114;Taip;0;21;0;21
4527;Lakštingala;Žiogeliai;8470575927;Taip;1;0;0;1
4528;Lakštingala;SPINDULIUKAI;19003276281;Taip;11;0;0;11
4529;Lakštingala;SPINDULIUKAI;31911078405;Taip;11;0;0;11
4530;Lakštingala;SPINDULIUKAI;1263184555;Taip;0;2;0;2
4531;Lakštingala;SPINDULIUKAI;42012300013;Taip;1;1;0;2
4532;Lakštingala;SPINDULIUKAI;2002196654;Taip;3;1;0;4
4533;Lakštingala;SPINDULIUKAI;4261431738;Taip;0;1;0;1
4534;Lakštingala;SPINDULIUKAI;58847206918;Taip;0;0;3;3
4535;Lakštingala;SPINDULIUKAI;5033145687;Taip;4;1;0;5
4536;Lakštingala;SPINDULIUKAI;26288159700;Taip;8;0;1;9
4537;Lakštingala;SPINDULIUKAI;11399672681;Taip;5;0;0;5
4538;Lakštingala;SPINDULIUKAI;95832669291;Taip;8;6;0;14
4539;Lakštingala;SPINDULIUKAI;4183492894;Taip;0;1;0;1
4540;Lakštingala;SPINDULIUKAI;65408046990;Taip;0;5;2;7
4541;Lakštingala;SPINDULIUKAI;48160996499;Taip;17;0;0;17
4542;Lakštingala;SPINDULIUKAI;70748679017;Taip;1;0;0;1
4543;Lakštingala;SPINDULIUKAI;37897965773;Taip;0;4;0;4
4544;Lakštingala;SPINDULIUKAI;4770775472;Taip;0;4;0;4
4545;Lakštingala;SPINDULIUKAI;7448175606;Taip;0;8;0;8
4546;Lakštingala;Pėledžiukai;98609129644;Taip;0;12;0;12
4547;Lakštingala;Pėledžiukai;2635399411;Taip;0;1;0;1
4548;Lakštingala;Pėledžiukai;7325183642;Taip;6;0;0;6
4549;Lakštingala;Pėledžiukai;21094902562;Taip;8;0;0;8
4550;Lakštingala;Pėledžiukai;1297637335;Taip;0;1;0;1
4551;Lakštingala;Pėledžiukai;1271455798;Taip;0;2;0;2
4552;Lakštingala;Pėledžiukai;1868573076;Taip;6;1;0;7
4553;Lakštingala;Pėledžiukai;14410791110;Taip;0;2;0;2
4554;Lakštingala;Pėledžiukai;30840899725;Taip;13;0;0;13
4555;Lakštingala;Pėledžiukai;1676655778;Taip;19;0;0;19
4556;Lakštingala;Pėledžiukai;15430318196;Taip;0;0;19;19
4557;Lakštingala;Pėledžiukai;9381815353;Taip;0;2;0;2
4558;Lakštingala;Pėledžiukai;25449089230;Taip;0;7;0;7
4559;Lakštingala;Pėledžiukai;91671174585;Taip;0;8;1;9
4560;Lakštingala;Pėledžiukai;1347480198;Taip;0;1;0;1
4561;Lakštingala;Pėledžiukai;88947243829;Taip;0;1;0;1
4562;Lakštingala;Pėledžiukai;6329787217;Taip;0;1;6;7
4563;Lakštingala;Pėledžiukai;58056130761;Taip;0;10;0;10
4564;Lakštingala;Pėledžiukai;1310400524;Taip;0;3;1;4
4565;Lakštingala;Pėledžiukai;2013216779;Taip;0;3;0;3
4566;Lakštingala;Pėledžiukai;8890852891;Taip;0;2;0;2
4567;Lakštingala;Pėledžiukai;9998322501;Taip;0;0;14;14
4568;Lakštingala;Katinėliai;9774836470;Taip;1;2;0;3
4569;Lakštingala;Katinėliai;7929034243;Taip;2;0;0;2
4570;Lakštingala;Katinėliai;8171357606;Taip;0;5;0;5
4571;Lakštingala;Katinėliai;6780591792;Taip;2;0;0;2
4572;Lakštingala;Katinėliai;9431217584;Taip;4;0;10;14
4573;Lakštingala;Katinėliai;2962846236;Taip;0;0;4;4
4574;Lakštingala;Katinėliai;3811230983;Taip;3;0;0;3
4575;Lakštingala;Katinėliai;5854794141;Taip;0;6;0;6
4576;Lakštingala;Katinėliai;8422745100;Taip;0;3;0;3
4577;Lakštingala;Katinėliai;5598711072;Taip;10;0;0;10
4578;Lakštingala;Katinėliai;1958696382;Taip;0;0;11;11
4579;Lakštingala;Katinėliai;2022621678;Taip;0;0;7;7
4580;Lakštingala;Katinėliai;4542992319;Taip;0;0;14;14
4581;Lakštingala;Katinėliai;5537018556;Taip;0;1;0;1
4582;Lakštingala;Katinėliai;2593030897;Taip;3;0;0;3
4583;Lakštingala;Katinėliai;8529259340;Taip;0;12;9;21
4584;Lakštingala;Katinėliai;9762500668;Taip;5;8;0;13
4585;Lakštingala;Deimantėliai;4032030375;Taip;0;8;0;8
4586;Lakštingala;Deimantėliai;1655202909;Taip;13;0;0;13
4587;Lakštingala;Deimantėliai;8284565948;Taip;3;0;0;3
4588;Lakštingala;Deimantėliai;1648466517;Taip;1;2;0;3
4589;Lakštingala;Deimantėliai;3993759015;Taip;18;0;0;18
4590;Lakštingala;Deimantėliai;3568151046;Taip;4;0;0;4
4591;Lakštingala;Deimantėliai;9725851433;Taip;11;0;0;11
4592;Lakštingala;Deimantėliai;4700135106;Taip;0;2;0;2
4593;Lakštingala;Deimantėliai;1863034132;Taip;21;0;0;21
4594;Lakštingala;Deimantėliai;9879064676;Taip;10;0;0;10
4595;Lakštingala;Deimantėliai;2423651716;Taip;0;2;0;2
4596;Lakštingala;Deimantėliai;3369263112;Taip;10;1;0;11
4597;Lakštingala;Deimantėliai;9489982241;Taip;2;1;0;3
4598;Lakštingala;Deimantėliai;3724324861;Taip;15;0;0;15
4599;Lakštingala;Deimantėliai;2652305131;Taip;10;2;0;12
4600;Lakštingala;Deimantėliai;6332498461;Taip;6;3;3;12
4601;Lakštingala;Deimantėliai;9912622093;Taip;5;0;0;5
4602;Lašelis;VIŠČIUKAI;86191407652;Taip;0;0;1;1
4603;Lašelis;VIŠČIUKAI;8873895533;Taip;0;0;2;2
4604;Lašelis;VIŠČIUKAI;58391864442;Taip;7;0;0;7
4605;Lašelis;VIŠČIUKAI;10694830733;Ne;0;11;0;11
4606;Lašelis;VIŠČIUKAI;4320017329;Taip;8;0;0;8
4607;Lašelis;VIŠČIUKAI;1132803162;Taip;10;6;0;16
4608;Lašelis;VIŠČIUKAI;14934740494;Ne;5;4;0;9
4609;Lašelis;VIŠČIUKAI;1584708183;Taip;0;2;0;2
4610;Lašelis;VIŠČIUKAI;1282991939;Taip;6;0;0;6
4611;Lašelis;VIŠČIUKAI;60394164372;Taip;4;0;0;4
4612;Lašelis;VIŠČIUKAI;713862923;Taip;1;1;0;2
4613;Lašelis;VIŠČIUKAI;82073061357;Taip;1;1;0;2
4614;Lašelis;VIŠČIUKAI;4277113412;Ne;5;6;0;11
4615;Lašelis;VIŠČIUKAI;7349722463;Taip;0;3;0;3
4616;Lašelis;VIŠČIUKAI;2429224297;Taip;0;5;0;5
4617;Lašelis;VIŠČIUKAI;1383759549;Taip;8;0;3;11
4618;Lašelis;VIŠČIUKAI;2118500745;Taip;0;0;3;3
4619;Lašelis;VIŠČIUKAI;5437008837;Taip;13;0;0;13
4620;Lašelis;VIŠČIUKAI;1171647193;Taip;0;0;7;7
4621;Lašelis;ŠYPSENA;9391594216;Taip;0;9;0;9
4622;Lašelis;ŠYPSENA;65174922062;Taip;0;3;0;3
4623;Lašelis;ŠYPSENA;6977000987;Taip;1;0;1;2
4624;Lašelis;ŠYPSENA;4599789649;Taip;7;2;0;9
4625;Lašelis;ŠYPSENA;6090290046;Taip;17;0;0;17
4626;Lašelis;ŠYPSENA;1417989409;Taip;2;0;0;2
4627;Lašelis;ŠYPSENA;1193336600;Taip;0;12;1;13
4628;Lašelis;ŠYPSENA;1268330178;Taip;18;0;0;18
4629;Lašelis;ŠYPSENA;1739797553;Taip;0;2;0;2
4630;Lašelis;ŠYPSENA;1578956182;Taip;0;5;0;5
4631;Lašelis;ŠYPSENA;2500332755;Taip;0;4;0;4
4632;Lašelis;ŠYPSENA;1953392509;Taip;0;0;1;1
4633;Lašelis;ŠYPSENA;1343084840;Taip;15;2;0;17
4634;Lašelis;ŠYPSENA;7471332824;Taip;11;0;0;11
4635;Lašelis;ŠYPSENA;6492909546;Taip;0;1;0;1
4636;Lašelis;ŠYPSENA;8324581018;Ne;8;0;2;10
4637;Lašelis;ŠYPSENA;5046619730;Taip;0;0;1;1
4638;Lašelis;ŠYPSENA;3741905080;Taip;0;0;3;3
4639;Lašelis;NYKŠTUKAI;1614647892;Taip;6;0;0;6
4640;Lašelis;NYKŠTUKAI;8181369424;Taip;0;0;2;2
4641;Lašelis;NYKŠTUKAI;1534313851;Ne;0;1;0;1
4642;Lašelis;NYKŠTUKAI;40927906931;Taip;0;0;1;1
4643;Lašelis;NYKŠTUKAI;1099685342;Taip;0;8;0;8
4644;Lašelis;NYKŠTUKAI;38601962350;Taip;0;2;0;2
4645;Lašelis;NYKŠTUKAI;1917927039;Taip;0;9;0;9
4646;Lašelis;NYKŠTUKAI;3447120578;Taip;7;0;1;8
4647;Lašelis;NYKŠTUKAI;1833121579;Taip;9;0;0;9
4648;Lašelis;NYKŠTUKAI;1635550414;Taip;0;12;0;12
4649;Lašelis;NYKŠTUKAI;7047619741;Taip;10;0;1;11
4650;Lašelis;NYKŠTUKAI;85641710509;Taip;0;0;15;15
4651;Lašelis;NYKŠTUKAI;28071639285;Taip;0;5;0;5
4652;Lašelis;NYKŠTUKAI;37726695989;Taip;0;8;0;8
4653;Lašelis;NYKŠTUKAI;75224154074;Taip;0;4;0;4
4654;Lašelis;NYKŠTUKAI;29417065142;Taip;0;4;0;4
4655;Lašelis;NYKŠTUKAI;1711262987;Taip;21;0;0;21
4656;Lašelis;NYKŠTUKAI;73391370015;Taip;0;8;0;8
4657;Lašelis;SAULUTĖ;71550135640;Ne;0;13;0;13
4658;Lašelis;SAULUTĖ;17105970545;Taip;0;2;0;2
4659;Lašelis;SAULUTĖ;18905952587;Taip;0;5;0;5
4660;Lašelis;SAULUTĖ;39887519960;Taip;14;0;0;14
4661;Lašelis;SAULUTĖ;52081356883;Taip;0;1;0;1
4662;Lašelis;SAULUTĖ;19712015840;Taip;0;2;0;2
4663;Lašelis;SAULUTĖ;72661430712;Taip;9;2;0;11
4664;Lašelis;SAULUTĖ;94756490716;Taip;0;3;0;3
4665;Lašelis;SAULUTĖ;34947111596;Taip;7;0;0;7
4666;Lašelis;SAULUTĖ;29635578653;Taip;1;0;0;1
4667;Lašelis;SAULUTĖ;36907557289;Ne;0;3;0;3
4668;Lašelis;SAULUTĖ;92897887533;Ne;0;3;0;3
4669;Lašelis;SAULUTĖ;85978955807;Taip;0;12;0;12
4670;Lašelis;SAULUTĖ;20798875600;Ne;0;4;0;4
4671;Lašelis;SAULUTĖ;3505668718;Taip;0;6;0;6
4672;Lašelis;SAULUTĖ;72124622387;Taip;0;9;0;9
4673;Lašelis;BORUŽĖLĖS;1085400709;Taip;0;8;0;8
4674;Lašelis;BORUŽĖLĖS;7998812497;Taip;21;0;0;21
4675;Lašelis;BORUŽĖLĖS;2912232814;Taip;21;0;0;21
4676;Lašelis;BORUŽĖLĖS;6127747445;Taip;1;6;0;7
4677;Lašelis;BORUŽĖLĖS;1777442316;Taip;8;0;0;8
4678;Lašelis;BORUŽĖLĖS;6553762186;Taip;0;13;0;13
4679;Lašelis;BORUŽĖLĖS;3867799187;Taip;11;3;0;14
4680;Lašelis;BORUŽĖLĖS;3982877012;Taip;0;0;7;7
4681;Lašelis;BORUŽĖLĖS;6669130831;Taip;10;0;0;10
4682;Lašelis;BORUŽĖLĖS;5556821953;Taip;19;0;0;19
4683;Lašelis;BORUŽĖLĖS;1646912457;Taip;11;3;0;14
4684;Lašelis;BORUŽĖLĖS;1886540733;Taip;6;3;0;9
4685;Lašelis;BORUŽĖLĖS;4151582358;Taip;11;3;0;14
4686;Lašelis;BORUŽĖLĖS;7802622810;Taip;12;0;0;12
4687;Lašelis;SKRUZDELIUKAI;8318512396;Taip;8;0;0;8
4688;Lašelis;SKRUZDELIUKAI;1244168190;Taip;5;3;0;8
4689;Lašelis;SKRUZDELIUKAI;7367305924;Taip;10;0;0;10
4690;Lašelis;SKRUZDELIUKAI;3495676199;Taip;6;0;0;6
4691;Lašelis;SKRUZDELIUKAI;3843163586;Taip;0;5;0;5
4692;Lašelis;SKRUZDELIUKAI;6304391719;Taip;1;1;0;2
4693;Lazdynėlis;BITUTĖS;75400333117;Taip;0;0;1;1
4694;Lazdynėlis;BITUTĖS;55695017411;Taip;0;21;0;21
4695;Lazdynėlis;BITUTĖS;50788636961;Taip;0;21;0;21
4696;Lazdynėlis;BITUTĖS;28176922691;Taip;0;0;2;2
4697;Lazdynėlis;BITUTĖS;48328518819;Taip;0;1;3;4
4698;Lazdynėlis;BITUTĖS;90734124818;Taip;0;1;0;1
4699;Lazdynėlis;BITUTĖS;83140388277;Taip;0;0;1;1
4700;Lazdynėlis;BITUTĖS;69220585579;Taip;0;1;5;6
4701;Lazdynėlis;BITUTĖS;79847018203;Taip;0;0;1;1
4702;Lazdynėlis;BITUTĖS;76733730112;Taip;0;0;4;4
4703;Lazdynėlis;BITUTĖS;95546662727;Taip;0;9;0;9
4704;Lazdynėlis;BITUTĖS;82313332357;Taip;0;21;0;21
4705;Lazdynėlis;BITUTĖS;57393413722;Taip;0;1;4;5
4706;Lazdynėlis;BITUTĖS;28670815274;Taip;0;10;0;10
4707;Lazdynėlis;BITUTĖS;57891137452;Taip;0;1;2;3
4708;Lazdynėlis;BITUTĖS;14797154110;Taip;0;1;3;4
4709;Lazdynėlis;BITUTĖS;8954195210;Taip;0;1;0;1
4710;Lazdynėlis;BITUTĖS;49407698116;Taip;4;0;0;4
4711;Lazdynėlis;BITUTĖS;8245694943;Taip;0;5;1;6
4712;Lazdynėlis;BITUTĖS;99629193401;Taip;0;0;7;7
4713;Lazdynėlis;BITUTĖS;57522150425;Taip;0;10;0;10
4714;Lazdynėlis;EŽIUKAI;5068598385;Taip;0;1;0;1
4715;Lazdynėlis;EŽIUKAI;2491872016;Taip;0;1;0;1
4716;Lazdynėlis;EŽIUKAI;2041709821;Taip;0;21;0;21
4717;Lazdynėlis;EŽIUKAI;32856469893;Taip;15;0;0;15
4718;Lazdynėlis;EŽIUKAI;6542840562;Taip;0;0;2;2
4719;Lazdynėlis;EŽIUKAI;8975341347;Taip;10;0;1;11
4720;Lazdynėlis;EŽIUKAI;5301460250;Taip;9;0;1;10
4721;Lazdynėlis;EŽIUKAI;1265404063;Taip;5;0;0;5
4722;Lazdynėlis;EŽIUKAI;83586382037;Taip;0;0;3;3
4723;Lazdynėlis;EŽIUKAI;7313399153;Taip;0;1;0;1
4724;Lazdynėlis;EŽIUKAI;10727984477;Taip;0;1;0;1
4725;Lazdynėlis;EŽIUKAI;9081770664;Taip;8;0;1;9
4726;Lazdynėlis;EŽIUKAI;1479568714;Taip;2;5;0;7
4727;Lazdynėlis;EŽIUKAI;8271766964;Taip;0;21;0;21
4728;Lazdynėlis;EŽIUKAI;9668839027;Taip;5;3;0;8
4729;Lazdynėlis;EŽIUKAI;2740122426;Taip;10;1;2;13
4730;Lazdynėlis;EŽIUKAI;47861078891;Taip;9;0;0;9
4731;Lazdynėlis;EŽIUKAI;2841262230;Taip;8;0;0;8
4732;Lazdynėlis;EŽIUKAI;7499322078;Taip;0;3;0;3
4733;Lazdynėlis;EŽIUKAI;48860174942;Taip;0;2;2;4
4734;Lazdynėlis;EŽIUKAI;92889991874;Taip;10;0;0;10
4735;Lazdynėlis;EŽIUKAI;91720096560;Taip;9;1;0;10
4736;Lazdynėlis;BORUŽIUKAI;2168516394;Taip;0;2;0;2
4737;Lazdynėlis;BORUŽIUKAI;4961149717;Taip;0;1;0;1
4738;Lazdynėlis;BORUŽIUKAI;6156638726;Taip;0;11;0;11
4739;Lazdynėlis;BORUŽIUKAI;1321841783;Taip;0;1;0;1
4740;Lazdynėlis;BORUŽIUKAI;1055608079;Taip;0;1;0;1
4741;Lazdynėlis;BORUŽIUKAI;9570299877;Taip;0;21;0;21
4742;Lazdynėlis;BORUŽIUKAI;1715738053;Taip;1;0;0;1
4743;Lazdynėlis;BORUŽIUKAI;50390821034;Taip;0;2;0;2
4744;Lazdynėlis;BORUŽIUKAI;2112064241;Taip;5;1;0;6
4745;Lazdynėlis;BORUŽIUKAI;86740660262;Taip;10;1;0;11
4746;Lazdynėlis;BORUŽIUKAI;1207280684;Taip;0;3;0;3
4747;Lazdynėlis;BORUŽIUKAI;57448939020;Taip;0;10;0;10
4748;Lazdynėlis;BORUŽIUKAI;1789237348;Taip;10;4;0;14
4749;Lazdynėlis;BORUŽIUKAI;2007361692;Taip;0;1;0;1
4750;Lazdynėlis;BORUŽIUKAI;2105998927;Taip;0;1;0;1
4751;Lazdynėlis;BORUŽIUKAI;29288665418;Taip;21;0;0;21
4752;Lazdynėlis;BORUŽIUKAI;1559884361;Taip;0;1;0;1
4753;Lazdynėlis;BORUŽIUKAI;11379612306;Taip;0;1;0;1
4754;Lazdynėlis;BORUŽIUKAI;7237629135;Taip;16;0;0;16
4755;Lazdynėlis;BORUŽIUKAI;8945282683;Taip;0;2;0;2
4756;Lazdynėlis;BORUŽIUKAI;5838945434;Taip;0;7;0;7
4757;Lazdynėlis;BORUŽIUKAI;6230420677;Taip;0;7;0;7
4758;Lazdynėlis;KAČIUKAI;3603045321;Taip;0;1;0;1
4759;Lazdynėlis;KAČIUKAI;58490612549;Taip;0;1;1;2
4760;Lazdynėlis;KAČIUKAI;43267615847;Taip;0;1;0;1
4761;Lazdynėlis;KAČIUKAI;59588430935;Taip;8;0;0;8
4762;Lazdynėlis;KAČIUKAI;66134107213;Taip;15;1;0;16
4763;Lazdynėlis;KAČIUKAI;32336340968;Taip;0;0;5;5
4764;Lazdynėlis;KAČIUKAI;23011537816;Taip;2;0;0;2
4765;Lazdynėlis;KAČIUKAI;61642550142;Ne;0;1;1;2
4766;Lazdynėlis;KAČIUKAI;67819115627;Taip;0;1;0;1
4767;Lazdynėlis;KAČIUKAI;52949287680;Taip;0;1;0;1
4768;Lazdynėlis;KAČIUKAI;97795271362;Taip;20;1;0;21
4769;Lazdynėlis;KAČIUKAI;56747379453;Taip;0;2;0;2
4770;Lazdynėlis;KAČIUKAI;1634936961;Taip;21;0;0;21
4771;Lazdynėlis;KAČIUKAI;65438421685;Taip;0;1;0;1
4772;Lazdynėlis;KAČIUKAI;79445476316;Taip;0;1;0;1
4773;Lazdynėlis;KAČIUKAI;5638072847;Taip;0;1;1;2
4774;Lazdynėlis;KAČIUKAI;78302777769;Taip;15;0;0;15
4775;Lazdynėlis;KAČIUKAI;87419458418;Taip;0;1;8;9
4776;Lazdynėlis;KAČIUKAI;85340642919;Taip;7;0;2;9
4777;Lazdynėlis;KAČIUKAI;77950321376;Taip;0;1;2;3
4778;Lazdynėlis;KAČIUKAI;62600252729;Ne;0;1;4;5
4779;Lazdynėlis;VOVERIUKAI;4425724586;Taip;10;0;1;11
4780;Lazdynėlis;VOVERIUKAI;4928593615;Taip;0;1;0;1
4781;Lazdynėlis;VOVERIUKAI;6684940385;Taip;18;0;0;18
4782;Lazdynėlis;VOVERIUKAI;9187681789;Taip;0;0;12;12
4783;Lazdynėlis;VOVERIUKAI;14427234202;Taip;4;0;0;4
4784;Lazdynėlis;VOVERIUKAI;1107441074;Taip;0;0;1;1
4785;Lazdynėlis;VOVERIUKAI;25596458181;Taip;0;21;0;21
4786;Lazdynėlis;VOVERIUKAI;24978945607;Taip;0;0;2;2
4787;Lazdynėlis;VOVERIUKAI;18498032472;Taip;0;0;2;2
4788;Lazdynėlis;VOVERIUKAI;158059657;Taip;0;1;4;5
4789;Lazdynėlis;VOVERIUKAI;1852865534;Taip;18;0;0;18
4790;Lazdynėlis;VOVERIUKAI;3902772678;Taip;7;1;0;8
4791;Lazdynėlis;VOVERIUKAI;8822378464;Taip;15;0;1;16
4792;Lazdynėlis;VOVERIUKAI;6863715428;Taip;0;0;2;2
4793;Lazdynėlis;VOVERIUKAI;2587142646;Taip;17;0;1;18
4794;Lazdynėlis;VOVERIUKAI;2603427970;Taip;21;0;0;21
4795;Lazdynėlis;VOVERIUKAI;2441835588;Taip;0;1;0;1
4796;Lazdynėlis;VOVERIUKAI;44510351979;Taip;0;10;0;10
4797;Lazdynėlis;VOVERIUKAI;7965433882;Taip;5;0;0;5
4798;Lazdynėlis;VOVERIUKAI;1424382629;Taip;11;0;0;11
4799;Lazdynėlis;RIEŠUTĖLIAI;82893485399;Taip;0;7;0;7
4800;Lazdynėlis;RIEŠUTĖLIAI;53141612488;Taip;3;1;0;4
4801;Lazdynėlis;RIEŠUTĖLIAI;81489861336;Taip;0;1;0;1
4802;Lazdynėlis;RIEŠUTĖLIAI;11830560488;Taip;0;1;2;3
4803;Lazdynėlis;RIEŠUTĖLIAI;24433496244;Taip;0;11;0;11
4804;Lazdynėlis;RIEŠUTĖLIAI;99158632198;Taip;3;1;0;4
4805;Lazdynėlis;RIEŠUTĖLIAI;4510916643;Taip;3;1;0;4
4806;Lazdynėlis;RIEŠUTĖLIAI;91895608057;Taip;0;1;0;1
4807;Lazdynėlis;RIEŠUTĖLIAI;95539787778;Taip;0;11;0;11
4808;Lazdynėlis;RIEŠUTĖLIAI;75017112973;Taip;3;0;0;3
4809;Lazdynėlis;RIEŠUTĖLIAI;66392058189;Taip;0;1;0;1
4810;Lazdynėlis;RIEŠUTĖLIAI;93311489447;Taip;8;4;0;12
4811;Lazdynėlis;RIEŠUTĖLIAI;3980826951;Taip;6;0;0;6
4812;Lazdynėlis;RIEŠUTĖLIAI;8338944978;Taip;0;1;1;2
4813;Lazdynėlis;RIEŠUTĖLIAI;1712263816;Taip;0;2;1;3
4814;Lazdynėlis;RIEŠUTĖLIAI;98624254124;Taip;0;1;0;1
4815;Lazdynėlis;RIEŠUTĖLIAI;1213657708;Taip;0;2;4;6
4816;Lazdynėlis;RIEŠUTĖLIAI;1169424024;Taip;0;4;0;4
4817;Lazdynėlis;RIEŠUTĖLIAI;1257093165;Taip;11;0;0;11
4818;Lazdynėlis;RIEŠUTĖLIAI;58985240094;Taip;0;0;5;5
4819;Lazdynėlis;ANČIUKAI;5888646355;Taip;7;0;1;8
4820;Lazdynėlis;ANČIUKAI;4758605343;Taip;0;0;17;17
4821;Lazdynėlis;ANČIUKAI;4842228703;Taip;6;0;0;6
4822;Lazdynėlis;ANČIUKAI;8295967906;Taip;0;0;2;2
4823;Lazdynėlis;ANČIUKAI;7076664657;Taip;0;0;3;3
4824;Lazdynėlis;ANČIUKAI;7864896721;Taip;1;0;3;4
4825;Lazdynėlis;ANČIUKAI;8435203145;Taip;3;0;1;4
4826;Lazdynėlis;ANČIUKAI;4779025603;Taip;0;0;17;17
4827;Lazdynėlis;ANČIUKAI;79583491543;Taip;4;0;0;4
4828;Lazdynėlis;ANČIUKAI;1878157118;Taip;0;1;0;1
4829;Lazdynėlis;ANČIUKAI;2998606948;Taip;19;0;0;19
4830;Lazdynėlis;ANČIUKAI;9886856760;Taip;19;0;0;19
4831;Lazdynėlis;ANČIUKAI;3062408541;Taip;5;11;0;16
4832;Lazdynėlis;ANČIUKAI;7941793866;Taip;11;0;2;13
4833;Lazdynėlis;ANČIUKAI;3667994076;Taip;0;21;0;21
4834;Lazdynėlis;ANČIUKAI;6762312809;Taip;14;2;2;18
4835;Lazdynėlis;ANČIUKAI;9881554733;Taip;0;5;0;5
4836;Lazdynėlis;ANČIUKAI;7242681767;Taip;4;0;1;5
4837;Lazdynėlis;ANČIUKAI;5796381191;Taip;0;21;0;21
4838;Lazdynėlis;ANČIUKAI;5708643953;Taip;0;0;1;1
4839;Lazdynėlis;GUDRUČIAI;6079498859;Ne;0;7;0;7
4840;Lazdynėlis;GUDRUČIAI;96599967318;Taip;0;0;2;2
4841;Lazdynėlis;GUDRUČIAI;16456265624;Taip;0;9;0;9
4842;Lazdynėlis;GUDRUČIAI;92885300680;Ne;0;21;0;21
4843;Lazdynėlis;GUDRUČIAI;44974714364;Taip;0;0;2;2
4844;Lazdynėlis;GUDRUČIAI;57304690488;Taip;0;0;2;2
4845;Lazdynėlis;GUDRUČIAI;57619129301;Taip;0;5;0;5
4846;Lazdynėlis;GUDRUČIAI;64086512959;Taip;4;0;0;4
4847;Lazdynėlis;GUDRUČIAI;56719158862;Taip;5;1;0;6
4848;Lazdynėlis;GUDRUČIAI;76657029807;Taip;0;1;0;1
4849;Lazdynėlis;GUDRUČIAI;41094911675;Taip;0;1;0;1
4850;Lazdynėlis;GUDRUČIAI;70505428445;Taip;4;1;0;5
4851;Lazdynėlis;GUDRUČIAI;47140772153;Taip;0;1;0;1
4852;Lazdynėlis;GUDRUČIAI;34657435789;Taip;0;3;0;3
4853;Lazdynėlis;GUDRUČIAI;62863155757;Taip;0;1;0;1
4854;Lazdynėlis;GUDRUČIAI;34619798427;Taip;0;1;0;1
4855;Lazdynėlis;GUDRUČIAI;1909075641;Taip;0;1;0;1
4856;Lazdynėlis;GUDRUČIAI;2496563388;Taip;5;1;0;6
4857;Lazdynėlis;GUDRUČIAI;8704566189;Taip;2;0;1;3
4858;Lazdynėlis;GUDRUČIAI;41929529092;Taip;0;0;3;3
4859;Lazdynėlis;MEŠKIUKAI;2013752858;Taip;0;1;6;7
4860;Lazdynėlis;MEŠKIUKAI;2586187455;Taip;8;1;0;9
4861;Lazdynėlis;MEŠKIUKAI;6038907328;Taip;0;15;0;15
4862;Lazdynėlis;MEŠKIUKAI;2032759165;Taip;5;0;0;5
4863;Lazdynėlis;MEŠKIUKAI;4142277927;Taip;10;3;0;13
4864;Lazdynėlis;MEŠKIUKAI;2044188250;Taip;0;7;2;9
4865;Lazdynėlis;MEŠKIUKAI;1450181711;Taip;2;0;0;2
4866;Lazdynėlis;MEŠKIUKAI;7911328294;Taip;0;1;0;1
4867;Lazdynėlis;MEŠKIUKAI;9761942869;Taip;0;1;3;4
4868;Lazdynėlis;MEŠKIUKAI;6557165567;Taip;16;0;2;18
4869;Lazdynėlis;MEŠKIUKAI;5557752248;Taip;0;21;0;21
4870;Lazdynėlis;MEŠKIUKAI;4545757725;Taip;0;21;0;21
4871;Lazdynėlis;MEŠKIUKAI;8159928299;Taip;0;0;4;4
4872;Lazdynėlis;MEŠKIUKAI;5030400578;Taip;8;1;0;9
4873;Lazdynėlis;MEŠKIUKAI;1574847460;Taip;0;21;0;21
4874;Lazdynėlis;MEŠKIUKAI;4462819848;Taip;1;0;4;5
4875;Lazdynėlis;MEŠKIUKAI;1748260780;Taip;0;21;0;21
4876;Lazdynėlis;MEŠKIUKAI;8008332680;Taip;7;0;0;7
4877;Lazdynėlis;MEŠKIUKAI;4826167852;Taip;0;21;0;21
4878;Linelis;Giliukai;85241351404;Ne;6;0;1;7
4879;Linelis;Giliukai;18406137746;Taip;0;0;2;2
4880;Linelis;Giliukai;29074930927;Taip;12;0;0;12
4881;Linelis;Giliukai;1539102468;Taip;0;0;1;1
4882;Linelis;Giliukai;79543604124;Taip;0;1;0;1
4883;Linelis;Giliukai;3300710386;Taip;6;0;1;7
4884;Linelis;Giliukai;1505058152;Taip;4;0;3;7
4885;Linelis;Giliukai;92658776822;Taip;0;8;0;8
4886;Linelis;Giliukai;4644771654;Taip;7;7;0;14
4887;Linelis;Giliukai;11026646292;Taip;8;0;2;10
4888;Linelis;Giliukai;94514045159;Taip;12;0;1;13
4889;Linelis;Giliukai;18847368957;Taip;0;0;2;2
4890;Linelis;Giliukai;1646521870;Taip;0;0;8;8
4891;Linelis;Giliukai;1270931913;Taip;0;0;2;2
4892;Linelis;Giliukai;1237521453;Taip;4;0;0;4
4893;Linelis;Giliukai;53442382594;Taip;4;0;4;8
4894;Linelis;Giliukai;87947273588;Taip;3;0;1;4
4895;Linelis;Giliukai;93959783827;Taip;0;0;1;1
4896;Linelis;Giliukai;1270843542;Taip;0;0;1;1
4897;Linelis;Giliukai;1159267747;Taip;6;4;0;10
4898;Linelis;Saulutė;39379678474;Taip;0;1;0;1
4899;Linelis;Saulutė;67550509307;Taip;0;1;1;2
4900;Linelis;Saulutė;50135757374;Taip;5;0;0;5
4901;Linelis;Saulutė;88082442940;Taip;0;5;0;5
4902;Linelis;Saulutė;78794214074;Taip;0;10;0;10
4903;Linelis;Saulutė;39302486335;Taip;0;1;0;1
4904;Linelis;Saulutė;77154624822;Taip;0;1;0;1
4905;Linelis;Saulutė;54594020356;Taip;0;0;9;9
4906;Linelis;Saulutė;68038417200;Taip;0;0;2;2
4907;Linelis;Saulutė;23823598531;Ne;0;1;5;6
4908;Linelis;Saulutė;26545201411;Taip;0;0;1;1
4909;Linelis;Saulutė;91181408578;Taip;0;0;3;3
4910;Linelis;Saulutė;44313943197;Taip;4;0;0;4
4911;Linelis;Saulutė;30874840026;Taip;12;0;0;12
4912;Linelis;Saulutė;13906245933;Taip;0;6;0;6
4913;Linelis;Saulutė;90100555876;Taip;0;1;1;2
4914;Linelis;Saulutė;62954795489;Taip;10;0;0;10
4915;Linelis;Saulutė;1478318177;Taip;0;19;0;19
4916;Linelis;Saulutė;13522521866;Taip;0;1;2;3
4917;Linelis;Nykštukai;58467930454;Taip;0;5;0;5
4918;Linelis;Nykštukai;38426234048;Taip;0;0;1;1
4919;Linelis;Nykštukai;1526473615;Taip;0;0;7;7
4920;Linelis;Nykštukai;61862257310;Taip;0;0;3;3
4921;Linelis;Nykštukai;1891722948;Taip;5;0;1;6
4922;Linelis;Nykštukai;1148540808;Taip;1;0;1;2
4923;Linelis;Nykštukai;4443285231;Taip;0;5;0;5
4924;Linelis;Nykštukai;5075219728;Taip;10;0;0;10
4925;Linelis;Nykštukai;8339073780;Taip;4;1;2;7
4926;Linelis;Nykštukai;5302605429;Taip;0;0;4;4
4927;Linelis;Nykštukai;7530950218;Taip;5;0;7;12
4928;Linelis;Nykštukai;71647031404;Taip;4;0;0;4
4929;Linelis;Nykštukai;1194624252;Taip;0;0;1;1
4930;Linelis;Nykštukai;46788785414;Taip;4;1;0;5
4931;Linelis;Nykštukai;3483401448;Taip;0;0;2;2
4932;Linelis;Nykštukai;2391319590;Taip;0;0;1;1
4933;Linelis;Nykštukai;1887737859;Taip;4;0;0;4
4934;Linelis;Daigiukai;6385439136;Taip;0;0;1;1
4935;Linelis;Daigiukai;1552829080;Taip;0;0;1;1
4936;Linelis;Daigiukai;4253571334;Taip;5;0;4;9
4937;Linelis;Daigiukai;4126444564;Taip;0;1;0;1
4938;Linelis;Daigiukai;8837847094;Taip;6;0;4;10
4939;Linelis;Daigiukai;3189188757;Taip;15;0;0;15
4940;Linelis;Daigiukai;1351957198;Taip;0;0;6;6
4941;Linelis;Daigiukai;7881263225;Taip;7;10;0;17
4942;Linelis;Daigiukai;3682550072;Taip;6;0;2;8
4943;Linelis;Daigiukai;2857645329;Taip;10;0;1;11
4944;Linelis;Daigiukai;6130634131;Taip;4;0;0;4
4945;Linelis;Daigiukai;8654487151;Taip;0;11;0;11
4946;Linelis;Daigiukai;6160295507;Taip;7;0;6;13
4947;Linelis;Daigiukai;6374352500;Taip;9;0;0;9
4948;Markučiai;Žirniukų;13358445982;Taip;0;1;0;1
4949;Markučiai;Žirniukų;4934200922;Taip;0;2;0;2
4950;Markučiai;Žirniukų;89393452327;Taip;0;0;7;7
4951;Markučiai;Žirniukų;9506953554;Taip;0;8;0;8
4952;Markučiai;Žirniukų;61354140820;Taip;0;1;0;1
4953;Markučiai;Žirniukų;86073430849;Taip;0;1;4;5
4954;Markučiai;Žirniukų;23712199138;Taip;3;0;0;3
4955;Markučiai;Žirniukų;59514770545;Taip;0;5;0;5
4956;Markučiai;Žirniukų;68178936347;Taip;13;0;0;13
4957;Markučiai;Žirniukų;95776655287;Taip;9;0;0;9
4958;Markučiai;Žirniukų;47122307518;Taip;0;0;4;4
4959;Markučiai;Žirniukų;9326053563;Taip;10;0;2;12
4960;Markučiai;Žirniukų;3498150320;Taip;5;3;0;8
4961;Markučiai;Žirniukų;1813116125;Taip;0;5;0;5
4962;Markučiai;Žirniukų;1150675918;Taip;4;0;2;6
4963;Markučiai;Žirniukų;95347461846;Taip;6;5;0;11
4964;Markučiai;Žirniukų;1962169822;Taip;4;0;0;4
4965;Markučiai;Žirniukų;4511936094;Taip;7;1;0;8
4966;Markučiai;Nykštukų;46647877230;Taip;0;6;0;6
4967;Markučiai;Nykštukų;37101160556;Taip;0;2;0;2
4968;Markučiai;Nykštukų;1473258832;Taip;4;0;0;4
4969;Markučiai;Nykštukų;92394309416;Taip;0;1;3;4
4970;Markučiai;Nykštukų;5026941590;Taip;8;0;0;8
4971;Markučiai;Nykštukų;6915912992;Taip;0;1;3;4
4972;Markučiai;Nykštukų;52920975294;Taip;0;0;1;1
4973;Markučiai;Nykštukų;88304161598;Taip;0;4;0;4
4974;Markučiai;Nykštukų;76003071176;Taip;0;1;0;1
4975;Markučiai;Nykštukų;7578995182;Taip;0;10;0;10
4976;Markučiai;Nykštukų;6639579832;Taip;2;1;0;3
4977;Markučiai;Nykštukų;9985442003;Taip;0;6;0;6
4978;Markučiai;Nykštukų;1507368475;Taip;7;0;0;7
4979;Markučiai;Nykštukų;1817367317;Taip;5;0;0;5
4980;Markučiai;Nykštukų;5954207590;Taip;7;0;0;7
4981;Markučiai;Pelėdžiukų;1586644788;Taip;4;0;0;4
4982;Markučiai;Pelėdžiukų;2539130198;Taip;0;0;3;3
4983;Markučiai;Pelėdžiukų;66953564222;Taip;0;2;2;4
4984;Markučiai;Pelėdžiukų;99878848764;Taip;0;1;11;12
4985;Markučiai;Pelėdžiukų;40039975519;Taip;3;1;0;4
4986;Markučiai;Pelėdžiukų;47402355544;Taip;10;7;0;17
4987;Markučiai;Pelėdžiukų;62012358431;Taip;5;2;2;9
4988;Markučiai;Pelėdžiukų;35937680002;Taip;2;1;1;4
4989;Markučiai;Pelėdžiukų;80867943870;Taip;2;2;0;4
4990;Markučiai;Pelėdžiukų;86596936099;Taip;0;4;0;4
4991;Markučiai;Pelėdžiukų;29403750068;Taip;5;0;0;5
4992;Markučiai;Pelėdžiukų;37310130818;Taip;0;7;0;7
4993;Markučiai;Pelėdžiukų;52599782800;Taip;0;11;0;11
4994;Markučiai;Pelėdžiukų;1482031262;Taip;3;1;1;5
4995;Markučiai;Pelėdžiukų;95026191001;Taip;0;2;0;2
4996;Markučiai;Pelėdžiukų;28059558537;Taip;5;1;1;7
4997;Markučiai;Pelėdžiukų;4938918595;Taip;2;1;0;3
4998;Markučiai;Pelėdžiukų;54616789785;Taip;0;0;3;3
4999;Markučiai;Pelėdžiukų;981774400;Taip;2;10;0;12
5000;Markučiai;Pelėdžiukų;1155718131;Taip;9;4;0;13
5001;Markučiai;Pelėdžiukų;18563720509;Taip;0;1;4;5
5002;Markučiai;Boružėlių;9059302464;Taip;10;0;1;11
5003;Markučiai;Boružėlių;2962530721;Taip;7;0;0;7
5004;Markučiai;Boružėlių;6574037877;Taip;0;16;0;16
5005;Markučiai;Boružėlių;5752762229;Taip;7;2;0;9
5006;Markučiai;Boružėlių;4383421917;Taip;0;1;0;1
5007;Markučiai;Boružėlių;9789274040;Taip;0;0;2;2
5008;Markučiai;Boružėlių;1171899107;Taip;0;6;0;6
5009;Markučiai;Boružėlių;8092642447;Taip;0;2;0;2
5010;Markučiai;Boružėlių;8078777204;Taip;16;0;0;16
5011;Markučiai;Boružėlių;8605357678;Taip;2;0;0;2
5012;Markučiai;Boružėlių;3755794133;Taip;2;1;0;3
5013;Markučiai;Boružėlių;8244065962;Taip;6;0;0;6
5014;Markučiai;Boružėlių;5902165968;Taip;15;1;0;16
5015;Markučiai;Bitučių;4653663237;Taip;5;0;6;11
5016;Markučiai;Bitučių;1720541082;Taip;5;0;1;6
5017;Markučiai;Bitučių;1717624510;Taip;1;0;0;1
5018;Markučiai;Bitučių;9518247571;Taip;11;0;2;13
5019;Markučiai;Bitučių;9027071539;Taip;0;1;0;1
5020;Markučiai;Bitučių;8748794886;Taip;0;0;15;15
5021;Markučiai;Bitučių;5727655114;Taip;4;0;0;4
5022;Markučiai;Bitučių;6740434675;Taip;7;0;0;7
5023;Markučiai;Bitučių;6707310242;Taip;5;0;1;6
5024;Markučiai;Bitučių;2256262371;Taip;17;1;3;21
5025;Markučiai;Bitučių;7387460586;Taip;10;1;0;11
5026;Markučiai;Bitučių;8950442843;Taip;5;0;0;5
5027;Markučiai;Bitučių;6260010822;Taip;3;0;1;4
5028;Markučiai;Drugelių;1719927769;Taip;5;0;1;6
5029;Markučiai;Drugelių;1411292558;Taip;6;1;0;7
5030;Markučiai;Drugelių;63211076619;Taip;0;0;5;5
5031;Markučiai;Drugelių;2608111078;Taip;0;0;1;1
5032;Markučiai;Drugelių;61666612833;Taip;4;1;0;5
5033;Markučiai;Drugelių;20261053601;Taip;5;1;0;6
5034;Markučiai;Drugelių;4573605085;Taip;8;0;0;8
5035;Markučiai;Drugelių;19415636420;Taip;0;0;1;1
5036;Markučiai;Drugelių;24315961901;Taip;5;0;3;8
5037;Markučiai;Drugelių;45698891062;Taip;17;0;0;17
5038;Markučiai;Drugelių;9028932081;Taip;0;15;2;17
5039;Markučiai;Drugelių;9019827941;Taip;9;0;0;9
5040;Markučiai;Drugelių;11203825718;Taip;6;5;0;11
5041;Markučiai;Drugelių;7538681006;Taip;7;9;0;16
5042;Markučiai;Drugelių;7194049189;Taip;0;1;3;4
5043;Markučiai;Drugelių;1964223995;Taip;7;0;3;10
5044;Markučiai;Drugelių;23081602011;Taip;14;0;0;14
5045;Markučiai;Skruzdėliukų;1471334430;Taip;9;0;5;14
5046;Markučiai;Skruzdėliukų;9825799013;Ne;13;0;0;13
5047;Markučiai;Skruzdėliukų;8803226424;Taip;4;0;1;5
5048;Markučiai;Skruzdėliukų;20702694553;Taip;11;0;0;11
5049;Markučiai;Skruzdėliukų;39971140989;Taip;6;0;5;11
5050;Markučiai;Skruzdėliukų;54732351634;Taip;0;0;4;4
5051;Markučiai;Skruzdėliukų;1631270056;Taip;9;0;0;9
5052;Markučiai;Skruzdėliukų;1419433247;Taip;4;10;0;14
5053;Markučiai;Skruzdėliukų;1089500743;Taip;0;4;3;7
5054;Markučiai;Skruzdėliukų;2939795063;Taip;0;1;2;3
5055;Markučiai;Skruzdėliukų;9285037135;Taip;7;0;0;7
5056;Markučiai;Skruzdėliukų;1699369138;Taip;0;0;16;16
5057;Markučiai;Skruzdėliukų;1881218133;Taip;4;0;0;4
5058;Markučiai;Skruzdėliukų;1200278823;Taip;0;4;2;6
5059;Markučiai;Skruzdėliukų;8863238710;Taip;9;0;5;14
5060;Markučiai;Skruzdėliukų;68193563408;Taip;3;4;0;7
5061;Markučiai;Skruzdėliukų;92854605649;Taip;13;0;0;13
5062;Markučiai;Skruzdėliukų;7114409929;Taip;0;0;1;1
5063;Markučiai;Skruzdėliukų;1529531638;Taip;0;3;1;4
5064;Markučiai;ZUIKUČIŲ;4861535057;Taip;1;1;0;2
5065;Markučiai;ZUIKUČIŲ;1482203905;Taip;0;0;3;3
5066;Markučiai;ZUIKUČIŲ;11751635395;Taip;0;1;0;1
5067;Markučiai;ZUIKUČIŲ;1184908076;Taip;0;11;0;11
5068;Markučiai;ZUIKUČIŲ;7729045227;Taip;0;20;0;20
5069;Markučiai;ZUIKUČIŲ;1392582514;Taip;10;0;0;10
5070;Markučiai;ZUIKUČIŲ;7691410556;Taip;0;3;0;3
5071;Markučiai;ZUIKUČIŲ;7969520467;Taip;13;0;0;13
5072;Markučiai;ZUIKUČIŲ;6808291628;Taip;4;5;0;9
5073;Markučiai;ZUIKUČIŲ;3794643964;Taip;0;3;1;4
5074;Markučiai;ZUIKUČIŲ;91228262895;Taip;0;0;4;4
5075;Markučiai;ZUIKUČIŲ;7481923902;Taip;0;0;7;7
5076;Markučiai;ZUIKUČIŲ;1025406111;Taip;12;4;0;16
5077;Markučiai;ZUIKUČIŲ;5749873170;Taip;0;0;4;4
5078;Markučiai;ZUIKUČIŲ;9581578352;Taip;15;0;0;15
5079;Markučiai;ŽIOGELIŲ;5099997904;Taip;10;0;0;10
5080;Markučiai;ŽIOGELIŲ;3163226803;Taip;5;0;0;5
5081;Markučiai;ŽIOGELIŲ;1244026489;Taip;21;0;0;21
5082;Markučiai;ŽIOGELIŲ;1323922187;Taip;13;0;0;13
5083;Markučiai;ŽIOGELIŲ;54892037118;Taip;0;1;0;1
5084;Markučiai;ŽIOGELIŲ;1549653580;Taip;0;12;0;12
5085;Markučiai;ŽIOGELIŲ;1054802708;Taip;5;4;0;9
5086;Markučiai;ŽIOGELIŲ;67074776419;Taip;8;1;0;9
5087;Markučiai;ŽIOGELIŲ;1007919702;Taip;0;7;0;7
5088;Markučiai;ŽIOGELIŲ;1923521405;Taip;6;0;1;7
5089;Markučiai;ŽIOGELIŲ;1164386108;Taip;6;0;1;7
5090;Markučiai;ŽIOGELIŲ;7850311496;Taip;20;1;0;21
5091;Markučiai;ŽIOGELIŲ;2169583290;Taip;0;10;0;10
5092;Markučiai;ŽIOGELIŲ;3340385503;Taip;10;0;1;11
5093;Markučiai;ŽIOGELIŲ;4152184290;Taip;0;0;1;1
5094;Markučiai;ŽIOGELIŲ;1742944578;Taip;0;1;0;1
5095;Markučiai;ŽIOGELIŲ;23267867195;Taip;7;1;0;8
5096;Markučiai;Ežiukių;1827829954;Taip;0;3;0;3
5097;Markučiai;Ežiukių;4925856706;Taip;0;9;0;9
5098;Markučiai;Ežiukių;6570638672;Taip;3;0;0;3
5099;Markučiai;Ežiukių;3771563320;Taip;1;1;0;2
5100;Markučiai;Ežiukių;1648283497;Taip;0;13;0;13
5101;Markučiai;Ežiukių;4186684938;Taip;0;0;1;1
5102;Markučiai;Ežiukių;5975331223;Taip;0;0;1;1
5103;Markučiai;Ežiukių;2687320408;Taip;1;1;0;2
5104;Markučiai;Ežiukių;1309122110;Taip;2;11;0;13
5105;Markučiai;Ežiukių;8990923872;Taip;3;0;0;3
5106;Markučiai;Ežiukių;2738553283;Taip;16;1;3;20
5107;Markučiai;Ežiukių;3386071459;Taip;15;0;1;16
5108;Markučiai;Ežiukių;7255617408;Taip;16;1;0;17
5109;Markučiai;Ežiukių;1599633295;Taip;0;9;0;9
5110;Markučiai;Ežiukių;6308368050;Taip;6;0;0;6
5111;Markučiai;Ežiukių;5958705106;Taip;5;0;1;6
5112;Markučiai;Ežiukių;3282845685;Taip;0;0;4;4
5113;Mažylis;"2 DARŽELIO GR.";5063094678;Taip;1;0;5;6
5114;Mažylis;"2 DARŽELIO GR.";3860760654;Taip;12;0;1;13
5115;Mažylis;"2 DARŽELIO GR.";9608529135;Taip;4;0;2;6
5116;Mažylis;"2 DARŽELIO GR.";8899463988;Taip;1;0;0;1
5117;Mažylis;"2 DARŽELIO GR.";9411559447;Taip;12;0;0;12
5118;Mažylis;"2 DARŽELIO GR.";45148418456;Taip;4;0;0;4
5119;Mažylis;"2 DARŽELIO GR.";4252408251;Taip;10;0;3;13
5120;Mažylis;"2 DARŽELIO GR.";38277640135;Taip;0;1;3;4
5121;Mažylis;"2 DARŽELIO GR.";1514640197;Taip;0;0;6;6
5122;Mažylis;"2 DARŽELIO GR.";6851169340;Taip;1;0;0;1
5123;Mažylis;"2 DARŽELIO GR.";4486742281;Taip;11;0;2;13
5124;Mažylis;"2 DARŽELIO GR.";79181926145;Taip;5;0;1;6
5125;Mažylis;"2 DARŽELIO GR.";6920129837;Taip;5;0;0;5
5126;Mažylis;"2 DARŽELIO GR.";1663347167;Taip;17;0;0;17
5127;Mažylis;"2 DARŽELIO GR.";7416381505;Taip;0;0;9;9
5128;Mažylis;"2 DARŽELIO GR.";3217527771;Taip;5;0;0;5
5129;Mažylis;"2 DARŽELIO GR.";1002832487;Taip;0;0;13;13
5130;Mažylis;"2 DARŽELIO GR.";6134051712;Taip;1;0;1;2
5131;Mažylis;"4 PRIEŠMOKYKLINĖ GR.";70526651195;Taip;0;0;1;1
5132;Mažylis;"4 PRIEŠMOKYKLINĖ GR.";6302092043;Taip;8;1;0;9
5133;Mažylis;"4 PRIEŠMOKYKLINĖ GR.";66861078627;Ne;0;1;3;4
5134;Mažylis;"4 PRIEŠMOKYKLINĖ GR.";28914540415;Taip;4;1;5;10
5135;Mažylis;"4 PRIEŠMOKYKLINĖ GR.";57677251463;Taip;6;0;0;6
5136;Mažylis;"4 PRIEŠMOKYKLINĖ GR.";69106809499;Ne;4;0;0;4
5137;Mažylis;"4 PRIEŠMOKYKLINĖ GR.";5439091390;Taip;0;0;5;5
5138;Mažylis;"4 PRIEŠMOKYKLINĖ GR.";79482905001;Taip;0;1;1;2
5139;Mažylis;"4 PRIEŠMOKYKLINĖ GR.";87616420119;Taip;0;1;4;5
5140;Mažylis;"4 PRIEŠMOKYKLINĖ GR.";33743124122;Taip;1;0;2;3
5141;Mažylis;"4 PRIEŠMOKYKLINĖ GR.";40329007615;Ne;14;0;0;14
5142;Mažylis;"4 PRIEŠMOKYKLINĖ GR.";81496635362;Taip;0;0;4;4
5143;Mažylis;"4 PRIEŠMOKYKLINĖ GR.";1102106521;Taip;0;0;4;4
5144;Mažylis;"4 PRIEŠMOKYKLINĖ GR.";54844605291;Taip;6;0;3;9
5145;Mažylis;"4 PRIEŠMOKYKLINĖ GR.";26981897418;Taip;5;6;0;11
5146;Mažylis;"4 PRIEŠMOKYKLINĖ GR.";52616512471;Taip;0;1;6;7
5147;Mažylis;"4 PRIEŠMOKYKLINĖ GR.";53780435826;Taip;6;2;0;8
5148;Mažylis;"4 PRIEŠMOKYKLINĖ GR.";89877442445;Taip;0;2;0;2
5149;Mažylis;"4 PRIEŠMOKYKLINĖ GR.";5984612355;Taip;6;1;2;9
5150;Mažylis;"5 DARŽ.GR.";71577274183;Taip;5;0;1;6
5151;Mažylis;"5 DARŽ.GR.";9095049088;Taip;0;0;2;2
5152;Mažylis;"5 DARŽ.GR.";1692808423;Taip;0;0;6;6
5153;Mažylis;"5 DARŽ.GR.";76814348181;Taip;0;7;0;7
5154;Mažylis;"5 DARŽ.GR.";18640177395;Taip;10;0;3;13
5155;Mažylis;"5 DARŽ.GR.";37676161966;Taip;11;0;2;13
5156;Mažylis;"5 DARŽ.GR.";91436869919;Taip;0;0;4;4
5157;Mažylis;"5 DARŽ.GR.";74056314359;Taip;0;0;4;4
5158;Mažylis;"5 DARŽ.GR.";36307201422;Taip;5;0;1;6
5159;Mažylis;"5 DARŽ.GR.";37179412928;Taip;0;1;2;3
5160;Mažylis;"5 DARŽ.GR.";9958976870;Taip;0;1;3;4
5161;Mažylis;"5 DARŽ.GR.";56438009944;Taip;0;0;21;21
5162;Mažylis;"5 DARŽ.GR.";11471986928;Taip;1;0;2;3
5163;Mažylis;"5 DARŽ.GR.";87637767247;Taip;0;1;0;1
5164;Mažylis;"5 DARŽ.GR.";1391395429;Taip;6;0;2;8
5165;Mažylis;"5 DARŽ.GR.";43986953632;Taip;6;0;0;6
5166;Mažylis;"5 DARŽ.GR.";8439933210;Taip;8;0;0;8
5167;Mažylis;"5 DARŽ.GR.";3436690709;Taip;1;0;1;2
5168;Mažylis;"5 DARŽ.GR.";8318476578;Taip;7;0;10;17
5169;Mažylis;"3 DARŽELIO GR.";98057700570;Taip;0;1;2;3
5170;Mažylis;"3 DARŽELIO GR.";1643460270;Taip;0;8;0;8
5171;Mažylis;"3 DARŽELIO GR.";24303144913;Taip;11;0;0;11
5172;Mažylis;"3 DARŽELIO GR.";69238700097;Taip;0;1;2;3
5173;Mažylis;"3 DARŽELIO GR.";50868656860;Taip;5;0;0;5
5174;Mažylis;"3 DARŽELIO GR.";1370723211;Taip;6;0;0;6
5175;Mažylis;"3 DARŽELIO GR.";2070067356;Ne;0;0;4;4
5176;Mažylis;"3 DARŽELIO GR.";81907805809;Taip;0;0;3;3
5177;Mažylis;"3 DARŽELIO GR.";1999937720;Taip;0;0;4;4
5178;Mažylis;"3 DARŽELIO GR.";90336289067;Taip;0;2;0;2
5179;Mažylis;"3 DARŽELIO GR.";46239142395;Taip;5;0;1;6
5180;Mažylis;"3 DARŽELIO GR.";1021183555;Taip;4;0;2;6
5181;Mažylis;"3 DARŽELIO GR.";1910064549;Taip;8;0;1;9
5182;Mažylis;"3 DARŽELIO GR.";86823456557;Taip;0;0;1;1
5183;Mažylis;"3 DARŽELIO GR.";2520667095;Taip;0;0;1;1
5184;Mažylis;"3 DARŽELIO GR.";5479496104;Taip;5;1;1;7
5185;Mažylis;"3 DARŽELIO GR.";5271395545;Taip;1;0;0;1
5186;Mažylis;"6 DARŽELIO GR.";1023886258;Taip;0;0;9;9
5187;Mažylis;"6 DARŽELIO GR.";2249845212;Taip;7;2;0;9
5188;Mažylis;"6 DARŽELIO GR.";38333694019;Taip;18;0;0;18
5189;Mažylis;"6 DARŽELIO GR.";68630915872;Taip;5;0;0;5
5190;Mažylis;"6 DARŽELIO GR.";37552673590;Taip;4;0;0;4
5191;Mažylis;"6 DARŽELIO GR.";44917962136;Taip;5;1;0;6
5192;Mažylis;"6 DARŽELIO GR.";34677678888;Ne;0;10;0;10
5193;Mažylis;"6 DARŽELIO GR.";88409362086;Taip;0;0;1;1
5194;Mažylis;"6 DARŽELIO GR.";72018918082;Taip;2;0;1;3
5195;Mažylis;"6 DARŽELIO GR.";99612915803;Taip;0;0;3;3
5196;Mažylis;"6 DARŽELIO GR.";96882209197;Taip;10;0;0;10
5197;Mažylis;"6 DARŽELIO GR.";10093289570;Ne;5;0;0;5
5198;Mažylis;"6 DARŽELIO GR.";71414598607;Taip;0;0;2;2
5199;Mažylis;"6 DARŽELIO GR.";67697608754;Taip;8;0;1;9
5200;Mažylis;"6 DARŽELIO GR.";1217081615;Taip;0;0;6;6
5201;Mažylis;"6 DARŽELIO GR.";4899739075;Taip;0;1;0;1
5202;Mažylis;"6 DARŽELIO GR.";1418120714;Taip;0;5;0;5
5203;Mažylis;"6 DARŽELIO GR.";1381948803;Taip;12;0;1;13
5204;Mažylis;"6 DARŽELIO GR.";94128544096;Taip;5;0;0;5
5205;Mažylis;"6 DARŽELIO GR.";33428832459;Taip;0;0;3;3
5206;Mažylis;"1 NAUJA (LOPŠELIS)";6854350717;Taip;0;0;10;10
5207;Mažylis;"1 NAUJA (LOPŠELIS)";5870983755;Taip;0;0;2;2
5208;Mažylis;"1 NAUJA (LOPŠELIS)";2979849055;Taip;3;0;0;3
5209;Mažylis;"1 NAUJA (LOPŠELIS)";4503734408;Taip;12;0;0;12
5210;Mažylis;"1 NAUJA (LOPŠELIS)";6162880220;Taip;10;0;0;10
5211;Mažylis;"1 NAUJA (LOPŠELIS)";9362249595;Taip;3;0;1;4
5212;Mažylis;"1 NAUJA (LOPŠELIS)";1077493584;Taip;5;1;0;6
5213;Mažylis;"1 NAUJA (LOPŠELIS)";2704741847;Taip;8;0;1;9
5214;Mažylis;"1 NAUJA (LOPŠELIS)";4798415786;Taip;5;1;0;6
5215;Mažylis;"1 NAUJA (LOPŠELIS)";7185347381;Taip;5;0;0;5
5216;Mažylis;"1 NAUJA (LOPŠELIS)";3327673298;Taip;3;0;0;3
5217;Mažylis;"1 NAUJA (LOPŠELIS)";4280547746;Taip;5;2;0;7
5218;Mažylis;"1 NAUJA (LOPŠELIS)";9447747294;Taip;6;1;6;13
5219;Medynėlis;BITUTĖS;1721728772;Taip;11;5;0;16
5220;Medynėlis;BITUTĖS;1870621987;Taip;1;0;5;6
5221;Medynėlis;BITUTĖS;51942577095;Taip;0;2;0;2
5222;Medynėlis;BITUTĖS;46570048371;Taip;0;1;0;1
5223;Medynėlis;BITUTĖS;42543506690;Taip;3;4;1;8
5224;Medynėlis;BITUTĖS;57858019710;Taip;0;1;2;3
5225;Medynėlis;BITUTĖS;78341557395;Taip;3;3;1;7
5226;Medynėlis;BITUTĖS;38838111813;Taip;0;7;0;7
5227;Medynėlis;BITUTĖS;1641742927;Ne;1;0;0;1
5228;Medynėlis;BITUTĖS;5202479867;Taip;7;0;3;10
5229;Medynėlis;BITUTĖS;83599369692;Taip;8;1;0;9
5230;Medynėlis;BITUTĖS;72334464245;Taip;0;6;0;6
5231;Medynėlis;BITUTĖS;54282609151;Taip;3;0;0;3
5232;Medynėlis;BITUTĖS;44971270687;Taip;4;0;0;4
5233;Medynėlis;BITUTĖS;39476010274;Taip;18;0;0;18
5234;Medynėlis;BITUTĖS;2055140361;Taip;0;11;10;21
5235;Medynėlis;BITUTĖS;1663988144;Taip;10;0;0;10
5236;Medynėlis;BITUTĖS;3684709853;Taip;0;2;0;2
5237;Medynėlis;BITUTĖS;65852278020;Taip;5;2;2;9
5238;Medynėlis;BITUTĖS;34879998108;Taip;0;1;0;1
5239;Medynėlis;DRUGELIAI;29673282359;Taip;6;3;0;9
5240;Medynėlis;DRUGELIAI;56207399170;Taip;0;1;0;1
5241;Medynėlis;DRUGELIAI;77267420461;Taip;15;0;0;15
5242;Medynėlis;DRUGELIAI;64020246327;Taip;2;0;0;2
5243;Medynėlis;DRUGELIAI;82368415455;Taip;6;0;0;6
5244;Medynėlis;DRUGELIAI;22422832248;Taip;10;0;0;10
5245;Medynėlis;DRUGELIAI;69233446672;Taip;0;1;0;1
5246;Medynėlis;DRUGELIAI;96133788423;Taip;17;0;0;17
5247;Medynėlis;DRUGELIAI;1673034349;Taip;9;2;0;11
5248;Medynėlis;DRUGELIAI;98839852579;Taip;0;1;0;1
5249;Medynėlis;DRUGELIAI;22845549109;Taip;5;0;0;5
5250;Medynėlis;DRUGELIAI;64603154583;Taip;9;0;0;9
5251;Medynėlis;DRUGELIAI;27434992072;Taip;15;0;0;15
5252;Medynėlis;DRUGELIAI;75083011184;Taip;5;6;0;11
5253;Medynėlis;DRUGELIAI;55276812676;Taip;1;0;0;1
5254;Medynėlis;DRUGELIAI;76282032727;Taip;0;1;0;1
5255;Medynėlis;DRUGELIAI;97943522374;Taip;0;1;0;1
5256;Medynėlis;DRUGELIAI;1864572888;Taip;9;3;0;12
5257;Medynėlis;DRUGELIAI;1828684971;Taip;5;6;0;11
5258;Medynėlis;DRUGELIAI;30399789674;Taip;8;0;0;8
5259;Medynėlis;SKRUZDĖLIUKAI;4024866819;Taip;11;0;0;11
5260;Medynėlis;SKRUZDĖLIUKAI;2418225089;Taip;11;5;0;16
5261;Medynėlis;SKRUZDĖLIUKAI;1827495325;Taip;3;1;0;4
5262;Medynėlis;SKRUZDĖLIUKAI;9413309043;Taip;14;0;0;14
5263;Medynėlis;SKRUZDĖLIUKAI;6594928740;Taip;8;9;0;17
5264;Medynėlis;SKRUZDĖLIUKAI;4581683292;Taip;6;1;0;7
5265;Medynėlis;SKRUZDĖLIUKAI;4137297035;Taip;12;2;0;14
5266;Medynėlis;SKRUZDĖLIUKAI;9009316740;Taip;6;5;0;11
5267;Medynėlis;SKRUZDĖLIUKAI;1795479738;Taip;16;4;0;20
5268;Medynėlis;SKRUZDĖLIUKAI;5530782065;Taip;4;1;5;10
5269;Medynėlis;SKRUZDĖLIUKAI;5269927048;Taip;9;0;0;9
5270;Medynėlis;SKRUZDĖLIUKAI;2427349194;Taip;20;0;0;20
5271;Medynėlis;SKRUZDĖLIUKAI;8948133343;Taip;0;10;0;10
5272;Medynėlis;SKRUZDĖLIUKAI;7633674694;Taip;11;1;0;12
5273;Medynėlis;SKRUZDĖLIUKAI;7244497661;Taip;10;10;0;20
5274;Medynėlis;SKRUZDĖLIUKAI;5995034919;Taip;16;0;0;16
5275;Medynėlis;SKRUZDĖLIUKAI;8775219704;Taip;21;0;0;21
5276;Medynėlis;SKRUZDĖLIUKAI;1658457155;Taip;8;1;2;11
5277;Medynėlis;SKRUZDĖLIUKAI;33981260502;Taip;0;0;12;12
5278;Medynėlis;SKRUZDĖLIUKAI;3773215372;Taip;9;0;0;9
5279;Medynėlis;VOVERIUKAI;2834559432;Taip;2;0;0;2
5280;Medynėlis;VOVERIUKAI;2310200034;Taip;0;1;1;2
5281;Medynėlis;VOVERIUKAI;6999562417;Taip;0;2;0;2
5282;Medynėlis;VOVERIUKAI;5586407412;Taip;7;0;0;7
5283;Medynėlis;VOVERIUKAI;7108619017;Taip;9;6;0;15
5284;Medynėlis;VOVERIUKAI;1820113382;Taip;0;4;0;4
5285;Medynėlis;VOVERIUKAI;9304002459;Taip;12;0;0;12
5286;Medynėlis;VOVERIUKAI;5982453884;Taip;17;0;0;17
5287;Medynėlis;VOVERIUKAI;1173510831;Taip;15;3;0;18
5288;Medynėlis;VOVERIUKAI;6406459222;Taip;5;3;0;8
5289;Medynėlis;VOVERIUKAI;2335108073;Taip;0;0;2;2
5290;Medynėlis;VOVERIUKAI;4985243068;Taip;14;0;0;14
5291;Medynėlis;VOVERIUKAI;2057309788;Taip;6;0;0;6
5292;Medynėlis;VOVERIUKAI;9073514151;Taip;0;5;0;5
5293;Medynėlis;VOVERIUKAI;1750775033;Taip;7;0;1;8
5294;Medynėlis;VOVERIUKAI;9800678364;Taip;17;0;2;19
5295;Medynėlis;VOVERIUKAI;1237589979;Taip;21;0;0;21
5296;Medynėlis;MEŠKIUKAI;1434648803;Taip;9;1;0;10
5297;Medynėlis;MEŠKIUKAI;1975763240;Taip;10;0;1;11
5298;Medynėlis;MEŠKIUKAI;5347745655;Taip;21;0;0;21
5299;Medynėlis;MEŠKIUKAI;1781906016;Taip;0;7;0;7
5300;Medynėlis;MEŠKIUKAI;91658912153;Taip;10;0;1;11
5301;Medynėlis;MEŠKIUKAI;1269734734;Taip;20;0;0;20
5302;Medynėlis;MEŠKIUKAI;46445461622;Taip;16;0;0;16
5303;Medynėlis;MEŠKIUKAI;7226012217;Taip;11;2;3;16
5304;Medynėlis;MEŠKIUKAI;5007624930;Taip;12;0;0;12
5305;Medynėlis;MEŠKIUKAI;9476336240;Taip;16;0;0;16
5306;Medynėlis;MEŠKIUKAI;8629622922;Taip;8;2;1;11
5307;Medynėlis;MEŠKIUKAI;1479759021;Taip;10;1;0;11
5308;Medynėlis;MEŠKIUKAI;2389345601;Taip;6;2;2;10
5309;Medynėlis;MEŠKIUKAI;1635649525;Taip;0;2;5;7
5310;Medynėlis;MEŠKIUKAI;6479758789;Taip;0;1;4;5
5311;Medynėlis;MEŠKIUKAI;12287981032;Taip;6;0;0;6
5312;Medynėlis;MEŠKIUKAI;12812096047;Taip;3;0;1;4
5313;Medynėlis;MEŠKIUKAI;2326848026;Taip;11;2;0;13
5314;Medynėlis;MEŠKIUKAI;5924711043;Taip;8;0;0;8
5315;Medynėlis;MEŠKIUKAI;8143370943;Taip;0;0;7;7
5316;Medynėlis;MEŠKIUKAI;32683798983;Taip;20;0;0;20
5317;Medynėlis;MEŠKIUKAI;99799126572;Ne;0;7;0;7
5318;Medynėlis;PELĖDŽIUKAI;1379827887;Taip;11;1;3;15
5319;Medynėlis;PELĖDŽIUKAI;1829338208;Taip;7;1;0;8
5320;Medynėlis;PELĖDŽIUKAI;88240380945;Taip;3;0;0;3
5321;Medynėlis;PELĖDŽIUKAI;1129265551;Taip;15;0;1;16
5322;Medynėlis;PELĖDŽIUKAI;76668029492;Taip;10;6;0;16
5323;Medynėlis;PELĖDŽIUKAI;1080058205;Taip;13;0;0;13
5324;Medynėlis;PELĖDŽIUKAI;38759466139;Taip;2;0;0;2
5325;Medynėlis;PELĖDŽIUKAI;1968892466;Taip;0;10;0;10
5326;Medynėlis;PELĖDŽIUKAI;1194247621;Taip;0;10;0;10
5327;Medynėlis;PELĖDŽIUKAI;1590889839;Taip;10;2;0;12
5328;Medynėlis;PELĖDŽIUKAI;1755767517;Taip;8;2;0;10
5329;Medynėlis;PELĖDŽIUKAI;37435525923;Taip;0;0;3;3
5330;Medynėlis;PELĖDŽIUKAI;1415208530;Taip;12;0;6;18
5331;Medynėlis;PELĖDŽIUKAI;7804751416;Taip;20;0;0;20
5332;Medynėlis;PELĖDŽIUKAI;6182500688;Taip;9;3;0;12
5333;Medynėlis;PELĖDŽIUKAI;8122944228;Taip;12;1;3;16
5334;Medynėlis;PELĖDŽIUKAI;15047814683;Taip;8;0;0;8
5335;Medynėlis;PELĖDŽIUKAI;1937403950;Ne;6;0;0;6
5336;Medynėlis;PELĖDŽIUKAI;53914093216;Taip;16;0;0;16
5337;Medynėlis;BORUŽIUKAI;1657676226;Taip;0;5;0;5
5338;Medynėlis;BORUŽIUKAI;80165108645;Taip;1;0;0;1
5339;Medynėlis;BORUŽIUKAI;51192496113;Taip;0;1;0;1
5340;Medynėlis;BORUŽIUKAI;1314163134;Taip;0;1;0;1
5341;Medynėlis;BORUŽIUKAI;1010025777;Taip;0;3;0;3
5342;Medynėlis;BORUŽIUKAI;96544597673;Taip;3;1;0;4
5343;Medynėlis;BORUŽIUKAI;79786316561;Taip;1;2;0;3
5344;Medynėlis;BORUŽIUKAI;88550635466;Taip;0;5;0;5
5345;Medynėlis;BORUŽIUKAI;1693185124;Taip;0;5;0;5
5346;Medynėlis;BORUŽIUKAI;1563329598;Taip;0;5;0;5
5347;Medynėlis;BORUŽIUKAI;1611512841;Taip;4;5;0;9
5348;Medynėlis;BORUŽIUKAI;55848491611;Taip;10;1;0;11
5349;Medynėlis;BORUŽIUKAI;7061506238;Taip;0;2;0;2
5350;Medynėlis;BORUŽIUKAI;1192592678;Ne;21;0;0;21
5351;Medynėlis;BORUŽIUKAI;12150004702;Taip;11;3;0;14
5352;Medynėlis;BORUŽIUKAI;7628899696;Taip;0;4;0;4
5353;Medynėlis;BORUŽIUKAI;2044676215;Taip;5;0;0;5
5354;Medynėlis;BORUŽIUKAI;48636516521;Taip;2;0;0;2
5355;Medynėlis;EŽIUKAI;1409464952;Taip;8;3;0;11
5356;Medynėlis;EŽIUKAI;3398294520;Taip;0;7;0;7
5357;Medynėlis;EŽIUKAI;2026582294;Taip;11;0;0;11
5358;Medynėlis;EŽIUKAI;1437000615;Taip;0;10;0;10
5359;Medynėlis;EŽIUKAI;1995078812;Taip;7;0;0;7
5360;Medynėlis;EŽIUKAI;1208227740;Taip;0;1;0;1
5361;Medynėlis;EŽIUKAI;1569413876;Taip;15;0;0;15
5362;Medynėlis;EŽIUKAI;31443674861;Taip;1;4;0;5
5363;Medynėlis;EŽIUKAI;1882919126;Taip;5;2;0;7
5364;Medynėlis;EŽIUKAI;50558260808;Taip;4;0;0;4
5365;Medynėlis;EŽIUKAI;61158254770;Taip;0;8;0;8
5366;Medynėlis;EŽIUKAI;1216195798;Taip;0;6;0;6
5367;Medynėlis;EŽIUKAI;2406561273;Taip;10;0;0;10
5368;Medynėlis;EŽIUKAI;1915791061;Taip;5;0;0;5
5369;Medynėlis;ZUIKUČIAI;9825580191;Taip;0;1;0;1
5370;Medynėlis;ZUIKUČIAI;6706028300;Taip;6;0;0;6
5371;Medynėlis;ZUIKUČIAI;6955467123;Taip;17;0;0;17
5372;Medynėlis;ZUIKUČIAI;5785463517;Taip;11;1;0;12
5373;Medynėlis;ZUIKUČIAI;9184868565;Taip;14;1;0;15
5374;Medynėlis;ZUIKUČIAI;1621499650;Taip;11;3;0;14
5375;Medynėlis;ZUIKUČIAI;4222917765;Taip;11;3;0;14
5376;Medynėlis;ZUIKUČIAI;4323515017;Taip;7;1;0;8
5377;Medynėlis;ZUIKUČIAI;9866431097;Taip;15;0;0;15
5378;Medynėlis;ZUIKUČIAI;5571641847;Taip;15;1;0;16
5379;Medynėlis;ZUIKUČIAI;6681155625;Taip;21;0;0;21
5380;Medynėlis;ZUIKUČIAI;6073797962;Taip;7;0;0;7
5381;Medynėlis;ZUIKUČIAI;9355165862;Taip;5;1;0;6
5382;Medynėlis;ZUIKUČIAI;1901805808;Taip;5;0;1;6
5383;Medynėlis;ZUIKUČIAI;5784691118;Taip;5;0;1;6
5384;Medynėlis;KAČIUKAI;7740591575;Taip;6;3;0;9
5385;Medynėlis;KAČIUKAI;4100792567;Taip;1;0;1;2
5386;Medynėlis;KAČIUKAI;2086963376;Taip;9;0;0;9
5387;Medynėlis;KAČIUKAI;1587899391;Taip;16;0;0;16
5388;Medynėlis;KAČIUKAI;1056744101;Taip;21;0;0;21
5389;Medynėlis;KAČIUKAI;7455041214;Taip;0;0;9;9
5390;Medynėlis;KAČIUKAI;5267128750;Taip;10;1;0;11
5391;Medynėlis;KAČIUKAI;3554823424;Taip;9;0;0;9
5392;Medynėlis;KAČIUKAI;7272017225;Taip;20;0;0;20
5393;Medynėlis;KAČIUKAI;4092824377;Taip;0;15;0;15
5394;Medynėlis;KAČIUKAI;6826790492;Taip;9;0;0;9
5395;Medynėlis;KAČIUKAI;4488439037;Taip;21;0;0;21
5396;Medynėlis;KAČIUKAI;6485314750;Taip;0;0;12;12
5397;Medynėlis;KAČIUKAI;6101613567;Taip;9;3;3;15
5398;Medynėlis;KAČIUKAI;2234994999;Taip;14;5;0;19
5399;Medynėlis;PELIUKAI;9314893329;Taip;5;6;0;11
5400;Medynėlis;PELIUKAI;9764215406;Taip;3;3;0;6
5401;Medynėlis;PELIUKAI;3787172254;Taip;5;0;1;6
5402;Medynėlis;PELIUKAI;5051773825;Taip;16;0;0;16
5403;Medynėlis;PELIUKAI;1525185037;Taip;6;1;2;9
5404;Medynėlis;PELIUKAI;6218943275;Taip;7;2;0;9
5405;Medynėlis;PELIUKAI;1406029765;Taip;7;1;0;8
5406;Medynėlis;PELIUKAI;1162859552;Taip;2;1;0;3
5407;Medynėlis;PELIUKAI;6032067904;Taip;4;1;0;5
5408;Medynėlis;PELIUKAI;7232396755;Taip;6;0;0;6
5409;Medynėlis;PELIUKAI;9919108302;Taip;11;2;0;13
5410;Medynėlis;PELIUKAI;1463263793;Taip;10;5;0;15
5411;Medynėlis;PELIUKAI;1333848517;Taip;2;0;0;2
5412;Medynėlis;PELIUKAI;3270413614;Taip;7;2;0;9
5413;Medynėlis;PELIUKAI;5532880670;Taip;12;0;1;13
5414;Medynėlis;PELIUKAI;7651663404;Taip;11;0;0;11
5415;Medynėlis;PELIUKAI;5446430319;Taip;0;0;2;2
5416;Medynėlis;PELIUKAI;8271170887;Taip;8;0;0;8
5417;Medynėlis;PELIUKAI;4315717555;Taip;6;0;3;9
5418;Molinukas;NYKŠTUKAI;70883949824;Taip;0;1;1;2
5419;Molinukas;NYKŠTUKAI;25562159395;Taip;0;15;1;16
5420;Molinukas;NYKŠTUKAI;51421193001;Taip;0;5;0;5
5421;Molinukas;NYKŠTUKAI;65954418475;Taip;0;0;10;10
5422;Molinukas;NYKŠTUKAI;25761685637;Taip;0;3;0;3
5423;Molinukas;NYKŠTUKAI;25402100091;Taip;0;0;7;7
5424;Molinukas;NYKŠTUKAI;62719013867;Taip;0;0;1;1
5425;Molinukas;NYKŠTUKAI;41890709428;Taip;9;0;0;9
5426;Molinukas;NYKŠTUKAI;74040038141;Taip;7;0;0;7
5427;Molinukas;NYKŠTUKAI;73542178867;Taip;0;0;2;2
5428;Molinukas;NYKŠTUKAI;96140904528;Taip;0;17;0;17
5429;Molinukas;NYKŠTUKAI;24664585525;Taip;0;2;0;2
5430;Molinukas;NYKŠTUKAI;96366441416;Taip;0;0;4;4
5431;Molinukas;NYKŠTUKAI;94725766823;Taip;0;9;0;9
5432;Molinukas;NYKŠTUKAI;52577977910;Ne;0;5;0;5
5433;Molinukas;NYKŠTUKAI;46887752521;Taip;5;1;8;14
5434;Molinukas;NYKŠTUKAI;60386582602;Taip;0;0;1;1
5435;Molinukas;NYKŠTUKAI;1388074160;Taip;7;1;3;11
5436;Molinukas;NYKŠTUKAI;78355703743;Ne;0;0;3;3
5437;Molinukas;NYKŠTUKAI;10647191823;Taip;0;1;0;1
5438;Molinukas;NYKŠTUKAI;95409535650;Taip;0;0;2;2
5439;Molinukas;NYKŠTUKAI;6155259547;Taip;0;3;1;4
5440;Molinukas;NYKŠTUKAI;11787953136;Taip;0;12;0;12
5441;Molinukas;NYKŠTUKAI;81983716075;Taip;0;9;0;9
5442;Molinukas;ZUIKUČIŲ;1469884686;Taip;5;0;0;5
5443;Molinukas;ZUIKUČIŲ;5387818175;Taip;0;0;2;2
5444;Molinukas;ZUIKUČIŲ;1138255845;Taip;0;0;1;1
5445;Molinukas;ZUIKUČIŲ;6326031969;Taip;5;3;1;9
5446;Molinukas;ZUIKUČIŲ;7398075402;Taip;0;0;1;1
5447;Molinukas;ZUIKUČIŲ;1185903576;Taip;5;0;0;5
5448;Molinukas;ZUIKUČIŲ;7377137582;Taip;0;0;1;1
5449;Molinukas;ZUIKUČIŲ;4534279257;Taip;14;0;0;14
5450;Molinukas;ZUIKUČIŲ;8688180482;Taip;17;1;0;18
5451;Molinukas;ZUIKUČIŲ;3917187380;Taip;0;0;5;5
5452;Molinukas;ZUIKUČIŲ;1686122652;Taip;7;0;0;7
5453;Molinukas;ZUIKUČIŲ;2324578741;Taip;0;0;4;4
5454;Molinukas;ZUIKUČIŲ;4918181437;Taip;0;0;5;5
5455;Molinukas;ZUIKUČIŲ;3497266382;Taip;8;0;0;8
5456;Molinukas;ZUIKUČIŲ;8604288346;Taip;15;0;2;17
5457;Molinukas;ZUIKUČIŲ;8297662673;Taip;16;0;0;16
5458;Molinukas;ZUIKUČIŲ;1856269656;Taip;10;1;4;15
5459;Molinukas;ZUIKUČIŲ;6636118069;Taip;0;10;0;10
5460;Molinukas;ZUIKUČIŲ;8525796051;Taip;15;0;2;17
5461;Molinukas;ZUIKUČIŲ;2774371800;Taip;12;0;0;12
5462;Molinukas;ZUIKUČIŲ;8913137310;Ne;0;1;0;1
5463;Molinukas;ZUIKUČIŲ;8416644024;Taip;13;0;2;15
5464;Molinukas;SRAIGIUKŲ;5116921885;Taip;0;1;5;6
5465;Molinukas;SRAIGIUKŲ;91328196871;Taip;6;1;0;7
5466;Molinukas;SRAIGIUKŲ;66414602983;Taip;8;0;2;10
5467;Molinukas;SRAIGIUKŲ;26935664306;Taip;0;2;0;2
5468;Molinukas;SRAIGIUKŲ;9379961926;Taip;0;0;6;6
5469;Molinukas;SRAIGIUKŲ;43690886471;Taip;0;1;0;1
5470;Molinukas;SRAIGIUKŲ;62433691448;Taip;0;1;1;2
5471;Molinukas;SRAIGIUKŲ;94522698417;Ne;3;1;0;4
5472;Molinukas;SRAIGIUKŲ;311898127;Taip;0;0;1;1
5473;Molinukas;SRAIGIUKŲ;36167191615;Taip;0;1;4;5
5474;Molinukas;SRAIGIUKŲ;58796578218;Taip;0;1;0;1
5475;Molinukas;SRAIGIUKŲ;93991392425;Taip;15;1;0;16
5476;Molinukas;SRAIGIUKŲ;28860932985;Taip;0;1;0;1
5477;Molinukas;SRAIGIUKŲ;8013554298;Taip;0;1;1;2
5478;Molinukas;SRAIGIUKŲ;71842515853;Taip;0;0;2;2
5479;Molinukas;SRAIGIUKŲ;9854008152;Taip;2;0;0;2
5480;Molinukas;SRAIGIUKŲ;42123897177;Taip;2;0;2;4
5481;Molinukas;SRAIGIUKŲ;11340728166;Taip;3;1;0;4
5482;Molinukas;SRAIGIUKŲ;4659400698;Taip;0;8;0;8
5483;Molinukas;SRAIGIUKŲ;21801124679;Ne;0;1;3;4
5484;Molinukas;SRAIGIUKŲ;5258874882;Taip;0;6;0;6
5485;Molinukas;SRAIGIUKŲ;3000090536;Taip;7;1;2;10
5486;Molinukas;VOVERIUKAI;99537506556;Taip;0;0;1;1
5487;Molinukas;VOVERIUKAI;49733379099;Taip;0;6;0;6
5488;Molinukas;VOVERIUKAI;7991320348;Taip;0;1;0;1
5489;Molinukas;VOVERIUKAI;1293862946;Taip;0;5;0;5
5490;Molinukas;VOVERIUKAI;8674220663;Taip;9;0;0;9
5491;Molinukas;VOVERIUKAI;1151672597;Taip;5;3;0;8
5492;Molinukas;VOVERIUKAI;13856993048;Taip;9;0;1;10
5493;Molinukas;VOVERIUKAI;41153045448;Taip;0;0;2;2
5494;Molinukas;VOVERIUKAI;43651915331;Taip;12;1;6;19
5495;Molinukas;VOVERIUKAI;12208955611;Taip;0;2;2;4
5496;Molinukas;VOVERIUKAI;91913856999;Taip;0;0;2;2
5497;Molinukas;VOVERIUKAI;1241069188;Taip;0;3;1;4
5498;Molinukas;VOVERIUKAI;44399175317;Taip;6;2;0;8
5499;Molinukas;VOVERIUKAI;10482714545;Taip;5;12;0;17
5500;Molinukas;VOVERIUKAI;1880434477;Taip;0;0;1;1
5501;Molinukas;VOVERIUKAI;54948831792;Taip;0;0;3;3
5502;Molinukas;VOVERIUKAI;45801826827;Taip;5;0;0;5
5503;Molinukas;VOVERIUKAI;1018558040;Taip;0;0;6;6
5504;Molinukas;VOVERIUKAI;1538778372;Taip;0;0;2;2
5505;Molinukas;VOVERIUKAI;1167405137;Taip;10;0;1;11
5506;Molinukas;VOVERIUKAI;2048642721;Taip;4;0;0;4
5507;Molinukas;VOVERIUKAI;2041132581;Taip;5;6;1;12
5508;Molinukas;VOVERIUKAI;2931616290;Taip;15;0;0;15
5509;Molinukas;VOVERIUKAI;7987658567;Ne;0;0;1;1
5510;Molinukas;ŽVIRBLIUKŲ;5876669121;Taip;19;0;0;19
5511;Molinukas;ŽVIRBLIUKŲ;3030169626;Taip;11;0;10;21
5512;Molinukas;ŽVIRBLIUKŲ;6087698882;Taip;15;0;2;17
5513;Molinukas;ŽVIRBLIUKŲ;6832647220;Taip;11;0;0;11
5514;Molinukas;ŽVIRBLIUKŲ;2211909678;Taip;19;0;0;19
5515;Molinukas;ŽVIRBLIUKŲ;4950808381;Taip;0;11;1;12
5516;Molinukas;ŽVIRBLIUKŲ;7623051674;Taip;6;1;3;10
5517;Molinukas;ŽVIRBLIUKŲ;6795839380;Taip;0;0;19;19
5518;Molinukas;ŽVIRBLIUKŲ;2348120316;Taip;6;0;0;6
5519;Molinukas;ŽVIRBLIUKŲ;8053608348;Taip;0;5;0;5
5520;Molinukas;ŽVIRBLIUKŲ;8446233414;Taip;15;0;1;16
5521;Molinukas;ŽVIRBLIUKŲ;6014990150;Taip;11;1;0;12
5522;Molinukas;KAČIUKŲ;1651650182;Taip;0;0;1;1
5523;Molinukas;KAČIUKŲ;7134802574;Taip;0;0;4;4
5524;Molinukas;KAČIUKŲ;8260101075;Taip;0;0;4;4
5525;Molinukas;KAČIUKŲ;5685582215;Taip;1;2;6;9
5526;Molinukas;KAČIUKŲ;9448910819;Taip;8;0;0;8
5527;Molinukas;KAČIUKŲ;3469196411;Taip;15;0;1;16
5528;Molinukas;KAČIUKŲ;1849018608;Taip;0;0;1;1
5529;Molinukas;KAČIUKŲ;4171978721;Taip;17;0;1;18
5530;Molinukas;KAČIUKŲ;5580968328;Taip;17;0;1;18
5531;Molinukas;KAČIUKŲ;9413396859;Taip;19;0;1;20
5532;Molinukas;KAČIUKŲ;4896935150;Taip;13;0;0;13
5533;Molinukas;KAČIUKŲ;2286586693;Taip;16;2;0;18
5534;Molinukas;KAČIUKŲ;8536615996;Taip;4;0;1;5
5535;Molinukas;KAČIUKŲ;6898958282;Taip;9;0;2;11
5536;Naminukas;Drugeliai;46165828687;Taip;10;5;0;15
5537;Naminukas;Drugeliai;2126348084;Taip;0;11;0;11
5538;Naminukas;Drugeliai;1462439902;Taip;5;0;0;5
5539;Naminukas;Drugeliai;85754834119;Taip;0;4;0;4
5540;Naminukas;Drugeliai;1315517694;Taip;13;0;0;13
5541;Naminukas;Drugeliai;93286140513;Taip;0;0;6;6
5542;Naminukas;Drugeliai;10134368426;Taip;0;8;0;8
5543;Naminukas;Drugeliai;2126839560;Taip;5;2;1;8
5544;Naminukas;Drugeliai;1355495217;Taip;0;0;2;2
5545;Naminukas;Drugeliai;7291023483;Taip;0;2;0;2
5546;Naminukas;Drugeliai;27189261329;Taip;5;0;0;5
5547;Naminukas;Drugeliai;50807508081;Taip;1;1;0;2
5548;Naminukas;Drugeliai;34296400556;Taip;0;1;0;1
5549;Naminukas;Drugeliai;19432091931;Taip;1;1;0;2
5550;Naminukas;Drugeliai;90672353258;Taip;0;3;0;3
5551;Naminukas;Drugeliai;15608850480;Taip;0;1;1;2
5552;Naminukas;Drugeliai;8716638124;Taip;11;2;0;13
5553;Naminukas;Drugeliai;2967647412;Taip;0;11;0;11
5554;Naminukas;Drugeliai;5822184150;Taip;0;0;3;3
5555;Naminukas;Drugeliai;7440490894;Taip;12;1;0;13
5556;Naminukas;Bitutės;53746114607;Taip;0;10;1;11
5557;Naminukas;Bitutės;9541388086;Taip;0;0;1;1
5558;Naminukas;Bitutės;4419568254;Taip;0;0;1;1
5559;Naminukas;Bitutės;1956749138;Taip;10;5;0;15
5560;Naminukas;Bitutės;6503569633;Taip;7;0;3;10
5561;Naminukas;Bitutės;3192885665;Taip;15;0;2;17
5562;Naminukas;Bitutės;9530232649;Taip;9;0;3;12
5563;Naminukas;Bitutės;8131328042;Taip;9;7;0;16
5564;Naminukas;Bitutės;2769848640;Taip;0;0;3;3
5565;Naminukas;Bitutės;7176287699;Taip;4;0;6;10
5566;Naminukas;Bitutės;7888950723;Taip;0;0;2;2
5567;Naminukas;Bitutės;1710002948;Taip;0;8;3;11
5568;Naminukas;Bitutės;5610993611;Taip;0;2;0;2
5569;Naminukas;Bitutės;3994190066;Taip;0;2;0;2
5570;Naminukas;Bitutės;6526207235;Taip;6;3;0;9
5571;Naminukas;Bitutės;9600303816;Taip;0;3;0;3
5572;Naminukas;Bitutės;5244682030;Taip;0;2;0;2
5573;Naminukas;Bitutės;5195078101;Taip;0;2;0;2
5574;Naminukas;Bitutės;9501202207;Taip;0;12;7;19
5575;Naminukas;Paukšteliai;37525846039;Taip;0;1;1;2
5576;Naminukas;Paukšteliai;2126182508;Taip;0;4;0;4
5577;Naminukas;Paukšteliai;3603079488;Ne;6;0;3;9
5578;Naminukas;Paukšteliai;1870907311;Taip;0;2;1;3
5579;Naminukas;Paukšteliai;69952843049;Taip;1;0;0;1
5580;Naminukas;Paukšteliai;59473696226;Taip;6;0;0;6
5581;Naminukas;Paukšteliai;1946057668;Taip;16;0;0;16
5582;Naminukas;Paukšteliai;1647625489;Taip;0;0;1;1
5583;Naminukas;Paukšteliai;1893485577;Taip;0;12;2;14
5584;Naminukas;Paukšteliai;1863885754;Taip;5;1;4;10
5585;Naminukas;Paukšteliai;1439033627;Taip;11;1;2;14
5586;Naminukas;Paukšteliai;1973581463;Taip;0;0;7;7
5587;Naminukas;Paukšteliai;15748906161;Taip;5;0;1;6
5588;Naminukas;Paukšteliai;70836957729;Taip;14;1;0;15
5589;Naminukas;Paukšteliai;79166535343;Taip;0;2;1;3
5590;Naminukas;Paukšteliai;7386776624;Taip;0;1;1;2
5591;Naminukas;Paukšteliai;9039313646;Taip;0;1;1;2
5592;Naminukas;"NYKŠTUKAI ";1509433995;Taip;0;1;2;3
5593;Naminukas;"NYKŠTUKAI ";59020433000;Taip;4;3;0;7
5594;Naminukas;"NYKŠTUKAI ";2544422668;Taip;0;0;2;2
5595;Naminukas;"NYKŠTUKAI ";3029310084;Taip;6;0;0;6
5596;Naminukas;"NYKŠTUKAI ";16946991001;Taip;21;0;0;21
5597;Naminukas;"NYKŠTUKAI ";7632725551;Taip;0;11;0;11
5598;Naminukas;"NYKŠTUKAI ";46665774314;Taip;0;5;0;5
5599;Naminukas;"NYKŠTUKAI ";1490712871;Taip;5;0;1;6
5600;Naminukas;"NYKŠTUKAI ";1252481328;Taip;20;0;0;20
5601;Naminukas;"NYKŠTUKAI ";5918430817;Taip;0;4;0;4
5602;Naminukas;"NYKŠTUKAI ";1499464511;Taip;9;0;0;9
5603;Naminukas;"NYKŠTUKAI ";9321656855;Taip;0;2;1;3
5604;Naminukas;"NYKŠTUKAI ";4515242836;Taip;5;0;1;6
5605;Naminukas;"NYKŠTUKAI ";3826149605;Taip;0;3;0;3
5606;Naminukas;"NYKŠTUKAI ";6501046678;Taip;5;0;1;6
5607;Naminukas;"NYKŠTUKAI ";6029194403;Taip;5;2;0;7
5608;Naminukas;"NYKŠTUKAI ";70281612245;Taip;7;0;2;9
5609;Naminukas;"NYKŠTUKAI ";10563508139;Taip;0;1;0;1
5610;Naminukas;"NYKŠTUKAI ";90045007984;Taip;4;0;0;4
5611;Naminukas;"NYKŠTUKAI ";74291965804;Taip;11;0;0;11
5612;Neries;DEBESĖLIŲ;28267779362;Taip;4;0;0;4
5613;Neries;DEBESĖLIŲ;8573169074;Taip;0;9;0;9
5614;Neries;DEBESĖLIŲ;2085901811;Taip;2;1;0;3
5615;Neries;DEBESĖLIŲ;70177841044;Taip;13;2;0;15
5616;Neries;DEBESĖLIŲ;97670123581;Taip;0;1;0;1
5617;Neries;DEBESĖLIŲ;78475531620;Taip;9;0;0;9
5618;Neries;DEBESĖLIŲ;58447815495;Taip;13;2;0;15
5619;Neries;DEBESĖLIŲ;1908377973;Taip;0;12;0;12
5620;Neries;DEBESĖLIŲ;44887591473;Ne;0;6;0;6
5621;Neries;DEBESĖLIŲ;1139288486;Taip;0;7;0;7
5622;Neries;DEBESĖLIŲ;6449369298;Taip;0;8;0;8
5623;Neries;DEBESĖLIŲ;6378297641;Taip;0;1;0;1
5624;Neries;DEBESĖLIŲ;2531690903;Taip;0;16;0;16
5625;Neries;DEBESĖLIŲ;25015347703;Taip;0;16;0;16
5626;Neries;DEBESĖLIŲ;40087119136;Taip;0;11;0;11
5627;Neries;DEBESĖLIŲ;6994378824;Taip;11;0;0;11
5628;Neries;PUMPURĖLIŲ;4058545269;Taip;6;0;0;6
5629;Neries;PUMPURĖLIŲ;40762091796;Taip;0;10;0;10
5630;Neries;PUMPURĖLIŲ;5189351158;Taip;0;3;0;3
5631;Neries;PUMPURĖLIŲ;4112888398;Taip;5;1;0;6
5632;Neries;PUMPURĖLIŲ;1300411811;Taip;0;15;0;15
5633;Neries;PUMPURĖLIŲ;1355661922;Taip;3;1;0;4
5634;Neries;PUMPURĖLIŲ;1414837177;Taip;0;7;0;7
5635;Neries;PUMPURĖLIŲ;2003536788;Taip;0;10;0;10
5636;Neries;PUMPURĖLIŲ;14071513289;Taip;0;1;0;1
5637;Neries;PUMPURĖLIŲ;7332285452;Taip;5;3;0;8
5638;Neries;PUMPURĖLIŲ;2823401633;Taip;0;5;0;5
5639;Neries;PUMPURĖLIŲ;3914400553;Taip;3;0;0;3
5640;Neries;PUMPURĖLIŲ;5283566263;Ne;12;0;0;12
5641;Nykštukas;SMAGURIAI;46457925178;Taip;0;4;0;4
5642;Nykštukas;SMAGURIAI;67215878528;Taip;3;3;0;6
5643;Nykštukas;SMAGURIAI;279882740;Taip;0;11;0;11
5644;Nykštukas;SMAGURIAI;40791169410;Taip;6;0;0;6
5645;Nykštukas;SMAGURIAI;45998334166;Taip;6;0;1;7
5646;Nykštukas;SMAGURIAI;22907267392;Taip;1;2;0;3
5647;Nykštukas;SMAGURIAI;25467677674;Ne;0;2;0;2
5648;Nykštukas;SMAGURIAI;49403159088;Taip;0;3;0;3
5649;Nykštukas;SMAGURIAI;40507821302;Taip;17;0;0;17
5650;Nykštukas;SMAGURIAI;65431970524;Taip;0;1;3;4
5651;Nykštukas;SMAGURIAI;86774266699;Taip;0;1;1;2
5652;Nykštukas;SMAGURIAI;73015157334;Taip;0;1;0;1
5653;Nykštukas;SMAGURIAI;94379087811;Taip;9;0;0;9
5654;Nykštukas;SMAGURIAI;57158850838;Taip;0;5;0;5
5655;Nykštukas;SMAGURIAI;61896011340;Taip;0;4;0;4
5656;Nykštukas;SMAGURIAI;74269403579;Taip;8;2;0;10
5657;Nykštukas;SMAGURIAI;5270008748;Taip;0;7;0;7
5658;Nykštukas;SMAGURIAI;40765421180;Taip;0;1;0;1
5659;Nykštukas;SMAGURIAI;44921552171;Taip;0;13;0;13
5660;Nykštukas;SMAGURIAI;51839683425;Taip;0;2;0;2
5661;Nykštukas;SMAGURIAI;18018106215;Taip;0;1;1;2
5662;Nykštukas;SMALSIUKAI;59343371023;Taip;0;2;0;2
5663;Nykštukas;SMALSIUKAI;62768852397;Taip;0;1;0;1
5664;Nykštukas;SMALSIUKAI;47375659986;Taip;0;3;0;3
5665;Nykštukas;SMALSIUKAI;38098661273;Taip;0;3;0;3
5666;Nykštukas;SMALSIUKAI;87609458114;Taip;5;1;0;6
5667;Nykštukas;SMALSIUKAI;26952411744;Ne;3;1;0;4
5668;Nykštukas;SMALSIUKAI;79340379786;Taip;3;11;0;14
5669;Nykštukas;SMALSIUKAI;74234678869;Taip;0;10;0;10
5670;Nykštukas;SMALSIUKAI;51448568141;Taip;0;0;5;5
5671;Nykštukas;SMALSIUKAI;4909057583;Taip;12;0;0;12
5672;Nykštukas;SMALSIUKAI;50854821473;Taip;7;1;2;10
5673;Nykštukas;SMALSIUKAI;26248363243;Taip;0;0;3;3
5674;Nykštukas;SMALSIUKAI;57664247691;Taip;7;1;0;8
5675;Nykštukas;SMALSIUKAI;2018631335;Taip;0;0;3;3
5676;Nykštukas;SMALSIUKAI;9506999469;Taip;4;0;0;4
5677;Nykštukas;AITVARIUKAI;1144228064;Taip;4;2;0;6
5678;Nykštukas;AITVARIUKAI;6787279403;Taip;0;6;0;6
5679;Nykštukas;AITVARIUKAI;3808695428;Taip;10;0;0;10
5680;Nykštukas;AITVARIUKAI;2002197530;Taip;16;0;0;16
5681;Nykštukas;AITVARIUKAI;2113361929;Taip;18;0;0;18
5682;Nykštukas;AITVARIUKAI;4256675710;Taip;0;6;0;6
5683;Nykštukas;AITVARIUKAI;1209871301;Taip;13;1;0;14
5684;Nykštukas;AITVARIUKAI;93527297465;Taip;8;0;0;8
5685;Nykštukas;AITVARIUKAI;1642172676;Taip;0;7;0;7
5686;Nykštukas;AITVARIUKAI;4487291454;Taip;0;2;0;2
5687;Nykštukas;AITVARIUKAI;6274009442;Taip;4;2;0;6
5688;Nykštukas;AITVARIUKAI;5356005675;Taip;17;4;0;21
5689;Nykštukas;AITVARIUKAI;1760718866;Taip;0;0;5;5
5690;Nykštukas;AITVARIUKAI;9229795383;Taip;12;0;0;12
5691;Nykštukas;AITVARIUKAI;1643843455;Taip;6;0;2;8
5692;Nykštukas;AITVARIUKAI;1965559069;Taip;8;2;0;10
5693;Nykštukas;AITVARIUKAI;6480026426;Taip;13;0;0;13
5694;Nykštukas;DAINORĖLIAI;1505896987;Taip;7;0;0;7
5695;Nykštukas;DAINORĖLIAI;1070086244;Taip;18;1;0;19
5696;Nykštukas;DAINORĖLIAI;6105521992;Taip;0;11;0;11
5697;Nykštukas;DAINORĖLIAI;67968815055;Taip;10;6;0;16
5698;Nykštukas;DAINORĖLIAI;8027860617;Taip;12;0;2;14
5699;Nykštukas;DAINORĖLIAI;7498721887;Taip;4;1;0;5
5700;Nykštukas;DAINORĖLIAI;7660848578;Taip;0;8;0;8
5701;Nykštukas;DAINORĖLIAI;2284266953;Taip;11;0;0;11
5702;Nykštukas;DAINORĖLIAI;8370864547;Taip;1;0;0;1
5703;Nykštukas;DAINORĖLIAI;4720226790;Taip;8;6;0;14
5704;Nykštukas;DAINORĖLIAI;7546263542;Taip;6;0;0;6
5705;Nykštukas;DAINORĖLIAI;7150793310;Taip;17;1;0;18
5706;Nykštukas;DAINORĖLIAI;7584220414;Taip;4;4;0;8
5707;Nykštukas;DAINORĖLIAI;8323439041;Taip;17;0;0;17
5708;Nykštukas;DAINORĖLIAI;7615678714;Taip;8;2;0;10
5709;Nykštukas;DAINORĖLIAI;9567571526;Taip;0;0;10;10
5710;Nykštukas;DAINORĖLIAI;3970413055;Taip;0;0;4;4
5711;Nykštukas;DAINORĖLIAI;2657373608;Taip;5;2;0;7
5712;Nykštukas;DAINORĖLIAI;1755944368;Taip;12;0;0;12
5713;Nykštukas;DAINORĖLIAI;8781148130;Taip;6;0;0;6
5714;Nykštukas;DAINORĖLIAI;3904901392;Taip;0;10;0;10
5715;Nykštukas;POKŠTUKAI;3600328638;Taip;0;1;0;1
5716;Nykštukas;POKŠTUKAI;55774090623;Taip;0;2;0;2
5717;Nykštukas;POKŠTUKAI;76331610722;Taip;0;1;0;1
5718;Nykštukas;POKŠTUKAI;38015323588;Taip;4;0;0;4
5719;Nykštukas;POKŠTUKAI;97061337677;Taip;0;3;0;3
5720;Nykštukas;POKŠTUKAI;61522787793;Taip;3;0;0;3
5721;Nykštukas;POKŠTUKAI;57257040004;Taip;0;2;0;2
5722;Nykštukas;POKŠTUKAI;26881921240;Ne;0;9;0;9
5723;Nykštukas;POKŠTUKAI;89891993226;Taip;5;3;0;8
5724;Nykštukas;POKŠTUKAI;76160042626;Taip;0;5;0;5
5725;Nykštukas;POKŠTUKAI;47502587491;Taip;0;8;0;8
5726;Nykštukas;POKŠTUKAI;89192783223;Taip;5;5;0;10
5727;Nykštukas;POKŠTUKAI;35147793572;Taip;0;1;0;1
5728;Nykštukas;POKŠTUKAI;47936707754;Taip;7;1;0;8
5729;Nykštukas;POKŠTUKAI;26063170580;Taip;0;2;0;2
5730;Nykštukas;POKŠTUKAI;23972457568;Taip;0;3;0;3
5731;Nykštukas;POKŠTUKAI;16702608956;Taip;0;1;0;1
5732;Nykštukas;POKŠTUKAI;85166768951;Taip;0;5;0;5
5733;Nykštukas;KODĖLČIUKAI;6260667325;Taip;0;6;0;6
5734;Nykštukas;KODĖLČIUKAI;2082842190;Taip;15;6;0;21
5735;Nykštukas;KODĖLČIUKAI;68620632362;Taip;4;2;0;6
5736;Nykštukas;KODĖLČIUKAI;10417553044;Taip;0;6;0;6
5737;Nykštukas;KODĖLČIUKAI;26966643974;Taip;0;3;0;3
5738;Nykštukas;KODĖLČIUKAI;16477177174;Taip;0;3;0;3
5739;Nykštukas;KODĖLČIUKAI;32089764813;Taip;0;6;0;6
5740;Nykštukas;KODĖLČIUKAI;86515707900;Taip;0;2;0;2
5741;Nykštukas;KODĖLČIUKAI;44948458322;Taip;0;1;0;1
5742;Nykštukas;KODĖLČIUKAI;17699507209;Taip;0;3;0;3
5743;Nykštukas;KODĖLČIUKAI;3027861392;Taip;5;2;0;7
5744;Nykštukas;KODĖLČIUKAI;189969762;Taip;12;0;0;12
5745;Nykštukas;KODĖLČIUKAI;46532492743;Taip;11;1;0;12
5746;Nykštukas;KODĖLČIUKAI;36547972390;Taip;0;6;0;6
5747;Nykštukas;KODĖLČIUKAI;61302078210;Taip;14;7;0;21
5748;Nykštukas;KODĖLČIUKAI;98067007304;Taip;8;0;1;9
5749;Nykštukas;KODĖLČIUKAI;50111679676;Ne;0;1;0;1
5750;Nykštukas;KODĖLČIUKAI;4168838641;Taip;0;5;2;7
5751;Nykštukas;PASAKORIAI;29477668697;Taip;0;1;0;1
5752;Nykštukas;PASAKORIAI;84548941865;Taip;2;1;0;3
5753;Nykštukas;PASAKORIAI;86393328886;Taip;5;13;0;18
5754;Nykštukas;PASAKORIAI;67433137766;Taip;0;2;0;2
5755;Nykštukas;PASAKORIAI;12777395170;Taip;0;9;0;9
5756;Nykštukas;PASAKORIAI;59971592045;Taip;3;6;0;9
5757;Nykštukas;PASAKORIAI;29414650504;Taip;0;2;0;2
5758;Nykštukas;PASAKORIAI;1412282356;Taip;0;4;0;4
5759;Nykštukas;PASAKORIAI;77231391186;Taip;0;3;0;3
5760;Nykštukas;PASAKORIAI;1312775821;Taip;15;0;0;15
5761;Nykštukas;PASAKORIAI;67209958343;Taip;0;14;0;14
5762;Nykštukas;PASAKORIAI;40012664626;Taip;5;8;0;13
5763;Nykštukas;PASAKORIAI;2106464061;Taip;5;3;0;8
5764;Nykštukas;PASAKORIAI;368045639;Taip;0;11;0;11
5765;Nykštukas;PASAKORIAI;53994799769;Taip;12;3;0;15
5766;Nykštukas;PASAKORIAI;1967445943;Taip;0;1;0;1
5767;Nykštukas;PASAKORIAI;88757197161;Taip;0;6;0;6
5768;Nykštukas;PASAKORIAI;301318033;Taip;5;10;0;15
5769;Nykštukas;PASAKORIAI;25431679881;Taip;11;0;3;14
5770;Nykštukas;PASAKORIAI;22318910984;Taip;9;0;0;9
5771;Nykštukas;PASAKORIAI;6154158870;Taip;0;2;0;2
5772;Nykštukas;PASAKORIAI;9728270999;Taip;0;1;0;1
5773;Nykštukas;PASAKORIAI;45917705129;Taip;7;1;0;8
5774;Nykštukas;PASAKORIAI;5185856324;Taip;9;0;0;9
5775;Nykštukas;GUDRUČIAI;90969634936;Taip;0;2;0;2
5776;Nykštukas;GUDRUČIAI;1572666795;Taip;0;9;0;9
5777;Nykštukas;GUDRUČIAI;66071060125;Taip;16;0;0;16
5778;Nykštukas;GUDRUČIAI;30508998297;Taip;0;4;0;4
5779;Nykštukas;GUDRUČIAI;25097193002;Taip;0;2;0;2
5780;Nykštukas;GUDRUČIAI;1448977214;Taip;16;0;1;17
5781;Nykštukas;GUDRUČIAI;2109799405;Taip;0;4;0;4
5782;Nykštukas;GUDRUČIAI;83322635443;Taip;0;5;0;5
5783;Nykštukas;GUDRUČIAI;9041364129;Taip;4;7;0;11
5784;Nykštukas;GUDRUČIAI;7098812765;Taip;7;2;0;9
5785;Nykštukas;GUDRUČIAI;48718365302;Taip;2;2;1;5
5786;Nykštukas;GUDRUČIAI;40386182073;Taip;8;1;0;9
5787;Nykštukas;GUDRUČIAI;54607001703;Taip;0;1;0;1
5788;Nykštukas;GUDRUČIAI;7356168681;Taip;0;1;0;1
5789;Nykštukas;GUDRUČIAI;56267408803;Taip;0;1;0;1
5790;Nykštukas;GUDRUČIAI;26154640888;Taip;21;0;0;21
5791;Nykštukas;GUDRUČIAI;92898851752;Taip;0;13;0;13
5792;Nykštukas;GUDRUČIAI;85663477778;Taip;0;5;0;5
5793;Nykštukas;GUDRUČIAI;52614843907;Taip;8;1;0;9
5794;Nykštukas;GUDRUČIAI;94426618018;Taip;4;3;0;7
5795;Nykštukas;GUDRUČIAI;7325852578;Taip;5;2;0;7
5796;Nykštukas;GUDRUČIAI;1055246536;Taip;5;0;0;5
5797;Nykštukas;NAMINUKAI;99161787513;Taip;0;3;2;5
5798;Nykštukas;NAMINUKAI;69041011010;Taip;0;3;2;5
5799;Nykštukas;NAMINUKAI;1856534241;Taip;7;5;0;12
5800;Nykštukas;NAMINUKAI;34930388032;Ne;1;0;0;1
5801;Nykštukas;NAMINUKAI;1178437485;Taip;0;3;0;3
5802;Nykštukas;NAMINUKAI;1608057875;Taip;15;2;0;17
5803;Nykštukas;NAMINUKAI;1285120987;Taip;0;1;0;1
5804;Nykštukas;NAMINUKAI;1994080785;Taip;0;9;0;9
5805;Nykštukas;NAMINUKAI;37253009284;Taip;10;1;0;11
5806;Nykštukas;NAMINUKAI;1630706629;Ne;2;0;0;2
5807;Nykštukas;NAMINUKAI;1350373348;Taip;6;4;0;10
5808;Nykštukas;NAMINUKAI;27896604498;Taip;0;4;0;4
5809;Nykštukas;NAMINUKAI;7322548781;Taip;5;1;0;6
5810;Nykštukas;NAMINUKAI;9422129964;Taip;1;2;0;3
5811;Nykštukas;NAMINUKAI;7836485289;Taip;4;0;1;5
5812;Nykštukas;NAMINUKAI;1186114115;Taip;6;0;1;7
5813;Nykštukas;NAMINUKAI;30762220262;Taip;13;0;0;13
5814;Nykštukas;NAMINUKAI;9184265280;Taip;6;1;0;7
5815;Nykštukas;NAMINUKAI;1687759661;Taip;9;1;0;10
5816;Nykštukas;NAMINUKAI;30020977675;Ne;0;13;0;13
5817;Nykštukas;NAMINUKAI;61615049677;Taip;0;3;0;3
5818;Nykštukas;NAMINUKAI;86582838748;Taip;21;0;0;21
5819;Nykštukas;NAMINUKAI;49056338161;Taip;0;3;0;3
5820;Nykštukas;KŪLVERSTUKAI;9532956150;Taip;11;0;0;11
5821;Nykštukas;KŪLVERSTUKAI;4331906712;Taip;9;0;3;12
5822;Nykštukas;KŪLVERSTUKAI;8948554271;Taip;14;0;0;14
5823;Nykštukas;KŪLVERSTUKAI;6112448299;Taip;0;2;0;2
5824;Nykštukas;KŪLVERSTUKAI;2696384135;Taip;18;0;0;18
5825;Nykštukas;KŪLVERSTUKAI;4040123876;Taip;7;6;0;13
5826;Nykštukas;KŪLVERSTUKAI;1930357859;Taip;16;0;0;16
5827;Nykštukas;KŪLVERSTUKAI;2205400512;Taip;8;1;0;9
5828;Nykštukas;KŪLVERSTUKAI;1102555964;Taip;6;0;0;6
5829;Nykštukas;KŪLVERSTUKAI;9779645295;Taip;8;0;0;8
5830;Nykštukas;KŪLVERSTUKAI;6106373554;Taip;0;1;0;1
5831;Nykštukas;KŪLVERSTUKAI;4612171029;Taip;17;0;0;17
5832;Nykštukas;KŪLVERSTUKAI;3120577264;Taip;12;3;0;15
5833;Nykštukas;KŪLVERSTUKAI;6958596223;Taip;4;1;0;5
5834;Nykštukas;KŪLVERSTUKAI;3273579005;Taip;11;1;0;12
5835;Nykštukas;KŪLVERSTUKAI;5121027981;Taip;15;3;0;18
5836;Nykštukas;KŪLVERSTUKAI;3002966681;Taip;12;2;0;14
5837;Nykštukas;KŪLVERSTUKAI;3985610575;Taip;9;2;0;11
5838;Nykštukas;TREPSIUKAI;5190754451;Taip;6;3;0;9
5839;Nykštukas;TREPSIUKAI;8120626738;Taip;9;0;0;9
5840;Nykštukas;TREPSIUKAI;4795301170;Taip;8;1;0;9
5841;Nykštukas;TREPSIUKAI;4949895196;Taip;7;0;1;8
5842;Nykštukas;TREPSIUKAI;9713859038;Taip;16;0;0;16
5843;Nykštukas;TREPSIUKAI;2988856911;Taip;21;0;0;21
5844;Nykštukas;TREPSIUKAI;4830484167;Taip;11;0;0;11
5845;Nykštukas;TREPSIUKAI;2661110617;Taip;10;0;0;10
5846;Nykštukas;TREPSIUKAI;1707956308;Taip;7;1;0;8
5847;Nykštukas;TREPSIUKAI;8310484267;Taip;12;0;0;12
5848;Nykštukas;TREPSIUKAI;9842748132;Taip;21;0;0;21
5849;Nykštukas;TREPSIUKAI;4771072061;Taip;17;0;0;17
5850;Nykštukas;TREPSIUKAI;1902253981;Taip;0;11;0;11
5851;Nykštukas;TREPSIUKAI;6139988523;Taip;16;0;0;16
5852;Nykštukas;TREPSIUKAI;2826079911;Taip;11;0;0;11
5853;Nykštukas;TREPSIUKAI;2000207070;Taip;10;0;0;10
5854;Nykštukas;TREPSIUKAI;8635571067;Taip;5;5;0;10
5855;Nykštukas;TREPSIUKAI;5421090978;Taip;21;0;0;21
5856;Nykštukas;TREPSIUKAI;7954996421;Taip;0;9;0;9
5857;Ozas;Smalsučiai;2641398988;Taip;0;1;0;1
5858;Ozas;Smalsučiai;9227939420;Taip;2;2;0;4
5859;Ozas;Smalsučiai;7917100888;Taip;10;1;0;11
5860;Ozas;Smalsučiai;87218067796;Taip;16;0;0;16
5861;Ozas;Smalsučiai;1974320330;Taip;0;3;0;3
5862;Ozas;Smalsučiai;1173284700;Taip;2;9;0;11
5863;Ozas;Smalsučiai;67987032400;Taip;10;0;0;10
5864;Ozas;Smalsučiai;71695973592;Taip;3;0;0;3
5865;Ozas;Smalsučiai;57069047630;Taip;0;2;0;2
5866;Ozas;Smalsučiai;5150746885;Taip;0;2;0;2
5867;Ozas;Smalsučiai;9595277597;Taip;7;0;0;7
5868;Ozas;Smalsučiai;1893257809;Taip;6;0;1;7
5869;Ozas;Smalsučiai;6540803077;Taip;15;0;0;15
5870;Ozas;Smalsučiai;8072802467;Taip;0;0;2;2
5871;Ozas;Smalsučiai;1248092034;Ne;4;2;0;6
5872;Ozas;Smalsučiai;43381497677;Taip;5;1;0;6
5873;Ozas;Smalsučiai;7351651916;Taip;10;2;0;12
5874;Ozas;Smalsučiai;3286170280;Taip;14;0;0;14
5875;Ozas;Smalsučiai;9521048381;Taip;17;0;0;17
5876;Ozas;Smalsučiai;2053832360;Taip;1;0;0;1
5877;Ozas;Drugeliai;1655808777;Taip;0;4;0;4
5878;Ozas;Drugeliai;7802699257;Taip;9;2;0;11
5879;Ozas;Drugeliai;8176840834;Taip;0;15;3;18
5880;Ozas;Drugeliai;8088330187;Taip;18;1;0;19
5881;Ozas;Drugeliai;9073973849;Taip;0;0;1;1
5882;Ozas;Drugeliai;9322806566;Taip;2;11;0;13
5883;Ozas;Drugeliai;2676747542;Taip;15;0;3;18
5884;Ozas;Drugeliai;2812687451;Taip;0;0;4;4
5885;Ozas;Drugeliai;8289643065;Taip;10;0;0;10
5886;Ozas;Drugeliai;9987863302;Taip;7;0;3;10
5887;Ozas;Drugeliai;5503766544;Taip;0;7;0;7
5888;Ozas;Drugeliai;2980799420;Taip;21;0;0;21
5889;Ozas;Drugeliai;4935698806;Taip;0;6;2;8
5890;Ozas;Drugeliai;8318380547;Taip;0;7;0;7
5891;Ozas;Drugeliai;4884054504;Taip;11;0;0;11
5892;Ozas;Drugeliai;2825614921;Taip;17;0;0;17
5893;Ozas;Drugeliai;43660054250;Taip;0;13;0;13
5894;Ozas;Boružėlės;1348960421;Taip;7;0;0;7
5895;Ozas;Boružėlės;1375643969;Ne;8;0;2;10
5896;Ozas;Boružėlės;63852147122;Taip;0;5;1;6
5897;Ozas;Boružėlės;8190314087;Taip;15;0;0;15
5898;Ozas;Boružėlės;3803998816;Taip;5;6;1;12
5899;Ozas;Boružėlės;1212358423;Taip;15;1;0;16
5900;Ozas;Boružėlės;7615907271;Taip;12;0;0;12
5901;Ozas;Boružėlės;1560342499;Taip;11;0;0;11
5902;Ozas;Boružėlės;8529654920;Taip;0;0;1;1
5903;Ozas;Boružėlės;60194872867;Taip;4;1;0;5
5904;Ozas;Boružėlės;7172573921;Taip;0;0;3;3
5905;Ozas;Boružėlės;2527574646;Taip;0;10;0;10
5906;Ozas;Boružėlės;9773251894;Taip;0;0;3;3
5907;Ozas;Boružėlės;36523514229;Taip;0;4;0;4
5908;Ozas;Boružėlės;1367050160;Taip;3;0;0;3
5909;Ozas;Boružėlės;68364031736;Taip;0;2;0;2
5910;Ozas;Boružėlės;2678629892;Taip;1;0;6;7
5911;Ozas;Boružėlės;1109113859;Ne;3;0;1;4
5912;Ozas;Boružėlės;1826499734;Taip;6;6;1;13
5913;Ozas;Boružėlės;6432357144;Taip;21;0;0;21
5914;Ozas;Boružėlės;1498656201;Taip;7;6;0;13
5915;Ozas;Boružėlės;8979747150;Taip;17;0;1;18
5916;Ozas;Boružėlės;1217496635;Taip;11;0;0;11
5917;Ozas;Boružėlės;1682529482;Taip;7;0;0;7
5918;Ozas;Žiogeliai;89211493110;Taip;20;1;0;21
5919;Ozas;Žiogeliai;51572539013;Ne;0;1;0;1
5920;Ozas;Žiogeliai;84527270114;Taip;0;0;1;1
5921;Ozas;Žiogeliai;52850058303;Taip;20;1;0;21
5922;Ozas;Žiogeliai;71334912565;Taip;0;6;0;6
5923;Ozas;Žiogeliai;58157410967;Taip;0;1;0;1
5924;Ozas;Žiogeliai;54246199303;Taip;0;5;0;5
5925;Ozas;Žiogeliai;34439403991;Taip;5;11;0;16
5926;Ozas;Žiogeliai;1763449085;Taip;0;1;1;2
5927;Ozas;Žiogeliai;79201129646;Taip;10;9;0;19
5928;Ozas;Žiogeliai;33802611373;Taip;0;5;2;7
5929;Ozas;Žiogeliai;26147218825;Taip;0;12;0;12
5930;Ozas;Žiogeliai;4396409015;Taip;0;4;0;4
5931;Ozas;Žiogeliai;16202534864;Ne;0;6;1;7
5932;Ozas;Žiogeliai;47247380242;Ne;0;10;0;10
5933;Ozas;Žiogeliai;49875201400;Taip;0;3;0;3
5934;Ozas;Žiogeliai;44852155196;Taip;0;2;1;3
5935;Ozas;Žiogeliai;82797241773;Taip;0;2;0;2
5936;Ozas;Žiogeliai;42846343820;Taip;5;1;0;6
5937;Ozas;Bitutės;72570693905;Taip;0;1;0;1
5938;Ozas;Bitutės;26114981770;Taip;0;0;8;8
5939;Ozas;Bitutės;49220695182;Taip;0;11;0;11
5940;Ozas;Bitutės;99554644089;Taip;2;1;0;3
5941;Ozas;Bitutės;25241271456;Taip;0;5;9;14
5942;Ozas;Bitutės;21436609394;Ne;0;2;0;2
5943;Ozas;Bitutės;1806690419;Taip;0;0;2;2
5944;Ozas;Bitutės;20806414515;Taip;0;2;5;7
5945;Ozas;Bitutės;11842802958;Taip;0;1;0;1
5946;Ozas;Bitutės;14182351781;Taip;0;6;0;6
5947;Ozas;Bitutės;89886182151;Taip;5;1;0;6
5948;Ozas;Bitutės;55341521797;Taip;7;0;0;7
5949;Ozas;Bitutės;1352632856;Taip;0;3;0;3
5950;Ozas;Bitutės;37636521897;Taip;2;1;0;3
5951;Ozas;Bitutės;36825745378;Taip;0;0;1;1
5952;Ozas;Bitutės;2110892014;Taip;0;2;2;4
5953;Ozas;Bitutės;39931003216;Taip;8;0;0;8
5954;Ozas;Aitvarėliai;1653285671;Taip;5;6;0;11
5955;Ozas;Aitvarėliai;36897118363;Taip;0;1;0;1
5956;Ozas;Aitvarėliai;25660709486;Taip;21;0;0;21
5957;Ozas;Aitvarėliai;87500216376;Taip;3;1;0;4
5958;Ozas;Aitvarėliai;62542133064;Taip;5;1;0;6
5959;Ozas;Aitvarėliai;77935174855;Taip;9;0;2;11
5960;Ozas;Aitvarėliai;74709964983;Taip;0;2;0;2
5961;Ozas;Aitvarėliai;28736160618;Taip;0;2;0;2
5962;Ozas;Aitvarėliai;31810796132;Taip;0;1;0;1
5963;Ozas;Aitvarėliai;3222282556;Taip;0;2;0;2
5964;Ozas;Aitvarėliai;46679332069;Taip;0;2;0;2
5965;Ozas;Aitvarėliai;1556404162;Taip;8;1;0;9
5966;Ozas;Aitvarėliai;20944134865;Taip;5;6;0;11
5967;Ozas;Aitvarėliai;2087307495;Taip;5;0;1;6
5968;Ozas;Aitvarėliai;99211100553;Taip;1;0;0;1
5969;Ozas;Aitvarėliai;56927777775;Taip;0;12;2;14
5970;Ozas;Aitvarėliai;84378491220;Taip;0;1;1;2
5971;Ozas;Aitvarėliai;53609618421;Taip;0;1;0;1
5972;Ozas;Aitvarėliai;71286685759;Taip;5;2;0;7
5973;Ozas;Aitvarėliai;83249479846;Taip;1;0;0;1
5974;Ozas;Aitvarėliai;1182573257;Taip;13;0;0;13
5975;Ozas;Aitvarėliai;85075096111;Taip;0;6;0;6
5976;Ozas;Voveraitės;89115682092;Taip;0;2;1;3
5977;Ozas;Voveraitės;97875471586;Taip;0;1;5;6
5978;Ozas;Voveraitės;42030629149;Taip;0;0;10;10
5979;Ozas;Voveraitės;8817179462;Taip;0;1;0;1
5980;Ozas;Voveraitės;87683044622;Taip;21;0;0;21
5981;Ozas;Voveraitės;88443183082;Taip;0;0;3;3
5982;Ozas;Voveraitės;94576453630;Taip;16;2;0;18
5983;Ozas;Voveraitės;26834809068;Taip;1;5;0;6
5984;Ozas;Voveraitės;88508505247;Taip;5;2;0;7
5985;Ozas;Voveraitės;47574756201;Taip;5;2;0;7
5986;Ozas;Voveraitės;24088059514;Taip;0;7;3;10
5987;Ozas;Voveraitės;29411948493;Taip;0;5;0;5
5988;Ozas;Voveraitės;27655773887;Taip;0;1;0;1
5989;Ozas;Voveraitės;62608717700;Taip;7;0;0;7
5990;Ozas;Voveraitės;88837027397;Taip;0;7;0;7
5991;Ozas;Voveraitės;66463185196;Taip;5;6;0;11
5992;Ozas;Voveraitės;93882562685;Taip;0;7;0;7
5993;Ozas;Voveraitės;37505558259;Taip;0;2;0;2
5994;Ozas;Voveraitės;90020306864;Taip;8;1;0;9
5995;Ozas;Voveraitės;16101439010;Taip;0;3;1;4
5996;Ozas;Voveraitės;5637273299;Taip;0;0;9;9
5997;Ozas;Voveraitės;1637437696;Taip;6;5;1;12
5998;Ozas;Kodelčiukai;2808066733;Taip;9;11;0;20
5999;Ozas;Kodelčiukai;71351371644;Taip;5;0;0;5
6000;Ozas;Kodelčiukai;13077342836;Taip;0;10;0;10
6001;Ozas;Kodelčiukai;1746778441;Taip;2;1;0;3
6002;Ozas;Kodelčiukai;1110232715;Taip;7;1;0;8
6003;Ozas;Kodelčiukai;28273919775;Taip;5;0;0;5
6004;Ozas;Kodelčiukai;88618151766;Taip;0;0;1;1
6005;Ozas;Kodelčiukai;3637786952;Taip;0;4;0;4
6006;Ozas;Kodelčiukai;39003781970;Taip;0;9;0;9
6007;Ozas;Kodelčiukai;1243205832;Taip;9;0;0;9
6008;Ozas;Kodelčiukai;1235925750;Taip;0;0;1;1
6009;Ozas;Kodelčiukai;69756875821;Taip;0;5;0;5
6010;Ozas;Kodelčiukai;19065860134;Taip;0;5;0;5
6011;Ozas;Kodelčiukai;91774614891;Taip;4;2;0;6
6012;Ozas;Kodelčiukai;19284606277;Taip;5;1;0;6
6013;Ozas;Kodelčiukai;1230455881;Taip;5;0;0;5
6014;Ozas;Kodelčiukai;9664748034;Taip;0;12;0;12
6015;Ozas;Kodelčiukai;1684454071;Taip;11;1;0;12
6016;Ozas;Kodelčiukai;1995302672;Taip;0;5;0;5
6017;Ozas;Kodelčiukai;1288477637;Taip;7;3;0;10
6018;Ozas;Kodelčiukai;82373453244;Taip;5;0;0;5
6019;Ozas;Kodelčiukai;94673981368;Taip;1;1;0;2
6020;Ozas;Pelėdžiukai;1462541264;Taip;17;2;0;19
6021;Ozas;Pelėdžiukai;3439351594;Taip;0;15;0;15
6022;Ozas;Pelėdžiukai;60743195418;Taip;0;9;0;9
6023;Ozas;Pelėdžiukai;64778552590;Taip;0;0;2;2
6024;Ozas;Pelėdžiukai;35346948351;Taip;6;0;0;6
6025;Ozas;Pelėdžiukai;13375413701;Taip;0;2;0;2
6026;Ozas;Pelėdžiukai;16523707810;Taip;12;0;2;14
6027;Ozas;Pelėdžiukai;47291376629;Taip;6;1;0;7
6028;Ozas;Pelėdžiukai;34330362446;Taip;11;0;0;11
6029;Ozas;Pelėdžiukai;1450257399;Taip;7;6;0;13
6030;Ozas;Pelėdžiukai;88159158596;Taip;0;7;0;7
6031;Ozas;Pelėdžiukai;4765249675;Taip;6;0;0;6
6032;Ozas;Pelėdžiukai;1814400303;Taip;10;0;2;12
6033;Ozas;Pelėdžiukai;1889249743;Taip;0;1;0;1
6034;Ozas;Pelėdžiukai;1099026003;Taip;1;8;0;9
6035;Ozas;Pelėdžiukai;2058548464;Taip;8;0;0;8
6036;Ozas;Pelėdžiukai;4590847831;Taip;0;5;1;6
6037;Ozas;Pelėdžiukai;1910114048;Taip;5;0;2;7
6038;Ozas;"Kačiukai ";75077443996;Taip;9;5;0;14
6039;Ozas;"Kačiukai ";95179927759;Taip;4;12;0;16
6040;Ozas;"Kačiukai ";4075968205;Taip;0;0;14;14
6041;Ozas;"Kačiukai ";6618249243;Taip;10;3;0;13
6042;Ozas;"Kačiukai ";1151213934;Taip;6;0;0;6
6043;Ozas;"Kačiukai ";2114612776;Taip;18;0;1;19
6044;Ozas;"Kačiukai ";60155732637;Taip;3;3;0;6
6045;Ozas;"Kačiukai ";37159754070;Taip;0;0;3;3
6046;Ozas;"Kačiukai ";61398533877;Taip;12;0;0;12
6047;Ozas;"Kačiukai ";1848619053;Taip;0;0;11;11
6048;Ozas;"Kačiukai ";1316758924;Taip;11;0;3;14
6049;Ozas;"Kačiukai ";2018398634;Taip;0;0;16;16
6050;Ozas;"Kačiukai ";34196440412;Taip;7;0;0;7
6051;Ozas;"Kačiukai ";84277015523;Taip;5;0;10;15
6052;Ozas;"Kačiukai ";1822377180;Taip;6;0;7;13
6053;Ozas;"Kačiukai ";1551028882;Taip;15;0;0;15
6054;Ozas;"Kačiukai ";14760258125;Taip;1;0;0;1
6055;Ozas;"Kačiukai ";4400619617;Taip;0;0;4;4
6056;Ozas;"Kačiukai ";9345447142;Taip;6;0;3;9
6057;Ozas;"Kačiukai ";1681367373;Taip;0;17;0;17
6058;Ozas;"Kačiukai ";8248732706;Taip;0;20;1;21
6059;Ozas;Ančiukų;9392526836;Taip;6;6;0;12
6060;Ozas;Ančiukų;3631049449;Taip;6;0;0;6
6061;Ozas;Ančiukų;3255382007;Taip;13;0;0;13
6062;Ozas;Ančiukų;1837947633;Taip;6;1;1;8
6063;Ozas;Ančiukų;5850824864;Taip;14;0;0;14
6064;Ozas;Ančiukų;4966355020;Taip;8;0;0;8
6065;Ozas;Ančiukų;1562277866;Taip;0;5;1;6
6066;Ozas;Ančiukų;6088757991;Taip;5;4;0;9
6067;Ozas;Ančiukų;2991511872;Taip;10;2;0;12
6068;Ozas;Ančiukų;6257625501;Taip;21;0;0;21
6069;Ozas;Ančiukų;7402290524;Taip;16;2;0;18
6070;Ozas;Ančiukų;4571583671;Taip;11;5;0;16
6071;Ozas;Ančiukų;5682027094;Taip;11;10;0;21
6072;Ozas;Ančiukų;6053885086;Taip;6;3;0;9
6073;Ozas;Ančiukų;6950802941;Taip;17;0;0;17
6074;Ozas;Ančiukų;6499549095;Taip;0;2;2;4
6075;Ozas;Ančiukų;9324647606;Taip;15;2;0;17
6076;Ozas;Nykškukų;2352118061;Taip;4;0;0;4
6077;Ozas;Nykškukų;7499756171;Taip;0;16;0;16
6078;Ozas;Nykškukų;7018190169;Taip;3;0;0;3
6079;Ozas;Nykškukų;4254601638;Taip;12;0;0;12
6080;Ozas;Nykškukų;4227555342;Taip;5;0;0;5
6081;Ozas;Nykškukų;4220780257;Taip;21;0;0;21
6082;Ozas;Nykškukų;2773182934;Taip;4;0;3;7
6083;Ozas;Nykškukų;5102704846;Taip;0;0;2;2
6084;Ozas;Nykškukų;5642468671;Taip;14;0;0;14
6085;Ozas;Nykškukų;7494307084;Taip;11;0;1;12
6086;Ozas;Nykškukų;4583818638;Taip;1;0;0;1
6087;Ozas;Nykškukų;2369544599;Taip;0;1;0;1
6088;Ozas;Nykškukų;8416839037;Taip;10;6;0;16
6089;Ozas;Nykškukų;1161776624;Taip;0;4;0;4
6090;Pabiručiai;Voveriukų;82866592801;Taip;0;9;0;9
6091;Pabiručiai;Voveriukų;59605903606;Taip;3;0;0;3
6092;Pabiručiai;Voveriukų;36884058806;Taip;0;4;0;4
6093;Pabiručiai;Voveriukų;1798480819;Taip;0;6;0;6
6094;Pabiručiai;Voveriukų;57797244989;Taip;0;4;0;4
6095;Pabiručiai;Voveriukų;48017416657;Taip;0;1;4;5
6096;Pabiručiai;Voveriukų;36265846400;Taip;9;0;0;9
6097;Pabiručiai;Voveriukų;16377580421;Taip;7;2;0;9
6098;Pabiručiai;Voveriukų;95846629190;Taip;0;12;0;12
6099;Pabiručiai;Voveriukų;5059523668;Taip;8;7;0;15
6100;Pabiručiai;Voveriukų;53593230261;Taip;0;2;0;2
6101;Pabiručiai;Voveriukų;55956922916;Taip;0;9;0;9
6102;Pabiručiai;Voveriukų;81393745800;Ne;0;5;0;5
6103;Pabiručiai;Voveriukų;9492402983;Taip;7;0;0;7
6104;Pabiručiai;Voveriukų;44352248446;Ne;0;5;0;5
6105;Pabiručiai;Voveriukų;6160308400;Taip;0;6;0;6
6106;Pabiručiai;Boružiukų;1303589700;Taip;0;8;0;8
6107;Pabiručiai;Boružiukų;22866929836;Taip;0;9;0;9
6108;Pabiručiai;Boružiukų;47314536610;Taip;0;4;0;4
6109;Pabiručiai;Boružiukų;82164704789;Taip;0;6;0;6
6110;Pabiručiai;Boružiukų;32325675784;Taip;0;5;0;5
6111;Pabiručiai;Boružiukų;93509618214;Taip;0;2;4;6
6112;Pabiručiai;Boružiukų;57792326027;Taip;0;4;0;4
6113;Pabiručiai;Boružiukų;91293202710;Taip;0;6;0;6
6114;Pabiručiai;Boružiukų;27052463521;Taip;10;1;0;11
6115;Pabiručiai;Boružiukų;59616111036;Taip;0;2;1;3
6116;Pabiručiai;Boružiukų;2284041402;Taip;0;1;0;1
6117;Pabiručiai;Boružiukų;61547104192;Taip;0;2;2;4
6118;Pabiručiai;Boružiukų;97165250663;Taip;0;2;0;2
6119;Pabiručiai;Boružiukų;38492844225;Taip;0;3;0;3
6120;Pabiručiai;Boružiukų;3959937657;Taip;12;0;0;12
6121;Pabiručiai;Boružiukų;74823092402;Ne;0;1;0;1
6122;Pabiručiai;Boružiukų;32339177392;Taip;10;1;0;11
6123;Pabiručiai;Katinėlių;1670938208;Taip;12;0;0;12
6124;Pabiručiai;Katinėlių;1224986101;Taip;8;0;4;12
6125;Pabiručiai;Katinėlių;3756365293;Taip;7;0;0;7
6126;Pabiručiai;Katinėlių;6283372742;Taip;8;0;0;8
6127;Pabiručiai;Katinėlių;1749155319;Ne;7;1;3;11
6128;Pabiručiai;Katinėlių;34883375155;Taip;5;4;0;9
6129;Pabiručiai;Katinėlių;1705085006;Taip;6;0;0;6
6130;Pabiručiai;Katinėlių;58112415466;Taip;0;10;0;10
6131;Pabiručiai;Katinėlių;42877891797;Taip;0;7;0;7
6132;Pabiručiai;Katinėlių;6285940478;Taip;4;0;0;4
6133;Pabiručiai;Katinėlių;8710389714;Taip;0;6;0;6
6134;Pabiručiai;Katinėlių;4501176225;Taip;0;8;0;8
6135;Pabiručiai;Katinėlių;8503177793;Taip;10;0;0;10
6136;Pabiručiai;Katinėlių;95695057362;Taip;5;0;0;5
6137;Pabiručiai;Katinėlių;4339607826;Taip;5;11;0;16
6138;Pabiručiai;Katinėlių;8306688649;Taip;4;0;0;4
6139;Pabiručiai;Katinėlių;2572570925;Taip;10;0;3;13
6140;Pabiručiai;Katinėlių;6994301415;Taip;21;0;0;21
6141;Pabiručiai;Katinėlių;4205107384;Taip;8;0;1;9
6142;Pabiručiai;Žiogelių;5522447437;Taip;4;0;0;4
6143;Pabiručiai;Žiogelių;7974345478;Taip;10;2;0;12
6144;Pabiručiai;Žiogelių;8367889753;Taip;0;2;0;2
6145;Pabiručiai;Žiogelių;8421025940;Taip;0;10;0;10
6146;Pabiručiai;Žiogelių;3028063887;Taip;0;1;0;1
6147;Pabiručiai;Žiogelių;1642658060;Taip;4;6;0;10
6148;Pabiručiai;Žiogelių;3206962828;Taip;15;0;0;15
6149;Pabiručiai;Žiogelių;3355875364;Taip;0;1;0;1
6150;Pabiručiai;Žiogelių;7085036701;Taip;0;9;0;9
6151;Pabiručiai;Žiogelių;8736658575;Taip;6;1;2;9
6152;Pabiručiai;Žiogelių;1311650644;Taip;5;2;0;7
6153;Pabiručiai;Žiogelių;5480714322;Taip;0;9;0;9
6154;Pabiručiai;Žiogelių;3585198013;Taip;0;7;0;7
6155;Pabiručiai;Žiogelių;2356833740;Taip;6;0;2;8
6156;Pabiručiai;Žiogelių;5311762824;Taip;0;10;0;10
6157;Pabiručiai;Žiogelių;1587905929;Taip;2;0;0;2
6158;Pabiručiai;Žiogelių;5761888906;Taip;0;7;0;7
6159;Pabiručiai;Žiogelių;4667769378;Taip;0;5;0;5
6160;Pabiručiai;Smalsiukai;77665506359;Taip;8;3;0;11
6161;Pabiručiai;Smalsiukai;33576823599;Taip;7;5;0;12
6162;Pabiručiai;Smalsiukai;25404048436;Taip;0;0;3;3
6163;Pabiručiai;Smalsiukai;99245902550;Ne;0;3;0;3
6164;Pabiručiai;Smalsiukai;72030186300;Taip;0;4;0;4
6165;Pabiručiai;Smalsiukai;1461544209;Taip;8;0;3;11
6166;Pabiručiai;Smalsiukai;1749795353;Taip;17;2;0;19
6167;Pabiručiai;Smalsiukai;83758151778;Ne;0;1;0;1
6168;Pabiručiai;Smalsiukai;46891762701;Taip;0;7;0;7
6169;Pabiručiai;Smalsiukai;88469372129;Taip;3;0;0;3
6170;Pabiručiai;Smalsiukai;1052844376;Taip;0;1;0;1
6171;Pabiručiai;Smalsiukai;97516241743;Taip;11;0;0;11
6172;Pabiručiai;Smalsiukai;37299891873;Taip;0;1;0;1
6173;Pabiručiai;Smalsiukai;99612002248;Taip;0;1;0;1
6174;Pabiručiai;Smalsiukai;67029008630;Taip;0;1;0;1
6175;Pabiručiai;Smalsiukai;8690290547;Taip;0;17;0;17
6176;Pabiručiai;Smalsiukai;1961336031;Taip;10;2;0;12
6177;Pabiručiai;Kiškučiai;23334247840;Taip;12;6;0;18
6178;Pabiručiai;Kiškučiai;78055744911;Taip;0;9;0;9
6179;Pabiručiai;Kiškučiai;9756328087;Ne;0;10;0;10
6180;Pabiručiai;Kiškučiai;16153916925;Taip;0;12;0;12
6181;Pabiručiai;Kiškučiai;69948274186;Taip;0;2;0;2
6182;Pabiručiai;Kiškučiai;62817645726;Taip;0;7;0;7
6183;Pabiručiai;Kiškučiai;2117594123;Taip;12;6;0;18
6184;Pabiručiai;Kiškučiai;99405892035;Taip;0;12;0;12
6185;Pabiručiai;Kiškučiai;31043795418;Taip;13;3;0;16
6186;Pabiručiai;Kiškučiai;1189209435;Taip;0;5;0;5
6187;Pabiručiai;Kiškučiai;58410416452;Taip;5;2;0;7
6188;Pabiručiai;Kiškučiai;1457799587;Taip;0;1;0;1
6189;Pabiručiai;Kiškučiai;93595653770;Taip;0;8;0;8
6190;Pabiručiai;Kiškučiai;72090235276;Taip;0;13;0;13
6191;Pabiručiai;Kiškučiai;4463663862;Taip;1;8;0;9
6192;Pabiručiai;Kiškučiai;1780827082;Taip;6;0;0;6
6193;Pabiručiai;Kiškučiai;3767061583;Taip;11;5;0;16
6194;Pabiručiai;Kiškučiai;37991862437;Taip;0;5;0;5
6195;Pabiručiai;Kiškučiai;5327687404;Taip;5;2;0;7
6196;Pabiručiai;"Pėledžiukai ";7457099536;Taip;15;1;0;16
6197;Pabiručiai;"Pėledžiukai ";77273870334;Taip;0;2;0;2
6198;Pabiručiai;"Pėledžiukai ";80756439543;Taip;0;2;1;3
6199;Pabiručiai;"Pėledžiukai ";75098378597;Taip;0;6;0;6
6200;Pabiručiai;"Pėledžiukai ";40295012430;Taip;0;0;1;1
6201;Pabiručiai;"Pėledžiukai ";90849312010;Taip;11;0;0;11
6202;Pabiručiai;"Pėledžiukai ";6112244077;Taip;9;2;0;11
6203;Pabiručiai;"Pėledžiukai ";18356992277;Taip;6;6;0;12
6204;Pabiručiai;"Pėledžiukai ";55197056543;Taip;8;0;0;8
6205;Pabiručiai;"Pėledžiukai ";42627202407;Taip;0;1;0;1
6206;Pabiručiai;"Pėledžiukai ";28121667845;Taip;10;0;0;10
6207;Pabiručiai;"Pėledžiukai ";1474411801;Taip;9;1;0;10
6208;Pabiručiai;"Pėledžiukai ";1591342751;Taip;15;2;0;17
6209;Pabiručiai;"Pėledžiukai ";1701727758;Taip;10;1;0;11
6210;Pabiručiai;"Pėledžiukai ";1078387167;Taip;9;0;0;9
6211;Pabiručiai;"Pėledžiukai ";3733576400;Taip;0;9;0;9
6212;Pabiručiai;"Pėledžiukai ";4568554097;Taip;0;0;1;1
6213;Pabiručiai;"Pėledžiukai ";34215100257;Taip;0;7;0;7
6214;Pabiručiai;"Pėledžiukai ";26940925728;Taip;0;7;0;7
6215;Pabiručiai;"Pėledžiukai ";2944433375;Taip;13;1;0;14
6216;Pabiručiai;"Kodelčiūkai ";1819457592;Taip;0;2;0;2
6217;Pabiručiai;"Kodelčiūkai ";38142737487;Taip;0;4;0;4
6218;Pabiručiai;"Kodelčiūkai ";62923769489;Taip;15;3;0;18
6219;Pabiručiai;"Kodelčiūkai ";15948930587;Taip;12;0;0;12
6220;Pabiručiai;"Kodelčiūkai ";78798062773;Taip;10;0;0;10
6221;Pabiručiai;"Kodelčiūkai ";66085180057;Ne;0;11;0;11
6222;Pabiručiai;"Kodelčiūkai ";1901455947;Taip;0;0;7;7
6223;Pabiručiai;"Kodelčiūkai ";1718014001;Taip;0;5;0;5
6224;Pabiručiai;"Kodelčiūkai ";46251218463;Taip;0;0;2;2
6225;Pabiručiai;"Kodelčiūkai ";1029743585;Taip;0;1;0;1
6226;Pabiručiai;"Kodelčiūkai ";1236499374;Taip;10;7;0;17
6227;Pabiručiai;"Kodelčiūkai ";8344476830;Taip;0;6;0;6
6228;Pabiručiai;"Peliukų ";4301904533;Taip;14;0;0;14
6229;Pabiručiai;"Peliukų ";3096466200;Taip;8;1;0;9
6230;Pabiručiai;"Peliukų ";7524993271;Taip;0;2;0;2
6231;Pabiručiai;"Peliukų ";5708597471;Taip;0;1;0;1
6232;Pabiručiai;"Peliukų ";8106446562;Taip;0;7;0;7
6233;Pabiručiai;"Peliukų ";7046122545;Taip;0;0;1;1
6234;Pabiručiai;"Peliukų ";1673473814;Taip;0;3;0;3
6235;Pabiručiai;"Peliukų ";5686769648;Taip;0;5;0;5
6236;Pabiručiai;"Peliukų ";8175565139;Taip;0;2;0;2
6237;Pabiručiai;"Peliukų ";4006783343;Taip;1;0;0;1
6238;Pabiručiai;"Peliukų ";7073230645;Taip;11;2;0;13
6239;Pabiručiai;"Peliukų ";1344711015;Taip;3;2;0;5
6240;Pabiručiai;"Viščiukų ";9468698553;Taip;5;0;0;5
6241;Pabiručiai;"Viščiukų ";4040533883;Taip;0;0;3;3
6242;Pabiručiai;"Viščiukų ";9356327400;Taip;5;5;0;10
6243;Pabiručiai;"Viščiukų ";8236964683;Taip;10;0;0;10
6244;Pabiručiai;"Viščiukų ";7090116276;Taip;14;0;0;14
6245;Pabiručiai;"Viščiukų ";4069564285;Taip;6;9;0;15
6246;Pabiručiai;"Viščiukų ";5232678556;Taip;14;0;0;14
6247;Pabiručiai;"Viščiukų ";8897462614;Taip;2;3;0;5
6248;Pabiručiai;"Viščiukų ";7278334800;Taip;5;0;1;6
6249;Pabiručiai;"Viščiukų ";7846758352;Taip;14;0;0;14
6250;Pabiručiai;"Viščiukų ";1663953648;Taip;0;4;0;4
6251;Pabiručiai;"Drugelių ";6251432968;Taip;2;0;0;2
6252;Pabiručiai;"Drugelių ";1671027282;Taip;10;3;0;13
6253;Pabiručiai;"Drugelių ";3151360288;Taip;11;1;0;12
6254;Pabiručiai;"Drugelių ";1028312285;Taip;11;0;0;11
6255;Pabiručiai;"Drugelių ";2446697763;Taip;0;0;2;2
6256;Pabiručiai;"Drugelių ";1498738549;Taip;0;6;0;6
6257;Pabiručiai;"Drugelių ";4312364951;Taip;13;0;0;13
6258;Pabiručiai;"Drugelių ";4462744848;Taip;5;2;0;7
6259;Pabiručiai;"Drugelių ";1240057541;Taip;0;11;0;11
6260;Pabiručiai;"Drugelių ";9589005897;Taip;11;0;1;12
6261;Pabiručiai;"Drugelių ";3759350345;Taip;0;13;0;13
6262;Pabiručiai;"Drugelių ";1582754284;Taip;0;1;0;1
6263;Pabiručiai;"Drugelių ";4813206044;Taip;3;8;0;11
6264;Pabiručiai;"Drugelių ";5497318373;Taip;12;0;0;12
6265;Pabiručiai;"Drugelių ";7572077461;Taip;15;1;0;16
6266;Pagrandukas;Saulytės;56985738094;Taip;0;6;0;6
6267;Pagrandukas;Saulytės;73747309137;Taip;3;0;0;3
6268;Pagrandukas;Saulytės;90141915028;Taip;6;11;0;17
6269;Pagrandukas;Saulytės;25042144265;Taip;0;1;0;1
6270;Pagrandukas;Saulytės;92496791690;Taip;0;8;0;8
6271;Pagrandukas;Saulytės;8490035231;Taip;0;16;0;16
6272;Pagrandukas;Saulytės;17860708643;Taip;9;0;0;9
6273;Pagrandukas;Saulytės;10275994267;Taip;0;6;0;6
6274;Pagrandukas;Saulytės;53442283517;Taip;0;6;0;6
6275;Pagrandukas;Saulytės;85893187794;Taip;0;1;0;1
6276;Pagrandukas;Saulytės;1735088719;Taip;0;8;0;8
6277;Pagrandukas;Saulytės;2240690677;Taip;0;4;0;4
6278;Pagrandukas;Saulytės;23836053268;Taip;0;1;0;1
6279;Pagrandukas;Saulytės;82076379343;Taip;0;2;0;2
6280;Pagrandukas;Saulytės;90244057040;Taip;0;17;0;17
6281;Pagrandukas;Saulytės;5179694773;Taip;0;1;0;1
6282;Pagrandukas;Saulytės;1432860651;Taip;6;0;0;6
6283;Pagrandukas;Saulytės;4550081974;Taip;0;7;0;7
6284;Pagrandukas;Zuikučiai;13992515800;Taip;0;6;0;6
6285;Pagrandukas;Zuikučiai;27121246153;Taip;0;0;4;4
6286;Pagrandukas;Zuikučiai;7341198311;Taip;0;0;2;2
6287;Pagrandukas;Zuikučiai;61698205530;Taip;0;0;4;4
6288;Pagrandukas;Zuikučiai;65443026043;Taip;3;1;0;4
6289;Pagrandukas;Zuikučiai;45339513408;Taip;0;4;0;4
6290;Pagrandukas;Zuikučiai;52079380668;Taip;0;7;0;7
6291;Pagrandukas;Zuikučiai;44541642222;Taip;0;5;0;5
6292;Pagrandukas;Zuikučiai;81042926297;Taip;0;0;3;3
6293;Pagrandukas;Zuikučiai;641267897;Taip;0;3;0;3
6294;Pagrandukas;Zuikučiai;99150983585;Taip;0;7;0;7
6295;Pagrandukas;Zuikučiai;43720624711;Taip;0;5;0;5
6296;Pagrandukas;Zuikučiai;62003687896;Taip;0;0;1;1
6297;Pagrandukas;Zuikučiai;49574848652;Taip;0;8;0;8
6298;Pagrandukas;Zuikučiai;18049426774;Taip;0;1;0;1
6299;Pagrandukas;Boružėlių;3398225200;Taip;16;0;0;16
6300;Pagrandukas;Boružėlių;5752454925;Taip;0;2;4;6
6301;Pagrandukas;Boružėlių;3587941684;Taip;11;1;0;12
6302;Pagrandukas;Boružėlių;5946007985;Taip;12;1;0;13
6303;Pagrandukas;Boružėlių;7770852445;Taip;11;1;0;12
6304;Pagrandukas;Boružėlių;6304701617;Taip;13;0;0;13
6305;Pagrandukas;Boružėlių;3953844737;Taip;0;5;0;5
6306;Pagrandukas;Boružėlių;7271589727;Taip;0;4;0;4
6307;Pagrandukas;Boružėlių;5640182548;Taip;7;0;0;7
6308;Pagrandukas;Boružėlių;1403569615;Taip;5;10;0;15
6309;Pagrandukas;Boružėlių;1998073387;Taip;0;6;0;6
6310;Pagrandukas;Boružėlių;5511396314;Taip;0;12;0;12
6311;Pagrandukas;Bitutės;95949044544;Taip;0;1;2;3
6312;Pagrandukas;Bitutės;22146063631;Taip;0;11;0;11
6313;Pagrandukas;Bitutės;1844631218;Taip;0;1;3;4
6314;Pagrandukas;Bitutės;1479570204;Taip;0;1;0;1
6315;Pagrandukas;Bitutės;1505620688;Taip;0;1;3;4
6316;Pagrandukas;Bitutės;1654566158;Taip;0;1;0;1
6317;Pagrandukas;Bitutės;41904915714;Taip;0;1;0;1
6318;Pagrandukas;Bitutės;44029972943;Taip;0;2;3;5
6319;Pagrandukas;Bitutės;47836927832;Taip;4;0;0;4
6320;Pagrandukas;Bitutės;1707429884;Taip;0;1;1;2
6321;Pagrandukas;Bitutės;91591094393;Taip;0;0;5;5
6322;Pagrandukas;Bitutės;6585880191;Taip;0;2;1;3
6323;Pagrandukas;Bitutės;8891887553;Taip;0;1;1;2
6324;Pagrandukas;Bitutės;1503479321;Taip;0;2;4;6
6325;Pagrandukas;Bitutės;9313380552;Taip;0;0;5;5
6326;Pagrandukas;Bitutės;51982253355;Taip;0;6;0;6
6327;Pagrandukas;Bitutės;6044667668;Taip;0;0;1;1
6328;Pagrandukas;Bitutės;3227066520;Taip;0;2;4;6
6329;Pagrandukas;Bitutės;1813676320;Taip;0;0;4;4
6330;Pagrandukas;Pelėdžiukai;1590309916;Taip;0;2;0;2
6331;Pagrandukas;Pelėdžiukai;1964310988;Taip;0;1;0;1
6332;Pagrandukas;Pelėdžiukai;44044284874;Taip;0;7;0;7
6333;Pagrandukas;Pelėdžiukai;33750135077;Taip;0;5;0;5
6334;Pagrandukas;Pelėdžiukai;2066377478;Taip;0;1;2;3
6335;Pagrandukas;Pelėdžiukai;1189453012;Taip;0;1;0;1
6336;Pagrandukas;Pelėdžiukai;43539883053;Taip;5;2;0;7
6337;Pagrandukas;Pelėdžiukai;4391887554;Taip;7;0;0;7
6338;Pagrandukas;Pelėdžiukai;33909593470;Taip;0;1;0;1
6339;Pagrandukas;Pelėdžiukai;2068155037;Taip;0;0;1;1
6340;Pagrandukas;Pelėdžiukai;7751376696;Taip;0;1;0;1
6341;Pagrandukas;Pelėdžiukai;5818020587;Taip;3;2;0;5
6342;Pagrandukas;Pelėdžiukai;1232460221;Taip;5;6;0;11
6343;Pagrandukas;Pelėdžiukai;7611916563;Taip;0;8;0;8
6344;Pagrandukas;Pelėdžiukai;57471531440;Taip;0;14;0;14
6345;Pagrandukas;Žvaigždutė;1904462840;Taip;0;9;0;9
6346;Pagrandukas;Žvaigždutė;9329518124;Taip;0;1;0;1
6347;Pagrandukas;Žvaigždutė;75080308291;Taip;0;10;0;10
6348;Pagrandukas;Žvaigždutė;7876029445;Taip;0;1;0;1
6349;Pagrandukas;Žvaigždutė;1313716840;Taip;0;2;0;2
6350;Pagrandukas;Žvaigždutė;14043704729;Taip;0;5;0;5
6351;Pagrandukas;Žvaigždutė;51692261484;Taip;0;1;0;1
6352;Pagrandukas;Žvaigždutė;1511562720;Taip;0;1;0;1
6353;Pagrandukas;Žvaigždutė;35830862363;Taip;10;1;0;11
6354;Pagrandukas;Žvaigždutė;2079943643;Taip;2;1;0;3
6355;Pagrandukas;Žvaigždutė;2923517578;Taip;0;3;0;3
6356;Pagrandukas;Žvaigždutė;4724383814;Taip;11;0;0;11
6357;Pagrandukas;Žvaigždutė;7782678159;Taip;13;1;0;14
6358;Pagrandukas;Žvaigždutė;8879549409;Taip;0;10;0;10
6359;Pagrandukas;Žvaigždutė;6299298199;Taip;0;7;0;7
6360;Pagrandukas;Žvaigždutė;7543795007;Taip;10;3;0;13
6361;Pagrandukas;Žvaigždutė;3860781857;Taip;0;11;0;11
6362;Pagrandukas;Žvaigždutė;24287759126;Taip;0;0;1;1
6363;Pagrandukas;Žvaigždutė;9522269582;Taip;0;11;0;11
6364;Pagrandukas;Žvaigždutė;2461803626;Taip;0;1;1;2
6365;Pakalnutė;Pagrandukai;22735454739;Taip;9;2;2;13
6366;Pakalnutė;Pagrandukai;1621947670;Taip;2;1;0;3
6367;Pakalnutė;Pagrandukai;2930341121;Taip;0;2;0;2
6368;Pakalnutė;Pagrandukai;18927141423;Taip;0;1;0;1
6369;Pakalnutė;Pagrandukai;70476217309;Ne;0;2;0;2
6370;Pakalnutė;Pagrandukai;83425301719;Taip;3;1;0;4
6371;Pakalnutė;Pagrandukai;46144634381;Taip;0;2;0;2
6372;Pakalnutė;Pagrandukai;85764245101;Taip;0;2;0;2
6373;Pakalnutė;Pagrandukai;6551713953;Taip;6;2;0;8
6374;Pakalnutė;Pagrandukai;57463392902;Taip;0;5;1;6
6375;Pakalnutė;Pagrandukai;24840895951;Taip;0;2;0;2
6376;Pakalnutė;Pagrandukai;89329905839;Taip;0;5;0;5
6377;Pakalnutė;Pagrandukai;58670351468;Taip;0;1;0;1
6378;Pakalnutė;Pagrandukai;1210432627;Taip;3;5;0;8
6379;Pakalnutė;Pagrandukai;3987920952;Ne;0;1;0;1
6380;Pakalnutė;Pagrandukai;28398386463;Taip;0;0;3;3
6381;Pakalnutė;"Pelėdžiukų ";1167939323;Taip;8;0;0;8
6382;Pakalnutė;"Pelėdžiukų ";82985105104;Taip;0;0;1;1
6383;Pakalnutė;"Pelėdžiukų ";77988376736;Taip;0;9;0;9
6384;Pakalnutė;"Pelėdžiukų ";26491667009;Taip;1;11;0;12
6385;Pakalnutė;"Pelėdžiukų ";37321817270;Taip;3;0;0;3
6386;Pakalnutė;"Pelėdžiukų ";42969128937;Taip;0;0;1;1
6387;Pakalnutė;"Pelėdžiukų ";1970792910;Taip;11;0;1;12
6388;Pakalnutė;"Pelėdžiukų ";1101880932;Taip;0;18;0;18
6389;Pakalnutė;"Pelėdžiukų ";2304898969;Taip;0;0;3;3
6390;Pakalnutė;"Pelėdžiukų ";12785798739;Taip;17;0;0;17
6391;Pakalnutė;"Pelėdžiukų ";65265804867;Taip;0;0;3;3
6392;Pakalnutė;"Pelėdžiukų ";24118925398;Taip;0;10;0;10
6393;Pakalnutė;Ežiukai;72729647117;Taip;0;8;0;8
6394;Pakalnutė;Ežiukai;64242664158;Taip;0;9;0;9
6395;Pakalnutė;Ežiukai;56277347819;Taip;0;8;0;8
6396;Pakalnutė;Ežiukai;48593837984;Taip;0;0;1;1
6397;Pakalnutė;Ežiukai;26038172396;Taip;2;0;0;2
6398;Pakalnutė;Ežiukai;82408964876;Taip;6;4;0;10
6399;Pakalnutė;Ežiukai;60227035402;Taip;1;0;0;1
6400;Pakalnutė;Ežiukai;68936094010;Ne;0;1;0;1
6401;Pakalnutė;Ežiukai;49066311903;Taip;0;2;0;2
6402;Pakalnutė;Ežiukai;78371539346;Ne;7;4;0;11
6403;Pakalnutė;Ežiukai;89871858343;Taip;0;2;0;2
6404;Pakalnutė;Ežiukai;91448223847;Taip;8;0;0;8
6405;Pakalnutė;Ežiukai;1936371007;Taip;0;0;1;1
6406;Pakalnutė;Skruzdėliukų;89875639056;Taip;0;6;0;6
6407;Pakalnutė;Skruzdėliukų;1855158585;Taip;14;0;0;14
6408;Pakalnutė;Skruzdėliukų;7171281063;Taip;0;1;0;1
6409;Pakalnutė;Skruzdėliukų;58650103614;Taip;0;12;0;12
6410;Pakalnutė;Skruzdėliukų;73006298922;Taip;0;4;0;4
6411;Pakalnutė;Skruzdėliukų;1785760365;Taip;6;0;0;6
6412;Pakalnutė;Skruzdėliukų;42536262678;Taip;3;0;0;3
6413;Pakalnutė;Skruzdėliukų;16888957248;Taip;0;5;0;5
6414;Pakalnutė;Skruzdėliukų;1693445653;Taip;11;0;0;11
6415;Pakalnutė;Bitučių;2993145079;Taip;10;5;0;15
6416;Pakalnutė;Bitučių;2367683002;Taip;0;1;0;1
6417;Pakalnutė;Bitučių;9445909071;Taip;16;0;0;16
6418;Pakalnutė;Bitučių;5532458706;Taip;10;0;0;10
6419;Pakalnutė;Bitučių;5355198213;Taip;10;0;1;11
6420;Pakalnutė;Bitučių;5941955322;Taip;2;0;0;2
6421;Pakalnutė;Bitučių;3306334576;Taip;16;0;0;16
6422;Pakalnutė;Bitučių;2095540372;Taip;7;2;0;9
6423;Pakalnutė;Bitučių;5342592825;Taip;5;5;0;10
6424;Pakalnutė;Bitučių;2932205226;Taip;0;6;0;6
6425;Pakalnutė;Bitučių;1238121406;Taip;4;2;0;6
6426;Pakalnutė;Bitučių;6117542654;Taip;12;3;0;15
6427;Pakalnutė;Bitučių;5464143742;Taip;7;1;0;8
6428;Pakalnutė;Bitučių;6351193702;Taip;20;0;0;20
6429;Pakalnutė;Boružiukų;9256219647;Taip;8;5;0;13
6430;Pakalnutė;Boružiukų;6798939288;Taip;0;5;0;5
6431;Pakalnutė;Boružiukų;7357431226;Taip;11;4;0;15
6432;Pakalnutė;Boružiukų;4934095931;Taip;6;0;0;6
6433;Pakalnutė;Boružiukų;5039000154;Taip;0;2;0;2
6434;Pakalnutė;Boružiukų;7853479591;Taip;6;5;0;11
6435;Pakalnutė;Boružiukų;6575909478;Taip;5;1;0;6
6436;Pakalnutė;Boružiukų;3583094831;Taip;6;5;0;11
6437;Pakalnutė;Boružiukų;4033813807;Taip;0;7;2;9
6438;Pakalnutė;Boružiukų;2040992265;Taip;1;0;4;5
6439;Pakalnutė;Boružiukų;7503936754;Taip;7;0;0;7
6440;Pakalnutė;Boružiukų;9382160515;Taip;10;0;0;10
6441;Pakalnutė;Boružiukų;5134342817;Taip;3;0;0;3
6442;Pakalnutė;Boružiukų;7672252382;Taip;7;0;0;7
6443;Pakalnutė;Meškiukų;1602013811;Taip;0;8;0;8
6444;Pakalnutė;Meškiukų;41008813511;Ne;10;0;0;10
6445;Pakalnutė;Meškiukų;83174865018;Taip;0;2;0;2
6446;Pakalnutė;Meškiukų;1655551042;Taip;0;1;0;1
6447;Pakalnutė;Meškiukų;40117721972;Taip;0;9;0;9
6448;Pakalnutė;Meškiukų;64706392096;Taip;5;4;0;9
6449;Pakalnutė;Meškiukų;1411083263;Taip;0;2;0;2
6450;Pakalnutė;Meškiukų;2202341545;Taip;8;0;4;12
6451;Pakalnutė;Meškiukų;9355380341;Taip;6;0;9;15
6452;Pakalnutė;Meškiukų;7324846434;Taip;9;0;0;9
6453;Pakalnutė;Meškiukų;9001185744;Taip;0;0;1;1
6454;Pakalnutė;Nykštukai;6769352325;Taip;0;7;0;7
6455;Pakalnutė;Nykštukai;1202301707;Taip;0;0;3;3
6456;Pakalnutė;Nykštukai;72137985328;Taip;1;0;0;1
6457;Pakalnutė;Nykštukai;11183301096;Taip;13;2;0;15
6458;Pakalnutė;Nykštukai;19773872429;Taip;0;6;0;6
6459;Pakalnutė;Nykštukai;85900847069;Taip;0;1;1;2
6460;Pakalnutė;Nykštukai;16651154416;Taip;4;3;0;7
6461;Pakalnutė;Nykštukai;7452656662;Taip;1;1;0;2
6462;Pakalnutė;Nykštukai;7389600659;Taip;0;2;0;2
6463;Pakalnutė;Nykštukai;5309195407;Taip;0;11;0;11
6464;Pakalnutė;Nykštukai;1849396954;Taip;0;0;2;2
6465;Pakalnutė;Nykštukai;81963663668;Taip;0;0;4;4
6466;Pakalnutė;Nykštukai;76382908561;Taip;0;0;3;3
6467;Pakalnutė;Nykštukai;99344331316;Taip;5;0;2;7
6468;Pakalnutė;Nykštukai;33667858388;Taip;5;8;0;13
6469;Pakalnutė;Nykštukai;2815093249;Taip;0;3;0;3
6470;Pakalnutė;Nykštukai;1372722843;Taip;0;4;0;4
6471;Pakalnutė;Nykštukai;2051737273;Taip;0;0;3;3
6472;Pakalnutė;Nykštukai;61712002384;Taip;0;7;0;7
6473;Pakalnutė;Nykštukai;2946347383;Taip;0;0;4;4
6474;Pakalnutė;"Zuikučių ";1198230323;Taip;0;5;0;5
6475;Pakalnutė;"Zuikučių ";6016791282;Taip;0;1;0;1
6476;Pakalnutė;"Zuikučių ";3609982613;Taip;1;2;0;3
6477;Pakalnutė;"Zuikučių ";5958653847;Taip;5;0;0;5
6478;Pakalnutė;"Zuikučių ";8513260520;Taip;4;0;0;4
6479;Pakalnutė;"Zuikučių ";2159430356;Taip;7;3;0;10
6480;Pakalnutė;"Zuikučių ";1147843795;Taip;13;0;0;13
6481;Pakalnutė;"Zuikučių ";6879558965;Taip;0;10;0;10
6482;Pakalnutė;"Zuikučių ";3555822605;Taip;8;0;0;8
6483;Pakalnutė;"Zuikučių ";7563201788;Taip;0;0;1;1
6484;Pakalnutė;"Zuikučių ";1583462733;Taip;2;0;1;3
6485;Pakalnutė;"Zuikučių ";6377564215;Taip;4;0;0;4
6486;Pakalnutė;"Zuikučių ";3306670221;Taip;0;0;6;6
6487;Pakalnutė;"Zuikučių ";1159312512;Taip;17;0;0;17
6488;Pakalnutė;"Zuikučių ";6549217377;Taip;8;0;0;8
6489;Pakalnutė;"Zuikučių ";8813262660;Taip;6;9;0;15
6490;Pakalnutė;"Zuikučių ";5102345686;Taip;10;0;0;10
6491;Pakalnutė;"Zuikučių ";7949588551;Taip;2;0;0;2
6492;Pakalnutė;"Zuikučių ";81578522887;Taip;0;1;0;1
6493;Pakalnutė;"Drugelių ";4046820545;Taip;0;2;0;2
6494;Pakalnutė;"Drugelių ";5973972464;Taip;5;0;0;5
6495;Pakalnutė;"Drugelių ";3035056391;Taip;5;7;0;12
6496;Pakalnutė;"Drugelių ";4742424647;Taip;0;1;0;1
6497;Pakalnutė;"Drugelių ";5435336235;Taip;0;0;4;4
6498;Pakalnutė;"Drugelių ";4514642887;Taip;6;1;0;7
6499;Pakalnutė;"Drugelių ";9274456755;Taip;0;1;0;1
6500;Pakalnutė;"Drugelių ";2721810040;Taip;0;0;3;3
6501;Pakalnutė;"Drugelių ";80818670065;Taip;0;1;1;2
6502;Pakalnutė;"Drugelių ";2049079012;Taip;7;3;0;10
6503;Pakalnutė;"Drugelių ";4681267749;Taip;9;0;0;9
6504;Pakalnutė;"Drugelių ";85356812538;Taip;8;1;1;10
6505;Pakalnutė;"Drugelių ";6771510589;Taip;5;0;3;8
6506;Pakalnutė;"Drugelių ";18503890312;Taip;0;8;0;8
6507;Pakalnutė;"Drugelių ";4264260466;Taip;16;0;0;16
6508;Papartis;ZUIKUČIAI;1065234123;Taip;10;0;0;10
6509;Papartis;ZUIKUČIAI;27900855758;Taip;3;0;0;3
6510;Papartis;ZUIKUČIAI;1219140467;Taip;11;1;0;12
6511;Papartis;ZUIKUČIAI;1260151691;Taip;6;1;0;7
6512;Papartis;ZUIKUČIAI;2412700197;Taip;13;0;0;13
6513;Papartis;ZUIKUČIAI;1554777403;Taip;6;0;0;6
6514;Papartis;ZUIKUČIAI;7703070601;Taip;0;7;0;7
6515;Papartis;ZUIKUČIAI;7902130389;Taip;11;0;0;11
6516;Papartis;ZUIKUČIAI;4992305227;Taip;15;0;0;15
6517;Papartis;ZUIKUČIAI;4346817695;Taip;6;0;0;6
6518;Papartis;ZUIKUČIAI;2447926422;Taip;5;11;0;16
6519;Papartis;ZUIKUČIAI;3182457453;Taip;11;0;0;11
6520;Papartis;ZUIKUČIAI;3275123842;Taip;7;1;0;8
6521;Papartis;ZUIKUČIAI;8190458132;Taip;7;0;0;7
6522;Papartis;ZUIKUČIAI;8952917454;Taip;0;0;1;1
6523;Papartis;ZUIKUČIAI;5410369044;Taip;2;0;0;2
6524;Papartis;ZUIKUČIAI;6126912448;Taip;0;0;2;2
6525;Papartis;ZUIKUČIAI;5675537250;Taip;0;1;0;1
6526;Papartis;ZUIKUČIAI;5846324441;Taip;0;8;4;12
6527;Papartis;ZUIKUČIAI;1065128993;Taip;18;1;0;19
6528;Papartis;ZUIKUČIAI;3895487270;Taip;0;7;0;7
6529;Papartis;DRUGELIAI;4508053349;Taip;2;1;0;3
6530;Papartis;DRUGELIAI;7387281720;Taip;5;0;0;5
6531;Papartis;DRUGELIAI;2778629398;Taip;2;4;1;7
6532;Papartis;DRUGELIAI;3475745012;Taip;7;0;11;18
6533;Papartis;DRUGELIAI;2535412635;Taip;10;0;0;10
6534;Papartis;DRUGELIAI;6797687614;Taip;3;0;2;5
6535;Papartis;DRUGELIAI;7606939822;Taip;5;0;0;5
6536;Papartis;DRUGELIAI;9719465384;Taip;3;0;1;4
6537;Papartis;DRUGELIAI;8148483438;Taip;10;0;1;11
6538;Papartis;DRUGELIAI;5265293240;Taip;15;1;0;16
6539;Papartis;DRUGELIAI;7590170146;Taip;5;0;0;5
6540;Papartis;DRUGELIAI;9134335737;Taip;14;1;0;15
6541;Papartis;DRUGELIAI;4935694347;Taip;4;8;0;12
6542;Papartis;DRUGELIAI;1672028156;Taip;0;10;0;10
6543;Papartis;DRUGELIAI;4634683589;Ne;0;1;0;1
6544;Papartis;DRUGELIAI;3107106078;Taip;0;0;2;2
6545;Papartis;DRUGELIAI;1205854439;Taip;7;0;0;7
6546;Papartis;DRUGELIAI;7067369268;Taip;7;0;6;13
6547;Papartis;DRUGELIAI;6746279237;Taip;21;0;0;21
6548;Papartis;ŽVIRBLIUKAI;50932429867;Taip;0;1;1;2
6549;Papartis;ŽVIRBLIUKAI;76557621397;Taip;0;5;1;6
6550;Papartis;ŽVIRBLIUKAI;25395258852;Taip;0;1;0;1
6551;Papartis;ŽVIRBLIUKAI;38687595335;Taip;0;2;0;2
6552;Papartis;ŽVIRBLIUKAI;2572865390;Taip;9;1;5;15
6553;Papartis;ŽVIRBLIUKAI;42525320308;Taip;0;0;1;1
6554;Papartis;ŽVIRBLIUKAI;36753788655;Taip;0;6;0;6
6555;Papartis;ŽVIRBLIUKAI;75872164784;Taip;5;1;1;7
6556;Papartis;ŽVIRBLIUKAI;97003005429;Taip;6;1;8;15
6557;Papartis;ŽVIRBLIUKAI;2328716782;Taip;7;0;0;7
6558;Papartis;ŽVIRBLIUKAI;46090386686;Taip;16;0;0;16
6559;Papartis;ŽVIRBLIUKAI;42363051383;Taip;0;1;2;3
6560;Papartis;ŽVIRBLIUKAI;60618694149;Taip;0;1;0;1
6561;Papartis;ŽVIRBLIUKAI;60803503066;Taip;0;7;0;7
6562;Papartis;ŽVIRBLIUKAI;66084413148;Taip;11;1;3;15
6563;Papartis;ŽVIRBLIUKAI;54923526939;Taip;0;1;5;6
6564;Papartis;ŽVIRBLIUKAI;65887563163;Ne;0;1;1;2
6565;Papartis;ŽVIRBLIUKAI;95325725936;Taip;0;1;0;1
6566;Papartis;ŽVIRBLIUKAI;6896883671;Taip;0;1;1;2
6567;Papartis;ŽVIRBLIUKAI;1712122097;Taip;0;2;0;2
6568;Papartis;PELĖDŽIUKAI;31558670598;Taip;0;2;0;2
6569;Papartis;PELĖDŽIUKAI;68000919945;Taip;0;8;0;8
6570;Papartis;PELĖDŽIUKAI;17727499036;Taip;8;1;3;12
6571;Papartis;PELĖDŽIUKAI;33710012877;Taip;0;1;4;5
6572;Papartis;PELĖDŽIUKAI;3150874256;Taip;6;6;0;12
6573;Papartis;PELĖDŽIUKAI;37962640982;Taip;0;0;1;1
6574;Papartis;PELĖDŽIUKAI;5610352010;Taip;0;6;0;6
6575;Papartis;PELĖDŽIUKAI;97048061562;Taip;0;2;0;2
6576;Papartis;PELĖDŽIUKAI;14737302670;Taip;0;8;0;8
6577;Papartis;PELĖDŽIUKAI;77941154397;Taip;0;1;0;1
6578;Papartis;PELĖDŽIUKAI;10942624686;Taip;0;1;20;21
6579;Papartis;PELĖDŽIUKAI;2759394795;Taip;0;1;3;4
6580;Papartis;PELĖDŽIUKAI;62851879822;Taip;4;2;0;6
6581;Papartis;PELĖDŽIUKAI;75595469519;Taip;0;0;5;5
6582;Papartis;PELĖDŽIUKAI;50230057955;Taip;20;1;0;21
6583;Papartis;PELĖDŽIUKAI;98845059554;Taip;0;1;0;1
6584;Papartis;PELĖDŽIUKAI;14077470090;Taip;0;4;0;4
6585;Papartis;PELĖDŽIUKAI;7603023091;Ne;0;5;0;5
6586;Papartis;PELĖDŽIUKAI;72201740881;Taip;0;1;14;15
6587;Papartis;PELĖDŽIUKAI;87817163360;Taip;0;1;3;4
6588;Papartis;PELĖDŽIUKAI;89808286532;Taip;0;5;0;5
6589;Papartis;PELĖDŽIUKAI;4351158000;Taip;0;8;0;8
6590;Papartis;SAULUTĖS;42803013754;Taip;0;2;0;2
6591;Papartis;SAULUTĖS;2022533158;Taip;2;0;1;3
6592;Papartis;SAULUTĖS;1237889393;Taip;6;4;0;10
6593;Papartis;SAULUTĖS;1246604915;Taip;0;1;0;1
6594;Papartis;SAULUTĖS;48182233276;Taip;0;4;0;4
6595;Papartis;SAULUTĖS;23218268605;Ne;4;0;0;4
6596;Papartis;SAULUTĖS;18124337938;Taip;0;5;0;5
6597;Papartis;SAULUTĖS;22443998204;Taip;5;1;0;6
6598;Papartis;SAULUTĖS;30982681803;Taip;0;4;0;4
6599;Papartis;SAULUTĖS;95139517078;Taip;0;3;0;3
6600;Papartis;SAULUTĖS;14978429821;Taip;0;2;0;2
6601;Papartis;SAULUTĖS;55573140983;Taip;8;0;0;8
6602;Papartis;SAULUTĖS;10078570352;Taip;0;1;3;4
6603;Papartis;SAULUTĖS;88700503601;Taip;0;2;2;4
6604;Papartis;SAULUTĖS;21963930874;Taip;7;3;0;10
6605;Papartis;SAULUTĖS;15207322802;Taip;0;1;0;1
6606;Papartis;SAULUTĖS;3933829088;Taip;0;0;2;2
6607;Papartis;SAULUTĖS;67966766974;Taip;0;6;0;6
6608;Papartis;GANDRIUKAI;46076659264;Ne;0;2;0;2
6609;Papartis;GANDRIUKAI;31606112621;Taip;0;2;0;2
6610;Papartis;GANDRIUKAI;1727771667;Taip;0;0;1;1
6611;Papartis;GANDRIUKAI;37759125130;Taip;0;21;0;21
6612;Papartis;GANDRIUKAI;20862839950;Taip;0;2;1;3
6613;Papartis;GANDRIUKAI;20907751423;Taip;0;2;0;2
6614;Papartis;GANDRIUKAI;8564913801;Taip;6;0;0;6
6615;Papartis;GANDRIUKAI;47876153590;Taip;0;2;0;2
6616;Papartis;GANDRIUKAI;84260015363;Taip;0;4;0;4
6617;Papartis;GANDRIUKAI;67226404925;Taip;21;0;0;21
6618;Papartis;GANDRIUKAI;83927324420;Taip;4;2;0;6
6619;Papartis;GANDRIUKAI;21840378271;Taip;1;0;0;1
6620;Papartis;GANDRIUKAI;93141801552;Taip;0;5;0;5
6621;Papartis;GANDRIUKAI;80455285324;Taip;0;1;0;1
6622;Papartis;GANDRIUKAI;285754903;Taip;4;3;1;8
6623;Papartis;GANDRIUKAI;51857496843;Taip;0;2;0;2
6624;Papartis;GANDRIUKAI;79080758672;Taip;0;3;0;3
6625;Papartis;GANDRIUKAI;18164175829;Taip;0;2;0;2
6626;Papartis;GANDRIUKAI;10026323228;Taip;0;1;20;21
6627;Papartis;GANDRIUKAI;1045629158;Taip;0;5;0;5
6628;Papartis;GANDRIUKAI;8593823543;Taip;0;5;0;5
6629;Papartis;AITVARELIAI;4139884005;Taip;0;10;0;10
6630;Papartis;AITVARELIAI;77686722867;Taip;0;0;2;2
6631;Papartis;AITVARELIAI;2146286089;Taip;5;0;0;5
6632;Papartis;AITVARELIAI;1876543445;Taip;0;1;0;1
6633;Papartis;AITVARELIAI;1282377728;Taip;0;10;0;10
6634;Papartis;AITVARELIAI;19544040390;Taip;0;0;2;2
6635;Papartis;AITVARELIAI;19852567505;Taip;7;5;0;12
6636;Papartis;AITVARELIAI;67237428983;Taip;0;1;1;2
6637;Papartis;AITVARELIAI;89486863055;Taip;0;0;1;1
6638;Papartis;AITVARELIAI;20002349512;Taip;1;0;0;1
6639;Papartis;AITVARELIAI;81734271362;Taip;6;0;0;6
6640;Papartis;AITVARELIAI;87519747220;Taip;0;0;5;5
6641;Papartis;AITVARELIAI;93468721158;Taip;0;2;0;2
6642;Papartis;AITVARELIAI;87353511647;Taip;0;1;0;1
6643;Papartis;AITVARELIAI;26912851152;Taip;1;0;3;4
6644;Papartis;AITVARELIAI;60706816641;Taip;0;5;5;10
6645;Papartis;AITVARELIAI;1973027294;Taip;0;15;0;15
6646;Papartis;AITVARELIAI;1403114386;Taip;0;1;0;1
6647;Papartis;SMALSUČIAI;4823666725;Taip;0;2;1;3
6648;Papartis;SMALSUČIAI;1406820323;Taip;6;8;0;14
6649;Papartis;SMALSUČIAI;2092191603;Taip;4;0;1;5
6650;Papartis;SMALSUČIAI;10659508171;Taip;0;6;0;6
6651;Papartis;SMALSUČIAI;2067304804;Taip;9;2;0;11
6652;Papartis;SMALSUČIAI;88418552221;Taip;0;2;0;2
6653;Papartis;SMALSUČIAI;51899025231;Taip;0;1;0;1
6654;Papartis;SMALSUČIAI;74972133115;Taip;3;0;0;3
6655;Papartis;SMALSUČIAI;1322826573;Taip;0;7;2;9
6656;Papartis;SMALSUČIAI;1527263538;Taip;0;7;1;8
6657;Papartis;SMALSUČIAI;88722771438;Taip;0;0;1;1
6658;Papartis;SMALSUČIAI;4216398263;Taip;0;2;1;3
6659;Papartis;SMALSUČIAI;82454730189;Taip;0;1;2;3
6660;Papartis;SMALSUČIAI;74734443304;Taip;5;0;0;5
6661;Papartis;SMALSUČIAI;2398385967;Taip;10;1;0;11
6662;Papartis;SMALSUČIAI;63087155760;Taip;1;0;0;1
6663;Papartis;SMALSUČIAI;26193472997;Taip;0;2;0;2
6664;Papartis;SMALSUČIAI;68478260102;Ne;6;1;0;7
6665;Papartis;"ŽIRNIUKAI ";44833872631;Taip;0;0;6;6
6666;Papartis;"ŽIRNIUKAI ";1944730492;Taip;5;1;2;8
6667;Papartis;"ŽIRNIUKAI ";12406782910;Taip;0;1;0;1
6668;Papartis;"ŽIRNIUKAI ";1271303103;Taip;10;0;3;13
6669;Papartis;"ŽIRNIUKAI ";30041894006;Taip;0;0;4;4
6670;Papartis;"ŽIRNIUKAI ";3630377970;Taip;9;2;1;12
6671;Papartis;"ŽIRNIUKAI ";38896771062;Taip;6;0;0;6
6672;Papartis;"ŽIRNIUKAI ";86735273559;Taip;8;4;0;12
6673;Papartis;"ŽIRNIUKAI ";22570313128;Taip;13;0;0;13
6674;Papartis;"ŽIRNIUKAI ";51588027659;Taip;0;5;0;5
6675;Papartis;"ŽIRNIUKAI ";64345875780;Ne;13;2;0;15
6676;Papartis;"ŽIRNIUKAI ";2598688561;Taip;5;0;0;5
6677;Papartis;"ŽIRNIUKAI ";53040207725;Taip;0;6;4;10
6678;Papartis;"ŽIRNIUKAI ";3991709974;Taip;4;5;0;9
6679;Papartis;"ŽIRNIUKAI ";3367009621;Taip;4;0;0;4
6680;Papartis;"ŽIRNIUKAI ";7102350653;Taip;0;1;0;1
6681;Papartis;"ŽIRNIUKAI ";3408756311;Taip;6;2;0;8
6682;Papartis;BORUŽĖLĖS;3320524073;Taip;0;3;0;3
6683;Papartis;BORUŽĖLĖS;9384670351;Taip;10;3;0;13
6684;Papartis;BORUŽĖLĖS;1974159967;Taip;8;0;0;8
6685;Papartis;BORUŽĖLĖS;5732853976;Taip;5;0;1;6
6686;Papartis;BORUŽĖLĖS;4279580382;Taip;10;0;0;10
6687;Papartis;BORUŽĖLĖS;8891856856;Taip;5;0;1;6
6688;Papartis;BORUŽĖLĖS;8532558577;Taip;12;1;0;13
6689;Papartis;BORUŽĖLĖS;9968072478;Taip;15;0;3;18
6690;Papartis;BORUŽĖLĖS;1916222143;Taip;21;0;0;21
6691;Papartis;BORUŽĖLĖS;2215846642;Taip;16;0;0;16
6692;Papartis;BORUŽĖLĖS;9704930584;Taip;4;1;0;5
6693;Papartis;BORUŽĖLĖS;7859096984;Taip;8;1;0;9
6694;Papartis;BORUŽĖLĖS;1442806517;Taip;5;0;0;5
6695;Papartis;BORUŽĖLĖS;7252265838;Taip;16;0;0;16
6696;Papartis;BORUŽĖLĖS;9072635586;Taip;8;0;0;8
6697;Papartis;BORUŽĖLĖS;9804863902;Taip;0;1;2;3
6698;Papartis;VARPELIAI;9502229005;Taip;12;0;0;12
6699;Papartis;VARPELIAI;4203241118;Taip;0;1;14;15
6700;Papartis;VARPELIAI;4570512336;Taip;11;1;0;12
6701;Papartis;VARPELIAI;3324647852;Taip;15;0;0;15
6702;Papartis;VARPELIAI;5652560002;Taip;1;0;0;1
6703;Papartis;VARPELIAI;6794076631;Taip;6;0;1;7
6704;Papartis;VARPELIAI;1596721999;Taip;12;0;9;21
6705;Papartis;VARPELIAI;5957889361;Taip;0;2;0;2
6706;Papartis;VARPELIAI;4806652727;Taip;0;0;3;3
6707;Papartis;VARPELIAI;9939850340;Taip;12;1;0;13
6708;Papartis;VARPELIAI;8932290803;Taip;14;0;0;14
6709;Papartis;VARPELIAI;7803854703;Taip;0;1;0;1
6710;Papartis;VARPELIAI;5218101579;Taip;6;1;0;7
6711;Papartis;VARPELIAI;5608868738;Ne;6;1;0;7
6712;Papartis;NYKŠTUKAI;94692743993;Taip;14;1;0;15
6713;Papartis;NYKŠTUKAI;28903744662;Taip;0;0;2;2
6714;Papartis;NYKŠTUKAI;49067272346;Taip;5;2;0;7
6715;Papartis;NYKŠTUKAI;1683639252;Taip;0;2;3;5
6716;Papartis;NYKŠTUKAI;86974446702;Taip;0;3;0;3
6717;Papartis;NYKŠTUKAI;18677892477;Taip;0;4;0;4
6718;Papartis;NYKŠTUKAI;2414727436;Taip;14;1;0;15
6719;Papartis;NYKŠTUKAI;1787027071;Taip;5;0;2;7
6720;Papartis;NYKŠTUKAI;1957969359;Taip;5;0;2;7
6721;Papartis;NYKŠTUKAI;1699776923;Taip;2;0;1;3
6722;Papartis;NYKŠTUKAI;1691817767;Taip;5;4;0;9
6723;Papartis;NYKŠTUKAI;35385266110;Taip;0;2;0;2
6724;Papartis;NYKŠTUKAI;7308118576;Taip;7;0;3;10
6725;Papartis;NYKŠTUKAI;45289621684;Taip;0;5;0;5
6726;Papartis;NYKŠTUKAI;3264373480;Taip;0;1;0;1
6727;Papartis;NYKŠTUKAI;29324405170;Taip;0;5;0;5
6728;Pasagėlė;SMALSUČIŲ;29755294214;Taip;0;6;0;6
6729;Pasagėlė;SMALSUČIŲ;63657801249;Taip;4;6;0;10
6730;Pasagėlė;SMALSUČIŲ;2077383621;Taip;0;6;0;6
6731;Pasagėlė;SMALSUČIŲ;2096927238;Taip;0;4;0;4
6732;Pasagėlė;SMALSUČIŲ;2096035763;Taip;0;9;0;9
6733;Pasagėlė;SMALSUČIŲ;6687699907;Taip;0;5;0;5
6734;Pasagėlė;SMALSUČIŲ;27151485531;Taip;0;4;0;4
6735;Pasagėlė;SMALSUČIŲ;1616662586;Taip;0;19;0;19
6736;Pasagėlė;SMALSUČIŲ;7477773004;Taip;0;8;0;8
6737;Pasagėlė;SMALSUČIŲ;1180183091;Taip;0;20;0;20
6738;Pasagėlė;SMALSUČIŲ;8285580095;Taip;0;10;0;10
6739;Pasagėlė;SMALSUČIŲ;8218872969;Taip;7;9;0;16
6740;Pasagėlė;SMALSUČIŲ;8301904575;Taip;21;0;0;21
6741;Pasagėlė;SMALSUČIŲ;1587218379;Taip;1;6;0;7
6742;Pasagėlė;SMALSUČIŲ;80775017833;Taip;0;7;0;7
6743;Pasagėlė;SMALSUČIŲ;76285364171;Taip;0;2;0;2
6744;Pasagėlė;SMALSUČIŲ;49106308532;Taip;3;0;0;3
6745;Pasagėlė;SMALSUČIŲ;1974755599;Taip;0;5;0;5
6746;Pasagėlė;SMALSUČIŲ;6543038595;Taip;0;21;0;21
6747;Pasagėlė;GUDRUČIŲ;75037090183;Ne;0;0;8;8
6748;Pasagėlė;GUDRUČIŲ;1768000089;Taip;0;0;2;2
6749;Pasagėlė;GUDRUČIŲ;84330734709;Taip;0;0;1;1
6750;Pasagėlė;GUDRUČIŲ;2137489054;Taip;0;7;9;16
6751;Pasagėlė;GUDRUČIŲ;1040850911;Taip;4;0;2;6
6752;Pasagėlė;GUDRUČIŲ;1215400980;Taip;1;0;1;2
6753;Pasagėlė;GUDRUČIŲ;1054424694;Taip;5;0;0;5
6754;Pasagėlė;GUDRUČIŲ;6011034443;Taip;0;0;6;6
6755;Pasagėlė;GUDRUČIŲ;3254801126;Taip;0;0;1;1
6756;Pasagėlė;GUDRUČIŲ;1511098546;Taip;0;3;0;3
6757;Pasagėlė;GUDRUČIŲ;54694832614;Taip;0;0;4;4
6758;Pasagėlė;GUDRUČIŲ;8428101374;Taip;4;0;2;6
6759;Pasagėlė;GUDRUČIŲ;60492768809;Taip;0;0;3;3
6760;Pasagėlė;GUDRUČIŲ;64636489181;Taip;0;0;1;1
6761;Pasagėlė;GUDRUČIŲ;69892632522;Taip;6;9;0;15
6762;Pasagėlė;GUDRUČIŲ;1600378710;Taip;0;0;2;2
6763;Pasagėlė;PABIRUČIŲ;1113026818;Taip;5;0;0;5
6764;Pasagėlė;PABIRUČIŲ;20999997254;Taip;0;4;0;4
6765;Pasagėlė;PABIRUČIŲ;9388057389;Taip;2;1;0;3
6766;Pasagėlė;PABIRUČIŲ;20743334216;Taip;6;0;0;6
6767;Pasagėlė;PABIRUČIŲ;1371753067;Taip;0;0;2;2
6768;Pasagėlė;PABIRUČIŲ;3405470634;Taip;4;0;0;4
6769;Pasagėlė;PABIRUČIŲ;55527703561;Taip;0;0;4;4
6770;Pasagėlė;PABIRUČIŲ;38355661182;Taip;1;0;1;2
6771;Pasagėlė;PABIRUČIŲ;3583848327;Taip;0;6;8;14
6772;Pasagėlė;PABIRUČIŲ;5040657332;Taip;0;5;0;5
6773;Pasagėlė;PABIRUČIŲ;3924127476;Taip;0;0;1;1
6774;Pasagėlė;PABIRUČIŲ;2769668641;Taip;5;0;1;6
6775;Pasagėlė;PABIRUČIŲ;4261133734;Taip;4;1;0;5
6776;Pasagėlė;PABIRUČIŲ;3576157355;Taip;6;0;12;18
6777;Pasagėlė;PABIRUČIŲ;6429160371;Taip;0;0;3;3
6778;Pasagėlė;PABIRUČIŲ;2717225575;Taip;0;0;2;2
6779;Pasaka;Drugelių;94297031036;Taip;0;1;3;4
6780;Pasaka;Drugelių;13636850029;Taip;0;0;1;1
6781;Pasaka;Drugelių;6029722606;Taip;5;1;1;7
6782;Pasaka;Drugelių;1182329854;Taip;0;7;0;7
6783;Pasaka;Drugelių;28436567147;Taip;0;1;4;5
6784;Pasaka;Drugelių;23870813014;Taip;5;1;0;6
6785;Pasaka;Drugelių;9176679994;Taip;5;0;0;5
6786;Pasaka;Drugelių;39078157321;Taip;0;2;0;2
6787;Pasaka;Drugelių;39551214597;Taip;0;0;1;1
6788;Pasaka;Drugelių;12737037014;Taip;10;0;0;10
6789;Pasaka;Drugelių;65838651894;Taip;0;1;0;1
6790;Pasaka;Drugelių;35974582480;Taip;6;0;0;6
6791;Pasaka;Drugelių;27093500070;Taip;14;0;0;14
6792;Pasaka;Drugelių;33026273567;Taip;0;1;5;6
6793;Pasaka;Drugelių;28874215183;Taip;6;0;0;6
6794;Pasaka;Drugelių;63580854012;Taip;5;1;2;8
6795;Pasaka;Nykštukų;71026394541;Taip;11;2;0;13
6796;Pasaka;Nykštukų;2063660647;Taip;6;1;0;7
6797;Pasaka;Nykštukų;18135410695;Taip;7;2;0;9
6798;Pasaka;Nykštukų;44488699090;Taip;4;2;1;7
6799;Pasaka;Nykštukų;1386420328;Taip;6;0;1;7
6800;Pasaka;Nykštukų;27770796692;Taip;11;0;0;11
6801;Pasaka;Nykštukų;5459272292;Taip;0;2;1;3
6802;Pasaka;Nykštukų;5665758011;Taip;0;3;2;5
6803;Pasaka;Nykštukų;8166051272;Taip;0;1;0;1
6804;Pasaka;Nykštukų;91546084785;Taip;0;2;5;7
6805;Pasaka;Nykštukų;7040953491;Taip;4;0;0;4
6806;Pasaka;Nykštukų;1333499160;Taip;7;1;0;8
6807;Pasaka;Nykštukų;66315088164;Taip;10;0;0;10
6808;Pasaka;Nykštukų;3088081091;Taip;1;1;0;2
6809;Pasaka;Nykštukų;6893044575;Taip;8;1;0;9
6810;Pasaka;Nykštukų;4071643754;Taip;9;0;0;9
6811;Pasaka;Montesori;52716349501;Taip;0;2;1;3
6812;Pasaka;Montesori;4130774501;Taip;0;0;2;2
6813;Pasaka;Montesori;93485300003;Taip;6;0;0;6
6814;Pasaka;Montesori;67492634520;Taip;5;0;1;6
6815;Pasaka;Montesori;65118883315;Taip;0;0;1;1
6816;Pasaka;Montesori;50242777961;Taip;1;1;0;2
6817;Pasaka;Montesori;88392698583;Taip;6;0;0;6
6818;Pasaka;Montesori;49914586879;Taip;2;0;0;2
6819;Pasaka;Montesori;47000824102;Taip;5;1;0;6
6820;Pasaka;Montesori;1450566193;Taip;2;0;0;2
6821;Pasaka;Montesori;79583667868;Taip;0;9;0;9
6822;Pasaka;Montesori;90472847444;Taip;4;2;0;6
6823;Pasaka;Montesori;17311912868;Taip;7;4;0;11
6824;Pasaka;Montesori;69250064506;Taip;0;0;5;5
6825;Pasaka;Montesori;81598865451;Taip;5;0;1;6
6826;Pasaka;Montesori;1564467627;Taip;0;0;2;2
6827;Pasaka;Montesori;7016077429;Taip;7;1;0;8
6828;Pasaka;Montesori;39319539842;Taip;5;0;1;6
6829;Pasaka;Montesori;16974081144;Taip;0;0;3;3
6830;Pasaka;Montesori;1514381003;Taip;0;1;1;2
6831;Pasaka;Montesori;93994995081;Taip;0;1;0;1
6832;Pasaka;Montesori;5812041166;Taip;0;0;2;2
6833;Pasaka;Montesori;4305485747;Taip;6;0;0;6
6834;Pasaka;Žirniukų;17931259433;Taip;5;0;0;5
6835;Pasaka;Žirniukų;9722435751;Taip;9;1;0;10
6836;Pasaka;Žirniukų;7648503006;Taip;3;0;5;8
6837;Pasaka;Žirniukų;2697014098;Taip;0;0;2;2
6838;Pasaka;Žirniukų;73703706115;Taip;5;0;3;8
6839;Pasaka;Žirniukų;2018620389;Taip;0;7;0;7
6840;Pasaka;Žirniukų;6441884677;Taip;5;1;0;6
6841;Pasaka;Žirniukų;5651452381;Taip;5;1;0;6
6842;Pasaka;Žirniukų;1720511696;Taip;6;0;0;6
6843;Pasaka;Žirniukų;1836826810;Taip;5;0;0;5
6844;Pasaka;Žirniukų;1826743229;Taip;0;5;0;5
6845;Pasaka;Žirniukų;9560190761;Taip;1;5;0;6
6846;Pasaka;Žirniukų;7286419663;Taip;2;0;0;2
6847;Pasaka;Žirniukų;2788679885;Taip;17;0;0;17
6848;Pasaka;Žirniukų;6378803142;Taip;11;0;0;11
6849;Pasaka;Žirniukų;7441310161;Taip;11;0;0;11
6850;Pasaka;Žirniukų;1565873178;Taip;0;0;3;3
6851;Pasaka;Žirniukų;7445696309;Taip;0;7;0;7
6852;Pasaka;Žirniukų;2400455036;Taip;0;0;1;1
6853;Pasaka;Žirniukų;79170702319;Taip;16;0;0;16
6854;Pasaka;"Voveriukų ";15051078156;Taip;0;1;0;1
6855;Pasaka;"Voveriukų ";50319234551;Taip;7;0;11;18
6856;Pasaka;"Voveriukų ";15500820772;Taip;6;0;1;7
6857;Pasaka;"Voveriukų ";89376142045;Taip;0;2;0;2
6858;Pasaka;"Voveriukų ";13944030346;Taip;0;1;0;1
6859;Pasaka;"Voveriukų ";52135673503;Taip;0;0;1;1
6860;Pasaka;"Voveriukų ";20358771509;Taip;0;1;3;4
6861;Pasaka;"Voveriukų ";94514447596;Taip;0;1;0;1
6862;Pasaka;"Voveriukų ";35718732394;Taip;3;1;0;4
6863;Pasaka;"Voveriukų ";71316589358;Taip;6;1;0;7
6864;Pasaka;"Voveriukų ";4344243194;Taip;0;1;0;1
6865;Pasaka;"Voveriukų ";8122815158;Taip;0;1;5;6
6866;Pasaka;"Voveriukų ";1719236931;Taip;4;0;0;4
6867;Pasaka;"Voveriukų ";1257775317;Taip;4;0;1;5
6868;Pasaka;"Voveriukų ";1268530885;Taip;0;6;2;8
6869;Pasaka;"VALDOFRO 12";2141354232;Taip;0;0;1;1
6870;Pasaka;"VALDOFRO 12";4271029223;Taip;0;0;3;3
6871;Pasaka;"VALDOFRO 12";75591036061;Taip;4;0;0;4
6872;Pasaka;"VALDOFRO 12";90604380611;Taip;0;0;2;2
6873;Pasaka;"VALDOFRO 12";8042135600;Taip;0;1;3;4
6874;Pasaka;"VALDOFRO 12";20521208273;Taip;0;0;2;2
6875;Pasaka;"VALDOFRO 12";73057603223;Taip;0;0;2;2
6876;Pasaka;"VALDOFRO 12";40698629247;Taip;7;0;2;9
6877;Pasaka;"VALDOFRO 12";72287065055;Ne;3;6;0;9
6878;Pasaka;"VALDOFRO 12";77282670444;Taip;0;1;0;1
6879;Pasaka;"VALDOFRO 12";22557231904;Taip;0;1;3;4
6880;Pasaka;"VALDOFRO 12";3367120837;Taip;7;0;2;9
6881;Pasaka;"VALDOFRO 12";7010681103;Taip;0;11;4;15
6882;Pasaka;"VALDOFRO 12";1155273197;Taip;0;12;4;16
6883;Pasaka;"VALDOFRO 12";56766427323;Taip;6;0;0;6
6884;Pasaka;"VALDOFRO 12";4680456848;Taip;0;1;1;2
6885;Pasaka;"VALDOFRO 12";5141156728;Taip;0;1;0;1
6886;Pasaka;"VALDORFO 2";34612155918;Taip;0;0;3;3
6887;Pasaka;"VALDORFO 2";48295303497;Taip;0;0;2;2
6888;Pasaka;"VALDORFO 2";1397972532;Taip;0;0;4;4
6889;Pasaka;"VALDORFO 2";27035873367;Taip;0;0;4;4
6890;Pasaka;"VALDORFO 2";27496232796;Taip;0;0;2;2
6891;Pasaka;"VALDORFO 2";95494862542;Taip;10;0;3;13
6892;Pasaka;"VALDORFO 2";25283698668;Taip;0;0;1;1
6893;Pasaka;"VALDORFO 2";42294285713;Taip;7;0;1;8
6894;Pasaka;"VALDORFO 2";50030735612;Taip;0;0;1;1
6895;Pasaka;"VALDORFO 2";80814715752;Taip;0;0;2;2
6896;Pasaka;"VALDORFO 2";61077353229;Taip;0;0;1;1
6897;Pasaka;"VALDORFO 2";2077818693;Taip;0;6;0;6
6898;Pasaka;"VALDORFO 2";71365777764;Taip;4;0;1;5
6899;Pasaka;"VALDORFO 2";1741935840;Taip;0;0;8;8
6900;Pasaka;"VALDORFO 2";77904202630;Taip;7;0;1;8
6901;Pasaka;"VALDORFO 2";4752117533;Taip;0;0;2;2
6902;Pasaka;"VALDORFO 2";7432241898;Taip;5;0;1;6
6903;Pasaka;"VALDORFO 2";10616073718;Taip;0;0;2;2
6904;Pasaka;"VALDORFO 2";8590385693;Taip;4;0;0;4
6905;Pasaka;Gudručiai;39815814046;Taip;2;0;0;2
6906;Pasaka;Gudručiai;92877021972;Taip;6;1;0;7
6907;Pasaka;Gudručiai;81610725511;Taip;5;1;2;8
6908;Pasaka;Gudručiai;48750144608;Taip;6;2;0;8
6909;Pasaka;Gudručiai;30111718221;Taip;0;0;4;4
6910;Pasaka;Gudručiai;1291936607;Taip;2;1;0;3
6911;Pasaka;Gudručiai;49342277188;Taip;0;8;0;8
6912;Pasaka;Gudručiai;79187482503;Taip;14;1;1;16
6913;Pasaka;Gudručiai;36316289275;Taip;0;0;2;2
6914;Pasaka;Gudručiai;55650091777;Taip;0;2;0;2
6915;Pasaka;Gudručiai;74752546806;Taip;0;0;5;5
6916;Pasaka;Gudručiai;21863319299;Taip;2;1;3;6
6917;Pasaka;Gudručiai;65228168263;Taip;0;0;2;2
6918;Pasaka;Gudručiai;91855873214;Taip;0;2;2;4
6919;Pasaka;Gudručiai;35413730712;Taip;2;2;1;5
6920;Pasaka;Gudručiai;19883430399;Taip;0;0;1;1
6921;Pasaka;Gudručiai;1117608861;Taip;8;0;0;8
6922;Pasaka;Gudručiai;78574165785;Taip;0;0;1;1
6923;Pasaka;Bitelių;76899232405;Taip;0;1;0;1
6924;Pasaka;Bitelių;8821776109;Taip;0;0;5;5
6925;Pasaka;Bitelių;45184972933;Taip;1;10;0;11
6926;Pasaka;Bitelių;76560015870;Taip;0;0;1;1
6927;Pasaka;Bitelių;78517147252;Taip;17;0;0;17
6928;Pasaka;Bitelių;55254934245;Taip;3;0;4;7
6929;Pasaka;Bitelių;96080851386;Taip;0;0;2;2
6930;Pasaka;Bitelių;62051806386;Taip;0;1;0;1
6931;Pasaka;Bitelių;80567536745;Taip;0;0;8;8
6932;Pasaka;Bitelių;53151161817;Taip;0;2;1;3
6933;Pasaka;Bitelių;17537343699;Taip;0;0;2;2
6934;Pasaka;Bitelių;72878659455;Taip;0;6;0;6
6935;Pasaka;Bitelių;91499940063;Taip;0;1;0;1
6936;Pasaka;"Pabiručių ";6868519179;Taip;0;0;5;5
6937;Pasaka;"Pabiručių ";6759415053;Taip;0;0;5;5
6938;Pasaka;"Pabiručių ";5351364328;Taip;14;0;0;14
6939;Pasaka;"Pabiručių ";4635912654;Taip;14;0;0;14
6940;Pasaka;"Pabiručių ";8132829016;Taip;9;0;4;13
6941;Pasaka;"Pabiručių ";8651165520;Taip;9;0;4;13
6942;Pasaka;"Pabiručių ";5371046207;Taip;15;0;1;16
6943;Pasaka;"Pabiručių ";4137222204;Taip;10;0;0;10
6944;Pasaka;"Pabiručių ";3047931231;Taip;11;0;0;11
6945;Pasaka;"Pabiručių ";7103485358;Taip;5;0;0;5
6946;Pasaka;"Pabiručių ";7248640367;Taip;12;0;2;14
6947;Pasaka;"Pabiručių ";8277245475;Taip;0;0;1;1
6948;Pasaka;"Pabiručių ";5723970763;Taip;21;0;0;21
6949;Pasaka;"Pabiručių ";9136521759;Taip;4;0;0;4
6950;Pasaka;"Pabiručių ";8119086492;Taip;18;0;1;19
6951;Pasaka;Šnekučių;31896116591;Taip;6;0;1;7
6952;Pasaka;Šnekučių;36716138833;Taip;6;0;2;8
6953;Pasaka;Šnekučių;49626651411;Taip;15;0;1;16
6954;Pasaka;Šnekučių;9549799936;Taip;12;0;0;12
6955;Pasaka;Šnekučių;34897359060;Taip;1;0;0;1
6956;Pasaka;Šnekučių;52912333520;Taip;0;3;2;5
6957;Pasaka;Šnekučių;8744626237;Taip;4;1;0;5
6958;Pasaka;Šnekučių;9973758979;Taip;0;0;1;1
6959;Pasaka;Šnekučių;1693530160;Taip;8;0;0;8
6960;Pasaka;Šnekučių;62303770229;Taip;0;5;2;7
6961;Pasaka;Šnekučių;23132755276;Taip;9;0;0;9
6962;Pasaka;Šnekučių;7082166681;Taip;3;3;0;6
6963;Pasaka;Šnekučių;8615661704;Taip;6;0;0;6
6964;Pasaka;Šnekučių;4178679491;Taip;6;0;0;6
6965;Pasaka;Šnekučių;56983167265;Taip;10;0;1;11
6966;Pasaka;Šnekučių;5021568651;Taip;11;0;0;11
6967;Pasaka;Šnekučių;50456063454;Taip;5;0;2;7
6968;Pasaka;Šnekučių;10055061537;Taip;10;0;6;16
6969;Pasaka;Šnekučių;51500606207;Taip;6;0;0;6
6970;Paslaptis;Priešmokyklinė;62476103195;Taip;0;14;0;14
6971;Paslaptis;Priešmokyklinė;8052295537;Taip;0;1;0;1
6972;Paslaptis;Priešmokyklinė;50274794824;Taip;15;0;0;15
6973;Paslaptis;Priešmokyklinė;26977991466;Taip;0;1;0;1
6974;Paslaptis;Priešmokyklinė;61247199871;Taip;0;0;1;1
6975;Paslaptis;Priešmokyklinė;16224875313;Taip;5;0;0;5
6976;Paslaptis;Priešmokyklinė;68726419200;Taip;0;1;1;2
6977;Paslaptis;Priešmokyklinė;60268283772;Taip;0;1;3;4
6978;Paslaptis;Priešmokyklinė;1828914082;Taip;11;3;1;15
6979;Paslaptis;Priešmokyklinė;1259942408;Taip;0;9;1;10
6980;Paslaptis;Priešmokyklinė;1667818122;Taip;0;7;0;7
6981;Paslaptis;Priešmokyklinė;1128775055;Taip;2;0;17;19
6982;Paslaptis;Priešmokyklinė;36229769543;Taip;10;1;0;11
6983;Paslaptis;Priešmokyklinė;87862241593;Taip;21;0;0;21
6984;Paslaptis;Priešmokyklinė;1677007836;Taip;0;1;0;1
6985;Paslaptis;Priešmokyklinė;1982955007;Ne;0;6;0;6
6986;Paslaptis;Priešmokyklinė;1273662366;Taip;4;0;0;4
6987;Paslaptis;Priešmokyklinė;99228588629;Taip;0;1;0;1
6988;Paslaptis;Priešmokyklinė;57773958059;Taip;0;7;0;7
6989;Paslaptis;Priešmokyklinė;73547132372;Taip;3;1;0;4
6990;Paslaptis;Priešmokyklinė;69704103686;Taip;15;1;0;16
6991;Paslaptis;Priešmokyklinė;18629473292;Taip;4;0;5;9
6992;Paslaptis;Priešmokyklinė;85698709368;Ne;1;1;0;2
6993;Paslaptis;Priešmokyklinė;96867169512;Taip;1;1;0;2
6994;Paslaptis;Priešmokyklinė;1445974659;Taip;0;1;0;1
6995;Paslaptis;Priešmokyklinė;2578713065;Ne;0;11;5;16
6996;Paslaptis;"Darželio mišraus amžiaus grupė";8522925854;Taip;6;6;0;12
6997;Paslaptis;"Darželio mišraus amžiaus grupė";1868248793;Taip;0;14;0;14
6998;Paslaptis;"Darželio mišraus amžiaus grupė";1950287365;Taip;13;0;4;17
6999;Paslaptis;"Darželio mišraus amžiaus grupė";1530380043;Taip;3;0;0;3
7000;Paslaptis;"Darželio mišraus amžiaus grupė";1938288335;Taip;3;0;0;3
7001;Paslaptis;"Darželio mišraus amžiaus grupė";1127602652;Taip;0;1;0;1
7002;Paslaptis;"Darželio mišraus amžiaus grupė";40283689721;Taip;7;4;0;11
7003;Paslaptis;"Darželio mišraus amžiaus grupė";4731417201;Taip;15;1;0;16
7004;Paslaptis;"Darželio mišraus amžiaus grupė";3461773781;Taip;21;0;0;21
7005;Paslaptis;"Darželio mišraus amžiaus grupė";5790420711;Taip;0;1;0;1
7006;Paslaptis;"Darželio mišraus amžiaus grupė";1195616749;Taip;0;1;2;3
7007;Paslaptis;"Darželio mišraus amžiaus grupė";4674623065;Taip;0;21;0;21
7008;Paslaptis;"Darželio mišraus amžiaus grupė";6375966771;Taip;0;2;0;2
7009;Paslaptis;"Darželio mišraus amžiaus grupė";2474900044;Taip;8;0;0;8
7010;Paslaptis;"Darželio mišraus amžiaus grupė";9559318660;Taip;11;0;0;11
7011;Paslaptis;"Darželio mišraus amžiaus grupė";2705751628;Taip;0;0;2;2
7012;Paslaptis;"Darželio mišraus amžiaus grupė";8280740387;Taip;14;0;3;17
7013;Paslaptis;"Darželio mišraus amžiaus grupė";2891547963;Taip;2;0;0;2
7014;Paslaptis;"Darželio mišraus amžiaus grupė";3415869190;Taip;1;1;0;2
7015;Paslaptis;"Darželio mišraus amžiaus grupė";1983773762;Taip;0;1;0;1
7016;Paslaptis;"Darželio mišraus amžiaus grupė";5557019619;Taip;0;1;2;3
7017;Paslaptis;"Darželio mišraus amžiaus grupė";1782398974;Taip;10;0;0;10
7018;Paslaptis;"Darželio mišraus amžiaus grupė";4109288950;Taip;6;0;0;6
7019;Paslaptis;"Darželio mišraus amžiaus grupė";8083478190;Taip;8;0;1;9
7020;Paslaptis;"Darželio mišraus amžiaus grupė";2089780119;Taip;0;12;0;12
7021;Paslaptis;"NAUJA (LOPŠELIS)";2879752620;Taip;0;0;3;3
7022;Paslaptis;"NAUJA (LOPŠELIS)";2693910134;Taip;0;6;0;6
7023;Paslaptis;"NAUJA (LOPŠELIS)";8239855620;Taip;6;0;0;6
7024;Paslaptis;"NAUJA (LOPŠELIS)";1033910097;Taip;3;0;2;5
7025;Paslaptis;"NAUJA (LOPŠELIS)";5206529350;Taip;14;0;0;14
7026;Paslaptis;"NAUJA (LOPŠELIS)";8895770223;Taip;6;0;0;6
7027;Paslaptis;"NAUJA (LOPŠELIS)";5756338103;Taip;14;1;0;15
7028;Paslaptis;"NAUJA (LOPŠELIS)";6131831325;Taip;15;1;1;17
7029;Paslaptis;"NAUJA (LOPŠELIS)";5886364670;Taip;12;0;0;12
7030;Paslaptis;"NAUJA (LOPŠELIS)";9941731250;Taip;2;0;0;2
7031;Paslaptis;"NAUJA (LOPŠELIS)";7579781779;Taip;12;0;0;12
7032;Paslaptis;"NAUJA (LOPŠELIS)";3844066232;Taip;0;2;0;2
7033;Paslaptis;"NAUJA (LOPŠELIS)";3243226933;Taip;0;0;1;1
7034;Paslaptis;"NAUJA (LOPŠELIS)";3104525540;Taip;16;0;0;16
7035;Paslaptis;"NAUJA (LOPŠELIS)";8146824196;Taip;10;0;0;10
7036;Paslaptis;"NAUJA (LOPŠELIS)";3398729758;Taip;11;0;0;11
7037;Paslaptis;"NAUJA (LOPŠELIS)";2675089401;Taip;1;0;0;1
7038;Pasakaitė;Vieversėlių;70802215290;Taip;0;13;0;13
7039;Pasakaitė;Vieversėlių;82272856075;Taip;0;1;0;1
7040;Pasakaitė;Vieversėlių;23103636206;Taip;4;8;0;12
7041;Pasakaitė;Vieversėlių;48421643700;Taip;0;3;0;3
7042;Pasakaitė;Vieversėlių;94906317709;Taip;0;2;0;2
7043;Pasakaitė;Vieversėlių;41359431347;Taip;1;0;0;1
7044;Pasakaitė;Vieversėlių;725988513;Taip;0;2;0;2
7045;Pasakaitė;Vieversėlių;62372417041;Taip;0;0;3;3
7046;Pasakaitė;Vieversėlių;91751201397;Taip;5;0;1;6
7047;Pasakaitė;Vieversėlių;6909280007;Taip;5;0;0;5
7048;Pasakaitė;Vieversėlių;1631919806;Taip;11;0;1;12
7049;Pasakaitė;Vieversėlių;1696228992;Taip;11;0;1;12
7050;Pasakaitė;Vieversėlių;47661428412;Taip;0;12;0;12
7051;Pasakaitė;Vieversėlių;18419655194;Taip;0;3;1;4
7052;Pasakaitė;Vieversėlių;91109909258;Taip;1;8;0;9
7053;Pasakaitė;Vieversėlių;1917342472;Ne;10;0;0;10
7054;Pasakaitė;Vieversėlių;39926553926;Taip;0;8;0;8
7055;Pasakaitė;Vieversėlių;1139554564;Taip;11;8;0;19
7056;Pasakaitė;Spindulėlių;52127092749;Taip;0;1;1;2
7057;Pasakaitė;Spindulėlių;72232008007;Taip;2;0;0;2
7058;Pasakaitė;Spindulėlių;58071607976;Taip;0;1;0;1
7059;Pasakaitė;Spindulėlių;20667371334;Taip;0;20;0;20
7060;Pasakaitė;Spindulėlių;21284070194;Taip;0;1;0;1
7061;Pasakaitė;Spindulėlių;15644259897;Taip;0;1;0;1
7062;Pasakaitė;Spindulėlių;88951595986;Ne;5;1;0;6
7063;Pasakaitė;Spindulėlių;45451715428;Taip;11;1;0;12
7064;Pasakaitė;Spindulėlių;1381307997;Taip;9;9;0;18
7065;Pasakaitė;Spindulėlių;75361056418;Taip;4;0;0;4
7066;Pasakaitė;Spindulėlių;4680949976;Taip;5;7;0;12
7067;Pasakaitė;Spindulėlių;3734935229;Taip;8;0;2;10
7068;Pasakaitė;Spindulėlių;2523842161;Taip;11;0;0;11
7069;Pasakaitė;Spindulėlių;4267488049;Taip;0;11;0;11
7070;Pasakaitė;Spindulėlių;1523034176;Taip;5;1;0;6
7071;Pasakaitė;Spindulėlių;7152349570;Taip;0;17;0;17
7072;Pasakaitė;Pasagėlių;3165658822;Taip;10;7;0;17
7073;Pasakaitė;Pasagėlių;61230317080;Taip;0;2;0;2
7074;Pasakaitė;Pasagėlių;1740419218;Taip;11;8;0;19
7075;Pasakaitė;Pasagėlių;5378855541;Taip;0;5;2;7
7076;Pasakaitė;Pasagėlių;8466086339;Taip;13;0;0;13
7077;Pasakaitė;Pasagėlių;1019010454;Taip;15;1;0;16
7078;Pasakaitė;Pasagėlių;4959175420;Taip;0;2;0;2
7079;Pasakaitė;Pasagėlių;3259688782;Taip;3;0;0;3
7080;Pasakaitė;Pasagėlių;1144813356;Taip;5;5;0;10
7081;Pasakaitė;Pasagėlių;83018133588;Taip;0;0;3;3
7082;Pasakaitė;Pasagėlių;4013900094;Taip;4;0;0;4
7083;Pasakaitė;Pasagėlių;5605619860;Taip;0;0;5;5
7084;Pasakaitė;Pasagėlių;1791015854;Taip;6;0;0;6
7085;Pasakaitė;Pasagėlių;39853246609;Taip;13;0;0;13
7086;Pasakaitė;Pasagėlių;4591161640;Ne;0;0;5;5
7087;Pasakaitė;Pasagėlių;1707428977;Taip;12;1;0;13
7088;Pasakaitė;Pasagėlių;5467179333;Taip;8;8;0;16
7089;Pasakaitė;Švyturėlių;26826144324;Taip;0;1;0;1
7090;Pasakaitė;Švyturėlių;26485770641;Taip;6;0;0;6
7091;Pasakaitė;Švyturėlių;30460033968;Taip;0;1;0;1
7092;Pasakaitė;Švyturėlių;39762990812;Taip;5;0;7;12
7093;Pasakaitė;Švyturėlių;24235494284;Taip;6;0;3;9
7094;Pasakaitė;Švyturėlių;74338375162;Taip;0;1;0;1
7095;Pasakaitė;Švyturėlių;83737263199;Taip;0;0;1;1
7096;Pasakaitė;Švyturėlių;56474981516;Taip;0;0;5;5
7097;Pasakaitė;Švyturėlių;24096031951;Taip;0;1;1;2
7098;Pasakaitė;Švyturėlių;11001677712;Taip;4;0;8;12
7099;Pasakaitė;Švyturėlių;9914689534;Taip;14;0;0;14
7100;Pasakaitė;Švyturėlių;88077831193;Taip;4;0;0;4
7101;Pasakaitė;Švyturėlių;8225188274;Taip;6;0;0;6
7102;Pasakaitė;Švyturėlių;73957497029;Taip;6;0;0;6
7103;Pasakaitė;Švyturėlių;1070409611;Taip;3;1;2;6
7104;Pasakaitė;Švyturėlių;1159523006;Taip;10;0;0;10
7105;Pasakaitė;Švyturėlių;5436985035;Taip;0;10;0;10
7106;Pasakaitė;Švyturėlių;1627102470;Taip;0;0;3;3
7107;Pasakaitė;Švyturėlių;4008826950;Taip;10;6;1;17
7108;Pasakaitė;Švyturėlių;32235101944;Taip;4;2;0;6
7109;Pasakaitė;Kodėlčiukų;94317654094;Taip;0;1;2;3
7110;Pasakaitė;Kodėlčiukų;1121139222;Ne;0;0;5;5
7111;Pasakaitė;Kodėlčiukų;2017823264;Taip;6;0;0;6
7112;Pasakaitė;Kodėlčiukų;72093762601;Taip;0;0;2;2
7113;Pasakaitė;Kodėlčiukų;11006810461;Taip;1;5;0;6
7114;Pasakaitė;Kodėlčiukų;1553678838;Taip;15;0;0;15
7115;Pasakaitė;Kodėlčiukų;1854100959;Taip;0;1;6;7
7116;Pasakaitė;Kodėlčiukų;22071058323;Taip;16;5;0;21
7117;Pasakaitė;Kodėlčiukų;93907096625;Taip;8;0;1;9
7118;Pasakaitė;Kodėlčiukų;9746401498;Ne;11;0;0;11
7119;Pasakaitė;Kodėlčiukų;6839399035;Taip;7;0;5;12
7120;Pasakaitė;Kodėlčiukų;99352468512;Taip;4;2;0;6
7121;Pasakaitė;Kodėlčiukų;1809383469;Taip;4;4;0;8
7122;Pasakaitė;Kodėlčiukų;2742595829;Taip;7;0;7;14
7123;Pasakaitė;Kodėlčiukų;1592521766;Taip;0;0;5;5
7124;Pasakaitė;Kodėlčiukų;6983619733;Taip;11;0;0;11
7125;Pasakaitė;Kodėlčiukų;5313360864;Taip;6;0;1;7
7126;Pasakaitė;Kodėlčiukų;9506178305;Taip;16;0;0;16
7127;Pasakaitė;Gudručių;85389647155;Taip;0;6;0;6
7128;Pasakaitė;Gudručių;89807086522;Taip;0;2;2;4
7129;Pasakaitė;Gudručių;25228014112;Taip;21;0;0;21
7130;Pasakaitė;Gudručių;61088864114;Taip;0;0;6;6
7131;Pasakaitė;Gudručių;31076632547;Taip;0;2;0;2
7132;Pasakaitė;Gudručių;1175881877;Taip;11;1;1;13
7133;Pasakaitė;Gudručių;96876687235;Taip;0;1;3;4
7134;Pasakaitė;Gudručių;76810884215;Taip;0;1;1;2
7135;Pasakaitė;Gudručių;89036969556;Taip;0;0;1;1
7136;Pasakaitė;Gudručių;44876121501;Taip;12;1;1;14
7137;Pasakaitė;Gudručių;68762624079;Taip;0;1;7;8
7138;Pasakaitė;Gudručių;36916241082;Ne;0;1;1;2
7139;Pasakaitė;Gudručių;62505201993;Taip;0;1;1;2
7140;Pasakaitė;Gudručių;64811535115;Taip;10;1;1;12
7141;Pasakaitė;Gudručių;13548717757;Taip;14;1;1;16
7142;Pasakaitė;Gudručių;38485750316;Taip;0;1;0;1
7143;Pasakaitė;Gudručių;80929303402;Taip;0;1;0;1
7144;Pasakaitė;Gudručių;31971771240;Taip;0;4;1;5
7145;Pasakaitė;Gudručių;81509638417;Ne;0;1;7;8
7146;Pasakaitė;Gudručių;2031899743;Taip;0;1;1;2
7147;Pasakaitė;Čiulbonėlių;18107086294;Taip;0;9;0;9
7148;Pasakaitė;Čiulbonėlių;5414310905;Taip;0;0;7;7
7149;Pasakaitė;Čiulbonėlių;81406378986;Taip;4;0;1;5
7150;Pasakaitė;Čiulbonėlių;61216378563;Taip;0;1;6;7
7151;Pasakaitė;Čiulbonėlių;52612577074;Taip;20;1;0;21
7152;Pasakaitė;Čiulbonėlių;55594674308;Taip;0;1;0;1
7153;Pasakaitė;Čiulbonėlių;6035279095;Taip;0;1;0;1
7154;Pasakaitė;Čiulbonėlių;1304294521;Taip;4;5;0;9
7155;Pasakaitė;Čiulbonėlių;1827896757;Taip;2;1;0;3
7156;Pasakaitė;Čiulbonėlių;61297377425;Ne;0;20;0;20
7157;Pasakaitė;Čiulbonėlių;20868624857;Taip;0;1;10;11
7158;Pasakaitė;Čiulbonėlių;55779894463;Taip;0;0;3;3
7159;Pasakaitė;Čiulbonėlių;90096913388;Taip;0;8;0;8
7160;Pasakaitė;Čiulbonėlių;26218072375;Taip;0;1;0;1
7161;Pasakaitė;Čiulbonėlių;98801528286;Taip;6;0;0;6
7162;Pasakaitė;Čiulbonėlių;52200664190;Taip;0;1;15;16
7163;Pasakaitė;Čiulbonėlių;1135448504;Taip;0;0;11;11
7164;Pasakaitė;Čiulbonėlių;1801321757;Taip;0;1;1;2
7165;Pasakaitė;"Verpstelių ";12092268542;Taip;0;5;0;5
7166;Pasakaitė;"Verpstelių ";62677241195;Taip;0;1;0;1
7167;Pasakaitė;"Verpstelių ";600641021;Taip;0;9;0;9
7168;Pasakaitė;"Verpstelių ";26031226748;Taip;2;1;1;4
7169;Pasakaitė;"Verpstelių ";1407277414;Taip;0;0;1;1
7170;Pasakaitė;"Verpstelių ";17218793370;Taip;1;8;0;9
7171;Pasakaitė;"Verpstelių ";33418184802;Taip;0;0;1;1
7172;Pasakaitė;"Verpstelių ";46873849992;Taip;0;8;0;8
7173;Pasakaitė;"Verpstelių ";96648719544;Taip;0;8;0;8
7174;Pasakaitė;"Verpstelių ";82475369612;Taip;3;3;0;6
7175;Pasakaitė;"Verpstelių ";51040024089;Taip;6;0;0;6
7176;Pasakaitė;"Verpstelių ";88885227604;Taip;0;7;0;7
7177;Pasakaitė;"Verpstelių ";5954676615;Taip;0;0;4;4
7178;Pasakaitė;"Verpstelių ";1270179754;Taip;0;0;1;1
7179;Pasakaitė;"Verpstelių ";2210519019;Taip;6;0;0;6
7180;Pasakaitė;"Verpstelių ";18105216772;Taip;5;1;0;6
7181;Pasakaitė;"Verpstelių ";50537059387;Taip;15;0;0;15
7182;Pasakaitė;"Verpstelių ";29699532850;Taip;0;13;0;13
7183;Pasakaitė;"Verpstelių ";46074425530;Taip;3;0;0;3
7184;Pasakaitė;"Verpstelių ";45157801238;Taip;5;0;1;6
7185;Pasakaitė;Smalsučiai;7685647972;Taip;8;1;0;9
7186;Pasakaitė;Smalsučiai;7963057831;Taip;0;0;1;1
7187;Pasakaitė;Smalsučiai;7020773169;Taip;14;0;6;20
7188;Pasakaitė;Smalsučiai;5948958906;Taip;5;0;0;5
7189;Pasakaitė;Smalsučiai;3231283338;Taip;10;0;0;10
7190;Pasakaitė;Smalsučiai;5455278072;Taip;13;0;0;13
7191;Pasakaitė;Smalsučiai;9543991684;Taip;14;3;0;17
7192;Pasakaitė;Smalsučiai;3778906698;Taip;0;6;0;6
7193;Pasakaitė;Smalsučiai;3541877287;Taip;11;0;0;11
7194;Pasakaitė;Smalsučiai;3680596008;Taip;13;0;0;13
7195;Pasakaitė;Smalsučiai;5628746801;Taip;0;0;3;3
7196;Pasakaitė;Smalsučiai;4882856664;Taip;0;5;4;9
7197;Pasakaitė;Smalsučiai;8315840473;Taip;9;1;0;10
7198;Pasakaitė;Smalsučiai;5953162958;Taip;5;0;0;5
7199;Pasakaitė;Smalsučiai;3579498202;Taip;0;2;1;3
7200;Pasakaitė;Smalsučiai;1060914693;Taip;10;1;0;11
7201;Pasakaitė;"Čiauškučiai ";3606601644;Taip;9;1;0;10
7202;Pasakaitė;"Čiauškučiai ";6714500298;Taip;0;12;0;12
7203;Pasakaitė;"Čiauškučiai ";8578521969;Taip;16;0;0;16
7204;Pasakaitė;"Čiauškučiai ";7526264241;Taip;12;0;0;12
7205;Pasakaitė;"Čiauškučiai ";9166649594;Taip;8;5;1;14
7206;Pasakaitė;"Čiauškučiai ";8390366303;Taip;12;0;0;12
7207;Pasakaitė;"Čiauškučiai ";8463220257;Taip;8;0;0;8
7208;Pasakaitė;"Čiauškučiai ";7761162338;Taip;10;0;0;10
7209;Pasakaitė;"Čiauškučiai ";8223662339;Taip;21;0;0;21
7210;Pasakaitė;"Čiauškučiai ";9018830962;Taip;14;0;0;14
7211;Pasakaitė;"Čiauškučiai ";7790937149;Taip;13;0;0;13
7212;Pasakaitė;"Čiauškučiai ";3400305768;Taip;5;0;0;5
7213;Pasakaitė;"Čiauškučiai ";8469043564;Taip;12;0;1;13
7214;Pasakaitė;Pabiručiai;1827070201;Taip;17;0;0;17
7215;Pasakaitė;Pabiručiai;1879865535;Taip;11;0;0;11
7216;Pasakaitė;Pabiručiai;9175612991;Taip;14;0;1;15
7217;Pasakaitė;Pabiručiai;26714845001;Taip;15;0;0;15
7218;Pasakaitė;Pabiručiai;46891856500;Taip;8;2;0;10
7219;Pasakaitė;Pabiručiai;3397132786;Taip;10;5;0;15
7220;Pasakaitė;Pabiručiai;1769070351;Taip;0;3;0;3
7221;Pasakaitė;Pabiručiai;49117693773;Taip;0;1;0;1
7222;Pasakaitė;Pabiručiai;1320898756;Taip;10;0;5;15
7223;Pasakaitė;Pabiručiai;1027136050;Taip;6;0;0;6
7224;Pasakaitė;Pabiručiai;1198248619;Taip;0;6;0;6
7225;Pasakaitė;Pabiručiai;1595057434;Taip;18;0;0;18
7226;Pasakaitė;Pabiručiai;1032113089;Taip;0;6;0;6
7227;Pasakaitė;Pabiručiai;21252086256;Taip;5;0;0;5
7228;Pasakaitė;Pabiručiai;6134483994;Taip;6;5;0;11
7229;Pasakaitė;Pabiručiai;1673576868;Taip;9;6;0;15
7230;Pasakaitė;Pabiručiai;2017275984;Taip;2;0;0;2
7231;Pasakaitė;Pabiručiai;27702516199;Taip;1;0;4;5
7232;Pasakaitė;Pabiručiai;6346678827;Ne;0;0;11;11
7233;Pelenė;Varpelis;69242277342;Taip;0;1;0;1
7234;Pelenė;Varpelis;59921559091;Taip;0;0;2;2
7235;Pelenė;Varpelis;54232015265;Taip;0;0;1;1
7236;Pelenė;Varpelis;62426432001;Taip;13;0;0;13
7237;Pelenė;Varpelis;2029929226;Taip;0;1;0;1
7238;Pelenė;Varpelis;8311474428;Taip;6;2;0;8
7239;Pelenė;Varpelis;8189960936;Taip;9;0;1;10
7240;Pelenė;Varpelis;62172213063;Taip;0;6;0;6
7241;Pelenė;Varpelis;93009343319;Taip;0;0;2;2
7242;Pelenė;Varpelis;72752022712;Taip;0;21;0;21
7243;Pelenė;Varpelis;22762248459;Taip;9;0;3;12
7244;Pelenė;Varpelis;70438374608;Taip;0;6;0;6
7245;Pelenė;Varpelis;17746532458;Taip;4;0;0;4
7246;Pelenė;Varpelis;6533433685;Taip;11;10;0;21
7247;Pelenė;Varpelis;59795549508;Taip;0;2;0;2
7248;Pelenė;Varpelis;1072148409;Taip;0;0;6;6
7249;Pelenė;Varpelis;83359560510;Taip;0;10;0;10
7250;Pelenė;Saulutės;59732999282;Taip;14;0;0;14
7251;Pelenė;Saulutės;99849461351;Taip;0;4;0;4
7252;Pelenė;Saulutės;4233272418;Taip;0;4;0;4
7253;Pelenė;Saulutės;93982153559;Taip;0;0;2;2
7254;Pelenė;Saulutės;55808304356;Taip;0;0;2;2
7255;Pelenė;Saulutės;93692312117;Taip;5;0;1;6
7256;Pelenė;Saulutės;1321060587;Taip;6;0;1;7
7257;Pelenė;Saulutės;11671895181;Taip;0;1;0;1
7258;Pelenė;Saulutės;24547508796;Ne;9;5;0;14
7259;Pelenė;Saulutės;91433727359;Taip;0;3;0;3
7260;Pelenė;Saulutės;72216942887;Taip;0;6;0;6
7261;Pelenė;Saulutės;96121315210;Taip;0;0;3;3
7262;Pelenė;Saulutės;78085706850;Taip;0;0;1;1
7263;Pelenė;Saulutės;11924441656;Taip;0;9;0;9
7264;Pelenė;Saulutės;15949989455;Ne;0;9;0;9
7265;Pelenė;Saulutės;53044546376;Taip;10;0;0;10
7266;Pelenė;Saulutės;98221995571;Taip;0;0;1;1
7267;Pelenė;Saulutės;2115021063;Taip;7;0;0;7
7268;Pelenė;Raktelis;85051053863;Taip;0;0;13;13
7269;Pelenė;Raktelis;1356029457;Taip;16;0;3;19
7270;Pelenė;Raktelis;32577488307;Taip;0;5;2;7
7271;Pelenė;Raktelis;3245982902;Taip;2;0;2;4
7272;Pelenė;Raktelis;25108428891;Taip;16;0;0;16
7273;Pelenė;Raktelis;32716320977;Taip;0;2;0;2
7274;Pelenė;Raktelis;29587640966;Taip;0;5;0;5
7275;Pelenė;Raktelis;55350714718;Taip;0;0;2;2
7276;Pelenė;Raktelis;30625065081;Taip;5;0;0;5
7277;Pelenė;Raktelis;33408520827;Taip;8;0;1;9
7278;Pelenė;Raktelis;62615483649;Taip;10;0;0;10
7279;Pelenė;Raktelis;87207607315;Taip;0;0;3;3
7280;Pelenė;Raktelis;70335326964;Taip;0;3;0;3
7281;Pelenė;Raktelis;1045206373;Taip;0;0;1;1
7282;Pelenė;Raktelis;120966603;Taip;14;6;0;20
7283;Pelenė;Raktelis;534670514;Taip;0;1;0;1
7284;Pelenė;Žvaigždutės;55160554683;Taip;10;0;0;10
7285;Pelenė;Žvaigždutės;33028103211;Taip;5;0;2;7
7286;Pelenė;Žvaigždutės;45687410331;Taip;0;6;0;6
7287;Pelenė;Žvaigždutės;8483195434;Taip;5;5;0;10
7288;Pelenė;Žvaigždutės;66474157416;Taip;0;6;0;6
7289;Pelenė;Žvaigždutės;1793514226;Taip;0;14;0;14
7290;Pelenė;Žvaigždutės;55747365118;Taip;0;0;2;2
7291;Pelenė;Žvaigždutės;77504082241;Taip;0;8;0;8
7292;Pelenė;Žvaigždutės;93234992958;Taip;0;0;8;8
7293;Pelenė;Žvaigždutės;2393068606;Taip;0;0;1;1
7294;Pelenė;Žvaigždutės;62544766703;Taip;0;5;0;5
7295;Pelenė;Žvaigždutės;14791621417;Taip;6;0;2;8
7296;Pelenė;Žvaigždutės;43686344645;Ne;0;5;0;5
7297;Pelenė;Žvaigždutės;39850314417;Taip;2;0;2;4
7298;Pelenė;Žvaigždutės;71274664713;Taip;0;8;0;8
7299;Pelenė;Žvaigždutės;1542958753;Taip;9;0;3;12
7300;Pelenė;Žvaigždutės;1846536895;Taip;0;14;0;14
7301;Pelenė;Žvaigždutės;1516249890;Taip;0;5;0;5
7302;Pelenė;Žvaigždutės;2147596414;Taip;8;0;0;8
7303;Pelenė;Žvaigždutės;1908166570;Taip;0;0;1;1
7304;Pelenė;Žvaigždutės;1157718969;Taip;0;0;1;1
7305;Pelenė;Žvaigždutės;1599336930;Taip;1;0;0;1
7306;Pelenė;Nykštukas;35657264407;Ne;3;0;0;3
7307;Pelenė;Nykštukas;3299454566;Taip;0;0;1;1
7308;Pelenė;Nykštukas;1931857547;Taip;0;0;1;1
7309;Pelenė;Nykštukas;3465518545;Taip;4;0;3;7
7310;Pelenė;Nykštukas;4386060612;Ne;0;0;14;14
7311;Pelenė;Nykštukas;1418000665;Taip;0;0;5;5
7312;Pelenė;Nykštukas;1038583766;Taip;6;0;0;6
7313;Pelenė;Nykštukas;1127657620;Taip;0;1;0;1
7314;Pelenė;Nykštukas;42431378466;Taip;0;3;0;3
7315;Pelenė;Nykštukas;1183026351;Taip;0;0;1;1
7316;Pelenė;Nykštukas;2072863178;Taip;8;0;0;8
7317;Pelenė;Nykštukas;1050272821;Taip;0;5;0;5
7318;Pelenė;Nykštukas;45589326259;Ne;0;0;2;2
7319;Pelenė;Nykštukas;26010775076;Taip;0;4;0;4
7320;Pelenė;Nykštukas;51979406888;Taip;9;0;1;10
7321;Pelenė;Nykštukas;14200374671;Taip;11;0;0;11
7322;Pelenė;Nykštukas;89920419797;Taip;5;1;0;6
7323;Pelenė;Žirniukai;52690820;Taip;0;0;1;1
7324;Pelenė;Žirniukai;43987538343;Taip;10;0;0;10
7325;Pelenė;Žirniukai;1710249888;Taip;0;2;0;2
7326;Pelenė;Žirniukai;78648474464;Taip;1;0;4;5
7327;Pelenė;Žirniukai;86063417321;Taip;5;0;0;5
7328;Pelenė;Žirniukai;61012202440;Taip;0;4;0;4
7329;Pelenė;Žirniukai;4178071578;Taip;0;1;0;1
7330;Pelenė;Žirniukai;45410683361;Taip;14;0;0;14
7331;Pelenė;Žirniukai;34765342495;Taip;0;8;0;8
7332;Pelenė;Žirniukai;5804848640;Taip;0;0;1;1
7333;Pelenė;Žirniukai;8813044848;Taip;0;0;5;5
7334;Pelenė;Žirniukai;1807037374;Taip;1;0;4;5
7335;Pelenė;Žirniukai;6559830470;Taip;0;0;2;2
7336;Pelenė;Žirniukai;62484999314;Taip;6;0;4;10
7337;Pelenė;Žirniukai;1289416312;Taip;0;10;0;10
7338;Pelenė;Žirniukai;1774912517;Taip;9;0;0;9
7339;Pelenė;Lašeliai;1483843416;Taip;0;17;0;17
7340;Pelenė;Lašeliai;2677995903;Taip;1;5;0;6
7341;Pelenė;Lašeliai;6579504852;Taip;0;0;5;5
7342;Pelenė;Lašeliai;6181604926;Taip;0;0;4;4
7343;Pelenė;Lašeliai;2092775878;Taip;3;8;0;11
7344;Pelenė;Lašeliai;10457480694;Taip;7;0;0;7
7345;Pelenė;Lašeliai;9584503078;Taip;3;0;0;3
7346;Pelenė;Lašeliai;7589978427;Taip;7;0;0;7
7347;Pelenė;Lašeliai;8721423900;Taip;0;13;0;13
7348;Pelenė;Lašeliai;3189305906;Taip;7;0;0;7
7349;Pelenė;Lašeliai;8607110629;Taip;1;8;0;9
7350;Pelenė;Lašeliai;7144616734;Taip;7;0;0;7
7351;Pelenė;Lašeliai;1750366978;Taip;5;0;1;6
7352;Pelenė;Lašeliai;8675348688;Taip;0;0;1;1
7353;Pelenė;Lašeliai;1217505164;Taip;0;0;1;1
7354;Pelenė;Lašeliai;7836778389;Taip;4;0;1;5
7355;Pelenė;Lašeliai;1978481168;Taip;6;0;0;6
7356;Pelenė;Lašeliai;7254981715;Ne;0;4;0;4
7357;Pelenė;Lašeliai;6021833025;Taip;0;7;0;7
7358;Pelenė;Lašeliai;7469266085;Taip;7;12;0;19
7359;Pelenė;Lašeliai;3296147024;Taip;0;8;0;8
7360;Pelenė;Grūdelis;88349051367;Taip;0;1;0;1
7361;Pelenė;Grūdelis;38804968295;Taip;6;0;0;6
7362;Pelenė;Grūdelis;83979485459;Taip;5;0;0;5
7363;Pelenė;Grūdelis;27608464415;Ne;7;0;0;7
7364;Pelenė;Grūdelis;60203121022;Taip;1;0;0;1
7365;Pelenė;Grūdelis;8945972016;Taip;0;1;0;1
7366;Pelenė;Grūdelis;52681956071;Taip;5;0;0;5
7367;Pelenė;Grūdelis;45985345611;Taip;4;0;2;6
7368;Pelenė;Grūdelis;23859597260;Taip;7;0;0;7
7369;Pelenė;Grūdelis;28035546865;Taip;1;0;0;1
7370;Pelenė;Grūdelis;21224601178;Taip;0;10;0;10
7371;Pelenė;Grūdelis;67249286878;Taip;0;14;0;14
7372;Pelenė;Grūdelis;34209230034;Taip;1;0;0;1
7373;Pelenė;Grūdelis;82762950191;Taip;1;0;0;1
7374;Pelenė;Braškytė;5325176433;Taip;5;4;0;9
7375;Pelenė;Braškytė;7205437280;Taip;5;0;0;5
7376;Pelenė;Braškytė;9009271610;Taip;0;8;0;8
7377;Pelenė;Braškytė;8916634408;Taip;0;0;1;1
7378;Pelenė;Braškytė;4546285993;Taip;1;20;0;21
7379;Pelenė;Braškytė;3238807604;Taip;0;1;1;2
7380;Pelenė;Braškytė;1902314385;Taip;0;0;1;1
7381;Pelenė;Braškytė;5780697554;Taip;7;0;2;9
7382;Pelenė;Braškytė;6707167720;Taip;5;0;0;5
7383;Pelenė;Braškytė;5389865440;Taip;5;0;0;5
7384;Pelenė;Braškytė;8466974910;Taip;0;0;1;1
7385;Pelenė;Braškytė;7880284433;Taip;6;0;4;10
7386;Pelenė;Braškytė;9621197758;Taip;8;5;0;13
7387;Pelenė;Braškytė;9195113444;Taip;3;2;0;5
7388;Pelenė;Braškytė;4541391191;Taip;5;0;5;10
7389;Pelenė;Braškytė;6375060159;Taip;0;12;0;12
7390;Pelenė;Braškytė;9218868317;Taip;0;8;0;8
7391;Pelenė;Boružėlės;4624325473;Taip;0;2;1;3
7392;Pelenė;Boružėlės;1336431888;Taip;0;1;0;1
7393;Pelenė;Boružėlės;1114786936;Taip;0;0;2;2
7394;Pelenė;Boružėlės;8404317146;Taip;5;0;0;5
7395;Pelenė;Boružėlės;1140030742;Taip;5;4;0;9
7396;Pelenė;Boružėlės;3497915398;Taip;0;4;0;4
7397;Pelenė;Boružėlės;2154553741;Taip;0;4;0;4
7398;Pelenė;Boružėlės;8598498275;Taip;0;21;0;21
7399;Pelenė;Boružėlės;39705461573;Taip;6;0;9;15
7400;Pelenė;Boružėlės;3131930907;Taip;16;0;0;16
7401;Pelenė;Boružėlės;7172604045;Taip;0;0;1;1
7402;Pelenė;Boružėlės;1067737206;Taip;5;5;0;10
7403;Pelenė;Boružėlės;1775717256;Taip;3;0;4;7
7404;Pelenė;Boružėlės;7587887488;Taip;0;6;0;6
7405;Pelenė;Boružėlės;3419051414;Taip;0;0;3;3
7406;Pelenė;Boružėlės;6632188229;Taip;11;6;0;17
7407;Pelenė;Boružėlės;8716395810;Taip;0;1;0;1
7408;Pelenė;Saldainiukai;2737277656;Taip;10;1;0;11
7409;Pelenė;Saldainiukai;7164790060;Taip;1;0;0;1
7410;Pelenė;Saldainiukai;2647876561;Taip;5;0;0;5
7411;Pelenė;Saldainiukai;8194354176;Taip;5;0;0;5
7412;Pelenė;Saldainiukai;2322908067;Taip;10;6;0;16
7413;Pelenė;Saldainiukai;8239650471;Taip;21;0;0;21
7414;Pelenė;Saldainiukai;3174009848;Taip;15;0;0;15
7415;Pelenė;Saldainiukai;6524101295;Taip;11;0;1;12
7416;Pelenė;Saldainiukai;4376033711;Taip;10;0;0;10
7417;Pelenė;Saldainiukai;6894978459;Taip;0;6;0;6
7418;Pelenė;Saldainiukai;2103177773;Taip;12;0;0;12
7419;Pelenė;Saldainiukai;4321705575;Taip;1;6;0;7
7420;Pelenė;Saldainiukai;6481466282;Taip;6;0;0;6
7421;Pipiras;EŽIUKAI;12489971559;Taip;0;3;0;3
7422;Pipiras;EŽIUKAI;56241147614;Taip;13;0;0;13
7423;Pipiras;EŽIUKAI;1112327896;Taip;9;2;0;11
7424;Pipiras;EŽIUKAI;24106575180;Taip;14;1;0;15
7425;Pipiras;EŽIUKAI;52968399382;Taip;0;2;0;2
7426;Pipiras;EŽIUKAI;38894447952;Taip;5;3;0;8
7427;Pipiras;EŽIUKAI;24414917430;Taip;0;8;0;8
7428;Pipiras;EŽIUKAI;71881026465;Taip;0;2;0;2
7429;Pipiras;EŽIUKAI;32958963027;Taip;0;2;0;2
7430;Pipiras;EŽIUKAI;95904922548;Taip;5;11;0;16
7431;Pipiras;EŽIUKAI;55466909230;Taip;0;0;3;3
7432;Pipiras;EŽIUKAI;77307352546;Taip;2;1;0;3
7433;Pipiras;EŽIUKAI;53468621826;Taip;0;2;0;2
7434;Pipiras;EŽIUKAI;93498963556;Taip;0;2;3;5
7435;Pipiras;EŽIUKAI;22190236403;Taip;4;1;0;5
7436;Pipiras;EŽIUKAI;1213972436;Taip;4;2;0;6
7437;Pipiras;EŽIUKAI;4564046164;Taip;8;0;0;8
7438;Pipiras;EŽIUKAI;35225328018;Taip;0;2;0;2
7439;Pipiras;EŽIUKAI;1129409620;Taip;0;2;3;5
7440;Pipiras;BITUTĖS;20034839935;Taip;0;2;0;2
7441;Pipiras;BITUTĖS;75607109924;Taip;0;0;1;1
7442;Pipiras;BITUTĖS;35376853030;Taip;0;9;0;9
7443;Pipiras;BITUTĖS;96219330294;Taip;0;5;0;5
7444;Pipiras;BITUTĖS;77699420684;Taip;0;4;0;4
7445;Pipiras;BITUTĖS;61581422755;Taip;2;6;0;8
7446;Pipiras;BITUTĖS;9503515806;Taip;0;13;0;13
7447;Pipiras;BITUTĖS;75297843018;Taip;0;2;0;2
7448;Pipiras;BITUTĖS;81094360294;Taip;0;1;0;1
7449;Pipiras;BITUTĖS;64050236851;Taip;0;3;0;3
7450;Pipiras;BITUTĖS;89245567171;Taip;0;1;0;1
7451;Pipiras;BITUTĖS;43522302268;Taip;0;1;0;1
7452;Pipiras;BITUTĖS;7501158031;Taip;0;2;0;2
7453;Pipiras;BITUTĖS;35777468660;Taip;0;1;0;1
7454;Pipiras;BITUTĖS;8797825745;Taip;0;1;0;1
7455;Pipiras;BITUTĖS;74448139833;Taip;0;5;0;5
7456;Pipiras;BITUTĖS;7724903510;Taip;0;4;0;4
7457;Pipiras;NYKŠTUKAI;60655521743;Taip;0;2;0;2
7458;Pipiras;NYKŠTUKAI;5849366642;Taip;0;5;0;5
7459;Pipiras;NYKŠTUKAI;15927602783;Taip;0;3;0;3
7460;Pipiras;NYKŠTUKAI;56791669968;Taip;0;5;0;5
7461;Pipiras;NYKŠTUKAI;41412423426;Taip;0;2;0;2
7462;Pipiras;NYKŠTUKAI;32061333461;Taip;0;9;0;9
7463;Pipiras;NYKŠTUKAI;12906419175;Taip;0;1;0;1
7464;Pipiras;NYKŠTUKAI;72634292284;Taip;0;1;0;1
7465;Pipiras;NYKŠTUKAI;10825133339;Taip;0;6;0;6
7466;Pipiras;NYKŠTUKAI;86812470693;Taip;0;2;0;2
7467;Pipiras;NYKŠTUKAI;66182015590;Taip;0;9;0;9
7468;Pipiras;NYKŠTUKAI;11746912226;Taip;0;1;0;1
7469;Pipiras;NYKŠTUKAI;1626782165;Taip;0;3;0;3
7470;Pipiras;NYKŠTUKAI;1813200223;Taip;0;2;0;2
7471;Pipiras;PELĖDŽIUKAI;6694920607;Taip;0;18;0;18
7472;Pipiras;PELĖDŽIUKAI;3325511140;Taip;0;11;0;11
7473;Pipiras;PELĖDŽIUKAI;3341850450;Taip;9;0;0;9
7474;Pipiras;PELĖDŽIUKAI;7870521230;Taip;5;1;0;6
7475;Pipiras;PELĖDŽIUKAI;5778300856;Taip;3;1;0;4
7476;Pipiras;PELĖDŽIUKAI;3888552150;Taip;0;1;0;1
7477;Pipiras;PELĖDŽIUKAI;7026118693;Taip;0;1;0;1
7478;Pipiras;PELĖDŽIUKAI;1391682850;Taip;0;5;1;6
7479;Pipiras;PELĖDŽIUKAI;87924002679;Taip;13;0;3;16
7480;Pipiras;PELĖDŽIUKAI;6805620664;Taip;7;0;0;7
7481;Pipiras;PELĖDŽIUKAI;7912217889;Taip;5;1;1;7
7482;Pipiras;PELĖDŽIUKAI;5502001191;Taip;0;0;1;1
7483;Pipiras;PELĖDŽIUKAI;9275905384;Taip;1;0;4;5
7484;Pipiras;PELĖDŽIUKAI;4496076326;Taip;7;0;0;7
7485;Pipiras;PELĖDŽIUKAI;3141822820;Taip;0;7;0;7
7486;Pipiras;PELĖDŽIUKAI;2044498561;Taip;17;0;0;17
7487;Pipiras;PELĖDŽIUKAI;3357866319;Taip;0;2;3;5
7488;Pipiras;DRUGELIAI;41585818819;Taip;0;20;0;20
7489;Pipiras;DRUGELIAI;5577759167;Taip;16;0;0;16
7490;Pipiras;DRUGELIAI;7799786844;Taip;16;2;0;18
7491;Pipiras;DRUGELIAI;2345034928;Taip;12;0;1;13
7492;Pipiras;DRUGELIAI;5014457985;Taip;8;0;0;8
7493;Pipiras;DRUGELIAI;4927845000;Taip;0;9;0;9
7494;Pipiras;DRUGELIAI;1904376366;Taip;5;3;0;8
7495;Pipiras;DRUGELIAI;1128674099;Taip;7;2;0;9
7496;Pipiras;DRUGELIAI;3422170541;Taip;2;1;0;3
7497;Pipiras;DRUGELIAI;1391958633;Taip;11;5;0;16
7498;Pipiras;DRUGELIAI;7784343130;Taip;0;0;5;5
7499;Pipiras;DRUGELIAI;3622164823;Taip;0;15;0;15
7500;Pipiras;DRUGELIAI;3008358842;Taip;4;0;0;4
7501;Pipiras;DRUGELIAI;2024777430;Taip;7;0;0;7
7502;Pipiras;DRUGELIAI;6339186940;Taip;0;9;0;9
7503;Pipiras;DRUGELIAI;3314276870;Taip;11;1;0;12
7504;Pipiras;DRUGELIAI;5637557921;Taip;18;0;0;18
7505;Pipiras;DRUGELIAI;1050430252;Taip;7;2;0;9
7506;Pipiras;GĖLYTĖS;48059975861;Taip;0;1;0;1
7507;Pipiras;GĖLYTĖS;81335131932;Taip;0;1;0;1
7508;Pipiras;GĖLYTĖS;23377947863;Taip;11;4;0;15
7509;Pipiras;GĖLYTĖS;87831792882;Taip;19;0;0;19
7510;Pipiras;GĖLYTĖS;1417855241;Taip;0;7;0;7
7511;Pipiras;GĖLYTĖS;1791226869;Taip;0;11;0;11
7512;Pipiras;GĖLYTĖS;60652954862;Taip;0;3;0;3
7513;Pipiras;GĖLYTĖS;27808576289;Taip;0;2;0;2
7514;Pipiras;GĖLYTĖS;5114553619;Taip;0;5;0;5
7515;Pipiras;GĖLYTĖS;1780531222;Taip;0;1;0;1
7516;Pipiras;GĖLYTĖS;4246712256;Taip;0;3;0;3
7517;Pipiras;GĖLYTĖS;25000181631;Taip;0;4;0;4
7518;Pipiras;GĖLYTĖS;2473644942;Taip;0;15;0;15
7519;Pipiras;GĖLYTĖS;1650661825;Taip;0;1;0;1
7520;Pipiras;GĖLYTĖS;56822466210;Taip;10;0;0;10
7521;Pipiras;GĖLYTĖS;23663823688;Taip;6;7;0;13
7522;Pipiras;GĖLYTĖS;6481320053;Ne;5;1;0;6
7523;Pipiras;BORUŽĖLĖS;68636458010;Taip;0;3;0;3
7524;Pipiras;BORUŽĖLĖS;20456702162;Taip;1;0;0;1
7525;Pipiras;BORUŽĖLĖS;57459408180;Taip;0;17;0;17
7526;Pipiras;BORUŽĖLĖS;7354253729;Taip;0;13;0;13
7527;Pipiras;BORUŽĖLĖS;9423015002;Taip;0;4;0;4
7528;Pipiras;BORUŽĖLĖS;68235713574;Taip;0;1;0;1
7529;Pipiras;BORUŽĖLĖS;63605758339;Taip;0;2;0;2
7530;Pipiras;BORUŽĖLĖS;23794561369;Taip;0;11;0;11
7531;Pipiras;BORUŽĖLĖS;46165404909;Taip;0;5;0;5
7532;Pipiras;BORUŽĖLĖS;92764472620;Taip;0;2;0;2
7533;Pipiras;BORUŽĖLĖS;6804964469;Taip;0;1;0;1
7534;Pipiras;BORUŽĖLĖS;1676986127;Taip;1;1;0;2
7535;Pipiras;BORUŽĖLĖS;1334584865;Taip;8;0;3;11
7536;Pipiras;BORUŽĖLĖS;9673674008;Taip;9;0;0;9
7537;Pipiras;BORUŽĖLĖS;1657721144;Taip;1;0;0;1
7538;Pipiras;SKRUZDĖLIUKAI;76840668343;Taip;21;0;0;21
7539;Pipiras;SKRUZDĖLIUKAI;1975780209;Taip;5;0;1;6
7540;Pipiras;SKRUZDĖLIUKAI;50739918812;Ne;0;1;0;1
7541;Pipiras;SKRUZDĖLIUKAI;75153377410;Taip;0;9;0;9
7542;Pipiras;SKRUZDĖLIUKAI;53426269440;Taip;0;2;0;2
7543;Pipiras;SKRUZDĖLIUKAI;7196519583;Taip;0;15;0;15
7544;Pipiras;SKRUZDĖLIUKAI;53180156021;Taip;0;1;0;1
7545;Pipiras;SKRUZDĖLIUKAI;96711811784;Taip;0;10;0;10
7546;Pipiras;SKRUZDĖLIUKAI;85339674885;Taip;0;14;0;14
7547;Pipiras;SKRUZDĖLIUKAI;61166497338;Taip;0;2;0;2
7548;Pipiras;SKRUZDĖLIUKAI;90202583208;Taip;0;10;0;10
7549;Pipiras;SKRUZDĖLIUKAI;84791674090;Ne;0;8;0;8
7550;Pipiras;SKRUZDĖLIUKAI;53377928276;Taip;0;1;0;1
7551;Pipiras;SKRUZDĖLIUKAI;1450882528;Taip;0;0;1;1
7552;Pipiras;SKRUZDĖLIUKAI;1469877916;Taip;0;1;0;1
7553;Pipiras;SKRUZDĖLIUKAI;71790101454;Taip;0;5;0;5
7554;Pipiras;SKRUZDĖLIUKAI;73564428514;Ne;0;13;0;13
7555;Pipiras;ŽVIRBLIUKŲ;80046621658;Taip;21;0;0;21
7556;Pipiras;ŽVIRBLIUKŲ;70940029154;Taip;0;1;0;1
7557;Pipiras;ŽVIRBLIUKŲ;1549121029;Taip;0;3;0;3
7558;Pipiras;ŽVIRBLIUKŲ;37087220885;Taip;2;0;0;2
7559;Pipiras;ŽVIRBLIUKŲ;1700856741;Taip;0;2;0;2
7560;Pipiras;ŽVIRBLIUKŲ;1319863476;Taip;17;0;0;17
7561;Pipiras;ŽVIRBLIUKŲ;1757192919;Taip;0;1;0;1
7562;Pipiras;ŽVIRBLIUKŲ;1417086043;Taip;0;18;0;18
7563;Pipiras;ŽVIRBLIUKŲ;1441590033;Taip;6;2;0;8
7564;Pipiras;ŽVIRBLIUKŲ;3370047940;Taip;9;7;0;16
7565;Pipiras;ŽVIRBLIUKŲ;1008228932;Taip;11;0;0;11
7566;Pipiras;ŽVIRBLIUKŲ;2030665851;Taip;3;2;0;5
7567;Pipiras;ŽVIRBLIUKŲ;1182415963;Taip;0;7;0;7
7568;Pipiras;ŽVIRBLIUKŲ;8657924258;Taip;0;6;0;6
7569;Pipiras;ŽVIRBLIUKŲ;10750695428;Taip;7;7;0;14
7570;Pipiras;ŽVIRBLIUKŲ;66816368717;Taip;0;7;0;7
7571;Pipiras;ŽVIRBLIUKŲ;1799335356;Ne;6;10;0;16
7572;Pipiras;ŽVIRBLIUKŲ;3247709788;Taip;0;21;0;21
7573;Pipiras;ZUIKUČIŲ;7161727352;Taip;0;1;0;1
7574;Pipiras;ZUIKUČIŲ;5225533488;Taip;6;4;0;10
7575;Pipiras;ZUIKUČIŲ;5622119207;Taip;0;6;0;6
7576;Pipiras;ZUIKUČIŲ;2016718354;Taip;0;1;0;1
7577;Pipiras;ZUIKUČIŲ;9157870634;Taip;0;1;0;1
7578;Pipiras;ZUIKUČIŲ;4177166475;Taip;0;8;0;8
7579;Pipiras;ZUIKUČIŲ;6792777396;Taip;0;2;0;2
7580;Pipiras;ZUIKUČIŲ;5845498558;Taip;13;1;0;14
7581;Pipiras;ZUIKUČIŲ;1784839485;Taip;0;4;0;4
7582;Pipiras;ZUIKUČIŲ;5141447649;Taip;8;3;0;11
7583;Pipiras;ZUIKUČIŲ;3775916247;Taip;0;1;0;1
7584;Pipiras;ZUIKUČIŲ;5908707752;Taip;0;19;0;19
7585;Pipiras;ZUIKUČIŲ;3882437376;Taip;0;0;1;1
7586;Pipiras;VARLIUKŲ;6363349541;Taip;1;1;0;2
7587;Pipiras;VARLIUKŲ;6340323302;Taip;3;0;0;3
7588;Pipiras;VARLIUKŲ;4266424785;Taip;4;0;0;4
7589;Pipiras;VARLIUKŲ;6748400056;Taip;0;5;0;5
7590;Pipiras;VARLIUKŲ;2315614501;Taip;5;0;1;6
7591;Pipiras;VARLIUKŲ;5422547144;Taip;11;2;0;13
7592;Pipiras;VARLIUKŲ;3421769229;Taip;5;0;0;5
7593;Pipiras;VARLIUKŲ;5445858240;Taip;8;1;0;9
7594;Pipiras;VARLIUKŲ;1242260242;Taip;12;0;0;12
7595;Pipiras;VARLIUKŲ;6685567970;Taip;11;0;0;11
7596;Pipiras;VARLIUKŲ;8520454289;Taip;1;0;0;1
7597;Pipiras;VARLIUKŲ;7969837759;Taip;0;21;0;21
7598;Pipiras;VARLIUKŲ;4426479971;Taip;5;0;0;5
7599;Pipiras;VARLIUKŲ;2267192782;Taip;0;10;0;10
7600;Pipiras;ŽIOGELIŲ;2096009051;Taip;14;1;0;15
7601;Pipiras;ŽIOGELIŲ;71283505646;Taip;5;4;0;9
7602;Pipiras;ŽIOGELIŲ;1485565125;Taip;6;0;0;6
7603;Pipiras;ŽIOGELIŲ;2061168407;Taip;10;0;0;10
7604;Pipiras;ŽIOGELIŲ;2030170020;Taip;4;3;0;7
7605;Pipiras;ŽIOGELIŲ;2637950013;Taip;21;0;0;21
7606;Pipiras;ŽIOGELIŲ;3652741639;Taip;21;0;0;21
7607;Pipiras;ŽIOGELIŲ;1415741097;Taip;8;4;0;12
7608;Pipiras;ŽIOGELIŲ;1082396096;Taip;9;2;0;11
7609;Pipiras;ŽIOGELIŲ;6794437566;Taip;21;0;0;21
7610;Pipiras;ŽIOGELIŲ;1371141047;Taip;3;1;0;4
7611;Pipiras;ŽIOGELIŲ;1420510354;Taip;0;2;0;2
7612;Pipiras;ŽIOGELIŲ;1293250996;Taip;11;1;0;12
7613;Pipiras;ŽIOGELIŲ;1751427121;Taip;7;2;0;9
7614;Pipiras;ŽIOGELIŲ;1114377378;Taip;0;5;0;5
7615;Pipiras;ŽIOGELIŲ;1694848410;Taip;11;0;0;11
7616;Pipiras;ŽIOGELIŲ;8088285579;Ne;0;5;0;5
7617;Pipiras;ŽIOGELIŲ;1949087858;Taip;17;0;0;17
7618;"Prie pasakų parko";"ZUIKUČIŲ (SPEC.)";1783727978;Taip;5;0;0;5
7619;"Prie pasakų parko";"ZUIKUČIŲ (SPEC.)";1079827182;Taip;8;0;2;10
7620;"Prie pasakų parko";"ZUIKUČIŲ (SPEC.)";1057427744;Ne;0;0;1;1
7621;"Prie pasakų parko";"ZUIKUČIŲ (SPEC.)";4574965127;Ne;0;0;3;3
7622;"Prie pasakų parko";"ZUIKUČIŲ (SPEC.)";18652266729;Taip;0;0;1;1
7623;"Prie pasakų parko";"ZUIKUČIŲ (SPEC.)";3397410463;Ne;0;0;3;3
7624;"Prie pasakų parko";PAUKŠČIUKŲ;5982019255;Taip;10;0;0;10
7625;"Prie pasakų parko";PAUKŠČIUKŲ;2160440145;Taip;21;0;0;21
7626;"Prie pasakų parko";PAUKŠČIUKŲ;6992830082;Taip;16;0;0;16
7627;"Prie pasakų parko";PAUKŠČIUKŲ;2216634402;Taip;14;0;1;15
7628;"Prie pasakų parko";PAUKŠČIUKŲ;1278065349;Taip;17;0;0;17
7629;"Prie pasakų parko";PAUKŠČIUKŲ;3356307067;Taip;2;0;0;2
7630;"Prie pasakų parko";PAUKŠČIUKŲ;8215830508;Ne;7;6;0;13
7631;"Prie pasakų parko";PAUKŠČIUKŲ;8318567916;Taip;10;0;0;10
7632;"Prie pasakų parko";PAUKŠČIUKŲ;8189217660;Taip;11;8;0;19
7633;"Prie pasakų parko";PAUKŠČIUKŲ;2741301903;Taip;6;6;0;12
7634;"Prie pasakų parko";PAUKŠČIUKŲ;4181676762;Taip;0;7;0;7
7635;"Prie pasakų parko";PAUKŠČIUKŲ;1482803930;Taip;8;0;3;11
7636;"Prie pasakų parko";PAUKŠČIUKŲ;9926991259;Taip;8;3;0;11
7637;"Prie pasakų parko";PAUKŠČIUKŲ;8574432191;Taip;0;3;0;3
7638;"Prie pasakų parko";PAUKŠČIUKŲ;1588062393;Taip;6;0;0;6
7639;"Prie pasakų parko";PAUKŠČIUKŲ;2217627240;Taip;5;0;0;5
7640;"Prie pasakų parko";PAUKŠČIUKŲ;7548653053;Taip;3;4;0;7
7641;"Prie pasakų parko";"LINKSMOJI ŠEIMYNĖLĖ (SPEC)";70678189213;Taip;7;0;0;7
7642;"Prie pasakų parko";"LINKSMOJI ŠEIMYNĖLĖ (SPEC)";3023913956;Ne;0;4;0;4
7643;"Prie pasakų parko";"LINKSMOJI ŠEIMYNĖLĖ (SPEC)";29561378525;Taip;3;0;10;13
7644;"Prie pasakų parko";"LINKSMOJI ŠEIMYNĖLĖ (SPEC)";7375940325;Taip;2;0;0;2
7645;"Prie pasakų parko";"LINKSMOJI ŠEIMYNĖLĖ (SPEC)";7186554262;Taip;7;0;1;8
7646;"Prie pasakų parko";"LINKSMOJI ŠEIMYNĖLĖ (SPEC)";6339321027;Taip;0;0;6;6
7647;"Prie pasakų parko";"LINKSMOJI ŠEIMYNĖLĖ (SPEC)";50713289266;Taip;4;0;0;4
7648;"Prie pasakų parko";"LINKSMOJI ŠEIMYNĖLĖ (SPEC)";1327847558;Taip;0;0;1;1
7649;"Prie pasakų parko";NYKŠTUKŲ;41410871117;Taip;0;0;1;1
7650;"Prie pasakų parko";NYKŠTUKŲ;18733824395;Taip;0;1;0;1
7651;"Prie pasakų parko";NYKŠTUKŲ;79438946697;Taip;0;8;0;8
7652;"Prie pasakų parko";NYKŠTUKŲ;21605684303;Taip;5;0;0;5
7653;"Prie pasakų parko";NYKŠTUKŲ;72936036464;Taip;16;0;0;16
7654;"Prie pasakų parko";NYKŠTUKŲ;1410161486;Taip;3;0;2;5
7655;"Prie pasakų parko";NYKŠTUKŲ;9384410578;Taip;0;0;1;1
7656;"Prie pasakų parko";NYKŠTUKŲ;7235277422;Taip;13;0;0;13
7657;"Prie pasakų parko";NYKŠTUKŲ;6577763037;Taip;0;1;0;1
7658;"Prie pasakų parko";NYKŠTUKŲ;6027613840;Taip;0;1;0;1
7659;"Prie pasakų parko";NYKŠTUKŲ;4657371068;Taip;4;0;0;4
7660;"Prie pasakų parko";NYKŠTUKŲ;70510594589;Taip;0;4;0;4
7661;"Prie pasakų parko";NYKŠTUKŲ;1634442815;Taip;0;3;0;3
7662;"Prie pasakų parko";LAŠELIŲ;2106160177;Taip;0;15;0;15
7663;"Prie pasakų parko";LAŠELIŲ;62268017779;Taip;10;0;0;10
7664;"Prie pasakų parko";LAŠELIŲ;98216786643;Taip;5;0;2;7
7665;"Prie pasakų parko";LAŠELIŲ;488285764;Taip;0;0;10;10
7666;"Prie pasakų parko";LAŠELIŲ;41495895397;Taip;5;4;0;9
7667;"Prie pasakų parko";LAŠELIŲ;80772711351;Taip;5;0;1;6
7668;"Prie pasakų parko";LAŠELIŲ;17947580061;Taip;0;0;1;1
7669;"Prie pasakų parko";"KAČIUKAI (SPEC)";5049934191;Ne;0;0;2;2
7670;"Prie pasakų parko";"KAČIUKAI (SPEC)";67103811533;Ne;6;0;1;7
7671;"Prie pasakų parko";"KAČIUKAI (SPEC)";4241426494;Ne;4;0;2;6
7672;"Prie pasakų parko";"KAČIUKAI (SPEC)";42696300043;Taip;12;1;0;13
7673;"Prie pasakų parko";"ŽVAIGŽDUTĖS  (SPEC)";39511689145;Taip;0;0;2;2
7674;"Prie pasakų parko";"ŽVAIGŽDUTĖS  (SPEC)";11759638207;Taip;5;0;1;6
7675;"Prie pasakų parko";"ŽVAIGŽDUTĖS  (SPEC)";3045247119;Taip;7;0;1;8
7676;"Prie pasakų parko";"ŽVAIGŽDUTĖS  (SPEC)";28449237128;Taip;0;0;3;3
7677;"Prie pasakų parko";"ŽVAIGŽDUTĖS  (SPEC)";7341054382;Ne;21;0;0;21
7678;"Prie pasakų parko";"ŽVAIGŽDUTĖS  (SPEC)";1118596267;Taip;0;0;1;1
7679;"Prie pasakų parko";"ŽVAIGŽDUTĖS  (SPEC)";89327404290;Taip;6;0;1;7
7680;"Prie pasakų parko";"ANČIUKAI (SPEC)";47396396133;Taip;0;0;2;2
7681;"Prie pasakų parko";"ANČIUKAI (SPEC)";4908579339;Taip;12;0;0;12
7682;"Prie pasakų parko";"ANČIUKAI (SPEC)";2241142980;Taip;0;0;3;3
7683;"Prie pasakų parko";"ANČIUKAI (SPEC)";1730134670;Ne;5;0;0;5
7684;"Prie pasakų parko";"ANČIUKAI (SPEC)";78012776060;Taip;3;0;0;3
7685;"Prie pasakų parko";"ANČIUKAI (SPEC)";1658448860;Taip;1;5;0;6
7686;"Prie pasakų parko";"ANČIUKAI (SPEC)";78634860827;Taip;0;2;0;2
7687;"Prie pasakų parko";"ANČIUKAI (SPEC)";1182188784;Taip;0;0;2;2
7688;"Prie pasakų parko";"ANČIUKAI (SPEC)";1508800551;Taip;6;0;4;10
7689;"Prie pasakų parko";"ANČIUKAI (SPEC)";7710346116;Ne;9;0;0;9
7690;"Prie pasakų parko";TIGRIUKAI;4427448272;Taip;3;0;3;6
7691;"Prie pasakų parko";TIGRIUKAI;2601881804;Taip;0;1;0;1
7692;"Prie pasakų parko";TIGRIUKAI;34800098950;Taip;5;0;1;6
7693;"Prie pasakų parko";TIGRIUKAI;1275460051;Taip;6;0;1;7
7694;"Prie pasakų parko";TIGRIUKAI;1400892707;Taip;4;0;3;7
7695;"Prie pasakų parko";TIGRIUKAI;6273733995;Taip;0;7;0;7
7696;"Prie pasakų parko";TIGRIUKAI;1204812495;Taip;0;6;0;6
7697;"Prie pasakų parko";TIGRIUKAI;5699852944;Taip;5;7;0;12
7698;"Prie pasakų parko";TIGRIUKAI;5001661462;Taip;7;0;0;7
7699;"Prie pasakų parko";TIGRIUKAI;65825430797;Taip;8;7;0;15
7700;"Prie pasakų parko";TIGRIUKAI;4900757614;Taip;0;2;1;3
7701;"Prie pasakų parko";TIGRIUKAI;8205731591;Taip;12;0;3;15
7702;"Prie pasakų parko";TIGRIUKAI;8474308320;Taip;21;0;0;21
7703;"Prie pasakų parko";TIGRIUKAI;4332682721;Ne;6;0;2;8
7704;"Prie pasakų parko";"EŽIUKŲ (SPEC)";2820889357;Ne;10;0;2;12
7705;"Prie pasakų parko";"EŽIUKŲ (SPEC)";1549137154;Taip;2;0;0;2
7706;"Prie pasakų parko";"EŽIUKŲ (SPEC)";7545372781;Ne;0;0;5;5
7707;"Prie pasakų parko";"EŽIUKŲ (SPEC)";29445903073;Taip;15;0;0;15
7708;"Prie pasakų parko";"EŽIUKŲ (SPEC)";2133790263;Ne;0;2;0;2
7709;"Prie pasakų parko";"EŽIUKŲ (SPEC)";8849417734;Taip;0;0;1;1
7710;"Prie pasakų parko";"EŽIUKŲ (SPEC)";9190379838;Taip;5;0;3;8
7711;"Prie pasakų parko";"EŽIUKŲ (SPEC)";7327208141;Ne;6;0;2;8
7712;"Prie pasakų parko";"BORUŽIUKŲ (SPEC)";2080597774;Taip;3;0;0;3
7713;"Prie pasakų parko";"BORUŽIUKŲ (SPEC)";28574450739;Taip;0;2;0;2
7714;"Prie pasakų parko";"BORUŽIUKŲ (SPEC)";8817950372;Taip;0;10;0;10
7715;"Prie pasakų parko";"BORUŽIUKŲ (SPEC)";4203385836;Taip;2;1;0;3
7716;"Prie pasakų parko";"BORUŽIUKŲ (SPEC)";6215345468;Ne;0;0;2;2
7717;"Prie pasakų parko";SAULYTĖS;1543331408;Taip;0;0;10;10
7718;"Prie pasakų parko";SAULYTĖS;4501408366;Taip;1;1;0;2
7719;"Prie pasakų parko";SAULYTĖS;4874244790;Taip;6;0;0;6
7720;"Prie pasakų parko";SAULYTĖS;8182873487;Taip;0;1;0;1
7721;"Prie pasakų parko";SAULYTĖS;1610362831;Ne;13;4;0;17
7722;"Prie pasakų parko";SAULYTĖS;2548712970;Taip;4;0;1;5
7723;"Prie pasakų parko";SAULYTĖS;78516912418;Taip;0;4;0;4
7724;"Prie pasakų parko";SAULYTĖS;5593546668;Taip;5;0;0;5
7725;"Prie pasakų parko";SAULYTĖS;6361878877;Taip;17;0;0;17
7726;"Prie pasakų parko";SAULYTĖS;4443834766;Taip;5;0;1;6
7727;"Prie pasakų parko";SAULYTĖS;3453119286;Taip;1;0;0;1
7728;"Prie pasakų parko";SAULYTĖS;5169736542;Taip;7;2;0;9
7729;"Prie pasakų parko";SAULYTĖS;5494350183;Taip;0;5;0;5
7730;"Prie pasakų parko";SAULYTĖS;6250397070;Taip;13;6;0;19
7731;Pumpurėlis;RAMUNĖLIŲ;61297074638;Taip;0;2;0;2
7732;Pumpurėlis;RAMUNĖLIŲ;87813594933;Taip;0;4;0;4
7733;Pumpurėlis;RAMUNĖLIŲ;7015779224;Taip;0;9;0;9
7734;Pumpurėlis;RAMUNĖLIŲ;24681852477;Taip;5;0;0;5
7735;Pumpurėlis;RAMUNĖLIŲ;27361939846;Taip;0;3;0;3
7736;Pumpurėlis;RAMUNĖLIŲ;20093100251;Taip;2;0;0;2
7737;Pumpurėlis;RAMUNĖLIŲ;15096075268;Taip;6;1;0;7
7738;Pumpurėlis;RAMUNĖLIŲ;1685401053;Taip;0;2;0;2
7739;Pumpurėlis;RAMUNĖLIŲ;33847164571;Taip;0;0;1;1
7740;Pumpurėlis;RAMUNĖLIŲ;2671657094;Taip;5;1;0;6
7741;Pumpurėlis;RAMUNĖLIŲ;91612536967;Taip;0;1;0;1
7742;Pumpurėlis;RAMUNĖLIŲ;45279361421;Taip;19;0;0;19
7743;Pumpurėlis;RAMUNĖLIŲ;16656067942;Taip;0;9;0;9
7744;Pumpurėlis;RAMUNĖLIŲ;9041599264;Taip;0;3;0;3
7745;Pumpurėlis;RAMUNĖLIŲ;1021043951;Taip;14;2;0;16
7746;Pumpurėlis;RAMUNĖLIŲ;1524688901;Taip;5;3;0;8
7747;Pumpurėlis;RAMUNĖLIŲ;1366801299;Taip;5;3;0;8
7748;Pumpurėlis;RAMUNĖLIŲ;1631951556;Taip;6;0;0;6
7749;Pumpurėlis;RAMUNĖLIŲ;6215273976;Taip;0;8;0;8
7750;Pumpurėlis;VARPELIŲ;97145389284;Taip;5;0;0;5
7751;Pumpurėlis;VARPELIŲ;70522541316;Taip;0;8;0;8
7752;Pumpurėlis;VARPELIŲ;465606233;Taip;0;2;0;2
7753;Pumpurėlis;VARPELIŲ;93964052608;Taip;5;1;0;6
7754;Pumpurėlis;VARPELIŲ;11052382671;Taip;0;11;0;11
7755;Pumpurėlis;VARPELIŲ;28759758744;Taip;0;0;1;1
7756;Pumpurėlis;VARPELIŲ;77110003421;Taip;0;2;2;4
7757;Pumpurėlis;VARPELIŲ;47596248180;Taip;0;10;0;10
7758;Pumpurėlis;VARPELIŲ;46386981131;Taip;0;3;0;3
7759;Pumpurėlis;VARPELIŲ;49176440282;Ne;0;6;0;6
7760;Pumpurėlis;VARPELIŲ;36645787745;Taip;15;2;0;17
7761;Pumpurėlis;VARPELIŲ;5901659879;Taip;2;1;0;3
7762;Pumpurėlis;VARPELIŲ;56351492623;Taip;2;2;0;4
7763;Pumpurėlis;VARPELIŲ;1754102092;Taip;0;3;0;3
7764;Pumpurėlis;VARPELIŲ;57426850391;Taip;5;1;1;7
7765;Pumpurėlis;VARPELIŲ;15256433275;Taip;0;10;0;10
7766;Pumpurėlis;VARPELIŲ;89695456583;Taip;0;6;0;6
7767;Pumpurėlis;VARPELIŲ;1544903261;Ne;0;12;0;12
7768;Pumpurėlis;VARPELIŲ;1945407792;Taip;6;0;0;6
7769;Pumpurėlis;VARPELIŲ;1645287832;Taip;11;2;1;14
7770;Pumpurėlis;VARPELIŲ;6025998706;Taip;0;1;0;1
7771;Pumpurėlis;DRUGELIŲ;1230058211;Taip;0;5;0;5
7772;Pumpurėlis;DRUGELIŲ;1225377038;Taip;1;0;6;7
7773;Pumpurėlis;DRUGELIŲ;1053338730;Taip;6;0;3;9
7774;Pumpurėlis;DRUGELIŲ;1261919194;Taip;0;0;1;1
7775;Pumpurėlis;DRUGELIŲ;1397924008;Taip;6;0;0;6
7776;Pumpurėlis;DRUGELIŲ;6230500803;Taip;0;12;0;12
7777;Pumpurėlis;DRUGELIŲ;2102427499;Taip;0;3;0;3
7778;Pumpurėlis;DRUGELIŲ;9724549899;Taip;12;0;0;12
7779;Pumpurėlis;DRUGELIŲ;9317495169;Taip;0;7;0;7
7780;Pumpurėlis;DRUGELIŲ;9078991043;Taip;16;0;0;16
7781;Pumpurėlis;DRUGELIŲ;9733380187;Taip;0;10;0;10
7782;Pumpurėlis;DRUGELIŲ;83388662869;Taip;0;8;0;8
7783;Pumpurėlis;DRUGELIŲ;7123915287;Taip;1;0;0;1
7784;Pumpurėlis;DRUGELIŲ;1690424790;Taip;11;2;0;13
7785;Pumpurėlis;DRUGELIŲ;4192641015;Taip;0;1;0;1
7786;Pumpurėlis;DRUGELIŲ;7519369167;Taip;0;0;5;5
7787;Pumpurėlis;DRUGELIŲ;1248017244;Taip;3;1;3;7
7788;Pumpurėlis;DRUGELIŲ;6395230524;Taip;0;0;1;1
7789;Pumpurėlis;KODĖLČIUKŲ;5984878126;Taip;14;2;0;16
7790;Pumpurėlis;KODĖLČIUKŲ;18928851032;Taip;5;1;0;6
7791;Pumpurėlis;KODĖLČIUKŲ;9224879966;Taip;9;2;0;11
7792;Pumpurėlis;KODĖLČIUKŲ;1188314397;Taip;4;1;0;5
7793;Pumpurėlis;KODĖLČIUKŲ;2468796972;Taip;0;4;0;4
7794;Pumpurėlis;KODĖLČIUKŲ;8830261792;Taip;14;0;0;14
7795;Pumpurėlis;KODĖLČIUKŲ;9583257172;Taip;21;0;0;21
7796;Pumpurėlis;KODĖLČIUKŲ;9138883172;Taip;4;1;0;5
7797;Pumpurėlis;KODĖLČIUKŲ;7533555059;Taip;9;7;0;16
7798;Pumpurėlis;KODĖLČIUKŲ;6669327226;Taip;0;3;0;3
7799;Pumpurėlis;KODĖLČIUKŲ;13952236905;Taip;4;0;0;4
7800;Pumpurėlis;KODĖLČIUKŲ;87061817106;Taip;0;1;0;1
7801;Pumpurėlis;KODĖLČIUKŲ;1835168438;Taip;5;5;0;10
7802;Pumpurėlis;KODĖLČIUKŲ;5615260965;Taip;0;5;0;5
7803;Pumpurėlis;KODĖLČIUKŲ;4344595328;Taip;0;1;0;1
7804;Pumpurėlis;KODĖLČIUKŲ;3298821054;Taip;10;0;0;10
7805;Pumpurėlis;KODĖLČIUKŲ;8806961007;Taip;0;0;3;3
7806;Pumpurėlis;KODĖLČIUKŲ;9439363363;Taip;17;0;0;17
7807;Pumpurėlis;KODĖLČIUKŲ;5964953923;Taip;13;0;0;13
7808;Pumpurėlis;KODĖLČIUKŲ;1492810528;Taip;5;0;4;9
7809;Pumpurėlis;KODĖLČIUKŲ;7566451857;Taip;14;0;0;14
7810;Pumpurėlis;LINELIS;84077240969;Taip;6;0;0;6
7811;Pumpurėlis;LINELIS;1320618070;Taip;0;2;0;2
7812;Pumpurėlis;LINELIS;90214423899;Taip;9;0;0;9
7813;Pumpurėlis;LINELIS;79842160701;Taip;4;0;0;4
7814;Pumpurėlis;LINELIS;22232669189;Taip;0;2;0;2
7815;Pumpurėlis;LINELIS;65556407758;Taip;11;1;0;12
7816;Pumpurėlis;LINELIS;50662453283;Taip;0;0;2;2
7817;Pumpurėlis;LINELIS;5626656132;Taip;3;3;0;6
7818;Pumpurėlis;LINELIS;8088505202;Taip;3;0;0;3
7819;Pumpurėlis;LINELIS;39148007125;Taip;4;3;0;7
7820;Pumpurėlis;LINELIS;8916669921;Taip;0;6;0;6
7821;Pumpurėlis;LINELIS;44429937857;Taip;0;2;0;2
7822;Pumpurėlis;LINELIS;79813871981;Taip;0;1;0;1
7823;Pumpurėlis;LINELIS;86581864351;Taip;0;1;0;1
7824;Pumpurėlis;LINELIS;24135602993;Taip;8;2;0;10
7825;Pumpurėlis;LINELIS;74357094385;Taip;0;1;0;1
7826;Pumpurėlis;LINELIS;99841176399;Taip;6;0;0;6
7827;Pumpurėlis;LINELIS;1890693598;Taip;0;1;0;1
7828;Pumpurėlis;LINELIS;57455327823;Taip;0;11;0;11
7829;Pumpurėlis;LINELIS;5956784613;Taip;4;10;0;14
7830;Pumpurėlis;SAULUTĖS;73683690800;Taip;15;0;0;15
7831;Pumpurėlis;SAULUTĖS;42537135918;Taip;8;1;0;9
7832;Pumpurėlis;SAULUTĖS;50393587861;Taip;7;1;0;8
7833;Pumpurėlis;SAULUTĖS;45898175544;Taip;8;7;0;15
7834;Pumpurėlis;SAULUTĖS;49696660115;Taip;0;2;0;2
7835;Pumpurėlis;SAULUTĖS;24927191443;Taip;0;10;0;10
7836;Pumpurėlis;SAULUTĖS;82272797732;Taip;5;1;0;6
7837;Pumpurėlis;SAULUTĖS;76081690528;Taip;0;1;0;1
7838;Pumpurėlis;SAULUTĖS;76467622234;Taip;0;9;0;9
7839;Pumpurėlis;SAULUTĖS;89004303712;Taip;0;2;0;2
7840;Pumpurėlis;SAULUTĖS;32946314312;Taip;0;2;0;2
7841;Pumpurėlis;SAULUTĖS;50292067501;Taip;11;2;0;13
7842;Pumpurėlis;SAULUTĖS;91231481674;Taip;5;1;0;6
7843;Pumpurėlis;SAULUTĖS;77181386286;Taip;0;1;0;1
7844;Pumpurėlis;SAULUTĖS;77106733982;Taip;0;1;0;1
7845;Pumpurėlis;SAULUTĖS;25796704653;Taip;0;2;0;2
7846;Pumpurėlis;SAULUTĖS;45310988567;Taip;0;2;0;2
7847;Pumpurėlis;SAULUTĖS;73862556514;Ne;5;9;0;14
7848;Pumpurėlis;SAULUTĖS;96528992638;Taip;1;1;0;2
7849;Pumpurėlis;SAULUTĖS;2129522323;Taip;0;2;4;6
7850;Pumpurėlis;SAULUTĖS;1595705560;Taip;0;2;0;2
7851;Pumpurėlis;BITUTĖS;2028515310;Taip;2;2;0;4
7852;Pumpurėlis;BITUTĖS;44982629856;Taip;0;2;0;2
7853;Pumpurėlis;BITUTĖS;1333429949;Taip;12;0;0;12
7854;Pumpurėlis;BITUTĖS;8747439652;Taip;0;1;0;1
7855;Pumpurėlis;BITUTĖS;92238719397;Taip;0;1;0;1
7856;Pumpurėlis;BITUTĖS;1400057487;Taip;5;0;1;6
7857;Pumpurėlis;BITUTĖS;1274293175;Taip;0;1;1;2
7858;Pumpurėlis;BITUTĖS;93809482039;Taip;5;0;0;5
7859;Pumpurėlis;BITUTĖS;7786926187;Taip;3;0;0;3
7860;Pumpurėlis;BITUTĖS;74144468541;Taip;5;4;0;9
7861;Pumpurėlis;BITUTĖS;1640573725;Taip;10;0;0;10
7862;Pumpurėlis;BITUTĖS;1473237607;Taip;8;1;1;10
7863;Pumpurėlis;BITUTĖS;71979455611;Taip;0;5;0;5
7864;Pumpurėlis;BITUTĖS;1001114367;Taip;3;0;0;3
7865;Pumpurėlis;BITUTĖS;26859673794;Taip;0;9;0;9
7866;Pumpurėlis;BITUTĖS;72719147901;Taip;0;0;2;2
7867;Pumpurėlis;BITUTĖS;1527144198;Taip;0;2;0;2
7868;Pumpurėlis;BITUTĖS;57949968899;Taip;0;0;7;7
7869;Pumpurėlis;BITUTĖS;1298302188;Taip;6;8;0;14
7870;Pumpurėlis;BITUTĖS;1255753542;Taip;11;0;0;11
7871;Pumpurėlis;DOBILIUKAI;1273831078;Taip;0;2;0;2
7872;Pumpurėlis;DOBILIUKAI;98061041685;Taip;15;0;0;15
7873;Pumpurėlis;DOBILIUKAI;1439043505;Taip;0;1;0;1
7874;Pumpurėlis;DOBILIUKAI;1287902351;Taip;0;8;0;8
7875;Pumpurėlis;DOBILIUKAI;1209654095;Taip;7;5;1;13
7876;Pumpurėlis;DOBILIUKAI;40267078306;Taip;0;5;2;7
7877;Pumpurėlis;DOBILIUKAI;51793437519;Taip;0;11;0;11
7878;Pumpurėlis;DOBILIUKAI;1319664504;Taip;0;0;4;4
7879;Pumpurėlis;DOBILIUKAI;1921332565;Taip;4;11;0;15
7880;Pumpurėlis;DOBILIUKAI;1055683170;Taip;0;4;0;4
7881;Pumpurėlis;DOBILIUKAI;1620037477;Taip;0;3;0;3
7882;Pumpurėlis;DOBILIUKAI;1307929787;Taip;0;6;0;6
7883;Pumpurėlis;DOBILIUKAI;1511761574;Taip;0;6;0;6
7884;Pumpurėlis;DOBILIUKAI;1346602122;Taip;5;1;0;6
7885;Pumpurėlis;DOBILIUKAI;88732170322;Taip;0;2;0;2
7886;Pumpurėlis;DOBILIUKAI;1469189392;Taip;21;0;0;21
7887;Pumpurėlis;DOBILIUKAI;94636926281;Taip;0;0;12;12
7888;Pumpurėlis;DOBILIUKAI;1027125361;Taip;13;2;0;15
7889;Pumpurėlis;PUPYČIŲ;9612924972;Taip;5;0;0;5
7890;Pumpurėlis;PUPYČIŲ;9884099545;Taip;10;0;0;10
7891;Pumpurėlis;PUPYČIŲ;8258560345;Taip;0;0;15;15
7892;Pumpurėlis;PUPYČIŲ;1687770779;Taip;12;0;2;14
7893;Pumpurėlis;PUPYČIŲ;5196733185;Taip;7;2;0;9
7894;Pumpurėlis;PUPYČIŲ;2668855786;Taip;9;7;0;16
7895;Pumpurėlis;PUPYČIŲ;8886730333;Taip;0;9;0;9
7896;Pumpurėlis;PUPYČIŲ;5438584331;Taip;8;0;0;8
7897;Pumpurėlis;PUPYČIŲ;7160091629;Taip;5;4;0;9
7898;Pumpurėlis;PUPYČIŲ;3893768713;Taip;0;1;0;1
7899;Pumpurėlis;PUPYČIŲ;3101133244;Taip;15;0;0;15
7900;Pumpurėlis;PUPYČIŲ;4508966729;Taip;11;1;0;12
7901;Pumpurėlis;PUPYČIŲ;4451898302;Taip;6;0;2;8
7902;Pumpurėlis;PUPYČIŲ;5023658988;Taip;0;5;0;5
7903;Pumpurėlis;PUPYČIŲ;9552913910;Taip;0;0;7;7
7904;Pumpurėlis;ŽIRNIUKŲ;4985045047;Taip;8;0;0;8
7905;Pumpurėlis;ŽIRNIUKŲ;7610949816;Taip;7;1;0;8
7906;Pumpurėlis;ŽIRNIUKŲ;3405169131;Taip;21;0;0;21
7907;Pumpurėlis;ŽIRNIUKŲ;6977710645;Taip;11;0;0;11
7908;Pumpurėlis;ŽIRNIUKŲ;9431295796;Taip;11;0;1;12
7909;Pumpurėlis;ŽIRNIUKŲ;1395380236;Taip;6;0;0;6
7910;Pumpurėlis;ŽIRNIUKŲ;9424449290;Taip;0;8;0;8
7911;Pumpurėlis;ŽIRNIUKŲ;6955168163;Taip;11;0;0;11
7912;Pumpurėlis;ŽIRNIUKŲ;7229289985;Taip;0;10;0;10
7913;Pumpurėlis;ŽIRNIUKŲ;5663147778;Taip;5;0;0;5
7914;Pumpurėlis;ŽIRNIUKŲ;7559071945;Taip;8;0;0;8
7915;Pumpurėlis;ŽIRNIUKŲ;8373105196;Taip;8;1;0;9
7916;Pumpurėlis;ŽIRNIUKŲ;9726028397;Taip;8;6;0;14
7917;Pumpurėlis;ŽIRNIUKŲ;5171198109;Taip;0;5;0;5
7918;Pumpurėlis;ŽIRNIUKŲ;2969734731;Taip;12;0;0;12
7919;Pumpurėlis;BORUŽĖLIŲ;42611228425;Taip;0;1;1;2
7920;Pumpurėlis;BORUŽĖLIŲ;68035717481;Taip;0;3;0;3
7921;Pumpurėlis;BORUŽĖLIŲ;1568701327;Taip;0;0;2;2
7922;Pumpurėlis;BORUŽĖLIŲ;1842097360;Taip;0;0;1;1
7923;Pumpurėlis;BORUŽĖLIŲ;82659096039;Taip;0;3;0;3
7924;Pumpurėlis;BORUŽĖLIŲ;1098875585;Taip;3;3;4;10
7925;Pumpurėlis;BORUŽĖLIŲ;1034745510;Taip;0;0;1;1
7926;Pumpurėlis;BORUŽĖLIŲ;1617303626;Taip;1;0;0;1
7927;Pumpurėlis;BORUŽĖLIŲ;1306102772;Taip;8;0;1;9
7928;Pumpurėlis;BORUŽĖLIŲ;1436627913;Taip;0;2;0;2
7929;Pumpurėlis;BORUŽĖLIŲ;1075914140;Taip;2;0;0;2
7930;Pumpurėlis;BORUŽĖLIŲ;2345116167;Taip;0;3;0;3
7931;Pumpurėlis;BORUŽĖLIŲ;63610860077;Taip;7;5;0;12
7932;Pumpurėlis;BORUŽĖLIŲ;6097804285;Taip;2;0;0;2
7933;Pumpurėlis;BORUŽĖLIŲ;1257222112;Taip;0;0;2;2
7934;Pumpurėlis;BORUŽĖLIŲ;1508245418;Taip;0;0;1;1
7935;Pumpurėlis;BORUŽĖLIŲ;81595634697;Taip;12;0;0;12
7936;Pumpurėlis;BORUŽĖLIŲ;1061975374;Taip;0;5;0;5
7937;Puriena;Ančiukų;73312316742;Taip;0;0;3;3
7938;Puriena;Ančiukų;90765300922;Taip;10;0;0;10
7939;Puriena;Ančiukų;54803470430;Taip;0;2;0;2
7940;Puriena;Ančiukų;27321768851;Taip;0;1;0;1
7941;Puriena;Ančiukų;17378740941;Taip;7;0;4;11
7942;Puriena;Ančiukų;78566741895;Taip;0;2;0;2
7943;Puriena;Ančiukų;69902514699;Taip;0;2;0;2
7944;Puriena;Ančiukų;54723251890;Taip;0;2;0;2
7945;Puriena;Ančiukų;54181308247;Taip;6;9;0;15
7946;Puriena;Ančiukų;86174474927;Taip;1;0;0;1
7947;Puriena;Ančiukų;85013789582;Taip;0;6;0;6
7948;Puriena;Ančiukų;93516016900;Taip;0;2;1;3
7949;Puriena;Ančiukų;61259599767;Taip;0;3;0;3
7950;Puriena;Ančiukų;84757305442;Taip;0;0;8;8
7951;Puriena;Ančiukų;50171510736;Taip;11;0;0;11
7952;Puriena;Ančiukų;48507270084;Taip;0;0;2;2
7953;Puriena;Ančiukų;88268169404;Taip;6;0;0;6
7954;Puriena;Ančiukų;9440991851;Taip;8;0;0;8
7955;Puriena;Ančiukų;1394510964;Taip;0;2;0;2
7956;Puriena;Ančiukų;73970752510;Taip;12;0;0;12
7957;Puriena;Drugeliai;7337038503;Taip;10;1;2;13
7958;Puriena;Drugeliai;47316276655;Taip;20;0;0;20
7959;Puriena;Drugeliai;48468411549;Taip;12;0;0;12
7960;Puriena;Drugeliai;20286870431;Taip;5;0;0;5
7961;Puriena;Drugeliai;63196502622;Taip;1;0;5;6
7962;Puriena;Drugeliai;11497629767;Taip;0;3;0;3
7963;Puriena;Drugeliai;2146036332;Taip;5;0;3;8
7964;Puriena;Drugeliai;1142929858;Taip;0;0;6;6
7965;Puriena;Drugeliai;1443945321;Taip;4;6;0;10
7966;Puriena;Drugeliai;1703078658;Taip;11;0;0;11
7967;Puriena;Drugeliai;2083071198;Taip;5;2;0;7
7968;Puriena;Drugeliai;8213725698;Taip;10;0;0;10
7969;Puriena;Drugeliai;2378865002;Taip;15;0;0;15
7970;Puriena;Drugeliai;5891404983;Taip;0;0;2;2
7971;Puriena;Drugeliai;9239618299;Taip;0;13;0;13
7972;Puriena;Drugeliai;2089174669;Taip;11;0;0;11
7973;Puriena;Drugeliai;2131343339;Taip;0;2;1;3
7974;Puriena;Drugeliai;1748337587;Taip;6;5;0;11
7975;Puriena;Drugeliai;1030958414;Taip;12;0;0;12
7976;Puriena;Drugeliai;8618298134;Taip;21;0;0;21
7977;Puriena;Drugeliai;8707076857;Taip;0;0;1;1
7978;Puriena;Drugeliai;1820719083;Taip;12;0;1;13
7979;Puriena;Drugeliai;4394023057;Taip;0;12;0;12
7980;Puriena;Pelėdžiukai;11431481909;Taip;0;6;0;6
7981;Puriena;Pelėdžiukai;53451774513;Taip;0;8;0;8
7982;Puriena;Pelėdžiukai;54048579160;Taip;0;12;0;12
7983;Puriena;Pelėdžiukai;43490363874;Taip;0;6;0;6
7984;Puriena;Pelėdžiukai;34689084311;Taip;0;3;0;3
7985;Puriena;Pelėdžiukai;21611180390;Taip;0;1;0;1
7986;Puriena;Pelėdžiukai;15016729899;Taip;0;2;0;2
7987;Puriena;Pelėdžiukai;11677252767;Taip;13;0;0;13
7988;Puriena;Pelėdžiukai;16437608299;Taip;0;8;0;8
7989;Puriena;Pelėdžiukai;69494886505;Taip;0;2;0;2
7990;Puriena;Pelėdžiukai;95972862152;Taip;5;2;0;7
7991;Puriena;Pelėdžiukai;51874022935;Taip;0;4;0;4
7992;Puriena;Pelėdžiukai;58791977007;Taip;0;1;0;1
7993;Puriena;Pelėdžiukai;53286108187;Taip;5;0;0;5
7994;Puriena;Pelėdžiukai;81806945761;Taip;0;6;0;6
7995;Puriena;Pelėdžiukai;26040866189;Taip;0;2;0;2
7996;Puriena;Pelėdžiukai;90508354565;Taip;0;2;0;2
7997;Puriena;Pelėdžiukai;95822432988;Taip;3;2;0;5
7998;Puriena;Pelėdžiukai;45627148409;Taip;0;5;0;5
7999;Puriena;Pelėdžiukai;2011809589;Taip;0;12;0;12
8000;Puriena;Voveriukai;23746358787;Taip;3;0;0;3
8001;Puriena;Voveriukai;6285846517;Taip;0;1;0;1
8002;Puriena;Voveriukai;5501308683;Taip;4;1;0;5
8003;Puriena;Voveriukai;92604925140;Taip;0;1;0;1
8004;Puriena;Voveriukai;1263637124;Taip;4;1;0;5
8005;Puriena;Voveriukai;1290933817;Taip;6;2;0;8
8006;Puriena;Voveriukai;7429832136;Taip;20;0;0;20
8007;Puriena;Voveriukai;2663832596;Taip;0;5;0;5
8008;Puriena;Voveriukai;4966293604;Taip;1;0;0;1
8009;Puriena;Voveriukai;2203259310;Taip;0;0;1;1
8010;Puriena;Voveriukai;40573980976;Taip;5;3;0;8
8011;Puriena;Voveriukai;1381379515;Taip;18;0;0;18
8012;Puriena;Voveriukai;6057477307;Taip;8;6;0;14
8013;Puriena;Voveriukai;1290962809;Taip;0;12;3;15
8014;Puriena;Voveriukai;11242620566;Taip;6;1;0;7
8015;Puriena;Voveriukai;9139110598;Taip;0;1;0;1
8016;Puriena;Voveriukai;8112003551;Taip;4;0;0;4
8017;Puriena;Voveriukai;9106525954;Taip;3;0;0;3
8018;Puriena;Voveriukai;5999564879;Taip;11;0;0;11
8019;Puriena;Voveriukai;9146447088;Taip;5;0;12;17
8020;Puriena;Voveriukai;8478901457;Taip;5;0;1;6
8021;Puriena;Bitučių;77708842205;Taip;0;2;1;3
8022;Puriena;Bitučių;67031288256;Taip;21;0;0;21
8023;Puriena;Bitučių;11169417266;Ne;5;2;0;7
8024;Puriena;Bitučių;45287018563;Taip;0;2;0;2
8025;Puriena;Bitučių;3538587188;Taip;0;1;0;1
8026;Puriena;Bitučių;25813179990;Taip;0;0;12;12
8027;Puriena;Bitučių;59762352185;Taip;0;1;0;1
8028;Puriena;Bitučių;6794972162;Taip;0;3;0;3
8029;Puriena;Bitučių;33307762315;Taip;0;0;1;1
8030;Puriena;Bitučių;65319170607;Taip;4;0;0;4
8031;Puriena;Bitučių;55441324338;Taip;0;1;0;1
8032;Puriena;Bitučių;10701053444;Taip;0;2;0;2
8033;Puriena;Bitučių;10530139834;Taip;4;2;0;6
8034;Puriena;Bitučių;85386780648;Taip;0;6;0;6
8035;Puriena;Bitučių;38994996491;Taip;0;2;2;4
8036;Puriena;Bitučių;65910898731;Taip;0;0;4;4
8037;Puriena;Zylutės;29931607789;Taip;14;0;0;14
8038;Puriena;Zylutės;5920910288;Taip;8;0;0;8
8039;Puriena;Zylutės;14052847763;Taip;8;1;0;9
8040;Puriena;Zylutės;46510003255;Taip;3;5;0;8
8041;Puriena;Zylutės;64733952400;Taip;7;7;3;17
8042;Puriena;Zylutės;1993142891;Taip;8;2;0;10
8043;Puriena;Zylutės;6539425730;Ne;20;1;0;21
8044;Puriena;Zylutės;88483773966;Taip;14;0;0;14
8045;Puriena;Zylutės;61706928693;Taip;0;1;0;1
8046;Puriena;Zylutės;45128021817;Taip;11;0;0;11
8047;Puriena;Zylutės;7285127722;Taip;7;1;0;8
8048;Puriena;Zylutės;63953968050;Ne;0;5;0;5
8049;Puriena;Zylutės;88595039240;Taip;9;1;0;10
8050;Puriena;Zylutės;65137815385;Taip;0;1;0;1
8051;Puriena;Zylutės;14780389529;Taip;5;0;0;5
8052;Puriena;Zylutės;54604607448;Taip;11;4;0;15
8053;Puriena;Zylutės;1994224209;Taip;0;8;0;8
8054;Puriena;Zylutės;27546501673;Taip;1;0;0;1
8055;Puriena;Meškučių;5026857195;Taip;0;2;0;2
8056;Puriena;Meškučių;88588968229;Taip;0;2;0;2
8057;Puriena;Meškučių;1758690169;Taip;9;2;0;11
8058;Puriena;Meškučių;25112307864;Taip;4;2;0;6
8059;Puriena;Meškučių;1240190350;Taip;0;2;3;5
8060;Puriena;Meškučių;19157486407;Taip;0;1;0;1
8061;Puriena;Meškučių;1557814435;Taip;0;1;0;1
8062;Puriena;Meškučių;87523460146;Taip;0;3;0;3
8063;Puriena;Meškučių;61241768982;Taip;12;4;0;16
8064;Puriena;Meškučių;4260334053;Taip;0;9;0;9
8065;Puriena;Meškučių;83821680276;Taip;1;0;0;1
8066;Puriena;Meškučių;71778035373;Taip;21;0;0;21
8067;Puriena;Meškučių;1184946421;Taip;15;1;0;16
8068;Puriena;Meškučių;61117212576;Taip;0;0;2;2
8069;Puriena;Meškučių;59193676476;Taip;0;4;0;4
8070;Puriena;Meškučių;91069175088;Taip;8;0;0;8
8071;Puriena;Meškučių;16572830524;Taip;0;1;0;1
8072;Puriena;Meškučių;18592085188;Taip;0;2;0;2
8073;Puriena;Meškučių;3327714361;Taip;0;0;3;3
8074;Puriena;Meškučių;1418776789;Taip;5;0;0;5
8075;Puriena;Nykštukų;71773966341;Taip;0;0;8;8
8076;Puriena;Nykštukų;85334594528;Taip;0;3;1;4
8077;Puriena;Nykštukų;1945542034;Taip;0;1;0;1
8078;Puriena;Nykštukų;79194353091;Taip;10;1;0;11
8079;Puriena;Nykštukų;1629458651;Taip;1;2;0;3
8080;Puriena;Nykštukų;91735621242;Taip;0;2;0;2
8081;Puriena;Nykštukų;5284316470;Taip;5;0;0;5
8082;Puriena;Nykštukų;1116529845;Taip;0;7;0;7
8083;Puriena;Nykštukų;98967026878;Taip;0;5;0;5
8084;Puriena;Nykštukų;8719239663;Taip;5;0;0;5
8085;Puriena;Nykštukų;1206969296;Taip;8;0;3;11
8086;Puriena;Nykštukų;84527348236;Ne;0;1;0;1
8087;Puriena;Nykštukų;24572685191;Taip;4;0;3;7
8088;Puriena;Nykštukų;95153406240;Taip;0;1;0;1
8089;Puriena;Nykštukų;1125102675;Taip;7;0;0;7
8090;Puriena;Nykštukų;29217326976;Taip;5;0;8;13
8091;Puriena;Nykštukų;1507059980;Taip;0;2;0;2
8092;Puriena;Ežiukai;1900570261;Taip;0;0;1;1
8093;Puriena;Ežiukai;1704296685;Taip;0;4;1;5
8094;Puriena;Ežiukai;1174355613;Taip;1;1;7;9
8095;Puriena;Ežiukai;2255508780;Taip;0;9;0;9
8096;Puriena;Ežiukai;35226601932;Taip;12;0;0;12
8097;Puriena;Ežiukai;2072874096;Taip;6;2;0;8
8098;Puriena;Ežiukai;11011727269;Taip;0;13;0;13
8099;Puriena;Ežiukai;87416314075;Taip;0;2;0;2
8100;Puriena;Ežiukai;1175577834;Taip;0;0;15;15
8101;Puriena;Ežiukai;1134539790;Taip;0;2;0;2
8102;Puriena;Ežiukai;9471669903;Taip;14;1;0;15
8103;Puriena;Ežiukai;1707413291;Taip;7;2;0;9
8104;Puriena;Ežiukai;1773431155;Taip;21;0;0;21
8105;Puriena;Ežiukai;21180207545;Taip;0;0;8;8
8106;Puriena;Ežiukai;1762395617;Taip;0;9;0;9
8107;Puriena;Ežiukai;1786569222;Taip;5;2;0;7
8108;Puriena;Ežiukai;41863686552;Taip;0;6;0;6
8109;Puriena;"Boružiukų ";3033562627;Taip;15;1;0;16
8110;Puriena;"Boružiukų ";5777076971;Taip;15;1;0;16
8111;Puriena;"Boružiukų ";5336923102;Taip;10;0;0;10
8112;Puriena;"Boružiukų ";7769252165;Taip;0;1;0;1
8113;Puriena;"Boružiukų ";2170025682;Taip;5;0;0;5
8114;Puriena;"Boružiukų ";1428098802;Taip;10;5;0;15
8115;Puriena;"Boružiukų ";3772941726;Taip;10;5;0;15
8116;Puriena;"Boružiukų ";4460575818;Taip;5;4;0;9
8117;Puriena;"Boružiukų ";4605662701;Taip;6;7;0;13
8118;Puriena;"Boružiukų ";8120597514;Taip;0;4;0;4
8119;Puriena;"Boružiukų ";4776745276;Taip;12;0;2;14
8120;Puriena;"Boružiukų ";6158842119;Taip;21;0;0;21
8121;Puriena;"Boružiukų ";3681811493;Taip;1;2;0;3
8122;Puriena;"Boružiukų ";4060087185;Taip;0;11;2;13
8123;Puriena;"Boružiukų ";8310231540;Taip;10;0;0;10
8124;Puriena;"Boružiukų ";1819876614;Taip;0;0;15;15
8125;Puriena;"Zuikučių ";6883573289;Taip;8;0;3;11
8126;Puriena;"Zuikučių ";1339162214;Taip;14;0;0;14
8127;Puriena;"Zuikučių ";4283608124;Taip;1;1;6;8
8128;Puriena;"Zuikučių ";8130975863;Taip;3;0;0;3
8129;Puriena;"Zuikučių ";2813562677;Taip;2;0;0;2
8130;Puriena;"Zuikučių ";6656013805;Taip;0;1;0;1
8131;Puriena;"Zuikučių ";3542374463;Taip;5;4;0;9
8132;Puriena;"Zuikučių ";7573536525;Taip;10;2;3;15
8133;Puriena;"Zuikučių ";8022809059;Taip;18;0;0;18
8134;Puriena;"Zuikučių ";4498919764;Taip;10;0;0;10
8135;Puriena;"Zuikučių ";5395382717;Taip;1;5;0;6
8136;Puriena;"Zuikučių ";4444523140;Taip;21;0;0;21
8137;Puriena;"Zuikučių ";1933733714;Taip;11;10;0;21
8138;Puriena;"Zuikučių ";7622407056;Taip;1;4;0;5
8139;Puriena;"Zuikučių ";6150437624;Taip;16;0;0;16
8140;Puriena;"Zuikučių ";6813480086;Taip;5;1;0;6
8141;Puriena;"Zuikučių ";9854244405;Taip;8;0;0;8
8142;Pušaitė;Kodėlčiukai;62054870153;Taip;13;0;0;13
8143;Pušaitė;Kodėlčiukai;1972872969;Taip;0;21;0;21
8144;Pušaitė;Kodėlčiukai;44525744411;Taip;10;0;0;10
8145;Pušaitė;Kodėlčiukai;1434600898;Taip;7;2;0;9
8146;Pušaitė;Kodėlčiukai;10978479164;Ne;10;2;2;14
8147;Pušaitė;Kodėlčiukai;10391045958;Taip;0;2;0;2
8148;Pušaitė;Kodėlčiukai;79462284429;Taip;0;2;1;3
8149;Pušaitė;Kodėlčiukai;51875651426;Taip;12;1;1;14
8150;Pušaitė;Kodėlčiukai;35587797387;Taip;0;7;1;8
8151;Pušaitė;Kodėlčiukai;36990708512;Taip;5;0;5;10
8152;Pušaitė;Kodėlčiukai;37480908997;Taip;10;2;5;17
8153;Pušaitė;Kodėlčiukai;81773729142;Taip;0;5;4;9
8154;Pušaitė;Kodėlčiukai;2856902024;Taip;0;21;0;21
8155;Pušaitė;Kodėlčiukai;10955132610;Taip;0;0;5;5
8156;Pušaitė;Kodėlčiukai;7680945149;Taip;4;2;0;6
8157;Pušaitė;Kodėlčiukai;1611231114;Taip;8;0;13;21
8158;Pušaitė;Kodėlčiukai;89687717250;Taip;0;1;3;4
8159;Pušaitė;Kodėlčiukai;3554790718;Taip;9;0;0;9
8160;Pušaitė;Kodėlčiukai;1912176781;Taip;0;4;0;4
8161;Pušaitė;Kodėlčiukai;20960105409;Taip;9;3;0;12
8162;Pušaitė;Kodėlčiukai;1444313482;Taip;0;1;2;3
8163;Pušaitė;Saulutės;29899199427;Taip;0;3;0;3
8164;Pušaitė;Saulutės;36646217833;Taip;0;3;6;9
8165;Pušaitė;Saulutės;40449072854;Taip;0;2;0;2
8166;Pušaitė;Saulutės;46097491628;Taip;0;2;0;2
8167;Pušaitė;Saulutės;2066639203;Taip;0;1;0;1
8168;Pušaitė;Saulutės;99740435577;Ne;6;2;0;8
8169;Pušaitė;Saulutės;34324686486;Taip;0;2;0;2
8170;Pušaitė;Saulutės;88286687854;Taip;0;4;0;4
8171;Pušaitė;Saulutės;1302087452;Taip;0;3;1;4
8172;Pušaitė;Saulutės;12326544543;Taip;0;1;0;1
8173;Pušaitė;Saulutės;61624123734;Taip;0;2;0;2
8174;Pušaitė;Saulutės;10115195053;Taip;0;0;4;4
8175;Pušaitė;Saulutės;22491605433;Taip;0;2;0;2
8176;Pušaitė;Saulutės;81155033460;Taip;0;1;0;1
8177;Pušaitė;Saulutės;1389123203;Taip;1;0;5;6
8178;Pušaitė;Saulutės;2030939996;Taip;0;2;0;2
8179;Pušaitė;Zuikučiai;2115591523;Taip;5;0;3;8
8180;Pušaitė;Zuikučiai;8738827821;Taip;3;0;0;3
8181;Pušaitė;Zuikučiai;2181510181;Taip;9;8;1;18
8182;Pušaitė;Zuikučiai;6306133416;Taip;18;0;1;19
8183;Pušaitė;Zuikučiai;2099169654;Taip;5;0;1;6
8184;Pušaitė;Zuikučiai;6355379926;Taip;11;0;2;13
8185;Pušaitė;Zuikučiai;9389544351;Taip;0;21;0;21
8186;Pušaitė;Zuikučiai;1296700534;Taip;3;1;0;4
8187;Pušaitė;Zuikučiai;51500717235;Taip;13;0;0;13
8188;Pušaitė;Zuikučiai;2125574493;Taip;0;0;3;3
8189;Pušaitė;Zuikučiai;5398532705;Taip;0;10;0;10
8190;Pušaitė;Zuikučiai;8309000712;Taip;10;0;0;10
8191;Pušaitė;Zuikučiai;4881689337;Taip;12;0;0;12
8192;Pušaitė;Zuikučiai;1295203136;Taip;7;0;0;7
8193;Pušaitė;Zuikučiai;6259961070;Taip;0;6;0;6
8194;Pušaitė;Zuikučiai;3813761666;Taip;0;0;21;21
8195;Pušaitė;Zuikučiai;4762094720;Taip;0;1;0;1
8196;Pušaitė;Zuikučiai;6600314608;Taip;11;0;0;11
8197;Pušaitė;Vėžliukai;23761715185;Taip;0;1;0;1
8198;Pušaitė;Vėžliukai;64592128211;Ne;0;2;0;2
8199;Pušaitė;Vėžliukai;1556107106;Taip;5;0;5;10
8200;Pušaitė;Vėžliukai;82231263639;Taip;4;0;1;5
8201;Pušaitė;Vėžliukai;2841816118;Taip;0;0;4;4
8202;Pušaitė;Vėžliukai;42099662246;Taip;7;2;1;10
8203;Pušaitė;Vėžliukai;18643269807;Taip;0;1;0;1
8204;Pušaitė;Vėžliukai;15673961087;Taip;0;1;0;1
8205;Pušaitė;Vėžliukai;57942390119;Taip;5;1;0;6
8206;Pušaitė;Vėžliukai;54773904854;Taip;6;6;2;14
8207;Pušaitė;Vėžliukai;24065238572;Ne;5;0;0;5
8208;Pušaitė;Vėžliukai;94185131317;Taip;0;21;0;21
8209;Pušaitė;Vėžliukai;49430231849;Taip;13;5;0;18
8210;Pušaitė;Vėžliukai;87253675662;Taip;0;1;0;1
8211;Pušaitė;Vėžliukai;85087765749;Taip;0;1;0;1
8212;Pušaitė;Vėžliukai;2452682364;Taip;0;5;0;5
8213;Pušaitė;Vėžliukai;7097481136;Taip;0;0;2;2
8214;Pušaitė;"Linksmieji nykštukai";78786009806;Taip;0;2;0;2
8215;Pušaitė;"Linksmieji nykštukai";44872108751;Taip;0;0;2;2
8216;Pušaitė;"Linksmieji nykštukai";8716642556;Taip;0;0;1;1
8217;Pušaitė;"Linksmieji nykštukai";64419428816;Taip;5;2;0;7
8218;Pušaitė;"Linksmieji nykštukai";60260690155;Taip;0;1;0;1
8219;Pušaitė;"Linksmieji nykštukai";97437734501;Taip;0;1;0;1
8220;Pušaitė;"Linksmieji nykštukai";1195830679;Taip;0;1;0;1
8221;Pušaitė;"Linksmieji nykštukai";31633196136;Taip;0;3;0;3
8222;Pušaitė;"Linksmieji nykštukai";49959888584;Taip;0;1;0;1
8223;Pušaitė;"Linksmieji nykštukai";43153897720;Taip;2;1;1;4
8224;Pušaitė;"Linksmieji nykštukai";35461910180;Taip;0;1;0;1
8225;Pušaitė;"Linksmieji nykštukai";62109955821;Taip;0;2;0;2
8226;Pušaitė;"Linksmieji nykštukai";3093517968;Ne;0;9;0;9
8227;Pušaitė;"Linksmieji nykštukai";2060782612;Taip;0;1;2;3
8228;Pušaitė;"Linksmieji nykštukai";1877125294;Taip;0;1;14;15
8229;Pušaitė;"Linksmieji nykštukai";3670887761;Taip;0;1;0;1
8230;Pušaitė;"Linksmieji nykštukai";1907401304;Taip;9;2;0;11
8231;Pušaitė;"Linksmieji nykštukai";2725492842;Taip;10;0;1;11
8232;Pušaitė;"Kačiukų trobelė";1665866520;Taip;0;0;12;12
8233;Pušaitė;"Kačiukų trobelė";78247116817;Taip;0;0;2;2
8234;Pušaitė;"Kačiukų trobelė";16304995570;Taip;0;10;1;11
8235;Pušaitė;"Kačiukų trobelė";4007278281;Taip;3;0;1;4
8236;Pušaitė;"Kačiukų trobelė";48012145823;Taip;0;2;0;2
8237;Pušaitė;"Kačiukų trobelė";41913267562;Taip;0;1;3;4
8238;Pušaitė;"Kačiukų trobelė";94141517569;Taip;10;2;0;12
8239;Pušaitė;"Kačiukų trobelė";50194950518;Taip;8;0;0;8
8240;Pušaitė;"Kačiukų trobelė";39697900885;Taip;0;0;3;3
8241;Pušaitė;"Kačiukų trobelė";48452579219;Taip;0;0;3;3
8242;Pušaitė;"Kačiukų trobelė";61421071205;Taip;0;1;0;1
8243;Pušaitė;"Kačiukų trobelė";37954589328;Taip;5;0;0;5
8244;Pušaitė;"Kačiukų trobelė";75933088658;Ne;0;3;0;3
8245;Pušaitė;"Kačiukų trobelė";96861089842;Taip;0;6;0;6
8246;Pušaitė;"Kačiukų trobelė";63041098317;Taip;0;2;0;2
8247;Pušaitė;"Kačiukų trobelė";1478137437;Ne;0;6;0;6
8248;Pušaitė;"Kačiukų trobelė";9124124056;Taip;0;1;2;3
8249;Pušaitė;"Kačiukų trobelė";3996667689;Taip;0;2;0;2
8250;Pušaitė;"Kačiukų trobelė";7216538264;Taip;0;1;0;1
8251;Pušaitė;"Kačiukų trobelė";5534494766;Taip;0;21;0;21
8252;Pušaitė;"Kačiukų trobelė";5354874010;Taip;0;21;0;21
8253;Pušaitė;Ežiukai;3577616212;Taip;0;2;0;2
8254;Pušaitė;Ežiukai;2090143259;Taip;0;0;2;2
8255;Pušaitė;Ežiukai;2951618391;Taip;0;2;0;2
8256;Pušaitė;Ežiukai;9524002395;Taip;0;2;0;2
8257;Pušaitė;Ežiukai;7305350540;Taip;15;1;0;16
8258;Pušaitė;Ežiukai;1111143593;Taip;5;0;0;5
8259;Pušaitė;Ežiukai;5394378197;Taip;0;6;0;6
8260;Pušaitė;Ežiukai;15270671089;Taip;0;1;0;1
8261;Pušaitė;Ežiukai;69869396094;Taip;0;2;0;2
8262;Pušaitė;Ežiukai;3359574190;Taip;0;1;0;1
8263;Pušaitė;Ežiukai;1143122778;Taip;10;0;0;10
8264;Pušaitė;Ežiukai;9461292576;Taip;10;0;0;10
8265;Pušaitė;Ežiukai;5185787803;Taip;4;0;1;5
8266;Pušaitė;Ežiukai;4671293211;Taip;1;0;0;1
8267;Pušaitė;Ežiukai;8958364766;Taip;11;0;0;11
8268;Pušaitė;Ežiukai;2983890410;Taip;11;0;0;11
8269;Pušaitė;Ežiukai;7808186865;Taip;0;1;0;1
8270;Pušaitė;Ežiukai;4842783897;Taip;6;0;0;6
8271;Pušaitė;Ežiukai;5436168234;Taip;0;0;2;2
8272;Pušaitė;Ežiukai;6472169278;Taip;7;1;0;8
8273;Pušaitė;Ežiukai;8021494509;Taip;0;21;0;21
8274;Pušaitė;Ežiukai;2172342063;Taip;9;3;0;12
8275;Pušaitė;"Gudručių šalis";6470721291;Taip;0;2;0;2
8276;Pušaitė;"Gudručių šalis";24768657107;Taip;8;1;0;9
8277;Pušaitė;"Gudručių šalis";15550007793;Taip;0;2;7;9
8278;Pušaitė;"Gudručių šalis";4386242143;Taip;9;1;0;10
8279;Pušaitė;"Gudručių šalis";9997642887;Taip;0;7;7;14
8280;Pušaitė;"Gudručių šalis";15546035138;Taip;0;1;0;1
8281;Pušaitė;"Gudručių šalis";79097991060;Taip;0;2;0;2
8282;Pušaitė;"Gudručių šalis";1275885492;Taip;0;3;0;3
8283;Pušaitė;"Gudručių šalis";40886746431;Taip;0;0;5;5
8284;Pušaitė;"Gudručių šalis";66025911973;Taip;0;15;0;15
8285;Pušaitė;"Gudručių šalis";90178990466;Taip;9;0;1;10
8286;Pušaitė;"Gudručių šalis";89985930634;Taip;5;2;0;7
8287;Pušaitė;"Gudručių šalis";4266368627;Ne;7;2;0;9
8288;Pušaitė;"Gudručių šalis";49973513385;Taip;0;4;0;4
8289;Pušaitė;"Gudručių šalis";89212112638;Taip;0;2;8;10
8290;Pušaitė;"Gudručių šalis";11297426946;Taip;1;0;2;3
8291;Pušaitė;"Gudručių šalis";67365323950;Taip;0;1;0;1
8292;Pušaitė;"Gudručių šalis";35947321028;Taip;0;21;0;21
8293;Pušaitė;"Gudručių šalis";1459628106;Taip;0;2;1;3
8294;Pušaitė;"Gudručių šalis";87504481892;Taip;0;2;0;2
8295;Pušaitė;"Gudručių šalis";6915619931;Taip;17;1;0;18
8296;Pušaitė;"Lapučių mokyklėlė";1108868901;Taip;0;0;3;3
8297;Pušaitė;"Lapučių mokyklėlė";1102988768;Taip;0;1;0;1
8298;Pušaitė;"Lapučių mokyklėlė";40417586835;Taip;0;3;1;4
8299;Pušaitė;"Lapučių mokyklėlė";91960884985;Taip;0;0;2;2
8300;Pušaitė;"Lapučių mokyklėlė";85343380637;Taip;0;1;2;3
8301;Pušaitė;"Lapučių mokyklėlė";2044213583;Taip;0;21;0;21
8302;Pušaitė;"Lapučių mokyklėlė";7408224942;Taip;4;2;0;6
8303;Pušaitė;"Lapučių mokyklėlė";1394847204;Taip;0;1;1;2
8304;Pušaitė;"Lapučių mokyklėlė";97778827111;Taip;0;2;4;6
8305;Pušaitė;"Lapučių mokyklėlė";21992678312;Taip;6;0;0;6
8306;Pušaitė;"Lapučių mokyklėlė";6667124375;Taip;2;2;0;4
8307;Pušaitė;"Lapučių mokyklėlė";41026183089;Taip;0;1;1;2
8308;Pušaitė;"Lapučių mokyklėlė";77082825248;Taip;9;0;0;9
8309;Pušaitė;"Lapučių mokyklėlė";1487637695;Taip;10;0;0;10
8310;Pušaitė;"Lapučių mokyklėlė";3231637165;Taip;0;1;0;1
8311;Pušaitė;"Lapučių mokyklėlė";6542917863;Taip;0;1;2;3
8312;Pušaitė;"VOVERIUKAI ";8438652029;Taip;0;0;6;6
8313;Pušaitė;"VOVERIUKAI ";5191894075;Taip;0;0;6;6
8314;Pušaitė;"VOVERIUKAI ";6180888008;Taip;8;0;1;9
8315;Pušaitė;"VOVERIUKAI ";9127444013;Taip;0;1;1;2
8316;Pušaitė;"VOVERIUKAI ";6578483902;Taip;6;6;1;13
8317;Pušaitė;"VOVERIUKAI ";3350461304;Taip;0;2;1;3
8318;Pušaitė;"VOVERIUKAI ";9313564235;Taip;14;0;0;14
8319;Pušaitė;"VOVERIUKAI ";1781601521;Taip;6;0;1;7
8320;Pušaitė;"VOVERIUKAI ";1024996364;Taip;5;0;2;7
8321;Pušaitė;"VOVERIUKAI ";4123080241;Taip;0;1;0;1
8322;Pušaitė;"VOVERIUKAI ";1161519408;Taip;0;21;0;21
8323;Pušaitė;"VOVERIUKAI ";8822285103;Taip;10;0;0;10
8324;Pušaitė;MEŠKUČIAI;3695016765;Taip;1;12;0;13
8325;Pušaitė;MEŠKUČIAI;5104111840;Taip;4;0;0;4
8326;Pušaitė;MEŠKUČIAI;1122112207;Taip;1;0;0;1
8327;Pušaitė;MEŠKUČIAI;1624587173;Taip;0;0;5;5
8328;Pušaitė;MEŠKUČIAI;5415680731;Taip;0;21;0;21
8329;Pušaitė;MEŠKUČIAI;3014180020;Taip;11;0;0;11
8330;Pušaitė;MEŠKUČIAI;9327636862;Taip;0;0;3;3
8331;Pušaitė;MEŠKUČIAI;4175909754;Taip;18;0;0;18
8332;Pušaitė;MEŠKUČIAI;1635528919;Taip;0;5;6;11
8333;Pušaitė;MEŠKUČIAI;3788392895;Taip;3;0;0;3
8334;Pušaitė;MEŠKUČIAI;2837439334;Taip;0;21;0;21
8335;Pušaitė;MEŠKUČIAI;7014914682;Taip;9;0;0;9
8336;Pušaitė;PELIUKAI;3130824742;Taip;5;1;0;6
8337;Pušaitė;PELIUKAI;9265357004;Taip;0;5;0;5
8338;Pušaitė;PELIUKAI;8793102437;Taip;1;12;0;13
8339;Pušaitė;PELIUKAI;3150144924;Taip;0;2;1;3
8340;Pušaitė;PELIUKAI;9390342572;Taip;16;1;0;17
8341;Pušaitė;PELIUKAI;9056933586;Taip;7;2;2;11
8342;Pušaitė;PELIUKAI;4517181474;Taip;0;1;0;1
8343;Pušaitė;PELIUKAI;9033615485;Taip;17;0;0;17
8344;Pušaitė;PELIUKAI;4605161267;Taip;6;8;0;14
8345;Pušaitė;PELIUKAI;7520393710;Taip;9;0;4;13
8346;Pušaitė;PELIUKAI;4374232593;Taip;6;0;0;6
8347;Pušaitė;PELIUKAI;6160825713;Taip;0;3;3;6
8348;Pušaitė;PELIUKAI;7898355721;Taip;1;0;9;10
8349;Pušaitė;PELIUKAI;3698808100;Taip;17;0;0;17
8350;Pušynėlis;PUMPURĖLIAI;2048377076;Taip;6;0;0;6
8351;Pušynėlis;PUMPURĖLIAI;23816147491;Taip;0;3;1;4
8352;Pušynėlis;PUMPURĖLIAI;9665845150;Taip;0;10;0;10
8353;Pušynėlis;PUMPURĖLIAI;1817179601;Taip;15;1;0;16
8354;Pušynėlis;PUMPURĖLIAI;4030500100;Taip;8;0;2;10
8355;Pušynėlis;PUMPURĖLIAI;8172450090;Taip;5;0;2;7
8356;Pušynėlis;PUMPURĖLIAI;9466109315;Taip;0;0;2;2
8357;Pušynėlis;PUMPURĖLIAI;76597184985;Taip;5;0;1;6
8358;Pušynėlis;PUMPURĖLIAI;1284674882;Taip;11;2;0;13
8359;Pušynėlis;PUMPURĖLIAI;9039274775;Taip;10;1;0;11
8360;Pušynėlis;PUMPURĖLIAI;2012089695;Taip;0;13;0;13
8361;Pušynėlis;PUMPURĖLIAI;6077698697;Taip;0;0;2;2
8362;Pušynėlis;PUMPURĖLIAI;25261143142;Taip;0;5;0;5
8363;Pušynėlis;PUMPURĖLIAI;35538053975;Taip;12;0;0;12
8364;Pušynėlis;PUMPURĖLIAI;3510202379;Taip;6;0;9;15
8365;Pušynėlis;PUMPURĖLIAI;9154108688;Taip;0;4;0;4
8366;Pušynėlis;PUMPURĖLIAI;7046421581;Taip;19;0;0;19
8367;Pušynėlis;PUMPURĖLIAI;3037031809;Taip;10;0;0;10
8368;Pušynėlis;PUMPURĖLIAI;6716726918;Taip;11;2;0;13
8369;Pušynėlis;SAULUTĖS;1415916851;Taip;9;1;0;10
8370;Pušynėlis;SAULUTĖS;93484950406;Taip;0;0;10;10
8371;Pušynėlis;SAULUTĖS;91759717760;Taip;0;9;1;10
8372;Pušynėlis;SAULUTĖS;15555681471;Taip;0;1;6;7
8373;Pušynėlis;SAULUTĖS;2431940444;Taip;0;8;0;8
8374;Pušynėlis;SAULUTĖS;58252435610;Taip;0;0;3;3
8375;Pušynėlis;SAULUTĖS;75716791245;Taip;0;12;0;12
8376;Pušynėlis;SAULUTĖS;40478713455;Taip;0;0;5;5
8377;Pušynėlis;SAULUTĖS;1253953853;Ne;0;4;0;4
8378;Pušynėlis;SAULUTĖS;39796631884;Taip;0;11;5;16
8379;Pušynėlis;SAULUTĖS;48050606382;Taip;0;1;0;1
8380;Pušynėlis;SAULUTĖS;79386112020;Taip;0;1;4;5
8381;Pušynėlis;SAULUTĖS;2042833795;Taip;3;2;0;5
8382;Pušynėlis;SAULUTĖS;74952593070;Taip;0;6;0;6
8383;Pušynėlis;SAULUTĖS;1610449906;Taip;0;3;0;3
8384;Pušynėlis;SAULUTĖS;8920359311;Taip;3;0;0;3
8385;Pušynėlis;SAULUTĖS;51835639636;Taip;0;11;0;11
8386;Pušynėlis;SAULUTĖS;32714964224;Taip;3;0;0;3
8387;Pušynėlis;SAULUTĖS;1863758087;Taip;9;1;0;10
8388;Pušynėlis;PRIEŠMOKYKLINĖ;45205911818;Taip;0;5;0;5
8389;Pušynėlis;PRIEŠMOKYKLINĖ;62127095103;Taip;0;1;0;1
8390;Pušynėlis;PRIEŠMOKYKLINĖ;72180767422;Taip;11;2;0;13
8391;Pušynėlis;PRIEŠMOKYKLINĖ;80673105992;Ne;0;7;0;7
8392;Pušynėlis;PRIEŠMOKYKLINĖ;1148988140;Taip;6;0;0;6
8393;Pušynėlis;PRIEŠMOKYKLINĖ;34354697329;Ne;3;1;2;6
8394;Pušynėlis;PRIEŠMOKYKLINĖ;17591358511;Taip;14;1;0;15
8395;Pušynėlis;PRIEŠMOKYKLINĖ;6823339260;Taip;0;7;0;7
8396;Pušynėlis;PRIEŠMOKYKLINĖ;45123764353;Taip;7;1;0;8
8397;Pušynėlis;PRIEŠMOKYKLINĖ;23088088585;Taip;4;2;0;6
8398;Pušynėlis;PRIEŠMOKYKLINĖ;81276442183;Taip;0;1;11;12
8399;Pušynėlis;PRIEŠMOKYKLINĖ;53367560890;Taip;0;3;0;3
8400;Pušynėlis;PRIEŠMOKYKLINĖ;6577939120;Taip;0;1;2;3
8401;Pušynėlis;PRIEŠMOKYKLINĖ;21260292631;Taip;0;1;1;2
8402;Pušynėlis;PRIEŠMOKYKLINĖ;75612576422;Taip;3;2;0;5
8403;Pušynėlis;PRIEŠMOKYKLINĖ;24035278105;Taip;0;1;10;11
8404;Pušynėlis;PRIEŠMOKYKLINĖ;68201469907;Taip;0;1;1;2
8405;Pušynėlis;PRIEŠMOKYKLINĖ;61363661998;Taip;0;2;0;2
8406;Pušynėlis;PRIEŠMOKYKLINĖ;21082691040;Taip;0;1;0;1
8407;Pušynėlis;PRIEŠMOKYKLINĖ;80287782066;Taip;5;0;0;5
8408;Pušynėlis;PRIEŠMOKYKLINĖ;1224747660;Taip;4;5;0;9
8409;Pušynėlis;PRIEŠMOKYKLINĖ;1071102465;Taip;12;0;0;12
8410;Pušynėlis;LOPŠELIS;2141785580;Taip;0;11;0;11
8411;Pušynėlis;LOPŠELIS;2508640229;Taip;1;0;0;1
8412;Pušynėlis;LOPŠELIS;2793982816;Taip;12;0;0;12
8413;Pušynėlis;LOPŠELIS;1034336110;Taip;0;0;5;5
8414;Pušynėlis;LOPŠELIS;1610132076;Taip;0;0;1;1
8415;Pušynėlis;LOPŠELIS;4920818548;Taip;0;21;0;21
8416;Pušynėlis;LOPŠELIS;5236219294;Taip;5;0;2;7
8417;Pušynėlis;LOPŠELIS;6709692748;Taip;16;0;0;16
8418;Pušynėlis;LOPŠELIS;8799095053;Taip;0;2;0;2
8419;Pušynėlis;LOPŠELIS;5318223378;Taip;16;0;0;16
8420;Pušynėlis;LOPŠELIS;4052132379;Taip;12;0;1;13
8421;Pušynėlis;LOPŠELIS;8451160808;Taip;7;0;3;10
8422;Pušynėlis;LOPŠELIS;5897839636;Taip;0;10;0;10
8423;Raktelis;LAŠIUKAI;91578547534;Taip;0;1;0;1
8424;Raktelis;LAŠIUKAI;84902670203;Taip;0;1;0;1
8425;Raktelis;LAŠIUKAI;58035524929;Taip;0;4;0;4
8426;Raktelis;LAŠIUKAI;44697037907;Ne;0;1;0;1
8427;Raktelis;LAŠIUKAI;44404187711;Taip;0;8;0;8
8428;Raktelis;LAŠIUKAI;4050296775;Taip;0;1;0;1
8429;Raktelis;LAŠIUKAI;2586639003;Ne;0;1;0;1
8430;Raktelis;LAŠIUKAI;88421097745;Taip;0;2;0;2
8431;Raktelis;LAŠIUKAI;11398845304;Taip;0;2;0;2
8432;Raktelis;LAŠIUKAI;83327989096;Taip;0;1;0;1
8433;Raktelis;LAŠIUKAI;43111419596;Taip;5;2;0;7
8434;Raktelis;LAŠIUKAI;74848273145;Taip;0;7;0;7
8435;Raktelis;LAŠIUKAI;61588160544;Taip;0;3;0;3
8436;Raktelis;LAŠIUKAI;10029133549;Ne;0;3;0;3
8437;Raktelis;LAŠIUKAI;59965096201;Taip;0;2;0;2
8438;Raktelis;LAŠIUKAI;81622959801;Taip;0;2;0;2
8439;Raktelis;LAŠIUKAI;7486620978;Taip;8;3;0;11
8440;Raktelis;LAŠIUKAI;6358826871;Taip;4;1;0;5
8441;Raktelis;LAŠIUKAI;88714718433;Taip;0;2;0;2
8442;Raktelis;LAŠIUKAI;8495930552;Taip;0;1;0;1
8443;Raktelis;LAŠIUKAI;1508479097;Taip;10;2;0;12
8444;Raktelis;LAŠIUKAI;13722490194;Taip;0;5;0;5
8445;Raktelis;BITUTĖS;61636842808;Taip;0;0;1;1
8446;Raktelis;BITUTĖS;49216690763;Taip;0;0;2;2
8447;Raktelis;BITUTĖS;68578915107;Taip;8;1;0;9
8448;Raktelis;BITUTĖS;67716590566;Taip;10;3;0;13
8449;Raktelis;BITUTĖS;77068762851;Taip;0;0;2;2
8450;Raktelis;BITUTĖS;83366206408;Taip;0;2;0;2
8451;Raktelis;BITUTĖS;86120193313;Taip;0;0;1;1
8452;Raktelis;BITUTĖS;1224477393;Ne;0;6;0;6
8453;Raktelis;BITUTĖS;69445577844;Taip;0;2;0;2
8454;Raktelis;BITUTĖS;93797285418;Taip;0;1;0;1
8455;Raktelis;BITUTĖS;60619347523;Taip;21;0;0;21
8456;Raktelis;BITUTĖS;71909273139;Taip;1;0;0;1
8457;Raktelis;BITUTĖS;37587869107;Taip;0;1;0;1
8458;Raktelis;BITUTĖS;1544882634;Taip;10;2;0;12
8459;Raktelis;BITUTĖS;63051817818;Taip;0;3;0;3
8460;Raktelis;BITUTĖS;78841101231;Taip;1;0;2;3
8461;Raktelis;BITUTĖS;76758476679;Taip;19;0;0;19
8462;Raktelis;BITUTĖS;5663304735;Ne;0;10;0;10
8463;Raktelis;BITUTĖS;17270742947;Taip;0;8;0;8
8464;Raktelis;BITUTĖS;5392514118;Taip;0;3;10;13
8465;Raktelis;BITUTĖS;9774706725;Taip;5;2;2;9
8466;Raktelis;BITUTĖS;1455550617;Taip;0;0;1;1
8467;Raktelis;BORUŽĖLĖS;8117871963;Taip;0;0;7;7
8468;Raktelis;BORUŽĖLĖS;5031703240;Taip;7;0;0;7
8469;Raktelis;BORUŽĖLĖS;95104355224;Taip;1;2;0;3
8470;Raktelis;BORUŽĖLĖS;6049420030;Ne;0;0;3;3
8471;Raktelis;BORUŽĖLĖS;9313156299;Taip;0;2;3;5
8472;Raktelis;BORUŽĖLĖS;54221331553;Taip;2;3;0;5
8473;Raktelis;BORUŽĖLĖS;2070196225;Taip;10;5;0;15
8474;Raktelis;BORUŽĖLĖS;2303286473;Taip;0;3;0;3
8475;Raktelis;BORUŽĖLĖS;1192775994;Taip;0;5;0;5
8476;Raktelis;BORUŽĖLĖS;3609939325;Taip;5;0;0;5
8477;Raktelis;BORUŽĖLĖS;8374755632;Taip;17;0;1;18
8478;Raktelis;BORUŽĖLĖS;3345708690;Taip;3;0;0;3
8479;Raktelis;BORUŽĖLĖS;8245310502;Taip;21;0;0;21
8480;Raktelis;BORUŽĖLĖS;7487507324;Taip;0;2;0;2
8481;Raktelis;BORUŽĖLĖS;93271260871;Taip;0;16;0;16
8482;Raktelis;BORUŽĖLĖS;6779413882;Taip;17;0;0;17
8483;Raktelis;BORUŽĖLĖS;9584164290;Taip;0;6;0;6
8484;Raktelis;BORUŽĖLĖS;8410301417;Taip;3;0;0;3
8485;Raktelis;BORUŽĖLĖS;6854111162;Taip;5;2;0;7
8486;Raktelis;BORUŽĖLĖS;5818899732;Taip;6;0;0;6
8487;Raktelis;BORUŽĖLĖS;3762141936;Taip;0;2;0;2
8488;Raktelis;BORUŽĖLĖS;3713386556;Taip;0;7;0;7
8489;Raktelis;KAČIUKAI;8579864696;Taip;5;0;0;5
8490;Raktelis;KAČIUKAI;1393351147;Taip;6;0;0;6
8491;Raktelis;KAČIUKAI;27084497916;Taip;1;0;0;1
8492;Raktelis;KAČIUKAI;1063413424;Ne;10;4;3;17
8493;Raktelis;KAČIUKAI;4449411816;Taip;9;0;2;11
8494;Raktelis;KAČIUKAI;1623046697;Taip;0;0;1;1
8495;Raktelis;KAČIUKAI;87211875672;Taip;0;1;0;1
8496;Raktelis;KAČIUKAI;21063882404;Taip;0;1;2;3
8497;Raktelis;KAČIUKAI;78145437124;Taip;2;0;0;2
8498;Raktelis;KAČIUKAI;2143998936;Taip;0;1;0;1
8499;Raktelis;KAČIUKAI;4906678347;Taip;8;0;0;8
8500;Raktelis;KAČIUKAI;1567546511;Taip;0;13;0;13
8501;Raktelis;KAČIUKAI;86883305675;Taip;0;3;0;3
8502;Raktelis;KAČIUKAI;9380332489;Taip;0;1;0;1
8503;Raktelis;KAČIUKAI;30092089456;Taip;0;8;0;8
8504;Raktelis;KAČIUKAI;50372098009;Taip;10;0;0;10
8505;Raktelis;KAČIUKAI;1378192491;Taip;0;11;0;11
8506;Raktelis;KAČIUKAI;1457880868;Taip;21;0;0;21
8507;Raktelis;KAČIUKAI;4071338645;Taip;0;7;0;7
8508;Raktelis;KIŠKUČIAI;7170546710;Taip;13;6;0;19
8509;Raktelis;KIŠKUČIAI;1983808547;Taip;9;0;0;9
8510;Raktelis;KIŠKUČIAI;4905982507;Taip;7;2;3;12
8511;Raktelis;KIŠKUČIAI;6367875352;Taip;0;1;0;1
8512;Raktelis;KIŠKUČIAI;4317705126;Taip;2;0;1;3
8513;Raktelis;KIŠKUČIAI;1975411457;Taip;19;0;0;19
8514;Raktelis;KIŠKUČIAI;6199212999;Taip;5;4;0;9
8515;Raktelis;KIŠKUČIAI;2499890317;Taip;10;0;1;11
8516;Raktelis;KIŠKUČIAI;1843086151;Taip;2;0;1;3
8517;Raktelis;KIŠKUČIAI;5405322552;Taip;6;0;2;8
8518;Raktelis;KIŠKUČIAI;6281687751;Taip;1;0;0;1
8519;Raktelis;KIŠKUČIAI;6550851582;Taip;0;1;0;1
8520;Raktelis;KIŠKUČIAI;5492437864;Taip;10;6;1;17
8521;Raktelis;KIŠKUČIAI;9779789133;Taip;0;3;0;3
8522;Raktelis;KIŠKUČIAI;6102196040;Taip;0;3;0;3
8523;Raktelis;NYKŠTUKAI;5627179884;Taip;10;1;1;12
8524;Raktelis;NYKŠTUKAI;6608224825;Taip;0;9;0;9
8525;Raktelis;NYKŠTUKAI;9210856228;Taip;0;1;11;12
8526;Raktelis;NYKŠTUKAI;8873203690;Taip;0;5;0;5
8527;Raktelis;NYKŠTUKAI;2219712757;Taip;8;3;0;11
8528;Raktelis;NYKŠTUKAI;2807100092;Taip;10;2;0;12
8529;Raktelis;NYKŠTUKAI;5218387088;Taip;13;0;0;13
8530;Raktelis;NYKŠTUKAI;2753402906;Taip;1;2;0;3
8531;Raktelis;NYKŠTUKAI;9591285702;Taip;11;1;0;12
8532;Raktelis;NYKŠTUKAI;5925441742;Taip;13;0;0;13
8533;Raktelis;NYKŠTUKAI;9593639791;Taip;7;2;0;9
8534;Raktelis;NYKŠTUKAI;4658530212;Taip;13;0;0;13
8535;Raktelis;NYKŠTUKAI;9357757604;Taip;5;8;0;13
8536;Raktelis;NYKŠTUKAI;4335378625;Taip;4;2;0;6
8537;Raktelis;NYKŠTUKAI;7973137015;Taip;5;8;0;13
8538;Raktelis;NYKŠTUKAI;7265543701;Taip;4;1;0;5
8539;Raktelis;NYKŠTUKAI;1392036584;Taip;5;0;0;5
8540;Raktelis;NYKŠTUKAI;8459980712;Taip;9;2;0;11
8541;Raktelis;PELIUKAI;4610536784;Taip;5;0;0;5
8542;Raktelis;PELIUKAI;1109105359;Taip;5;3;0;8
8543;Raktelis;PELIUKAI;8320696048;Taip;5;0;0;5
8544;Raktelis;PELIUKAI;1453677708;Taip;7;1;0;8
8545;Raktelis;PELIUKAI;5768653399;Taip;16;0;0;16
8546;Raktelis;PELIUKAI;4583377785;Taip;10;2;0;12
8547;Raktelis;PELIUKAI;6385127914;Taip;7;0;0;7
8548;Raktelis;PELIUKAI;3884068578;Taip;5;0;0;5
8549;Raktelis;PELIUKAI;4228614834;Taip;7;2;0;9
8550;Raktelis;PELIUKAI;4755892641;Taip;0;1;0;1
8551;Raktelis;PELIUKAI;8353427144;Taip;19;1;0;20
8552;Raktelis;PELIUKAI;5082785025;Taip;12;0;0;12
8553;Raktelis;PELIUKAI;7869495911;Taip;4;0;0;4
8554;Raktelis;PELIUKAI;9130613710;Taip;1;6;0;7
8555;Raktelis;PELIUKAI;2282754345;Taip;5;0;0;5
8556;Raktelis;PELIUKAI;8869030487;Taip;10;0;0;10
8557;Raktelis;PELIUKAI;4167194960;Taip;5;0;2;7
8558;Raktelis;AGUONOS;1453259901;Taip;13;0;1;14
8559;Raktelis;AGUONOS;66327590524;Taip;0;7;0;7
8560;Raktelis;AGUONOS;6935703343;Taip;9;1;0;10
8561;Raktelis;AGUONOS;54361317676;Taip;0;5;0;5
8562;Raktelis;AGUONOS;5430563880;Taip;0;2;3;5
8563;Raktelis;AGUONOS;25504804011;Taip;0;3;0;3
8564;Raktelis;AGUONOS;12333424396;Taip;0;1;0;1
8565;Raktelis;AGUONOS;30483797110;Taip;0;2;1;3
8566;Raktelis;AGUONOS;61367764807;Taip;0;0;2;2
8567;Raktelis;AGUONOS;24160611392;Taip;0;17;0;17
8568;Raktelis;AGUONOS;55504358470;Taip;0;8;0;8
8569;Raktelis;AGUONOS;82549894936;Taip;0;7;0;7
8570;Raktelis;AGUONOS;874585350;Taip;11;0;0;11
8571;Raktelis;AGUONOS;79301972646;Taip;0;2;1;3
8572;Raktelis;AGUONOS;8796557675;Taip;15;0;0;15
8573;Raktelis;AGUONOS;1820583792;Taip;21;0;0;21
8574;Raktelis;AGUONOS;5711863758;Taip;0;2;1;3
8575;Raktelis;AGUONOS;1747834520;Taip;0;13;0;13
8576;Raktelis;AGUONOS;5000264125;Taip;0;6;0;6
8577;Raktelis;AGUONOS;53034039807;Taip;9;2;0;11
8578;Raktelis;AGUONOS;5802689482;Taip;14;3;0;17
8579;Raktelis;AGUONOS;6014726741;Taip;6;0;0;6
8580;Raktelis;LAPIUKŲ;8996622650;Taip;0;4;0;4
8581;Raktelis;LAPIUKŲ;51237034253;Taip;0;7;0;7
8582;Raktelis;LAPIUKŲ;1326855282;Taip;5;2;0;7
8583;Raktelis;LAPIUKŲ;92373834478;Ne;0;8;0;8
8584;Raktelis;LAPIUKŲ;68570148753;Taip;0;9;0;9
8585;Raktelis;LAPIUKŲ;27403835292;Taip;0;1;0;1
8586;Raktelis;LAPIUKŲ;10188975432;Taip;0;9;0;9
8587;Raktelis;LAPIUKŲ;14234831040;Taip;0;1;0;1
8588;Raktelis;LAPIUKŲ;15159708127;Taip;0;2;0;2
8589;Raktelis;LAPIUKŲ;25141529581;Taip;1;0;0;1
8590;Raktelis;LAPIUKŲ;43500434912;Taip;0;7;0;7
8591;Raktelis;LAPIUKŲ;9501202273;Taip;2;2;0;4
8592;Raktelis;LAPIUKŲ;98616285680;Taip;0;2;0;2
8593;Raktelis;LAPIUKŲ;54341630847;Taip;1;4;0;5
8594;Raktelis;LAPIUKŲ;1197826066;Taip;2;1;0;3
8595;Raktelis;LAPIUKŲ;4569798381;Taip;19;0;0;19
8596;Raktelis;LAPIUKŲ;1819514057;Ne;8;1;0;9
8597;Raktelis;LAPIUKŲ;67304194087;Taip;14;1;0;15
8598;Raktelis;LAPIUKŲ;15583558585;Taip;2;4;0;6
8599;Raktelis;PELĖDŽIUKAI;2985254060;Taip;6;0;0;6
8600;Raktelis;PELĖDŽIUKAI;59913848400;Taip;0;11;0;11
8601;Raktelis;PELĖDŽIUKAI;68390568000;Taip;1;2;2;5
8602;Raktelis;PELĖDŽIUKAI;61890775725;Taip;0;1;0;1
8603;Raktelis;PELĖDŽIUKAI;26764160130;Taip;0;0;2;2
8604;Raktelis;PELĖDŽIUKAI;79109699217;Taip;0;1;0;1
8605;Raktelis;PELĖDŽIUKAI;11937575740;Taip;0;2;0;2
8606;Raktelis;PELĖDŽIUKAI;34216516886;Taip;4;1;0;5
8607;Raktelis;PELĖDŽIUKAI;15685936471;Taip;6;0;0;6
8608;Raktelis;PELĖDŽIUKAI;24221829774;Taip;4;1;0;5
8609;Raktelis;PELĖDŽIUKAI;57958699478;Taip;0;2;0;2
8610;Raktelis;PELĖDŽIUKAI;46587243900;Taip;8;3;0;11
8611;Raktelis;PELĖDŽIUKAI;18646642032;Taip;0;1;0;1
8612;Raktelis;PELĖDŽIUKAI;5914986262;Taip;5;0;3;8
8613;Raktelis;PELĖDŽIUKAI;48454225305;Taip;8;1;0;9
8614;Raktelis;PELĖDŽIUKAI;32913698258;Taip;0;0;1;1
8615;Raktelis;PELĖDŽIUKAI;67378900057;Ne;0;0;1;1
8616;Raktelis;PELĖDŽIUKAI;38001876942;Taip;0;4;0;4
8617;Raktelis;PELĖDŽIUKAI;67756822733;Taip;10;0;0;10
8618;Raktelis;PELĖDŽIUKAI;82492627;Taip;5;1;0;6
8619;Rasa;Nykštukai;1846631921;Taip;0;5;0;5
8620;Rasa;Nykštukai;72152762554;Taip;0;1;0;1
8621;Rasa;Nykštukai;32724807082;Taip;0;5;0;5
8622;Rasa;Nykštukai;36336738780;Taip;1;1;0;2
8623;Rasa;Nykštukai;69640669835;Taip;1;2;0;3
8624;Rasa;Nykštukai;68980971096;Taip;7;0;0;7
8625;Rasa;Nykštukai;36874827315;Taip;0;4;0;4
8626;Rasa;Nykštukai;59339333069;Taip;0;4;0;4
8627;Rasa;Nykštukai;87310376118;Taip;8;5;0;13
8628;Rasa;Nykštukai;1067614202;Taip;6;1;4;11
8629;Rasa;Nykštukai;99521832856;Taip;11;0;0;11
8630;Rasa;Nykštukai;95625598016;Taip;5;0;0;5
8631;Rasa;Nykštukai;29141190550;Taip;0;6;0;6
8632;Rasa;Nykštukai;1549153022;Taip;5;0;0;5
8633;Rasa;Nykštukai;96518910021;Taip;3;1;0;4
8634;Rasa;Nykštukai;5108279813;Taip;2;1;0;3
8635;Rasa;"Širdelė mergaičių estetinio lavinimo grupė";2133989183;Taip;0;3;0;3
8636;Rasa;"Širdelė mergaičių estetinio lavinimo grupė";1883458628;Taip;1;3;0;4
8637;Rasa;"Širdelė mergaičių estetinio lavinimo grupė";1339376048;Taip;5;0;3;8
8638;Rasa;"Širdelė mergaičių estetinio lavinimo grupė";33479419656;Taip;0;1;0;1
8639;Rasa;"Širdelė mergaičių estetinio lavinimo grupė";3281315532;Taip;0;2;2;4
8640;Rasa;"Širdelė mergaičių estetinio lavinimo grupė";58858081077;Taip;0;6;0;6
8641;Rasa;"Širdelė mergaičių estetinio lavinimo grupė";56168039878;Taip;6;1;0;7
8642;Rasa;"Širdelė mergaičių estetinio lavinimo grupė";4601657045;Taip;0;5;0;5
8643;Rasa;"Širdelė mergaičių estetinio lavinimo grupė";2626361958;Taip;12;0;4;16
8644;Rasa;"Širdelė mergaičių estetinio lavinimo grupė";6976298054;Taip;0;3;0;3
8645;Rasa;"Širdelė mergaičių estetinio lavinimo grupė";2840872613;Taip;0;0;2;2
8646;Rasa;"Širdelė mergaičių estetinio lavinimo grupė";8866896989;Taip;0;16;0;16
8647;Rasa;"Širdelė mergaičių estetinio lavinimo grupė";13135367451;Taip;0;1;13;14
8648;Rasa;"Širdelė mergaičių estetinio lavinimo grupė";9648034081;Taip;0;1;0;1
8649;Rasa;"Širdelė mergaičių estetinio lavinimo grupė";5599182715;Taip;0;6;0;6
8650;Rasa;"Širdelė mergaičių estetinio lavinimo grupė";9938280570;Taip;0;5;0;5
8651;Rasa;"Širdelė mergaičių estetinio lavinimo grupė";91931863004;Taip;6;15;0;21
8652;Rasa;"Širdelė mergaičių estetinio lavinimo grupė";2132535297;Taip;0;1;3;4
8653;Rasa;"Širdelė mergaičių estetinio lavinimo grupė";23600769349;Taip;0;2;0;2
8654;Rasa;Meškiukai;8278928396;Taip;0;0;1;1
8655;Rasa;Meškiukai;8052120247;Taip;6;0;0;6
8656;Rasa;Meškiukai;1013865195;Taip;0;2;0;2
8657;Rasa;Meškiukai;72772661373;Taip;4;1;5;10
8658;Rasa;Meškiukai;63673920646;Taip;5;0;0;5
8659;Rasa;Meškiukai;4485715299;Taip;17;1;0;18
8660;Rasa;Meškiukai;52913880917;Taip;2;5;0;7
8661;Rasa;Meškiukai;5932187584;Taip;14;0;2;16
8662;Rasa;Meškiukai;5145978804;Taip;21;4;0;25
8663;Rasa;Meškiukai;8438563545;Taip;11;0;0;11
8664;Rasa;Meškiukai;6356448094;Taip;0;0;25;25
8665;Rasa;Meškiukai;2683897055;Taip;16;6;0;22
8666;Rasa;Meškiukai;4790859112;Taip;0;0;3;3
8667;Rasa;Meškiukai;7534548604;Taip;11;0;1;12
8668;Rasa;Meškiukai;7565880116;Taip;6;0;0;6
8669;Rasa;Meškiukai;7544963724;Taip;1;5;0;6
8670;Rasa;Meškiukai;3567565920;Taip;0;0;3;3
8671;Rasa;Sauliukai;68458114162;Taip;0;2;0;2
8672;Rasa;Sauliukai;42792180843;Taip;0;2;2;4
8673;Rasa;Sauliukai;34022508928;Taip;11;2;0;13
8674;Rasa;Sauliukai;12635625072;Taip;0;13;0;13
8675;Rasa;Sauliukai;18715553061;Taip;0;6;0;6
8676;Rasa;Sauliukai;30725310352;Taip;0;3;0;3
8677;Rasa;Sauliukai;37957299639;Taip;7;1;0;8
8678;Rasa;Sauliukai;2095297719;Taip;5;0;0;5
8679;Rasa;Sauliukai;84260038900;Taip;0;6;0;6
8680;Rasa;Sauliukai;8781212539;Taip;0;1;5;6
8681;Rasa;Sauliukai;92593352340;Taip;0;8;0;8
8682;Rasa;Sauliukai;41438771469;Taip;1;0;0;1
8683;Rasa;Sauliukai;2452794792;Taip;0;3;12;15
8684;Rasa;Sauliukai;79283195492;Taip;0;1;0;1
8685;Rasa;Sauliukai;51362685893;Taip;0;2;0;2
8686;Rasa;Sauliukai;9148315088;Taip;0;6;0;6
8687;Rasa;Sauliukai;89783044220;Taip;2;1;2;5
8688;Rasa;Sauliukai;69984722099;Taip;0;12;0;12
8689;Rasa;Sauliukai;1717387929;Taip;0;4;0;4
8690;Rasa;Sauliukai;35226191822;Taip;0;1;0;1
8691;Rasa;Smalsučiai;38570340276;Ne;6;2;0;8
8692;Rasa;Smalsučiai;1614333465;Taip;0;1;1;2
8693;Rasa;Smalsučiai;62152088598;Taip;0;3;0;3
8694;Rasa;Smalsučiai;47160008402;Taip;0;1;4;5
8695;Rasa;Smalsučiai;1860228984;Taip;0;1;0;1
8696;Rasa;Smalsučiai;61191043836;Taip;5;1;0;6
8697;Rasa;Smalsučiai;67603435279;Taip;7;1;1;9
8698;Rasa;Smalsučiai;18169786070;Taip;0;0;3;3
8699;Rasa;Smalsučiai;7873461118;Taip;0;11;0;11
8700;Rasa;Smalsučiai;2123727085;Taip;0;5;0;5
8701;Rasa;Smalsučiai;1011880741;Taip;0;1;1;2
8702;Rasa;Smalsučiai;1908234170;Ne;0;2;3;5
8703;Rasa;Smalsučiai;38285343302;Taip;0;1;0;1
8704;Rasa;Smalsučiai;35934308248;Taip;0;1;3;4
8705;Rasa;Smalsučiai;2100861702;Taip;12;1;0;13
8706;Rasa;Smalsučiai;1348331466;Taip;0;3;0;3
8707;Rasa;Smalsučiai;33210203210;Taip;8;2;0;10
8708;Rasa;Smalsučiai;79908276669;Taip;0;1;0;1
8709;Rasa;Smalsučiai;2639024477;Taip;0;0;2;2
8710;Rasa;Smalsučiai;27981379045;Taip;0;5;0;5
8711;Rasa;"Pelėdžiukai ";77589878141;Taip;0;1;2;3
8712;Rasa;"Pelėdžiukai ";1803769089;Taip;0;0;6;6
8713;Rasa;"Pelėdžiukai ";1311346161;Taip;12;2;0;14
8714;Rasa;"Pelėdžiukai ";1581241275;Taip;0;1;2;3
8715;Rasa;"Pelėdžiukai ";20587484061;Taip;8;0;0;8
8716;Rasa;"Pelėdžiukai ";1176606744;Taip;0;0;1;1
8717;Rasa;"Pelėdžiukai ";2121070882;Taip;0;0;8;8
8718;Rasa;"Pelėdžiukai ";1457384318;Taip;5;0;0;5
8719;Rasa;"Pelėdžiukai ";3884105235;Taip;0;1;4;5
8720;Rasa;"Pelėdžiukai ";1726266997;Taip;11;0;0;11
8721;Rasa;"Pelėdžiukai ";7558966891;Taip;4;0;0;4
8722;Rasa;"Pelėdžiukai ";3063226692;Ne;1;7;0;8
8723;Rasa;"Pelėdžiukai ";6773004268;Taip;5;0;18;23
8724;Rasa;"Pelėdžiukai ";3023088027;Taip;0;25;0;25
8725;Rasa;"Pelėdžiukai ";8953448462;Taip;10;0;0;10
8726;Rasa;"Pelėdžiukai ";5325275053;Taip;5;9;0;14
8727;Rasa;Katinėliai;69686196470;Taip;5;0;0;5
8728;Rasa;Katinėliai;18425735174;Taip;5;0;0;5
8729;Rasa;Katinėliai;52215260039;Taip;0;18;0;18
8730;Rasa;Katinėliai;3312448238;Taip;3;9;0;12
8731;Rasa;Katinėliai;6462106753;Taip;0;4;0;4
8732;Rasa;Katinėliai;97125416712;Ne;0;1;0;1
8733;Rasa;Katinėliai;19313431652;Taip;8;4;0;12
8734;Rasa;Katinėliai;67334304285;Taip;0;2;0;2
8735;Rasa;Katinėliai;1018965809;Taip;0;1;0;1
8736;Rasa;Katinėliai;1226974819;Ne;4;3;0;7
8737;Rasa;Katinėliai;7404447244;Taip;9;4;0;13
8738;Rasa;Katinėliai;74206773356;Taip;2;0;0;2
8739;Rasa;Katinėliai;6781449151;Taip;2;0;0;2
8740;Rasa;Katinėliai;88319654798;Taip;0;17;0;17
8741;Rasa;Katinėliai;95692605702;Taip;6;1;1;8
8742;Rasa;Katinėliai;33757319655;Ne;0;6;0;6
8743;Rasa;Katinėliai;45229725317;Taip;0;7;0;7
8744;Rasa;Katinėliai;1516629281;Taip;9;1;0;10
8745;Rasa;Ančiukai;7520665472;Taip;0;4;0;4
8746;Rasa;Ančiukai;7185331699;Taip;0;5;0;5
8747;Rasa;Ančiukai;1060810039;Taip;0;5;0;5
8748;Rasa;Ančiukai;2977737634;Taip;2;0;0;2
8749;Rasa;Ančiukai;8310400946;Taip;4;0;0;4
8750;Rasa;Ančiukai;9599510902;Taip;15;0;0;15
8751;Rasa;Ančiukai;7037958994;Taip;0;13;0;13
8752;Rasa;Ančiukai;9668538340;Taip;4;7;0;11
8753;Rasa;Ančiukai;4795339259;Taip;0;7;0;7
8754;Rasa;Ančiukai;3668598028;Taip;0;25;0;25
8755;Rasa;Ančiukai;6019853365;Taip;21;0;0;21
8756;Rasa;Ančiukai;4694111253;Taip;2;0;0;2
8757;Rasa;Ančiukai;6208444770;Taip;5;2;0;7
8758;Rasa;Ančiukai;3664125930;Ne;8;6;0;14
8759;Rasa;Ančiukai;7028605422;Taip;6;5;0;11
8760;Rasa;"Vyturiukai ";1210203141;Taip;0;1;4;5
8761;Rasa;"Vyturiukai ";7575833127;Taip;0;0;8;8
8762;Rasa;"Vyturiukai ";27131705540;Taip;0;2;0;2
8763;Rasa;"Vyturiukai ";1823276800;Taip;9;0;0;9
8764;Rasa;"Vyturiukai ";1651905746;Taip;0;5;0;5
8765;Rasa;"Vyturiukai ";66103644564;Taip;0;0;4;4
8766;Rasa;"Vyturiukai ";73115061371;Taip;3;5;0;8
8767;Rasa;"Vyturiukai ";1049242346;Taip;0;0;11;11
8768;Rasa;"Vyturiukai ";1179402963;Taip;0;11;0;11
8769;Rasa;"Vyturiukai ";1210340955;Taip;4;5;0;9
8770;Rasa;"Vyturiukai ";83227920971;Ne;1;0;0;1
8771;Rasa;"Vyturiukai ";34934099958;Taip;4;0;0;4
8772;Rasa;"Vyturiukai ";84161884493;Taip;0;0;6;6
8773;Rasa;"Vyturiukai ";1214055260;Taip;0;3;0;3
8774;Rasa;"Vyturiukai ";50186813736;Taip;4;0;6;10
8775;Rasa;"Vyturiukai ";2041098301;Taip;0;2;0;2
8776;Rasa;"Vyturiukai ";71420694152;Ne;10;0;4;14
8777;Rasa;"Vyturiukai ";1477555365;Taip;5;13;0;18
8778;Rasa;"Vyturiukai ";6344169010;Taip;5;0;0;5
8779;Rasa;Voveriukai;88779978297;Taip;0;1;0;1
8780;Rasa;Voveriukai;99911904705;Taip;0;4;0;4
8781;Rasa;Voveriukai;5201341227;Taip;0;0;1;1
8782;Rasa;Voveriukai;1267340581;Taip;0;0;1;1
8783;Rasa;Voveriukai;1558712079;Taip;0;13;0;13
8784;Rasa;Voveriukai;25918582395;Ne;6;1;0;7
8785;Rasa;Voveriukai;9890493148;Taip;4;1;0;5
8786;Rasa;Voveriukai;79439306932;Taip;0;8;0;8
8787;Rasa;Voveriukai;1728275988;Taip;11;0;1;12
8788;Rasa;Voveriukai;13286984288;Taip;5;1;0;6
8789;Rasa;Voveriukai;74744565967;Taip;9;0;0;9
8790;Rasa;Voveriukai;1452467682;Taip;0;1;1;2
8791;Rasa;Voveriukai;67288516242;Taip;0;6;0;6
8792;Rasa;Voveriukai;1093723298;Ne;0;5;0;5
8793;Rasa;Voveriukai;2879767810;Taip;0;13;0;13
8794;Rasa;Voveriukai;2158444381;Taip;0;1;1;2
8795;Rasa;Voveriukai;5589971159;Taip;1;0;1;2
8796;Rasa;"DRUGELIAI ";4847544355;Taip;5;0;2;7
8797;Rasa;"DRUGELIAI ";9847597133;Taip;0;5;0;5
8798;Rasa;"DRUGELIAI ";1386880644;Taip;7;0;3;10
8799;Rasa;"DRUGELIAI ";1223962374;Taip;0;1;0;1
8800;Rasa;"DRUGELIAI ";1336291828;Taip;11;1;0;12
8801;Rasa;"DRUGELIAI ";3200377629;Taip;14;0;0;14
8802;Rasa;"DRUGELIAI ";3979273111;Taip;0;3;0;3
8803;Rasa;"DRUGELIAI ";5176175108;Taip;16;0;1;17
8804;Rasa;"DRUGELIAI ";5363748728;Taip;4;0;0;4
8805;Rasa;"DRUGELIAI ";7004232909;Taip;5;0;1;6
8806;Rasa;"DRUGELIAI ";9723040721;Taip;7;0;0;7
8807;Rasa;"DRUGELIAI ";7228037580;Taip;0;3;0;3
8808;Rasa;"DRUGELIAI ";5861229664;Taip;6;0;0;6
8809;Rasa;"DRUGELIAI ";2540124793;Taip;17;0;0;17
8810;Rasa;"DRUGELIAI ";2093263887;Taip;4;0;0;4
8811;Rasa;Zuikučiai;1916783052;Taip;0;1;0;1
8812;Rasa;Zuikučiai;2137321989;Taip;0;13;0;13
8813;Rasa;Zuikučiai;1860462451;Taip;13;0;0;13
8814;Rasa;Zuikučiai;42609897431;Taip;0;5;0;5
8815;Rasa;Zuikučiai;55374082940;Taip;0;11;0;11
8816;Rasa;Zuikučiai;2114613635;Taip;0;1;0;1
8817;Rasa;Zuikučiai;56016538926;Taip;0;0;2;2
8818;Rasa;Zuikučiai;7397794681;Taip;0;0;6;6
8819;Rasa;Zuikučiai;7657119471;Taip;0;13;0;13
8820;Rasa;Zuikučiai;13297122928;Taip;6;0;0;6
8821;Rasa;Zuikučiai;6795591746;Taip;0;11;0;11
8822;Rasa;Zuikučiai;6108187043;Taip;0;3;0;3
8823;Rasa;Zuikučiai;1560278351;Taip;5;1;0;6
8824;Rasa;Zuikučiai;26384431360;Taip;0;1;3;4
8825;Rasa;Zuikučiai;1690518970;Taip;10;0;0;10
8826;Rasa;Zuikučiai;1131418692;Taip;0;4;0;4
8827;Riešutėlis;Viščiukų;1782544949;Taip;0;5;0;5
8828;Riešutėlis;Viščiukų;91799192513;Taip;4;0;0;4
8829;Riešutėlis;Viščiukų;50427986973;Taip;11;3;0;14
8830;Riešutėlis;Viščiukų;4098825502;Taip;3;1;0;4
8831;Riešutėlis;Viščiukų;28855582790;Taip;1;1;0;2
8832;Riešutėlis;Viščiukų;2131349938;Taip;2;8;0;10
8833;Riešutėlis;Viščiukų;41275727334;Taip;15;0;0;15
8834;Riešutėlis;Viščiukų;98456292572;Taip;0;5;0;5
8835;Riešutėlis;Viščiukų;63919369801;Taip;5;2;0;7
8836;Riešutėlis;Viščiukų;85564700996;Taip;5;0;0;5
8837;Riešutėlis;Viščiukų;2146831972;Taip;3;5;0;8
8838;Riešutėlis;Viščiukų;61571638960;Taip;7;0;0;7
8839;Riešutėlis;Viščiukų;8857939937;Taip;3;1;0;4
8840;Riešutėlis;Viščiukų;1957794151;Taip;5;7;0;12
8841;Riešutėlis;Viščiukų;5520818573;Taip;7;1;0;8
8842;Riešutėlis;Viščiukų;1743324657;Taip;3;1;0;4
8843;Riešutėlis;Viščiukų;1792212841;Taip;14;3;0;17
8844;Riešutėlis;Viščiukų;1930481567;Taip;0;0;1;1
8845;Riešutėlis;Viščiukų;86455801201;Taip;3;0;2;5
8846;Riešutėlis;Viščiukų;93958381534;Taip;0;3;0;3
8847;Riešutėlis;Viščiukų;1532275496;Taip;7;0;1;8
8848;Riešutėlis;Viščiukų;4311016578;Taip;9;0;1;10
8849;Riešutėlis;Viščiukų;2201158918;Taip;0;3;0;3
8850;Riešutėlis;Viščiukų;4229384438;Taip;2;1;0;3
8851;Riešutėlis;"Riešutėliai ";8077135868;Taip;21;0;0;21
8852;Riešutėlis;"Riešutėliai ";84116863778;Taip;0;5;1;6
8853;Riešutėlis;"Riešutėliai ";1077680441;Taip;7;0;0;7
8854;Riešutėlis;"Riešutėliai ";1430255154;Taip;0;5;0;5
8855;Riešutėlis;"Riešutėliai ";90082848356;Taip;15;1;0;16
8856;Riešutėlis;"Riešutėliai ";6097581240;Taip;0;7;1;8
8857;Riešutėlis;"Riešutėliai ";55620350407;Taip;7;0;0;7
8858;Riešutėlis;"Riešutėliai ";57437627642;Ne;0;1;0;1
8859;Riešutėlis;"Riešutėliai ";2035669978;Taip;0;2;5;7
8860;Riešutėlis;"Riešutėliai ";1105598415;Taip;4;0;0;4
8861;Riešutėlis;"Riešutėliai ";11913461630;Taip;11;0;0;11
8862;Riešutėlis;"Riešutėliai ";1674871670;Taip;5;3;0;8
8863;Riešutėlis;"Riešutėliai ";1853283967;Taip;0;0;1;1
8864;Riešutėlis;"Riešutėliai ";49061075792;Taip;0;12;0;12
8865;Riešutėlis;"Riešutėliai ";1532633795;Taip;0;0;10;10
8866;Riešutėlis;"Riešutėliai ";6855553238;Taip;0;0;7;7
8867;Riešutėlis;"Riešutėliai ";3806836220;Taip;0;1;3;4
8868;Riešutėlis;"Riešutėliai ";16308059025;Taip;6;1;0;7
8869;Riešutėlis;"Riešutėliai ";9023304543;Taip;5;2;0;7
8870;Riešutėlis;"Riešutėliai ";1941869661;Taip;0;2;0;2
8871;Riešutėlis;Ežiukai;68367330775;Taip;14;0;2;16
8872;Riešutėlis;Ežiukai;80570358139;Taip;4;0;0;4
8873;Riešutėlis;Ežiukai;8407612029;Taip;0;3;0;3
8874;Riešutėlis;Ežiukai;83564208896;Taip;5;1;0;6
8875;Riešutėlis;Ežiukai;45372107189;Taip;0;0;10;10
8876;Riešutėlis;Ežiukai;1659653711;Taip;12;2;0;14
8877;Riešutėlis;Ežiukai;20330297586;Taip;2;3;0;5
8878;Riešutėlis;Ežiukai;52227650850;Taip;0;2;0;2
8879;Riešutėlis;Ežiukai;66558189779;Taip;0;11;0;11
8880;Riešutėlis;Ežiukai;62003857623;Taip;6;2;2;10
8881;Riešutėlis;Ežiukai;23972193661;Taip;0;3;0;3
8882;Riešutėlis;Ežiukai;54820388507;Taip;0;7;0;7
8883;Riešutėlis;Ežiukai;32134152672;Taip;0;1;0;1
8884;Riešutėlis;Ežiukai;1579325190;Taip;4;0;1;5
8885;Riešutėlis;Ežiukai;57828137061;Taip;4;5;0;9
8886;Riešutėlis;Ežiukai;48055109138;Taip;0;11;0;11
8887;Riešutėlis;Ežiukai;69587584156;Taip;5;1;0;6
8888;Riešutėlis;Ežiukai;59086252488;Taip;0;1;0;1
8889;Riešutėlis;Ežiukai;9485880468;Taip;0;1;0;1
8890;Riešutėlis;Ežiukai;3626122579;Taip;0;0;3;3
8891;Riešutėlis;Ežiukai;2378768167;Taip;14;1;0;15
8892;Riešutėlis;Ežiukai;1320515966;Taip;17;0;0;17
8893;Riešutėlis;Pelėdžiukai;89573913251;Taip;0;5;0;5
8894;Riešutėlis;Pelėdžiukai;6303767779;Taip;5;0;8;13
8895;Riešutėlis;Pelėdžiukai;8018914251;Taip;0;1;0;1
8896;Riešutėlis;Pelėdžiukai;8012201566;Taip;8;5;0;13
8897;Riešutėlis;Pelėdžiukai;8751571852;Taip;12;0;0;12
8898;Riešutėlis;Pelėdžiukai;5479780116;Taip;1;1;0;2
8899;Riešutėlis;Pelėdžiukai;7225365172;Taip;9;0;0;9
8900;Riešutėlis;Pelėdžiukai;9839084885;Taip;0;0;3;3
8901;Riešutėlis;Pelėdžiukai;6928558714;Taip;0;0;1;1
8902;Riešutėlis;Pelėdžiukai;6405116059;Taip;4;0;3;7
8903;Riešutėlis;Pelėdžiukai;5995176001;Taip;1;2;0;3
8904;Riešutėlis;Pelėdžiukai;2430518637;Taip;0;12;0;12
8905;Riešutėlis;Pelėdžiukai;3970874098;Taip;0;1;0;1
8906;Riešutėlis;Pelėdžiukai;4451419273;Taip;8;9;0;17
8907;Riešutėlis;Pelėdžiukai;1638021880;Taip;7;0;1;8
8908;Riešutėlis;Pelėdžiukai;4581184004;Taip;6;0;0;6
8909;Riešutėlis;Pelėdžiukai;5598052531;Taip;1;0;0;1
8910;Riešutėlis;Pelėdžiukai;5282039544;Ne;0;0;3;3
8911;Riešutėlis;Meškiukai;1485215618;Taip;0;5;0;5
8912;Riešutėlis;Meškiukai;54091928168;Taip;0;3;0;3
8913;Riešutėlis;Meškiukai;35918917950;Taip;15;3;0;18
8914;Riešutėlis;Meškiukai;14272401750;Taip;5;0;0;5
8915;Riešutėlis;Meškiukai;37951030398;Taip;3;0;0;3
8916;Riešutėlis;Meškiukai;61160276176;Taip;10;0;0;10
8917;Riešutėlis;Meškiukai;75116205075;Taip;0;2;0;2
8918;Riešutėlis;Meškiukai;50016291414;Taip;0;0;2;2
8919;Riešutėlis;Meškiukai;76883335437;Taip;2;0;1;3
8920;Riešutėlis;Meškiukai;82203033052;Taip;10;1;2;13
8921;Riešutėlis;Meškiukai;30351563466;Taip;0;7;0;7
8922;Riešutėlis;Meškiukai;54175641919;Taip;0;1;0;1
8923;Riešutėlis;Meškiukai;86230171561;Taip;0;1;0;1
8924;Riešutėlis;Meškiukai;7435155136;Taip;2;0;1;3
8925;Riešutėlis;Meškiukai;12005650217;Taip;0;5;0;5
8926;Riešutėlis;Meškiukai;14480798602;Taip;0;1;0;1
8927;Riešutėlis;Meškiukai;17419936511;Taip;4;2;0;6
8928;Riešutėlis;Meškiukai;6201042890;Taip;0;3;1;4
8929;Riešutėlis;Meškiukai;2815239542;Taip;8;0;0;8
8930;Riešutėlis;Meškiukai;8927730307;Taip;3;0;0;3
8931;Riešutėlis;Meškiukai;3722925159;Taip;21;0;0;21
8932;Riešutėlis;Kiškučiai;90088217854;Taip;5;1;0;6
8933;Riešutėlis;Kiškučiai;60941759790;Taip;0;1;0;1
8934;Riešutėlis;Kiškučiai;92159110899;Taip;0;0;1;1
8935;Riešutėlis;Kiškučiai;1623455993;Taip;15;1;0;16
8936;Riešutėlis;Kiškučiai;96066602684;Taip;5;0;0;5
8937;Riešutėlis;Kiškučiai;55715445788;Taip;0;1;0;1
8938;Riešutėlis;Kiškučiai;1747328573;Taip;0;5;0;5
8939;Riešutėlis;Kiškučiai;1250209796;Taip;0;14;0;14
8940;Riešutėlis;Kiškučiai;1526573984;Taip;4;0;0;4
8941;Riešutėlis;Kiškučiai;50338275044;Taip;0;11;0;11
8942;Riešutėlis;Kiškučiai;18310744085;Taip;0;1;0;1
8943;Riešutėlis;Kiškučiai;35876952602;Taip;7;0;0;7
8944;Riešutėlis;Kiškučiai;1748738558;Taip;13;0;0;13
8945;Riešutėlis;Kiškučiai;93192056557;Taip;3;0;4;7
8946;Riešutėlis;Kiškučiai;9205961122;Taip;0;0;2;2
8947;Riešutėlis;Kiškučiai;2163433983;Taip;5;0;5;10
8948;Riešutėlis;Kiškučiai;4916885450;Taip;0;16;5;21
8949;Riešutėlis;Voveriukų;6500567162;Taip;0;11;0;11
8950;Riešutėlis;Voveriukų;9081486438;Taip;0;5;0;5
8951;Riešutėlis;Voveriukų;1212829190;Taip;19;0;0;19
8952;Riešutėlis;Voveriukų;59279444190;Taip;6;0;0;6
8953;Riešutėlis;Voveriukų;31417468379;Taip;3;1;0;4
8954;Riešutėlis;Voveriukų;1065105725;Taip;4;1;0;5
8955;Riešutėlis;Voveriukų;36176126840;Taip;0;1;0;1
8956;Riešutėlis;Voveriukų;26053212952;Taip;0;1;0;1
8957;Riešutėlis;Voveriukų;51840071269;Taip;0;1;0;1
8958;Riešutėlis;Voveriukų;70549617521;Taip;0;1;0;1
8959;Riešutėlis;Voveriukų;36161702165;Taip;9;0;0;9
8960;Riešutėlis;Voveriukų;46444683383;Taip;0;2;0;2
8961;Riešutėlis;Voveriukų;56426084480;Taip;0;1;0;1
8962;Riešutėlis;Voveriukų;65629075580;Taip;0;5;0;5
8963;Riešutėlis;Voveriukų;50971787753;Taip;0;1;0;1
8964;Riešutėlis;Voveriukų;89384403521;Taip;0;7;0;7
8965;Riešutėlis;Voveriukų;64736615832;Taip;5;0;0;5
8966;Riešutėlis;Voveriukų;29751938918;Taip;9;0;6;15
8967;Riešutėlis;Saulutės;9198963882;Taip;15;1;0;16
8968;Riešutėlis;Saulutės;2111280879;Taip;0;2;0;2
8969;Riešutėlis;Saulutės;1190403952;Taip;0;1;0;1
8970;Riešutėlis;Saulutės;1160573638;Taip;13;2;0;15
8971;Riešutėlis;Saulutės;1056034480;Taip;11;1;0;12
8972;Riešutėlis;Saulutės;1136025173;Taip;0;0;21;21
8973;Riešutėlis;Saulutės;2112179980;Taip;13;1;0;14
8974;Riešutėlis;Saulutės;2851186469;Taip;10;0;0;10
8975;Riešutėlis;Saulutės;7207507008;Taip;0;2;4;6
8976;Riešutėlis;Saulutės;8749505821;Taip;0;1;0;1
8977;Riešutėlis;Saulutės;1169051233;Taip;3;4;0;7
8978;Riešutėlis;Saulutės;1091941952;Taip;12;0;0;12
8979;Riešutėlis;Saulutės;24776322315;Taip;10;1;0;11
8980;Riešutėlis;Saulutės;7912773569;Taip;4;12;0;16
8981;Riešutėlis;Saulutės;2655848313;Taip;7;1;0;8
8982;Riešutėlis;Saulutės;4898775561;Taip;0;5;0;5
8983;Riešutėlis;Saulutės;6402032861;Taip;16;0;0;16
8984;Riešutėlis;Saulutės;5717194707;Taip;7;1;0;8
8985;Riešutėlis;Saulutės;5537309549;Taip;9;2;4;15
8986;Riešutėlis;Saulutės;8271632629;Taip;0;1;0;1
8987;Riešutėlis;"Boruželės ";16561622902;Taip;0;2;0;2
8988;Riešutėlis;"Boruželės ";56117509354;Taip;9;6;0;15
8989;Riešutėlis;"Boruželės ";1936519033;Taip;14;0;0;14
8990;Riešutėlis;"Boruželės ";2611705234;Taip;10;0;0;10
8991;Riešutėlis;"Boruželės ";4131218911;Taip;6;0;0;6
8992;Riešutėlis;"Boruželės ";1455509576;Taip;10;2;2;14
8993;Riešutėlis;"Boruželės ";3577669231;Taip;9;0;0;9
8994;Riešutėlis;"Boruželės ";9670912357;Taip;6;0;1;7
8995;Riešutėlis;"Boruželės ";26781529460;Taip;6;0;3;9
8996;Riešutėlis;"Boruželės ";5097410462;Taip;0;0;1;1
8997;Riešutėlis;"Boruželės ";4344185375;Taip;0;9;0;9
8998;Riešutėlis;"Boruželės ";8936419431;Taip;1;2;1;4
8999;Riešutėlis;"Boruželės ";8087180983;Taip;0;21;0;21
9000;Riešutėlis;"Boruželės ";4276034784;Taip;0;0;4;4
9001;Riešutėlis;"Boruželės ";2566084613;Taip;1;10;0;11
9002;Riešutėlis;"Boruželės ";1640383686;Taip;14;0;0;14
9003;Riešutėlis;"Boruželės ";3851000866;Taip;0;1;6;7
9004;Riešutėlis;"Boruželės ";1623681835;Taip;10;0;0;10
9005;Riešutėlis;"Bitutės ";1000408690;Taip;0;6;0;6
9006;Riešutėlis;"Bitutės ";54011982803;Taip;0;2;0;2
9007;Riešutėlis;"Bitutės ";4366097328;Taip;0;5;0;5
9008;Riešutėlis;"Bitutės ";2395648260;Taip;0;16;0;16
9009;Riešutėlis;"Bitutės ";4480906648;Taip;21;0;0;21
9010;Riešutėlis;"Bitutės ";86647499063;Taip;12;0;0;12
9011;Riešutėlis;"Bitutės ";6852846350;Taip;0;2;0;2
9012;Riešutėlis;"Bitutės ";13815744901;Taip;2;0;0;2
9013;Riešutėlis;"Bitutės ";91430094368;Taip;0;6;0;6
9014;Riešutėlis;"Bitutės ";4897379979;Taip;6;0;0;6
9015;Riešutėlis;"Bitutės ";65873300738;Taip;0;5;0;5
9016;Riešutėlis;"Bitutės ";8313605541;Taip;2;1;1;4
9017;Riešutėlis;"Bitutės ";1921241349;Taip;0;2;3;5
9018;Riešutėlis;Drugelių;8266735624;Taip;0;2;0;2
9019;Riešutėlis;Drugelių;4776231497;Taip;0;2;0;2
9020;Riešutėlis;Drugelių;5753609922;Taip;0;21;0;21
9021;Riešutėlis;Drugelių;8578903763;Taip;8;2;0;10
9022;Riešutėlis;Drugelių;3975091711;Taip;9;0;0;9
9023;Riešutėlis;Drugelių;6194259707;Taip;4;0;0;4
9024;Riešutėlis;Drugelių;7769079730;Taip;0;1;0;1
9025;Riešutėlis;Drugelių;5811657782;Taip;5;5;0;10
9026;Riešutėlis;Drugelių;4221375847;Taip;0;21;0;21
9027;Riešutėlis;Drugelių;8016820352;Taip;6;0;0;6
9028;Riešutėlis;Drugelių;1942944625;Taip;0;1;0;1
9029;Riešutėlis;Drugelių;8845709386;Taip;1;5;0;6
9030;Riešutėlis;Drugelių;8352146446;Taip;2;0;0;2
9031;Riešutėlis;Drugelių;1528972517;Taip;5;3;0;8
9032;Riešutėlis;Drugelių;8180618419;Taip;3;1;0;4
9033;Riešutėlis;Drugelių;3920525584;Taip;10;0;0;10
9034;Riešutėlis;Drugelių;5412882446;Taip;17;0;0;17
9035;Riešutėlis;Drugelių;8020533200;Taip;6;0;0;6
9036;Ramunėlė;SAULUTĖS;19664665864;Ne;0;18;0;18
9037;Ramunėlė;SAULUTĖS;80319760551;Taip;0;2;0;2
9038;Ramunėlė;SAULUTĖS;37338389480;Taip;1;2;0;3
9039;Ramunėlė;SAULUTĖS;7736649569;Taip;0;1;0;1
9040;Ramunėlė;SAULUTĖS;43737882488;Taip;0;3;0;3
9041;Ramunėlė;SAULUTĖS;16577268434;Taip;0;3;0;3
9042;Ramunėlė;SAULUTĖS;44016905818;Taip;0;3;3;6
9043;Ramunėlė;SAULUTĖS;19784681244;Taip;0;14;0;14
9044;Ramunėlė;SAULUTĖS;99807372989;Taip;0;6;0;6
9045;Ramunėlė;SAULUTĖS;3599929268;Taip;0;3;0;3
9046;Ramunėlė;SAULUTĖS;9266024764;Taip;0;7;0;7
9047;Ramunėlė;SAULUTĖS;85972695257;Taip;0;1;0;1
9048;Ramunėlė;SAULUTĖS;94707638226;Taip;0;2;0;2
9049;Ramunėlė;SAULUTĖS;69367849602;Taip;0;7;0;7
9050;Ramunėlė;SAULUTĖS;97944093065;Taip;0;1;0;1
9051;Ramunėlė;SAULUTĖS;27163734018;Taip;0;3;11;14
9052;Ramunėlė;SAULUTĖS;1712780584;Taip;0;7;0;7
9053;Ramunėlė;SAULUTĖS;2089805114;Taip;0;5;3;8
9054;Ramunėlė;SAULUTĖS;1079295964;Taip;0;2;0;2
9055;Ramunėlė;SAULUTĖS;26568396284;Taip;7;0;0;7
9056;Ramunėlė;SAULUTĖS;1982905923;Taip;0;2;6;8
9057;Ramunėlė;SAULUTĖS;9918328799;Taip;0;11;0;11
9058;Ramunėlė;ŽIBUTĖ;8943746426;Taip;0;3;0;3
9059;Ramunėlė;ŽIBUTĖ;57697488265;Taip;4;8;0;12
9060;Ramunėlė;ŽIBUTĖ;4103951942;Taip;0;9;0;9
9061;Ramunėlė;ŽIBUTĖ;37227575121;Taip;0;13;0;13
9062;Ramunėlė;ŽIBUTĖ;21178777924;Taip;0;1;0;1
9063;Ramunėlė;ŽIBUTĖ;9615607625;Taip;8;5;0;13
9064;Ramunėlė;ŽIBUTĖ;24395304267;Taip;4;2;0;6
9065;Ramunėlė;ŽIBUTĖ;41210974793;Taip;4;2;0;6
9066;Ramunėlė;ŽIBUTĖ;71451001033;Taip;0;0;1;1
9067;Ramunėlė;ŽIBUTĖ;6126971384;Taip;2;2;0;4
9068;Ramunėlė;ŽIBUTĖ;78632810141;Taip;15;0;0;15
9069;Ramunėlė;ŽIBUTĖ;8826277893;Taip;0;7;0;7
9070;Ramunėlė;ŽIBUTĖ;573414969;Taip;0;1;0;1
9071;Ramunėlė;ŽIBUTĖ;2069380818;Taip;4;0;1;5
9072;Ramunėlė;ŽIBUTĖ;1686559920;Taip;0;11;0;11
9073;Ramunėlė;ŽIBUTĖ;2127262855;Taip;0;7;0;7
9074;Ramunėlė;ŽIBUTĖ;1383896021;Taip;6;2;1;9
9075;Ramunėlė;ŽIBUTĖ;1898089064;Taip;7;3;0;10
9076;Ramunėlė;ŽIBUTĖ;1575204445;Taip;0;2;5;7
9077;Ramunėlė;ŽIBUTĖ;1511271386;Taip;0;2;0;2
9078;Ramunėlė;ŽIBUTĖ;1845973626;Taip;0;8;0;8
9079;Ramunėlė;ŽIBUTĖ;1177226887;Taip;1;0;0;1
9080;Ramunėlė;ŽIRNIUKAI;99821576722;Taip;0;4;0;4
9081;Ramunėlė;ŽIRNIUKAI;50481250500;Taip;11;0;0;11
9082;Ramunėlė;ŽIRNIUKAI;94856703262;Taip;0;5;0;5
9083;Ramunėlė;ŽIRNIUKAI;63588041951;Taip;0;6;0;6
9084;Ramunėlė;ŽIRNIUKAI;65453540817;Taip;0;7;0;7
9085;Ramunėlė;ŽIRNIUKAI;42260677623;Taip;0;2;0;2
9086;Ramunėlė;ŽIRNIUKAI;6024704965;Taip;0;9;0;9
9087;Ramunėlė;ŽIRNIUKAI;26794018418;Taip;0;7;0;7
9088;Ramunėlė;ŽIRNIUKAI;91420704570;Taip;0;1;0;1
9089;Ramunėlė;ŽIRNIUKAI;32944616981;Taip;4;3;0;7
9090;Ramunėlė;ŽIRNIUKAI;88310187748;Taip;6;0;0;6
9091;Ramunėlė;ŽIRNIUKAI;26023476423;Taip;0;12;0;12
9092;Ramunėlė;ŽIRNIUKAI;31363181264;Taip;0;2;2;4
9093;Ramunėlė;ŽIRNIUKAI;74094856940;Ne;0;4;4;8
9094;Ramunėlė;ŽIRNIUKAI;5434810703;Taip;11;0;0;11
9095;Ramunėlė;ŽIRNIUKAI;84737816930;Taip;0;5;0;5
9096;Ramunėlė;ŽIRNIUKAI;46655439401;Taip;10;2;0;12
9097;Ramunėlė;ŽIRNIUKAI;49072154718;Taip;0;3;0;3
9098;Ramunėlė;ŽIRNIUKAI;81555246386;Taip;0;8;0;8
9099;Ramunėlė;ŽIRNIUKAI;68236739228;Taip;0;6;0;6
9100;Ramunėlė;ŽIRNIUKAI;15299809362;Ne;5;1;0;6
9101;Ramunėlė;ŽIRNIUKAI;64011542531;Taip;11;0;2;13
9102;Ramunėlė;ŽIRNIUKAI;74958543608;Taip;3;6;0;9
9103;Ramunėlė;ŽIRNIUKAI;19570213314;Taip;0;6;0;6
9104;Ramunėlė;BITUTĖS;32110200138;Taip;0;0;2;2
9105;Ramunėlė;BITUTĖS;23095478847;Taip;9;1;0;10
9106;Ramunėlė;BITUTĖS;9961229084;Taip;7;2;0;9
9107;Ramunėlė;BITUTĖS;7921336790;Taip;0;1;0;1
9108;Ramunėlė;BITUTĖS;86378277613;Taip;0;3;0;3
9109;Ramunėlė;BITUTĖS;1866642357;Ne;0;14;0;14
9110;Ramunėlė;BITUTĖS;32249506035;Taip;5;1;0;6
9111;Ramunėlė;BITUTĖS;1090204906;Taip;0;4;0;4
9112;Ramunėlė;BITUTĖS;42582811243;Taip;0;1;0;1
9113;Ramunėlė;BITUTĖS;1485483496;Taip;0;3;0;3
9114;Ramunėlė;BITUTĖS;3683430430;Taip;16;2;0;18
9115;Ramunėlė;BITUTĖS;16357824257;Taip;0;3;0;3
9116;Ramunėlė;BITUTĖS;9715654332;Taip;0;1;0;1
9117;Ramunėlė;BITUTĖS;1012658900;Taip;0;8;0;8
9118;Ramunėlė;DRUGELIAI;52584057093;Taip;6;2;0;8
9119;Ramunėlė;DRUGELIAI;22249196276;Taip;8;2;0;10
9120;Ramunėlė;DRUGELIAI;81774258556;Taip;0;0;2;2
9121;Ramunėlė;DRUGELIAI;22097349678;Taip;0;3;0;3
9122;Ramunėlė;DRUGELIAI;62716754080;Taip;0;6;0;6
9123;Ramunėlė;DRUGELIAI;15363368541;Taip;2;0;2;4
9124;Ramunėlė;DRUGELIAI;15310034187;Taip;15;0;0;15
9125;Ramunėlė;DRUGELIAI;22306706669;Taip;0;11;0;11
9126;Ramunėlė;DRUGELIAI;25346770513;Taip;0;2;7;9
9127;Ramunėlė;DRUGELIAI;72620475723;Taip;10;2;0;12
9128;Ramunėlė;DRUGELIAI;92929314036;Taip;9;0;0;9
9129;Ramunėlė;DRUGELIAI;28838673166;Ne;0;2;0;2
9130;Ramunėlė;DRUGELIAI;1253351354;Taip;0;0;2;2
9131;Ramunėlė;DRUGELIAI;13195968349;Taip;6;4;0;10
9132;Ramunėlė;DRUGELIAI;84319432445;Taip;5;2;0;7
9133;Ramunėlė;DRUGELIAI;21608020858;Taip;10;2;1;13
9134;Ramunėlė;DRUGELIAI;1478538572;Taip;0;5;0;5
9135;Ramunėlė;DRUGELIAI;26152001976;Taip;0;5;0;5
9136;Ramunėlė;DRUGELIAI;1175561112;Taip;0;2;0;2
9137;Ramunėlė;NEUŽMIRŠTUOLĖS;19420482998;Taip;0;13;0;13
9138;Ramunėlė;NEUŽMIRŠTUOLĖS;4990982790;Taip;9;2;0;11
9139;Ramunėlė;NEUŽMIRŠTUOLĖS;9130637883;Taip;11;0;0;11
9140;Ramunėlė;NEUŽMIRŠTUOLĖS;3271832822;Taip;12;2;0;14
9141;Ramunėlė;NEUŽMIRŠTUOLĖS;3554787356;Taip;0;0;3;3
9142;Ramunėlė;NEUŽMIRŠTUOLĖS;8098492540;Taip;0;8;0;8
9143;Ramunėlė;NEUŽMIRŠTUOLĖS;6217540064;Taip;1;2;0;3
9144;Ramunėlė;NEUŽMIRŠTUOLĖS;17201639406;Taip;7;0;1;8
9145;Ramunėlė;NEUŽMIRŠTUOLĖS;3065727741;Taip;10;0;1;11
9146;Ramunėlė;NEUŽMIRŠTUOLĖS;4511376806;Taip;4;9;0;13
9147;Ramunėlė;NEUŽMIRŠTUOLĖS;9171690612;Taip;0;2;6;8
9148;Ramunėlė;NEUŽMIRŠTUOLĖS;8357049686;Taip;4;2;0;6
9149;Ramunėlė;NEUŽMIRŠTUOLĖS;1078618047;Taip;10;11;0;21
9150;Ramunėlė;NEUŽMIRŠTUOLĖS;6329943991;Taip;0;0;3;3
9151;Ramunėlė;NEUŽMIRŠTUOLĖS;8940763540;Taip;0;0;17;17
9152;Ramunėlė;NEUŽMIRŠTUOLĖS;8086994543;Taip;0;10;0;10
9153;Ramunėlė;NEUŽMIRŠTUOLĖS;7652421432;Taip;0;1;0;1
9154;Ramunėlė;NEUŽMIRŠTUOLĖS;5822045625;Taip;0;1;4;5
9155;Ramunėlė;NEUŽMIRŠTUOLĖS;2225787182;Taip;0;16;0;16
9156;Ramunėlė;OBUOLIUKAI;1376538015;Ne;6;2;0;8
9157;Ramunėlė;OBUOLIUKAI;1783572058;Taip;0;1;0;1
9158;Ramunėlė;OBUOLIUKAI;30907738272;Taip;0;2;0;2
9159;Ramunėlė;OBUOLIUKAI;1891454355;Taip;8;0;0;8
9160;Ramunėlė;OBUOLIUKAI;1814199950;Taip;0;2;0;2
9161;Ramunėlė;OBUOLIUKAI;1199690327;Taip;6;0;1;7
9162;Ramunėlė;OBUOLIUKAI;52168460247;Taip;6;0;1;7
9163;Ramunėlė;OBUOLIUKAI;67836032797;Taip;0;2;0;2
9164;Ramunėlė;OBUOLIUKAI;66630134164;Taip;5;0;1;6
9165;Ramunėlė;OBUOLIUKAI;1988109236;Taip;15;1;0;16
9166;Ramunėlė;OBUOLIUKAI;1083479451;Taip;10;0;0;10
9167;Ramunėlė;OBUOLIUKAI;7228065409;Taip;0;6;0;6
9168;Ramunėlė;OBUOLIUKAI;2567264851;Taip;0;0;16;16
9169;Ramunėlė;OBUOLIUKAI;9584620339;Taip;4;0;0;4
9170;Ramunėlė;OBUOLIUKAI;8402889872;Taip;8;2;0;10
9171;Ramunėlė;OBUOLIUKAI;1745170057;Taip;0;2;6;8
9172;Ramunėlė;OBUOLIUKAI;3617897977;Taip;0;0;1;1
9173;Ramunėlė;OBUOLIUKAI;8768539595;Taip;0;13;0;13
9174;Ramunėlė;OBUOLIUKAI;2055332353;Taip;0;15;0;15
9175;Ramunėlė;OBUOLIUKAI;7955507702;Taip;0;0;1;1
9176;Ramunėlė;OBUOLIUKAI;58573425792;Taip;0;0;2;2
9177;Ramunėlė;SAULĖGRĄŽA;3973083939;Taip;0;3;0;3
9178;Ramunėlė;SAULĖGRĄŽA;53748116108;Taip;7;2;0;9
9179;Ramunėlė;SAULĖGRĄŽA;1028730863;Taip;0;2;0;2
9180;Ramunėlė;SAULĖGRĄŽA;1085668968;Taip;0;3;0;3
9181;Ramunėlė;SAULĖGRĄŽA;1500685962;Taip;0;3;0;3
9182;Ramunėlė;SAULĖGRĄŽA;2075485387;Taip;15;1;0;16
9183;Ramunėlė;SAULĖGRĄŽA;57963557951;Taip;9;1;0;10
9184;Ramunėlė;SAULĖGRĄŽA;9924675250;Taip;0;2;0;2
9185;Ramunėlė;SAULĖGRĄŽA;1171170929;Taip;0;0;1;1
9186;Ramunėlė;SAULĖGRĄŽA;10677635919;Taip;0;9;0;9
9187;Ramunėlė;SAULĖGRĄŽA;11512621396;Taip;0;7;0;7
9188;Ramunėlė;SAULĖGRĄŽA;1157861595;Taip;0;0;1;1
9189;Ramunėlė;SAULĖGRĄŽA;17292085814;Taip;0;6;0;6
9190;Ramunėlė;SAULĖGRĄŽA;4814208279;Taip;13;0;0;13
9191;Ramunėlė;SAULĖGRĄŽA;8254302108;Taip;4;0;0;4
9192;Ramunėlė;SAULĖGRĄŽA;1364997950;Taip;0;2;0;2
9193;Ramunėlė;SAULĖGRĄŽA;1397784717;Taip;0;0;2;2
9194;Ramunėlė;SAULĖGRĄŽA;8496322672;Taip;0;0;2;2
9195;Ramunėlė;BORUŽĖLĖS;82024687579;Taip;8;7;0;15
9196;Ramunėlė;BORUŽĖLĖS;1563618796;Taip;0;9;0;9
9197;Ramunėlė;BORUŽĖLĖS;1033548164;Taip;0;2;0;2
9198;Ramunėlė;BORUŽĖLĖS;1946639898;Taip;7;2;0;9
9199;Ramunėlė;BORUŽĖLĖS;1058243928;Taip;5;5;0;10
9200;Ramunėlė;BORUŽĖLĖS;63470398650;Taip;10;3;0;13
9201;Ramunėlė;BORUŽĖLĖS;1439962940;Taip;0;1;0;1
9202;Ramunėlė;BORUŽĖLĖS;93125217886;Taip;0;6;0;6
9203;Ramunėlė;BORUŽĖLĖS;1690224857;Taip;0;0;2;2
9204;Ramunėlė;BORUŽĖLĖS;1827657363;Taip;0;2;0;2
9205;Ramunėlė;BORUŽĖLĖS;1176835101;Taip;0;1;0;1
9206;Ramunėlė;BORUŽĖLĖS;1341351994;Taip;0;7;0;7
9207;Ramunėlė;BORUŽĖLĖS;1041998279;Taip;0;2;3;5
9208;Ramunėlė;BORUŽĖLĖS;2859202237;Taip;5;9;0;14
9209;Ramunėlė;BORUŽĖLĖS;17273267465;Taip;0;1;0;1
9210;Ramunėlė;BORUŽĖLĖS;1405532116;Taip;3;0;0;3
9211;Ramunėlė;BORUŽĖLĖS;1709795078;Taip;0;15;0;15
9212;Ramunėlė;BORUŽĖLĖS;1077068878;Taip;7;2;2;11
9213;Ramunėlė;BORUŽĖLĖS;1207455851;Taip;5;0;1;6
9214;Ramunėlė;NYKŠTUKAS;2995509132;Taip;1;0;0;1
9215;Ramunėlė;NYKŠTUKAS;3301219357;Taip;7;1;0;8
9216;Ramunėlė;NYKŠTUKAS;6348171102;Taip;0;2;0;2
9217;Ramunėlė;NYKŠTUKAS;1800967823;Taip;0;0;4;4
9218;Ramunėlė;NYKŠTUKAS;7829765488;Taip;7;0;0;7
9219;Ramunėlė;NYKŠTUKAS;8205893352;Taip;0;3;0;3
9220;Ramunėlė;NYKŠTUKAS;4392309015;Taip;0;0;2;2
9221;Ramunėlė;NYKŠTUKAS;8656417794;Taip;9;2;0;11
9222;Ramunėlė;NYKŠTUKAS;9663290607;Taip;8;1;0;9
9223;Ramunėlė;NYKŠTUKAS;2569491673;Taip;8;0;0;8
9224;Ramunėlė;NYKŠTUKAS;7902931560;Taip;21;0;0;21
9225;Ramunėlė;NYKŠTUKAS;3883411539;Taip;0;2;2;4
9226;Ramunėlė;NYKŠTUKAS;5465647281;Taip;6;8;0;14
9227;Ramunėlė;NYKŠTUKAS;6809164145;Taip;0;0;2;2
9228;Ramunėlė;NYKŠTUKAS;5436185479;Taip;3;0;0;3
9229;Ramunėlė;NYKŠTUKAS;6184872126;Taip;6;0;0;6
9230;Ramunėlė;UOGELĖ;6134554678;Taip;2;4;9;15
9231;Ramunėlė;UOGELĖ;8726443989;Taip;0;9;0;9
9232;Ramunėlė;UOGELĖ;7219400182;Taip;0;1;0;1
9233;Ramunėlė;UOGELĖ;4715809064;Taip;5;3;0;8
9234;Ramunėlė;UOGELĖ;5315953299;Taip;15;2;0;17
9235;Ramunėlė;UOGELĖ;3852734401;Taip;12;2;1;15
9236;Ramunėlė;UOGELĖ;1192743154;Taip;13;1;0;14
9237;Ramunėlė;UOGELĖ;5562960498;Taip;0;13;0;13
9238;Ramunėlė;UOGELĖ;1599595174;Taip;0;18;0;18
9239;Ramunėlė;UOGELĖ;1483391590;Taip;0;1;0;1
9240;Ramunėlė;UOGELĖ;5605444408;Taip;7;1;0;8
9241;Ramunėlė;UOGELĖ;8323020864;Taip;21;0;0;21
9242;Ramunėlė;UOGELĖ;8912978935;Taip;0;1;0;1
9243;Ramunėlė;UOGELĖ;9320573498;Taip;14;1;0;15
9244;Ramunėlė;UOGELĖ;5420360864;Taip;10;5;0;15
9245;Ramunėlė;UOGELĖ;3779769727;Taip;7;3;0;10
9246;Ramunėlė;UOGELĖ;8929122197;Taip;3;0;0;3
9247;Ramunėlė;UOGELĖ;4575123456;Taip;4;1;4;9
9248;Ramunėlė;UOGELĖ;3574886801;Taip;21;0;0;21
9249;Ramunėlė;VARPELIAI;3762539352;Taip;10;0;0;10
9250;Ramunėlė;VARPELIAI;2499280049;Taip;1;0;0;1
9251;Ramunėlė;VARPELIAI;2007790746;Taip;0;1;0;1
9252;Ramunėlė;VARPELIAI;6310921755;Taip;6;5;0;11
9253;Ramunėlė;VARPELIAI;7750405604;Taip;1;2;0;3
9254;Ramunėlė;VARPELIAI;58028743912;Taip;18;0;0;18
9255;Ramunėlė;VARPELIAI;4349250416;Taip;0;1;0;1
9256;Ramunėlė;VARPELIAI;3055294324;Taip;5;12;0;17
9257;Ramunėlė;VARPELIAI;9448369796;Taip;4;0;0;4
9258;Ramunėlė;VARPELIAI;6612728883;Taip;0;1;0;1
9259;Ramunėlė;VARPELIAI;1534723406;Taip;4;0;0;4
9260;Ramunėlė;VARPELIAI;1567537525;Taip;0;2;2;4
9261;Ramunėlė;VARPELIAI;1216101539;Taip;10;2;0;12
9262;Ramunėlė;VARPELIAI;6837072361;Taip;0;1;0;1
9263;Ramunėlė;VARPELIAI;1303053333;Taip;7;0;0;7
9264;Ramunėlė;VARPELIAI;6695672297;Taip;10;0;0;10
9265;Ramunėlė;VARPELIAI;7638038269;Taip;8;2;0;10
9266;Ramunėlė;VARPELIAI;3566074517;Taip;0;8;0;8
9267;Ramunėlė;VARPELIAI;7825538259;Taip;11;1;0;12
9268;Rūta;SMALSUČIAI;14391882157;Taip;4;0;4;8
9269;Rūta;SMALSUČIAI;18117978189;Taip;11;0;2;13
9270;Rūta;SMALSUČIAI;184041928;Taip;5;1;0;6
9271;Rūta;SMALSUČIAI;77285178781;Taip;0;3;0;3
9272;Rūta;SMALSUČIAI;45391890869;Ne;0;0;2;2
9273;Rūta;SMALSUČIAI;78953568121;Taip;3;5;0;8
9274;Rūta;SMALSUČIAI;89046897963;Taip;3;3;0;6
9275;Rūta;SMALSUČIAI;26152518052;Taip;21;0;0;21
9276;Rūta;SMALSUČIAI;68107516536;Taip;0;2;0;2
9277;Rūta;SMALSUČIAI;87692898919;Taip;11;0;2;13
9278;Rūta;SMALSUČIAI;3874247966;Taip;10;0;1;11
9279;Rūta;SMALSUČIAI;1323253379;Taip;0;0;2;2
9280;Rūta;SMALSUČIAI;8604212304;Taip;16;0;0;16
9281;Rūta;SMALSUČIAI;38837808144;Taip;0;0;1;1
9282;Rūta;SMALSUČIAI;50814418724;Taip;8;2;0;10
9283;Rūta;SMALSUČIAI;1996690514;Taip;11;1;0;12
9284;Rūta;SMALSUČIAI;59694891781;Taip;11;1;0;12
9285;Rūta;SMALSUČIAI;1945068716;Taip;8;0;0;8
9286;Rūta;SMALSUČIAI;83473072263;Taip;3;1;0;4
9287;Rūta;KŪLVERSTUKAI;1800198849;Taip;0;3;0;3
9288;Rūta;KŪLVERSTUKAI;1150292834;Taip;6;3;0;9
9289;Rūta;KŪLVERSTUKAI;56171468735;Taip;0;8;0;8
9290;Rūta;KŪLVERSTUKAI;88159609117;Taip;6;0;0;6
9291;Rūta;KŪLVERSTUKAI;48758751494;Taip;0;0;10;10
9292;Rūta;KŪLVERSTUKAI;2084379688;Taip;0;0;2;2
9293;Rūta;KŪLVERSTUKAI;1807332522;Taip;10;4;0;14
9294;Rūta;KŪLVERSTUKAI;1674584707;Taip;0;16;0;16
9295;Rūta;KŪLVERSTUKAI;2079429418;Taip;0;10;0;10
9296;Rūta;KŪLVERSTUKAI;1972150300;Taip;10;1;0;11
9297;Rūta;KŪLVERSTUKAI;99777522247;Taip;0;0;5;5
9298;Rūta;KŪLVERSTUKAI;50658624766;Taip;18;0;0;18
9299;Rūta;KŪLVERSTUKAI;1971925569;Taip;0;4;0;4
9300;Rūta;KŪLVERSTUKAI;56470874552;Taip;13;0;0;13
9301;Rūta;KŪLVERSTUKAI;1363296753;Taip;0;0;4;4
9302;Rūta;KŪLVERSTUKAI;17349566042;Taip;0;2;0;2
9303;Rūta;KŪLVERSTUKAI;10059496231;Taip;0;0;3;3
9304;Rūta;KŪLVERSTUKAI;1043614414;Taip;14;0;0;14
9305;Rūta;KŪLVERSTUKAI;1703148668;Taip;0;0;1;1
9306;Rūta;KODĖLČIUKAI;6136733410;Taip;10;0;6;16
9307;Rūta;KODĖLČIUKAI;8607455403;Taip;0;6;0;6
9308;Rūta;KODĖLČIUKAI;4168356825;Taip;1;0;1;2
9309;Rūta;KODĖLČIUKAI;1186493111;Taip;0;0;4;4
9310;Rūta;KODĖLČIUKAI;1390207547;Taip;4;2;0;6
9311;Rūta;KODĖLČIUKAI;9569447586;Taip;0;4;0;4
9312;Rūta;KODĖLČIUKAI;32004750783;Taip;11;0;0;11
9313;Rūta;KODĖLČIUKAI;6982618655;Taip;0;12;0;12
9314;Rūta;KODĖLČIUKAI;1433704180;Taip;12;0;0;12
9315;Rūta;KODĖLČIUKAI;1671913833;Taip;0;0;3;3
9316;Rūta;KODĖLČIUKAI;5114985659;Taip;0;0;5;5
9317;Rūta;KODĖLČIUKAI;4282074540;Taip;2;0;2;4
9318;Rūta;KODĖLČIUKAI;5866619097;Taip;5;0;1;6
9319;Rūta;KODĖLČIUKAI;2677062861;Taip;16;0;0;16
9320;Rūta;KODĖLČIUKAI;1415664888;Taip;0;0;11;11
9321;Rūta;KODĖLČIUKAI;4426456302;Taip;4;0;1;5
9322;Rūta;KODĖLČIUKAI;9675482322;Taip;11;0;5;16
9323;Rūta;KODĖLČIUKAI;2912054049;Taip;6;0;0;6
9324;Rūta;BORUŽĖLĖS;1346367896;Taip;0;6;0;6
9325;Rūta;BORUŽĖLĖS;1565896222;Taip;0;0;16;16
9326;Rūta;BORUŽĖLĖS;8673942478;Taip;0;3;4;7
9327;Rūta;BORUŽĖLĖS;1092908255;Taip;5;0;2;7
9328;Rūta;BORUŽĖLĖS;1521231573;Taip;2;0;8;10
9329;Rūta;BORUŽĖLĖS;1967141665;Taip;12;1;1;14
9330;Rūta;BORUŽĖLĖS;6006094035;Taip;0;21;0;21
9331;Rūta;BORUŽĖLĖS;8889388348;Taip;10;0;0;10
9332;Rūta;BORUŽĖLĖS;8704594038;Taip;0;0;13;13
9333;Rūta;BORUŽĖLĖS;3478456813;Taip;8;2;0;10
9334;Rūta;BORUŽĖLĖS;1180144866;Taip;5;1;0;6
9335;Rūta;BORUŽĖLĖS;4078957924;Taip;6;0;0;6
9336;Rūta;BORUŽĖLĖS;4363571135;Taip;2;5;0;7
9337;Rūta;BORUŽĖLĖS;4754142240;Taip;9;1;0;10
9338;Rūta;BORUŽĖLĖS;2116581815;Taip;7;0;0;7
9339;Rūta;BORUŽĖLĖS;8851591109;Taip;8;0;3;11
9340;Rūta;BORUŽĖLĖS;7552644990;Taip;15;0;0;15
9341;Rūta;BORUŽĖLĖS;1336973131;Taip;4;3;0;7
9342;Rūta;BORUŽĖLĖS;3873876608;Taip;3;0;0;3
9343;Rūta;BORUŽĖLĖS;7631229177;Taip;12;0;1;13
9344;Rūta;VYTURĖLIAI;1938200654;Taip;7;0;0;7
9345;Rūta;VYTURĖLIAI;31821660367;Taip;0;3;0;3
9346;Rūta;VYTURĖLIAI;14552031490;Taip;0;1;0;1
9347;Rūta;VYTURĖLIAI;46129637744;Taip;21;0;0;21
9348;Rūta;VYTURĖLIAI;58334018927;Taip;0;0;1;1
9349;Rūta;VYTURĖLIAI;24807873951;Taip;3;3;0;6
9350;Rūta;VYTURĖLIAI;86163505598;Taip;5;1;1;7
9351;Rūta;VYTURĖLIAI;89650991326;Taip;2;8;0;10
9352;Rūta;VYTURĖLIAI;86514347752;Taip;15;0;0;15
9353;Rūta;VYTURĖLIAI;8941291651;Taip;0;3;0;3
9354;Rūta;VYTURĖLIAI;92007397776;Taip;16;0;0;16
9355;Rūta;VYTURĖLIAI;92554408021;Taip;0;4;0;4
9356;Rūta;VYTURĖLIAI;27023480832;Taip;0;3;0;3
9357;Rūta;VYTURĖLIAI;87233420613;Taip;0;3;0;3
9358;Rūta;VYTURĖLIAI;90699177243;Taip;0;0;2;2
9359;Rūta;VYTURĖLIAI;70038163995;Taip;0;0;3;3
9360;Rūta;VYTURĖLIAI;56355568788;Taip;0;1;3;4
9361;Rūta;VYTURĖLIAI;21286497837;Taip;12;0;0;12
9362;Rūta;VYTURĖLIAI;74717101386;Taip;5;3;1;9
9363;Rūta;VYTURĖLIAI;67822551240;Taip;4;1;0;5
9364;Rūta;VYTURĖLIAI;18736757488;Taip;0;1;0;1
9365;Rūta;VYTURĖLIAI;8213932715;Taip;16;1;0;17
9366;Rūta;"PABIRUČIAI (LOGOPEDINĖ)";70608720189;Taip;5;0;0;5
9367;Rūta;"PABIRUČIAI (LOGOPEDINĖ)";57805651069;Taip;0;5;0;5
9368;Rūta;"PABIRUČIAI (LOGOPEDINĖ)";58313529531;Taip;4;0;0;4
9369;Rūta;"PABIRUČIAI (LOGOPEDINĖ)";97812491022;Taip;0;0;2;2
9370;Rūta;"PABIRUČIAI (LOGOPEDINĖ)";1489564914;Taip;0;4;0;4
9371;Rūta;"PABIRUČIAI (LOGOPEDINĖ)";45484303685;Taip;0;6;0;6
9372;Rūta;GUDRUČIAI;78925728976;Ne;0;5;0;5
9373;Rūta;GUDRUČIAI;44365150696;Taip;11;1;0;12
9374;Rūta;GUDRUČIAI;10957816153;Taip;10;0;0;10
9375;Rūta;GUDRUČIAI;35843737071;Taip;0;0;3;3
9376;Rūta;GUDRUČIAI;13023764979;Taip;6;0;0;6
9377;Rūta;GUDRUČIAI;4409524323;Taip;0;4;0;4
9378;Rūta;GUDRUČIAI;2033577529;Taip;0;5;0;5
9379;Rūta;GUDRUČIAI;15393327975;Taip;0;1;0;1
9380;Rūta;GUDRUČIAI;79762491266;Taip;3;0;0;3
9381;Rūta;GUDRUČIAI;76831234529;Taip;10;1;2;13
9382;Rūta;GUDRUČIAI;24211514845;Taip;0;1;2;3
9383;Rūta;GUDRUČIAI;48213220767;Taip;9;2;3;14
9384;Rūta;GUDRUČIAI;50266063379;Ne;0;0;1;1
9385;Rūta;GUDRUČIAI;28676981495;Taip;0;5;0;5
9386;Rūta;GUDRUČIAI;81049938466;Taip;10;6;0;16
9387;Rūta;GUDRUČIAI;67740925555;Taip;0;1;0;1
9388;Rūta;GUDRUČIAI;34935546673;Taip;14;1;0;15
9389;Rūta;GUDRUČIAI;47869128534;Taip;3;1;4;8
9390;Rūta;GUDRUČIAI;28332403249;Taip;0;1;2;3
9391;Rūta;GUDRUČIAI;91072621203;Taip;5;6;0;11
9392;Rūta;GUDRUČIAI;28158130932;Taip;3;0;0;3
9393;Rūta;SEKLYTĖLĖ;73486569144;Taip;5;1;0;6
9394;Rūta;SEKLYTĖLĖ;63130007113;Taip;5;1;0;6
9395;Rūta;SEKLYTĖLĖ;36767660286;Taip;6;3;1;10
9396;Rūta;SEKLYTĖLĖ;74600889000;Taip;0;4;0;4
9397;Rūta;SEKLYTĖLĖ;61614584274;Taip;2;0;0;2
9398;Rūta;SEKLYTĖLĖ;91160282230;Taip;0;1;3;4
9399;Rūta;SEKLYTĖLĖ;35546560715;Taip;4;0;0;4
9400;Rūta;SEKLYTĖLĖ;7273166365;Taip;3;0;0;3
9401;Rūta;SEKLYTĖLĖ;38233380265;Taip;6;1;0;7
9402;Rūta;SEKLYTĖLĖ;28539513133;Taip;5;2;0;7
9403;Rūta;SEKLYTĖLĖ;11116950913;Taip;15;0;0;15
9404;Rūta;SEKLYTĖLĖ;32768658491;Taip;0;7;0;7
9405;Rūta;SEKLYTĖLĖ;39447933171;Taip;7;4;0;11
9406;Rūta;SEKLYTĖLĖ;52426424863;Taip;5;0;0;5
9407;Rūta;SEKLYTĖLĖ;94077980408;Taip;0;6;0;6
9408;Rūta;SEKLYTĖLĖ;9037549271;Taip;10;3;0;13
9409;Rūta;SEKLYTĖLĖ;1789959175;Taip;0;1;1;2
9410;Rūta;SEKLYTĖLĖ;5905750207;Taip;4;0;0;4
9411;Rūta;SEKLYTĖLĖ;2080471128;Taip;0;6;0;6
9412;Rūta;SEKLYTĖLĖ;1168419924;Taip;10;2;0;12
9413;Rūta;"VARPELIAI (LOGOPEDINĖ)";13743264567;Taip;7;1;0;8
9414;Rūta;"VARPELIAI (LOGOPEDINĖ)";23413166816;Taip;0;2;0;2
9415;Rūta;"VARPELIAI (LOGOPEDINĖ)";78172584064;Taip;0;1;0;1
9416;Rūta;"VARPELIAI (LOGOPEDINĖ)";97163853698;Taip;10;1;6;17
9417;Rūta;"VARPELIAI (LOGOPEDINĖ)";1617760535;Taip;8;0;0;8
9418;Rūta;KIŠKUČIŲ;4297300799;Taip;0;16;0;16
9419;Rūta;KIŠKUČIŲ;6207902435;Taip;0;1;0;1
9420;Rūta;KIŠKUČIŲ;9791861646;Taip;0;0;1;1
9421;Rūta;KIŠKUČIŲ;8182243701;Taip;8;4;5;17
9422;Rūta;KIŠKUČIŲ;3454881685;Taip;2;0;0;2
9423;Rūta;KIŠKUČIŲ;3043164521;Taip;10;0;0;10
9424;Rūta;KIŠKUČIŲ;1510268514;Taip;2;1;4;7
9425;Rūta;KIŠKUČIŲ;4728904136;Taip;5;10;0;15
9426;Rūta;KIŠKUČIŲ;9419809946;Taip;4;0;1;5
9427;Rūta;KIŠKUČIŲ;1811055786;Taip;0;0;4;4
9428;Rūta;KIŠKUČIŲ;2928803089;Taip;14;1;0;15
9429;Rūta;KIŠKUČIŲ;2702537976;Taip;0;1;17;18
9430;Rūta;ŽVIRBLIUKAI;3499727608;Taip;11;0;0;11
9431;Rūta;ŽVIRBLIUKAI;9765301038;Taip;11;0;0;11
9432;Rūta;ŽVIRBLIUKAI;8277677952;Taip;3;1;2;6
9433;Rūta;ŽVIRBLIUKAI;9638495757;Taip;8;0;4;12
9434;Rūta;ŽVIRBLIUKAI;3956912957;Taip;10;0;0;10
9435;Rūta;ŽVIRBLIUKAI;3055345528;Taip;0;6;5;11
9436;Rūta;ŽVIRBLIUKAI;4423305209;Taip;8;3;0;11
9437;Rūta;ŽVIRBLIUKAI;2890569107;Taip;0;0;8;8
9438;Rūta;ŽVIRBLIUKAI;3964922552;Taip;15;0;1;16
9439;Rūta;ŽVIRBLIUKAI;1216786487;Taip;0;2;0;2
9440;Rūta;ŽVIRBLIUKAI;9736567509;Taip;0;0;5;5
9441;Rūta;ŽVIRBLIUKAI;2474991135;Taip;10;0;2;12
9442;Rūta;ŽVIRBLIUKAI;7519931138;Taip;1;0;4;5
9443;Rūta;ŽVIRBLIUKAI;9400586178;Taip;0;0;1;1
9444;Rūta;ŽVIRBLIUKAI;8395765508;Taip;3;0;4;7
9445;Rūta;SAULUTĖS;54140704807;Taip;0;5;0;5
9446;Rūta;SAULUTĖS;26830853793;Taip;2;0;0;2
9447;Rūta;SAULUTĖS;75322385068;Taip;0;10;0;10
9448;Rūta;SAULUTĖS;76518034714;Taip;0;6;0;6
9449;Rūta;SAULUTĖS;79192262053;Taip;11;1;1;13
9450;Rūta;SAULUTĖS;42791864630;Taip;0;1;0;1
9451;Rūta;SAULUTĖS;61864833085;Taip;13;0;0;13
9452;Rūta;SAULUTĖS;20967345257;Taip;3;0;0;3
9453;Rūta;SAULUTĖS;89880409419;Taip;0;0;1;1
9454;Rūta;SAULUTĖS;29240858006;Taip;10;1;0;11
9455;Rūta;SAULUTĖS;75730421646;Taip;0;6;0;6
9456;Rūta;SAULUTĖS;732948370;Ne;0;1;0;1
9457;Rūta;SAULUTĖS;2711671531;Taip;10;1;0;11
9458;Rūta;SAULUTĖS;29483136582;Taip;0;4;0;4
9459;Rūta;SAULUTĖS;5733023163;Taip;0;0;1;1
9460;Rūta;SAULUTĖS;7061384784;Taip;17;0;0;17
9461;Rūta;SAULUTĖS;9994442882;Taip;0;3;0;3
9462;Rūta;SAULUTĖS;2188905055;Taip;10;1;0;11
9463;Sadutė;Kiškučiai;38918375280;Taip;0;1;0;1
9464;Sadutė;Kiškučiai;42447771280;Taip;0;2;0;2
9465;Sadutė;Kiškučiai;62408324442;Taip;5;0;0;5
9466;Sadutė;Kiškučiai;12421864073;Ne;0;1;0;1
9467;Sadutė;Kiškučiai;3253659165;Taip;6;1;0;7
9468;Sadutė;Kiškučiai;67439547513;Taip;6;0;0;6
9469;Sadutė;Kiškučiai;98527988102;Taip;0;7;0;7
9470;Sadutė;Kiškučiai;62077575922;Taip;0;11;4;15
9471;Sadutė;Kiškučiai;75149739907;Taip;0;2;1;3
9472;Sadutė;Kiškučiai;48298497;Taip;0;0;1;1
9473;Sadutė;Kiškučiai;1433422421;Taip;0;0;6;6
9474;Sadutė;Kiškučiai;73649870571;Taip;10;0;8;18
9475;Sadutė;Kiškučiai;1092421263;Taip;4;0;1;5
9476;Sadutė;Kiškučiai;1291782232;Taip;0;0;1;1
9477;Sadutė;Kiškučiai;5586949339;Taip;0;0;4;4
9478;Sadutė;Kiškučiai;64959385010;Taip;0;0;2;2
9479;Sadutė;Kiškučiai;9883685724;Taip;9;5;0;14
9480;Sadutė;Kiškučiai;4525909977;Taip;7;0;3;10
9481;Sadutė;Kiškučiai;1533081218;Taip;0;0;4;4
9482;Sadutė;Kiškučiai;3400524440;Taip;0;0;2;2
9483;Sadutė;Boružėlės;31020557647;Taip;9;0;4;13
9484;Sadutė;Boružėlės;99171108375;Taip;0;0;2;2
9485;Sadutė;Boružėlės;30046732620;Taip;6;0;0;6
9486;Sadutė;Boružėlės;91943880567;Taip;0;9;2;11
9487;Sadutė;Boružėlės;70505797915;Taip;17;0;0;17
9488;Sadutė;Boružėlės;48817619537;Taip;0;2;2;4
9489;Sadutė;Boružėlės;76464399248;Taip;0;0;1;1
9490;Sadutė;Boružėlės;47883796567;Taip;0;1;1;2
9491;Sadutė;Boružėlės;93561298785;Taip;5;1;0;6
9492;Sadutė;Boružėlės;48327367042;Taip;0;0;5;5
9493;Sadutė;Boružėlės;4064111008;Taip;0;1;0;1
9494;Sadutė;Boružėlės;35237170892;Taip;0;2;0;2
9495;Sadutė;Boružėlės;45569403734;Taip;2;2;0;4
9496;Sadutė;Boružėlės;38373089101;Taip;0;0;1;1
9497;Sadutė;Boružėlės;13779484979;Taip;0;11;0;11
9498;Sadutė;Boružėlės;12989960431;Taip;0;0;3;3
9499;Sadutė;Boružėlės;2414632774;Taip;5;0;4;9
9500;Sadutė;Boružėlės;16493384211;Taip;0;0;9;9
9501;Sadutė;Boružėlės;21011440269;Taip;0;4;5;9
9502;Sadutė;Boružėlės;39222963335;Taip;12;0;2;14
9503;Sadutė;Boružėlės;4695479762;Taip;14;0;0;14
9504;Sadutė;Boružėlės;1920496059;Taip;1;2;5;8
9505;Sadutė;Bitutės;85407883222;Taip;0;1;2;3
9506;Sadutė;Bitutės;37258486995;Taip;13;1;0;14
9507;Sadutė;Bitutės;70825850509;Taip;0;1;0;1
9508;Sadutė;Bitutės;15479694222;Ne;0;0;3;3
9509;Sadutė;Bitutės;23009676870;Taip;0;0;1;1
9510;Sadutė;Bitutės;67724608574;Taip;3;1;1;5
9511;Sadutė;Bitutės;61807934102;Taip;0;1;0;1
9512;Sadutė;Bitutės;40775963018;Taip;0;5;5;10
9513;Sadutė;Bitutės;38489473571;Taip;0;1;1;2
9514;Sadutė;Bitutės;60705293244;Taip;0;0;1;1
9515;Sadutė;Bitutės;71457072146;Taip;0;1;0;1
9516;Sadutė;Bitutės;8372941974;Ne;0;6;0;6
9517;Sadutė;Bitutės;6937310439;Taip;0;1;1;2
9518;Sadutė;Bitutės;5143204888;Ne;0;1;0;1
9519;Sadutė;Bitutės;97044964113;Taip;0;0;2;2
9520;Sadutė;Bitutės;63476202833;Taip;0;2;0;2
9521;Sadutė;Bitutės;64311208989;Taip;0;1;0;1
9522;Sadutė;Bitutės;56549103934;Taip;6;0;0;6
9523;Sadutė;Bitutės;78335876444;Taip;0;0;1;1
9524;Sadutė;Bitutės;2133207259;Taip;8;0;0;8
9525;Sadutė;Bitutės;50846021514;Taip;0;1;0;1
9526;Sadutė;Drugeliai;1552350084;Taip;0;5;1;6
9527;Sadutė;Drugeliai;7910380894;Taip;2;0;0;2
9528;Sadutė;Drugeliai;2467800545;Taip;7;0;0;7
9529;Sadutė;Drugeliai;8713575864;Taip;0;5;0;5
9530;Sadutė;Drugeliai;6994547344;Taip;0;1;0;1
9531;Sadutė;Drugeliai;1782594187;Taip;3;0;1;4
9532;Sadutė;Drugeliai;5816844295;Taip;16;0;0;16
9533;Sadutė;Drugeliai;2095914442;Taip;3;0;0;3
9534;Sadutė;Drugeliai;8803249656;Taip;17;0;0;17
9535;Sadutė;Drugeliai;4901634532;Taip;6;0;0;6
9536;Sadutė;Drugeliai;6196282159;Taip;10;0;4;14
9537;Sadutė;Drugeliai;8953107298;Taip;18;0;0;18
9538;Sadutė;Drugeliai;5139219626;Taip;0;0;2;2
9539;Sadutė;Drugeliai;1735450955;Taip;0;1;0;1
9540;Sadutė;Drugeliai;2064784580;Taip;0;1;0;1
9541;Sadutė;Drugeliai;2883991326;Taip;0;5;2;7
9542;Sadutė;Pėledžiukai;50662732693;Taip;15;0;0;15
9543;Sadutė;Pėledžiukai;26761581977;Taip;10;5;1;16
9544;Sadutė;Pėledžiukai;1885941594;Taip;0;11;0;11
9545;Sadutė;Pėledžiukai;4933574100;Taip;0;7;0;7
9546;Sadutė;Pėledžiukai;6105924871;Taip;2;0;0;2
9547;Sadutė;Pėledžiukai;8870465478;Taip;21;0;0;21
9548;Sadutė;Pėledžiukai;64835095908;Taip;16;0;0;16
9549;Sadutė;Pėledžiukai;3619323573;Taip;14;0;0;14
9550;Sadutė;Pėledžiukai;14962142857;Taip;0;1;0;1
9551;Sadutė;Pėledžiukai;92111253012;Taip;0;1;0;1
9552;Sadutė;Pėledžiukai;1594844154;Taip;4;0;0;4
9553;Sadutė;Pėledžiukai;1005751811;Taip;5;0;0;5
9554;Sadutė;Pėledžiukai;61450959987;Taip;2;0;0;2
9555;Sadutė;Pėledžiukai;45981672295;Taip;5;1;0;6
9556;Sadutė;Pėledžiukai;5864572784;Taip;1;0;0;1
9557;Sadutė;Pėledžiukai;8667620186;Taip;0;0;1;1
9558;Sadutė;Pėledžiukai;9946417453;Taip;0;3;0;3
9559;Sadutė;Pėledžiukai;48818906299;Taip;10;0;1;11
9560;Sadutė;Pėledžiukai;1190667513;Taip;0;2;3;5
9561;Sadutė;Pėledžiukai;1988169256;Taip;0;5;1;6
9562;Sadutė;Kačiukų;1507052440;Taip;5;7;4;16
9563;Sadutė;Kačiukų;1903961488;Taip;0;1;0;1
9564;Sadutė;Kačiukų;2890916313;Taip;0;21;0;21
9565;Sadutė;Kačiukų;2733633163;Taip;0;0;2;2
9566;Sadutė;Kačiukų;3993181500;Taip;5;0;0;5
9567;Sadutė;Kačiukų;1871236869;Taip;2;0;0;2
9568;Sadutė;Kačiukų;1759479328;Taip;0;21;0;21
9569;Sadutė;Kačiukų;8835627470;Taip;7;1;2;10
9570;Sadutė;Kačiukų;1975767401;Taip;3;0;0;3
9571;Sadutė;Kačiukų;2532626934;Taip;3;0;1;4
9572;Sadutė;Kačiukų;6253351299;Taip;3;1;2;6
9573;Sadutė;Kačiukų;2426974464;Taip;0;0;1;1
9574;Sadutė;Kačiukų;8974374101;Taip;0;21;0;21
9575;Sadutė;Kačiukų;9285865812;Taip;5;0;0;5
9576;Sadutė;Kačiukų;4401870028;Taip;3;0;1;4
9577;Sakalėlis;GIRINUKŲ;15886891387;Taip;6;0;0;6
9578;Sakalėlis;GIRINUKŲ;18298832212;Taip;6;1;0;7
9579;Sakalėlis;GIRINUKŲ;2124748537;Taip;6;0;3;9
9580;Sakalėlis;GIRINUKŲ;97259304899;Taip;4;0;0;4
9581;Sakalėlis;GIRINUKŲ;1605682818;Taip;0;8;0;8
9582;Sakalėlis;GIRINUKŲ;68379930730;Taip;0;1;1;2
9583;Sakalėlis;GIRINUKŲ;1538847469;Taip;0;0;1;1
9584;Sakalėlis;GIRINUKŲ;57477662126;Taip;0;1;0;1
9585;Sakalėlis;GIRINUKŲ;78050507580;Taip;9;0;0;9
9586;Sakalėlis;GIRINUKŲ;11432510669;Taip;0;1;0;1
9587;Sakalėlis;GIRINUKŲ;19456041826;Taip;8;1;0;9
9588;Sakalėlis;GIRINUKŲ;28930740067;Taip;6;0;0;6
9589;Sakalėlis;GIRINUKŲ;88344653299;Taip;5;0;0;5
9590;Sakalėlis;GIRINUKŲ;15950016412;Taip;0;1;1;2
9591;Sakalėlis;GIRINUKŲ;87950904971;Taip;3;0;1;4
9592;Sakalėlis;GIRINUKŲ;1075787529;Taip;4;1;0;5
9593;Sakalėlis;GIRINUKŲ;44702801581;Taip;0;0;5;5
9594;Sakalėlis;GIRINUKŲ;9634589602;Taip;5;0;2;7
9595;Sakalėlis;VYTURIUKŲ;21726291811;Taip;10;0;1;11
9596;Sakalėlis;VYTURIUKŲ;36411138178;Taip;0;0;2;2
9597;Sakalėlis;VYTURIUKŲ;7852180045;Taip;0;0;1;1
9598;Sakalėlis;VYTURIUKŲ;27291131963;Taip;0;1;2;3
9599;Sakalėlis;VYTURIUKŲ;1822130260;Taip;3;1;1;5
9600;Sakalėlis;VYTURIUKŲ;33360718659;Taip;0;1;1;2
9601;Sakalėlis;VYTURIUKŲ;59440026693;Taip;6;0;0;6
9602;Sakalėlis;VYTURIUKŲ;99937511623;Taip;0;0;1;1
9603;Sakalėlis;VYTURIUKŲ;14495611614;Taip;0;1;1;2
9604;Sakalėlis;VYTURIUKŲ;32956243898;Taip;4;1;1;6
9605;Sakalėlis;VYTURIUKŲ;87806505145;Taip;0;0;1;1
9606;Sakalėlis;VYTURIUKŲ;59067963901;Taip;21;0;0;21
9607;Sakalėlis;VYTURIUKŲ;1371469574;Taip;0;3;0;3
9608;Sakalėlis;VYTURIUKŲ;74622921410;Taip;0;0;1;1
9609;Sakalėlis;VYTURIUKŲ;13953070987;Taip;0;1;8;9
9610;Sakalėlis;VYTURIUKŲ;12474715312;Taip;0;0;4;4
9611;Sakalėlis;VYTURIUKŲ;77801416034;Taip;5;0;0;5
9612;Sakalėlis;VYTURIUKŲ;31051837141;Taip;0;0;1;1
9613;Sakalėlis;VYTURIUKŲ;12601081196;Taip;12;1;1;14
9614;Sakalėlis;DRUGELIŲ;21956747394;Taip;0;2;4;6
9615;Sakalėlis;DRUGELIŲ;98983107357;Taip;0;0;4;4
9616;Sakalėlis;DRUGELIŲ;45025342634;Taip;0;1;0;1
9617;Sakalėlis;DRUGELIŲ;56640981370;Taip;13;0;3;16
9618;Sakalėlis;DRUGELIŲ;91226844252;Taip;0;0;1;1
9619;Sakalėlis;DRUGELIŲ;86990914938;Taip;5;0;5;10
9620;Sakalėlis;DRUGELIŲ;76192257851;Taip;0;0;1;1
9621;Sakalėlis;DRUGELIŲ;2997731442;Taip;5;1;1;7
9622;Sakalėlis;DRUGELIŲ;43454117;Taip;0;3;2;5
9623;Sakalėlis;DRUGELIŲ;40651927926;Taip;5;0;3;8
9624;Sakalėlis;DRUGELIŲ;50107185320;Taip;0;5;0;5
9625;Sakalėlis;DRUGELIŲ;1320801494;Taip;0;0;2;2
9626;Sakalėlis;DRUGELIŲ;10560758846;Taip;0;1;1;2
9627;Sakalėlis;DRUGELIŲ;85527501724;Taip;0;1;1;2
9628;Sakalėlis;DRUGELIŲ;52603313942;Taip;0;1;1;2
9629;Sakalėlis;DRUGELIŲ;47527388407;Taip;3;0;2;5
9630;Sakalėlis;DRUGELIŲ;1194658676;Taip;5;1;0;6
9631;Sakalėlis;DRUGELIŲ;1508916735;Taip;5;1;0;6
9632;Sakalėlis;DRUGELIŲ;69625812172;Taip;4;1;0;5
9633;Sakalėlis;GENIUKŲ;58012583231;Ne;0;0;2;2
9634;Sakalėlis;GENIUKŲ;1114100138;Ne;0;1;12;13
9635;Sakalėlis;GENIUKŲ;11803756564;Taip;0;0;2;2
9636;Sakalėlis;GENIUKŲ;57612724915;Taip;0;0;2;2
9637;Sakalėlis;GENIUKŲ;63956070819;Taip;0;1;0;1
9638;Sakalėlis;GENIUKŲ;98322175734;Taip;0;1;7;8
9639;Sakalėlis;GENIUKŲ;70569243858;Taip;0;1;0;1
9640;Sakalėlis;GENIUKŲ;72915270234;Taip;0;0;1;1
9641;Sakalėlis;GENIUKŲ;87799673875;Taip;0;1;5;6
9642;Sakalėlis;GENIUKŲ;31894397351;Taip;0;0;1;1
9643;Sakalėlis;GENIUKŲ;72289518955;Taip;5;0;1;6
9644;Sakalėlis;GENIUKŲ;13087021336;Taip;15;1;1;17
9645;Sakalėlis;GENIUKŲ;96677994919;Taip;0;1;1;2
9646;Sakalėlis;GENIUKŲ;82248904456;Taip;0;1;1;2
9647;Sakalėlis;GENIUKŲ;23722033078;Taip;0;0;2;2
9648;Sakalėlis;GENIUKŲ;78556677636;Taip;0;1;10;11
9649;Sakalėlis;GENIUKŲ;1321373130;Taip;0;0;1;1
9650;Sakalėlis;GENIUKŲ;45174515952;Taip;4;4;0;8
9651;Sakalėlis;GENIUKŲ;31151919975;Taip;0;1;0;1
9652;Sakalėlis;VOVERIUKŲ;6190741162;Taip;8;0;0;8
9653;Sakalėlis;VOVERIUKŲ;1702964714;Taip;12;0;2;14
9654;Sakalėlis;VOVERIUKŲ;1839096675;Taip;0;2;0;2
9655;Sakalėlis;VOVERIUKŲ;4495453007;Taip;11;0;0;11
9656;Sakalėlis;VOVERIUKŲ;3962436122;Taip;0;1;0;1
9657;Sakalėlis;VOVERIUKŲ;1946531018;Taip;5;0;0;5
9658;Sakalėlis;VOVERIUKŲ;2796230671;Taip;0;1;1;2
9659;Sakalėlis;VOVERIUKŲ;1912068116;Taip;0;1;0;1
9660;Sakalėlis;VOVERIUKŲ;8662137531;Taip;0;1;0;1
9661;Sakalėlis;VOVERIUKŲ;1104881142;Taip;0;2;0;2
9662;Sakalėlis;VOVERIUKŲ;46629941288;Taip;5;0;1;6
9663;Sakalėlis;VOVERIUKŲ;3678172501;Taip;0;1;0;1
9664;Sakalėlis;VOVERIUKŲ;1133377117;Taip;0;0;2;2
9665;Sakalėlis;VOVERIUKŲ;5782214279;Taip;8;0;0;8
9666;Sakalėlis;VOVERIUKŲ;22614338778;Taip;9;0;0;9
9667;Sakalėlis;VOVERIUKŲ;34464485043;Taip;4;0;9;13
9668;Sakalėlis;VOVERIUKŲ;7567476424;Taip;0;1;0;1
9669;Sakalėlis;VOVERIUKŲ;6180987643;Taip;10;0;3;13
9670;Sakalėlis;PĖLEDŽIUKŲ;1974955778;Taip;0;0;3;3
9671;Sakalėlis;PĖLEDŽIUKŲ;69254656227;Taip;0;0;1;1
9672;Sakalėlis;PĖLEDŽIUKŲ;4573623341;Taip;0;3;2;5
9673;Sakalėlis;PĖLEDŽIUKŲ;1359444361;Taip;0;0;2;2
9674;Sakalėlis;PĖLEDŽIUKŲ;58113060986;Taip;2;0;0;2
9675;Sakalėlis;PĖLEDŽIUKŲ;89579043958;Taip;13;5;0;18
9676;Sakalėlis;PĖLEDŽIUKŲ;81593611262;Taip;4;0;0;4
9677;Sakalėlis;PĖLEDŽIUKŲ;1790571847;Taip;6;0;1;7
9678;Sakalėlis;PĖLEDŽIUKŲ;81361557297;Taip;13;0;3;16
9679;Sakalėlis;PĖLEDŽIUKŲ;39504139934;Taip;6;0;0;6
9680;Sakalėlis;PĖLEDŽIUKŲ;67193921335;Taip;3;0;1;4
9681;Sakalėlis;PĖLEDŽIUKŲ;49947049847;Taip;10;0;0;10
9682;Sakalėlis;PĖLEDŽIUKŲ;36670171187;Taip;3;0;0;3
9683;Sakalėlis;PĖLEDŽIUKŲ;79413947806;Taip;0;1;0;1
9684;Sakalėlis;"BITUČIŲ (LOGOPEDINĖ)";1139467130;Taip;0;1;0;1
9685;Sakalėlis;"BITUČIŲ (LOGOPEDINĖ)";4649447372;Taip;19;0;0;19
9686;Sakalėlis;"BITUČIŲ (LOGOPEDINĖ)";1219441890;Taip;1;0;1;2
9687;Sakalėlis;"BITUČIŲ (LOGOPEDINĖ)";4086981816;Ne;0;0;2;2
9688;Sakalėlis;"BITUČIŲ (LOGOPEDINĖ)";4716949191;Taip;5;0;0;5
9689;Sakalėlis;"BITUČIŲ (LOGOPEDINĖ)";2074868084;Taip;0;21;0;21
9690;Sakalėlis;"BITUČIŲ (LOGOPEDINĖ)";1384225025;Taip;9;0;1;10
9691;Sakalėlis;"BITUČIŲ (LOGOPEDINĖ)";8852001037;Taip;4;0;4;8
9692;Sakalėlis;"BORUŽIUKŲ (LOGOPEDINĖ)";68146506860;Taip;0;0;3;3
9693;Sakalėlis;"BORUŽIUKŲ (LOGOPEDINĖ)";92557587855;Taip;9;0;0;9
9694;Sakalėlis;"BORUŽIUKŲ (LOGOPEDINĖ)";32402268054;Taip;0;2;0;2
9695;Sakalėlis;"BORUŽIUKŲ (LOGOPEDINĖ)";8973784809;Taip;0;0;3;3
9696;Sakalėlis;"BORUŽIUKŲ (LOGOPEDINĖ)";22863239773;Taip;1;0;1;2
9697;Sakalėlis;"BORUŽIUKŲ (LOGOPEDINĖ)";70791762492;Taip;0;0;1;1
9698;Sakalėlis;"BORUŽIUKŲ (LOGOPEDINĖ)";9452901338;Taip;0;7;0;7
9699;Sakalėlis;"BORUŽIUKŲ (LOGOPEDINĖ)";76019778588;Taip;0;7;1;8
9700;Sakalėlis;"BORUŽIUKŲ (LOGOPEDINĖ)";4514546151;Taip;0;2;0;2
9701;Sakalėlis;"BORUŽIUKŲ (LOGOPEDINĖ)";50037388220;Taip;5;0;0;5
9702;Sakalėlis;MEŠKUČIŲ;1027765680;Taip;5;2;0;7
9703;Sakalėlis;MEŠKUČIŲ;3371763993;Taip;0;0;3;3
9704;Sakalėlis;MEŠKUČIŲ;2829386777;Taip;11;0;0;11
9705;Sakalėlis;MEŠKUČIŲ;9830907922;Taip;10;4;0;14
9706;Sakalėlis;MEŠKUČIŲ;96053733139;Taip;2;0;0;2
9707;Sakalėlis;MEŠKUČIŲ;1552929452;Taip;15;1;0;16
9708;Sakalėlis;MEŠKUČIŲ;1526540031;Taip;3;6;0;9
9709;Sakalėlis;MEŠKUČIŲ;7987368969;Taip;0;0;8;8
9710;Sakalėlis;MEŠKUČIŲ;8649226611;Taip;0;0;3;3
9711;Sakalėlis;MEŠKUČIŲ;4612388683;Taip;0;12;0;12
9712;Sakalėlis;MEŠKUČIŲ;4775685174;Taip;5;0;0;5
9713;Sakalėlis;MEŠKUČIŲ;4763858893;Taip;0;0;3;3
9714;Sakalėlis;MEŠKUČIŲ;7085108710;Taip;5;0;0;5
9715;Sakalėlis;MEŠKUČIŲ;7159705304;Taip;2;0;0;2
9716;Sakalėlis;MEŠKUČIŲ;3337299648;Taip;5;0;0;5
9717;Sakalėlis;MEŠKUČIŲ;43677485606;Taip;15;0;0;15
9718;Sakalėlis;MEŠKUČIŲ;6727251397;Taip;6;8;0;14
9719;Sakalėlis;KIŠKUČIŲ;5496044442;Taip;16;0;0;16
9720;Sakalėlis;KIŠKUČIŲ;2474164013;Taip;18;0;0;18
9721;Sakalėlis;KIŠKUČIŲ;5405669698;Taip;15;0;0;15
9722;Sakalėlis;KIŠKUČIŲ;9493905856;Taip;0;0;3;3
9723;Sakalėlis;KIŠKUČIŲ;3165387995;Taip;10;0;3;13
9724;Sakalėlis;KIŠKUČIŲ;6603105354;Taip;10;0;0;10
9725;Sakalėlis;KIŠKUČIŲ;3418702674;Taip;10;0;0;10
9726;Sakalėlis;KIŠKUČIŲ;3748865437;Taip;0;2;0;2
9727;Sakalėlis;KIŠKUČIŲ;8667155756;Taip;0;0;1;1
9728;Sakalėlis;KIŠKUČIŲ;6706466627;Taip;5;8;0;13
9729;Sakalėlis;KIŠKUČIŲ;4458071075;Taip;17;0;0;17
9730;Sakalėlis;KIŠKUČIŲ;4209146744;Taip;3;1;0;4
9731;Sakalėlis;KIŠKUČIŲ;2780141413;Taip;0;2;0;2
9732;Sakalėlis;KIŠKUČIŲ;4596727938;Taip;10;0;0;10
9733;Sakalėlis;KIŠKUČIŲ;3333037807;Taip;5;2;0;7
9734;Sakalėlis;KIŠKUČIŲ;6700169944;Taip;5;0;2;7
9735;Sakalėlis;KIŠKUČIŲ;8790189865;Taip;12;0;0;12
9736;Sakalėlis;SVIRPLIUKŲ;4986131090;Taip;0;1;0;1
9737;Sakalėlis;SVIRPLIUKŲ;9322351120;Taip;10;0;5;15
9738;Sakalėlis;SVIRPLIUKŲ;3680732318;Taip;3;6;0;9
9739;Sakalėlis;SVIRPLIUKŲ;4862004373;Taip;15;1;0;16
9740;Sakalėlis;SVIRPLIUKŲ;6579827280;Taip;0;6;0;6
9741;Sakalėlis;SVIRPLIUKŲ;6806170544;Taip;15;0;0;15
9742;Sakalėlis;SVIRPLIUKŲ;8381310908;Taip;7;0;0;7
9743;Sakalėlis;SVIRPLIUKŲ;5795250727;Taip;0;5;0;5
9744;Sakalėlis;SVIRPLIUKŲ;2985239904;Taip;7;5;0;12
9745;Sakalėlis;SVIRPLIUKŲ;3351218789;Taip;5;0;3;8
9746;Sakalėlis;SVIRPLIUKŲ;3927363997;Taip;14;1;0;15
9747;Sakalėlis;SVIRPLIUKŲ;9120873899;Taip;0;21;0;21
9748;Sakalėlis;SVIRPLIUKŲ;1347171934;Taip;2;0;0;2
9749;Sakalėlis;SVIRPLIUKŲ;7672947538;Taip;0;0;2;2
9750;Sakalėlis;SVIRPLIUKŲ;5233697077;Taip;19;0;0;19
9751;Sakalėlis;SVIRPLIUKŲ;2539006620;Taip;0;21;0;21
9752;Sakalėlis;SVIRPLIUKŲ;7285833058;Taip;15;0;0;15
9753;Salininkų;BORUŽIUKAI;61252066272;Taip;0;8;0;8
9754;Salininkų;BORUŽIUKAI;69329549093;Taip;0;0;1;1
9755;Salininkų;BORUŽIUKAI;86262807558;Taip;0;0;1;1
9756;Salininkų;BORUŽIUKAI;81713688097;Taip;0;2;0;2
9757;Salininkų;BORUŽIUKAI;32201000670;Taip;0;4;0;4
9758;Salininkų;BORUŽIUKAI;93466518815;Taip;15;1;0;16
9759;Salininkų;BORUŽIUKAI;75056599725;Taip;0;3;0;3
9760;Salininkų;BORUŽIUKAI;39675001939;Taip;0;1;0;1
9761;Salininkų;BORUŽIUKAI;16879258172;Taip;0;0;4;4
9762;Salininkų;BORUŽIUKAI;2097313917;Taip;0;4;0;4
9763;Salininkų;BORUŽIUKAI;87653480003;Taip;0;8;0;8
9764;Salininkų;BORUŽIUKAI;1614501473;Taip;15;5;0;20
9765;Salininkų;BORUŽIUKAI;1632485114;Taip;9;0;0;9
9766;Salininkų;BORUŽIUKAI;40053462731;Ne;0;13;0;13
9767;Salininkų;BORUŽIUKAI;1364275404;Taip;0;2;0;2
9768;Salininkų;BORUŽIUKAI;77477857775;Taip;5;0;0;5
9769;Salininkų;BORUŽIUKAI;8258045565;Taip;4;0;2;6
9770;Salininkų;BORUŽIUKAI;6978618796;Taip;11;3;0;14
9771;Salininkų;BORUŽIUKAI;8897523583;Taip;0;1;0;1
9772;Salininkų;BORUŽIUKAI;1507178637;Taip;0;1;0;1
9773;Salininkų;BORUŽIUKAI;88149790626;Taip;0;2;0;2
9774;Salininkų;GĖLYTĖS;3015863723;Taip;20;0;0;20
9775;Salininkų;GĖLYTĖS;3323233525;Taip;20;0;0;20
9776;Salininkų;GĖLYTĖS;7665409499;Taip;9;0;0;9
9777;Salininkų;GĖLYTĖS;9890660815;Taip;7;0;1;8
9778;Salininkų;GĖLYTĖS;4323257798;Taip;5;0;0;5
9779;Salininkų;GĖLYTĖS;6850925495;Taip;1;0;2;3
9780;Salininkų;GĖLYTĖS;3585435095;Taip;0;0;1;1
9781;Salininkų;GĖLYTĖS;2760231414;Taip;20;0;0;20
9782;Salininkų;GĖLYTĖS;9724367035;Taip;15;1;0;16
9783;Salininkų;GĖLYTĖS;1658695150;Taip;9;1;1;11
9784;Salininkų;GĖLYTĖS;7383557807;Taip;7;2;0;9
9785;Salininkų;GĖLYTĖS;9344614003;Taip;12;1;0;13
9786;Salininkų;GĖLYTĖS;2808778763;Taip;4;11;0;15
9787;Salininkų;GĖLYTĖS;6656578271;Taip;5;0;2;7
9788;Salininkų;GĖLYTĖS;2278499562;Taip;0;0;2;2
9789;Salininkų;GĖLYTĖS;8995565864;Taip;14;3;0;17
9790;Salininkų;GĖLYTĖS;8394582546;Taip;0;9;0;9
9791;Salininkų;GĖLYTĖS;6327046935;Taip;4;9;2;15
9792;Salininkų;DRUGELIAI;1641123436;Taip;21;0;0;21
9793;Salininkų;DRUGELIAI;1910467994;Taip;6;4;0;10
9794;Salininkų;DRUGELIAI;2812554783;Taip;10;0;0;10
9795;Salininkų;DRUGELIAI;14626363996;Taip;16;0;0;16
9796;Salininkų;DRUGELIAI;1883307260;Taip;0;1;1;2
9797;Salininkų;DRUGELIAI;1948988168;Taip;17;0;0;17
9798;Salininkų;DRUGELIAI;1868857584;Taip;0;0;5;5
9799;Salininkų;DRUGELIAI;5434294777;Taip;0;0;1;1
9800;Salininkų;DRUGELIAI;1815368137;Taip;7;0;0;7
9801;Salininkų;DRUGELIAI;8157811781;Taip;0;7;0;7
9802;Salininkų;DRUGELIAI;48956671934;Taip;21;0;0;21
9803;Salininkų;DRUGELIAI;1963139815;Taip;2;0;2;4
9804;Salininkų;DRUGELIAI;45194646218;Taip;0;3;0;3
9805;Salininkų;DRUGELIAI;6125334614;Taip;4;9;2;15
9806;Salininkų;DRUGELIAI;15199054558;Ne;0;10;0;10
9807;Salininkų;DRUGELIAI;1568780329;Taip;11;5;0;16
9808;Salininkų;DRUGELIAI;30123603107;Taip;15;0;0;15
9809;Salininkų;DRUGELIAI;9074440999;Taip;6;0;1;7
9810;Salininkų;ŽIRNIUKAI;5063792784;Taip;10;0;0;10
9811;Salininkų;ŽIRNIUKAI;73016259669;Taip;5;0;0;5
9812;Salininkų;ŽIRNIUKAI;1355032282;Taip;10;2;0;12
9813;Salininkų;ŽIRNIUKAI;35611320012;Taip;0;3;0;3
9814;Salininkų;ŽIRNIUKAI;22167560908;Taip;0;2;0;2
9815;Salininkų;ŽIRNIUKAI;5689344488;Taip;6;0;0;6
9816;Salininkų;ŽIRNIUKAI;2292919406;Taip;0;10;0;10
9817;Salininkų;ŽIRNIUKAI;10335028421;Taip;17;0;1;18
9818;Salininkų;ŽIRNIUKAI;8488127476;Taip;3;0;1;4
9819;Salininkų;ŽIRNIUKAI;1723241116;Taip;5;2;1;8
9820;Salininkų;ŽIRNIUKAI;46867660097;Taip;6;6;0;12
9821;Salininkų;ŽIRNIUKAI;4269202761;Taip;17;0;2;19
9822;Salininkų;ŽIRNIUKAI;3692008687;Taip;0;10;0;10
9823;Salininkų;ŽIRNIUKAI;91859774311;Taip;5;0;2;7
9824;Salininkų;ŽIRNIUKAI;1065549119;Taip;0;0;1;1
9825;Salininkų;PAUKŠČIUKAI;1202154135;Taip;0;2;0;2
9826;Salininkų;PAUKŠČIUKAI;1489067126;Taip;11;1;0;12
9827;Salininkų;PAUKŠČIUKAI;1521333219;Taip;0;1;0;1
9828;Salininkų;PAUKŠČIUKAI;95919160139;Taip;15;1;0;16
9829;Salininkų;PAUKŠČIUKAI;23990693770;Taip;0;1;0;1
9830;Salininkų;PAUKŠČIUKAI;67593920224;Taip;10;3;0;13
9831;Salininkų;PAUKŠČIUKAI;1153455356;Taip;0;4;0;4
9832;Salininkų;PAUKŠČIUKAI;1470744233;Taip;0;6;0;6
9833;Salininkų;PAUKŠČIUKAI;2031724954;Taip;0;3;0;3
9834;Salininkų;PAUKŠČIUKAI;52499970010;Taip;6;0;0;6
9835;Salininkų;PAUKŠČIUKAI;18178857793;Taip;0;6;0;6
9836;Salininkų;PAUKŠČIUKAI;1439852031;Taip;6;9;0;15
9837;Salininkų;PAUKŠČIUKAI;20609963605;Taip;5;2;0;7
9838;Salininkų;PAUKŠČIUKAI;52194170807;Taip;0;2;0;2
9839;Salininkų;PAUKŠČIUKAI;86019335524;Taip;0;2;0;2
9840;Salininkų;PAUKŠČIUKAI;1586012117;Taip;5;3;0;8
9841;Salininkų;PAUKŠČIUKAI;2415539904;Taip;0;1;0;1
9842;Salininkų;PAUKŠČIUKAI;29341671329;Taip;0;6;0;6
9843;Salininkų;PAUKŠČIUKAI;3878896109;Taip;9;9;0;18
9844;Salininkų;PAUKŠČIUKAI;16967442608;Taip;0;10;0;10
9845;Salvija;Daigelis(šatil);1517130961;Ne;4;0;0;4
9846;Salvija;Daigelis(šatil);1478775998;Taip;0;5;1;6
9847;Salvija;Daigelis(šatil);8802891478;Ne;0;5;3;8
9848;Salvija;Daigelis(šatil);24038366791;Taip;6;0;1;7
9849;Salvija;Daigelis(šatil);12326049516;Taip;10;0;0;10
9850;Salvija;Daigelis(šatil);1261005294;Taip;0;0;1;1
9851;Salvija;Daigelis(šatil);62170308628;Taip;4;0;0;4
9852;Salvija;Daigelis(šatil);3424917706;Ne;10;0;1;11
9853;Salvija;Daigelis(šatil);9908473681;Taip;0;0;1;1
9854;Salvija;Daigelis(šatil);4152602039;Taip;0;0;3;3
9855;Salvija;Daigelis(šatil);9456556523;Taip;0;0;4;4
9856;Salvija;Daigelis(šatil);3856351749;Taip;0;0;5;5
9857;Salvija;Daigelis(šatil);1791922219;Taip;9;2;0;11
9858;Salvija;Daigelis(šatil);1653831148;Taip;4;0;0;4
9859;Salvija;Daigelis(šatil);8023422294;Taip;8;0;4;12
9860;Salvija;Daigelis(šatil);7449993309;Taip;6;0;4;10
9861;Salvija;"Pienė (savjon)";20005587910;Taip;0;6;3;9
9862;Salvija;"Pienė (savjon)";1826525181;Taip;0;5;2;7
9863;Salvija;"Pienė (savjon)";53604559443;Taip;0;1;1;2
9864;Salvija;"Pienė (savjon)";22615390885;Taip;0;0;1;1
9865;Salvija;"Pienė (savjon)";9168718017;Taip;21;0;0;21
9866;Salvija;"Pienė (savjon)";4167467237;Taip;0;6;0;6
9867;Salvija;"Pienė (savjon)";8585265946;Taip;0;0;1;1
9868;Salvija;"Pienė (savjon)";1641242817;Taip;4;1;0;5
9869;Salvija;"Pienė (savjon)";85826762998;Taip;3;0;0;3
9870;Salvija;"Pienė (savjon)";58888784609;Taip;0;5;0;5
9871;Salvija;"Pienė (savjon)";96747548556;Taip;0;1;0;1
9872;Salvija;"Pienė (savjon)";47567003954;Taip;0;5;1;6
9873;Salvija;"Pienė (savjon)";4845744417;Taip;0;6;0;6
9874;Salvija;"Pienė (savjon)";2495133021;Taip;0;6;0;6
9875;Salvija;"Pienė (savjon)";57752478379;Taip;0;6;0;6
9876;Salvija;"Pienė (savjon)";62121799666;Taip;5;3;0;8
9877;Salvija;"Pienė (savjon)";95774147903;Taip;0;5;1;6
9878;Salvija;"Pienė (savjon)";41158937437;Taip;0;3;0;3
9879;Saulėtekis;BERŽELIS;37001834066;Taip;14;0;1;15
9880;Saulėtekis;BERŽELIS;29935189464;Taip;0;0;2;2
9881;Saulėtekis;BERŽELIS;95214907923;Taip;0;1;0;1
9882;Saulėtekis;BERŽELIS;49102885577;Taip;0;4;0;4
9883;Saulėtekis;BERŽELIS;18801492293;Taip;2;0;0;2
9884;Saulėtekis;BERŽELIS;43809213927;Taip;0;1;0;1
9885;Saulėtekis;BERŽELIS;17046444483;Taip;8;0;0;8
9886;Saulėtekis;BERŽELIS;14357681543;Taip;0;0;3;3
9887;Saulėtekis;BERŽELIS;27109020149;Taip;8;1;0;9
9888;Saulėtekis;BERŽELIS;42952333477;Taip;5;6;0;11
9889;Saulėtekis;BERŽELIS;88165168902;Taip;5;2;0;7
9890;Saulėtekis;BERŽELIS;19786161536;Taip;4;2;0;6
9891;Saulėtekis;BERŽELIS;55975992548;Taip;0;7;0;7
9892;Saulėtekis;BERŽELIS;9333073549;Taip;0;5;0;5
9893;Saulėtekis;BERŽELIS;9632257866;Taip;5;0;5;10
9894;Saulėtekis;BERŽELIS;24403133622;Taip;0;8;0;8
9895;Saulėtekis;BERŽELIS;7440287746;Taip;5;4;0;9
9896;Saulėtekis;BERŽELIS;1359594045;Taip;0;0;2;2
9897;Saulėtekis;BERŽELIS;1502304241;Ne;0;4;0;4
9898;Saulėtekis;BERŽELIS;19209281962;Taip;0;0;4;4
9899;Saulėtekis;BERŽELIS;2096996257;Taip;13;0;4;17
9900;Saulėtekis;ŠYPSENA;9972687066;Taip;5;3;0;8
9901;Saulėtekis;ŠYPSENA;7346852524;Taip;12;0;0;12
9902;Saulėtekis;ŠYPSENA;1902333363;Taip;12;0;0;12
9903;Saulėtekis;ŠYPSENA;6072030240;Taip;4;0;0;4
9904;Saulėtekis;ŠYPSENA;8574702901;Taip;11;0;0;11
9905;Saulėtekis;ŠYPSENA;7893982893;Taip;6;0;0;6
9906;Saulėtekis;ŠYPSENA;7505040675;Taip;0;3;0;3
9907;Saulėtekis;ŠYPSENA;6501250875;Taip;17;0;0;17
9908;Saulėtekis;ŠYPSENA;9791926936;Taip;12;3;3;18
9909;Saulėtekis;ŠYPSENA;8620689981;Taip;0;4;0;4
9910;Saulėtekis;ŠYPSENA;8143793642;Taip;9;1;0;10
9911;Saulėtekis;ŠYPSENA;8603952810;Taip;4;0;0;4
9912;Saulėtekis;ŠYPSENA;9783450998;Taip;0;3;0;3
9913;Saulėtekis;ŠYPSENA;4909850069;Taip;10;0;0;10
9914;Saulėtekis;NYKŠTUKAI;62765692719;Taip;7;1;0;8
9915;Saulėtekis;NYKŠTUKAI;87107015716;Taip;0;1;0;1
9916;Saulėtekis;NYKŠTUKAI;81074197598;Taip;0;1;0;1
9917;Saulėtekis;NYKŠTUKAI;87539304992;Taip;0;4;0;4
9918;Saulėtekis;NYKŠTUKAI;75818502835;Taip;6;0;0;6
9919;Saulėtekis;NYKŠTUKAI;1769434568;Taip;17;0;0;17
9920;Saulėtekis;NYKŠTUKAI;23597877284;Taip;4;2;0;6
9921;Saulėtekis;NYKŠTUKAI;36050720419;Taip;0;10;0;10
9922;Saulėtekis;NYKŠTUKAI;29734420962;Taip;0;9;0;9
9923;Saulėtekis;NYKŠTUKAI;1623791240;Taip;0;9;0;9
9924;Saulėtekis;NYKŠTUKAI;71042846070;Taip;6;1;0;7
9925;Saulėtekis;NYKŠTUKAI;46936348504;Taip;0;3;0;3
9926;Saulėtekis;NYKŠTUKAI;47570401883;Taip;10;1;0;11
9927;Saulėtekis;NYKŠTUKAI;89956895058;Taip;0;6;0;6
9928;Saulėtekis;NYKŠTUKAI;90708381762;Taip;3;5;0;8
9929;Saulėtekis;NYKŠTUKAI;90484365520;Taip;0;2;0;2
9930;Saulėtekis;NYKŠTUKAI;40443812162;Taip;4;0;0;4
9931;Saulėtekis;NYKŠTUKAI;57417558875;Taip;0;9;0;9
9932;Saulėtekis;NYKŠTUKAI;1288313734;Taip;16;0;0;16
9933;Saulėtekis;PAGRANDUKAS;9428709415;Taip;11;2;0;13
9934;Saulėtekis;PAGRANDUKAS;8102360466;Taip;17;0;0;17
9935;Saulėtekis;PAGRANDUKAS;2371396923;Taip;18;0;0;18
9936;Saulėtekis;PAGRANDUKAS;4152255439;Taip;16;0;0;16
9937;Saulėtekis;PAGRANDUKAS;2209156661;Taip;5;0;6;11
9938;Saulėtekis;PAGRANDUKAS;3220993253;Taip;3;0;1;4
9939;Saulėtekis;PAGRANDUKAS;5552614092;Taip;0;0;1;1
9940;Saulėtekis;PAGRANDUKAS;9497129509;Taip;2;6;0;8
9941;Saulėtekis;PAGRANDUKAS;9918219913;Taip;8;0;0;8
9942;Saulėtekis;PAGRANDUKAS;8517049464;Taip;1;10;0;11
9943;Saulėtekis;PAGRANDUKAS;7186085219;Taip;16;0;1;17
9944;Saulėtekis;PAGRANDUKAS;1020209414;Taip;6;0;1;7
9945;Saulėtekis;PAGRANDUKAS;8745921541;Taip;16;1;0;17
9946;Saulėtekis;PAGRANDUKAS;2728836108;Taip;6;6;0;12
9947;Saulėtekis;PAGRANDUKAS;8390615573;Taip;11;0;0;11
9948;Saulėtekis;PAGRANDUKAS;2698535938;Taip;4;2;0;6
9949;Saulėtekis;PAGRANDUKAS;2656659133;Taip;18;3;0;21
9950;Saulėtekis;RAMUNĖLIŲ;70948000188;Taip;0;1;0;1
9951;Saulėtekis;RAMUNĖLIŲ;1456140823;Taip;0;0;1;1
9952;Saulėtekis;RAMUNĖLIŲ;16450627896;Taip;0;0;2;2
9953;Saulėtekis;RAMUNĖLIŲ;60662699125;Taip;0;0;1;1
9954;Saulėtekis;RAMUNĖLIŲ;77630031851;Taip;16;0;0;16
9955;Saulėtekis;RAMUNĖLIŲ;31291807930;Taip;0;11;0;11
9956;Saulėtekis;RAMUNĖLIŲ;49053923177;Taip;0;0;1;1
9957;Saulėtekis;RAMUNĖLIŲ;42485505048;Ne;5;5;0;10
9958;Saulėtekis;RAMUNĖLIŲ;86593254070;Taip;6;0;2;8
9959;Saulėtekis;RAMUNĖLIŲ;75785868657;Taip;4;1;0;5
9960;Saulėtekis;RAMUNĖLIŲ;40093795729;Taip;16;0;0;16
9961;Saulėtekis;RAMUNĖLIŲ;10524532865;Taip;6;6;0;12
9962;Saulėtekis;RAMUNĖLIŲ;80037388013;Taip;5;0;0;5
9963;Saulėtekis;RAMUNĖLIŲ;1219435678;Taip;0;3;0;3
9964;Saulėtekis;RAMUNĖLIŲ;29662148323;Taip;5;0;0;5
9965;Saulėtekis;RAMUNĖLIŲ;3394231244;Taip;0;1;1;2
9966;Saulėtekis;RAMUNĖLIŲ;7544912614;Taip;0;3;0;3
9967;Saulėtekis;RAMUNĖLIŲ;1349303787;Taip;16;0;0;16
9968;Saulėtekis;RAMUNĖLIŲ;1103824875;Taip;3;0;1;4
9969;Saulėtekis;PASAKAITĖ;3458088977;Taip;5;1;0;6
9970;Saulėtekis;PASAKAITĖ;80652165734;Taip;10;0;3;13
9971;Saulėtekis;PASAKAITĖ;99932790328;Taip;6;1;0;7
9972;Saulėtekis;PASAKAITĖ;33621514262;Taip;5;1;3;9
9973;Saulėtekis;PASAKAITĖ;24878473562;Taip;0;11;0;11
9974;Saulėtekis;PASAKAITĖ;96500691386;Taip;0;1;0;1
9975;Saulėtekis;PASAKAITĖ;33485541086;Taip;0;14;0;14
9976;Saulėtekis;PASAKAITĖ;36401102768;Taip;2;1;0;3
9977;Saulėtekis;PASAKAITĖ;71579240842;Ne;8;4;0;12
9978;Saulėtekis;PASAKAITĖ;6833534993;Taip;6;0;0;6
9979;Saulėtekis;PASAKAITĖ;30101217515;Taip;10;0;0;10
9980;Saulėtekis;PASAKAITĖ;75415518904;Taip;0;4;0;4
9981;Saulėtekis;PASAKAITĖ;5777142934;Taip;5;0;0;5
9982;Saulėtekis;PASAKAITĖ;5068358612;Taip;0;7;0;7
9983;Saulėtekis;PASAKAITĖ;6084164103;Taip;21;0;0;21
9984;Saulėtekis;PASAKAITĖ;17692658424;Ne;0;1;0;1
9985;Saulėtekis;VARPELIAI;94326821425;Taip;5;8;0;13
9986;Saulėtekis;VARPELIAI;1339984127;Taip;0;5;0;5
9987;Saulėtekis;VARPELIAI;68563453302;Taip;18;0;0;18
9988;Saulėtekis;VARPELIAI;77901730057;Taip;8;3;0;11
9989;Saulėtekis;VARPELIAI;74713390994;Taip;5;0;0;5
9990;Saulėtekis;VARPELIAI;43127755042;Taip;0;3;0;3
9991;Saulėtekis;VARPELIAI;1335149249;Taip;0;4;0;4
9992;Saulėtekis;VARPELIAI;1108321396;Taip;5;0;0;5
9993;Saulėtekis;VARPELIAI;891603633;Taip;6;4;0;10
9994;Saulėtekis;VARPELIAI;36605502570;Taip;6;0;3;9
9995;Saulėtekis;VARPELIAI;2075281680;Taip;12;1;0;13
9996;Saulėtekis;VARPELIAI;1213567219;Taip;7;0;1;8
9997;Saulėtekis;VARPELIAI;61118132521;Taip;0;2;0;2
9998;Saulėtekis;VARPELIAI;7464965841;Taip;4;0;0;4
9999;Saulėtekis;VARPELIAI;6671771491;Taip;5;4;0;9
10000;Saulėtekis;VARPELIAI;8752857993;Taip;0;9;0;9
10001;Saulėtekis;VARPELIAI;2641849320;Ne;8;0;0;8
10002;Saulėtekis;GRŪDELIS;20794781914;Taip;18;0;0;18
10003;Saulėtekis;GRŪDELIS;9132383069;Taip;8;0;0;8
10004;Saulėtekis;GRŪDELIS;67951758325;Taip;6;0;0;6
10005;Saulėtekis;GRŪDELIS;70230805151;Taip;9;0;1;10
10006;Saulėtekis;GRŪDELIS;41775536104;Taip;0;2;0;2
10007;Saulėtekis;GRŪDELIS;12954283491;Taip;5;2;0;7
10008;Saulėtekis;GRŪDELIS;21376960952;Taip;0;8;0;8
10009;Saulėtekis;GRŪDELIS;4027823257;Taip;0;0;2;2
10010;Saulėtekis;GRŪDELIS;86804497954;Taip;8;2;0;10
10011;Saulėtekis;GRŪDELIS;1180197203;Taip;9;0;0;9
10012;Saulėtekis;GRŪDELIS;1066191639;Taip;5;0;0;5
10013;Saulėtekis;GRŪDELIS;98936544904;Taip;0;0;1;1
10014;Saulėtekis;GRŪDELIS;22570044589;Taip;1;0;2;3
10015;Saulėtekis;GRŪDELIS;1865278537;Taip;0;7;0;7
10016;Saulėtekis;GRŪDELIS;1220962473;Taip;6;1;0;7
10017;Saulėtekis;GRŪDELIS;20534872540;Taip;14;0;0;14
10018;Saulėtekis;GRŪDELIS;53906058088;Taip;0;11;2;13
10019;Saulėtekis;GRŪDELIS;1646943569;Taip;17;0;0;17
10020;Saulėtekis;JONVABALIS;5003645081;Taip;17;0;0;17
10021;Saulėtekis;JONVABALIS;21569877958;Taip;0;2;0;2
10022;Saulėtekis;JONVABALIS;6736441901;Taip;13;2;0;15
10023;Saulėtekis;JONVABALIS;1466627555;Taip;0;9;0;9
10024;Saulėtekis;JONVABALIS;1691667254;Taip;0;17;0;17
10025;Saulėtekis;JONVABALIS;1064355395;Taip;0;5;0;5
10026;Saulėtekis;JONVABALIS;45284061866;Taip;6;0;0;6
10027;Saulėtekis;JONVABALIS;1715634399;Taip;5;8;0;13
10028;Saulėtekis;JONVABALIS;1897872021;Taip;0;7;0;7
10029;Saulėtekis;JONVABALIS;1010906684;Taip;8;0;0;8
10030;Saulėtekis;JONVABALIS;97037457833;Taip;2;6;0;8
10031;Saulėtekis;JONVABALIS;1111323783;Taip;0;10;0;10
10032;Saulėtekis;JONVABALIS;84492261206;Taip;10;4;0;14
10033;Saulėtekis;JONVABALIS;72559769416;Taip;4;0;0;4
10034;Saulėtekis;JONVABALIS;29552225924;Taip;0;3;0;3
10035;Saulėtekis;JONVABALIS;1611009868;Taip;14;0;0;14
10036;Saulėtekis;JONVABALIS;4613040294;Taip;11;0;0;11
10037;Saulėtekis;JONVABALIS;1655720839;Taip;8;0;0;8
10038;Saulėtekis;SMALSUČIAI;40877542045;Taip;13;0;0;13
10039;Saulėtekis;SMALSUČIAI;9095968376;Taip;2;4;0;6
10040;Saulėtekis;SMALSUČIAI;86524549051;Taip;4;0;0;4
10041;Saulėtekis;SMALSUČIAI;7030227903;Taip;0;2;1;3
10042;Saulėtekis;SMALSUČIAI;81118611780;Taip;6;0;0;6
10043;Saulėtekis;SMALSUČIAI;38762730531;Taip;9;2;0;11
10044;Saulėtekis;SMALSUČIAI;1808644850;Taip;10;4;0;14
10045;Saulėtekis;SMALSUČIAI;1642031589;Taip;0;9;0;9
10046;Saulėtekis;SMALSUČIAI;29472863931;Taip;1;4;0;5
10047;Saulėtekis;SMALSUČIAI;8415116580;Taip;6;1;0;7
10048;Saulėtekis;SMALSUČIAI;97771948184;Taip;10;1;0;11
10049;Saulėtekis;SMALSUČIAI;7621094096;Taip;0;1;0;1
10050;Saulėtekis;SMALSUČIAI;13451381485;Taip;13;0;0;13
10051;Saulėtekis;SMALSUČIAI;19605249139;Taip;10;1;0;11
10052;Saulėtekis;SMALSUČIAI;1619134034;Taip;13;1;0;14
10053;Saulėtekis;SMALSUČIAI;8673024996;Taip;1;0;1;2
10054;Saulėtekis;SMALSUČIAI;1456865685;Taip;6;5;0;11
10055;Saulėtekis;SMALSUČIAI;32658647272;Taip;7;0;0;7
10056;Saulėtekis;BITUTĖS;7766084857;Taip;11;0;0;11
10057;Saulėtekis;BITUTĖS;4537254306;Taip;0;3;0;3
10058;Saulėtekis;BITUTĖS;60462712074;Taip;12;0;0;12
10059;Saulėtekis;BITUTĖS;1699576940;Taip;0;1;0;1
10060;Saulėtekis;BITUTĖS;9945647968;Taip;7;3;0;10
10061;Saulėtekis;BITUTĖS;1962914764;Taip;9;6;0;15
10062;Saulėtekis;BITUTĖS;8302260087;Taip;0;0;3;3
10063;Saulėtekis;BITUTĖS;2593106154;Taip;0;2;0;2
10064;Saulėtekis;BITUTĖS;2813949848;Taip;12;1;0;13
10065;Saulėtekis;BITUTĖS;9983577817;Taip;11;2;0;13
10066;Saulėtekis;BITUTĖS;7986712728;Taip;14;1;0;15
10067;Saulėtekis;BITUTĖS;6087170055;Taip;17;0;0;17
10068;Saulėtekis;BITUTĖS;7027103276;Taip;0;4;0;4
10069;Saulėtekis;BITUTĖS;7758268674;Taip;0;0;2;2
10070;Saulėtekis;BITUTĖS;2077976415;Taip;13;0;1;14
10071;Saulėtekis;BITUTĖS;9605052795;Taip;9;1;0;10
10072;Saulėtekis;BITUTĖS;7075757274;Taip;12;0;0;12
10073;Saulėtekis;RIEŠUTĖLIAI;3337160930;Taip;18;0;0;18
10074;Saulėtekis;RIEŠUTĖLIAI;2021901593;Taip;1;4;0;5
10075;Saulėtekis;RIEŠUTĖLIAI;7842280836;Taip;0;5;0;5
10076;Saulėtekis;RIEŠUTĖLIAI;2407911405;Taip;5;0;0;5
10077;Saulėtekis;RIEŠUTĖLIAI;6102064617;Taip;0;1;0;1
10078;Saulėtekis;RIEŠUTĖLIAI;2238947856;Taip;5;9;0;14
10079;Saulėtekis;RIEŠUTĖLIAI;84982517658;Taip;0;1;0;1
10080;Saulėtekis;RIEŠUTĖLIAI;3541535891;Taip;5;0;0;5
10081;Saulėtekis;RIEŠUTĖLIAI;36003078842;Taip;0;3;0;3
10082;Saulėtekis;RIEŠUTĖLIAI;4663268649;Taip;5;0;0;5
10083;Saulėtekis;RIEŠUTĖLIAI;25199011812;Taip;17;0;0;17
10084;Saulėtekis;RIEŠUTĖLIAI;81153273188;Taip;6;1;0;7
10085;Saulėtekis;RIEŠUTĖLIAI;1290215067;Taip;4;0;2;6
10086;Saulėtekis;RIEŠUTĖLIAI;7051608858;Taip;18;0;0;18
10087;Saulėtekis;RIEŠUTĖLIAI;9634949452;Taip;3;1;0;4
10088;Saulėtekis;RIEŠUTĖLIAI;4338502152;Taip;0;1;0;1
10089;Saulėtekis;RIEŠUTĖLIAI;8002806189;Taip;11;0;1;12
10090;Saulėtekis;RIEŠUTĖLIAI;9657195627;Taip;13;1;0;14
10091;Skroblinukas;SVIRPLIUKŲ;56496090956;Ne;0;0;3;3
10092;Skroblinukas;SVIRPLIUKŲ;27948464942;Taip;1;0;7;8
10093;Skroblinukas;SVIRPLIUKŲ;92096423589;Taip;3;3;0;6
10094;Skroblinukas;SVIRPLIUKŲ;69303322030;Taip;0;0;2;2
10095;Skroblinukas;SVIRPLIUKŲ;2034869306;Taip;1;4;0;5
10096;Skroblinukas;SVIRPLIUKŲ;2020866728;Taip;2;0;0;2
10097;Skroblinukas;SVIRPLIUKŲ;91070212533;Taip;9;5;0;14
10098;Skroblinukas;SVIRPLIUKŲ;60291417607;Taip;0;5;0;5
10099;Skroblinukas;SVIRPLIUKŲ;18955401411;Taip;6;0;1;7
10100;Skroblinukas;SVIRPLIUKŲ;31484348317;Taip;4;1;0;5
10101;Skroblinukas;SVIRPLIUKŲ;88601994922;Taip;6;7;0;13
10102;Skroblinukas;SVIRPLIUKŲ;1364608720;Taip;5;2;0;7
10103;Skroblinukas;SVIRPLIUKŲ;31670763980;Taip;2;0;2;4
10104;Skroblinukas;SVIRPLIUKŲ;89356084678;Ne;5;1;0;6
10105;Skroblinukas;SVIRPLIUKŲ;30925721180;Taip;0;3;0;3
10106;Skroblinukas;SVIRPLIUKŲ;87902801288;Taip;0;4;0;4
10107;Skroblinukas;SVIRPLIUKŲ;1462404838;Taip;0;2;0;2
10108;Skroblinukas;SVIRPLIUKŲ;23551272822;Taip;0;3;5;8
10109;Skroblinukas;GANDRIUKŲ;9936253477;Taip;0;3;0;3
10110;Skroblinukas;GANDRIUKŲ;11039821123;Taip;0;3;0;3
10111;Skroblinukas;GANDRIUKŲ;2574443420;Taip;15;1;1;17
10112;Skroblinukas;GANDRIUKŲ;47487985525;Taip;0;1;0;1
10113;Skroblinukas;GANDRIUKŲ;77924018810;Taip;5;1;0;6
10114;Skroblinukas;GANDRIUKŲ;55187339508;Taip;6;5;1;12
10115;Skroblinukas;GANDRIUKŲ;1799813420;Taip;10;1;0;11
10116;Skroblinukas;GANDRIUKŲ;29786434898;Taip;6;1;0;7
10117;Skroblinukas;GANDRIUKŲ;1852949849;Taip;10;2;0;12
10118;Skroblinukas;GANDRIUKŲ;74443337196;Taip;0;1;0;1
10119;Skroblinukas;GANDRIUKŲ;33658383206;Taip;0;13;0;13
10120;Skroblinukas;GANDRIUKŲ;77076233947;Taip;0;6;0;6
10121;Skroblinukas;GANDRIUKŲ;28889483128;Taip;0;1;1;2
10122;Skroblinukas;GANDRIUKŲ;18613971878;Taip;5;0;1;6
10123;Skroblinukas;GANDRIUKŲ;19962514046;Taip;0;12;1;13
10124;Skroblinukas;GANDRIUKŲ;69558864958;Taip;5;11;1;17
10125;Skroblinukas;GANDRIUKŲ;68389194619;Taip;1;1;0;2
10126;Skroblinukas;GANDRIUKŲ;65724262749;Taip;5;1;0;6
10127;Skroblinukas;GANDRIUKŲ;6662751729;Ne;0;0;2;2
10128;Skroblinukas;GANDRIUKŲ;7616559972;Ne;0;1;0;1
10129;Skroblinukas;GANDRIUKŲ;3519615689;Ne;0;1;0;1
10130;Skroblinukas;VYTURIUKŲ;32625726014;Ne;0;1;2;3
10131;Skroblinukas;VYTURIUKŲ;40320573258;Taip;6;9;0;15
10132;Skroblinukas;VYTURIUKŲ;85882169908;Taip;0;10;1;11
10133;Skroblinukas;VYTURIUKŲ;98214579906;Taip;0;2;0;2
10134;Skroblinukas;VYTURIUKŲ;81438612530;Taip;1;6;0;7
10135;Skroblinukas;VYTURIUKŲ;778965033;Taip;0;3;0;3
10136;Skroblinukas;VYTURIUKŲ;89809217827;Taip;0;3;0;3
10137;Skroblinukas;VYTURIUKŲ;25474129751;Taip;4;0;0;4
10138;Skroblinukas;VYTURIUKŲ;9313338574;Ne;0;2;0;2
10139;Skroblinukas;VYTURIUKŲ;152535859;Taip;0;5;0;5
10140;Skroblinukas;VYTURIUKŲ;1935381164;Taip;0;1;4;5
10141;Skroblinukas;VYTURIUKŲ;64034793218;Taip;0;0;7;7
10142;Skroblinukas;VYTURIUKŲ;52489636337;Taip;0;9;0;9
10143;Skroblinukas;VYTURIUKŲ;21966526141;Taip;0;1;3;4
10144;Skroblinukas;VYTURIUKŲ;55519865793;Taip;0;14;0;14
10145;Skroblinukas;VYTURIUKŲ;87202801900;Taip;0;1;0;1
10146;Skroblinukas;VYTURIUKŲ;58117699822;Ne;5;0;1;6
10147;Skroblinukas;VYTURIUKŲ;17906689562;Taip;1;0;0;1
10148;Skroblinukas;VYTURIUKŲ;78319454763;Taip;0;1;4;5
10149;Skroblinukas;GENIUKŲ;48655837755;Taip;2;0;0;2
10150;Skroblinukas;GENIUKŲ;1930578755;Taip;7;0;2;9
10151;Skroblinukas;GENIUKŲ;4393041946;Taip;0;0;2;2
10152;Skroblinukas;GENIUKŲ;2323980730;Taip;5;0;0;5
10153;Skroblinukas;GENIUKŲ;1325903217;Taip;0;6;0;6
10154;Skroblinukas;GENIUKŲ;8380073853;Taip;0;0;12;12
10155;Skroblinukas;GENIUKŲ;1361836818;Ne;0;1;3;4
10156;Skroblinukas;GENIUKŲ;5766702969;Taip;0;15;2;17
10157;Skroblinukas;GENIUKŲ;4436698905;Taip;13;0;0;13
10158;Skroblinukas;GENIUKŲ;1905085978;Taip;5;0;0;5
10159;Skroblinukas;GENIUKŲ;1557733803;Taip;10;1;0;11
10160;Skroblinukas;GENIUKŲ;9433465007;Taip;9;0;0;9
10161;Skroblinukas;GENIUKŲ;9777300890;Taip;17;0;0;17
10162;Skroblinukas;GENIUKŲ;1696303051;Taip;5;1;0;6
10163;Skroblinukas;GENIUKŲ;9846569195;Taip;11;0;2;13
10164;Skroblinukas;GENIUKŲ;3746278003;Taip;21;0;0;21
10165;Skroblinukas;GENIUKŲ;4773576465;Taip;0;0;2;2
10166;Skroblinukas;GENIUKŲ;2704157855;Taip;6;0;0;6
10167;Skroblinukas;GENIUKŲ;6129591146;Taip;0;4;0;4
10168;Skroblinukas;GENIUKŲ;3128337104;Taip;0;0;2;2
10169;Skroblinukas;BITUČIŲ;1255323441;Taip;3;0;3;6
10170;Skroblinukas;BITUČIŲ;1934804499;Taip;9;0;0;9
10171;Skroblinukas;BITUČIŲ;2134821488;Taip;10;0;0;10
10172;Skroblinukas;BITUČIŲ;2071447940;Taip;5;0;0;5
10173;Skroblinukas;BITUČIŲ;1659335142;Taip;0;8;0;8
10174;Skroblinukas;BITUČIŲ;6604496585;Taip;6;4;0;10
10175;Skroblinukas;BITUČIŲ;3736883850;Taip;10;0;1;11
10176;Skroblinukas;BITUČIŲ;7191689856;Taip;0;9;0;9
10177;Skroblinukas;BITUČIŲ;2032621707;Taip;4;0;2;6
10178;Skroblinukas;BITUČIŲ;8277152812;Taip;0;2;0;2
10179;Skroblinukas;BITUČIŲ;8618587013;Taip;2;0;4;6
10180;Skroblinukas;BITUČIŲ;4945107862;Ne;0;0;6;6
10181;Skroblinukas;BITUČIŲ;9594078223;Taip;5;2;0;7
10182;Skroblinukas;BITUČIŲ;1432694920;Taip;15;1;0;16
10183;Skroblinukas;BITUČIŲ;1967305501;Taip;10;0;3;13
10184;Skroblinukas;BITUČIŲ;1688990637;Taip;21;0;0;21
10185;Skroblinukas;BITUČIŲ;1957488412;Taip;0;3;0;3
10186;Skroblinukas;BITUČIŲ;1544346282;Taip;6;5;0;11
10187;Skroblinukas;BITUČIŲ;1711568129;Taip;6;0;2;8
10188;Skroblinukas;BORUŽĖLIŲ;2706526326;Taip;4;0;2;6
10189;Skroblinukas;BORUŽĖLIŲ;6293879765;Taip;8;0;0;8
10190;Skroblinukas;BORUŽĖLIŲ;9888115079;Taip;14;3;0;17
10191;Skroblinukas;BORUŽĖLIŲ;8576448571;Taip;21;0;0;21
10192;Skroblinukas;BORUŽĖLIŲ;8946940285;Taip;0;2;0;2
10193;Skroblinukas;BORUŽĖLIŲ;3290115134;Taip;9;1;0;10
10194;Skroblinukas;BORUŽĖLIŲ;9813249677;Taip;1;0;0;1
10195;Skroblinukas;BORUŽĖLIŲ;3461165182;Taip;0;0;4;4
10196;Skroblinukas;BORUŽĖLIŲ;2101748012;Taip;7;0;0;7
10197;Skroblinukas;BORUŽĖLIŲ;5915278745;Taip;5;2;0;7
10198;Skroblinukas;BORUŽĖLIŲ;6433636135;Taip;0;2;0;2
10199;Skroblinukas;BORUŽĖLIŲ;9475514959;Ne;3;2;0;5
10200;Skroblinukas;SKRUZDĖLIUKŲ;1446835893;Taip;0;16;2;18
10201;Skroblinukas;SKRUZDĖLIUKŲ;2116630768;Taip;0;1;8;9
10202;Skroblinukas;SKRUZDĖLIUKŲ;1710559060;Taip;8;0;0;8
10203;Skroblinukas;SKRUZDĖLIUKŲ;1175660577;Taip;18;1;0;19
10204;Skroblinukas;SKRUZDĖLIUKŲ;21862553841;Taip;15;0;0;15
10205;Skroblinukas;SKRUZDĖLIUKŲ;1611685585;Taip;10;2;0;12
10206;Skroblinukas;SKRUZDĖLIUKŲ;1631945330;Taip;0;0;1;1
10207;Skroblinukas;SKRUZDĖLIUKŲ;58000101216;Taip;0;0;5;5
10208;Skroblinukas;SKRUZDĖLIUKŲ;85704624097;Taip;6;0;2;8
10209;Skroblinukas;SKRUZDĖLIUKŲ;72528180087;Taip;0;1;0;1
10210;Skroblinukas;SKRUZDĖLIUKŲ;91409992058;Taip;0;0;1;1
10211;Skroblinukas;SKRUZDĖLIUKŲ;50466456602;Taip;1;0;0;1
10212;Skroblinukas;SKRUZDĖLIUKŲ;40602768192;Taip;8;4;0;12
10213;Skroblinukas;SKRUZDĖLIUKŲ;3226377926;Taip;0;0;3;3
10214;Skroblinukas;SKRUZDĖLIUKŲ;42252673755;Taip;6;1;0;7
10215;Skroblinukas;SKRUZDĖLIUKŲ;7896922448;Taip;0;2;0;2
10216;Skroblinukas;SKRUZDĖLIUKŲ;2035304515;Taip;5;6;0;11
10217;Skroblinukas;SKRUZDĖLIUKŲ;1388763405;Taip;20;0;1;21
10218;Skroblinukas;SKRUZDĖLIUKŲ;60597534140;Taip;0;0;1;1
10219;Skroblinukas;SKRUZDĖLIUKŲ;7416993749;Taip;0;2;1;3
10220;Skroblinukas;ŽVIRBLIUKŲ;9045708140;Taip;4;3;0;7
10221;Skroblinukas;ŽVIRBLIUKŲ;2197158518;Taip;0;0;4;4
10222;Skroblinukas;ŽVIRBLIUKŲ;6266609965;Taip;0;7;0;7
10223;Skroblinukas;ŽVIRBLIUKŲ;5646847921;Taip;0;1;2;3
10224;Skroblinukas;ŽVIRBLIUKŲ;6640062847;Taip;20;0;0;20
10225;Skroblinukas;ŽVIRBLIUKŲ;4560580022;Taip;2;0;0;2
10226;Skroblinukas;ŽVIRBLIUKŲ;7921251819;Taip;6;3;0;9
10227;Skroblinukas;ŽVIRBLIUKŲ;5546256869;Taip;0;0;2;2
10228;Skroblinukas;ŽVIRBLIUKŲ;9572912046;Taip;0;13;0;13
10229;Skroblinukas;ŽVIRBLIUKŲ;2097758483;Taip;8;4;0;12
10230;Skroblinukas;ŽVIRBLIUKŲ;2406619611;Taip;0;0;1;1
10231;Skroblinukas;ŽVIRBLIUKŲ;9377215921;Taip;18;0;0;18
10232;Skroblinukas;ŽIOGELIŲ;5157913924;Taip;1;3;2;6
10233;Skroblinukas;ŽIOGELIŲ;9368764758;Taip;15;0;0;15
10234;Skroblinukas;ŽIOGELIŲ;3006521657;Taip;0;3;0;3
10235;Skroblinukas;ŽIOGELIŲ;3771045336;Taip;0;3;0;3
10236;Skroblinukas;ŽIOGELIŲ;6890306112;Taip;7;5;0;12
10237;Skroblinukas;ŽIOGELIŲ;9958188318;Taip;0;1;14;15
10238;Skroblinukas;ŽIOGELIŲ;9634311146;Taip;8;0;0;8
10239;Skroblinukas;ŽIOGELIŲ;5688453546;Taip;0;7;3;10
10240;Skroblinukas;ŽIOGELIŲ;6445065388;Taip;7;9;0;16
10241;Skroblinukas;ŽIOGELIŲ;4424763028;Taip;4;8;0;12
10242;Skroblinukas;ŽIOGELIŲ;9353353289;Taip;15;3;0;18
10243;Skroblinukas;ŽIOGELIŲ;2883593274;Taip;7;0;0;7
10244;Skroblinukas;ŽIOGELIŲ;7493915017;Taip;0;2;1;3
10245;Skroblinukas;ŽIOGELIŲ;1970738675;Taip;0;0;21;21
10246;Skroblinukas;STRAZDELIŲ;1054097622;Taip;5;1;0;6
10247;Skroblinukas;STRAZDELIŲ;5433647187;Taip;17;0;0;17
10248;Skroblinukas;STRAZDELIŲ;9915130747;Taip;10;2;0;12
10249;Skroblinukas;STRAZDELIŲ;1159546580;Taip;6;0;3;9
10250;Skroblinukas;STRAZDELIŲ;2310750833;Taip;1;2;2;5
10251;Skroblinukas;STRAZDELIŲ;2184711783;Taip;0;0;7;7
10252;Skroblinukas;STRAZDELIŲ;8875703109;Taip;10;2;0;12
10253;Skroblinukas;STRAZDELIŲ;3010510262;Taip;9;0;0;9
10254;Skroblinukas;STRAZDELIŲ;6489976163;Taip;7;0;4;11
10255;Skroblinukas;STRAZDELIŲ;1669610397;Taip;6;0;0;6
10256;Skroblinukas;STRAZDELIŲ;9541682085;Taip;15;0;0;15
10257;Skroblinukas;STRAZDELIŲ;5566457656;Ne;16;0;0;16
10258;Skroblinukas;STRAZDELIŲ;4571530482;Taip;0;5;7;12
10259;Skroblinukas;DRUGELIŲ;1792672886;Taip;0;0;7;7
10260;Skroblinukas;DRUGELIŲ;1964529755;Taip;0;12;0;12
10261;Skroblinukas;DRUGELIŲ;86231564690;Taip;0;0;2;2
10262;Skroblinukas;DRUGELIŲ;23687553212;Taip;13;3;0;16
10263;Skroblinukas;DRUGELIŲ;4532268875;Taip;0;0;5;5
10264;Skroblinukas;DRUGELIŲ;86542450905;Taip;21;0;0;21
10265;Skroblinukas;DRUGELIŲ;2019575002;Taip;8;0;0;8
10266;Skroblinukas;DRUGELIŲ;3636028890;Taip;8;0;4;12
10267;Skroblinukas;DRUGELIŲ;2079452635;Taip;0;6;0;6
10268;Skroblinukas;DRUGELIŲ;1510927547;Taip;0;6;0;6
10269;Skroblinukas;DRUGELIŲ;2325940694;Taip;0;14;3;17
10270;Skroblinukas;DRUGELIŲ;15977832913;Taip;1;0;4;5
10271;Skroblinukas;DRUGELIŲ;5068339590;Taip;7;0;0;7
10272;Skroblinukas;DRUGELIŲ;3580045988;Taip;1;6;0;7
10273;Skroblinukas;DRUGELIŲ;1005726705;Taip;14;0;2;16
10274;Skroblinukas;DRUGELIŲ;1791669956;Taip;0;2;4;6
10275;Skroblinukas;DRUGELIŲ;7184817010;Taip;10;0;2;12
10276;Skroblinukas;DRUGELIŲ;1109895463;Ne;0;3;0;3
10277;Skroblinukas;DRUGELIŲ;4272941994;Taip;0;0;4;4
10278;Skroblinukas;PELĖDŽIUKŲ;5975039463;Taip;11;0;0;11
10279;Skroblinukas;PELĖDŽIUKŲ;63514584063;Taip;0;15;0;15
10280;Skroblinukas;PELĖDŽIUKŲ;1000422430;Taip;0;9;0;9
10281;Skroblinukas;PELĖDŽIUKŲ;1556675902;Taip;15;1;0;16
10282;Skroblinukas;PELĖDŽIUKŲ;7666122737;Taip;6;0;0;6
10283;Skroblinukas;PELĖDŽIUKŲ;1759830058;Taip;0;2;0;2
10284;Skroblinukas;PELĖDŽIUKŲ;1382981497;Taip;3;3;0;6
10285;Skroblinukas;PELĖDŽIUKŲ;29908502973;Taip;0;1;0;1
10286;Skroblinukas;PELĖDŽIUKŲ;1220311458;Taip;0;3;0;3
10287;Skroblinukas;PELĖDŽIUKŲ;1599112927;Taip;11;1;0;12
10288;Skroblinukas;PELĖDŽIUKŲ;95946607624;Taip;12;1;0;13
10289;Skroblinukas;PELĖDŽIUKŲ;8150037173;Taip;0;1;0;1
10290;Skroblinukas;PELĖDŽIUKŲ;1898486832;Taip;6;0;0;6
10291;Skroblinukas;PELĖDŽIUKŲ;76523308405;Taip;10;7;0;17
10292;Skroblinukas;PELĖDŽIUKŲ;39209870512;Taip;0;0;4;4
10293;Skroblinukas;PELĖDŽIUKŲ;4914479407;Taip;2;0;1;3
10294;Skroblinukas;PELĖDŽIUKŲ;1847074960;Taip;8;0;1;9
10295;Smalsučiai;Žibuoklės;46376560575;Taip;2;6;0;8
10296;Smalsučiai;Žibuoklės;68726523946;Taip;0;4;0;4
10297;Smalsučiai;Žibuoklės;50803234873;Taip;2;1;0;3
10298;Smalsučiai;Žibuoklės;1760728524;Taip;0;9;0;9
10299;Smalsučiai;Žibuoklės;85358131888;Taip;0;0;2;2
10300;Smalsučiai;Žibuoklės;82746324948;Ne;0;2;0;2
10301;Smalsučiai;Žibuoklės;51889095612;Taip;1;0;2;3
10302;Smalsučiai;Žibuoklės;4258713607;Taip;7;13;0;20
10303;Smalsučiai;Žibuoklės;68097436766;Taip;0;2;0;2
10304;Smalsučiai;Žibuoklės;85352082436;Taip;0;5;0;5
10305;Smalsučiai;Žibuoklės;1023262986;Taip;0;5;1;6
10306;Smalsučiai;Žibuoklės;83033796468;Taip;11;1;0;12
10307;Smalsučiai;Žibuoklės;62767756842;Taip;0;5;3;8
10308;Smalsučiai;Žibuoklės;2099765750;Taip;10;6;0;16
10309;Smalsučiai;Žibuoklės;9512217842;Taip;0;2;0;2
10310;Smalsučiai;Žibuoklės;56779125767;Taip;0;1;0;1
10311;Smalsučiai;Žibuoklės;97809921080;Taip;0;2;0;2
10312;Smalsučiai;Aitvarų;53737587501;Taip;0;7;0;7
10313;Smalsučiai;Aitvarų;67243805772;Taip;2;1;0;3
10314;Smalsučiai;Aitvarų;26007606072;Taip;0;6;0;6
10315;Smalsučiai;Aitvarų;37375504483;Taip;0;1;0;1
10316;Smalsučiai;Aitvarų;55212746834;Taip;0;1;0;1
10317;Smalsučiai;Aitvarų;97665693700;Taip;0;8;0;8
10318;Smalsučiai;Aitvarų;70181610962;Ne;0;2;0;2
10319;Smalsučiai;Aitvarų;48426272721;Taip;0;0;5;5
10320;Smalsučiai;Aitvarų;12446167265;Taip;0;3;0;3
10321;Smalsučiai;Aitvarų;76405732236;Taip;0;2;2;4
10322;Smalsučiai;Aitvarų;68897306811;Taip;8;5;0;13
10323;Smalsučiai;Aitvarų;45731306499;Taip;0;1;3;4
10324;Smalsučiai;Aitvarų;1417945043;Taip;0;12;0;12
10325;Smalsučiai;Aitvarų;95501158334;Taip;0;3;0;3
10326;Smalsučiai;Aitvarų;31748074403;Taip;0;2;0;2
10327;Smalsučiai;Aitvarų;1673246147;Taip;0;3;0;3
10328;Smalsučiai;Aitvarų;62387945180;Taip;11;4;0;15
10329;Smalsučiai;Aitvarų;1095159887;Taip;0;2;0;2
10330;Smalsučiai;Aitvarų;1424532027;Taip;0;4;5;9
10331;Smalsučiai;Aitvarų;1567576834;Taip;11;0;0;11
10332;Smalsučiai;Aitvarų;1965194010;Taip;0;1;2;3
10333;Smalsučiai;Sraigiukų;4004275398;Taip;0;0;2;2
10334;Smalsučiai;Sraigiukų;18980466605;Taip;0;1;0;1
10335;Smalsučiai;Sraigiukų;2036701320;Taip;0;1;7;8
10336;Smalsučiai;Sraigiukų;1597721199;Taip;5;1;6;12
10337;Smalsučiai;Sraigiukų;87920436781;Taip;1;0;0;1
10338;Smalsučiai;Sraigiukų;36701180571;Taip;0;1;3;4
10339;Smalsučiai;Sraigiukų;1968415573;Taip;5;2;0;7
10340;Smalsučiai;Sraigiukų;8572292571;Taip;0;0;1;1
10341;Smalsučiai;Sraigiukų;92460059853;Taip;2;0;8;10
10342;Smalsučiai;Sraigiukų;8604112256;Taip;11;0;1;12
10343;Smalsučiai;Sraigiukų;68583864690;Taip;13;0;0;13
10344;Smalsučiai;Sraigiukų;1830368274;Taip;0;0;9;9
10345;Smalsučiai;Sraigiukų;92129554371;Taip;0;3;0;3
10346;Smalsučiai;Sraigiukų;4655599359;Taip;4;0;0;4
10347;Smalsučiai;Sraigiukų;28055409190;Taip;3;3;0;6
10348;Smalsučiai;Sraigiukų;2112871055;Taip;0;1;0;1
10349;Smalsučiai;Sraigiukų;1453463899;Taip;0;0;10;10
10350;Smalsučiai;Sraigiukų;7037820869;Taip;7;0;1;8
10351;Smalsučiai;Sraigiukų;7450298541;Taip;0;0;1;1
10352;Smalsučiai;Sraigiukų;3792738445;Taip;21;0;0;21
10353;Smalsučiai;Saulučių;513516143;Taip;0;1;1;2
10354;Smalsučiai;Saulučių;32382108578;Taip;0;0;3;3
10355;Smalsučiai;Saulučių;25838645404;Taip;0;0;1;1
10356;Smalsučiai;Saulučių;54610929862;Taip;0;1;1;2
10357;Smalsučiai;Saulučių;96461087926;Taip;0;1;0;1
10358;Smalsučiai;Saulučių;98196404299;Taip;12;0;0;12
10359;Smalsučiai;Saulučių;66154228179;Taip;0;0;2;2
10360;Smalsučiai;Saulučių;59594678142;Taip;0;1;0;1
10361;Smalsučiai;Saulučių;94734585174;Taip;0;4;6;10
10362;Smalsučiai;Saulučių;73783991852;Taip;0;0;1;1
10363;Smalsučiai;Saulučių;47452987441;Taip;0;0;2;2
10364;Smalsučiai;Saulučių;81834985961;Taip;0;1;9;10
10365;Smalsučiai;Saulučių;57622458673;Taip;0;1;4;5
10366;Smalsučiai;Saulučių;73899364649;Taip;0;1;14;15
10367;Smalsučiai;Saulučių;1575017231;Taip;6;0;0;6
10368;Smalsučiai;Saulučių;6857124432;Taip;5;0;1;6
10369;Smalsučiai;Saulučių;1653798728;Taip;0;4;0;4
10370;Smalsučiai;Viščiukų;2802867649;Taip;0;1;0;1
10371;Smalsučiai;Viščiukų;30592434971;Taip;3;1;0;4
10372;Smalsučiai;Viščiukų;18717627431;Taip;0;6;0;6
10373;Smalsučiai;Viščiukų;26787916874;Taip;1;1;0;2
10374;Smalsučiai;Viščiukų;63575906792;Taip;0;6;0;6
10375;Smalsučiai;Viščiukų;27727844778;Taip;0;2;0;2
10376;Smalsučiai;Viščiukų;1514166474;Taip;0;3;0;3
10377;Smalsučiai;Viščiukų;37702522563;Taip;0;1;0;1
10378;Smalsučiai;Viščiukų;96002139110;Taip;0;4;0;4
10379;Smalsučiai;Viščiukų;1893910089;Taip;9;0;0;9
10380;Smalsučiai;Viščiukų;1786097164;Ne;0;1;0;1
10381;Smalsučiai;Viščiukų;92961881271;Taip;0;1;0;1
10382;Smalsučiai;Viščiukų;66603023493;Taip;14;0;0;14
10383;Smalsučiai;Viščiukų;6264082741;Taip;12;2;0;14
10384;Smalsučiai;Viščiukų;30464130912;Taip;9;0;0;9
10385;Smalsučiai;Boružėlių;1703679877;Taip;1;0;0;1
10386;Smalsučiai;Boružėlių;2022025913;Taip;2;0;0;2
10387;Smalsučiai;Boružėlių;1473016908;Taip;4;0;0;4
10388;Smalsučiai;Boružėlių;6610166355;Taip;1;10;0;11
10389;Smalsučiai;Boružėlių;7226242747;Taip;10;0;0;10
10390;Smalsučiai;Boružėlių;6085020049;Taip;12;1;0;13
10391;Smalsučiai;Boružėlių;8340768848;Taip;6;0;0;6
10392;Smalsučiai;Boružėlių;6578328053;Taip;6;0;3;9
10393;Smalsučiai;Boružėlių;69450514879;Taip;17;0;0;17
10394;Smalsučiai;Boružėlių;4740303929;Taip;6;0;0;6
10395;Smalsučiai;Boružėlių;4046718551;Taip;15;0;0;15
10396;Smalsučiai;Boružėlių;7364431725;Taip;12;0;0;12
10397;Smalsučiai;Boružėlių;2694575252;Taip;0;0;1;1
10398;Smalsučiai;Boružėlių;2671403814;Taip;1;0;0;1
10399;Smalsučiai;Boružėlių;3063127699;Taip;6;0;0;6
10400;Smalsučiai;Boružėlių;2737886714;Taip;0;11;0;11
10401;Smalsučiai;Boružėlių;4858914868;Taip;14;0;1;15
10402;Smalsučiai;Zuikių;1154978396;Taip;2;1;4;7
10403;Smalsučiai;Zuikių;4930548597;Taip;5;2;0;7
10404;Smalsučiai;Zuikių;37584386087;Taip;0;8;0;8
10405;Smalsučiai;Zuikių;1384803468;Taip;13;1;0;14
10406;Smalsučiai;Zuikių;44282636010;Taip;0;1;0;1
10407;Smalsučiai;Zuikių;64619831879;Taip;5;3;0;8
10408;Smalsučiai;Zuikių;55334476483;Taip;0;1;0;1
10409;Smalsučiai;Zuikių;13761441573;Taip;0;1;1;2
10410;Smalsučiai;Zuikių;1445104610;Taip;0;2;0;2
10411;Smalsučiai;Zuikių;38212233932;Taip;0;2;0;2
10412;Smalsučiai;Zuikių;62371825718;Taip;2;0;0;2
10413;Smalsučiai;Zuikių;69940677093;Taip;8;5;0;13
10414;Smalsučiai;Zuikių;6208392231;Ne;0;1;0;1
10415;Smalsučiai;Zuikių;85617121883;Taip;0;2;0;2
10416;Smalsučiai;Zuikių;32121383319;Taip;6;1;0;7
10417;Smalsučiai;Nykštukų;2327930850;Taip;0;12;0;12
10418;Smalsučiai;Nykštukų;3787937467;Taip;0;13;0;13
10419;Smalsučiai;Nykštukų;9155011285;Taip;0;1;0;1
10420;Smalsučiai;Nykštukų;9582225178;Taip;1;0;0;1
10421;Smalsučiai;Nykštukų;4566816316;Taip;0;2;0;2
10422;Smalsučiai;Nykštukų;1471941426;Taip;0;1;0;1
10423;Smalsučiai;Nykštukų;1458544456;Taip;0;5;0;5
10424;Smalsučiai;Nykštukų;4364810458;Taip;0;1;0;1
10425;Smalsučiai;Nykštukų;6469604093;Taip;10;0;0;10
10426;Smalsučiai;Nykštukų;6358800570;Taip;0;1;0;1
10427;Smalsučiai;Nykštukų;5184903287;Taip;0;2;0;2
10428;Smalsučiai;Nykštukų;7933302912;Taip;0;4;0;4
10429;Smalsučiai;Nykštukų;3757955200;Taip;15;6;0;21
10430;Smalsučiai;Nykštukų;5406430393;Taip;8;4;0;12
10431;Smalsučiai;Nykštukų;9241738140;Taip;11;3;0;14
10432;Smalsučiai;Katinėlių;8259056296;Taip;11;0;0;11
10433;Smalsučiai;Katinėlių;9864518144;Taip;0;4;0;4
10434;Smalsučiai;Katinėlių;2958335372;Taip;8;2;0;10
10435;Smalsučiai;Katinėlių;7137550663;Taip;6;0;0;6
10436;Smalsučiai;Katinėlių;6090391818;Taip;9;0;4;13
10437;Smalsučiai;Katinėlių;6577214344;Taip;4;0;0;4
10438;Smalsučiai;Katinėlių;8977651419;Taip;10;1;2;13
10439;Smalsučiai;Katinėlių;6406285034;Taip;5;0;0;5
10440;Smalsučiai;Katinėlių;6006832443;Taip;16;0;0;16
10441;Smalsučiai;Katinėlių;7726086066;Taip;0;1;3;4
10442;Smalsučiai;Katinėlių;8128348060;Taip;13;0;4;17
10443;Smalsučiai;Katinėlių;9637877396;Taip;15;0;0;15
10444;Smalsučiai;PELĖDŽIUKAI;8794407618;Taip;0;5;0;5
10445;Smalsučiai;PELĖDŽIUKAI;1374075909;Taip;0;3;0;3
10446;Smalsučiai;PELĖDŽIUKAI;3543889830;Taip;7;3;0;10
10447;Smalsučiai;PELĖDŽIUKAI;67362576311;Taip;0;3;0;3
10448;Smalsučiai;PELĖDŽIUKAI;43758366827;Taip;0;2;1;3
10449;Smalsučiai;PELĖDŽIUKAI;30890983859;Taip;5;2;0;7
10450;Smalsučiai;PELĖDŽIUKAI;81140813811;Taip;6;1;0;7
10451;Smalsučiai;PELĖDŽIUKAI;3103358607;Taip;11;1;0;12
10452;Smalsučiai;PELĖDŽIUKAI;66765363937;Taip;0;6;0;6
10453;Smalsučiai;PELĖDŽIUKAI;22888541896;Taip;0;1;2;3
10454;Smalsučiai;PELĖDŽIUKAI;69010502468;Taip;0;3;0;3
10455;Smalsučiai;PELĖDŽIUKAI;50426509300;Taip;0;2;0;2
10456;Smalsučiai;PELĖDŽIUKAI;49495262113;Taip;0;1;0;1
10457;Smalsučiai;PELĖDŽIUKAI;98465335011;Taip;3;3;0;6
10458;Smalsučiai;Pingvinukai;99467576480;Taip;1;0;0;1
10459;Smalsučiai;Pingvinukai;5441966713;Taip;0;1;0;1
10460;Smalsučiai;Pingvinukai;8306946163;Taip;0;6;0;6
10461;Smalsučiai;Pingvinukai;1997966082;Taip;9;5;0;14
10462;Smalsučiai;Pingvinukai;4795138729;Taip;11;5;0;16
10463;Smalsučiai;Pingvinukai;2638709634;Taip;6;1;0;7
10464;Smalsučiai;Pingvinukai;6469044880;Taip;0;3;0;3
10465;Smalsučiai;Pingvinukai;1775539505;Taip;5;4;0;9
10466;Smalsučiai;Pingvinukai;2059832436;Taip;0;4;2;6
10467;Smalsučiai;Pingvinukai;8810690546;Taip;10;6;0;16
10468;Smalsučiai;Pingvinukai;4585930202;Taip;2;0;0;2
10469;Smalsučiai;Pingvinukai;9632022271;Taip;1;0;0;1
10470;Smalsučiai;Pingvinukai;2136420967;Taip;1;0;0;1
10471;Smalsučiai;Pingvinukai;1372591510;Taip;1;10;0;11
10472;Smalsučiai;Pingvinukai;8193410963;Taip;8;0;0;8
10473;Smalsučiai;Pingvinukai;3644256220;Taip;0;0;3;3
10474;Smalsučiai;Pingvinukai;6536165801;Taip;1;0;0;1
10475;Smalsučiai;Pingvinukai;4909226602;Taip;7;0;6;13
10476;Smalsučiai;Pingvinukai;2365835087;Taip;10;0;0;10
10477;Smalsučiai;Pingvinukai;5761169841;Taip;8;0;0;8
10478;Smalsučiai;Voverikų;2618753095;Taip;5;0;1;6
10479;Smalsučiai;Voverikų;7713078413;Taip;0;1;0;1
10480;Smalsučiai;Voverikų;3607226859;Taip;0;8;0;8
10481;Smalsučiai;Voverikų;22791221635;Taip;0;1;0;1
10482;Smalsučiai;Voverikų;7794541741;Taip;5;0;0;5
10483;Smalsučiai;Voverikų;1467603676;Taip;0;3;0;3
10484;Smalsučiai;Voverikų;1982046497;Taip;1;1;0;2
10485;Smalsučiai;Voverikų;1181574676;Taip;3;1;0;4
10486;Smalsučiai;Voverikų;1599488035;Taip;0;7;0;7
10487;Smalsučiai;Voverikų;6207026048;Taip;0;1;0;1
10488;Smalsučiai;Voverikų;19592364606;Taip;0;1;0;1
10489;Smalsučiai;Voverikų;1668692281;Taip;0;5;0;5
10490;Smalsučiai;Voverikų;5730866119;Taip;0;0;2;2
10491;Smalsučiai;Voverikų;1824321380;Taip;0;1;0;1
10492;Smalsučiai;Voverikų;5611487967;Taip;14;0;0;14
10493;Smalsučiai;Voverikų;8520753848;Taip;0;2;0;2
10494;Spindulėlis;SAULUTĖS;6435045068;Taip;0;0;1;1
10495;Spindulėlis;SAULUTĖS;1514479696;Taip;12;0;4;16
10496;Spindulėlis;SAULUTĖS;27408123487;Taip;6;15;0;21
10497;Spindulėlis;SAULUTĖS;4194714698;Taip;0;0;1;1
10498;Spindulėlis;SAULUTĖS;9977569249;Taip;14;0;0;14
10499;Spindulėlis;SAULUTĖS;1180176295;Taip;1;1;1;3
10500;Spindulėlis;SAULUTĖS;1730248631;Taip;1;0;0;1
10501;Spindulėlis;SAULUTĖS;21152690883;Taip;4;1;1;6
10502;Spindulėlis;SAULUTĖS;1391226466;Taip;0;6;2;8
10503;Spindulėlis;SAULUTĖS;1694423628;Taip;9;11;0;20
10504;Spindulėlis;SAULUTĖS;1679106754;Taip;0;6;0;6
10505;Spindulėlis;SAULUTĖS;72997461686;Taip;1;0;0;1
10506;Spindulėlis;SAULUTĖS;4353031174;Taip;5;0;0;5
10507;Spindulėlis;SAULUTĖS;1424288192;Taip;0;0;5;5
10508;Spindulėlis;SAULUTĖS;1346035733;Taip;5;7;0;12
10509;Spindulėlis;SAULUTĖS;9903990297;Taip;1;0;0;1
10510;Spindulėlis;SAULUTĖS;92417802345;Taip;0;3;1;4
10511;Spindulėlis;DRUGELIAI;30036722764;Ne;0;0;8;8
10512;Spindulėlis;DRUGELIAI;19541905006;Taip;0;5;0;5
10513;Spindulėlis;DRUGELIAI;27928352319;Taip;0;11;0;11
10514;Spindulėlis;DRUGELIAI;64339072411;Taip;0;5;0;5
10515;Spindulėlis;DRUGELIAI;1528496272;Taip;6;0;0;6
10516;Spindulėlis;DRUGELIAI;503164673;Taip;0;1;2;3
10517;Spindulėlis;DRUGELIAI;1763306358;Taip;0;15;0;15
10518;Spindulėlis;DRUGELIAI;1939526832;Taip;0;0;7;7
10519;Spindulėlis;DRUGELIAI;2988630379;Taip;0;1;0;1
10520;Spindulėlis;DRUGELIAI;55250330957;Taip;6;0;0;6
10521;Spindulėlis;DRUGELIAI;2137229669;Taip;0;6;0;6
10522;Spindulėlis;DRUGELIAI;60956380679;Taip;7;0;0;7
10523;Spindulėlis;DRUGELIAI;29747353664;Taip;0;0;7;7
10524;Spindulėlis;DRUGELIAI;97661389553;Taip;0;13;0;13
10525;Spindulėlis;DRUGELIAI;2131409282;Taip;0;0;1;1
10526;Spindulėlis;DRUGELIAI;9348576749;Taip;14;1;0;15
10527;Spindulėlis;DRUGELIAI;63344816879;Taip;21;0;0;21
10528;Spindulėlis;DRUGELIAI;18443825776;Taip;0;0;1;1
10529;Spindulėlis;DRUGELIAI;9145337789;Taip;0;0;1;1
10530;Spindulėlis;DRUGELIAI;96365393879;Taip;0;8;0;8
10531;Spindulėlis;DRUGELIAI;7757264510;Taip;0;0;2;2
10532;Spindulėlis;DRUGELIAI;5050019035;Taip;1;0;2;3
10533;Spindulėlis;BITUTĖS;9729955786;Taip;1;0;2;3
10534;Spindulėlis;BITUTĖS;74912418250;Taip;13;0;0;13
10535;Spindulėlis;BITUTĖS;19056425785;Taip;10;1;0;11
10536;Spindulėlis;BITUTĖS;17990017515;Taip;10;1;0;11
10537;Spindulėlis;BITUTĖS;83727622058;Taip;2;1;0;3
10538;Spindulėlis;BITUTĖS;34303994728;Taip;4;0;0;4
10539;Spindulėlis;BITUTĖS;4798024997;Taip;0;4;0;4
10540;Spindulėlis;BITUTĖS;54387249420;Taip;5;0;0;5
10541;Spindulėlis;BITUTĖS;83785970474;Taip;10;0;0;10
10542;Spindulėlis;BITUTĖS;20440477805;Taip;9;0;0;9
10543;Spindulėlis;BITUTĖS;4842304821;Taip;2;6;0;8
10544;Spindulėlis;BITUTĖS;1492573735;Taip;0;1;0;1
10545;Spindulėlis;BITUTĖS;92803008887;Taip;0;2;0;2
10546;Spindulėlis;BITUTĖS;35801673097;Taip;10;4;0;14
10547;Spindulėlis;BITUTĖS;85203448043;Taip;1;0;0;1
10548;Spindulėlis;BITUTĖS;4539792030;Taip;1;0;0;1
10549;Spindulėlis;BITUTĖS;81445263695;Taip;4;0;0;4
10550;Spindulėlis;BITUTĖS;16045001090;Taip;0;6;0;6
10551;Spindulėlis;BITUTĖS;1399847362;Taip;5;0;0;5
10552;Spindulėlis;BITUTĖS;54418444052;Taip;5;3;0;8
10553;Spindulėlis;BITUTĖS;8934483022;Taip;10;0;0;10
10554;Spindulėlis;BITUTĖS;60061983557;Taip;5;0;0;5
10555;Spindulėlis;VARPELIAI;5288557629;Taip;9;0;0;9
10556;Spindulėlis;VARPELIAI;5233044803;Taip;10;2;0;12
10557;Spindulėlis;VARPELIAI;8923393066;Taip;9;0;1;10
10558;Spindulėlis;VARPELIAI;9244494109;Taip;6;0;10;16
10559;Spindulėlis;VARPELIAI;4929866385;Taip;21;0;0;21
10560;Spindulėlis;VARPELIAI;8141324449;Taip;4;0;2;6
10561;Spindulėlis;VARPELIAI;6449284856;Taip;0;0;21;21
10562;Spindulėlis;VARPELIAI;6592057292;Taip;6;0;1;7
10563;Spindulėlis;VARPELIAI;2890377876;Taip;13;0;0;13
10564;Spindulėlis;VARPELIAI;1454039572;Taip;1;0;2;3
10565;Spindulėlis;VARPELIAI;9511051386;Taip;11;0;0;11
10566;Spindulėlis;VARPELIAI;9740815635;Taip;10;0;0;10
10567;Spindulėlis;VARPELIAI;5578151523;Taip;2;0;1;3
10568;Spindulėlis;VARPELIAI;7099787230;Taip;10;0;5;15
10569;Spindulėlis;VARPELIAI;4308169582;Taip;3;0;4;7
10570;Spindulėlis;VARPELIAI;3088386659;Taip;0;0;16;16
10571;Spragtukas;NYKŠTUKAI;1756340613;Taip;6;1;0;7
10572;Spragtukas;NYKŠTUKAI;8226921630;Taip;0;2;0;2
10573;Spragtukas;NYKŠTUKAI;5236797574;Taip;12;0;0;12
10574;Spragtukas;NYKŠTUKAI;9860876807;Taip;0;5;0;5
10575;Spragtukas;NYKŠTUKAI;5633883897;Taip;1;1;0;2
10576;Spragtukas;NYKŠTUKAI;1771141306;Taip;0;9;0;9
10577;Spragtukas;NYKŠTUKAI;1306663967;Taip;1;4;0;5
10578;Spragtukas;NYKŠTUKAI;9965087132;Taip;9;3;0;12
10579;Spragtukas;NYKŠTUKAI;5844437769;Taip;14;0;0;14
10580;Spragtukas;NYKŠTUKAI;2946297529;Taip;5;0;0;5
10581;Spragtukas;NYKŠTUKAI;1570206034;Taip;10;3;0;13
10582;Spragtukas;NYKŠTUKAI;9754594384;Taip;8;1;0;9
10583;Spragtukas;NYKŠTUKAI;5150028968;Taip;0;3;0;3
10584;Spragtukas;NYKŠTUKAI;2909322678;Taip;0;1;0;1
10585;Spragtukas;SAULUTĖ;89749837388;Taip;9;1;0;10
10586;Spragtukas;SAULUTĖ;92289435393;Taip;9;0;1;10
10587;Spragtukas;SAULUTĖ;3392224465;Taip;2;3;0;5
10588;Spragtukas;SAULUTĖ;1174566363;Taip;6;1;0;7
10589;Spragtukas;SAULUTĖ;10998123453;Taip;0;2;0;2
10590;Spragtukas;SAULUTĖ;48934106998;Taip;15;0;0;15
10591;Spragtukas;SAULUTĖ;34989165939;Ne;0;5;0;5
10592;Spragtukas;SAULUTĖ;1527719937;Taip;0;4;0;4
10593;Spragtukas;SAULUTĖ;59444737813;Taip;0;2;7;9
10594;Spragtukas;SAULUTĖ;1889153590;Taip;4;0;1;5
10595;Spragtukas;SAULUTĖ;53375921406;Ne;8;0;0;8
10596;Spragtukas;SAULUTĖ;50653432030;Taip;5;3;0;8
10597;Spragtukas;SAULUTĖ;63252513820;Taip;5;0;0;5
10598;Spragtukas;SAULUTĖ;51889437335;Taip;8;4;0;12
10599;Spragtukas;SAULUTĖ;94483480424;Taip;6;1;0;7
10600;Spragtukas;SAULUTĖ;7234682005;Taip;9;3;0;12
10601;Spragtukas;SAULUTĖ;42635888133;Taip;0;1;0;1
10602;Spragtukas;SAULUTĖ;80790750169;Taip;15;1;0;16
10603;Spragtukas;SAULUTĖ;96435499947;Taip;5;0;0;5
10604;Spragtukas;SAULUTĖ;91767288727;Taip;5;5;2;12
10605;Spragtukas;SAULUTĖ;94418271961;Taip;4;0;0;4
10606;Spragtukas;SAULUTĖ;5377198769;Taip;10;1;0;11
10607;Spragtukas;SAULUTĖ;14001343134;Taip;7;2;0;9
10608;Spragtukas;SPINDULĖLIAI;23609194808;Taip;6;0;0;6
10609;Spragtukas;SPINDULĖLIAI;61759595543;Taip;0;3;0;3
10610;Spragtukas;SPINDULĖLIAI;35161123605;Taip;0;0;5;5
10611;Spragtukas;SPINDULĖLIAI;89128154852;Taip;0;3;0;3
10612;Spragtukas;SPINDULĖLIAI;1992644726;Taip;9;1;0;10
10613;Spragtukas;SPINDULĖLIAI;78367721963;Taip;0;1;1;2
10614;Spragtukas;SPINDULĖLIAI;18431696631;Taip;0;7;1;8
10615;Spragtukas;SPINDULĖLIAI;88682218237;Taip;6;4;0;10
10616;Spragtukas;SPINDULĖLIAI;19772337903;Taip;0;2;0;2
10617;Spragtukas;SPINDULĖLIAI;73746856181;Taip;4;4;0;8
10618;Spragtukas;SPINDULĖLIAI;25586950966;Taip;6;3;1;10
10619;Spragtukas;SPINDULĖLIAI;64816442697;Taip;0;0;1;1
10620;Spragtukas;SPINDULĖLIAI;67746615170;Taip;3;2;0;5
10621;Spragtukas;SPINDULĖLIAI;22707134829;Taip;0;14;0;14
10622;Spragtukas;SPINDULĖLIAI;54800087274;Taip;8;0;0;8
10623;Spragtukas;SPINDULĖLIAI;60622170765;Taip;0;6;0;6
10624;Spragtukas;SPINDULĖLIAI;71104002732;Taip;0;8;0;8
10625;Spragtukas;GINTARĖLIAI;96995930924;Taip;16;0;0;16
10626;Spragtukas;GINTARĖLIAI;42746731488;Taip;0;11;0;11
10627;Spragtukas;GINTARĖLIAI;38858500522;Taip;0;1;0;1
10628;Spragtukas;GINTARĖLIAI;1437794402;Taip;10;0;0;10
10629;Spragtukas;GINTARĖLIAI;60731415960;Taip;7;4;0;11
10630;Spragtukas;GINTARĖLIAI;29398129736;Taip;0;1;0;1
10631;Spragtukas;GINTARĖLIAI;37209001618;Taip;4;1;0;5
10632;Spragtukas;GINTARĖLIAI;15208696709;Taip;4;0;0;4
10633;Spragtukas;GINTARĖLIAI;82498261158;Taip;9;0;0;9
10634;Spragtukas;GINTARĖLIAI;32290835176;Taip;0;7;0;7
10635;Spragtukas;GINTARĖLIAI;68059396649;Taip;0;3;0;3
10636;Spragtukas;GINTARĖLIAI;39962240237;Taip;15;1;0;16
10637;Spragtukas;GINTARĖLIAI;40971977434;Taip;0;10;4;14
10638;Spragtukas;GINTARĖLIAI;81928765016;Taip;8;0;0;8
10639;Spragtukas;GINTARĖLIAI;1035579583;Taip;0;1;0;1
10640;Spragtukas;GINTARĖLIAI;8554047390;Taip;0;9;0;9
10641;Spragtukas;GINTARĖLIAI;16927181370;Taip;5;4;0;9
10642;Spragtukas;ČIPOLINO;2371848091;Taip;0;8;0;8
10643;Spragtukas;ČIPOLINO;6582680700;Taip;0;9;0;9
10644;Spragtukas;ČIPOLINO;1599958343;Taip;0;2;0;2
10645;Spragtukas;ČIPOLINO;1547670082;Taip;0;1;0;1
10646;Spragtukas;ČIPOLINO;7504632314;Taip;0;1;0;1
10647;Spragtukas;ČIPOLINO;1597988501;Taip;0;5;0;5
10648;Spragtukas;ČIPOLINO;6526633051;Taip;0;3;0;3
10649;Spragtukas;ČIPOLINO;1058970799;Taip;0;5;0;5
10650;Spragtukas;ČIPOLINO;3045382299;Taip;0;1;0;1
10651;Spragtukas;ČIPOLINO;7640805299;Taip;0;4;0;4
10652;Spragtukas;ČIPOLINO;3566797064;Taip;5;2;0;7
10653;Spragtukas;ČIPOLINO;1827458781;Taip;9;0;0;9
10654;Spragtukas;ČIPOLINO;3798118695;Taip;13;7;0;20
10655;Spragtukas;ČIPOLINO;69114720307;Taip;7;2;0;9
10656;Spragtukas;ČIPOLINO;9789977863;Taip;0;9;0;9
10657;Spragtukas;BORUŽĖLĖS;2063156696;Taip;0;2;0;2
10658;Spragtukas;BORUŽĖLĖS;6729635545;Taip;2;3;0;5
10659;Spragtukas;BORUŽĖLĖS;1615068173;Taip;0;8;0;8
10660;Spragtukas;BORUŽĖLĖS;90741594830;Taip;4;2;0;6
10661;Spragtukas;BORUŽĖLĖS;9962282406;Taip;0;6;0;6
10662;Spragtukas;BORUŽĖLĖS;91568484446;Taip;0;1;0;1
10663;Spragtukas;BORUŽĖLĖS;1701035826;Ne;0;15;0;15
10664;Spragtukas;BORUŽĖLĖS;4513335615;Taip;0;13;0;13
10665;Spragtukas;BORUŽĖLĖS;69086864157;Taip;0;5;0;5
10666;Spragtukas;BORUŽĖLĖS;8415429693;Taip;0;7;0;7
10667;Spragtukas;DRUGELIAI;1190479265;Taip;0;0;1;1
10668;Spragtukas;DRUGELIAI;8673799897;Taip;9;0;0;9
10669;Spragtukas;DRUGELIAI;61714170354;Taip;0;6;0;6
10670;Spragtukas;DRUGELIAI;58491995121;Taip;0;0;1;1
10671;Spragtukas;DRUGELIAI;1570209659;Taip;8;3;0;11
10672;Spragtukas;DRUGELIAI;58366763944;Taip;0;8;0;8
10673;Spragtukas;DRUGELIAI;1212579682;Taip;0;0;1;1
10674;Spragtukas;DRUGELIAI;44715566085;Taip;6;0;0;6
10675;Spragtukas;DRUGELIAI;1082350468;Taip;0;0;6;6
10676;Spragtukas;DRUGELIAI;1668434690;Taip;5;0;0;5
10677;Spragtukas;DRUGELIAI;2086501624;Taip;0;1;1;2
10678;Spragtukas;DRUGELIAI;1035631190;Taip;0;1;0;1
10679;Spragtukas;DRUGELIAI;1751370218;Taip;8;0;0;8
10680;Spragtukas;DRUGELIAI;5765613911;Taip;0;6;0;6
10681;Spragtukas;DRUGELIAI;3508228828;Taip;0;0;8;8
10682;Spragtukas;DRUGELIAI;1315478099;Taip;6;0;0;6
10683;Spragtukas;DRUGELIAI;1779321635;Taip;0;1;0;1
10684;Spragtukas;DRUGELIAI;4542067558;Taip;0;0;2;2
10685;Spragtukas;DRUGELIAI;1400542296;Taip;0;0;2;2
10686;Spragtukas;DRUGELIAI;1130377645;Taip;0;1;0;1
10687;Spragtukas;DRUGELIAI;8516003036;Taip;0;10;0;10
10688;Spragtukas;DRUGELIAI;3181801668;Taip;5;0;1;6
10689;Spragtukas;GAIDELIAI;7569802487;Taip;4;0;0;4
10690;Spragtukas;GAIDELIAI;1305123801;Taip;0;6;0;6
10691;Spragtukas;GAIDELIAI;79237309377;Taip;6;5;0;11
10692;Spragtukas;GAIDELIAI;54099559107;Taip;16;0;1;17
10693;Spragtukas;GAIDELIAI;1203266608;Taip;3;0;0;3
10694;Spragtukas;GAIDELIAI;11849369985;Taip;2;0;1;3
10695;Spragtukas;GAIDELIAI;2042294168;Taip;5;0;1;6
10696;Spragtukas;GAIDELIAI;1030566027;Taip;6;4;0;10
10697;Spragtukas;GAIDELIAI;78296815539;Taip;0;0;2;2
10698;Spragtukas;GAIDELIAI;8150653485;Taip;5;6;0;11
10699;Spragtukas;GAIDELIAI;1247838976;Taip;17;1;0;18
10700;Spragtukas;GAIDELIAI;2061441977;Taip;11;0;0;11
10701;Spragtukas;GAIDELIAI;2848207417;Taip;15;0;0;15
10702;Spragtukas;GAIDELIAI;1210698072;Taip;8;0;0;8
10703;Spragtukas;GAIDELIAI;1070119148;Taip;6;6;0;12
10704;Spragtukas;GAIDELIAI;9235972927;Taip;12;0;1;13
10705;Spragtukas;ŽUVELĖS;32858776091;Taip;0;1;0;1
10706;Spragtukas;ŽUVELĖS;91794949460;Taip;9;1;0;10
10707;Spragtukas;ŽUVELĖS;2118272247;Taip;5;12;0;17
10708;Spragtukas;ŽUVELĖS;46794033116;Taip;1;1;0;2
10709;Spragtukas;ŽUVELĖS;1418494757;Taip;0;2;1;3
10710;Spragtukas;ŽUVELĖS;60980580078;Taip;1;5;0;6
10711;Spragtukas;ŽUVELĖS;82801263312;Taip;9;0;0;9
10712;Spragtukas;ŽUVELĖS;56384144331;Taip;0;2;1;3
10713;Spragtukas;ŽUVELĖS;2032107153;Taip;0;1;0;1
10714;Spragtukas;ŽUVELĖS;20279570129;Taip;10;2;0;12
10715;Spragtukas;ŽUVELĖS;1731215395;Taip;0;1;0;1
10716;Spragtukas;ŽUVELĖS;1138975383;Taip;0;0;1;1
10717;Spragtukas;ŽUVELĖS;1953368351;Taip;4;2;0;6
10718;Spragtukas;ŽUVELĖS;271958429;Taip;5;0;1;6
10719;Spragtukas;ŽUVELĖS;1030688447;Taip;10;0;0;10
10720;Spragtukas;ŽUVELĖS;1883944064;Taip;0;11;0;11
10721;Spragtukas;ŽUVELĖS;41147623084;Taip;0;1;2;3
10722;Spragtukas;ŽUVELĖS;22025568463;Taip;0;11;0;11
10723;Spragtukas;ŽUVELĖS;38120721944;Taip;0;5;0;5
10724;Spragtukas;RIEŠUTĖLIAI;8444759709;Taip;10;0;0;10
10725;Spragtukas;RIEŠUTĖLIAI;1384812263;Taip;0;1;1;2
10726;Spragtukas;RIEŠUTĖLIAI;8463747761;Taip;1;3;2;6
10727;Spragtukas;RIEŠUTĖLIAI;4131998934;Taip;6;1;0;7
10728;Spragtukas;RIEŠUTĖLIAI;1690400583;Taip;16;1;0;17
10729;Spragtukas;RIEŠUTĖLIAI;6419503965;Taip;0;17;0;17
10730;Spragtukas;RIEŠUTĖLIAI;8246512283;Taip;12;1;0;13
10731;Spragtukas;RIEŠUTĖLIAI;1627243902;Taip;9;0;0;9
10732;Spragtukas;RIEŠUTĖLIAI;1326603216;Taip;12;0;0;12
10733;Spragtukas;RIEŠUTĖLIAI;72636559695;Taip;0;1;0;1
10734;Spragtukas;RIEŠUTĖLIAI;6573750143;Taip;11;6;0;17
10735;Spragtukas;RIEŠUTĖLIAI;5306883933;Taip;6;1;0;7
10736;Spragtukas;RIEŠUTĖLIAI;3654640843;Taip;1;2;0;3
10737;Spragtukas;RIEŠUTĖLIAI;1849644444;Taip;2;0;0;2
10738;Spragtukas;RIEŠUTĖLIAI;9045185920;Taip;11;2;0;13
10739;Spragtukas;RIEŠUTĖLIAI;1800927281;Taip;15;0;0;15
10740;Spragtukas;RIEŠUTĖLIAI;1514277186;Taip;7;2;0;9
10741;Spragtukas;RIEŠUTĖLIAI;4427123314;Taip;0;5;0;5
10742;Spragtukas;RIEŠUTĖLIAI;3504197974;Taip;10;0;0;10
10743;Spragtukas;RIEŠUTĖLIAI;6322121173;Taip;0;5;0;5
10744;Spragtukas;RIEŠUTĖLIAI;3113106252;Taip;7;1;0;8
10745;Spragtukas;RIEŠUTĖLIAI;9314811354;Taip;0;11;0;11
10746;Spragtukas;VIŠČIUKAI;8429135626;Taip;0;21;0;21
10747;Spragtukas;VIŠČIUKAI;2356476212;Taip;7;1;0;8
10748;Spragtukas;VIŠČIUKAI;7070881522;Taip;11;4;0;15
10749;Spragtukas;VIŠČIUKAI;8652973900;Taip;0;7;0;7
10750;Spragtukas;VIŠČIUKAI;8551195766;Taip;3;0;0;3
10751;Spragtukas;VIŠČIUKAI;3261213140;Taip;0;5;0;5
10752;Spragtukas;VIŠČIUKAI;8623311748;Taip;0;0;2;2
10753;Spragtukas;VIŠČIUKAI;8460527225;Taip;3;7;0;10
10754;Spragtukas;VIŠČIUKAI;8297700739;Taip;13;0;1;14
10755;Spragtukas;VIŠČIUKAI;9595221494;Taip;11;3;0;14
10756;Spragtukas;VIŠČIUKAI;6185016824;Taip;7;2;0;9
10757;Spragtukas;VIŠČIUKAI;8715073512;Taip;11;0;0;11
10758;Spragtukas;VIŠČIUKAI;6162830167;Taip;13;4;0;17
10759;Spragtukas;VIŠČIUKAI;5689392663;Taip;16;1;1;18
10760;Spragtukas;VIŠČIUKAI;9805841777;Taip;2;0;1;3
10761;Spragtukas;MEŠKIUKAI;9592271053;Taip;5;0;0;5
10762;Spragtukas;MEŠKIUKAI;3968434618;Taip;0;2;0;2
10763;Spragtukas;MEŠKIUKAI;1150727381;Taip;11;2;0;13
10764;Spragtukas;MEŠKIUKAI;9191831532;Taip;4;0;3;7
10765;Spragtukas;MEŠKIUKAI;1272075883;Taip;0;9;0;9
10766;Spragtukas;MEŠKIUKAI;6465991136;Taip;0;1;0;1
10767;Spragtukas;MEŠKIUKAI;9282940430;Taip;7;1;0;8
10768;Spragtukas;MEŠKIUKAI;6503842956;Taip;10;0;0;10
10769;Spragtukas;MEŠKIUKAI;2578400770;Taip;0;7;0;7
10770;Spragtukas;MEŠKIUKAI;3189741449;Taip;5;1;0;6
10771;Spragtukas;MEŠKIUKAI;4344537391;Taip;16;0;0;16
10772;Spragtukas;MEŠKIUKAI;6757604305;Taip;17;0;0;17
10773;Spragtukas;MEŠKIUKAI;2076126173;Taip;11;5;0;16
10774;Spragtukas;MEŠKIUKAI;7859959104;Taip;10;3;0;13
10775;Spragtukas;MEŠKIUKAI;4548945364;Taip;11;3;0;14
10776;Strazdelis;Žiogelių;59969322783;Taip;0;1;0;1
10777;Strazdelis;Žiogelių;48052363003;Taip;0;3;0;3
10778;Strazdelis;Žiogelių;12739940649;Taip;12;3;0;15
10779;Strazdelis;Žiogelių;79443961061;Taip;0;8;0;8
10780;Strazdelis;Žiogelių;81910819903;Taip;6;0;0;6
10781;Strazdelis;Žiogelių;84548133061;Taip;0;7;0;7
10782;Strazdelis;Žiogelių;4013389618;Ne;6;1;0;7
10783;Strazdelis;Žiogelių;5449465531;Taip;1;2;0;3
10784;Strazdelis;Žiogelių;57514782479;Taip;0;4;0;4
10785;Strazdelis;Žiogelių;50984917126;Taip;10;3;1;14
10786;Strazdelis;Žiogelių;43128715501;Taip;1;2;0;3
10787;Strazdelis;Žiogelių;1058210612;Taip;10;0;0;10
10788;Strazdelis;Žiogelių;85877157333;Taip;8;2;2;12
10789;Strazdelis;Žiogelių;2110092578;Taip;0;10;0;10
10790;Strazdelis;Žiogelių;90936509570;Taip;2;0;0;2
10791;Strazdelis;Žiogelių;64076729200;Taip;9;2;0;11
10792;Strazdelis;Žiogelių;1858519255;Taip;0;11;0;11
10793;Strazdelis;Žiogelių;20845810823;Taip;7;3;0;10
10794;Strazdelis;Žiogelių;98433672584;Taip;10;0;0;10
10795;Strazdelis;Žiogelių;2086723106;Taip;19;0;0;19
10796;Strazdelis;Šeimynėlės;4454199703;Taip;15;0;0;15
10797;Strazdelis;Šeimynėlės;3662217925;Taip;17;0;0;17
10798;Strazdelis;Šeimynėlės;4698566091;Taip;7;2;1;10
10799;Strazdelis;Šeimynėlės;8274897977;Taip;17;0;0;17
10800;Strazdelis;Šeimynėlės;45083023033;Taip;6;1;0;7
10801;Strazdelis;Šeimynėlės;5698472204;Taip;6;8;0;14
10802;Strazdelis;Šeimynėlės;29586826889;Taip;5;2;0;7
10803;Strazdelis;Šeimynėlės;6528024720;Taip;7;2;0;9
10804;Strazdelis;Šeimynėlės;4697537943;Taip;15;0;0;15
10805;Strazdelis;Šeimynėlės;9835716116;Taip;8;1;0;9
10806;Strazdelis;Šeimynėlės;3943578036;Taip;11;0;0;11
10807;Strazdelis;Šeimynėlės;2802486859;Taip;0;6;0;6
10808;Strazdelis;Šeimynėlės;4791752179;Taip;12;0;0;12
10809;Strazdelis;Šeimynėlės;7215063033;Taip;12;1;0;13
10810;Strazdelis;Šeimynėlės;7149827850;Taip;0;11;0;11
10811;Strazdelis;Šeimynėlės;1665134387;Taip;19;1;0;20
10812;Strazdelis;Šeimynėlės;1481671624;Taip;11;0;0;11
10813;Strazdelis;Šeimynėlės;6014213362;Taip;0;6;0;6
10814;Strazdelis;Genelio;8754275576;Taip;7;2;0;9
10815;Strazdelis;Genelio;7216768880;Taip;13;0;0;13
10816;Strazdelis;Genelio;1540973269;Taip;3;1;0;4
10817;Strazdelis;Genelio;7120717682;Taip;0;3;1;4
10818;Strazdelis;Genelio;50350281905;Taip;18;3;0;21
10819;Strazdelis;Genelio;1187534672;Taip;6;1;0;7
10820;Strazdelis;Genelio;9198429790;Taip;3;4;0;7
10821;Strazdelis;Genelio;2871673641;Taip;12;2;0;14
10822;Strazdelis;Genelio;6147183190;Taip;12;4;0;16
10823;Strazdelis;Genelio;2078150337;Taip;0;5;0;5
10824;Strazdelis;Genelio;18461074207;Taip;20;0;0;20
10825;Strazdelis;Genelio;1362428967;Taip;1;3;0;4
10826;Strazdelis;Genelio;8801420992;Taip;13;0;0;13
10827;Strazdelis;Genelio;8634815556;Taip;6;0;0;6
10828;Strazdelis;Genelio;9904719582;Taip;15;0;0;15
10829;Strazdelis;Genelio;7308925265;Taip;5;2;0;7
10830;Strazdelis;Genelio;4655931716;Taip;0;2;1;3
10831;Strazdelis;Genelio;8182994112;Taip;6;0;0;6
10832;Strazdelis;Genelio;5371939820;Taip;0;2;1;3
10833;Strazdelis;Genelio;68605763183;Taip;21;0;0;21
10834;Strazdelis;Vikruolių;58844235230;Taip;0;6;0;6
10835;Strazdelis;Vikruolių;7549142768;Ne;0;2;0;2
10836;Strazdelis;Vikruolių;62366722408;Taip;0;3;0;3
10837;Strazdelis;Vikruolių;98620402347;Taip;0;2;0;2
10838;Strazdelis;Vikruolių;79337959137;Taip;9;2;0;11
10839;Strazdelis;Vikruolių;56331124076;Taip;0;1;0;1
10840;Strazdelis;Vikruolių;14923406397;Taip;0;1;0;1
10841;Strazdelis;Vikruolių;70999059743;Taip;0;2;0;2
10842;Strazdelis;Vikruolių;33107603963;Ne;0;2;0;2
10843;Strazdelis;Vikruolių;1952649844;Taip;3;0;0;3
10844;Strazdelis;Vikruolių;90310485415;Taip;0;1;0;1
10845;Strazdelis;Vikruolių;97958963239;Taip;0;1;0;1
10846;Strazdelis;Vikruolių;75235370334;Taip;0;2;0;2
10847;Strazdelis;Vikruolių;42180634251;Taip;0;5;0;5
10848;Strazdelis;Vikruolių;54028832658;Taip;1;2;0;3
10849;Strazdelis;Vikruolių;30372050952;Taip;11;0;0;11
10850;Strazdelis;Vikruolių;39915650220;Ne;0;7;0;7
10851;Strazdelis;Vikruolių;75528880272;Taip;8;0;0;8
10852;Strazdelis;Vikruolių;97790033745;Taip;0;1;0;1
10853;Strazdelis;Vikruolių;96227697952;Taip;0;3;0;3
10854;Strazdelis;Vyturėlių;89976183528;Taip;0;1;0;1
10855;Strazdelis;Vyturėlių;52370891798;Taip;0;6;0;6
10856;Strazdelis;Vyturėlių;21075820140;Taip;0;4;0;4
10857;Strazdelis;Vyturėlių;88801862582;Taip;0;4;0;4
10858;Strazdelis;Vyturėlių;33675356631;Ne;0;2;0;2
10859;Strazdelis;Vyturėlių;71377546049;Taip;0;3;0;3
10860;Strazdelis;Vyturėlių;1499287166;Taip;6;11;0;17
10861;Strazdelis;Vyturėlių;24240557041;Taip;0;3;0;3
10862;Strazdelis;Vyturėlių;26311407354;Taip;1;0;0;1
10863;Strazdelis;Vyturėlių;60144664935;Taip;0;1;0;1
10864;Strazdelis;Vyturėlių;1888068247;Taip;0;2;0;2
10865;Strazdelis;Vyturėlių;20384116848;Taip;0;1;0;1
10866;Strazdelis;Vyturėlių;41690491541;Taip;0;9;0;9
10867;Strazdelis;Vyturėlių;62150824334;Taip;0;4;0;4
10868;Strazdelis;Vyturėlių;3320884603;Taip;0;12;0;12
10869;Strazdelis;Varpelio;43722400626;Taip;5;3;0;8
10870;Strazdelis;Varpelio;39502125227;Taip;5;1;0;6
10871;Strazdelis;Varpelio;2502465398;Taip;0;1;0;1
10872;Strazdelis;Varpelio;83919699672;Taip;0;9;0;9
10873;Strazdelis;Varpelio;1426195737;Taip;0;6;0;6
10874;Strazdelis;Varpelio;86957187003;Taip;10;5;0;15
10875;Strazdelis;Varpelio;52211473547;Taip;0;2;0;2
10876;Strazdelis;Varpelio;98553857685;Taip;2;1;0;3
10877;Strazdelis;Varpelio;54646720821;Taip;3;1;0;4
10878;Strazdelis;Varpelio;62063592887;Taip;0;5;0;5
10879;Strazdelis;Varpelio;47899514138;Taip;5;0;0;5
10880;Strazdelis;Varpelio;3636163418;Taip;5;2;0;7
10881;Strazdelis;Varpelio;17045991832;Taip;0;7;0;7
10882;Strazdelis;Varpelio;58143176237;Taip;0;1;0;1
10883;Strazdelis;Varpelio;58440671129;Taip;5;5;0;10
10884;Strazdelis;Varpelio;1785962711;Taip;0;17;0;17
10885;Strazdelis;Varpelio;98818869900;Taip;0;3;0;3
10886;Strazdelis;Varpelio;1535288878;Taip;0;7;0;7
10887;Strazdelis;Varpelio;49277241025;Taip;4;2;0;6
10888;Strazdelis;Varpelio;1707225898;Taip;0;6;0;6
10889;Strazdelis;Pelėdžiukų;13220421668;Taip;2;1;0;3
10890;Strazdelis;Pelėdžiukų;13625184061;Taip;0;8;0;8
10891;Strazdelis;Pelėdžiukų;73711363249;Taip;3;0;0;3
10892;Strazdelis;Pelėdžiukų;66197587093;Taip;0;5;0;5
10893;Strazdelis;Pelėdžiukų;62754553467;Taip;0;4;0;4
10894;Strazdelis;Pelėdžiukų;16453584376;Taip;3;0;0;3
10895;Strazdelis;Pelėdžiukų;72069723016;Taip;0;8;0;8
10896;Strazdelis;Pelėdžiukų;63720428545;Taip;10;1;0;11
10897;Strazdelis;Pelėdžiukų;54050062292;Taip;0;4;0;4
10898;Strazdelis;Pelėdžiukų;64675347442;Taip;0;1;0;1
10899;Strazdelis;Pelėdžiukų;18595696353;Taip;0;2;0;2
10900;Strazdelis;Pelėdžiukų;23371576969;Taip;0;9;0;9
10901;Strazdelis;Pelėdžiukų;87689168341;Taip;0;2;0;2
10902;Strazdelis;Pelėdžiukų;23376659452;Taip;4;0;0;4
10903;Strazdelis;Pelėdžiukų;86783302100;Taip;5;0;0;5
10904;Strazdelis;Pelėdžiukų;56012252629;Taip;0;1;0;1
10905;Strazdelis;Pelėdžiukų;77589342371;Taip;0;3;0;3
10906;Strazdelis;Pelėdžiukų;91962766970;Taip;0;2;0;2
10907;Strazdelis;Pelėdžiukų;52790577750;Taip;5;0;0;5
10908;Strazdelis;Pelėdžiukų;1140100663;Taip;5;0;0;5
10909;Strazdelis;Saulutės;1474503932;Taip;1;1;0;2
10910;Strazdelis;Saulutės;27177757900;Taip;0;2;3;5
10911;Strazdelis;Saulutės;40932140069;Taip;8;1;0;9
10912;Strazdelis;Saulutės;1523471662;Taip;7;6;0;13
10913;Strazdelis;Saulutės;2854642875;Taip;17;0;0;17
10914;Strazdelis;Saulutės;7578229276;Taip;4;2;1;7
10915;Strazdelis;Saulutės;8710848483;Taip;0;2;0;2
10916;Strazdelis;Saulutės;6614184499;Taip;7;2;0;9
10917;Strazdelis;Saulutės;4129957131;Taip;15;0;0;15
10918;Strazdelis;Saulutės;3425430317;Taip;3;2;1;6
10919;Strazdelis;Saulutės;5059832307;Taip;0;2;2;4
10920;Strazdelis;Saulutės;7081517417;Taip;12;0;0;12
10921;Strazdelis;Saulutės;67641340859;Taip;14;1;3;18
10922;Strazdelis;Saulutės;15298412755;Taip;1;5;0;6
10923;Strazdelis;Saulutės;1802092125;Taip;1;2;0;3
10924;Strazdelis;Saulutės;1391009140;Taip;0;2;0;2
10925;Strazdelis;Saulutės;6779352728;Taip;9;1;0;10
10926;Strazdelis;Saulutės;29225108934;Taip;0;8;0;8
10927;Strazdelis;Bitutės;99973904527;Taip;0;1;0;1
10928;Strazdelis;Bitutės;92799934389;Taip;5;2;0;7
10929;Strazdelis;Bitutės;9065275674;Taip;14;1;0;15
10930;Strazdelis;Bitutės;33123804487;Taip;6;1;0;7
10931;Strazdelis;Bitutės;6523307315;Taip;21;0;0;21
10932;Strazdelis;Bitutės;15920566059;Taip;3;4;0;7
10933;Strazdelis;Bitutės;18222675927;Taip;0;11;0;11
10934;Strazdelis;Bitutės;47547568043;Ne;0;2;0;2
10935;Strazdelis;Bitutės;66254701944;Taip;2;10;0;12
10936;Strazdelis;Bitutės;24001445236;Taip;0;4;0;4
10937;Strazdelis;Bitutės;96062922228;Taip;0;2;0;2
10938;Strazdelis;Bitutės;1111310766;Taip;0;3;0;3
10939;Strazdelis;Bitutės;24669852216;Taip;12;3;0;15
10940;Strazdelis;Bitutės;51702469375;Taip;6;0;0;6
10941;Strazdelis;Bitutės;1073814440;Taip;0;5;0;5
10942;Strazdelis;Bitutės;59837435595;Taip;12;5;0;17
10943;Strazdelis;Bitutės;90089166514;Taip;0;2;1;3
10944;Strazdelis;Bitutės;1847755442;Taip;7;0;0;7
10945;Strazdelis;Bitutės;7812253305;Taip;5;0;0;5
10946;Strazdelis;Bitutės;96077591556;Taip;1;0;0;1
10947;Strazdelis;Bitutės;14459771394;Taip;1;0;0;1
10948;Strazdelis;Bitutės;2673522432;Taip;21;0;0;21
10949;Strazdelis;Mažylių;1955166372;Taip;0;0;2;2
10950;Strazdelis;Mažylių;8415383526;Taip;16;1;0;17
10951;Strazdelis;Mažylių;2963535523;Taip;1;0;0;1
10952;Strazdelis;Mažylių;6931726275;Taip;5;2;0;7
10953;Strazdelis;Mažylių;4873707286;Taip;12;1;0;13
10954;Strazdelis;Mažylių;4076266466;Taip;21;0;0;21
10955;Strazdelis;Mažylių;2824416350;Taip;0;2;3;5
10956;Strazdelis;Mažylių;3610250359;Taip;18;3;0;21
10957;Strazdelis;Mažylių;2766970956;Taip;5;0;0;5
10958;Strazdelis;Mažylių;2580733127;Taip;0;2;1;3
10959;Strazdelis;Mažylių;2662549392;Taip;0;1;0;1
10960;Strazdelis;Mažylių;9502341478;Taip;5;0;0;5
10961;Strazdelis;Mažylių;2251157025;Taip;6;0;0;6
10962;Strazdelis;Mažylių;9401101407;Taip;0;1;0;1
10963;Strazdelis;Mažylių;6527855940;Taip;0;1;0;1
10964;Strazdelis;Pabiručių;1021364759;Taip;12;1;0;13
10965;Strazdelis;Pabiručių;5580738386;Taip;4;0;0;4
10966;Strazdelis;Pabiručių;1706026100;Taip;9;0;0;9
10967;Strazdelis;Pabiručių;8637386316;Taip;5;1;0;6
10968;Strazdelis;Pabiručių;8287554571;Taip;5;0;0;5
10969;Strazdelis;Pabiručių;6555803164;Taip;0;3;0;3
10970;Strazdelis;Pabiručių;3943914976;Taip;12;0;0;12
10971;Strazdelis;Pabiručių;1704292727;Taip;14;1;0;15
10972;Strazdelis;Pabiručių;4617237063;Taip;6;2;1;9
10973;Strazdelis;Pabiručių;3036380561;Taip;6;2;1;9
10974;Strazdelis;Pabiručių;4562530311;Taip;5;0;0;5
10975;Strazdelis;Pabiručių;6046139859;Taip;4;0;0;4
10976;Strazdelis;Pabiručių;4448556404;Taip;15;0;0;15
10977;Strazdelis;Pabiručių;8854150040;Taip;3;1;0;4
10978;Strazdelis;Pabiručių;7393083827;Taip;10;3;0;13
10979;Strazdelis;Pabiručių;1901641517;Taip;14;0;0;14
10980;Strazdelis;Pabiručių;8371999002;Taip;5;1;0;6
10981;Šermukšnėlė;MOLINUKAI;82928987881;Taip;0;0;5;5
10982;Šermukšnėlė;MOLINUKAI;42211665091;Taip;0;0;1;1
10983;Šermukšnėlė;MOLINUKAI;77238595800;Taip;2;0;0;2
10984;Šermukšnėlė;MOLINUKAI;87315703379;Taip;0;3;0;3
10985;Šermukšnėlė;MOLINUKAI;61809452162;Taip;1;0;0;1
10986;Šermukšnėlė;MOLINUKAI;60863269031;Taip;0;2;0;2
10987;Šermukšnėlė;MOLINUKAI;31537402750;Taip;4;0;0;4
10988;Šermukšnėlė;MOLINUKAI;28087351377;Taip;0;1;0;1
10989;Šermukšnėlė;MOLINUKAI;87587621833;Taip;0;0;1;1
10990;Šermukšnėlė;MOLINUKAI;39534021804;Taip;0;0;2;2
10991;Šermukšnėlė;MOLINUKAI;54312555311;Taip;9;0;0;9
10992;Šermukšnėlė;MOLINUKAI;2100740973;Taip;5;2;0;7
10993;Šermukšnėlė;MOLINUKAI;1738008915;Taip;0;10;0;10
10994;Šermukšnėlė;MOLINUKAI;38451276871;Taip;4;0;0;4
10995;Šermukšnėlė;ŠIAUDINUKAI;85959255744;Taip;0;3;0;3
10996;Šermukšnėlė;ŠIAUDINUKAI;29600546074;Taip;0;2;0;2
10997;Šermukšnėlė;ŠIAUDINUKAI;61916462777;Taip;0;1;0;1
10998;Šermukšnėlė;ŠIAUDINUKAI;40455970268;Taip;0;1;0;1
10999;Šermukšnėlė;ŠIAUDINUKAI;95999386401;Taip;0;2;0;2
11000;Šermukšnėlė;ŠIAUDINUKAI;26710222684;Taip;5;1;0;6
11001;Šermukšnėlė;ŠIAUDINUKAI;34526101469;Taip;0;6;0;6
11002;Šermukšnėlė;ŠIAUDINUKAI;2734502079;Taip;0;1;0;1
11003;Šermukšnėlė;ŠIAUDINUKAI;27112465050;Taip;0;4;0;4
11004;Šermukšnėlė;ŠIAUDINUKAI;33885733234;Taip;0;0;3;3
11005;Šermukšnėlė;ŠIAUDINUKAI;80780535536;Taip;0;2;0;2
11006;Šermukšnėlė;ŠIAUDINUKAI;4487587228;Taip;0;5;0;5
11007;Šermukšnėlė;ŠIAUDINUKAI;63943361071;Taip;0;6;0;6
11008;Šermukšnėlė;ŠIAUDINUKAI;16859553972;Taip;0;1;0;1
11009;Šermukšnėlė;ŠIAUDINUKAI;99444734331;Taip;1;0;0;1
11010;Šermukšnėlė;ŠIAUDINUKAI;3851927973;Taip;0;0;4;4
11011;Šermukšnėlė;TOŠINUKAI;8648722780;Taip;0;1;1;2
11012;Šermukšnėlė;TOŠINUKAI;10371439347;Taip;11;0;0;11
11013;Šermukšnėlė;TOŠINUKAI;53558901565;Taip;0;2;0;2
11014;Šermukšnėlė;TOŠINUKAI;5263529062;Taip;0;6;0;6
11015;Šermukšnėlė;TOŠINUKAI;70200454607;Taip;0;1;2;3
11016;Šermukšnėlė;TOŠINUKAI;91969292233;Taip;10;0;2;12
11017;Šermukšnėlė;TOŠINUKAI;1636627303;Taip;4;0;0;4
11018;Šermukšnėlė;TOŠINUKAI;1846720859;Taip;0;0;1;1
11019;Šermukšnėlė;TOŠINUKAI;51058072005;Taip;7;0;0;7
11020;Šermukšnėlė;TOŠINUKAI;1559325175;Taip;1;0;3;4
11021;Šermukšnėlė;TOŠINUKAI;1755108527;Taip;0;0;1;1
11022;Šermukšnėlė;TOŠINUKAI;2137141949;Taip;3;0;0;3
11023;Šermukšnėlė;TOŠINUKAI;1858862320;Taip;16;0;1;17
11024;Šermukšnėlė;TOŠINUKAI;1016403317;Taip;0;0;2;2
11025;Šermukšnėlė;TOŠINUKAI;85018940292;Taip;0;13;0;13
11026;Šermukšnėlė;ODINUKAI;9132691512;Taip;0;0;6;6
11027;Šermukšnėlė;ODINUKAI;33974692298;Taip;5;4;0;9
11028;Šermukšnėlė;ODINUKAI;41864110754;Taip;6;2;0;8
11029;Šermukšnėlė;ODINUKAI;74932757076;Taip;5;0;0;5
11030;Šermukšnėlė;ODINUKAI;42759782885;Taip;5;1;1;7
11031;Šermukšnėlė;ODINUKAI;29953350731;Taip;5;0;1;6
11032;Šermukšnėlė;ODINUKAI;72671813439;Taip;0;1;1;2
11033;Šermukšnėlė;ODINUKAI;87510707958;Taip;4;3;0;7
11034;Šermukšnėlė;ODINUKAI;12208634069;Taip;0;1;0;1
11035;Šermukšnėlė;ODINUKAI;54578226695;Taip;2;1;4;7
11036;Šermukšnėlė;ODINUKAI;29671788305;Taip;0;3;1;4
11037;Šermukšnėlė;ODINUKAI;89495591163;Taip;3;0;0;3
11038;Šermukšnėlė;ODINUKAI;53753895760;Taip;0;2;0;2
11039;Šermukšnėlė;ODINUKAI;1911285078;Taip;0;0;4;4
11040;Šermukšnėlė;KRIAUKLELĖS;98850511500;Taip;3;3;0;6
11041;Šermukšnėlė;KRIAUKLELĖS;26775257484;Taip;0;9;0;9
11042;Šermukšnėlė;KRIAUKLELĖS;11053850075;Taip;5;6;0;11
11043;Šermukšnėlė;KRIAUKLELĖS;80349025945;Taip;15;0;0;15
11044;Šermukšnėlė;KRIAUKLELĖS;2561033248;Taip;5;5;0;10
11045;Šermukšnėlė;KRIAUKLELĖS;8123096990;Taip;4;5;0;9
11046;Šermukšnėlė;KRIAUKLELĖS;1492328724;Taip;3;0;1;4
11047;Šermukšnėlė;KRIAUKLELĖS;82028252228;Taip;11;0;0;11
11048;Šermukšnėlė;KRIAUKLELĖS;1110375562;Taip;21;0;0;21
11049;Šermukšnėlė;KRIAUKLELĖS;23434568160;Taip;0;0;2;2
11050;Šermukšnėlė;KRIAUKLELĖS;1562494176;Taip;0;5;0;5
11051;Šermukšnėlė;KRIAUKLELĖS;3543061360;Taip;0;8;0;8
11052;Šermukšnėlė;KRIAUKLELĖS;6896990721;Taip;12;0;0;12
11053;Šermukšnėlė;KRIAUKLELĖS;7564745299;Taip;0;11;0;11
11054;Šermukšnėlė;KRIAUKLELĖS;6937555692;Taip;5;0;1;6
11055;Šermukšnėlė;KRIAUKLELĖS;9617044855;Taip;0;9;0;9
11056;Šermukšnėlė;KRIAUKLELĖS;3639954786;Taip;0;0;3;3
11057;Šermukšnėlė;KRIAUKLELĖS;5757405893;Taip;10;0;0;10
11058;Šermukšnėlė;KRIAUKLELĖS;1902848560;Taip;5;3;0;8
11059;Šermukšnėlė;VYTINUKAI;4601810772;Taip;3;0;0;3
11060;Šermukšnėlė;VYTINUKAI;97906920174;Taip;11;0;0;11
11061;Šermukšnėlė;VYTINUKAI;1523361932;Taip;11;0;0;11
11062;Šermukšnėlė;VYTINUKAI;8531953934;Taip;2;0;0;2
11063;Šermukšnėlė;VYTINUKAI;25189813939;Taip;11;1;0;12
11064;Šermukšnėlė;VYTINUKAI;33936407625;Taip;4;0;0;4
11065;Šermukšnėlė;VYTINUKAI;83123267733;Taip;2;3;0;5
11066;Šermukšnėlė;VYTINUKAI;20028832329;Taip;0;3;0;3
11067;Šermukšnėlė;VYTINUKAI;3959795064;Taip;5;0;0;5
11068;Šermukšnėlė;VYTINUKAI;8498288021;Taip;12;1;1;14
11069;Šermukšnėlė;VYTINUKAI;3751769136;Taip;7;0;0;7
11070;Šermukšnėlė;VYTINUKAI;5905000902;Taip;9;0;0;9
11071;Šermukšnėlė;VYTINUKAI;6291531570;Taip;8;0;0;8
11072;Šermukšnėlė;VYTINUKAI;8398961969;Taip;8;7;0;15
11073;Šermukšnėlė;VYTINUKAI;1244964311;Taip;0;6;1;7
11074;Šermukšnėlė;VYTINUKAI;83882579952;Taip;0;2;0;2
11075;Šermukšnėlė;VYTINUKAI;60840526220;Taip;8;0;0;8
11076;Šermukšnėlė;VYTINUKAI;8610668395;Taip;16;0;1;17
11077;Šermukšnėlė;VYTINUKAI;1025787925;Taip;6;0;0;6
11078;Šermukšnėlė;GINTARĖLIAI;1167696952;Taip;8;0;1;9
11079;Šermukšnėlė;GINTARĖLIAI;85062380771;Taip;7;0;7;14
11080;Šermukšnėlė;GINTARĖLIAI;35389950541;Taip;5;0;15;20
11081;Šermukšnėlė;GINTARĖLIAI;1944687724;Taip;2;0;0;2
11082;Šermukšnėlė;GINTARĖLIAI;1013698297;Taip;0;0;6;6
11083;Šermukšnėlė;GINTARĖLIAI;2094932013;Taip;6;0;0;6
11084;Šermukšnėlė;GINTARĖLIAI;1853346049;Taip;7;0;0;7
11085;Šermukšnėlė;GINTARĖLIAI;1851549466;Taip;2;4;0;6
11086;Šermukšnėlė;GINTARĖLIAI;3697936074;Taip;6;0;0;6
11087;Šermukšnėlė;GINTARĖLIAI;2686950289;Taip;0;1;1;2
11088;Šermukšnėlė;GINTARĖLIAI;27183547828;Taip;3;0;0;3
11089;Šermukšnėlė;GINTARĖLIAI;10728235594;Taip;5;0;3;8
11090;Šermukšnėlė;GINTARĖLIAI;42477406335;Taip;0;0;3;3
11091;Šermukšnėlė;GINTARĖLIAI;61300763004;Taip;6;0;0;6
11092;Šermukšnėlė;GINTARĖLIAI;1425285365;Taip;0;1;2;3
11093;Šermukšnėlė;GINTARĖLIAI;6279210465;Taip;6;0;1;7
11094;Šermukšnėlė;AKMENUKAI;60154507177;Taip;6;1;2;9
11095;Šermukšnėlė;AKMENUKAI;6987675764;Taip;1;0;3;4
11096;Šermukšnėlė;AKMENUKAI;84389234313;Taip;7;0;1;8
11097;Šermukšnėlė;AKMENUKAI;35098181817;Taip;0;0;2;2
11098;Šermukšnėlė;AKMENUKAI;20272898512;Taip;0;0;2;2
11099;Šermukšnėlė;AKMENUKAI;85116657402;Taip;6;0;2;8
11100;Šermukšnėlė;AKMENUKAI;6604797702;Taip;0;0;3;3
11101;Šermukšnėlė;AKMENUKAI;95089450234;Taip;0;0;5;5
11102;Šermukšnėlė;AKMENUKAI;1332354208;Taip;0;0;2;2
11103;Šermukšnėlė;AKMENUKAI;1175718969;Taip;4;3;1;8
11104;Šermukšnėlė;AKMENUKAI;27139089487;Taip;0;1;0;1
11105;Šermukšnėlė;AKMENUKAI;42520543068;Taip;0;0;1;1
11106;Šermukšnėlė;AKMENUKAI;76682206033;Taip;0;6;0;6
11107;Šermukšnėlė;AKMENUKAI;3628734426;Taip;5;6;0;11
11108;Šermukšnėlė;AKMENUKAI;82161996761;Taip;10;0;0;10
11109;Šermukšnėlė;SIŪLINUKAI;32417473492;Taip;10;3;0;13
11110;Šermukšnėlė;SIŪLINUKAI;35508499818;Taip;10;3;0;13
11111;Šermukšnėlė;SIŪLINUKAI;30853722796;Taip;0;2;0;2
11112;Šermukšnėlė;SIŪLINUKAI;41661711151;Taip;0;1;0;1
11113;Šermukšnėlė;SIŪLINUKAI;62420710883;Taip;16;0;0;16
11114;Šermukšnėlė;SIŪLINUKAI;25663713043;Taip;0;7;0;7
11115;Šermukšnėlė;SIŪLINUKAI;57211490716;Taip;0;2;0;2
11116;Šermukšnėlė;SIŪLINUKAI;88123535614;Taip;0;2;0;2
11117;Šermukšnėlė;SIŪLINUKAI;20160146304;Taip;6;1;0;7
11118;Šermukšnėlė;SIŪLINUKAI;1330471614;Taip;0;1;0;1
11119;Šermukšnėlė;SIŪLINUKAI;1127786451;Taip;6;3;0;9
11120;Šermukšnėlė;SIŪLINUKAI;18799838453;Taip;0;1;0;1
11121;Šermukšnėlė;SIŪLINUKAI;78916223877;Taip;13;0;1;14
11122;Šermukšnėlė;SIŪLINUKAI;45632551657;Taip;6;2;0;8
11123;Šermukšnėlė;MEDINUKAi;2380988728;Taip;5;0;4;9
11124;Šermukšnėlė;MEDINUKAi;2529526401;Taip;8;0;3;11
11125;Šermukšnėlė;MEDINUKAi;1753169856;Taip;0;2;0;2
11126;Šermukšnėlė;MEDINUKAi;8956573129;Taip;0;3;0;3
11127;Šermukšnėlė;MEDINUKAi;3222466449;Taip;11;0;0;11
11128;Šermukšnėlė;MEDINUKAi;5096946133;Taip;0;9;0;9
11129;Šermukšnėlė;MEDINUKAi;8279692394;Taip;10;0;0;10
11130;Šermukšnėlė;MEDINUKAi;1459253197;Taip;0;0;1;1
11131;Šermukšnėlė;MEDINUKAi;2160616078;Taip;2;0;0;2
11132;Šermukšnėlė;MEDINUKAi;78341448188;Taip;6;1;3;10
11133;Šermukšnėlė;MEDINUKAi;1661977128;Taip;2;0;2;4
11134;Šermukšnėlė;MEDINUKAi;6430627501;Taip;0;2;0;2
11135;Šermukšnėlė;MEDINUKAi;5832072195;Taip;2;15;0;17
11136;Šermukšnėlė;MEDINUKAi;9035625467;Taip;5;1;0;6
11137;Šermukšnėlė;MEDINUKAi;7038705221;Taip;11;0;1;12
11138;Šermukšnėlė;MEDINUKAi;3081548524;Taip;0;3;0;3
11139;Šermukšnėlė;SKUDURINUKAI;7262199284;Taip;5;2;0;7
11140;Šermukšnėlė;SKUDURINUKAI;5151843494;Taip;0;0;1;1
11141;Šermukšnėlė;SKUDURINUKAI;1148559284;Taip;0;0;4;4
11142;Šermukšnėlė;SKUDURINUKAI;3148857617;Taip;0;10;0;10
11143;Šermukšnėlė;SKUDURINUKAI;4201283154;Taip;6;0;0;6
11144;Šermukšnėlė;SKUDURINUKAI;5575518612;Taip;0;0;1;1
11145;Šermukšnėlė;SKUDURINUKAI;5733540837;Taip;0;1;0;1
11146;Šermukšnėlė;SKUDURINUKAI;5397385093;Taip;9;0;0;9
11147;Šermukšnėlė;SKUDURINUKAI;3322053946;Taip;0;3;0;3
11148;Šermukšnėlė;SKUDURINUKAI;5354978646;Taip;0;0;6;6
11149;Šermukšnėlė;SKUDURINUKAI;1882432812;Taip;0;0;6;6
11150;Šermukšnėlė;SKUDURINUKAI;5242187638;Taip;1;0;0;1
11151;Šermukšnėlė;SKUDURINUKAI;5159461963;Taip;0;7;0;7
11152;Šermukšnėlė;PAGRANDUKAI;4569484117;Taip;0;3;0;3
11153;Šermukšnėlė;PAGRANDUKAI;5140264695;Taip;11;0;1;12
11154;Šermukšnėlė;PAGRANDUKAI;5159105661;Taip;17;0;0;17
11155;Šermukšnėlė;PAGRANDUKAI;7305013368;Taip;5;1;0;6
11156;Šermukšnėlė;PAGRANDUKAI;1437314920;Taip;0;2;0;2
11157;Šermukšnėlė;PAGRANDUKAI;7843128263;Taip;4;0;0;4
11158;Šermukšnėlė;PAGRANDUKAI;8407947566;Taip;3;0;0;3
11159;Šermukšnėlė;PAGRANDUKAI;2447547509;Taip;6;0;2;8
11160;Šermukšnėlė;PAGRANDUKAI;4086783761;Taip;5;0;1;6
11161;Šermukšnėlė;PAGRANDUKAI;9876533442;Taip;8;0;0;8
11162;Šermukšnėlė;PAGRANDUKAI;3513568460;Taip;5;0;3;8
11163;Šermukšnėlė;PAGRANDUKAI;4230698872;Taip;6;0;0;6
11164;Šermukšnėlė;PAGRANDUKAI;6067298318;Taip;6;1;0;7
11165;Šypsena;NYKŠTUKAI;5985974927;Taip;0;6;0;6
11166;Šypsena;NYKŠTUKAI;4766170132;Ne;0;0;1;1
11167;Šypsena;NYKŠTUKAI;4936775366;Taip;5;6;6;17
11168;Šypsena;NYKŠTUKAI;7569495879;Taip;0;1;0;1
11169;Šypsena;NYKŠTUKAI;4677405885;Taip;9;0;0;9
11170;Šypsena;NYKŠTUKAI;6590285866;Taip;0;0;1;1
11171;Šypsena;NYKŠTUKAI;1343249939;Taip;0;0;8;8
11172;Šypsena;NYKŠTUKAI;1387130727;Taip;7;0;0;7
11173;Šypsena;NYKŠTUKAI;3025437080;Taip;0;0;4;4
11174;Šypsena;NYKŠTUKAI;1669768648;Ne;10;0;3;13
11175;Šypsena;NYKŠTUKAI;1575413188;Taip;0;4;0;4
11176;Šypsena;NYKŠTUKAI;2005543016;Ne;0;10;0;10
11177;Šypsena;NYKŠTUKAI;6832433711;Taip;1;0;0;1
11178;Šypsena;NYKŠTUKAI;1796837022;Taip;0;2;0;2
11179;Šypsena;NYKŠTUKAI;7251064118;Taip;0;0;3;3
11180;Šypsena;SPINDULIUKAI;6444616846;Taip;6;0;0;6
11181;Šypsena;SPINDULIUKAI;1967590536;Taip;0;1;0;1
11182;Šypsena;SPINDULIUKAI;3541189470;Taip;11;0;1;12
11183;Šypsena;SPINDULIUKAI;1767948457;Ne;5;1;0;6
11184;Šypsena;SPINDULIUKAI;1917246860;Ne;0;19;0;19
11185;Šypsena;SPINDULIUKAI;46569341613;Taip;1;0;0;1
11186;Šypsena;SPINDULIUKAI;42130115068;Taip;0;8;0;8
11187;Šypsena;SPINDULIUKAI;1712017606;Ne;0;4;0;4
11188;Šypsena;SPINDULIUKAI;1996746426;Taip;0;1;0;1
11189;Šypsena;SPINDULIUKAI;4017777389;Taip;17;0;1;18
11190;Šypsena;SPINDULIUKAI;70188972463;Taip;4;0;0;4
11191;Šypsena;SPINDULIUKAI;76332370575;Taip;3;1;1;5
11192;Šypsena;SPINDULIUKAI;1906529989;Taip;17;0;0;17
11193;Šypsena;SPINDULIUKAI;2099216049;Taip;11;10;0;21
11194;Šypsena;SPINDULIUKAI;89503728819;Ne;0;8;0;8
11195;Šypsena;SPINDULIUKAI;8197460768;Taip;0;4;0;4
11196;Šypsena;SPINDULIUKAI;1133113196;Ne;0;1;0;1
11197;Šypsena;SKRUZDELIUKAI;7591001646;Ne;0;8;0;8
11198;Šypsena;SKRUZDELIUKAI;17041968817;Taip;6;0;0;6
11199;Šypsena;SKRUZDELIUKAI;1369664461;Ne;6;1;0;7
11200;Šypsena;SKRUZDELIUKAI;1886141947;Taip;0;0;3;3
11201;Šypsena;SKRUZDELIUKAI;49812111803;Taip;6;1;0;7
11202;Šypsena;SKRUZDELIUKAI;1329170686;Taip;0;2;0;2
11203;Šypsena;SKRUZDELIUKAI;84526597847;Taip;0;3;0;3
11204;Šypsena;SKRUZDELIUKAI;39296351965;Taip;0;6;0;6
11205;Šypsena;SKRUZDELIUKAI;25175991441;Taip;3;1;0;4
11206;Šypsena;SKRUZDELIUKAI;91846404526;Ne;0;3;0;3
11207;Šypsena;SKRUZDELIUKAI;47729405181;Taip;0;1;3;4
11208;Šypsena;SKRUZDELIUKAI;1972212253;Taip;0;2;2;4
11209;Šypsena;SKRUZDELIUKAI;31833883832;Taip;0;13;0;13
11210;Šypsena;SKRUZDELIUKAI;39495782526;Taip;0;7;0;7
11211;Šypsena;SKRUZDELIUKAI;2117865969;Taip;0;1;0;1
11212;Šypsena;SKRUZDELIUKAI;1755934341;Taip;7;0;4;11
11213;Šypsena;SKRUZDELIUKAI;1702152247;Taip;0;4;0;4
11214;Šypsena;SKRUZDELIUKAI;2119267347;Ne;0;1;0;1
11215;Šypsena;SKRUZDELIUKAI;5680397153;Taip;14;0;1;15
11216;Šypsena;MEŠKIUKAI;1114341518;Taip;6;0;4;10
11217;Šypsena;MEŠKIUKAI;8715718525;Taip;5;0;1;6
11218;Šypsena;MEŠKIUKAI;2312828770;Taip;6;1;1;8
11219;Šypsena;MEŠKIUKAI;7438060503;Taip;7;2;0;9
11220;Šypsena;MEŠKIUKAI;1515803985;Taip;5;1;0;6
11221;Šypsena;MEŠKIUKAI;5504570516;Taip;0;0;12;12
11222;Šypsena;MEŠKIUKAI;1063834589;Taip;6;3;0;9
11223;Šypsena;MEŠKIUKAI;1558614852;Taip;16;0;0;16
11224;Šypsena;MEŠKIUKAI;1897176871;Taip;6;6;0;12
11225;Šypsena;MEŠKIUKAI;1181590127;Taip;12;4;1;17
11226;Šypsena;MEŠKIUKAI;4808041625;Taip;8;1;0;9
11227;Šypsena;MEŠKIUKAI;5834057370;Taip;18;0;0;18
11228;Šypsena;MEŠKIUKAI;5928432220;Taip;0;7;0;7
11229;Šypsena;MEŠKIUKAI;2798819321;Taip;0;5;0;5
11230;Šypsena;BORUŽĖLĖS;3506046076;Ne;5;1;0;6
11231;Šypsena;BORUŽĖLĖS;5611440056;Ne;6;0;0;6
11232;Šypsena;BORUŽĖLĖS;7160466766;Taip;0;5;0;5
11233;Šypsena;BORUŽĖLĖS;4038279267;Taip;15;1;0;16
11234;Šypsena;BORUŽĖLĖS;3823623458;Ne;8;4;0;12
11235;Šypsena;BORUŽĖLĖS;6713182218;Taip;21;0;0;21
11236;Šypsena;BORUŽĖLĖS;8950694484;Taip;0;1;0;1
11237;Šypsena;BORUŽĖLĖS;4344780723;Taip;0;0;21;21
11238;Šypsena;BORUŽĖLĖS;7537442618;Taip;0;8;2;10
11239;Šypsena;BORUŽĖLĖS;3968514430;Taip;4;0;0;4
11240;Šypsena;BORUŽĖLĖS;1893123775;Taip;21;0;0;21
11241;Šypsena;BORUŽĖLĖS;6237208661;Taip;0;0;3;3
11242;Šypsena;BORUŽĖLĖS;6716558946;Taip;15;2;0;17
11243;Šypsena;BORUŽĖLĖS;7519967594;Taip;11;0;0;11
11244;Šnekutis;DRUGELIŲ;1723901018;Taip;0;0;1;1
11245;Šnekutis;DRUGELIŲ;81648325534;Taip;2;0;1;3
11246;Šnekutis;DRUGELIŲ;1245722149;Taip;1;12;0;13
11247;Šnekutis;DRUGELIŲ;1355103006;Taip;0;21;0;21
11248;Šnekutis;DRUGELIŲ;2000728679;Taip;0;1;0;1
11249;Šnekutis;DRUGELIŲ;54635137954;Taip;17;0;0;17
11250;Šnekutis;DRUGELIŲ;2049447215;Taip;0;0;1;1
11251;Šnekutis;DRUGELIŲ;1159232792;Taip;7;0;5;12
11252;Šnekutis;DRUGELIŲ;2092637040;Taip;15;0;0;15
11253;Šnekutis;DRUGELIŲ;94289379983;Taip;14;0;0;14
11254;Šnekutis;DRUGELIŲ;50085798686;Taip;4;5;0;9
11255;Šnekutis;DRUGELIŲ;1836892386;Taip;0;0;1;1
11256;Šnekutis;DRUGELIŲ;5962885680;Taip;0;4;0;4
11257;Šnekutis;DRUGELIŲ;4743885834;Taip;0;21;0;21
11258;Šnekutis;DRUGELIŲ;18354631454;Taip;1;0;3;4
11259;Šnekutis;DRUGELIŲ;5029631107;Taip;1;1;0;2
11260;Šnekutis;DRUGELIŲ;4104052524;Taip;0;6;0;6
11261;Šnekutis;DRUGELIŲ;46282997811;Taip;0;10;0;10
11262;Šnekutis;DRUGELIŲ;1867756701;Ne;0;0;3;3
11263;Šnekutis;DRUGELIŲ;1480772531;Taip;4;0;0;4
11264;Šnekutis;Kačiukų;1156210876;Taip;0;10;5;15
11265;Šnekutis;Kačiukų;1233059816;Taip;0;2;0;2
11266;Šnekutis;Kačiukų;50433076829;Taip;0;0;5;5
11267;Šnekutis;Kačiukų;1179210615;Taip;0;3;0;3
11268;Šnekutis;Kačiukų;1023572132;Taip;0;4;0;4
11269;Šnekutis;Kačiukų;10114111509;Taip;0;3;0;3
11270;Šnekutis;Kačiukų;13211267463;Taip;0;0;7;7
11271;Šnekutis;Kačiukų;1430904579;Taip;0;0;4;4
11272;Šnekutis;Kačiukų;1430790285;Taip;2;0;6;8
11273;Šnekutis;Kačiukų;2027114365;Taip;0;0;1;1
11274;Šnekutis;Kačiukų;41323355319;Taip;6;0;2;8
11275;Šnekutis;Kačiukų;21847996888;Taip;6;0;0;6
11276;Šnekutis;Kačiukų;1498045991;Taip;0;2;0;2
11277;Šnekutis;Kačiukų;57220861535;Taip;15;0;1;16
11278;Šnekutis;Kačiukų;93604802567;Taip;6;1;0;7
11279;Šnekutis;Kačiukų;88609559814;Taip;0;9;0;9
11280;Šnekutis;Kačiukų;5052576808;Taip;0;5;2;7
11281;Šnekutis;Kačiukų;11446344891;Taip;0;0;2;2
11282;Šnekutis;Pėlėdžiukų;5188035949;Taip;0;3;1;4
11283;Šnekutis;Pėlėdžiukų;3068754741;Taip;0;0;2;2
11284;Šnekutis;Pėlėdžiukų;77534335117;Taip;0;0;7;7
11285;Šnekutis;Pėlėdžiukų;3312928478;Taip;0;5;1;6
11286;Šnekutis;Pėlėdžiukų;42697936562;Taip;15;0;0;15
11287;Šnekutis;Pėlėdžiukų;7507857415;Taip;16;0;0;16
11288;Šnekutis;Pėlėdžiukų;8745465796;Taip;0;8;12;20
11289;Šnekutis;Pėlėdžiukų;3170928052;Taip;13;1;0;14
11290;Šnekutis;Pėlėdžiukų;5321817615;Taip;7;0;0;7
11291;Šnekutis;Pėlėdžiukų;2233161242;Taip;10;0;1;11
11292;Šnekutis;Pėlėdžiukų;3578045341;Taip;10;0;0;10
11293;Šnekutis;Pėlėdžiukų;5117544317;Taip;6;0;0;6
11294;Šnekutis;Pėlėdžiukų;2446630485;Taip;0;0;2;2
11295;Šnekutis;Pėlėdžiukų;1507200600;Taip;0;0;3;3
11296;Šnekutis;Pėlėdžiukų;5615869149;Taip;6;3;0;9
11297;Šnekutis;Pėlėdžiukų;1329958641;Taip;0;0;1;1
11298;Šnekutis;Pėlėdžiukų;5457906245;Taip;0;0;7;7
11299;Šnekutis;Pėlėdžiukų;9511116249;Taip;10;0;0;10
11300;Šnekutis;Pėlėdžiukų;1369660223;Taip;0;0;1;1
11301;Šnekutis;Pėlėdžiukų;1447824885;Taip;0;4;0;4
11302;Šnekutis;Boružėlių;1818789769;Taip;0;3;0;3
11303;Šnekutis;Boružėlių;4557629310;Taip;10;6;0;16
11304;Šnekutis;Boružėlių;5711964409;Taip;21;0;0;21
11305;Šnekutis;Boružėlių;37382772659;Taip;0;10;1;11
11306;Šnekutis;Boružėlių;84241751923;Taip;4;0;4;8
11307;Šnekutis;Boružėlių;79174984189;Taip;10;0;0;10
11308;Šnekutis;Boružėlių;1249451765;Taip;0;11;0;11
11309;Šnekutis;Boružėlių;1031911012;Taip;2;0;0;2
11310;Šnekutis;Boružėlių;1985052072;Taip;3;0;1;4
11311;Šnekutis;Boružėlių;1451503127;Taip;14;0;0;14
11312;Šnekutis;Boružėlių;1744313172;Taip;5;0;1;6
11313;Šnekutis;Boružėlių;1620268693;Taip;2;0;3;5
11314;Šnekutis;Boružėlių;22757448235;Ne;0;7;0;7
11315;Šnekutis;Boružėlių;2259206809;Taip;5;0;1;6
11316;Šnekutis;Boružėlių;54532738133;Taip;9;0;1;10
11317;Šnekutis;Boružėlių;5973303255;Taip;0;7;6;13
11318;Šnekutis;Boružėlių;27150074287;Taip;5;0;0;5
11319;Šnekutis;Boružėlių;7514753023;Taip;0;0;6;6
11320;Šnekutis;Boružėlių;6828079735;Taip;8;0;0;8
11321;Šnekutis;Meškučių;4835202527;Taip;11;2;0;13
11322;Šnekutis;Meškučių;2822538227;Taip;6;0;8;14
11323;Šnekutis;Meškučių;8531521901;Taip;1;15;1;17
11324;Šnekutis;Meškučių;9670205249;Taip;0;0;1;1
11325;Šnekutis;Meškučių;6684395256;Taip;10;1;0;11
11326;Šnekutis;Meškučių;3271262071;Taip;8;0;0;8
11327;Šnekutis;Meškučių;8440160819;Taip;5;0;4;9
11328;Šnekutis;Meškučių;9862362744;Taip;5;0;0;5
11329;Šnekutis;Meškučių;9780684867;Taip;11;0;3;14
11330;Šnekutis;Meškučių;7615716438;Taip;2;0;4;6
11331;Šnekutis;Meškučių;7622868249;Taip;16;0;0;16
11332;Šnekutis;Meškučių;3336605264;Taip;0;2;0;2
11333;Šnekutis;Viščiukų;7434438142;Taip;0;9;0;9
11334;Šnekutis;Viščiukų;9312935803;Taip;0;5;8;13
11335;Šnekutis;Viščiukų;9157136735;Taip;5;0;0;5
11336;Šnekutis;Viščiukų;7089000987;Taip;5;0;0;5
11337;Šnekutis;Viščiukų;5049964996;Taip;0;1;0;1
11338;Šnekutis;Viščiukų;3644413861;Taip;7;0;0;7
11339;Šnekutis;Viščiukų;7638626055;Taip;0;1;0;1
11340;Šnekutis;Viščiukų;4405567649;Taip;5;0;0;5
11341;Šnekutis;Viščiukų;6578568418;Taip;0;0;4;4
11342;Šnekutis;Viščiukų;9896249776;Taip;1;0;0;1
11343;Šnekutis;Viščiukų;9790803767;Taip;2;1;0;3
11344;Užupiukas;VYTURĖLIŲ;51802714332;Taip;0;2;0;2
11345;Užupiukas;VYTURĖLIŲ;78184067796;Taip;0;2;2;4
11346;Užupiukas;VYTURĖLIŲ;31338755810;Taip;0;3;0;3
11347;Užupiukas;VYTURĖLIŲ;266671806;Taip;1;5;0;6
11348;Užupiukas;VYTURĖLIŲ;37684526869;Taip;0;1;0;1
11349;Užupiukas;VYTURĖLIŲ;39058613355;Taip;8;1;0;9
11350;Užupiukas;VYTURĖLIŲ;75976703580;Taip;5;0;0;5
11351;Užupiukas;VYTURĖLIŲ;3663596268;Taip;0;0;2;2
11352;Užupiukas;VYTURĖLIŲ;39079421361;Taip;0;1;0;1
11353;Užupiukas;VYTURĖLIŲ;12401560384;Taip;10;1;0;11
11354;Užupiukas;VYTURĖLIŲ;44770930654;Taip;0;9;0;9
11355;Užupiukas;VYTURĖLIŲ;7060019183;Taip;8;1;0;9
11356;Užupiukas;KAČIUKŲ;68898413144;Taip;0;1;0;1
11357;Užupiukas;KAČIUKŲ;68812682685;Taip;0;1;0;1
11358;Užupiukas;KAČIUKŲ;97966482763;Taip;0;1;0;1
11359;Užupiukas;KAČIUKŲ;9263601354;Taip;0;1;0;1
11360;Užupiukas;KAČIUKŲ;61560152825;Taip;6;0;1;7
11361;Užupiukas;KAČIUKŲ;19777635011;Taip;8;0;0;8
11362;Užupiukas;KAČIUKŲ;12905151141;Taip;0;7;1;8
11363;Užupiukas;KAČIUKŲ;86504628397;Taip;5;1;1;7
11364;Užupiukas;KAČIUKŲ;10715755079;Taip;0;1;2;3
11365;Užupiukas;KAČIUKŲ;78675007424;Taip;5;2;0;7
11366;Užupiukas;KAČIUKŲ;42027395287;Taip;2;1;0;3
11367;Užupiukas;KAČIUKŲ;74913928694;Taip;0;1;0;1
11368;Užupiukas;KAČIUKŲ;31618737243;Taip;4;6;0;10
11369;Užupiukas;KAČIUKŲ;42772205412;Taip;0;1;1;2
11370;Užupiukas;KAČIUKŲ;7659981079;Taip;0;0;2;2
11371;Užupiukas;KAČIUKŲ;22839159539;Taip;0;1;1;2
11372;Užupiukas;KAČIUKŲ;32651983670;Taip;9;4;0;13
11373;Užupiukas;KAČIUKŲ;27226172373;Taip;0;1;0;1
11374;Užupiukas;KAČIUKŲ;30335529070;Taip;0;0;1;1
11375;Užupiukas;KAČIUKŲ;1700750771;Taip;0;1;0;1
11376;Užupiukas;KAČIUKŲ;31668159620;Ne;0;1;2;3
11377;Užupiukas;DRUGELIŲ;5406866873;Taip;0;0;2;2
11378;Užupiukas;DRUGELIŲ;1772019951;Taip;2;0;0;2
11379;Užupiukas;DRUGELIŲ;9655636851;Taip;16;0;0;16
11380;Užupiukas;DRUGELIŲ;1662564735;Taip;0;7;5;12
11381;Užupiukas;DRUGELIŲ;9863097416;Taip;15;0;0;15
11382;Užupiukas;DRUGELIŲ;7298322865;Taip;21;0;0;21
11383;Užupiukas;DRUGELIŲ;7056737587;Taip;9;0;5;14
11384;Užupiukas;DRUGELIŲ;8734960045;Taip;6;6;0;12
11385;Užupiukas;DRUGELIŲ;8724566014;Taip;13;0;0;13
11386;Užupiukas;DRUGELIŲ;14139543365;Taip;0;0;1;1
11387;Užupiukas;DRUGELIŲ;1554333137;Taip;1;0;0;1
11388;Užupiukas;DRUGELIŲ;3298267311;Taip;1;2;0;3
11389;Užupiukas;DRUGELIŲ;8341598147;Taip;9;1;2;12
11390;Užupiukas;DRUGELIŲ;9782972949;Taip;4;1;0;5
11391;Užupiukas;DRUGELIŲ;3579499796;Taip;0;0;3;3
11392;Užupiukas;DRUGELIŲ;7140606152;Taip;3;0;2;5
11393;Užupiukas;DRUGELIŲ;2348243399;Taip;19;0;0;19
11394;Užupiukas;DRUGELIŲ;8870229834;Taip;0;1;1;2
11395;Užupiukas;DRUGELIŲ;1679324943;Taip;0;1;0;1
11396;Užupiukas;DRUGELIŲ;9617597828;Taip;4;0;0;4
11397;Užupiukas;DRUGELIŲ;9096157655;Ne;0;0;1;1
11398;Užupiukas;EŽIUKŲ;1159892685;Taip;0;1;0;1
11399;Užupiukas;EŽIUKŲ;79908666651;Taip;0;1;8;9
11400;Užupiukas;EŽIUKŲ;95981297986;Taip;0;0;21;21
11401;Užupiukas;EŽIUKŲ;27438104059;Taip;8;0;1;9
11402;Užupiukas;EŽIUKŲ;94857555708;Taip;15;1;1;17
11403;Užupiukas;EŽIUKŲ;12023740118;Taip;11;0;1;12
11404;Užupiukas;EŽIUKŲ;98209952363;Taip;0;5;0;5
11405;Užupiukas;EŽIUKŲ;6442996343;Taip;10;0;0;10
11406;Užupiukas;EŽIUKŲ;9843068906;Taip;0;0;7;7
11407;Užupiukas;EŽIUKŲ;17473949362;Taip;0;8;0;8
11408;Užupiukas;EŽIUKŲ;1593878778;Taip;20;1;0;21
11409;Užupiukas;EŽIUKŲ;1535952427;Taip;0;7;7;14
11410;Užupiukas;EŽIUKŲ;1102150432;Taip;0;0;10;10
11411;Užupiukas;EŽIUKŲ;3785893846;Taip;5;1;0;6
11412;Užupiukas;EŽIUKŲ;1338561168;Taip;0;0;1;1
11413;Užupiukas;EŽIUKŲ;1891595719;Taip;0;0;3;3
11414;Užupiukas;EŽIUKŲ;2419842168;Taip;0;1;15;16
11415;Užupiukas;EŽIUKŲ;7616817709;Taip;0;1;1;2
11416;Užupiukas;EŽIUKŲ;1850295450;Taip;0;0;7;7
11417;Užupiukas;EŽIUKŲ;2924954048;Taip;0;5;0;5
11418;Užupiukas;BORUŽĖLIŲ;6828175620;Taip;5;0;1;6
11419;Užupiukas;BORUŽĖLIŲ;9791681813;Taip;10;1;0;11
11420;Užupiukas;BORUŽĖLIŲ;1503714343;Taip;0;1;0;1
11421;Užupiukas;BORUŽĖLIŲ;8313812681;Taip;6;0;3;9
11422;Užupiukas;BORUŽĖLIŲ;9906475253;Taip;5;1;12;18
11423;Užupiukas;BORUŽĖLIŲ;9677572224;Taip;10;2;0;12
11424;Užupiukas;BORUŽĖLIŲ;2445335267;Taip;5;2;0;7
11425;Užupiukas;BORUŽĖLIŲ;1108744283;Taip;0;0;2;2
11426;Užupiukas;BORUŽĖLIŲ;38066177076;Taip;0;3;0;3
11427;Užupiukas;BORUŽĖLIŲ;1514268763;Taip;0;1;1;2
11428;Užupiukas;BORUŽĖLIŲ;1582921323;Taip;6;0;1;7
11429;Užupiukas;BORUŽĖLIŲ;6526550727;Taip;12;0;0;12
11430;Užupiukas;BORUŽĖLIŲ;9735462228;Taip;4;0;0;4
11431;Užupiukas;BORUŽĖLIŲ;7555702944;Taip;0;0;11;11
11432;Užupiukas;BORUŽĖLIŲ;2307600884;Taip;0;0;5;5
11433;Užupiukas;BORUŽĖLIŲ;6073039842;Taip;8;0;2;10
11434;Užupiukas;BORUŽĖLIŲ;3038973312;Taip;5;0;0;5
11435;Užupiukas;BORUŽĖLIŲ;7861121290;Taip;0;0;6;6
11436;Užupiukas;SPINDULIUKŲ;51983057814;Taip;0;0;5;5
11437;Užupiukas;SPINDULIUKŲ;86921401020;Taip;0;1;0;1
11438;Užupiukas;SPINDULIUKŲ;90438855641;Taip;0;6;7;13
11439;Užupiukas;SPINDULIUKŲ;65677644430;Taip;0;1;0;1
11440;Užupiukas;SPINDULIUKŲ;84336476482;Taip;0;1;2;3
11441;Užupiukas;SPINDULIUKŲ;80007333669;Taip;0;8;3;11
11442;Užupiukas;SPINDULIUKŲ;26339684743;Taip;4;1;3;8
11443;Užupiukas;SPINDULIUKŲ;9827529278;Taip;0;0;8;8
11444;Užupiukas;SPINDULIUKŲ;37017020021;Taip;0;1;0;1
11445;Užupiukas;SPINDULIUKŲ;87149966445;Taip;6;0;0;6
11446;Užupiukas;SPINDULIUKŲ;26118376709;Taip;0;0;3;3
11447;Užupiukas;SPINDULIUKŲ;30335969437;Taip;0;1;1;2
11448;Užupiukas;SPINDULIUKŲ;34512830427;Taip;4;1;0;5
11449;Užupiukas;SPINDULIUKŲ;39837224579;Taip;0;1;6;7
11450;Užupiukas;SPINDULIUKŲ;33716467388;Taip;8;1;1;10
11451;Užupiukas;SPINDULIUKŲ;4322004071;Taip;0;1;2;3
11452;Užupiukas;SPINDULIUKŲ;59095867565;Taip;19;0;0;19
11453;Užupiukas;SPINDULIUKŲ;54802123672;Taip;5;1;6;12
11454;Užupiukas;SPINDULIUKŲ;3087557445;Taip;11;0;1;12
11455;Užupiukas;ŽVIRBLIUKŲ;66976483535;Taip;0;0;4;4
11456;Užupiukas;ŽVIRBLIUKŲ;74109296784;Taip;0;1;3;4
11457;Užupiukas;ŽVIRBLIUKŲ;30079394090;Taip;5;0;0;5
11458;Užupiukas;ŽVIRBLIUKŲ;41589248540;Taip;2;0;0;2
11459;Užupiukas;ŽVIRBLIUKŲ;6945412270;Taip;0;14;0;14
11460;Užupiukas;ŽVIRBLIUKŲ;29120240155;Taip;0;0;2;2
11461;Užupiukas;ŽVIRBLIUKŲ;77360572295;Taip;12;0;0;12
11462;Užupiukas;ŽVIRBLIUKŲ;12930564771;Taip;9;1;2;12
11463;Užupiukas;ŽVIRBLIUKŲ;39154080649;Taip;0;3;8;11
11464;Užupiukas;ŽVIRBLIUKŲ;66563646874;Taip;3;1;1;5
11465;Užupiukas;ŽVIRBLIUKŲ;53620240721;Taip;0;8;0;8
11466;Užupiukas;ŽVIRBLIUKŲ;54388164264;Taip;0;0;2;2
11467;Užupiukas;ŽVIRBLIUKŲ;77859943014;Taip;0;1;1;2
11468;Užupiukas;ŽVIRBLIUKŲ;78093835821;Taip;0;1;0;1
11469;Užupiukas;ŽVIRBLIUKŲ;9621834194;Taip;0;0;2;2
11470;Užupiukas;ŽVIRBLIUKŲ;2261114370;Taip;0;1;1;2
11471;Užupiukas;ŽVIRBLIUKŲ;55851979501;Taip;21;0;0;21
11472;Užupiukas;ŽVIRBLIUKŲ;50633300666;Taip;21;0;0;21
11473;Užupiukas;ŽVIRBLIUKŲ;80569399641;Taip;4;0;0;4
11474;Užupiukas;ŽVIRBLIUKŲ;1961593235;Taip;0;1;1;2
11475;Užupiukas;ŽVIRBLIUKŲ;65914465707;Taip;7;1;0;8
11476;Užupiukas;ŽVIRBLIUKŲ;11261333632;Taip;0;0;9;9
11477;Užupiukas;ŽVIRBLIUKŲ;4310051789;Taip;4;1;7;12
11478;Užupiukas;PELĖDŽIUKŲ;94936980824;Taip;5;0;0;5
11479;Užupiukas;PELĖDŽIUKŲ;51703520898;Taip;0;1;0;1
11480;Užupiukas;PELĖDŽIUKŲ;4147741857;Taip;8;1;0;9
11481;Užupiukas;PELĖDŽIUKŲ;40697997174;Taip;0;1;1;2
11482;Užupiukas;PELĖDŽIUKŲ;6447998472;Taip;10;1;0;11
11483;Užupiukas;PELĖDŽIUKŲ;79539936850;Taip;0;0;9;9
11484;Užupiukas;PELĖDŽIUKŲ;91266096205;Taip;0;1;1;2
11485;Užupiukas;PELĖDŽIUKŲ;29433022056;Taip;0;1;3;4
11486;Užupiukas;PELĖDŽIUKŲ;61722030522;Taip;3;0;1;4
11487;Užupiukas;PELĖDŽIUKŲ;25194791061;Taip;2;1;0;3
11488;Užupiukas;PELĖDŽIUKŲ;55760273994;Taip;0;1;1;2
11489;Užupiukas;PELĖDŽIUKŲ;91904601102;Taip;2;0;1;3
11490;Užupiukas;PELĖDŽIUKŲ;91632804337;Taip;0;1;3;4
11491;Užupiukas;PELĖDŽIUKŲ;24344329528;Taip;0;0;1;1
11492;Užupiukas;PELĖDŽIUKŲ;97373228204;Taip;4;1;7;12
11493;Užupiukas;PELĖDŽIUKŲ;43231263535;Taip;5;1;2;8
11494;Užupiukas;PELĖDŽIUKŲ;38236870957;Taip;0;1;3;4
11495;Užupiukas;PELĖDŽIUKŲ;70640896909;Taip;4;1;1;6
11496;Užupiukas;PELĖDŽIUKŲ;47039147715;Taip;0;0;2;2
11497;Užupiukas;PELĖDŽIUKŲ;41047619045;Taip;0;0;3;3
11498;Užupiukas;PELĖDŽIUKŲ;8865442531;Taip;4;0;1;5
11499;Užupiukas;PELĖDŽIUKŲ;22644512133;Taip;6;0;0;6
11500;Užupiukas;VARPELIŲ;6790700398;Taip;0;15;0;15
11501;Užupiukas;VARPELIŲ;23723147269;Taip;0;6;0;6
11502;Užupiukas;VARPELIŲ;7874627355;Taip;0;0;1;1
11503;Užupiukas;VARPELIŲ;17651645880;Taip;0;1;0;1
11504;Užupiukas;VARPELIŲ;50797530294;Taip;0;0;3;3
11505;Užupiukas;VARPELIŲ;57439594934;Taip;0;0;2;2
11506;Užupiukas;VARPELIŲ;2137620968;Taip;0;0;3;3
11507;Užupiukas;VARPELIŲ;1103878937;Taip;6;0;0;6
11508;Užupiukas;VARPELIŲ;5079596604;Taip;0;0;5;5
11509;Užupiukas;VARPELIŲ;2031306814;Taip;16;1;0;17
11510;Užupiukas;VARPELIŲ;82632886488;Taip;9;0;0;9
11511;Užupiukas;VARPELIŲ;77950386276;Taip;0;0;5;5
11512;Užupiukas;VARPELIŲ;8358242714;Taip;4;1;1;6
11513;Užupiukas;SAULUČIŲ;55683021710;Taip;0;0;2;2
11514;Užupiukas;SAULUČIŲ;64774033504;Taip;4;0;1;5
11515;Užupiukas;SAULUČIŲ;1656658765;Taip;0;16;1;17
11516;Užupiukas;SAULUČIŲ;52047323776;Taip;16;0;2;18
11517;Užupiukas;SAULUČIŲ;25118968273;Taip;0;0;6;6
11518;Užupiukas;SAULUČIŲ;1307564992;Taip;0;0;13;13
11519;Užupiukas;SAULUČIŲ;2740412091;Taip;3;0;2;5
11520;Užupiukas;SAULUČIŲ;1577630991;Taip;11;4;5;20
11521;Užupiukas;SAULUČIŲ;1158250810;Taip;0;11;0;11
11522;Užupiukas;SAULUČIŲ;48886679788;Taip;8;1;1;10
11523;Užupiukas;SAULUČIŲ;53272114855;Taip;0;2;0;2
11524;Užupiukas;SAULUČIŲ;52600923918;Taip;0;1;0;1
11525;Užupiukas;SAULUČIŲ;10522364665;Taip;0;1;0;1
11526;Užupiukas;SAULUČIŲ;87017671664;Taip;5;1;3;9
11527;Užupiukas;SAULUČIŲ;15815468617;Taip;0;0;2;2
11528;Užupiukas;SAULUČIŲ;73039119839;Taip;0;4;5;9
11529;Užupiukas;SAULUČIŲ;1592276956;Taip;11;1;1;13
11530;Užupiukas;SAULUČIŲ;6467238027;Taip;0;0;3;3
11531;Užupiukas;SAULUČIŲ;2499414724;Taip;12;5;0;17
11532;Užupiukas;LAPIUKŲ;3309195572;Taip;16;1;0;17
11533;Užupiukas;LAPIUKŲ;7563497568;Taip;0;0;1;1
11534;Užupiukas;LAPIUKŲ;2821350355;Taip;10;0;5;15
11535;Užupiukas;LAPIUKŲ;5665323444;Taip;9;0;1;10
11536;Užupiukas;LAPIUKŲ;22401995674;Taip;8;0;0;8
11537;Užupiukas;LAPIUKŲ;3774364829;Taip;18;0;0;18
11538;Užupiukas;LAPIUKŲ;6236652118;Taip;0;1;2;3
11539;Užupiukas;LAPIUKŲ;4247280316;Taip;0;0;3;3
11540;Užupiukas;LAPIUKŲ;2938276316;Taip;0;0;6;6
11541;Užupiukas;LAPIUKŲ;6478702476;Taip;0;2;1;3
11542;Užupiukas;LAPIUKŲ;4132760111;Taip;1;0;0;1
11543;Užupiukas;LAPIUKŲ;53412835151;Taip;4;0;1;5
11544;Užupiukas;LAPIUKŲ;9197242545;Taip;0;0;4;4
11545;Užupiukas;LAPIUKŲ;3205769002;Taip;10;0;0;10
11546;Užupiukas;LAPIUKŲ;5498369850;Taip;13;0;3;16
11547;Užupiukas;LAPIUKŲ;4608233152;Taip;10;0;1;11
11548;Užupiukas;LAPIUKŲ;6110869303;Taip;7;0;0;7
11549;Užupiukas;LAPIUKŲ;1739403100;Taip;0;0;15;15
11550;Užupiukas;LAPIUKŲ;3231001225;Taip;0;0;2;2
11551;Užupiukas;NYKŠTUKŲ;3905448176;Taip;4;0;0;4
11552;Užupiukas;NYKŠTUKŲ;4710910251;Taip;0;0;3;3
11553;Užupiukas;NYKŠTUKŲ;9991552624;Taip;0;1;2;3
11554;Užupiukas;NYKŠTUKŲ;3048959458;Taip;5;0;1;6
11555;Užupiukas;NYKŠTUKŲ;3080668107;Taip;0;1;0;1
11556;Užupiukas;NYKŠTUKŲ;1651249962;Taip;5;0;0;5
11557;Užupiukas;NYKŠTUKŲ;2390955083;Taip;16;0;0;16
11558;Užupiukas;NYKŠTUKŲ;1809036046;Taip;0;4;4;8
11559;Užupiukas;NYKŠTUKŲ;1100574872;Taip;11;2;0;13
11560;Užupiukas;NYKŠTUKŲ;3861173268;Taip;3;0;3;6
11561;Užupiukas;NYKŠTUKŲ;5072363435;Taip;13;0;0;13
11562;Užupiukas;NYKŠTUKŲ;9446562736;Taip;13;0;0;13
11563;Užupiukas;NYKŠTUKŲ;5116564840;Taip;9;0;0;9
11564;Užupiukas;NYKŠTUKŲ;6119222293;Ne;12;3;0;15
11565;Užupiukas;NYKŠTUKŲ;2724216446;Taip;16;0;0;16
11566;Užupiukas;NYKŠTUKŲ;1684901495;Taip;14;1;0;15
11567;Vaidilutė;Žiogelis;83446186815;Taip;1;0;1;2
11568;Vaidilutė;Žiogelis;76782239392;Taip;0;0;1;1
11569;Vaidilutė;Žiogelis;51568574636;Taip;0;1;0;1
11570;Vaidilutė;Žiogelis;45619465634;Taip;0;1;1;2
11571;Vaidilutė;Žiogelis;1587658785;Taip;0;0;2;2
11572;Vaidilutė;Žiogelis;72508198771;Taip;0;2;0;2
11573;Vaidilutė;Žiogelis;36995673806;Taip;5;1;1;7
11574;Vaidilutė;Žiogelis;26144399724;Taip;2;0;1;3
11575;Vaidilutė;Žiogelis;25736859991;Taip;0;0;1;1
11576;Vaidilutė;Žiogelis;11736298044;Taip;0;1;0;1
11577;Vaidilutė;Žiogelis;9616432332;Taip;0;0;1;1
11578;Vaidilutė;Žiogelis;65596730863;Taip;0;1;0;1
11579;Vaidilutė;Žiogelis;69907222472;Taip;0;1;0;1
11580;Vaidilutė;Žiogelis;63465904558;Taip;0;0;2;2
11581;Vaidilutė;Žiogelis;98760023673;Taip;0;0;2;2
11582;Vaidilutė;Rūtelė;12982620392;Taip;4;1;0;5
11583;Vaidilutė;Rūtelė;34945009241;Taip;5;0;1;6
11584;Vaidilutė;Rūtelė;95291858283;Taip;0;2;0;2
11585;Vaidilutė;Rūtelė;2176694565;Taip;0;2;0;2
11586;Vaidilutė;Rūtelė;15308595647;Taip;0;4;0;4
11587;Vaidilutė;Rūtelė;36162605033;Taip;8;1;0;9
11588;Vaidilutė;Rūtelė;41202484982;Taip;0;5;3;8
11589;Vaidilutė;Rūtelė;1347860031;Taip;7;0;0;7
11590;Vaidilutė;Rūtelė;70281031575;Taip;0;3;0;3
11591;Vaidilutė;Rūtelė;92269487538;Taip;10;0;2;12
11592;Vaidilutė;Rūtelė;57981568010;Taip;8;0;0;8
11593;Vaidilutė;Rūtelė;29245907351;Taip;7;5;0;12
11594;Vaidilutė;Rūtelė;13343473227;Taip;10;1;0;11
11595;Vaidilutė;Rūtelė;99220518506;Taip;0;1;2;3
11596;Vaidilutė;Rūtelė;8611047350;Taip;5;1;2;8
11597;Vaidilutė;Rūtelė;38331934468;Taip;2;3;0;5
11598;Vaidilutė;Rūtelė;5785964650;Taip;0;4;0;4
11599;Vaidilutė;Voveraitė;1993403692;Taip;0;6;1;7
11600;Vaidilutė;Voveraitė;9948685221;Taip;11;0;0;11
11601;Vaidilutė;Voveraitė;9869134464;Taip;7;0;1;8
11602;Vaidilutė;Voveraitė;29153363263;Taip;11;0;0;11
11603;Vaidilutė;Voveraitė;3069613102;Taip;5;0;0;5
11604;Vaidilutė;Voveraitė;5177060346;Taip;0;0;2;2
11605;Vaidilutė;Voveraitė;19402768340;Taip;0;5;0;5
11606;Vaidilutė;Voveraitė;4671287016;Taip;19;0;0;19
11607;Vaidilutė;Voveraitė;3600181974;Taip;2;0;0;2
11608;Vaidilutė;Voveraitė;1363913645;Taip;0;6;0;6
11609;Vaidilutė;Voveraitė;5252637701;Taip;5;0;0;5
11610;Vaidilutė;Voveraitė;1320999237;Taip;10;0;0;10
11611;Vaidilutė;Voveraitė;9124975928;Taip;0;3;0;3
11612;Vaidilutė;Voveraitė;3202508790;Taip;12;0;3;15
11613;Vaidilutė;Saulutė;20442760894;Taip;0;1;5;6
11614;Vaidilutė;Saulutė;72152961395;Taip;0;1;5;6
11615;Vaidilutė;Saulutė;21608644880;Taip;0;1;0;1
11616;Vaidilutė;Saulutė;66561742513;Taip;0;1;5;6
11617;Vaidilutė;Saulutė;73529326579;Taip;0;0;5;5
11618;Vaidilutė;Saulutė;70212515559;Ne;2;0;0;2
11619;Vaidilutė;Saulutė;70452446276;Ne;0;4;2;6
11620;Vaidilutė;Saulutė;13456910631;Taip;0;0;1;1
11621;Vaidilutė;Saulutė;91922432702;Taip;0;1;0;1
11622;Vaidilutė;Saulutė;26069775295;Taip;5;1;5;11
11623;Vaidilutė;Saulutė;1928414100;Taip;0;0;2;2
11624;Vaidilutė;Saulutė;1477466080;Taip;0;1;8;9
11625;Vaidilutė;Saulutė;4593200817;Taip;0;0;2;2
11626;Vaidilutė;Saulutė;9994830892;Taip;0;2;3;5
11627;Vaidilutė;Žibutė;5686463470;Taip;0;1;2;3
11628;Vaidilutė;Žibutė;1430802591;Taip;0;1;1;2
11629;Vaidilutė;Žibutė;7843388119;Taip;0;4;0;4
11630;Vaidilutė;Žibutė;2041126370;Taip;1;1;1;3
11631;Vaidilutė;Žibutė;16491592864;Taip;0;1;0;1
11632;Vaidilutė;Žibutė;45949026707;Taip;13;0;0;13
11633;Vaidilutė;Žibutė;4259585225;Taip;4;0;0;4
11634;Vaidilutė;Žibutė;4334934114;Taip;3;1;2;6
11635;Vaidilutė;Žibutė;9669118189;Taip;21;0;0;21
11636;Vaidilutė;Žibutė;5203062837;Taip;2;1;0;3
11637;Vaidilutė;Žibutė;1266927367;Taip;0;1;0;1
11638;Vaidilutė;Žibutė;2941550026;Taip;0;2;1;3
11639;Vaidilutė;Žibutė;1871542885;Taip;5;0;1;6
11640;Vaidilutė;Žibutė;1853463568;Taip;5;0;0;5
11641;Vaidilutė;Žibutė;9556632708;Taip;0;4;0;4
11642;Vaidilutė;"Ąžuoliukas ";2037322108;Taip;0;0;1;1
11643;Vaidilutė;"Ąžuoliukas ";1179339231;Taip;0;0;1;1
11644;Vaidilutė;"Ąžuoliukas ";53984070163;Taip;0;21;0;21
11645;Vaidilutė;"Ąžuoliukas ";27368743235;Taip;4;1;1;6
11646;Vaidilutė;"Ąžuoliukas ";14996785673;Taip;0;0;4;4
11647;Vaidilutė;"Ąžuoliukas ";78917497586;Taip;0;8;0;8
11648;Vaidilutė;"Ąžuoliukas ";31536755228;Ne;0;2;0;2
11649;Vaidilutė;"Ąžuoliukas ";47216762092;Taip;0;5;0;5
11650;Vaidilutė;"Ąžuoliukas ";84643800952;Taip;0;0;1;1
11651;Vaidilutė;"Ąžuoliukas ";20252774403;Taip;0;1;4;5
11652;Vaidilutė;"Ąžuoliukas ";34289554601;Taip;3;0;0;3
11653;Vaidilutė;"Ąžuoliukas ";93447858384;Taip;3;0;0;3
11654;Vaidilutė;"Ąžuoliukas ";3358680107;Taip;0;0;4;4
11655;Vaidilutė;"Ąžuoliukas ";6742144586;Taip;0;1;0;1
11656;Vaidilutė;"Ąžuoliukas ";7593066460;Ne;0;0;1;1
11657;Vaidilutė;"Žemuogėlė ";57518887320;Taip;0;0;5;5
11658;Vaidilutė;"Žemuogėlė ";56696406197;Taip;0;1;5;6
11659;Vaidilutė;"Žemuogėlė ";1982165935;Taip;0;0;8;8
11660;Vaidilutė;"Žemuogėlė ";77677139178;Taip;0;4;0;4
11661;Vaidilutė;"Žemuogėlė ";59140652359;Ne;0;0;4;4
11662;Vaidilutė;"Žemuogėlė ";95465325875;Taip;7;0;0;7
11663;Vaidilutė;"Žemuogėlė ";68611593221;Taip;6;0;2;8
11664;Vaidilutė;"Žemuogėlė ";41921356356;Taip;6;0;0;6
11665;Vaidilutė;"Žemuogėlė ";2372340492;Taip;6;0;0;6
11666;Vaidilutė;"Žemuogėlė ";5267566919;Taip;2;0;0;2
11667;Vaidilutė;"Žemuogėlė ";2089569687;Taip;8;0;3;11
11668;Vaidilutė;"Žemuogėlė ";2040610033;Taip;14;0;0;14
11669;Vaidilutė;"Vyturėlis ";5821467408;Taip;5;0;0;5
11670;Vaidilutė;"Vyturėlis ";24445906930;Taip;5;0;1;6
11671;Vaidilutė;"Vyturėlis ";83944413409;Taip;0;1;0;1
11672;Vaidilutė;"Vyturėlis ";5116482125;Taip;0;1;2;3
11673;Vaidilutė;"Vyturėlis ";25654419755;Taip;9;0;2;11
11674;Vaidilutė;"Vyturėlis ";2099647381;Taip;5;1;0;6
11675;Vaidilutė;"Vyturėlis ";34492341585;Taip;0;2;0;2
11676;Vaidilutė;"Vyturėlis ";27107732357;Taip;0;4;1;5
11677;Vaidilutė;"Vyturėlis ";79964507480;Taip;2;0;0;2
11678;Vaidilutė;"Vyturėlis ";10737417556;Taip;1;0;0;1
11679;Vaidilutė;"Vyturėlis ";1416870651;Taip;0;1;0;1
11680;Vaidilutė;"Vyturėlis ";3220471656;Taip;0;1;0;1
11681;Vaidilutė;"Vyturėlis ";1315347184;Taip;0;1;0;1
11682;Vaidilutė;"Vyturėlis ";1692795486;Taip;0;11;0;11
11683;Vaidilutė;"Varpelis ";1470597477;Taip;0;0;3;3
11684;Vaidilutė;"Varpelis ";1047235238;Taip;0;0;1;1
11685;Vaidilutė;"Varpelis ";2033196214;Taip;5;1;0;6
11686;Vaidilutė;"Varpelis ";26241930203;Taip;0;0;1;1
11687;Vaidilutė;"Varpelis ";37901356592;Taip;0;0;1;1
11688;Vaidilutė;"Varpelis ";1564429390;Taip;0;0;1;1
11689;Vaidilutė;"Varpelis ";42328411019;Taip;4;4;0;8
11690;Vaidilutė;"Varpelis ";96794583279;Taip;0;0;2;2
11691;Vaidilutė;"Varpelis ";1974967085;Taip;1;0;2;3
11692;Vaidilutė;"Varpelis ";6758078068;Taip;0;1;0;1
11693;Vaidilutė;"Varpelis ";48928174623;Taip;0;1;4;5
11694;Vaidilutė;"Varpelis ";1556646493;Taip;0;0;2;2
11695;Vaidilutė;"Varpelis ";82558684054;Taip;2;0;1;3
11696;Vaidilutė;"Varpelis ";25071409492;Taip;8;0;2;10
11697;Vaidilutė;"Varpelis ";55183164909;Taip;0;0;1;1
11698;Vaidilutė;"Boružėlių ";7319037375;Taip;0;2;0;2
11699;Vaidilutė;"Boružėlių ";4838951446;Taip;6;0;0;6
11700;Vaidilutė;"Boružėlių ";7494818866;Taip;3;0;0;3
11701;Vaidilutė;"Boružėlių ";5500950179;Taip;15;0;0;15
11702;Vaidilutė;"Boružėlių ";4954285515;Taip;0;21;0;21
11703;Vaidilutė;"Boružėlių ";1516903980;Taip;17;1;0;18
11704;Vaidilutė;"Boružėlių ";1140011879;Taip;7;0;0;7
11705;Vaidilutė;"Boružėlių ";9563257771;Taip;6;0;0;6
11706;Vaidilutė;"Boružėlių ";2024078532;Taip;13;0;0;13
11707;Vaidilutė;"Boružėlių ";8505156287;Taip;9;0;0;9
11708;Vaidilutė;"Boružėlių ";9652684068;Taip;5;0;0;5
11709;Vaidilutė;"Boružėlių ";6630603158;Taip;4;0;0;4
11710;Vaidilutė;"Malūnelis ";2763266518;Taip;0;1;0;1
11711;Vaidilutė;"Malūnelis ";6250831269;Taip;3;0;0;3
11712;Vaidilutė;"Malūnelis ";4430382895;Taip;5;0;3;8
11713;Vaidilutė;"Malūnelis ";4159072583;Taip;0;0;2;2
11714;Vaidilutė;"Malūnelis ";9689388330;Taip;0;0;3;3
11715;Vaidilutė;"Malūnelis ";6701103931;Taip;16;5;0;21
11716;Vaidilutė;"Malūnelis ";2081959307;Taip;8;0;2;10
11717;Vaidilutė;"Malūnelis ";8882402632;Taip;8;0;2;10
11718;Vaidilutė;"Malūnelis ";2058071219;Taip;5;0;2;7
11719;Vaidilutė;"Malūnelis ";6037349527;Taip;5;0;1;6
11720;Vaidilutė;"Malūnelis ";3832349858;Taip;0;0;1;1
11721;Vaidilutė;"Malūnelis ";9317774960;Taip;1;1;0;2
11722;Vaidilutė;"Malūnelis ";5448014291;Taip;0;7;0;7
11723;Vaidilutė;"Malūnelis ";4280822951;Taip;0;0;5;5
11724;Vaidilutė;"Malūnelis ";5867501558;Taip;4;0;0;4
11725;Vaidilutė;"Riešutėlis ";87621682081;Taip;6;7;0;13
11726;Vaidilutė;"Riešutėlis ";76613866916;Taip;3;1;1;5
11727;Vaidilutė;"Riešutėlis ";1942402815;Taip;7;0;0;7
11728;Vaidilutė;"Riešutėlis ";13133501690;Taip;0;0;4;4
11729;Vaidilutė;"Riešutėlis ";8543285470;Taip;16;0;1;17
11730;Vaidilutė;"Riešutėlis ";3962268551;Taip;0;0;5;5
11731;Vaidilutė;"Riešutėlis ";19413698194;Taip;6;0;0;6
11732;Vaidilutė;"Riešutėlis ";83887347923;Taip;1;0;0;1
11733;Vaidilutė;"Riešutėlis ";69452750985;Taip;0;1;2;3
11734;Vaidilutė;"Riešutėlis ";44867291232;Taip;0;0;1;1
11735;Vaidilutė;"Riešutėlis ";17497609539;Taip;1;6;0;7
11736;Vaidilutė;"Riešutėlis ";38698526742;Taip;0;0;4;4
11737;Vaidilutė;"Riešutėlis ";1608286003;Taip;0;0;4;4
11738;Vaidilutė;"Riešutėlis ";1083096707;Taip;3;0;1;4
11739;Vaidilutė;"Riešutėlis ";2397776116;Taip;3;0;14;17
11740;Vaidilutė;"Riešutėlis ";67830476121;Taip;12;0;0;12
11741;Vaidilutė;"Riešutėlis ";3243266869;Taip;2;0;2;4
11742;Vandenis;ŽUVĖDRŲ;83799061370;Taip;0;4;0;4
11743;Vandenis;ŽUVĖDRŲ;72923438583;Taip;0;1;0;1
11744;Vandenis;ŽUVĖDRŲ;49204161380;Taip;0;4;0;4
11745;Vandenis;ŽUVĖDRŲ;67472126318;Taip;0;3;0;3
11746;Vandenis;ŽUVĖDRŲ;32749176064;Taip;0;7;0;7
11747;Vandenis;ŽUVĖDRŲ;80186166441;Taip;0;2;1;3
11748;Vandenis;ŽUVĖDRŲ;4045401354;Taip;0;0;1;1
11749;Vandenis;ŽUVĖDRŲ;85287618619;Taip;0;18;0;18
11750;Vandenis;ŽUVĖDRŲ;3639803910;Taip;0;1;0;1
11751;Vandenis;ŽUVĖDRŲ;35581230147;Taip;0;1;0;1
11752;Vandenis;ŽUVĖDRŲ;22764351701;Taip;0;4;0;4
11753;Vandenis;ŽUVĖDRŲ;92857304500;Taip;5;2;0;7
11754;Vandenis;ŽUVĖDRŲ;55952119623;Taip;0;3;0;3
11755;Vandenis;ŽUVĖDRŲ;56648967396;Taip;0;7;1;8
11756;Vandenis;ŽUVĖDRŲ;48908599635;Taip;0;3;0;3
11757;Vandenis;RUONIUKŲ;2422642232;Taip;12;0;1;13
11758;Vandenis;RUONIUKŲ;1051281257;Taip;12;0;1;13
11759;Vandenis;RUONIUKŲ;7565308536;Taip;14;1;0;15
11760;Vandenis;RUONIUKŲ;9518434896;Taip;14;1;0;15
11761;Vandenis;RUONIUKŲ;2638433939;Taip;12;0;1;13
11762;Vandenis;RUONIUKŲ;1563710105;Taip;8;0;1;9
11763;Vandenis;RUONIUKŲ;7702272913;Taip;9;0;0;9
11764;Vandenis;RUONIUKŲ;6476051751;Taip;5;1;0;6
11765;Vandenis;RUONIUKŲ;9162936403;Taip;0;0;5;5
11766;Vandenis;RUONIUKŲ;6986724058;Taip;0;8;0;8
11767;Vandenis;RUONIUKŲ;7754158588;Taip;8;0;1;9
11768;Vandenis;RUONIUKŲ;9731729915;Taip;10;0;0;10
11769;Vandenis;RUONIUKŲ;9527253920;Taip;12;0;0;12
11770;Vandenis;RUONIUKŲ;8971291182;Taip;7;0;1;8
11771;Vandenis;ŽUVYČIŲ;1381872682;Taip;0;4;5;9
11772;Vandenis;ŽUVYČIŲ;46710726661;Taip;0;1;0;1
11773;Vandenis;ŽUVYČIŲ;36923046515;Taip;0;2;0;2
11774;Vandenis;ŽUVYČIŲ;73799053361;Taip;0;1;0;1
11775;Vandenis;ŽUVYČIŲ;62551219837;Taip;0;1;0;1
11776;Vandenis;ŽUVYČIŲ;18019716512;Taip;6;3;1;10
11777;Vandenis;ŽUVYČIŲ;8894986967;Taip;0;1;0;1
11778;Vandenis;ŽUVYČIŲ;11100629204;Taip;0;2;1;3
11779;Vandenis;ŽUVYČIŲ;50378723799;Taip;0;3;1;4
11780;Vandenis;ŽUVYČIŲ;50682359453;Taip;0;2;0;2
11781;Vandenis;ŽUVYČIŲ;25215508382;Taip;8;2;0;10
11782;Vandenis;ŽUVYČIŲ;50355487806;Taip;0;1;0;1
11783;Vandenis;ŽUVYČIŲ;32076192238;Taip;0;1;0;1
11784;Vandenis;ŽUVYČIŲ;42672846405;Taip;0;2;1;3
11785;Vandenis;ŽUVYČIŲ;48268115297;Taip;8;0;0;8
11786;Vandenis;ŽUVYČIŲ;888708348;Taip;0;1;0;1
11787;Vandenis;ŽUVYČIŲ;57050923237;Taip;0;6;0;6
11788;Vandenis;ŽUVYČIŲ;32078254928;Taip;0;5;0;5
11789;Vandenis;PERLIUKŲ;28286348996;Taip;4;2;0;6
11790;Vandenis;PERLIUKŲ;2494327284;Taip;6;0;2;8
11791;Vandenis;PERLIUKŲ;20458211098;Taip;5;3;0;8
11792;Vandenis;PERLIUKŲ;47333381244;Taip;10;1;0;11
11793;Vandenis;PERLIUKŲ;95498596116;Taip;15;1;0;16
11794;Vandenis;PERLIUKŲ;39662768043;Taip;0;9;1;10
11795;Vandenis;PERLIUKŲ;391453841;Taip;13;0;0;13
11796;Vandenis;PERLIUKŲ;32087433270;Taip;6;2;0;8
11797;Vandenis;PERLIUKŲ;50009330411;Taip;6;0;0;6
11798;Vandenis;PERLIUKŲ;18310147466;Taip;6;0;0;6
11799;Vandenis;PERLIUKŲ;318399174;Taip;0;4;0;4
11800;Vandenis;PERLIUKŲ;57251416305;Taip;11;1;0;12
11801;Vandenis;PERLIUKŲ;54659569326;Taip;10;0;0;10
11802;Vandenis;PERLIUKŲ;69485657846;Taip;0;2;0;2
11803;Vandenis;PERLIUKŲ;54762939917;Taip;10;0;0;10
11804;Vandenis;PERLIUKŲ;33177236893;Taip;8;1;0;9
11805;Vandenis;PERLIUKŲ;23752943243;Taip;6;0;0;6
11806;Vandenis;PERLIUKŲ;35977990277;Ne;7;1;0;8
11807;Vandenis;PERLIUKŲ;66499269949;Taip;10;0;0;10
11808;Vandenis;PERLIUKŲ;59487083886;Taip;0;1;0;1
11809;Vandenis;PERLIUKŲ;51472939588;Taip;7;2;1;10
11810;Vandenis;PERLIUKŲ;83480564066;Taip;3;1;0;4
11811;Vandenis;PERLIUKŲ;1493719754;Taip;12;2;0;14
11812;Vandenis;ANČIUKŲ;8233407105;Taip;0;2;4;6
11813;Vandenis;ANČIUKŲ;1282499654;Taip;0;9;1;10
11814;Vandenis;ANČIUKŲ;3578947540;Taip;0;1;0;1
11815;Vandenis;ANČIUKŲ;3243079651;Taip;15;0;0;15
11816;Vandenis;ANČIUKŲ;3938359901;Taip;0;8;0;8
11817;Vandenis;ANČIUKŲ;1314724267;Taip;11;0;0;11
11818;Vandenis;ANČIUKŲ;8251169901;Ne;15;1;0;16
11819;Vandenis;ANČIUKŲ;4750141780;Taip;0;9;0;9
11820;Vandenis;ANČIUKŲ;6181866272;Taip;0;8;0;8
11821;Vandenis;ANČIUKŲ;7522472652;Taip;0;1;0;1
11822;Vandenis;ANČIUKŲ;7630017843;Taip;6;0;0;6
11823;Vandenis;ANČIUKŲ;3067868099;Taip;5;0;0;5
11824;Vandenis;ANČIUKŲ;8511948282;Taip;17;1;0;18
11825;Vandenis;ANČIUKŲ;1739780612;Taip;10;1;1;12
11826;Vandenis;ANČIUKŲ;2489776665;Taip;10;0;8;18
11827;Vandenis;ANČIUKŲ;71786730314;Taip;0;2;0;2
11828;Vandenis;ANČIUKŲ;1621481561;Taip;10;0;1;11
11829;Vandenis;ANČIUKŲ;33782837791;Taip;0;4;0;4
11830;Vandenis;VĖŽLIUKŲ;39832993343;Taip;0;1;0;1
11831;Vandenis;VĖŽLIUKŲ;2120420294;Taip;0;0;3;3
11832;Vandenis;VĖŽLIUKŲ;88097898349;Taip;4;0;0;4
11833;Vandenis;VĖŽLIUKŲ;16402149104;Taip;0;9;0;9
11834;Vandenis;VĖŽLIUKŲ;17644420312;Taip;0;1;0;1
11835;Vandenis;VĖŽLIUKŲ;55331810310;Taip;0;1;1;2
11836;Vandenis;VĖŽLIUKŲ;48194812760;Taip;10;1;0;11
11837;Vandenis;VĖŽLIUKŲ;5363853315;Taip;0;5;0;5
11838;Vandenis;VĖŽLIUKŲ;85054617489;Taip;5;9;0;14
11839;Vandenis;VĖŽLIUKŲ;87310831307;Taip;0;5;0;5
11840;Vandenis;VĖŽLIUKŲ;63629799884;Taip;1;0;0;1
11841;Vandenis;VĖŽLIUKŲ;8447593747;Taip;2;1;0;3
11842;Vandenis;VĖŽLIUKŲ;1646554203;Taip;0;7;8;15
11843;Vandenis;VĖŽLIUKŲ;2056980868;Taip;2;0;1;3
11844;Vandenis;VĖŽLIUKŲ;92286914041;Taip;0;3;1;4
11845;Vandenis;AŠTUNKOJŲ;56729656278;Taip;0;1;0;1
11846;Vandenis;AŠTUNKOJŲ;39139875955;Taip;9;0;0;9
11847;Vandenis;AŠTUNKOJŲ;57302718152;Taip;6;1;0;7
11848;Vandenis;AŠTUNKOJŲ;6799539977;Taip;0;4;0;4
11849;Vandenis;AŠTUNKOJŲ;69980435432;Taip;0;2;0;2
11850;Vandenis;AŠTUNKOJŲ;83350314727;Taip;0;1;0;1
11851;Vandenis;AŠTUNKOJŲ;91232893198;Ne;0;2;0;2
11852;Vandenis;AŠTUNKOJŲ;56253560020;Taip;0;2;0;2
11853;Vandenis;AŠTUNKOJŲ;2576662589;Taip;0;4;0;4
11854;Vandenis;AŠTUNKOJŲ;40001674016;Ne;0;4;0;4
11855;Vandenis;AŠTUNKOJŲ;42776106653;Taip;11;0;0;11
11856;Vandenis;AŠTUNKOJŲ;93109763820;Taip;0;2;0;2
11857;Vandenis;AŠTUNKOJŲ;10706508637;Taip;0;1;0;1
11858;Vandenis;AŠTUNKOJŲ;42690205977;Taip;0;9;0;9
11859;Vandenis;AŠTUNKOJŲ;37019206511;Taip;0;7;0;7
11860;Vandenis;AŠTUNKOJŲ;68749162348;Taip;0;1;0;1
11861;Vandenis;AŠTUNKOJŲ;11953155563;Taip;0;1;0;1
11862;Vandenis;GANDRIUKŲ;1455424753;Taip;0;1;3;4
11863;Vandenis;GANDRIUKŲ;1029909269;Taip;10;3;0;13
11864;Vandenis;GANDRIUKŲ;11961797041;Taip;0;0;1;1
11865;Vandenis;GANDRIUKŲ;80422278900;Taip;0;2;0;2
11866;Vandenis;GANDRIUKŲ;83265714438;Taip;0;1;0;1
11867;Vandenis;GANDRIUKŲ;1498815019;Taip;3;0;0;3
11868;Vandenis;GANDRIUKŲ;1397176489;Taip;0;2;0;2
11869;Vandenis;GANDRIUKŲ;54770618599;Taip;0;2;0;2
11870;Vandenis;GANDRIUKŲ;10538645159;Ne;5;3;1;9
11871;Vandenis;GANDRIUKŲ;20957822945;Taip;7;2;3;12
11872;Vandenis;GANDRIUKŲ;47997751365;Taip;0;2;0;2
11873;Vandenis;GANDRIUKŲ;91684805923;Taip;0;1;10;11
11874;Vandenis;GANDRIUKŲ;48076017461;Taip;2;2;0;4
11875;Vandenis;ŽĄSIUKAI;80643665990;Taip;0;1;0;1
11876;Vandenis;ŽĄSIUKAI;74138671368;Taip;0;5;10;15
11877;Vandenis;ŽĄSIUKAI;25459674313;Taip;0;1;0;1
11878;Vandenis;ŽĄSIUKAI;2812520834;Taip;0;4;0;4
11879;Vandenis;ŽĄSIUKAI;1286716632;Taip;0;2;0;2
11880;Vandenis;ŽĄSIUKAI;11527007102;Taip;0;6;0;6
11881;Vandenis;ŽĄSIUKAI;1373653402;Taip;7;0;0;7
11882;Vandenis;ŽĄSIUKAI;65840410497;Taip;0;3;0;3
11883;Vandenis;ŽĄSIUKAI;53658866238;Taip;15;4;0;19
11884;Vandenis;ŽĄSIUKAI;1217508516;Taip;10;11;0;21
11885;Vandenis;ŽĄSIUKAI;55238344586;Taip;6;0;0;6
11886;Vandenis;ŽĄSIUKAI;78917527699;Taip;0;1;0;1
11887;Vandenis;ŽĄSIUKAI;1397125827;Taip;5;3;1;9
11888;Vandenis;ŽĄSIUKAI;1155423158;Taip;0;11;0;11
11889;Vandenis;PURIENŲ;877974909;Taip;0;3;0;3
11890;Vandenis;PURIENŲ;3823382249;Taip;4;0;0;4
11891;Vandenis;PURIENŲ;43295720034;Taip;3;3;0;6
11892;Vandenis;PURIENŲ;84636435681;Taip;4;0;0;4
11893;Vandenis;PURIENŲ;1958929302;Taip;6;0;0;6
11894;Vandenis;PURIENŲ;39973189502;Taip;0;0;1;1
11895;Vandenis;PURIENŲ;2096950367;Taip;0;8;0;8
11896;Vandenis;PURIENŲ;1633589144;Taip;4;1;0;5
11897;Vandenis;PURIENŲ;1854498462;Taip;0;3;0;3
11898;Vandenis;PURIENŲ;6673346389;Taip;0;1;0;1
11899;Vandenis;PURIENŲ;7168910452;Taip;6;0;0;6
11900;Vandenis;PURIENŲ;2073785910;Taip;5;0;0;5
11901;Vandenis;PURIENŲ;81817138188;Taip;10;1;0;11
11902;Vandenis;PURIENŲ;86947904365;Taip;3;0;0;3
11903;Vandenis;PURIENŲ;1395272045;Taip;0;10;0;10
11904;Vandenis;PURIENŲ;3740778932;Taip;9;2;0;11
11905;Vandenis;VARLIUKAI;7091356848;Taip;10;2;0;12
11906;Vandenis;VARLIUKAI;8116532445;Taip;6;5;0;11
11907;Vandenis;VARLIUKAI;7069369080;Taip;6;5;0;11
11908;Vandenis;VARLIUKAI;7924399684;Taip;0;3;0;3
11909;Vandenis;VARLIUKAI;5454049563;Taip;10;0;0;10
11910;Vandenis;VARLIUKAI;9805578141;Taip;10;0;0;10
11911;Vandenis;VARLIUKAI;8921666108;Taip;10;0;0;10
11912;Vandenis;VARLIUKAI;6011280420;Taip;17;0;0;17
11913;Vandenis;VARLIUKAI;1187395353;Taip;9;0;0;9
11914;Vandenis;VARLIUKAI;1081385111;Taip;0;0;1;1
11915;Vandenis;VARLIUKAI;9158541919;Taip;12;0;0;12
11916;Vandenis;VARLIUKAI;5959181898;Taip;12;0;0;12
11917;Vandenis;VARLIUKAI;7059385610;Taip;0;2;0;2
11918;Vandenis;VARLIUKAI;2645775090;Taip;8;5;0;13
11919;Vandenis;PINGVINAI;9994373029;Taip;10;0;0;10
11920;Vandenis;PINGVINAI;3544717790;Taip;0;5;0;5
11921;Vandenis;PINGVINAI;4085256182;Taip;2;1;2;5
11922;Vandenis;PINGVINAI;1568158992;Taip;0;5;0;5
11923;Vandenis;PINGVINAI;18336904438;Taip;8;2;0;10
11924;Vandenis;PINGVINAI;8689134931;Taip;0;1;0;1
11925;Vandenis;PINGVINAI;64711327503;Taip;17;0;1;18
11926;Vandenis;PINGVINAI;7381695975;Taip;0;1;0;1
11927;Vandenis;PINGVINAI;55421695186;Taip;2;1;0;3
11928;Vandenis;PINGVINAI;24217366528;Taip;0;6;0;6
11929;Vandenis;PINGVINAI;5549292096;Taip;0;11;0;11
11930;Vandenis;PINGVINAI;4643267945;Taip;20;1;0;21
11931;Vandenis;PINGVINAI;8430706407;Taip;7;0;0;7
11932;Vandenis;PINGVINAI;35673258175;Taip;1;0;3;4
11933;Vandenis;PINGVINAI;27409922803;Taip;13;0;0;13
11934;Vėjelis;Pumpurėliai;58369004570;Taip;4;0;0;4
11935;Vėjelis;Pumpurėliai;54924516732;Taip;0;2;0;2
11936;Vėjelis;Pumpurėliai;25872613643;Taip;5;1;0;6
11937;Vėjelis;Pumpurėliai;38106696628;Taip;0;8;0;8
11938;Vėjelis;Pumpurėliai;8653964270;Taip;0;6;0;6
11939;Vėjelis;Pumpurėliai;88817521596;Taip;0;2;0;2
11940;Vėjelis;Pumpurėliai;53270546031;Taip;4;2;1;7
11941;Vėjelis;Pumpurėliai;16294883533;Taip;3;0;0;3
11942;Vėjelis;Pumpurėliai;18902976827;Taip;0;1;0;1
11943;Vėjelis;Pumpurėliai;58314846835;Taip;5;6;0;11
11944;Vėjelis;Pumpurėliai;34584409245;Taip;0;7;0;7
11945;Vėjelis;Pumpurėliai;63893850632;Taip;7;0;0;7
11946;Vėjelis;Pumpurėliai;23799231345;Taip;4;1;0;5
11947;Vėjelis;Pumpurėliai;95469370742;Taip;10;0;0;10
11948;Vėjelis;Pumpurėliai;14212441124;Taip;0;3;0;3
11949;Vėjelis;Pumpurėliai;53379180843;Taip;10;0;0;10
11950;Vėjelis;Pumpurėliai;17523450164;Taip;0;3;0;3
11951;Vėjelis;Pumpurėliai;5365237487;Taip;7;1;0;8
11952;Vėjelis;Pumpurėliai;3965445196;Taip;0;5;0;5
11953;Vėjelis;Pumpurėliai;2301011427;Taip;1;10;1;12
11954;Vėjelis;Drugeliai;4746932126;Taip;5;9;0;14
11955;Vėjelis;Drugeliai;1978952781;Taip;3;0;0;3
11956;Vėjelis;Drugeliai;8353084814;Taip;7;0;0;7
11957;Vėjelis;Drugeliai;1115802837;Taip;15;0;0;15
11958;Vėjelis;Drugeliai;2416832899;Taip;2;1;1;4
11959;Vėjelis;Drugeliai;4741154518;Taip;0;0;3;3
11960;Vėjelis;Drugeliai;3276062426;Taip;11;0;1;12
11961;Vėjelis;Drugeliai;9298789434;Taip;7;0;0;7
11962;Vėjelis;Drugeliai;2734024890;Taip;10;3;0;13
11963;Vėjelis;Drugeliai;7981032872;Taip;9;2;0;11
11964;Vėjelis;Drugeliai;7133454882;Taip;11;1;0;12
11965;Vėjelis;Drugeliai;2000277444;Taip;0;0;1;1
11966;Vėjelis;Drugeliai;7594586198;Taip;10;0;0;10
11967;Vėjelis;Drugeliai;7697394469;Taip;16;0;0;16
11968;Vėjelis;Drugeliai;4066956765;Taip;9;0;0;9
11969;Vėjelis;Drugeliai;9696910320;Taip;21;0;0;21
11970;Vėjelis;Malūnėlis;63002531941;Taip;0;1;0;1
11971;Vėjelis;Malūnėlis;16498317981;Taip;0;3;0;3
11972;Vėjelis;Malūnėlis;93859592652;Taip;3;0;0;3
11973;Vėjelis;Malūnėlis;12149443904;Taip;16;1;0;17
11974;Vėjelis;Malūnėlis;76098853911;Ne;7;0;0;7
11975;Vėjelis;Malūnėlis;74207410750;Taip;5;0;0;5
11976;Vėjelis;Malūnėlis;69740475863;Ne;0;2;0;2
11977;Vėjelis;Malūnėlis;20148908290;Taip;0;1;4;5
11978;Vėjelis;Malūnėlis;39671245978;Taip;6;0;1;7
11979;Vėjelis;Malūnėlis;1209526192;Taip;0;1;0;1
11980;Vėjelis;Malūnėlis;58121447313;Taip;0;0;1;1
11981;Vėjelis;Malūnėlis;68958036563;Taip;11;7;0;18
11982;Vėjelis;Malūnėlis;20593684676;Taip;11;0;0;11
11983;Vėjelis;Malūnėlis;14502736200;Taip;0;2;0;2
11984;Vėjelis;Malūnėlis;98024305748;Taip;5;3;0;8
11985;Vėjelis;Malūnėlis;5735207486;Taip;20;0;0;20
11986;Vėjelis;Malūnėlis;4194366404;Taip;4;1;0;5
11987;Vėjelis;Malūnėlis;1603377234;Taip;10;1;0;11
11988;Vėjelis;Malūnėlis;87555226002;Taip;0;1;0;1
11989;Vėjelis;Žvaigždutės;1295818672;Taip;10;0;1;11
11990;Vėjelis;Žvaigždutės;1930159743;Taip;0;2;0;2
11991;Vėjelis;Žvaigždutės;1540879634;Taip;1;0;0;1
11992;Vėjelis;Žvaigždutės;1612878387;Taip;0;3;0;3
11993;Vėjelis;Žvaigždutės;3485366651;Taip;0;4;0;4
11994;Vėjelis;Žvaigždutės;5139323880;Taip;6;5;1;12
11995;Vėjelis;Žvaigždutės;2363974247;Taip;13;0;0;13
11996;Vėjelis;Žvaigždutės;8379298947;Taip;13;0;0;13
11997;Vėjelis;Žvaigždutės;47986392996;Taip;6;0;0;6
11998;Vėjelis;Žvaigždutės;7610485310;Taip;0;16;0;16
11999;Vėjelis;Žvaigždutės;90647333398;Taip;1;7;0;8
12000;Vėjelis;Žvaigždutės;40744700561;Taip;0;8;0;8
12001;Vėjelis;Žvaigždutės;26328498777;Taip;3;0;0;3
12002;Vėjelis;Žvaigždutės;47143492836;Taip;0;13;0;13
12003;Vėjelis;Žvaigždutės;69341469387;Taip;0;15;0;15
12004;Vėjelis;Žvaigždutės;9190085358;Taip;0;4;0;4
12005;Vėjelis;Žvaigždutės;56520156825;Taip;14;3;0;17
12006;Vėjelis;Žvaigždutės;90103717718;Taip;0;1;0;1
12007;Vėjelis;Žvaigždutės;8949760376;Taip;1;0;0;1
12008;Vėjelis;Žvaigždutės;6002719498;Taip;0;17;0;17
12009;Vėjelis;Žvaigždutės;9000966115;Taip;0;1;0;1
12010;Vėjelis;Varpeliai;2759958482;Taip;5;6;0;11
12011;Vėjelis;Varpeliai;898039829;Taip;0;4;0;4
12012;Vėjelis;Varpeliai;58968869099;Taip;0;3;0;3
12013;Vėjelis;Varpeliai;25190615976;Ne;0;4;0;4
12014;Vėjelis;Varpeliai;28696711850;Taip;0;8;0;8
12015;Vėjelis;Varpeliai;47402024682;Taip;0;5;0;5
12016;Vėjelis;Varpeliai;8787363287;Taip;0;11;0;11
12017;Vėjelis;Varpeliai;83608030842;Taip;2;0;0;2
12018;Vėjelis;Varpeliai;53440131428;Taip;0;3;0;3
12019;Vėjelis;Varpeliai;90996312461;Taip;0;10;0;10
12020;Vėjelis;Varpeliai;86680640521;Taip;2;6;0;8
12021;Vėjelis;Varpeliai;46016776013;Taip;0;1;0;1
12022;Vėjelis;Varpeliai;1944266562;Taip;5;0;7;12
12023;Vėjelis;Varpeliai;94214534219;Taip;0;2;0;2
12024;Vėjelis;Varpeliai;89044270439;Taip;1;0;0;1
12025;Vėjelis;Varpeliai;3214710339;Taip;6;1;0;7
12026;Vėjelis;Varpeliai;80942260332;Taip;0;6;0;6
12027;Vėjelis;Varpeliai;80423879616;Taip;0;7;0;7
12028;Vėjelis;Pelėdžiukų;1454662113;Taip;0;0;1;1
12029;Vėjelis;Pelėdžiukų;1467023330;Taip;4;0;0;4
12030;Vėjelis;Pelėdžiukų;1238171728;Taip;9;0;0;9
12031;Vėjelis;Pelėdžiukų;5992665537;Taip;0;1;0;1
12032;Vėjelis;Pelėdžiukų;4024898537;Taip;5;6;0;11
12033;Vėjelis;Pelėdžiukų;24011371444;Taip;9;0;0;9
12034;Vėjelis;Pelėdžiukų;2819491961;Taip;0;12;0;12
12035;Vėjelis;Pelėdžiukų;1783878104;Taip;10;2;0;12
12036;Vėjelis;Pelėdžiukų;55075988807;Taip;0;4;0;4
12037;Vėjelis;Pelėdžiukų;8033732937;Taip;20;0;0;20
12038;Vėjelis;Pelėdžiukų;6618114389;Taip;0;11;0;11
12039;Vėjelis;Pelėdžiukų;1510415602;Taip;10;0;1;11
12040;Vėjelis;Pelėdžiukų;2042863944;Taip;0;7;0;7
12041;Vėjelis;Pelėdžiukų;1347855869;Taip;6;1;0;7
12042;Vėjelis;Pelėdžiukų;1719502147;Taip;0;0;5;5
12043;Vėjelis;Pelėdžiukų;2128818222;Taip;4;0;1;5
12044;Vėjelis;Pelėdžiukų;4930807661;Taip;1;0;2;3
12045;Vėjelis;Pelėdžiukų;1518855620;Taip;5;4;0;9
12046;Vėjelis;Skruzdeliukų;2021887954;Taip;4;5;0;9
12047;Vėjelis;Skruzdeliukų;5468993286;Taip;0;5;0;5
12048;Vėjelis;Skruzdeliukų;46167493039;Taip;2;2;0;4
12049;Vėjelis;Skruzdeliukų;90185075321;Taip;1;0;0;1
12050;Vėjelis;Skruzdeliukų;1640356242;Taip;0;1;0;1
12051;Vėjelis;Skruzdeliukų;86128256406;Taip;0;3;2;5
12052;Vėjelis;Skruzdeliukų;41268510292;Taip;0;1;2;3
12053;Vėjelis;Skruzdeliukų;1921039937;Taip;0;0;1;1
12054;Vėjelis;Skruzdeliukų;57285479257;Taip;1;0;0;1
12055;Vėjelis;Skruzdeliukų;44482585723;Taip;0;2;0;2
12056;Vėjelis;Skruzdeliukų;77205958956;Taip;7;1;1;9
12057;Vėjelis;Skruzdeliukų;2718251356;Taip;0;0;9;9
12058;Vėjelis;Skruzdeliukų;1988459596;Taip;1;0;0;1
12059;Vėjelis;Skruzdeliukų;1934426525;Taip;8;5;0;13
12060;Vėjelis;Skruzdeliukų;64339770365;Taip;8;7;0;15
12061;Vėjelis;Skruzdeliukų;44153389025;Taip;4;3;0;7
12062;Vėjelis;Skruzdeliukų;1284286578;Taip;8;2;0;10
12063;Vėjelis;Skruzdeliukų;1789982154;Taip;0;13;0;13
12064;Vėjelis;Skruzdeliukų;75596757609;Taip;0;0;1;1
12065;Vėjelis;Pieštukų;3255066035;Taip;9;10;0;19
12066;Vėjelis;Pieštukų;76305473353;Taip;5;5;0;10
12067;Vėjelis;Pieštukų;50124109589;Taip;0;20;0;20
12068;Vėjelis;Pieštukų;4853650350;Taip;0;11;0;11
12069;Vėjelis;Pieštukų;73287916371;Taip;0;9;0;9
12070;Vėjelis;Pieštukų;60890519853;Taip;0;1;0;1
12071;Vėjelis;Pieštukų;78490601352;Taip;4;0;0;4
12072;Vėjelis;Pieštukų;8386409466;Taip;0;0;20;20
12073;Vėjelis;Pieštukų;8938491367;Taip;0;11;0;11
12074;Vėjelis;Pieštukų;9492690970;Taip;11;0;0;11
12075;Vėjelis;Pieštukų;6386092350;Taip;0;4;0;4
12076;Vėjelis;Pieštukų;8684461171;Taip;0;9;0;9
12077;Vėjelis;Pieštukų;8973530484;Taip;0;0;3;3
12078;Vėjelis;Pieštukų;98588113289;Taip;0;8;0;8
12079;Vėjelis;Pieštukų;4067153819;Taip;0;0;1;1
12080;Vėjelis;Pieštukų;9395929106;Taip;6;9;0;15
12081;Vėjelis;Pieštukų;1205392813;Taip;0;6;0;6
12082;Vėjelis;Pieštukų;5031781196;Taip;7;0;0;7
12083;Vėjelis;Ramunėlių;5987294293;Taip;0;4;0;4
12084;Vėjelis;Ramunėlių;8047799576;Taip;6;3;0;9
12085;Vėjelis;Ramunėlių;4353239658;Taip;1;1;1;3
12086;Vėjelis;Ramunėlių;7178844364;Taip;13;0;0;13
12087;Vėjelis;Ramunėlių;2164009051;Taip;10;1;0;11
12088;Vėjelis;Ramunėlių;2386927970;Taip;13;2;0;15
12089;Vėjelis;Ramunėlių;2124857941;Taip;11;1;0;12
12090;Vėjelis;Ramunėlių;6455798848;Taip;5;0;0;5
12091;Vėjelis;Ramunėlių;2999425729;Taip;21;0;0;21
12092;Vėjelis;Ramunėlių;6996900411;Taip;7;2;0;9
12093;Vėjelis;Ramunėlių;2289954824;Taip;12;1;0;13
12094;Vėjelis;Ramunėlių;1717847351;Taip;3;1;0;4
12095;Vėjelis;Ramunėlių;6777528441;Taip;9;4;0;13
12096;Vėjelis;Ramunėlių;6891260701;Taip;0;3;0;3
12097;Vėjelis;Ramunėlių;2151737048;Taip;11;5;0;16
12098;Vėjelis;Ramunėlių;7836199284;Taip;13;0;0;13
12099;Vėjelis;Ramunėlių;1331334220;Taip;1;0;9;10
12100;Vėjelis;Nykštukai;43342043904;Taip;0;2;0;2
12101;Vėjelis;Nykštukai;22865699640;Taip;6;0;0;6
12102;Vėjelis;Nykštukai;20492762368;Taip;3;0;0;3
12103;Vėjelis;Nykštukai;1251348150;Taip;0;5;0;5
12104;Vėjelis;Nykštukai;85352317063;Taip;0;8;0;8
12105;Vėjelis;Nykštukai;41673970488;Taip;9;0;0;9
12106;Vėjelis;Nykštukai;89943712210;Taip;7;1;0;8
12107;Vėjelis;Nykštukai;64628040227;Taip;9;2;0;11
12108;Vėjelis;Nykštukai;33235320630;Taip;0;5;0;5
12109;Vėjelis;Nykštukai;2132492766;Taip;0;0;2;2
12110;Vėjelis;Nykštukai;8226906949;Taip;16;0;0;16
12111;Vėjelis;Nykštukai;5207473829;Taip;8;0;1;9
12112;Vėjelis;Nykštukai;4938939921;Taip;5;6;0;11
12113;Vėjelis;Nykštukai;72881976363;Taip;5;2;0;7
12114;Vėjelis;Nykštukai;78465993753;Ne;7;2;0;9
12115;Vėjelis;Nykštukai;63900641942;Taip;5;2;0;7
12116;Vėjelis;Nykštukai;1053502203;Ne;5;1;0;6
12117;Vėjelis;Nykštukai;1481976292;Taip;0;1;1;2
12118;Vėjelis;Nykštukai;47716333909;Taip;5;7;0;12
12119;Vėjelis;BITUTĖS;5902455219;Taip;0;3;0;3
12120;Vėjelis;BITUTĖS;48694326383;Taip;0;1;0;1
12121;Vėjelis;BITUTĖS;4831426440;Taip;0;2;2;4
12122;Vėjelis;BITUTĖS;74475070018;Taip;0;1;0;1
12123;Vėjelis;BITUTĖS;5517128872;Taip;0;1;0;1
12124;Vėjelis;BITUTĖS;6724813553;Taip;6;0;0;6
12125;Vėjelis;BITUTĖS;4451119031;Taip;6;10;0;16
12126;Vėjelis;BITUTĖS;8721116918;Taip;7;0;0;7
12127;Vėjelis;BITUTĖS;1270627404;Taip;2;0;0;2
12128;Vėjelis;BITUTĖS;2575398136;Taip;2;0;2;4
12129;Vėjelis;BITUTĖS;3584347608;Taip;0;1;0;1
12130;Vėjelis;BITUTĖS;9108653045;Taip;0;11;0;11
12131;Vėjelis;BITUTĖS;5508269515;Taip;0;6;0;6
12132;Vėjelis;BITUTĖS;8998452731;Taip;5;0;0;5
12133;Vėjelis;BITUTĖS;9672929606;Taip;12;0;0;12
12134;Vėjelis;BITUTĖS;6451722893;Taip;9;0;1;10
12135;Vėjelis;BITUTĖS;5909697341;Taip;0;1;0;1
12136;Vėjelis;BITUTĖS;9754373141;Taip;0;0;1;1
12137;Vėjelis;BITUTĖS;4906958328;Taip;0;1;1;2
12138;Vėjelis;Boruželės;2199680661;Taip;0;2;0;2
12139;Vėjelis;Boruželės;5325081841;Taip;10;9;0;19
12140;Vėjelis;Boruželės;5381588565;Taip;0;2;0;2
12141;Vėjelis;Boruželės;1863210064;Taip;0;4;0;4
12142;Vėjelis;Boruželės;8553966497;Taip;0;11;0;11
12143;Vėjelis;Boruželės;1588345134;Taip;0;0;3;3
12144;Vėjelis;Boruželės;1751533938;Taip;0;2;0;2
12145;Vėjelis;Boruželės;4733227215;Taip;17;0;0;17
12146;Vėjelis;Boruželės;1429496839;Taip;0;2;0;2
12147;Vėjelis;Boruželės;1931659200;Taip;21;0;0;21
12148;Vėjelis;Boruželės;1076538028;Taip;1;1;0;2
12149;Vėjelis;Boruželės;6658178519;Taip;13;0;0;13
12150;Vėjelis;Boruželės;6221257045;Taip;0;2;0;2
12151;Vėjelis;Boruželės;8666759391;Taip;0;5;0;5
12152;Vėjelis;Boruželės;3844131154;Taip;3;1;0;4
12153;Vėjelis;Boruželės;4747466651;Taip;0;15;0;15
12154;Vėjelis;Boruželės;3473416323;Taip;5;1;0;6
12155;Vėjelis;Boruželės;8141198449;Taip;7;1;2;10
12156;Vėjelis;Boruželės;8121537795;Taip;20;0;0;20
12157;Vėtrungė;Debesėlių;62501279379;Taip;1;2;0;3
12158;Vėtrungė;Debesėlių;684188851;Taip;1;6;0;7
12159;Vėtrungė;Debesėlių;1833285759;Taip;0;6;0;6
12160;Vėtrungė;Debesėlių;31644585040;Ne;0;4;0;4
12161;Vėtrungė;Debesėlių;68262180072;Taip;0;3;2;5
12162;Vėtrungė;Debesėlių;18747550179;Taip;0;1;0;1
12163;Vėtrungė;Debesėlių;63472451321;Taip;14;3;0;17
12164;Vėtrungė;Debesėlių;97059033453;Ne;2;0;4;6
12165;Vėtrungė;Debesėlių;9844783953;Taip;0;1;0;1
12166;Vėtrungė;Debesėlių;8948342560;Taip;0;1;0;1
12167;Vėtrungė;Debesėlių;30792456956;Taip;4;1;0;5
12168;Vėtrungė;Debesėlių;28780493289;Taip;1;13;0;14
12169;Vėtrungė;Debesėlių;65861118217;Taip;0;4;1;5
12170;Vėtrungė;Debesėlių;48935809458;Ne;0;2;0;2
12171;Vėtrungė;Debesėlių;92977432447;Ne;8;3;0;11
12172;Vėtrungė;Debesėlių;11835082526;Taip;0;1;0;1
12173;Vėtrungė;Debesėlių;92266460791;Taip;0;0;4;4
12174;Vėtrungė;Debesėlių;30561569339;Ne;8;1;0;9
12175;Vėtrungė;Debesėlių;31570905515;Ne;8;1;0;9
12176;Vėtrungė;Debesėlių;4547247726;Taip;0;6;0;6
12177;Vėtrungė;Debesėlių;1918866964;Taip;4;3;0;7
12178;Vėtrungė;Debesėlių;96980344422;Taip;12;0;0;12
12179;Vėtrungė;Zuikių;8493950205;Taip;6;0;0;6
12180;Vėtrungė;Zuikių;7585075881;Taip;18;0;0;18
12181;Vėtrungė;Zuikių;4874628984;Taip;14;0;0;14
12182;Vėtrungė;Zuikių;9332362038;Taip;12;0;0;12
12183;Vėtrungė;Zuikių;9407558097;Taip;18;0;0;18
12184;Vėtrungė;Zuikių;2985829593;Taip;13;3;0;16
12185;Vėtrungė;Zuikių;4121886031;Taip;10;3;2;15
12186;Vėtrungė;Zuikių;7573021445;Taip;2;2;11;15
12187;Vėtrungė;Zuikių;9742099165;Taip;0;1;0;1
12188;Vėtrungė;Drugelių;34534856875;Ne;0;0;3;3
12189;Vėtrungė;Drugelių;1019550327;Taip;1;0;4;5
12190;Vėtrungė;Drugelių;26126038013;Taip;0;5;0;5
12191;Vėtrungė;Drugelių;40200404538;Taip;1;0;1;2
12192;Vėtrungė;Drugelių;72462689908;Taip;0;4;0;4
12193;Vėtrungė;Drugelių;38583821324;Ne;0;6;0;6
12194;Vėtrungė;Drugelių;42353807206;Taip;0;8;0;8
12195;Vėtrungė;Drugelių;68573318766;Ne;1;11;0;12
12196;Vėtrungė;Drugelių;76967115688;Taip;0;1;0;1
12197;Vėtrungė;Drugelių;68938242748;Taip;0;1;0;1
12198;Vėtrungė;Drugelių;93587767496;Taip;3;12;0;15
12199;Vėtrungė;Drugelių;1111688152;Taip;4;3;0;7
12200;Vėtrungė;Drugelių;1752676956;Taip;0;5;0;5
12201;Vėtrungė;Drugelių;1128961321;Taip;6;0;0;6
12202;Vėtrungė;Drugelių;88062307371;Taip;4;0;0;4
12203;Vėtrungė;Drugelių;99423172685;Ne;1;0;0;1
12204;Vėtrungė;Drugelių;58224525427;Taip;0;12;0;12
12205;Vėtrungė;Drugelių;1533796435;Taip;0;0;3;3
12206;Vėtrungė;Do-re-mi;6978977383;Taip;15;0;0;15
12207;Vėtrungė;Do-re-mi;4528101179;Taip;6;0;0;6
12208;Vėtrungė;Do-re-mi;6449124019;Taip;6;0;0;6
12209;Vėtrungė;Do-re-mi;3278452234;Taip;0;5;5;10
12210;Vėtrungė;Do-re-mi;9324733839;Taip;1;0;0;1
12211;Vėtrungė;Do-re-mi;2287044278;Taip;0;2;3;5
12212;Vėtrungė;Do-re-mi;2928868412;Taip;0;3;0;3
12213;Vėtrungė;Do-re-mi;9518734260;Taip;9;1;0;10
12214;Vėtrungė;Do-re-mi;7782972361;Taip;0;6;0;6
12215;Vėtrungė;Do-re-mi;7496582551;Taip;4;0;0;4
12216;Vėtrungė;Do-re-mi;5430818470;Taip;0;7;0;7
12217;Vėtrungė;Do-re-mi;1088517019;Ne;11;0;0;11
12218;Vėtrungė;Do-re-mi;5832298824;Ne;0;1;0;1
12219;Vėtrungė;Do-re-mi;7895027909;Taip;6;0;1;7
12220;Vėtrungė;Smalsučių;1024966114;Taip;0;0;1;1
12221;Vėtrungė;Smalsučių;12552330015;Taip;0;6;0;6
12222;Vėtrungė;Smalsučių;43313050517;Taip;0;2;2;4
12223;Vėtrungė;Smalsučių;1096312626;Taip;0;3;0;3
12224;Vėtrungė;Smalsučių;58071867972;Taip;5;11;0;16
12225;Vėtrungė;Smalsučių;25185803642;Taip;0;1;0;1
12226;Vėtrungė;Smalsučių;8303270253;Taip;5;0;0;5
12227;Vėtrungė;Smalsučių;10642323891;Taip;5;1;0;6
12228;Vėtrungė;Smalsučių;1637718306;Taip;6;0;0;6
12229;Vėtrungė;Smalsučių;37534609024;Taip;0;0;3;3
12230;Vėtrungė;Smalsučių;18697110620;Taip;0;1;5;6
12231;Vėtrungė;Smalsučių;55178408212;Taip;0;0;8;8
12232;Vėtrungė;Smalsučių;1828688039;Taip;0;1;0;1
12233;Vėtrungė;Gudručių;39325086836;Taip;4;2;0;6
12234;Vėtrungė;Gudručių;71205463603;Taip;0;1;0;1
12235;Vėtrungė;Gudručių;53452204630;Taip;0;3;0;3
12236;Vėtrungė;Gudručių;63918616201;Taip;0;3;0;3
12237;Vėtrungė;Gudručių;71037045946;Taip;3;7;0;10
12238;Vėtrungė;Gudručių;50620488812;Taip;0;2;2;4
12239;Vėtrungė;Gudručių;17639791114;Taip;3;6;0;9
12240;Vėtrungė;Gudručių;45652505960;Taip;0;4;0;4
12241;Vėtrungė;Gudručių;79959834921;Ne;0;3;0;3
12242;Vėtrungė;Gudručių;32639429554;Taip;7;1;0;8
12243;Vėtrungė;Gudručių;72698261170;Taip;0;14;0;14
12244;Vėtrungė;Gudručių;74200855756;Taip;6;1;0;7
12245;Vėtrungė;Gudručių;13233957713;Ne;0;1;0;1
12246;Vėtrungė;Gudručių;29414532281;Ne;0;1;0;1
12247;Vėtrungė;Gudručių;16576620734;Ne;0;6;0;6
12248;Vėtrungė;Gudručių;1120374635;Taip;0;1;0;1
12249;Vėtrungė;Gudručių;77759679609;Taip;0;9;0;9
12250;Vėtrungė;Kodėlčių;1366458234;Taip;6;7;0;13
12251;Vėtrungė;Kodėlčių;1021458176;Taip;0;22;0;22
12252;Vėtrungė;Kodėlčių;1267104594;Taip;5;5;0;10
12253;Vėtrungė;Kodėlčių;1022530443;Taip;14;1;0;15
12254;Vėtrungė;Kodėlčių;1283685496;Taip;5;13;0;18
12255;Vėtrungė;Kodėlčių;20608668180;Taip;8;6;0;14
12256;Vėtrungė;Kodėlčių;3980104822;Taip;6;1;0;7
12257;Vėtrungė;Kodėlčių;31133574731;Taip;17;6;0;23
12258;Vėtrungė;Kodėlčių;49220186521;Taip;5;2;0;7
12259;Vėtrungė;Kodėlčių;41508942219;Taip;8;12;0;20
12260;Vėtrungė;Kodėlčių;1662123237;Taip;0;14;0;14
12261;Vėtrungė;Kodėlčių;1456877681;Taip;0;25;0;25
12262;Vėtrungė;Kodėlčių;90528749634;Taip;14;1;1;16
12263;Vėtrungė;Kodėlčių;1487142899;Taip;20;0;0;20
12264;Vėtrungė;Kodėlčių;19486911273;Taip;8;0;0;8
12265;Vėtrungė;Kodėlčių;56266349747;Taip;14;2;0;16
12266;Vėtrungė;Kodėlčių;1902101426;Taip;0;14;0;14
12267;Vėtrungė;Kodėlčių;9395706055;Taip;11;10;0;21
12268;Vėtrungė;Kodėlčių;3231167303;Taip;10;0;0;10
12269;Vėtrungė;Kodėlčių;4291687553;Taip;6;4;2;12
12270;Vėtrungė;Kodėlčių;18426639118;Taip;7;6;0;13
12271;Vėtrungė;Kodėlčių;1383686133;Taip;8;1;0;9
12272;Vėtrungė;Kodėlčių;6563805572;Taip;21;1;0;22
12273;Vėtrungė;Kodėlčių;1395153496;Taip;0;15;0;15
12274;Vėtrungė;Paukštelių;63512524250;Ne;6;0;9;15
12275;Vėtrungė;Paukštelių;1322617786;Taip;25;0;0;25
12276;Vėtrungė;Paukštelių;2864217098;Taip;7;0;0;7
12277;Vėtrungė;Paukštelių;7921863675;Taip;5;3;0;8
12278;Vėtrungė;Paukštelių;4091719904;Taip;12;1;0;13
12279;Vėtrungė;Paukštelių;8915159672;Taip;0;9;0;9
12280;Vėtrungė;Paukštelių;2482436192;Taip;6;3;0;9
12281;Vėtrungė;Paukštelių;6732632515;Taip;25;0;0;25
12282;Vėtrungė;Paukštelių;8897558066;Taip;0;0;1;1
12283;Vėtrungė;Paukštelių;3404120492;Taip;1;0;0;1
12284;Vėtrungė;Paukštelių;8154023892;Ne;19;0;0;19
12285;Vėtrungė;Paukštelių;3721504364;Taip;11;0;0;11
12286;Vėtrungė;Paukštelių;4115995882;Taip;0;2;0;2
12287;Vėtrungė;Paukštelių;1357603285;Taip;6;0;0;6
12288;Vėtrungė;Paukštelių;5994465833;Taip;0;1;0;1
12289;Vėtrungė;Paukštelių;8721035192;Taip;0;25;0;25
12290;Vėtrungė;Paukštelių;6964225210;Taip;7;0;0;7
12291;Vėtrungė;Viščiukų;2809555356;Taip;9;0;0;9
12292;Vėtrungė;Viščiukų;8571622921;Taip;0;8;0;8
12293;Vėtrungė;Viščiukų;3369970611;Taip;0;10;0;10
12294;Vėtrungė;Viščiukų;3200251047;Taip;5;0;0;5
12295;Vėtrungė;Viščiukų;7749675589;Taip;0;3;0;3
12296;Vėtrungė;Viščiukų;8538678373;Taip;7;6;0;13
12297;Vėtrungė;Viščiukų;7483624989;Taip;0;25;0;25
12298;Vėtrungė;Viščiukų;5670113882;Taip;4;5;6;15
12299;Vėtrungė;Viščiukų;1808699695;Taip;0;2;1;3
12300;Vėtrungė;Viščiukų;7807708310;Taip;0;13;0;13
12301;Vėtrungė;Viščiukų;8961791293;Taip;0;3;0;3
12302;Vėtrungė;Viščiukų;4916692634;Taip;4;0;0;4
12303;Vėtrungė;Viščiukų;4197321604;Taip;11;0;0;11
12304;Vėtrungė;Viščiukų;5217297849;Ne;4;2;0;6
12305;Vėtrungė;Viščiukų;6416245099;Ne;0;2;0;2
12306;Vėtrungė;Viščiukų;8742161467;Taip;5;10;0;15
12307;Vėtrungė;Viščiukų;7558548846;Taip;4;1;0;5
12308;Vėtrungė;Viščiukų;1007578933;Taip;4;1;0;5
12309;Vėtrungė;Nykštukų;29699317546;Taip;0;6;0;6
12310;Vėtrungė;Nykštukų;1474010989;Taip;0;21;0;21
12311;Vėtrungė;Nykštukų;47141854213;Taip;0;20;0;20
12312;Vėtrungė;Nykštukų;1754493671;Ne;13;2;1;16
12313;Vėtrungė;Nykštukų;1843306606;Taip;4;9;0;13
12314;Vėtrungė;Nykštukų;5198153485;Taip;0;3;0;3
12315;Vėtrungė;Nykštukų;1630866223;Taip;0;7;1;8
12316;Vėtrungė;Nykštukų;1529226569;Taip;0;3;0;3
12317;Vėtrungė;Nykštukų;1690268842;Taip;5;0;1;6
12318;Vėtrungė;Nykštukų;1279678980;Taip;9;3;0;12
12319;Vėtrungė;Nykštukų;1370336984;Taip;0;4;1;5
12320;Vėtrungė;Nykštukų;78016704795;Taip;6;4;0;10
12321;Vėtrungė;Nykštukų;68628872682;Taip;5;0;0;5
12322;Vėtrungė;Nykštukų;54494917364;Taip;0;1;0;1
12323;Vėtrungė;Nykštukų;87686013986;Taip;4;2;0;6
12324;Vėtrungė;Nykštukų;70610257897;Taip;3;1;0;4
12325;Vėtrungė;Nykštukų;1744400765;Taip;7;2;0;9
12326;Vėtrungė;Nykštukų;1360031121;Taip;10;4;0;14
12327;Vėtrungė;Nykštukų;2145081325;Taip;1;8;2;11
12328;Vėtrungė;Nykštukų;2529102855;Taip;3;1;1;5
12329;Vėtrungė;Nykštukų;1611274573;Taip;0;1;2;3
12330;Vėtrungė;Nykštukų;7792694801;Ne;1;0;1;2
12331;Vėtrungė;Meškiukų;2510763357;Taip;5;0;0;5
12332;Vėtrungė;Meškiukų;4713420194;Taip;6;0;0;6
12333;Vėtrungė;Meškiukų;2226654309;Taip;8;3;0;11
12334;Vėtrungė;Meškiukų;7270370939;Taip;11;0;0;11
12335;Vėtrungė;Meškiukų;9207846866;Taip;20;0;0;20
12336;Vėtrungė;Meškiukų;9065848425;Taip;3;2;0;5
12337;Vėtrungė;Meškiukų;9491661945;Ne;3;0;0;3
12338;Vėtrungė;Meškiukų;3328447991;Taip;0;1;0;1
12339;Vėtrungė;Meškiukų;9685389270;Ne;4;11;0;15
12340;Vėtrungė;Meškiukų;9313438768;Taip;0;2;0;2
12341;Vėtrungė;Meškiukų;9070732925;Taip;0;7;0;7
12342;Vėtrungė;Meškiukų;3122948974;Taip;6;1;1;8
12343;Vėtrungė;Meškiukų;2880342138;Taip;6;0;1;7
12344;Vėtrungė;Meškiukų;2520926439;Taip;11;2;0;13
12345;Vėtrungė;Meškiukų;7704497739;Taip;6;2;0;8
12346;Vėtrungė;Meškiukų;7143997258;Taip;20;0;0;20
12347;Vėtrungė;Meškiukų;5123894802;Taip;0;4;0;4
12348;Vėtrungė;Meškiukų;4394100006;Taip;17;0;8;25
12349;Vėtrungė;Ąžuoliukų;7813907852;Taip;10;0;0;10
12350;Vėtrungė;Ąžuoliukų;2471926240;Taip;0;4;0;4
12351;Vėtrungė;Ąžuoliukų;3249689008;Taip;0;2;0;2
12352;Vėtrungė;Ąžuoliukų;7295216791;Taip;5;1;0;6
12353;Vėtrungė;Ąžuoliukų;2440001662;Taip;12;0;0;12
12354;Vėtrungė;Ąžuoliukų;1636432189;Taip;11;0;0;11
12355;Vėtrungė;Ąžuoliukų;7803736567;Taip;4;3;0;7
12356;Vėtrungė;Ąžuoliukų;1042333710;Ne;8;2;0;10
12357;Vėtrungė;Ąžuoliukų;7129180154;Taip;5;0;0;5
12358;Vėtrungė;Ąžuoliukų;9527296531;Taip;0;16;0;16
12359;Vėtrungė;Ąžuoliukų;16216365941;Taip;0;3;0;3
12360;Vėtrungė;Ąžuoliukų;6356914122;Ne;9;6;0;15
12361;Vėtrungė;Ąžuoliukų;2636219826;Taip;2;3;0;5
12362;Vėtrungė;Ąžuoliukų;1934540281;Ne;5;0;0;5
12363;Vėtrungė;Ąžuoliukų;6479094819;Taip;11;1;0;12
12364;Vėtrungė;Ąžuoliukų;5367369908;Taip;12;0;0;12
12365;Vėtrungė;Ąžuoliukų;4000379945;Taip;0;8;0;8
12366;Vėtrungė;Ąžuoliukų;1789419548;Ne;0;11;0;11
12367;Vėtrungė;Ąžuoliukų;7363490503;Taip;0;5;0;5
12368;Vilnelė;Lakštutė;9657350714;Taip;0;5;0;5
12369;Vilnelė;Lakštutė;1720695615;Taip;16;1;0;17
12370;Vilnelė;Lakštutė;2121071276;Taip;13;0;0;13
12371;Vilnelė;Lakštutė;1065422209;Taip;12;0;0;12
12372;Vilnelė;Lakštutė;1607330769;Taip;0;7;0;7
12373;Vilnelė;Lakštutė;66992481918;Taip;0;7;0;7
12374;Vilnelė;Lakštutė;85074719873;Taip;8;0;0;8
12375;Vilnelė;Lakštutė;3316451889;Taip;1;3;0;4
12376;Vilnelė;Lakštutė;8820091584;Taip;9;0;0;9
12377;Vilnelė;Lakštutė;8270866998;Taip;0;18;0;18
12378;Vilnelė;Lakštutė;2990112955;Taip;17;0;0;17
12379;Vilnelė;Lakštutė;8593060923;Taip;8;0;3;11
12380;Vilnelė;Lakštutė;3454141069;Taip;16;0;0;16
12381;Vilnelė;Lakštutė;9618342480;Taip;11;0;0;11
12382;Vilnelė;Lakštutė;9369955153;Taip;0;1;0;1
12383;Vilnelė;Lakštutė;2311184444;Taip;11;3;0;14
12384;Vilnelė;Lakštutė;6155522893;Taip;11;0;0;11
12385;Vilnelė;Lakštutė;6898685834;Taip;7;0;0;7
12386;Vilnelė;Lakštutė;6318246517;Taip;0;17;0;17
12387;Vilnelė;Lakštutė;7387394504;Taip;14;0;0;14
12388;Vilnelė;Vyturėlis;9643543101;Taip;0;6;0;6
12389;Vilnelė;Vyturėlis;6707161045;Taip;0;7;0;7
12390;Vilnelė;Vyturėlis;5091272908;Taip;1;2;2;5
12391;Vilnelė;Vyturėlis;2696565855;Taip;5;3;0;8
12392;Vilnelė;Vyturėlis;1133945467;Taip;6;0;0;6
12393;Vilnelė;Vyturėlis;3009064105;Taip;0;1;0;1
12394;Vilnelė;Vyturėlis;1674551092;Taip;0;2;0;2
12395;Vilnelė;Vyturėlis;3743740372;Taip;5;1;0;6
12396;Vilnelė;Vyturėlis;2131599015;Taip;2;13;0;15
12397;Vilnelė;Vyturėlis;9460789751;Taip;14;1;0;15
12398;Vilnelė;Vyturėlis;18740103706;Taip;8;0;0;8
12399;Vilnelė;Vyturėlis;7057183482;Taip;19;0;0;19
12400;Vilnelė;Vyturėlis;8725191514;Taip;1;2;2;5
12401;Vilnelė;Vyturėlis;6308015852;Taip;9;3;0;12
12402;Vilnelė;Vyturėlis;7963783957;Taip;14;0;0;14
12403;Vilnelė;Vyturėlis;1545570307;Taip;14;0;0;14
12404;Vilnelė;Vyturėlis;5540359276;Taip;6;0;0;6
12405;Vilnelė;Vyturėlis;1966090625;Taip;8;0;0;8
12406;Vilnelė;Vyturėlis;8740717061;Taip;1;4;0;5
12407;Vilnelė;Pagrandukas;47862530763;Taip;0;1;0;1
12408;Vilnelė;Pagrandukas;86632916976;Taip;0;7;0;7
12409;Vilnelė;Pagrandukas;22292043530;Taip;1;0;0;1
12410;Vilnelė;Pagrandukas;56581871326;Taip;0;3;0;3
12411;Vilnelė;Pagrandukas;99862516414;Taip;2;0;0;2
12412;Vilnelė;Pagrandukas;71697587760;Ne;0;7;0;7
12413;Vilnelė;Pagrandukas;15544719839;Taip;1;1;0;2
12414;Vilnelė;Pagrandukas;66846020652;Taip;0;0;6;6
12415;Vilnelė;Pagrandukas;6165517230;Taip;0;13;0;13
12416;Vilnelė;Pagrandukas;5818753821;Taip;0;4;0;4
12417;Vilnelė;Pagrandukas;97511728967;Taip;0;11;0;11
12418;Vilnelė;Pagrandukas;37597237480;Taip;0;9;0;9
12419;Vilnelė;Pagrandukas;68288478307;Taip;9;0;0;9
12420;Vilnelė;Pagrandukas;58925096937;Taip;0;5;0;5
12421;Vilnelė;Pagrandukas;71382526127;Taip;0;3;0;3
12422;Vilnelė;Pagrandukas;36889106081;Taip;0;1;0;1
12423;Vilnelė;Pagrandukas;22563964459;Taip;0;3;0;3
12424;Vilnelė;Bitutė;57355144827;Taip;0;1;2;3
12425;Vilnelė;Bitutė;31456400596;Ne;0;1;0;1
12426;Vilnelė;Bitutė;98916301986;Ne;0;2;0;2
12427;Vilnelė;Bitutė;5689110144;Taip;2;1;0;3
12428;Vilnelė;Bitutė;14782861836;Taip;0;4;0;4
12429;Vilnelė;Bitutė;81251620413;Taip;0;2;0;2
12430;Vilnelė;Bitutė;1401796093;Ne;3;1;6;10
12431;Vilnelė;Bitutė;5431869792;Ne;0;1;0;1
12432;Vilnelė;Bitutė;19340293938;Taip;0;16;0;16
12433;Vilnelė;Bitutė;57150212991;Ne;0;4;0;4
12434;Vilnelė;Bitutė;79392670872;Taip;0;1;0;1
12435;Vilnelė;Bitutė;66330140933;Taip;9;3;0;12
12436;Vilnelė;Bitutė;63559597074;Taip;0;0;7;7
12437;Vilnelė;Bitutė;65986476721;Taip;7;0;0;7
12438;Vilnelė;Bitutė;69506303971;Ne;1;0;0;1
12439;Vilnelė;Bitutė;70908264075;Taip;0;5;0;5
12440;Vilnelė;Bitutė;28905654375;Taip;0;3;0;3
12441;Vilnelė;Bitutė;41258849574;Taip;5;0;0;5
12442;Vilnelė;Bitutė;27320200466;Taip;0;2;0;2
12443;Vilnelė;Šaltinėlis;1783854203;Taip;0;7;0;7
12444;Vilnelė;Šaltinėlis;5013418313;Taip;5;2;0;7
12445;Vilnelė;Šaltinėlis;42835212158;Taip;7;0;0;7
12446;Vilnelė;Šaltinėlis;98028664140;Taip;6;3;0;9
12447;Vilnelė;Šaltinėlis;1255849405;Taip;8;9;0;17
12448;Vilnelė;Šaltinėlis;7292043157;Taip;0;2;0;2
12449;Vilnelė;Šaltinėlis;6327531229;Taip;12;0;0;12
12450;Vilnelė;Šaltinėlis;1572818047;Taip;4;0;0;4
12451;Vilnelė;Šaltinėlis;2130482375;Taip;15;0;0;15
12452;Vilnelė;Šaltinėlis;4480175299;Taip;10;6;0;16
12453;Vilnelė;Šaltinėlis;9058632601;Taip;0;12;0;12
12454;Vilnelė;Šaltinėlis;1507865281;Taip;5;6;0;11
12455;Vilnelė;Šaltinėlis;39494954188;Taip;0;15;0;15
12456;Vilnelė;Šaltinėlis;8615257084;Taip;10;0;0;10
12457;Vilnelė;Šaltinėlis;6146514112;Taip;0;6;0;6
12458;Vilnelė;Šaltinėlis;9016832316;Taip;5;7;0;12
12459;Vilnelė;Šaltinėlis;1281521052;Taip;18;0;0;18
12460;Vilnelė;Riešutėllis;55974182996;Taip;0;1;0;1
12461;Vilnelė;Riešutėllis;85568332595;Taip;2;7;0;9
12462;Vilnelė;Riešutėllis;22516605873;Taip;0;4;0;4
12463;Vilnelė;Riešutėllis;64066480740;Taip;1;11;0;12
12464;Vilnelė;Riešutėllis;16272480270;Taip;6;0;0;6
12465;Vilnelė;Riešutėllis;1859757115;Taip;0;3;0;3
12466;Vilnelė;Riešutėllis;1450994872;Taip;3;0;5;8
12467;Vilnelė;Riešutėllis;9331404812;Taip;0;11;0;11
12468;Vilnelė;Riešutėllis;11702051319;Taip;0;13;0;13
12469;Vilnelė;Riešutėllis;41536662155;Taip;5;0;2;7
12470;Vilnelė;Riešutėllis;69413564937;Taip;1;5;0;6
12471;Vilnelė;Riešutėllis;7916632244;Taip;0;4;0;4
12472;Vilnelė;Riešutėllis;20639648308;Taip;0;1;0;1
12473;Vilnelė;Riešutėllis;73658263243;Taip;11;4;0;15
12474;Vilnelė;Riešutėllis;8889469645;Taip;0;5;0;5
12475;Vilnelė;Riešutėllis;1522056886;Taip;5;0;1;6
12476;Vilnelė;Riešutėllis;77461494667;Taip;1;2;2;5
12477;Vilnelė;Riešutėllis;1321202650;Taip;0;2;4;6
12478;Vilnelė;Nykštukas;53049214510;Taip;0;1;0;1
12479;Vilnelė;Nykštukas;32988468324;Taip;0;6;0;6
12480;Vilnelė;Nykštukas;89748262997;Taip;10;1;0;11
12481;Vilnelė;Nykštukas;87406093438;Taip;10;1;0;11
12482;Vilnelė;Nykštukas;13583637193;Taip;0;4;0;4
12483;Vilnelė;Nykštukas;23442711820;Taip;2;0;0;2
12484;Vilnelė;Nykštukas;47863474499;Taip;1;0;1;2
12485;Vilnelė;Nykštukas;13231410969;Taip;0;8;0;8
12486;Vilnelė;Nykštukas;62208863766;Taip;16;0;0;16
12487;Vilnelė;Nykštukas;36905818484;Taip;16;0;0;16
12488;Vilnelė;Nykštukas;1845336128;Taip;0;6;0;6
12489;Vilnelė;Nykštukas;87094375121;Taip;6;1;0;7
12490;Vilnelė;Nykštukas;42526993637;Taip;1;0;1;2
12491;Vilnelė;Nykštukas;58422521907;Taip;0;1;0;1
12492;Vilnelė;Nykštukas;15265621906;Taip;0;2;0;2
12493;Vilnelė;Nykštukas;5198859945;Taip;8;3;0;11
12494;Vilnelė;Nykštukas;59579013512;Taip;0;9;0;9
12495;Vilnelė;Pieštukas;1061139491;Taip;0;9;0;9
12496;Vilnelė;Pieštukas;79700582010;Taip;0;1;0;1
12497;Vilnelė;Pieštukas;60707257606;Taip;0;8;0;8
12498;Vilnelė;Pieštukas;1957418704;Taip;15;0;0;15
12499;Vilnelė;Pieštukas;96611892032;Taip;4;1;0;5
12500;Vilnelė;Pieštukas;10333554439;Taip;10;0;0;10
12501;Vilnelė;Pieštukas;624138880;Taip;3;0;0;3
12502;Vilnelė;Pieštukas;31701260922;Taip;0;7;0;7
12503;Vilnelė;Pieštukas;87237045379;Taip;0;6;0;6
12504;Vilnelė;Pieštukas;985960052;Taip;0;7;0;7
12505;Vilnelė;Pieštukas;90173852512;Taip;0;8;0;8
12506;Vilnelė;Pieštukas;95736417954;Taip;0;3;0;3
12507;Vilnelė;Pieštukas;53990457379;Taip;0;2;0;2
12508;Vilnelė;Pieštukas;78753442031;Taip;0;6;0;6
12509;Vilnelė;Pieštukas;1051858780;Taip;16;0;0;16
12510;Vilnelė;Pieštukas;98404616387;Taip;0;6;0;6
12511;Vilnelė;Pieštukas;5936699300;Taip;0;4;0;4
12512;Vilnelė;Voverytė;1702224809;Taip;8;0;1;9
12513;Vilnelė;Voverytė;2812680090;Taip;7;0;0;7
12514;Vilnelė;Voverytė;95852926101;Taip;5;2;0;7
12515;Vilnelė;Voverytė;1594154669;Taip;5;0;0;5
12516;Vilnelė;Voverytė;32662933313;Taip;11;0;0;11
12517;Vilnelė;Voverytė;1410511913;Taip;7;0;1;8
12518;Vilnelė;Voverytė;48926369907;Taip;6;0;0;6
12519;Vilnelė;Voverytė;13646307629;Taip;0;7;0;7
12520;Vilnelė;Voverytė;1680411448;Taip;12;0;0;12
12521;Vilnelė;Voverytė;1294194561;Taip;15;0;0;15
12522;Vilnelė;Voverytė;54871985655;Taip;6;0;0;6
12523;Vilnelė;Voverytė;1733279710;Taip;18;1;0;19
12524;Vilnelė;Voverytė;91933747502;Taip;5;3;0;8
12525;Vilnelė;Voverytė;1346145809;Taip;10;0;0;10
12526;Vilnelė;Voverytė;1498777674;Taip;14;0;0;14
12527;Vilnelė;Voverytė;1932829642;Taip;14;0;0;14
12528;Vilnelė;Voverytė;5480363267;Taip;0;2;0;2
12529;Vilnelė;Voverytė;1422040758;Taip;18;0;0;18
12530;Vilnelė;Kodėlčiukas;6289991945;Taip;2;2;0;4
12531;Vilnelė;Kodėlčiukas;81657018187;Taip;0;2;0;2
12532;Vilnelė;Kodėlčiukas;1448257490;Taip;13;1;0;14
12533;Vilnelė;Kodėlčiukas;69532393507;Taip;9;1;0;10
12534;Vilnelė;Kodėlčiukas;1160794222;Taip;0;5;0;5
12535;Vilnelė;Kodėlčiukas;64950604083;Taip;0;3;0;3
12536;Vilnelė;Kodėlčiukas;99580393765;Taip;0;2;0;2
12537;Vilnelė;Kodėlčiukas;36561742487;Taip;1;2;0;3
12538;Vilnelė;Kodėlčiukas;96900970284;Taip;0;4;0;4
12539;Vilnelė;Kodėlčiukas;85391221236;Taip;5;6;0;11
12540;Vilnelė;Kodėlčiukas;39412868538;Taip;1;3;0;4
12541;Vilnelė;Kodėlčiukas;67110179640;Ne;0;7;0;7
12542;Vilnelė;Kodėlčiukas;35546482171;Taip;0;2;0;2
12543;Vilnelė;Kodėlčiukas;33652235251;Taip;1;5;0;6
12544;Vilnelė;Kodėlčiukas;32819254615;Taip;7;0;0;7
12545;Vilnelė;Kodėlčiukas;24746064267;Taip;0;1;0;1
12546;Vilnelė;Kodėlčiukas;18238619578;Taip;5;11;0;16
12547;Vilnelė;Žirniukas;3945921490;Taip;0;21;0;21
12548;Vilnelė;Žirniukas;6798728562;Taip;2;0;0;2
12549;Vilnelė;Žirniukas;3781595939;Taip;6;5;0;11
12550;Vilnelė;Žirniukas;1580287517;Taip;0;2;0;2
12551;Vilnelė;Žirniukas;9879688569;Taip;7;3;0;10
12552;Vilnelė;Žirniukas;5473379559;Taip;10;2;0;12
12553;Vilnelė;Žirniukas;1462397783;Taip;13;1;0;14
12554;Vilnelė;Žirniukas;1792586468;Taip;8;0;0;8
12555;Vilnelė;Žirniukas;8086759121;Taip;10;1;0;11
12556;Vilnelė;Žirniukas;7199490431;Taip;9;0;0;9
12557;Vilnelė;Žirniukas;4328263940;Taip;12;0;0;12
12558;Vilnelė;Žirniukas;9884955712;Taip;7;2;0;9
12559;Vilnelė;Žirniukas;2479090686;Taip;0;8;0;8
12560;Vilnelė;Pipiras;7536603663;Taip;4;4;0;8
12561;Vilnelė;Pipiras;3503461211;Taip;16;5;0;21
12562;Vilnelė;Pipiras;3993826389;Taip;0;1;0;1
12563;Vilnelė;Pipiras;7388336851;Taip;1;3;0;4
12564;Vilnelė;Pipiras;8667403338;Taip;0;4;0;4
12565;Vilnelė;Pipiras;7883724600;Taip;0;4;0;4
12566;Vilnelė;Pipiras;4166351390;Taip;13;0;0;13
12567;Vilnelė;Pipiras;1351798589;Taip;5;0;0;5
12568;Vilnelė;Pipiras;9162681538;Taip;0;2;2;4
12569;Vilnelė;Pipiras;3075681823;Taip;4;2;0;6
12570;Vilnelė;Pipiras;6342242777;Taip;1;0;0;1
12571;Vilnelė;Pipiras;3843064564;Taip;3;2;0;5
12572;Vilnelė;Pipiras;7085972543;Taip;18;0;0;18
12573;Vilnelė;Pipiras;4838684336;Taip;21;0;0;21
12574;Vėrinėlis;GAIDELIAI;4666918175;Taip;10;0;0;10
12575;Vėrinėlis;GAIDELIAI;2774618380;Taip;15;0;0;15
12576;Vėrinėlis;GAIDELIAI;5429955166;Taip;0;5;0;5
12577;Vėrinėlis;GAIDELIAI;5209398043;Taip;18;1;0;19
12578;Vėrinėlis;GAIDELIAI;1060619471;Taip;15;0;0;15
12579;Vėrinėlis;GAIDELIAI;8885866108;Taip;9;0;2;11
12580;Vėrinėlis;GAIDELIAI;8213498951;Taip;5;16;0;21
12581;Vėrinėlis;GAIDELIAI;6136232912;Taip;17;0;0;17
12582;Vėrinėlis;GAIDELIAI;7092421890;Taip;10;0;0;10
12583;Vėrinėlis;GAIDELIAI;6058712578;Taip;10;0;0;10
12584;Vėrinėlis;GAIDELIAI;6496291933;Taip;9;0;0;9
12585;Vėrinėlis;GAIDELIAI;1164396960;Taip;11;0;4;15
12586;Vėrinėlis;GAIDELIAI;8728166391;Taip;13;0;0;13
12587;Vėrinėlis;GAIDELIAI;4415030161;Taip;7;10;0;17
12588;Vėrinėlis;GAIDELIAI;8100283579;Taip;3;0;0;3
12589;Vėrinėlis;SAULUTĖ;71830611159;Taip;13;0;0;13
12590;Vėrinėlis;SAULUTĖ;6148700823;Taip;6;6;0;12
12591;Vėrinėlis;SAULUTĖ;1086306523;Ne;8;0;1;9
12592;Vėrinėlis;SAULUTĖ;11343969028;Taip;8;3;0;11
12593;Vėrinėlis;SAULUTĖ;1408704528;Taip;6;1;0;7
12594;Vėrinėlis;SAULUTĖ;1239744245;Taip;6;1;0;7
12595;Vėrinėlis;SAULUTĖ;6004379115;Taip;0;9;0;9
12596;Vėrinėlis;SAULUTĖ;39153716711;Taip;0;9;0;9
12597;Vėrinėlis;SAULUTĖ;9751494612;Taip;4;0;0;4
12598;Vėrinėlis;SAULUTĖ;1897451825;Taip;4;0;1;5
12599;Vėrinėlis;SAULUTĖ;4727265555;Taip;9;7;0;16
12600;Vėrinėlis;SAULUTĖ;1047139776;Taip;0;2;0;2
12601;Vėrinėlis;SAULUTĖ;1493604303;Taip;12;0;0;12
12602;Vėrinėlis;SAULUTĖ;5561043797;Taip;10;0;0;10
12603;Vėrinėlis;SAULUTĖ;9500715949;Taip;0;7;0;7
12604;Vėrinėlis;SAULUTĖ;1803838403;Taip;10;0;0;10
12605;Vėrinėlis;SAULUTĖ;8922728881;Taip;5;2;0;7
12606;Vėrinėlis;SAULUTĖ;84391578139;Taip;0;0;4;4
12607;Vėrinėlis;SAULUTĖ;9391697537;Taip;10;0;0;10
12608;Vėrinėlis;SAULUTĖ;7071043164;Taip;7;6;0;13
12609;Vėrinėlis;NYKŠTUKAI;7168682238;Taip;9;2;0;11
12610;Vėrinėlis;NYKŠTUKAI;668239862;Taip;0;1;0;1
12611;Vėrinėlis;NYKŠTUKAI;8197177876;Taip;12;1;1;14
12612;Vėrinėlis;NYKŠTUKAI;1518907235;Taip;9;1;0;10
12613;Vėrinėlis;NYKŠTUKAI;6065348004;Taip;2;0;4;6
12614;Vėrinėlis;NYKŠTUKAI;3563944204;Taip;7;0;0;7
12615;Vėrinėlis;NYKŠTUKAI;5238619411;Taip;0;0;1;1
12616;Vėrinėlis;NYKŠTUKAI;7436873997;Taip;15;4;0;19
12617;Vėrinėlis;NYKŠTUKAI;63333257753;Taip;3;1;0;4
12618;Vėrinėlis;NYKŠTUKAI;1592544116;Taip;0;0;2;2
12619;Vėrinėlis;NYKŠTUKAI;1261337457;Taip;7;5;4;16
12620;Vėrinėlis;NYKŠTUKAI;1804757495;Taip;0;0;1;1
12621;Vėrinėlis;NYKŠTUKAI;1029210296;Taip;1;2;0;3
12622;Vėrinėlis;NYKŠTUKAI;11459693163;Taip;0;0;1;1
12623;Vėrinėlis;NYKŠTUKAI;1295435839;Taip;0;8;0;8
12624;Vėrinėlis;NYKŠTUKAI;92480758419;Taip;0;0;5;5
12625;Vėrinėlis;NYKŠTUKAI;38428514086;Taip;10;9;0;19
12626;Vėrinėlis;NYKŠTUKAI;27431479888;Taip;1;0;0;1
12627;Vėrinėlis;NYKŠTUKAI;41029899086;Taip;4;0;2;6
12628;Vėrinėlis;NYKŠTUKAI;2001903188;Taip;3;0;0;3
12629;Vėrinėlis;NYKŠTUKAI;1251822610;Taip;19;0;0;19
12630;Vėrinėlis;BURATINAS;1001125426;Taip;0;13;0;13
12631;Vėrinėlis;BURATINAS;99734698213;Taip;0;0;3;3
12632;Vėrinėlis;BURATINAS;58909000723;Taip;0;8;0;8
12633;Vėrinėlis;BURATINAS;42875958735;Taip;0;3;0;3
12634;Vėrinėlis;BURATINAS;4541318324;Taip;9;0;0;9
12635;Vėrinėlis;BURATINAS;78121632796;Taip;0;1;2;3
12636;Vėrinėlis;BURATINAS;25734061057;Taip;13;0;0;13
12637;Vėrinėlis;BURATINAS;68027880109;Taip;9;0;0;9
12638;Vėrinėlis;BURATINAS;2676104110;Taip;8;0;0;8
12639;Vėrinėlis;BURATINAS;1876456237;Taip;0;1;0;1
12640;Vėrinėlis;BURATINAS;99325931907;Taip;0;1;0;1
12641;Vėrinėlis;BURATINAS;40706531692;Taip;1;0;2;3
12642;Vėrinėlis;BURATINAS;3044373634;Taip;0;0;2;2
12643;Vėrinėlis;BURATINAS;24888549934;Taip;0;7;0;7
12644;Vėrinėlis;BURATINAS;38831165210;Taip;0;10;0;10
12645;Vėrinėlis;BURATINAS;37600982027;Ne;0;1;0;1
12646;Vėrinėlis;BURATINAS;8978798314;Taip;0;0;11;11
12647;Vėrinėlis;BURATINAS;1953362884;Taip;15;0;0;15
12648;Vėrinėlis;BURATINAS;79317384797;Taip;0;4;0;4
12649;Vėrinėlis;GINTARĖLIAI;79005449877;Taip;0;2;0;2
12650;Vėrinėlis;GINTARĖLIAI;98927850113;Taip;5;0;0;5
12651;Vėrinėlis;GINTARĖLIAI;94043814995;Taip;4;1;0;5
12652;Vėrinėlis;GINTARĖLIAI;81355372884;Taip;0;6;2;8
12653;Vėrinėlis;GINTARĖLIAI;2241971642;Taip;0;6;0;6
12654;Vėrinėlis;GINTARĖLIAI;9935381405;Taip;0;7;0;7
12655;Vėrinėlis;GINTARĖLIAI;1039691410;Taip;0;1;0;1
12656;Vėrinėlis;GINTARĖLIAI;63357719105;Taip;0;1;0;1
12657;Vėrinėlis;GINTARĖLIAI;96157891711;Taip;0;2;0;2
12658;Vėrinėlis;GINTARĖLIAI;76043900105;Taip;0;1;0;1
12659;Vėrinėlis;GINTARĖLIAI;38154356317;Taip;0;0;1;1
12660;Vėrinėlis;GINTARĖLIAI;19538705090;Taip;4;1;0;5
12661;Vėrinėlis;GINTARĖLIAI;2023475725;Taip;0;1;0;1
12662;Vėrinėlis;RAMUNĖLĖS;65742227705;Taip;0;1;0;1
12663;Vėrinėlis;RAMUNĖLĖS;36051993269;Taip;0;1;1;2
12664;Vėrinėlis;RAMUNĖLĖS;71959077340;Taip;0;2;0;2
12665;Vėrinėlis;RAMUNĖLĖS;36922560017;Taip;9;1;0;10
12666;Vėrinėlis;RAMUNĖLĖS;22573601173;Taip;0;1;0;1
12667;Vėrinėlis;RAMUNĖLĖS;1540708366;Taip;15;1;0;16
12668;Vėrinėlis;RAMUNĖLĖS;7178943357;Taip;0;0;3;3
12669;Vėrinėlis;RAMUNĖLĖS;1292880457;Taip;12;0;0;12
12670;Vėrinėlis;RAMUNĖLĖS;41342430019;Taip;0;2;0;2
12671;Vėrinėlis;RAMUNĖLĖS;56656769188;Taip;5;1;0;6
12672;Vėrinėlis;RAMUNĖLĖS;1792855817;Taip;1;3;0;4
12673;Vėrinėlis;RAMUNĖLĖS;1979643933;Taip;1;3;0;4
12674;Vėrinėlis;RAMUNĖLĖS;1133491927;Taip;0;2;0;2
12675;Vėrinėlis;RAMUNĖLĖS;1268710930;Taip;7;1;0;8
12676;Vėrinėlis;RAMUNĖLĖS;1477336890;Taip;12;1;0;13
12677;Vėrinėlis;RAMUNĖLĖS;25415760747;Taip;5;1;1;7
12678;Vėrinėlis;KODELČIUKŲ;88831634291;Taip;14;2;0;16
12679;Vėrinėlis;KODELČIUKŲ;7561194911;Taip;0;9;0;9
12680;Vėrinėlis;KODELČIUKŲ;67977504520;Taip;0;13;0;13
12681;Vėrinėlis;KODELČIUKŲ;51807139150;Taip;11;5;0;16
12682;Vėrinėlis;KODELČIUKŲ;9955087519;Ne;11;0;1;12
12683;Vėrinėlis;KODELČIUKŲ;1129067900;Taip;0;3;0;3
12684;Vėrinėlis;KODELČIUKŲ;43944804765;Taip;6;8;0;14
12685;Vėrinėlis;KODELČIUKŲ;62639454640;Taip;7;0;0;7
12686;Vėrinėlis;KODELČIUKŲ;17400501595;Taip;0;5;0;5
12687;Vėrinėlis;KODELČIUKŲ;20342193231;Taip;0;16;0;16
12688;Vėrinėlis;KODELČIUKŲ;47633572816;Taip;10;0;2;12
12689;Vėrinėlis;KODELČIUKŲ;6088489477;Taip;0;4;0;4
12690;Vėrinėlis;KODELČIUKŲ;38040256220;Taip;0;10;0;10
12691;Vėrinėlis;KODELČIUKŲ;1481003777;Taip;1;0;0;1
12692;Vėrinėlis;KODELČIUKŲ;9930767796;Taip;0;12;0;12
12693;Vėrinėlis;KODELČIUKŲ;74375362661;Taip;0;10;0;10
12694;Vėrinėlis;KODELČIUKŲ;9889717756;Taip;13;0;0;13
12695;Vėrinėlis;KODELČIUKŲ;1680155836;Taip;0;10;0;10
12696;Vėrinėlis;ŽIRNIUKAI;3074835599;Taip;21;0;0;21
12697;Vėrinėlis;ŽIRNIUKAI;4981127515;Taip;1;0;0;1
12698;Vėrinėlis;ŽIRNIUKAI;7845985650;Taip;16;0;0;16
12699;Vėrinėlis;ŽIRNIUKAI;2815770695;Taip;3;0;0;3
12700;Vėrinėlis;ŽIRNIUKAI;9604483237;Taip;2;0;5;7
12701;Vėrinėlis;ŽIRNIUKAI;9419245081;Taip;4;0;1;5
12702;Vėrinėlis;ŽIRNIUKAI;8329989952;Taip;7;0;0;7
12703;Vėrinėlis;ŽIRNIUKAI;3202518504;Taip;21;0;0;21
12704;Vėrinėlis;ŽIRNIUKAI;8824435889;Taip;10;0;0;10
12705;Vėrinėlis;ŽIRNIUKAI;4752902173;Taip;4;0;0;4
12706;Vėrinėlis;ŽIRNIUKAI;5600815908;Taip;2;0;1;3
12707;Vėrinėlis;ŽIRNIUKAI;6779005350;Taip;3;0;1;4
12708;Vėrinėlis;ŽIRNIUKAI;7367485961;Taip;13;0;0;13
12709;Vėrinėlis;ŽIRNIUKAI;9340167973;Taip;21;0;0;21
12710;Vėrinėlis;ŽIRNIUKAI;1736733257;Taip;21;0;0;21
12711;Vėrinėlis;VARPELIAI;3316897176;Taip;0;0;1;1
12712;Vėrinėlis;VARPELIAI;3882915774;Taip;9;4;0;13
12713;Vėrinėlis;VARPELIAI;7273090217;Taip;6;0;0;6
12714;Vėrinėlis;VARPELIAI;7233139048;Taip;0;1;0;1
12715;Vėrinėlis;VARPELIAI;3130841241;Taip;13;0;0;13
12716;Vėrinėlis;VARPELIAI;6435612222;Taip;21;0;0;21
12717;Vėrinėlis;VARPELIAI;2337883071;Taip;15;0;2;17
12718;Vėrinėlis;VARPELIAI;6913001318;Taip;0;12;0;12
12719;Vėrinėlis;VARPELIAI;4728119881;Taip;20;0;0;20
12720;Vėrinėlis;VARPELIAI;7224418233;Taip;10;10;0;20
12721;Vėrinėlis;VARPELIAI;3239370561;Taip;0;0;1;1
12722;Vėrinėlis;VARPELIAI;1894717954;Taip;10;0;0;10
12723;Vėrinėlis;VARPELIAI;3667953591;Taip;15;0;0;15
12724;Vėrinėlis;VARPELIAI;8318388772;Taip;14;0;2;16
12725;Vėrinėlis;VARPELIAI;4191386053;Taip;5;0;2;7
12726;Vėrinėlis;VARPELIAI;2633143128;Taip;8;0;0;8
12727;Vėrinėlis;BORUŽĖLĖS;54666417396;Taip;0;1;0;1
12728;Vėrinėlis;BORUŽĖLĖS;57498275265;Taip;0;1;0;1
12729;Vėrinėlis;BORUŽĖLĖS;3703886468;Taip;5;0;0;5
12730;Vėrinėlis;BORUŽĖLĖS;1170817811;Taip;4;0;1;5
12731;Vėrinėlis;BORUŽĖLĖS;1410929889;Taip;0;3;0;3
12732;Vėrinėlis;BORUŽĖLĖS;65408541019;Taip;0;11;0;11
12733;Vėrinėlis;BORUŽĖLĖS;22726982138;Taip;10;0;0;10
12734;Vėrinėlis;BORUŽĖLĖS;30611731645;Taip;9;0;0;9
12735;Vėrinėlis;BORUŽĖLĖS;39884473503;Taip;6;0;1;7
12736;Vėrinėlis;BORUŽĖLĖS;25071096491;Taip;4;3;0;7
12737;Vėrinėlis;BORUŽĖLĖS;67282950717;Taip;10;0;3;13
12738;Vėrinėlis;BORUŽĖLĖS;7431541945;Taip;4;0;0;4
12739;Vėrinėlis;BORUŽĖLĖS;90264493281;Taip;0;4;0;4
12740;Vėrinėlis;BORUŽĖLĖS;89785057363;Taip;0;18;0;18
12741;Vėrinėlis;BORUŽĖLĖS;1028568095;Taip;0;6;0;6
12742;Vėrinėlis;BORUŽĖLĖS;4789626884;Taip;11;0;0;11
12743;Vėrinėlis;BORUŽĖLĖS;90979069296;Taip;8;0;2;10
12744;Vėrinėlis;BORUŽĖLĖS;67987598880;Taip;0;8;0;8
12745;Vėrinėlis;BORUŽĖLĖS;73256255966;Taip;9;0;0;9
12746;Vėrinėlis;SVEIKUOLIAI;87606501349;Taip;5;0;0;5
12747;Vėrinėlis;SVEIKUOLIAI;19865450007;Taip;10;0;0;10
12748;Vėrinėlis;SVEIKUOLIAI;6869951613;Taip;5;0;0;5
12749;Vėrinėlis;SVEIKUOLIAI;1865151493;Taip;7;0;0;7
12750;Vėrinėlis;SVEIKUOLIAI;1395590011;Taip;11;0;0;11
12751;Vėrinėlis;SVEIKUOLIAI;9751037428;Taip;0;7;0;7
12752;Vėrinėlis;SVEIKUOLIAI;1513856520;Taip;8;0;1;9
12753;Vėrinėlis;SVEIKUOLIAI;3562371502;Taip;2;0;1;3
12754;Vėrinėlis;SVEIKUOLIAI;4089567420;Taip;0;0;4;4
12755;Vėrinėlis;SVEIKUOLIAI;5960946826;Taip;0;7;0;7
12756;Vėrinėlis;SVEIKUOLIAI;5496928903;Taip;12;0;1;13
12757;Vėrinėlis;SVEIKUOLIAI;7865276052;Taip;0;0;5;5
12758;Vėrinėlis;SVEIKUOLIAI;7981261038;Taip;5;2;0;7
12759;Vėrinėlis;SVEIKUOLIAI;6278738058;Taip;8;0;0;8
12760;Vėrinėlis;SVEIKUOLIAI;5511584499;Taip;6;0;4;10
12761;Vėrinėlis;SVEIKUOLIAI;6644892686;Taip;6;7;0;13
12762;Vėrinėlis;SVEIKUOLIAI;4958359640;Taip;1;0;0;1
12763;Vėrinėlis;SVEIKUOLIAI;1338287524;Taip;0;3;0;3
12764;Vėrinėlis;ŠIRDELĖS;8579819581;Taip;10;5;0;15
12765;Vėrinėlis;ŠIRDELĖS;2944010445;Taip;3;10;0;13
12766;Vėrinėlis;ŠIRDELĖS;8195455092;Taip;4;0;0;4
12767;Vėrinėlis;ŠIRDELĖS;96779456411;Taip;0;0;3;3
12768;Vėrinėlis;ŠIRDELĖS;7167034587;Taip;5;3;0;8
12769;Vėrinėlis;ŠIRDELĖS;5712568063;Taip;0;0;4;4
12770;Vėrinėlis;ŠIRDELĖS;3049346950;Taip;13;0;4;17
12771;Vėrinėlis;ŠIRDELĖS;7070058961;Taip;12;2;0;14
12772;Vėrinėlis;ŠIRDELĖS;7130691686;Taip;5;0;2;7
12773;Vėrinėlis;ŠIRDELĖS;8709714647;Taip;0;0;5;5
12774;Vėrinėlis;ŠIRDELĖS;3308843618;Taip;5;4;0;9
12775;Vėrinėlis;ŠIRDELĖS;85262495209;Taip;0;11;0;11
12776;Vėrinėlis;ŠIRDELĖS;4039903678;Taip;12;0;0;12
12777;Vėrinėlis;ŠIRDELĖS;1467899937;Taip;0;0;6;6
12778;Vėrinėlis;ŠIRDELĖS;42298331453;Taip;6;1;0;7
12779;Vėrinėlis;ŠIRDELĖS;54361215161;Taip;0;0;1;1
12780;Vėrinėlis;ŠIRDELĖS;1135386852;Taip;20;0;0;20
12781;Vėrinėlis;ŠIRDELĖS;1535567719;Taip;10;3;0;13
12782;Viltenė;Drugeliai;7961006993;Taip;0;2;0;2
12783;Viltenė;Drugeliai;79464006792;Taip;0;13;0;13
12784;Viltenė;Drugeliai;70813966825;Taip;0;1;0;1
12785;Viltenė;Drugeliai;1936464823;Taip;5;4;0;9
12786;Viltenė;Drugeliai;50489733849;Ne;0;3;0;3
12787;Viltenė;Drugeliai;69838945768;Ne;15;0;0;15
12788;Viltenė;Drugeliai;54422258148;Taip;4;7;0;11
12789;Viltenė;Drugeliai;4322306031;Taip;0;3;0;3
12790;Viltenė;Drugeliai;82849073169;Taip;0;8;0;8
12791;Viltenė;Drugeliai;39676814294;Ne;0;13;0;13
12792;Viltenė;Drugeliai;45275376273;Taip;0;1;0;1
12793;Viltenė;Drugeliai;21489308130;Taip;4;0;0;4
12794;Viltenė;Drugeliai;91847807834;Taip;0;5;0;5
12795;Viltenė;Drugeliai;34691221253;Taip;0;5;0;5
12796;Viltenė;Drugeliai;75637599543;Taip;5;0;0;5
12797;Viltenė;Drugeliai;33159619580;Taip;5;0;0;5
12798;Viltenė;Drugeliai;4586042895;Taip;5;10;0;15
12799;Viltenė;Drugeliai;1739353382;Taip;0;4;0;4
12800;Viltenė;Bitučių;1747442313;Taip;2;14;0;16
12801;Viltenė;Bitučių;61093082990;Taip;1;4;0;5
12802;Viltenė;Bitučių;13157765051;Taip;0;8;0;8
12803;Viltenė;Bitučių;46245753187;Taip;0;5;0;5
12804;Viltenė;Bitučių;2046122804;Taip;0;7;0;7
12805;Viltenė;Bitučių;74464437862;Taip;0;2;0;2
12806;Viltenė;Bitučių;93664116601;Ne;0;4;0;4
12807;Viltenė;Bitučių;66587678111;Taip;7;0;0;7
12808;Viltenė;Bitučių;65252989761;Taip;0;5;0;5
12809;Viltenė;Bitučių;84451732377;Taip;0;1;0;1
12810;Viltenė;Bitučių;1702925444;Taip;0;5;0;5
12811;Viltenė;Bitučių;6006470515;Taip;0;1;0;1
12812;Viltenė;Bitučių;8985943715;Taip;6;2;0;8
12813;Viltenė;Bitučių;1798739406;Taip;0;1;0;1
12814;Viltenė;Bitučių;1656026241;Taip;10;1;0;11
12815;Viltenė;Bitučių;4554162475;Taip;4;0;0;4
12816;Viltenė;Bitučių;1291605426;Taip;0;7;0;7
12817;Viltenė;Bitučių;6322746293;Taip;0;9;0;9
12818;Viltenė;Bitučių;4334881910;Taip;0;12;0;12
12819;Viltenė;Boružėlių;97823483581;Taip;0;3;0;3
12820;Viltenė;Boružėlių;1657346055;Taip;0;8;0;8
12821;Viltenė;Boružėlių;24165965719;Taip;8;1;0;9
12822;Viltenė;Boružėlių;45338320216;Taip;0;3;0;3
12823;Viltenė;Boružėlių;9858448228;Taip;11;0;0;11
12824;Viltenė;Boružėlių;58371160698;Taip;0;13;0;13
12825;Viltenė;Boružėlių;50651685299;Taip;5;5;0;10
12826;Viltenė;Boružėlių;43591393680;Taip;0;3;0;3
12827;Viltenė;Boružėlių;27950438672;Taip;0;6;0;6
12828;Viltenė;Boružėlių;1963420643;Taip;0;5;0;5
12829;Viltenė;Boružėlių;4548358886;Taip;0;10;0;10
12830;Viltenė;Boružėlių;4361513192;Taip;0;1;0;1
12831;Viltenė;Gandriukų;48816849840;Taip;0;4;0;4
12832;Viltenė;Gandriukų;65109318544;Taip;5;0;0;5
12833;Viltenė;Gandriukų;64883562677;Taip;0;3;0;3
12834;Viltenė;Gandriukų;1658242811;Taip;0;1;0;1
12835;Viltenė;Gandriukų;55479966961;Taip;0;3;0;3
12836;Viltenė;Gandriukų;69267964826;Taip;6;6;2;14
12837;Viltenė;Gandriukų;15315166069;Taip;9;0;0;9
12838;Viltenė;Gandriukų;35607778200;Taip;0;2;5;7
12839;Viltenė;Gandriukų;11271646485;Taip;0;1;0;1
12840;Viltenė;Gandriukų;40901810557;Ne;0;1;0;1
12841;Viltenė;Gandriukų;33038163612;Taip;0;1;0;1
12842;Viltenė;Gandriukų;69157590882;Taip;9;0;0;9
12843;Viltenė;Gandriukų;2122259485;Taip;1;2;0;3
12844;Viltenė;Gandriukų;16356755996;Taip;0;2;0;2
12845;Viltenė;Gandriukų;50612310300;Taip;0;1;0;1
12846;Viltenė;Gandriukų;31216445971;Ne;0;1;2;3
12847;Viltenė;Gandriukų;1898136396;Taip;4;1;0;5
12848;Viltenė;Gandriukų;86027570047;Taip;4;0;0;4
12849;Viltenė;Gandriukų;98690857297;Taip;0;5;0;5
12850;Viltenė;Aitvariukai;95537304111;Taip;5;1;0;6
12851;Viltenė;Aitvariukai;95502667008;Taip;0;2;0;2
12852;Viltenė;Aitvariukai;51598096361;Taip;0;19;0;19
12853;Viltenė;Aitvariukai;15218988953;Taip;0;6;0;6
12854;Viltenė;Aitvariukai;9155192250;Taip;14;5;0;19
12855;Viltenė;Aitvariukai;9611851889;Ne;0;1;0;1
12856;Viltenė;Aitvariukai;5304966336;Taip;0;8;0;8
12857;Viltenė;Aitvariukai;3057761137;Taip;11;2;0;13
12858;Viltenė;Aitvariukai;6160715081;Taip;21;0;0;21
12859;Viltenė;Aitvariukai;5919786939;Taip;0;7;0;7
12860;Viltenė;Aitvariukai;17844870669;Taip;0;14;0;14
12861;Viltenė;Aitvariukai;56293220882;Taip;1;0;0;1
12862;Viltenė;Aitvariukai;8259812812;Taip;3;0;0;3
12863;Viltenė;Aitvariukai;23233966729;Taip;5;1;0;6
12864;Viltenė;Aitvariukai;99398043638;Taip;5;1;0;6
12865;Viltenė;Aitvariukai;1712349973;Taip;4;3;0;7
12866;Viltenė;Aitvariukai;55514676697;Taip;12;1;0;13
12867;Viltenė;Aitvariukai;14831307307;Taip;0;2;0;2
12868;Viltenė;Geniukų;1822220265;Taip;0;3;0;3
12869;Viltenė;Geniukų;9613791189;Taip;0;1;0;1
12870;Viltenė;Geniukų;6349032936;Taip;4;1;0;5
12871;Viltenė;Geniukų;7537754249;Taip;0;2;0;2
12872;Viltenė;Geniukų;1423254631;Taip;3;6;0;9
12873;Viltenė;Geniukų;3002690526;Taip;12;0;0;12
12874;Viltenė;Geniukų;6276349499;Taip;0;2;0;2
12875;Viltenė;Geniukų;3711956659;Taip;4;4;0;8
12876;Viltenė;Geniukų;1054469254;Taip;9;1;0;10
12877;Viltenė;Geniukų;4295285885;Taip;0;10;0;10
12878;Viltenė;Geniukų;6063181025;Taip;9;1;0;10
12879;Viltenė;Geniukų;1672091332;Taip;21;0;0;21
12880;Viltenė;Geniukų;9396183748;Taip;1;0;0;1
12881;Viltenė;Geniukų;3018271511;Taip;8;1;0;9
12882;Viltenė;Geniukų;49998813869;Taip;0;3;0;3
12883;Viltenė;Geniukų;3389110405;Taip;0;6;0;6
12884;Viltenė;Geniukų;4319685140;Taip;0;6;0;6
12885;Viltenė;Geniukų;6693601673;Taip;21;0;0;21
12886;Viltenė;Geniukų;8329611036;Taip;0;4;0;4
12887;Viltenė;Geniukų;8125023386;Taip;1;0;0;1
12888;Viltenė;Geniukų;8085993647;Taip;4;0;0;4
12889;Viltenė;Geniukų;9035687504;Taip;0;9;0;9
12890;Viltenė;Geniukų;5664573939;Taip;0;21;0;21
12891;Viltenė;Saulutės;2044754943;Taip;13;0;0;13
12892;Viltenė;Saulutės;6848403057;Taip;0;2;0;2
12893;Viltenė;Saulutės;1615415742;Taip;0;2;0;2
12894;Viltenė;Saulutės;9935236068;Taip;0;5;0;5
12895;Viltenė;Saulutės;2141002432;Taip;0;21;0;21
12896;Viltenė;Saulutės;1362308882;Taip;0;2;0;2
12897;Viltenė;Saulutės;8920533673;Taip;0;8;0;8
12898;Viltenė;Saulutės;5024192785;Taip;4;2;0;6
12899;Viltenė;Saulutės;92968672028;Taip;0;16;0;16
12900;Viltenė;Saulutės;3031926564;Taip;0;3;0;3
12901;Viltenė;Saulutės;1918867591;Taip;0;21;0;21
12902;Viltenė;Saulutės;1844509355;Taip;21;0;0;21
12903;Viltenė;Saulutės;7559243300;Taip;0;21;0;21
12904;Viltenė;Saulutės;3560474943;Taip;0;9;0;9
12905;Viltenė;Saulutės;2840208662;Taip;7;0;0;7
12906;Viltenė;Saulutės;2559945034;Taip;0;1;0;1
12907;Viltenė;Saulutės;2546789906;Taip;0;21;0;21
12908;Viltenė;Saulutės;3401975301;Taip;10;4;0;14
12909;Viltenė;Saulutės;9381280809;Taip;0;21;0;21
12910;Viltenė;Saulutės;9055821628;Taip;0;1;0;1
12911;Viltenė;Saulutės;9858998005;Taip;4;0;0;4
12912;Viltenė;Saulutės;7726650894;Taip;0;3;0;3
12913;Viltenė;Saulutės;3709362712;Taip;7;0;0;7
12914;Viltenė;Saulutės;1841732416;Taip;0;1;0;1
12915;Viltenė;Lapiukų;2016636764;Taip;4;1;0;5
12916;Viltenė;Lapiukų;1650304982;Taip;4;3;0;7
12917;Viltenė;Lapiukų;89844531860;Taip;4;4;0;8
12918;Viltenė;Lapiukų;8261531943;Taip;5;0;0;5
12919;Viltenė;Lapiukų;1884043126;Taip;0;4;0;4
12920;Viltenė;Lapiukų;60092202534;Taip;5;1;0;6
12921;Viltenė;Lapiukų;1559623914;Taip;0;7;0;7
12922;Viltenė;Lapiukų;1503728117;Taip;0;8;0;8
12923;Viltenė;Lapiukų;1042196397;Taip;2;5;0;7
12924;Viltenė;Lapiukų;1210824560;Taip;4;4;0;8
12925;Viltenė;Lapiukų;87698700338;Taip;0;2;0;2
12926;Viltenė;Lapiukų;3526237179;Taip;7;2;0;9
12927;Viltenė;Lapiukų;1662950901;Taip;5;1;0;6
12928;Viltenė;Lapiukų;1350487577;Taip;6;0;0;6
12929;Viltenė;Lapiukų;1592077335;Taip;0;14;0;14
12930;Viltenė;Lapiukų;1281808784;Taip;16;1;0;17
12931;Viltenė;Lapiukų;1726174128;Taip;11;2;0;13
12932;Viltenė;Lapiukų;2527648089;Taip;0;4;0;4
12933;Viltenė;Lapiukų;93894985640;Taip;9;0;0;9
12934;Viltenė;Lapiukų;3259114583;Taip;3;6;0;9
12935;Viltenė;Voveriukai;8732323660;Taip;0;1;0;1
12936;Viltenė;Voveriukai;13795858727;Ne;0;15;0;15
12937;Viltenė;Voveriukai;1306624353;Taip;4;2;0;6
12938;Viltenė;Voveriukai;41763338811;Taip;5;0;0;5
12939;Viltenė;Voveriukai;69110885244;Taip;0;5;0;5
12940;Viltenė;Voveriukai;46757944454;Taip;6;12;0;18
12941;Viltenė;Voveriukai;69918162258;Taip;0;1;0;1
12942;Viltenė;Voveriukai;76569470768;Taip;0;2;0;2
12943;Viltenė;Voveriukai;1262222404;Taip;5;0;0;5
12944;Viltenė;Voveriukai;69882566734;Taip;0;1;0;1
12945;Viltenė;Voveriukai;7245395388;Ne;0;10;0;10
12946;Viltenė;Voveriukai;46252876577;Taip;5;0;0;5
12947;Viltenė;Voveriukai;92175043385;Taip;0;2;0;2
12948;Viltenė;Voveriukai;35466181637;Taip;10;11;0;21
12949;Viltenė;Voveriukai;68243828276;Taip;0;4;0;4
12950;Viltenė;Voveriukai;1615151982;Taip;6;4;0;10
12951;Viltenė;Voveriukai;5357769446;Taip;0;10;0;10
12952;Viltenė;Voveriukai;51997485918;Ne;4;6;0;10
12953;Viltenė;Voveriukai;1872042290;Taip;3;1;0;4
12954;Viltenė;Voveriukai;2008408325;Ne;0;12;0;12
12955;Viltenė;Voveriukai;4441280059;Taip;0;3;0;3
12956;Viltenė;Triušikai;5280690534;Taip;4;0;0;4
12957;Viltenė;Triušikai;1243595112;Taip;0;1;0;1
12958;Viltenė;Triušikai;4604298036;Taip;0;3;0;3
12959;Viltenė;Triušikai;8110413064;Taip;0;3;0;3
12960;Viltenė;Triušikai;7693789849;Taip;6;13;0;19
12961;Viltenė;Triušikai;4036109404;Taip;7;0;0;7
12962;Viltenė;Triušikai;9756519374;Taip;0;21;0;21
12963;Viltenė;Triušikai;9820462941;Taip;3;0;0;3
12964;Viltenė;Triušikai;7928894276;Taip;9;1;0;10
12965;Viltenė;Triušikai;8527270437;Taip;10;0;0;10
12966;Viltenė;Triušikai;6621273812;Taip;10;0;0;10
12967;Viltenė;Triušikai;3278842582;Taip;5;0;0;5
12968;Viltenė;Triušikai;2026654467;Taip;0;9;0;9
12969;Viltenė;Triušikai;1598785483;Taip;21;0;0;21
12970;Viltenė;Triušikai;3073228245;Taip;2;0;1;3
12971;Viltenė;Triušikai;2383607612;Taip;7;0;0;7
12972;Viltenė;Triušikai;4195708756;Taip;13;5;0;18
12973;Viltenė;Triušikai;9197007374;Taip;15;0;0;15
12974;Viltenė;Triušikai;5522245968;Taip;10;0;0;10
12975;Viltenė;Kiškučiai;4945108189;Taip;2;0;0;2
12976;Viltenė;Kiškučiai;8549631247;Taip;12;2;0;14
12977;Viltenė;Kiškučiai;2884698447;Taip;0;8;0;8
12978;Viltenė;Kiškučiai;6481491422;Taip;0;2;0;2
12979;Viltenė;Kiškučiai;7092857844;Taip;7;1;0;8
12980;Viltenė;Kiškučiai;1126409020;Taip;0;8;0;8
12981;Viltenė;Kiškučiai;9228677568;Taip;6;4;0;10
12982;Viltenė;Kiškučiai;1840626621;Taip;3;1;0;4
12983;Viltenė;Kiškučiai;2815105107;Taip;0;1;0;1
12984;Viltenė;Kiškučiai;6511850468;Taip;2;7;0;9
12985;Viltenė;Kiškučiai;8477241365;Taip;1;0;0;1
12986;Viltenė;Kiškučiai;5850652322;Taip;2;6;0;8
12987;Viltenė;Kiškučiai;9187671201;Taip;3;1;0;4
12988;Viltenė;Kiškučiai;8840885039;Taip;18;0;0;18
12989;Viltenė;Kiškučiai;4616047113;Taip;4;1;0;5
12990;Viltenė;Kiškučiai;6060648988;Taip;17;3;0;20
12991;Viltenė;Nykštukų;4003018966;Taip;7;0;0;7
12992;Viltenė;Nykštukų;7912396297;Taip;6;2;0;8
12993;Viltenė;Nykštukų;3738838707;Taip;5;0;0;5
12994;Viltenė;Nykštukų;3777544301;Taip;6;0;1;7
12995;Viltenė;Nykštukų;9597857664;Taip;10;0;0;10
12996;Viltenė;Nykštukų;9572407405;Taip;5;0;0;5
12997;Viltenė;Nykštukų;8473588098;Taip;10;7;0;17
12998;Viltenė;Nykštukų;3995418079;Taip;13;0;0;13
12999;Viltenė;Nykštukų;1399653129;Taip;13;0;2;15
13000;Viltenė;Nykštukų;4121448859;Taip;11;0;0;11
13001;Viltenė;Nykštukų;5599943846;Taip;19;0;0;19
13002;Viltenė;Nykštukų;3164402142;Taip;9;0;0;9
13003;Viltenė;Nykštukų;8603418399;Taip;14;0;0;14
13004;Viltenė;Nykštukų;5379804362;Taip;0;0;1;1
13005;Viltenė;Nykštukų;1936628249;Taip;10;0;0;10
13006;Viltenė;Nykštukų;6721689684;Taip;13;1;0;14
13007;Viltenė;Nykštukų;2585198498;Taip;3;0;0;3
13008;Viltenė;Nykštukų;7526555727;Taip;5;0;1;6
13009;Viltenė;Nykštukų;5552217000;Taip;4;0;0;4
13010;Voveraitė;ŽVIRBLIUKŲ;63276868064;Taip;0;1;0;1
13011;Voveraitė;ŽVIRBLIUKŲ;12366200545;Taip;0;1;0;1
13012;Voveraitė;ŽVIRBLIUKŲ;34170702690;Taip;0;2;0;2
13013;Voveraitė;ŽVIRBLIUKŲ;37044398892;Taip;0;1;0;1
13014;Voveraitė;ŽVIRBLIUKŲ;90970378921;Taip;0;1;0;1
13015;Voveraitė;ŽVIRBLIUKŲ;6903776113;Taip;0;5;0;5
13016;Voveraitė;ŽVIRBLIUKŲ;15716865051;Ne;0;4;0;4
13017;Voveraitė;ŽVIRBLIUKŲ;14865004407;Taip;1;1;0;2
13018;Voveraitė;ŽVIRBLIUKŲ;39956224681;Taip;11;2;0;13
13019;Voveraitė;ŽVIRBLIUKŲ;1261834247;Taip;0;10;0;10
13020;Voveraitė;ŽVIRBLIUKŲ;1055423524;Taip;0;1;0;1
13021;Voveraitė;ŽVIRBLIUKŲ;65838266846;Taip;0;1;0;1
13022;Voveraitė;ŽVIRBLIUKŲ;69198613700;Taip;0;3;0;3
13023;Voveraitė;ŽVIRBLIUKŲ;5357569948;Taip;0;8;0;8
13024;Voveraitė;VOVERIUKŲ;26264960973;Taip;4;3;0;7
13025;Voveraitė;VOVERIUKŲ;46318035221;Taip;0;1;0;1
13026;Voveraitė;VOVERIUKŲ;3818120898;Taip;10;8;0;18
13027;Voveraitė;VOVERIUKŲ;57033218205;Taip;1;5;0;6
13028;Voveraitė;VOVERIUKŲ;64724933885;Taip;2;4;0;6
13029;Voveraitė;VOVERIUKŲ;1587569563;Taip;0;3;0;3
13030;Voveraitė;VOVERIUKŲ;89873985894;Taip;0;3;0;3
13031;Voveraitė;VOVERIUKŲ;89216481616;Taip;0;1;0;1
13032;Voveraitė;VOVERIUKŲ;69797506996;Taip;5;2;0;7
13033;Voveraitė;VOVERIUKŲ;76074825733;Taip;0;1;0;1
13034;Voveraitė;VOVERIUKŲ;49205285378;Taip;2;6;0;8
13035;Voveraitė;VOVERIUKŲ;84508228457;Taip;1;11;0;12
13036;Voveraitė;VOVERIUKŲ;61376515242;Taip;0;2;0;2
13037;Voveraitė;VOVERIUKŲ;47111956594;Taip;5;7;0;12
13038;Voveraitė;VOVERIUKŲ;22913200509;Taip;0;1;0;1
13039;Voveraitė;VOVERIUKŲ;26080915874;Taip;10;3;0;13
13040;Voveraitė;VOVERIUKŲ;59442802443;Taip;7;3;0;10
13041;Voveraitė;VOVERIUKŲ;1398043988;Taip;4;1;0;5
13042;Voveraitė;VOVERIUKŲ;53801893219;Taip;7;7;0;14
13043;Voveraitė;KIŠKUČIŲ;3615729576;Ne;0;1;0;1
13044;Voveraitė;KIŠKUČIŲ;9231751171;Taip;0;3;0;3
13045;Voveraitė;KIŠKUČIŲ;4338861332;Taip;0;2;0;2
13046;Voveraitė;KIŠKUČIŲ;9933037872;Taip;3;0;0;3
13047;Voveraitė;KIŠKUČIŲ;3113780055;Taip;8;0;0;8
13048;Voveraitė;KIŠKUČIŲ;65926130735;Taip;9;0;0;9
13049;Voveraitė;KIŠKUČIŲ;7069780513;Taip;0;4;0;4
13050;Voveraitė;KIŠKUČIŲ;9997346812;Taip;5;7;0;12
13051;Voveraitė;KIŠKUČIŲ;9703726869;Taip;5;0;0;5
13052;Voveraitė;KIŠKUČIŲ;7314148938;Taip;5;2;0;7
13053;Voveraitė;KIŠKUČIŲ;4511771924;Taip;5;2;0;7
13054;Voveraitė;KIŠKUČIŲ;5521756833;Taip;21;0;0;21
13055;Voveraitė;KIŠKUČIŲ;9007031372;Taip;3;3;0;6
13056;Voveraitė;KIŠKUČIŲ;6649068571;Taip;10;0;0;10
13057;Voveraitė;KIŠKUČIŲ;1775800865;Taip;0;5;0;5
13058;Voveraitė;KIŠKUČIŲ;6433760749;Taip;0;2;0;2
13059;Voveraitė;KODĖLČIUKŲ;3469734853;Taip;5;0;3;8
13060;Voveraitė;KODĖLČIUKŲ;5467979968;Taip;12;0;0;12
13061;Voveraitė;KODĖLČIUKŲ;1772758517;Taip;3;2;0;5
13062;Voveraitė;KODĖLČIUKŲ;9431523085;Taip;0;2;0;2
13063;Voveraitė;KODĖLČIUKŲ;51213803814;Taip;0;1;0;1
13064;Voveraitė;KODĖLČIUKŲ;36749754999;Taip;0;3;1;4
13065;Voveraitė;KODĖLČIUKŲ;6653141009;Taip;6;0;1;7
13066;Voveraitė;KODĖLČIUKŲ;4045121781;Taip;7;3;0;10
13067;Voveraitė;KODĖLČIUKŲ;2304004487;Taip;3;0;0;3
13068;Voveraitė;KODĖLČIUKŲ;7744504020;Taip;14;0;0;14
13069;Voveraitė;KODĖLČIUKŲ;2208396431;Taip;0;4;0;4
13070;Voveraitė;KODĖLČIUKŲ;6361417566;Taip;6;0;2;8
13071;Voveraitė;KODĖLČIUKŲ;5296850349;Taip;15;6;0;21
13072;Voveraitė;KODĖLČIUKŲ;2763656717;Taip;0;0;8;8
13073;Voveraitė;KODĖLČIUKŲ;4468214107;Taip;16;0;1;17
13074;Voveraitė;KODĖLČIUKŲ;9921313716;Taip;3;0;3;6
13075;Voveraitė;KODĖLČIUKŲ;5449490074;Taip;10;0;4;14
13076;Voveraitė;KODĖLČIUKŲ;7786378018;Taip;0;0;8;8
13077;Voveraitė;MEŠKIUKŲ;4079618555;Taip;10;1;0;11
13078;Voveraitė;MEŠKIUKŲ;3381417855;Taip;5;1;0;6
13079;Voveraitė;MEŠKIUKŲ;3703062195;Taip;7;0;0;7
13080;Voveraitė;MEŠKIUKŲ;8438876806;Taip;0;6;0;6
13081;Voveraitė;MEŠKIUKŲ;1058273156;Taip;7;3;0;10
13082;Voveraitė;MEŠKIUKŲ;9149748841;Taip;0;2;0;2
13083;Voveraitė;MEŠKIUKŲ;5576058454;Taip;8;0;0;8
13084;Voveraitė;MEŠKIUKŲ;1629942114;Taip;0;1;0;1
13085;Voveraitė;MEŠKIUKŲ;17534618616;Taip;0;3;0;3
13086;Voveraitė;MEŠKIUKŲ;1592633500;Taip;7;5;0;12
13087;Voveraitė;MEŠKIUKŲ;5437283673;Taip;6;2;0;8
13088;Voveraitė;MEŠKIUKŲ;7797966139;Taip;6;9;0;15
13089;Voveraitė;MEŠKIUKŲ;3029983180;Taip;0;4;0;4
13090;Voveraitė;MEŠKIUKŲ;9900940313;Taip;0;4;0;4
13091;Voveraitė;MEŠKIUKŲ;4680264973;Taip;7;5;0;12
13092;Voveraitė;MEŠKIUKŲ;5095849577;Taip;10;1;0;11
13093;Voveraitė;MEŠKIUKŲ;6886337758;Taip;8;9;0;17
13094;Voveraitė;BORUŽĖLIŲ;28598946561;Taip;10;1;0;11
13095;Voveraitė;BORUŽĖLIŲ;97620560960;Ne;0;1;0;1
13096;Voveraitė;BORUŽĖLIŲ;81073619227;Taip;0;2;0;2
13097;Voveraitė;BORUŽĖLIŲ;77602038332;Taip;0;6;0;6
13098;Voveraitė;BORUŽĖLIŲ;66403987802;Taip;0;6;0;6
13099;Voveraitė;BORUŽĖLIŲ;89152921324;Taip;0;7;0;7
13100;Voveraitė;BORUŽĖLIŲ;34369856708;Taip;0;1;0;1
13101;Voveraitė;BORUŽĖLIŲ;97109418554;Taip;0;9;0;9
13102;Voveraitė;BORUŽĖLIŲ;90671659606;Taip;0;5;0;5
13103;Voveraitė;BORUŽĖLIŲ;45746249613;Taip;0;1;0;1
13104;Voveraitė;BORUŽĖLIŲ;32041841165;Taip;0;2;0;2
13105;Voveraitė;BORUŽĖLIŲ;33234062327;Taip;0;7;0;7
13106;Voveraitė;BORUŽĖLIŲ;4440929639;Taip;0;2;0;2
13107;Voveraitė;BORUŽĖLIŲ;14945425849;Taip;0;4;0;4
13108;Voveraitė;BORUŽĖLIŲ;63634109515;Taip;0;1;0;1
13109;Voveraitė;BORUŽĖLIŲ;47199214035;Ne;0;0;3;3
13110;Voveraitė;BORUŽĖLIŲ;31214112756;Taip;4;2;0;6
13111;Voveraitė;BORUŽĖLIŲ;36024562927;Taip;0;1;0;1
13112;Voveraitė;BORUŽĖLIŲ;9288862466;Taip;4;3;0;7
13113;Voveraitė;PELĖDŽIUKŲ;59718931996;Taip;6;3;0;9
13114;Voveraitė;PELĖDŽIUKŲ;86565940690;Taip;0;3;0;3
13115;Voveraitė;PELĖDŽIUKŲ;2611108856;Taip;0;4;0;4
13116;Voveraitė;PELĖDŽIUKŲ;2009943498;Taip;0;2;0;2
13117;Voveraitė;PELĖDŽIUKŲ;6947553594;Taip;0;2;0;2
13118;Voveraitė;PELĖDŽIUKŲ;3114586597;Taip;0;5;0;5
13119;Voveraitė;PELĖDŽIUKŲ;74161507529;Ne;0;1;0;1
13120;Voveraitė;PELĖDŽIUKŲ;85594406820;Taip;5;1;0;6
13121;Voveraitė;PELĖDŽIUKŲ;30591405375;Taip;10;5;0;15
13122;Voveraitė;PELĖDŽIUKŲ;42683378356;Taip;3;0;0;3
13123;Voveraitė;PELĖDŽIUKŲ;12670469264;Taip;0;8;0;8
13124;Voveraitė;PELĖDŽIUKŲ;5232316253;Taip;0;4;0;4
13125;Voveraitė;PELĖDŽIUKŲ;32030461873;Taip;0;3;0;3
13126;Voveraitė;PELĖDŽIUKŲ;1273652060;Taip;5;1;0;6
13127;Voveraitė;PELĖDŽIUKŲ;68050017530;Taip;11;3;0;14
13128;Voveraitė;DRUGELIŲ;9623406874;Taip;5;8;0;13
13129;Voveraitė;DRUGELIŲ;1753442884;Taip;6;6;0;12
13130;Voveraitė;DRUGELIŲ;7974406524;Taip;5;8;0;13
13131;Voveraitė;DRUGELIŲ;1032086466;Taip;0;3;0;3
13132;Voveraitė;DRUGELIŲ;2711136945;Taip;0;5;0;5
13133;Voveraitė;DRUGELIŲ;81628846458;Taip;1;0;0;1
13134;Voveraitė;DRUGELIŲ;2044914624;Taip;6;7;0;13
13135;Voveraitė;DRUGELIŲ;2031078156;Taip;0;1;0;1
13136;Voveraitė;DRUGELIŲ;80330740714;Taip;11;0;0;11
13137;Voveraitė;DRUGELIŲ;6729475469;Taip;0;6;0;6
13138;Voveraitė;DRUGELIŲ;1397274691;Taip;13;6;0;19
13139;Voveraitė;DRUGELIŲ;1612322367;Taip;0;3;0;3
13140;Voveraitė;DRUGELIŲ;6847620019;Taip;0;14;0;14
13141;Voveraitė;DRUGELIŲ;53507758884;Taip;0;2;0;2
13142;Voveraitė;DRUGELIŲ;1780573926;Taip;7;1;0;8
13143;Voveraitė;DRUGELIŲ;8443005812;Taip;5;1;0;6
13144;Voveraitė;NYKŠTUKŲ;59346262217;Taip;4;10;0;14
13145;Voveraitė;NYKŠTUKŲ;44115826781;Taip;0;2;1;3
13146;Voveraitė;NYKŠTUKŲ;67851579200;Taip;0;11;0;11
13147;Voveraitė;NYKŠTUKŲ;28656009009;Taip;7;3;0;10
13148;Voveraitė;NYKŠTUKŲ;1704834744;Taip;6;0;0;6
13149;Voveraitė;NYKŠTUKŲ;35549553867;Taip;4;0;0;4
13150;Voveraitė;NYKŠTUKŲ;49924157014;Taip;0;1;0;1
13151;Voveraitė;NYKŠTUKŲ;41182124889;Taip;0;3;0;3
13152;Voveraitė;NYKŠTUKŲ;13173711840;Taip;6;5;0;11
13153;Voveraitė;NYKŠTUKŲ;602726070;Taip;0;4;0;4
13154;Voveraitė;NYKŠTUKŲ;27132982320;Taip;3;1;0;4
13155;Voveraitė;NYKŠTUKŲ;107968318;Taip;12;1;0;13
13156;Voveraitė;NYKŠTUKŲ;2762066479;Taip;0;2;0;2
13157;Voveraitė;NYKŠTUKŲ;66612277823;Taip;5;5;0;10
13158;Voveraitė;NYKŠTUKŲ;82642244788;Taip;6;4;0;10
13159;Voveraitė;NYKŠTUKŲ;1022447432;Taip;4;11;0;15
13160;Voveraitė;NYKŠTUKŲ;8666880821;Taip;0;5;0;5
13161;Voveraitė;NYKŠTUKŲ;2051732666;Taip;4;6;0;10
13162;Voveraitė;GENIUKŲ;23764078403;Taip;0;1;0;1
13163;Voveraitė;GENIUKŲ;78138420154;Taip;10;1;0;11
13164;Voveraitė;GENIUKŲ;18103338554;Taip;0;4;0;4
13165;Voveraitė;GENIUKŲ;3092390110;Taip;6;1;0;7
13166;Voveraitė;GENIUKŲ;6272832397;Taip;0;12;0;12
13167;Voveraitė;GENIUKŲ;90596813791;Taip;0;6;0;6
13168;Voveraitė;GENIUKŲ;1281767120;Taip;0;3;0;3
13169;Voveraitė;GENIUKŲ;69003610735;Taip;0;2;0;2
13170;Voveraitė;GENIUKŲ;1279597695;Taip;0;9;0;9
13171;Voveraitė;GENIUKŲ;59078135624;Taip;0;8;0;8
13172;Voveraitė;GENIUKŲ;57470452892;Taip;0;1;0;1
13173;Voveraitė;GENIUKŲ;67618706684;Taip;0;14;0;14
13174;Voveraitė;GENIUKŲ;50076604267;Taip;0;5;0;5
13175;Voveraitė;LAPIUKŲ;8925151080;Taip;3;0;0;3
13176;Voveraitė;LAPIUKŲ;4300235743;Taip;10;1;2;13
13177;Voveraitė;LAPIUKŲ;6684234832;Taip;16;0;0;16
13178;Voveraitė;LAPIUKŲ;9715405072;Taip;0;6;0;6
13179;Voveraitė;LAPIUKŲ;1441921029;Taip;9;0;0;9
13180;Voveraitė;LAPIUKŲ;8119493388;Taip;6;0;1;7
13181;Voveraitė;LAPIUKŲ;5804351872;Taip;5;0;1;6
13182;Voveraitė;LAPIUKŲ;2450726148;Taip;20;1;0;21
13183;Voveraitė;LAPIUKŲ;7531020548;Taip;0;9;0;9
13184;Voveraitė;LAPIUKŲ;7244142828;Taip;0;16;0;16
13185;Voveraitė;LAPIUKŲ;5510544648;Taip;3;0;8;11
13186;Voveraitė;LAPIUKŲ;3582805599;Taip;7;1;0;8
13187;Voveraitė;LAPIUKŲ;6994680282;Taip;13;0;0;13
13188;Voveraitė;LAPIUKŲ;5705303891;Taip;13;0;0;13
13189;Voveraitė;LAPIUKŲ;6959751328;Taip;0;0;3;3
13190;Voveraitė;EŽIUKŲ;8373093305;Taip;2;1;0;3
13191;Voveraitė;EŽIUKŲ;2246291631;Taip;11;2;0;13
13192;Voveraitė;EŽIUKŲ;4324619869;Taip;3;5;0;8
13193;Voveraitė;EŽIUKŲ;1960385335;Taip;13;5;0;18
13194;Voveraitė;EŽIUKŲ;2322594823;Taip;21;0;0;21
13195;Voveraitė;EŽIUKŲ;6007396459;Taip;13;0;0;13
13196;Voveraitė;EŽIUKŲ;6073270223;Taip;10;0;0;10
13197;Voveraitė;EŽIUKŲ;2662384275;Taip;4;2;0;6
13198;Voveraitė;EŽIUKŲ;4563198733;Taip;13;1;0;14
13199;Voveraitė;EŽIUKŲ;7746424196;Taip;0;5;0;5
13200;Voveraitė;EŽIUKŲ;2594535017;Taip;7;1;0;8
13201;Voveraitė;EŽIUKŲ;9912862474;Taip;7;7;0;14
13202;Voveraitė;EŽIUKŲ;1340379090;Taip;4;4;0;8
13203;Voveraitė;EŽIUKŲ;5138855000;Taip;10;3;0;13
13204;Voveraitė;EŽIUKŲ;9195700962;Taip;0;17;0;17
13205;Voveraitė;EŽIUKŲ;1515087924;Taip;0;5;0;5
13206;"Trakų Vokė";Voveriukų;7858812338;Taip;0;10;0;10
13207;"Trakų Vokė";Voveriukų;2730385281;Taip;10;0;0;10
13208;"Trakų Vokė";Voveriukų;4854440884;Taip;21;0;0;21
13209;"Trakų Vokė";Voveriukų;2761614687;Taip;21;0;0;21
13210;"Trakų Vokė";Voveriukų;6234943180;Taip;8;0;2;10
13211;"Trakų Vokė";Voveriukų;5909584565;Taip;8;0;2;10
13212;"Trakų Vokė";Voveriukų;3913623741;Taip;0;0;11;11
13213;"Trakų Vokė";Voveriukų;6732422645;Taip;5;0;1;6
13214;"Trakų Vokė";Voveriukų;2516219363;Taip;5;0;0;5
13215;"Trakų Vokė";Voveriukų;3209594216;Taip;10;0;1;11
13216;"Trakų Vokė";Voveriukų;5338798362;Taip;11;0;5;16
13217;"Trakų Vokė";Voveriukų;6326568445;Taip;13;0;1;14
13218;"Trakų Vokė";Voveriukų;4040038648;Taip;16;1;0;17
13219;"Trakų Vokė";Voveriukų;3319243283;Taip;10;0;0;10
13220;"Trakų Vokė";Voveriukų;7727246187;Taip;5;1;3;9
13221;"Trakų Vokė";Voveriukų;3611639112;Taip;8;0;4;12
13222;"Trakų Vokė";Voveriukų;5206616285;Taip;17;0;0;17
13223;"Trakų Vokė";Boružėlių;1100961040;Taip;0;8;3;11
13224;"Trakų Vokė";Boružėlių;71993634591;Taip;0;0;1;1
13225;"Trakų Vokė";Boružėlių;1809637955;Taip;0;4;0;4
13226;"Trakų Vokė";Boružėlių;32336388708;Taip;0;9;0;9
13227;"Trakų Vokė";Boružėlių;76399539244;Taip;0;7;0;7
13228;"Trakų Vokė";Boružėlių;39658854196;Taip;1;0;0;1
13229;"Trakų Vokė";Boružėlių;92262591306;Taip;0;0;2;2
13230;"Trakų Vokė";Boružėlių;37080835526;Taip;0;8;0;8
13231;"Trakų Vokė";Boružėlių;9642375918;Taip;0;3;0;3
13232;"Trakų Vokė";Boružėlių;89851471527;Taip;11;6;0;17
13233;"Trakų Vokė";Boružėlių;96632696431;Taip;20;0;0;20
13234;"Trakų Vokė";Boružėlių;43780546254;Taip;0;4;0;4
13235;"Trakų Vokė";Boružėlių;66607811394;Taip;8;0;1;9
13236;"Trakų Vokė";Boružėlių;66867557436;Taip;2;0;2;4
13237;"Trakų Vokė";Boružėlių;68968521202;Taip;5;1;0;6
13238;"Trakų Vokė";Boružėlių;95403241312;Taip;8;2;0;10
13239;"Trakų Vokė";Boružėlių;1837766168;Taip;0;4;0;4
13240;"Trakų Vokė";Boružėlių;1858168427;Taip;0;4;0;4
13241;"Trakų Vokė";Boružėlių;49616069190;Taip;5;2;0;7
13242;"Trakų Vokė";Boružėlių;4409993300;Taip;7;0;3;10
13243;"Trakų Vokė";Boružėlių;2466258377;Ne;0;6;3;9
13244;"Trakų Vokė";BITUTUČIŲ;4903261568;Taip;5;6;1;12
13245;"Trakų Vokė";BITUTUČIŲ;1461337199;Taip;0;0;2;2
13246;"Trakų Vokė";BITUTUČIŲ;7792654474;Taip;7;0;0;7
13247;"Trakų Vokė";BITUTUČIŲ;39255784762;Taip;7;0;0;7
13248;"Trakų Vokė";BITUTUČIŲ;50553766116;Taip;6;0;0;6
13249;"Trakų Vokė";BITUTUČIŲ;1433982328;Taip;6;0;2;8
13250;"Trakų Vokė";BITUTUČIŲ;2918937134;Taip;0;0;1;1
13251;"Trakų Vokė";BITUTUČIŲ;8542147751;Taip;5;0;0;5
13252;"Trakų Vokė";BITUTUČIŲ;1623166260;Taip;0;0;3;3
13253;"Trakų Vokė";BITUTUČIŲ;3406479364;Taip;0;3;0;3
13254;"Trakų Vokė";BITUTUČIŲ;1339594734;Taip;10;0;0;10
13255;"Trakų Vokė";BITUTUČIŲ;5526830430;Taip;6;0;2;8
13256;"Trakų Vokė";BITUTUČIŲ;4914675622;Taip;0;0;2;2
13257;"Trakų Vokė";BITUTUČIŲ;1590598232;Taip;16;0;0;16
13258;"Trakų Vokė";BITUTUČIŲ;3373764541;Taip;15;0;0;15
13259;"Trakų Vokė";BITUTUČIŲ;2839396687;Taip;0;0;4;4
13260;"Trakų Vokė";BITUTUČIŲ;4849992906;Taip;1;7;0;8
13261;"Trakų Vokė";BITUTUČIŲ;8857529726;Taip;0;0;4;4
13262;"Trakų Vokė";BITUTUČIŲ;6221283878;Taip;7;0;1;8
13263;"Trakų Vokė";BITUTUČIŲ;7566567901;Taip;5;0;3;8
13264;"Trakų Vokė";BITUTUČIŲ;3098390989;Taip;21;0;0;21
13265;"Trakų Vokė";BITUTUČIŲ;8997890367;Taip;10;0;0;10
13266;"Trakų Vokė";KIŠKUČIŲ;15897808544;Taip;0;0;11;11
13267;"Trakų Vokė";KIŠKUČIŲ;6675993703;Taip;6;0;3;9
13268;"Trakų Vokė";KIŠKUČIŲ;69866048102;Taip;0;0;6;6
13269;"Trakų Vokė";KIŠKUČIŲ;64083541565;Taip;2;0;3;5
13270;"Trakų Vokė";KIŠKUČIŲ;67434532111;Taip;0;15;0;15
13271;"Trakų Vokė";KIŠKUČIŲ;26598573711;Taip;0;0;2;2
13272;"Trakų Vokė";KIŠKUČIŲ;69311478204;Taip;4;0;0;4
13273;"Trakų Vokė";KIŠKUČIŲ;71417288063;Taip;0;0;11;11
13274;"Trakų Vokė";KIŠKUČIŲ;40200309769;Taip;7;0;2;9
13275;"Trakų Vokė";KIŠKUČIŲ;9705561511;Taip;13;0;0;13
13276;"Trakų Vokė";KIŠKUČIŲ;44023296535;Taip;11;6;0;17
13277;"Trakų Vokė";KIŠKUČIŲ;6418198934;Taip;12;0;0;12
13278;"Trakų Vokė";KIŠKUČIŲ;50697040061;Taip;17;0;1;18
13279;"Trakų Vokė";KIŠKUČIŲ;9135918587;Taip;0;0;2;2
13280;"Trakų Vokė";KIŠKUČIŲ;6362889550;Taip;16;0;1;17
13281;"Trakų Vokė";KIŠKUČIŲ;64019248229;Taip;0;0;1;1
13282;"Trakų Vokė";KIŠKUČIŲ;18796898215;Taip;9;0;3;12
13283;"Trakų Vokė";KIŠKUČIŲ;86504089176;Taip;0;0;5;5
13284;"Trakų Vokė";KIŠKUČIŲ;21329819892;Taip;0;1;0;1
13285;"Trakų Vokė";KIŠKUČIŲ;3210453801;Taip;0;2;9;11
13286;"Trakų Vokė";KIŠKUČIŲ;7753488216;Taip;6;0;7;13
13287;Zylutė;Katerok;62853712925;Taip;10;0;0;10
13288;Zylutė;Katerok;27007947432;Taip;0;3;0;3
13289;Zylutė;Katerok;54983937726;Taip;20;0;0;20
13290;Zylutė;Katerok;39472285691;Taip;0;6;0;6
13291;Zylutė;Katerok;43987426917;Taip;0;10;0;10
13292;Zylutė;Katerok;33326400213;Taip;8;2;0;10
13293;Zylutė;Katerok;86433183983;Taip;0;5;0;5
13294;Zylutė;Katerok;76259638454;Taip;0;2;0;2
13295;Zylutė;Katerok;54959972125;Ne;9;6;0;15
13296;Zylutė;Katerok;80556519366;Taip;0;4;0;4
13297;Zylutė;Katerok;1948356081;Taip;0;4;0;4
13298;Zylutė;Katerok;53283282669;Taip;6;0;8;14
13299;Zylutė;Katerok;91534371407;Taip;3;0;5;8
13300;Zylutė;Katerok;79923744237;Ne;0;7;0;7
13301;Zylutė;Katerok;58190315728;Taip;4;0;0;4
13302;Zylutė;Katerok;58045325209;Taip;0;1;0;1
13303;Zylutė;Katerok;1005572131;Taip;0;0;2;2
13304;Zylutė;"Vesole misiaki";15597884044;Taip;0;1;0;1
13305;Zylutė;"Vesole misiaki";84947394033;Taip;0;2;0;2
13306;Zylutė;"Vesole misiaki";52918539110;Taip;5;0;0;5
13307;Zylutė;"Vesole misiaki";66338689682;Taip;0;1;0;1
13308;Zylutė;"Vesole misiaki";5323116194;Taip;0;4;0;4
13309;Zylutė;"Vesole misiaki";74314676598;Taip;0;5;0;5
13310;Zylutė;"Vesole misiaki";1911748280;Taip;10;0;0;10
13311;Zylutė;"Vesole misiaki";62887824954;Taip;5;0;0;5
13312;Zylutė;"Vesole misiaki";86301183281;Taip;0;4;0;4
13313;Zylutė;"Vesole misiaki";1623576857;Taip;0;1;0;1
13314;Zylutė;"Vesole misiaki";43690245314;Taip;0;1;0;1
13315;Zylutė;"Vesole misiaki";1256879956;Taip;10;0;0;10
13316;Zylutė;"Vesole misiaki";3126726854;Taip;0;4;0;4
13317;Zylutė;"Vesole misiaki";9484752315;Taip;4;3;0;7
13318;Zylutė;"Vesole misiaki";7140223126;Taip;5;7;0;12
13319;Zylutė;"Vesole misiaki";81796510706;Taip;21;0;0;21
13320;Zylutė;"Vesole misiaki";7606434084;Taip;13;1;0;14
13321;Zylutė;"Vesole misiaki";6299191475;Taip;10;8;0;18
13322;Zylutė;NYKŠTUKAI;88823731584;Ne;0;2;0;2
13323;Zylutė;NYKŠTUKAI;91938227358;Taip;13;5;0;18
13324;Zylutė;NYKŠTUKAI;55672880453;Taip;0;5;3;8
13325;Zylutė;NYKŠTUKAI;63798640792;Taip;6;1;0;7
13326;Zylutė;NYKŠTUKAI;19429820228;Taip;6;1;0;7
13327;Zylutė;NYKŠTUKAI;89083249598;Taip;1;0;0;1
13328;Zylutė;NYKŠTUKAI;53165044678;Taip;0;0;1;1
13329;Zylutė;NYKŠTUKAI;42712894954;Taip;0;2;0;2
13330;Zylutė;NYKŠTUKAI;87231809477;Taip;0;0;6;6
13331;Zylutė;NYKŠTUKAI;1584743051;Taip;6;0;0;6
13332;Zylutė;NYKŠTUKAI;55136247841;Taip;0;0;2;2
13333;Zylutė;NYKŠTUKAI;2276463136;Taip;5;0;1;6
13334;Zylutė;NYKŠTUKAI;7042731356;Taip;5;0;0;5
13335;Zylutė;NYKŠTUKAI;27488840113;Taip;8;1;0;9
13336;Zylutė;NYKŠTUKAI;35300054087;Taip;0;1;0;1
13337;Zylutė;NYKŠTUKAI;15110117571;Taip;15;1;0;16
13338;Zylutė;NYKŠTUKAI;3246229837;Taip;19;0;0;19
13339;Zylutė;Ručijok;9913001904;Taip;0;5;0;5
13340;Zylutė;Ručijok;4415020772;Taip;1;0;0;1
13341;Zylutė;Ručijok;6221528830;Taip;10;2;0;12
13342;Zylutė;Ručijok;3117948118;Taip;0;10;0;10
13343;Zylutė;Ručijok;7241045507;Taip;10;0;0;10
13344;Zylutė;Ručijok;3826815202;Taip;8;0;0;8
13345;Zylutė;Ručijok;3943002728;Taip;18;0;0;18
13346;Zylutė;Ručijok;9381656201;Taip;0;7;0;7
13347;Zylutė;Ručijok;2654373943;Taip;16;1;0;17
13348;Zylutė;Ručijok;9325387975;Taip;0;9;0;9
13349;Zylutė;Ručijok;4497904128;Taip;9;8;0;17
13350;Zylutė;Ručijok;1423890598;Taip;8;0;0;8
13351;Zylutė;Ručijok;5264930854;Taip;0;13;0;13
13352;Zylutė;Ručijok;6569135467;Taip;8;0;1;9
13353;Zylutė;Ručijok;3363212754;Taip;0;0;10;10
13354;Zylutė;Raduga;1598044320;Taip;0;1;0;1
13355;Zylutė;Raduga;1756267879;Taip;4;0;0;4
13356;Zylutė;Raduga;42101273435;Taip;1;0;0;1
13357;Zylutė;Raduga;71494345484;Taip;0;4;0;4
13358;Zylutė;Raduga;24566804095;Taip;0;9;0;9
13359;Zylutė;Raduga;27116746304;Taip;0;10;0;10
13360;Zylutė;Raduga;31057429533;Taip;0;11;0;11
13361;Zylutė;Raduga;1035415228;Taip;0;4;0;4
13362;Zylutė;Raduga;1059365398;Taip;0;7;0;7
13363;Zylutė;Raduga;2092027180;Taip;0;15;0;15
13364;Zylutė;Raduga;60768660940;Taip;3;12;0;15
13365;Zylutė;Raduga;1840757726;Taip;0;4;0;4
13366;Zylutė;Raduga;86343860903;Taip;4;5;0;9
13367;Zylutė;Raduga;3179737181;Ne;0;2;1;3
13368;Zylutė;Raduga;1098174103;Taip;1;7;0;8
13369;Zylutė;Raduga;5202483589;Taip;0;1;0;1
13370;Zylutė;"Miki Maus";9457189905;Taip;0;1;0;1
13371;Zylutė;"Miki Maus";9664467134;Taip;14;0;0;14
13372;Zylutė;"Miki Maus";8336138549;Taip;11;3;0;14
13373;Zylutė;"Miki Maus";8638652914;Taip;5;3;0;8
13374;Zylutė;"Miki Maus";2445444641;Taip;0;1;0;1
13375;Zylutė;"Miki Maus";9908198854;Taip;0;10;0;10
13376;Zylutė;"Miki Maus";4493469560;Taip;15;0;0;15
13377;Zylutė;"Miki Maus";5670953383;Taip;9;0;0;9
13378;Zylutė;"Miki Maus";5027134228;Taip;0;13;0;13
13379;Zylutė;"Miki Maus";4715704693;Taip;5;0;0;5
13380;Zylutė;"Miki Maus";4543822765;Taip;10;4;0;14
13381;Zylutė;"Miki Maus";2968625045;Taip;4;0;0;4
13382;Zylutė;Solnyško;52293061924;Taip;0;11;0;11
13383;Zylutė;Solnyško;50784859977;Taip;0;1;0;1
13384;Zylutė;Solnyško;1212526573;Taip;5;1;0;6
13385;Zylutė;Solnyško;2020113161;Taip;4;0;0;4
13386;Zylutė;Solnyško;2058827699;Taip;0;2;0;2
13387;Zylutė;Solnyško;1328824849;Ne;0;2;0;2
13388;Zylutė;Solnyško;37968324911;Taip;0;3;0;3
13389;Zylutė;Solnyško;16723015849;Taip;11;0;0;11
13390;Zylutė;Solnyško;58033645899;Taip;0;11;0;11
13391;Zylutė;Solnyško;98295398362;Taip;0;5;0;5
13392;Zylutė;Solnyško;63287117036;Taip;0;8;0;8
13393;Zylutė;Solnyško;8582483538;Taip;5;1;0;6
13394;Zylutė;Solnyško;2910542367;Taip;7;3;0;10
13395;Zylutė;Solnyško;1979823314;Taip;0;7;0;7
13396;Zylutė;Solnyško;9728065395;Taip;9;1;0;10
13397;Zylutė;Solnyško;36486637873;Ne;2;0;0;2
13398;Zylutė;Solnyško;5090740854;Taip;20;0;0;20
13399;Zylutė;Motyliok;45252076215;Ne;11;5;0;16
13400;Zylutė;Motyliok;45779928616;Taip;0;1;0;1
13401;Zylutė;Motyliok;35364823312;Taip;0;7;0;7
13402;Zylutė;Motyliok;1897162912;Taip;1;0;0;1
13403;Zylutė;Motyliok;1801436436;Taip;3;0;0;3
13404;Zylutė;Motyliok;1445891751;Taip;0;8;0;8
13405;Zylutė;Motyliok;1284845681;Taip;11;0;0;11
13406;Zylutė;Motyliok;1873200936;Taip;0;2;0;2
13407;Zylutė;Motyliok;7298260831;Taip;0;4;0;4
13408;Zylutė;Motyliok;2306517891;Taip;5;0;0;5
13409;Zylutė;Motyliok;5803032683;Taip;13;0;0;13
13410;Zylutė;Motyliok;3089235413;Taip;11;6;0;17
13411;Zylutė;Motyliok;23826981323;Taip;10;2;0;12
13412;Zylutė;Motyliok;1094217042;Taip;16;0;0;16
13413;Zylutė;Motyliok;1145364380;Taip;16;0;0;16
13414;Zylutė;Motyliok;7712651566;Ne;0;2;0;2
13415;Zylutė;ŽVIRBLIUKAI;20569748356;Taip;2;6;0;8
13416;Zylutė;ŽVIRBLIUKAI;8783866036;Taip;15;3;0;18
13417;Zylutė;ŽVIRBLIUKAI;2274290871;Taip;15;4;0;19
13418;Zylutė;ŽVIRBLIUKAI;9902286013;Taip;5;0;0;5
13419;Zylutė;ŽVIRBLIUKAI;1972826928;Taip;8;0;0;8
13420;Zylutė;ŽVIRBLIUKAI;8018865138;Taip;6;2;0;8
13421;Zylutė;ŽVIRBLIUKAI;3074954453;Taip;0;2;0;2
13422;Zylutė;ŽVIRBLIUKAI;3919565034;Taip;4;1;0;5
13423;Zylutė;ŽVIRBLIUKAI;6865973084;Taip;0;9;0;9
13424;Zylutė;ŽVIRBLIUKAI;2744516236;Taip;4;1;0;5
13425;Zylutė;ŽVIRBLIUKAI;5174329244;Taip;0;6;0;6
13426;Zylutė;ŽVIRBLIUKAI;1939618217;Taip;0;1;0;1
13427;Zylutė;ŽVIRBLIUKAI;8627523283;Taip;11;0;0;11
13428;Zylutė;ŽVIRBLIUKAI;8874692591;Taip;0;7;0;7
13429;Zylutė;ŽVIRBLIUKAI;5431521522;Taip;5;12;0;17
13430;Zylutė;ŽVIRBLIUKAI;2792217953;Taip;4;0;0;4
13431;Zylutė;ŽVIRBLIUKAI;6548786007;Ne;10;2;0;12
13432;Zylutė;"DRUŽNYJE REBIATA";12377363480;Taip;13;0;0;13
13433;Zylutė;"DRUŽNYJE REBIATA";1428614163;Taip;0;9;0;9
13434;Zylutė;"DRUŽNYJE REBIATA";1674095701;Taip;6;4;0;10
13435;Zylutė;"DRUŽNYJE REBIATA";3379725202;Taip;2;0;1;3
13436;Zylutė;"DRUŽNYJE REBIATA";3843999609;Taip;6;0;0;6
13437;Zylutė;"DRUŽNYJE REBIATA";3036582121;Taip;14;0;0;14
13438;Zylutė;"DRUŽNYJE REBIATA";9163527400;Taip;0;11;0;11
13439;Zylutė;"DRUŽNYJE REBIATA";2157398751;Taip;5;1;0;6
13440;Zylutė;"DRUŽNYJE REBIATA";4302751308;Taip;0;0;1;1
13441;Zylutė;"DRUŽNYJE REBIATA";8293541980;Taip;4;0;0;4
13442;Zylutė;"DRUŽNYJE REBIATA";5452659798;Taip;8;5;0;13
13443;Zylutė;"DRUŽNYJE REBIATA";9589810356;Taip;0;3;0;3
13444;Zylutė;"DRUŽNYJE REBIATA";5224781417;Ne;0;5;0;5
13445;Zylutė;"DRUŽNYJE REBIATA";5162635301;Taip;7;3;0;10
13446;Zylutė;"DRUŽNYJE REBIATA";7023565057;Taip;16;0;0;16
13447;Zylutė;"DRUŽNYJE REBIATA";5641148690;Taip;0;6;0;6
13448;Zylutė;"DRUŽNYJE REBIATA";7804533930;Taip;11;0;0;11
13449;Zylutė;VIEVERSĖLIAI;2125519672;Taip;0;3;0;3
13450;Zylutė;VIEVERSĖLIAI;4505081448;Taip;5;0;0;5
13451;Zylutė;VIEVERSĖLIAI;2104570334;Taip;0;7;0;7
13452;Zylutė;VIEVERSĖLIAI;72716975865;Taip;4;0;0;4
13453;Zylutė;VIEVERSĖLIAI;3055559237;Taip;7;1;0;8
13454;Zylutė;VIEVERSĖLIAI;2125424949;Taip;0;2;0;2
13455;Zylutė;VIEVERSĖLIAI;6275164528;Taip;0;1;0;1
13456;Zylutė;VIEVERSĖLIAI;5172154642;Taip;0;5;0;5
13457;Zylutė;VIEVERSĖLIAI;2943888466;Taip;7;0;0;7
13458;Zylutė;VIEVERSĖLIAI;6907378757;Taip;9;1;0;10
13459;Zylutė;VIEVERSĖLIAI;6723650872;Taip;2;0;0;2
13460;Zylutė;VIEVERSĖLIAI;3810636967;Taip;11;1;0;12
13461;Zylutė;VIEVERSĖLIAI;6154352500;Taip;0;10;0;10
13462;Zylutė;VIEVERSĖLIAI;4016518230;Taip;0;1;0;1
13463;Zylutė;VIEVERSĖLIAI;9660898505;Taip;0;9;0;9
13464;Zylutė;VIEVERSĖLIAI;57138305703;Taip;0;10;0;10
13465;Zylutė;VIEVERSĖLIAI;5544338521;Taip;17;0;0;17
13466;Zylutė;VIEVERSĖLIAI;1897871944;Taip;10;2;0;12
13467;Zylutė;VIEVERSĖLIAI;4764295850;Taip;0;14;0;14
13468;Zylutė;VIEVERSĖLIAI;5687201052;Taip;11;1;0;12
13469;Zylutė;VIEVERSĖLIAI;1750040659;Taip;6;1;0;7
13470;Želmenėliai;Bitučių;43295789978;Taip;0;2;0;2
13471;Želmenėliai;Bitučių;97786398830;Taip;0;5;0;5
13472;Želmenėliai;Bitučių;66377316300;Taip;0;3;0;3
13473;Želmenėliai;Bitučių;8440363769;Taip;0;1;0;1
13474;Želmenėliai;Bitučių;77393977996;Taip;5;3;0;8
13475;Želmenėliai;Bitučių;36928282518;Taip;5;2;0;7
13476;Želmenėliai;Bitučių;1342057909;Taip;0;3;0;3
13477;Želmenėliai;Bitučių;83607110446;Taip;5;1;0;6
13478;Želmenėliai;Bitučių;93445022509;Taip;0;4;1;5
13479;Želmenėliai;Bitučių;1158828889;Taip;0;3;1;4
13480;Želmenėliai;Bitučių;2162788756;Taip;0;0;3;3
13481;Želmenėliai;Bitučių;3039903984;Ne;0;1;6;7
13482;Želmenėliai;Bitučių;5501491970;Taip;2;1;0;3
13483;Želmenėliai;Bitučių;1063647379;Ne;14;0;0;14
13484;Želmenėliai;Bitučių;7911857247;Taip;0;3;0;3
13485;Želmenėliai;Kačiukų;55423287751;Ne;0;3;0;3
13486;Želmenėliai;Kačiukų;6806260100;Taip;0;2;0;2
13487;Želmenėliai;Kačiukų;25991128602;Taip;20;1;0;21
13488;Želmenėliai;Kačiukų;50204719384;Taip;0;13;0;13
13489;Želmenėliai;Kačiukų;54492404542;Taip;3;0;0;3
13490;Želmenėliai;Kačiukų;40147904205;Taip;0;1;0;1
13491;Želmenėliai;Kačiukų;75215159489;Taip;0;9;0;9
13492;Želmenėliai;Kačiukų;68168210430;Taip;9;2;0;11
13493;Želmenėliai;Kačiukų;52474082386;Taip;14;0;0;14
13494;Želmenėliai;Kačiukų;32945118976;Taip;0;2;0;2
13495;Želmenėliai;Kačiukų;72091418618;Taip;2;0;0;2
13496;Želmenėliai;Kačiukų;72029098066;Taip;6;0;0;6
13497;Želmenėliai;Kačiukų;25744693727;Taip;0;1;0;1
13498;Želmenėliai;Kačiukų;41941728755;Taip;1;0;0;1
13499;Želmenėliai;Kačiukų;2005437403;Taip;5;1;0;6
13500;Želmenėliai;Kačiukų;1744939559;Taip;0;3;0;3
13501;Želmenėliai;Kačiukų;27187464726;Taip;0;1;0;1
13502;Želmenėliai;Voveriukų;1064518850;Taip;0;4;0;4
13503;Želmenėliai;Voveriukų;11316462529;Taip;0;0;1;1
13504;Želmenėliai;Voveriukų;5696221669;Taip;0;0;1;1
13505;Želmenėliai;Voveriukų;1799477959;Taip;5;3;0;8
13506;Želmenėliai;Voveriukų;98487229210;Taip;9;11;0;20
13507;Želmenėliai;Voveriukų;56814748796;Taip;10;2;0;12
13508;Želmenėliai;Voveriukų;39766114351;Taip;13;0;0;13
13509;Želmenėliai;Voveriukų;21263242044;Taip;0;1;0;1
13510;Želmenėliai;Voveriukų;68226657214;Taip;0;1;0;1
13511;Želmenėliai;Voveriukų;1619190849;Taip;15;6;0;21
13512;Želmenėliai;Voveriukų;10990624964;Ne;0;5;0;5
13513;Želmenėliai;Voveriukų;1868937175;Taip;8;0;0;8
13514;Želmenėliai;Voveriukų;77946540922;Taip;0;2;0;2
13515;Želmenėliai;Voveriukų;8218755050;Taip;5;1;15;21
13516;Želmenėliai;Voveriukų;6783113916;Taip;0;5;0;5
13517;Želmenėliai;Ežiukų;63879513374;Ne;0;6;0;6
13518;Želmenėliai;Ežiukų;12336777368;Ne;0;13;0;13
13519;Želmenėliai;Ežiukų;65633625929;Taip;0;3;0;3
13520;Želmenėliai;Ežiukų;5345737656;Taip;0;3;0;3
13521;Želmenėliai;Ežiukų;16400566719;Taip;9;0;0;9
13522;Želmenėliai;Ežiukų;2265545469;Taip;10;1;0;11
13523;Želmenėliai;Ežiukų;28030110904;Taip;4;13;0;17
13524;Želmenėliai;Ežiukų;22209426414;Taip;7;1;0;8
13525;Želmenėliai;Ežiukų;21636460884;Taip;5;5;2;12
13526;Želmenėliai;Ežiukų;4699944934;Taip;7;0;0;7
13527;Želmenėliai;Ežiukų;90992236935;Taip;0;1;0;1
13528;Želmenėliai;Ežiukų;8394779853;Taip;0;16;0;16
13529;Želmenėliai;Ežiukų;1425695010;Taip;9;0;0;9
13530;Želmenėliai;Ežiukų;9234190447;Taip;0;1;0;1
13531;Želmenėliai;Ežiukų;1369976001;Taip;0;15;0;15
13532;Želmenėliai;Ežiukų;8478954608;Taip;0;15;0;15
13533;Želmenėliai;Ežiukų;1799391978;Taip;0;15;0;15
13534;Želmenėliai;Ežiukų;10686783804;Taip;3;2;5;10
13535;Želmenėliai;Peledžiukų;4206128805;Taip;0;7;0;7
13536;Želmenėliai;Peledžiukų;6816346946;Taip;12;1;0;13
13537;Želmenėliai;Peledžiukų;9359070885;Taip;4;0;0;4
13538;Želmenėliai;Peledžiukų;2428447892;Taip;12;0;0;12
13539;Želmenėliai;Peledžiukų;5787772212;Taip;0;4;0;4
13540;Želmenėliai;Peledžiukų;1239398642;Taip;0;2;0;2
13541;Želmenėliai;Peledžiukų;29112205705;Taip;5;6;0;11
13542;Želmenėliai;Peledžiukų;1248541555;Taip;0;4;0;4
13543;Želmenėliai;Peledžiukų;8995804360;Taip;0;1;0;1
13544;Želmenėliai;Peledžiukų;1522141057;Taip;0;1;5;6
13545;Želmenėliai;Peledžiukų;5616709457;Taip;4;1;0;5
13546;Želmenėliai;Peledžiukų;8300887366;Taip;8;3;0;11
13547;Želmenėliai;Peledžiukų;96660519820;Taip;10;0;0;10
13548;Želmenėliai;Peledžiukų;5842563754;Taip;0;3;0;3
13549;Želmenėliai;Peledžiukų;9375550172;Taip;16;1;0;17
13550;Želmenėliai;Peledžiukų;8478564831;Taip;8;0;0;8
13551;Želmenėliai;Peledžiukų;1941723687;Taip;0;3;0;3
13552;Želmenėliai;Peledžiukų;8590746750;Taip;0;2;0;2
13553;Želmenėliai;Drugelių;7664430346;Taip;0;0;5;5
13554;Želmenėliai;Drugelių;3417538909;Taip;0;1;0;1
13555;Želmenėliai;Drugelių;3295852546;Taip;4;13;0;17
13556;Želmenėliai;Drugelių;3379266015;Taip;0;8;0;8
13557;Želmenėliai;Drugelių;3737786832;Taip;0;0;1;1
13558;Želmenėliai;Drugelių;5633127620;Taip;0;21;0;21
13559;Želmenėliai;Drugelių;1984105453;Taip;16;0;0;16
13560;Želmenėliai;Drugelių;1920917916;Taip;21;0;0;21
13561;Želmenėliai;Drugelių;4652412483;Taip;1;6;0;7
13562;Želmenėliai;Drugelių;1652949383;Taip;0;3;0;3
13563;Želmenėliai;Drugelių;5046836398;Taip;11;0;0;11
13564;Želmenėliai;Drugelių;9237611484;Taip;6;0;7;13
13565;Želmenėliai;Drugelių;13558387807;Taip;5;1;0;6
13566;Želmenėliai;Drugelių;5143554665;Taip;11;2;0;13
13567;Želmenėliai;Drugelių;7585159351;Taip;0;11;0;11
13568;Želmenėliai;Drugelių;9207984505;Taip;0;14;0;14
13569;Želmenėliai;Drugelių;4634346755;Taip;3;0;5;8
13570;Želmenėliai;Drugelių;4916436238;Taip;5;9;0;14
13571;Želmenėliai;Drugelių;5558795651;Taip;6;2;1;9
13572;Želmenėliai;Voriukų;95258645888;Taip;0;7;0;7
13573;Želmenėliai;Voriukų;52040816124;Taip;0;1;0;1
13574;Želmenėliai;Voriukų;26335599312;Taip;6;1;0;7
13575;Želmenėliai;Voriukų;92945999406;Ne;0;1;0;1
13576;Želmenėliai;Voriukų;82671339119;Taip;1;0;0;1
13577;Želmenėliai;Voriukų;26377076407;Taip;0;2;0;2
13578;Želmenėliai;Voriukų;25839440205;Taip;0;1;0;1
13579;Želmenėliai;Voriukų;2017960244;Taip;0;1;0;1
13580;Želmenėliai;Voriukų;1494996935;Taip;0;9;0;9
13581;Želmenėliai;Voriukų;7587565685;Taip;20;0;0;20
13582;Želmenėliai;Voriukų;1299167028;Taip;11;1;0;12
13583;Želmenėliai;Boružėlių;51756630728;Taip;0;12;0;12
13584;Želmenėliai;Boružėlių;22539846993;Taip;0;1;0;1
13585;Želmenėliai;Boružėlių;5223588064;Taip;0;1;0;1
13586;Želmenėliai;Boružėlių;2898358705;Taip;0;4;0;4
13587;Želmenėliai;Boružėlių;63043069680;Taip;4;2;1;7
13588;Želmenėliai;Boružėlių;10462964817;Taip;1;4;0;5
13589;Želmenėliai;Boružėlių;2103938312;Taip;0;2;0;2
13590;Želmenėliai;Boružėlių;35901929384;Taip;0;1;0;1
13591;Želmenėliai;Boružėlių;39675390598;Taip;0;2;0;2
13592;Želmenėliai;Boružėlių;1290780920;Taip;0;1;0;1
13593;Želmenėliai;Boružėlių;1699958696;Taip;5;11;0;16
13594;Želmenėliai;Boružėlių;98852944217;Taip;0;6;0;6
13595;Želmenėliai;Boružėlių;7502363323;Ne;0;10;0;10
13596;Želmenėliai;Boružėlių;1009164107;Taip;0;10;0;10
13597;Želmenėliai;Boružėlių;92486344928;Taip;0;8;0;8
13598;Želmenėliai;Boružėlių;1802714172;Taip;5;0;0;5
13599;Želmenėliai;Boružėlių;1686751892;Taip;21;0;0;21
13600;Želmenėliai;Boružėlių;1044902564;Ne;6;1;0;7
13601;Želmenėliai;Boružėlių;1933769076;Taip;0;0;2;2
13602;Želmenėliai;Boružėlių;1134743316;Taip;2;1;0;3
13603;Želmenėliai;Boružėlių;9414488405;Taip;14;0;2;16
13604;Želmenėliai;Pūkuotukų;73813829491;Taip;15;1;0;16
13605;Želmenėliai;Pūkuotukų;79879695958;Taip;7;2;0;9
13606;Želmenėliai;Pūkuotukų;54536849345;Taip;0;9;0;9
13607;Želmenėliai;Pūkuotukų;8936734213;Taip;0;3;0;3
13608;Želmenėliai;Pūkuotukų;1213403598;Taip;15;2;0;17
13609;Želmenėliai;Pūkuotukų;1803684569;Taip;11;0;0;11
13610;Želmenėliai;Pūkuotukų;1716801722;Taip;0;8;0;8
13611;Želmenėliai;Pūkuotukų;45440599686;Taip;6;5;0;11
13612;Želmenėliai;Pūkuotukų;50805473649;Taip;10;6;0;16
13613;Želmenėliai;Pūkuotukų;1405460015;Taip;0;2;0;2
13614;Želmenėliai;Pūkuotukų;85619767784;Taip;2;8;0;10
13615;Želmenėliai;Pūkuotukų;1800724034;Taip;19;0;0;19
13616;Želmenėliai;Pūkuotukų;74037118861;Taip;0;1;0;1
13617;Želmenėliai;Pūkuotukų;8706951420;Taip;0;3;0;3
13618;Želmenėliai;Pūkuotukų;7737877729;Taip;6;1;0;7
13619;Želmenėliai;Pūkuotukų;1426827854;Taip;9;0;0;9
13620;Želmenėliai;Pūkuotukų;1619412305;Taip;0;1;0;1
13621;Želmenėliai;Pūkuotukų;75198661944;Taip;5;0;0;5
13622;Želmenėliai;Pūkuotukų;2036184590;Taip;0;1;0;1
13623;Želmenėliai;Pūkuotukų;72855365141;Taip;1;0;0;1
13624;Želmenėliai;Pūkuotukų;22138795060;Taip;0;10;0;10
13625;Želmenėliai;Pūkuotukų;37152467004;Taip;6;9;0;15
13626;Želmenėliai;Ančiukų;1203343580;Taip;11;0;0;11
13627;Želmenėliai;Ančiukų;4264751761;Taip;11;10;0;21
13628;Želmenėliai;Ančiukų;7940403585;Taip;15;1;0;16
13629;Želmenėliai;Ančiukų;3184074698;Taip;0;1;0;1
13630;Želmenėliai;Ančiukų;2570248893;Taip;0;10;0;10
13631;Želmenėliai;Ančiukų;3014568232;Taip;5;1;0;6
13632;Želmenėliai;Ančiukų;7563461821;Taip;0;20;0;20
13633;Želmenėliai;Ančiukų;8504963337;Taip;0;2;0;2
13634;Želmenėliai;Ančiukų;9351650342;Taip;5;6;0;11
13635;Želmenėliai;Ančiukų;4534946646;Taip;6;5;0;11
13636;Želmenėliai;Ančiukų;4075533071;Taip;4;1;2;7
13637;Želmenėliai;Nykštukų;9611741258;Taip;1;5;0;6
13638;Želmenėliai;Nykštukų;1619143702;Taip;0;4;0;4
13639;Želmenėliai;Nykštukų;9825545754;Taip;13;0;3;16
13640;Želmenėliai;Nykštukų;3810550099;Taip;12;3;0;15
13641;Želmenėliai;Nykštukų;2846903449;Taip;4;0;0;4
13642;Želmenėliai;Nykštukų;4473677352;Taip;20;0;0;20
13643;Želmenėliai;Nykštukų;8973215240;Taip;10;0;0;10
13644;Želmenėliai;Nykštukų;7505996978;Taip;6;8;0;14
13645;Želmenėliai;Nykštukų;7955645490;Taip;4;6;0;10
13646;Želmenėliai;Nykštukų;5314438217;Taip;0;1;0;1
13647;Želmenėliai;Nykštukų;9995500724;Taip;4;6;0;10
13648;Želmenėliai;Nykštukų;8954705816;Taip;2;0;0;2
13649;Želmenėliai;Lašelių;6799702725;Taip;12;1;0;13
13650;Želmenėliai;Lašelių;7423900312;Taip;12;0;0;12
13651;Želmenėliai;Lašelių;8358780570;Taip;5;0;0;5
13652;Želmenėliai;Lašelių;2122665619;Taip;6;0;0;6
13653;Želmenėliai;Lašelių;9006406225;Taip;6;2;0;8
13654;Želmenėliai;Lašelių;2102401372;Taip;11;0;0;11
13655;Želmenėliai;Lašelių;5171736943;Taip;0;1;0;1
13656;Želmenėliai;Lašelių;4931835807;Taip;4;1;0;5
13657;Želmenėliai;Lašelių;5147895081;Taip;7;0;0;7
13658;Želmenėliai;Lašelių;7957790300;Taip;9;0;0;9
13659;Želmenėliai;Lašelių;6481952132;Taip;2;0;0;2
13660;Želmenėliai;Lašelių;6876147546;Taip;0;3;0;3
13661;Želmenėliai;Lašelių;9126715074;Taip;16;0;0;16
13662;Želmenėliai;Lašelių;2563117992;Taip;13;0;0;13
13663;Želmenėliai;Lašelių;6180553648;Taip;13;2;0;15
13664;Želmenėliai;Lašelių;5211426226;Taip;8;6;0;14
13665;Žemyna;Čiauškučiai;96099047169;Taip;12;1;0;13
13666;Žemyna;Čiauškučiai;85617781303;Taip;0;0;1;1
13667;Žemyna;Čiauškučiai;62565967575;Taip;0;2;0;2
13668;Žemyna;Čiauškučiai;25099273803;Taip;0;1;1;2
13669;Žemyna;Čiauškučiai;49793977825;Taip;0;5;0;5
13670;Žemyna;Čiauškučiai;40843229500;Taip;5;7;0;12
13671;Žemyna;Čiauškučiai;69690099920;Taip;6;0;0;6
13672;Žemyna;Čiauškučiai;98477626952;Taip;0;2;2;4
13673;Žemyna;Čiauškučiai;71013970407;Taip;0;7;0;7
13674;Žemyna;Čiauškučiai;56418377668;Taip;0;7;0;7
13675;Žemyna;Čiauškučiai;46550223916;Taip;1;0;0;1
13676;Žemyna;Čiauškučiai;98919412716;Taip;9;0;0;9
13677;Žemyna;Čiauškučiai;89754744294;Taip;1;2;0;3
13678;Žemyna;Čiauškučiai;1790109762;Taip;0;1;2;3
13679;Žemyna;Čiauškučiai;83056273504;Taip;4;2;0;6
13680;Žemyna;Čiauškučiai;1866645242;Taip;0;0;1;1
13681;Žemyna;Čiauškučiai;1917294883;Taip;5;0;0;5
13682;Žemyna;Čiauškučiai;1393006122;Taip;0;0;1;1
13683;Žemyna;Čiauškučiai;9409512255;Taip;2;0;5;7
13684;Žemyna;Nykštukai;69634515292;Taip;0;2;0;2
13685;Žemyna;Nykštukai;65677663175;Taip;0;2;2;4
13686;Žemyna;Nykštukai;74969696164;Taip;19;1;0;20
13687;Žemyna;Nykštukai;47974278492;Taip;0;4;1;5
13688;Žemyna;Nykštukai;92159859248;Taip;6;0;1;7
13689;Žemyna;Nykštukai;10344263960;Taip;0;0;3;3
13690;Žemyna;Nykštukai;54029612806;Taip;0;4;0;4
13691;Žemyna;Nykštukai;93378737171;Taip;5;1;0;6
13692;Žemyna;Nykštukai;5204796908;Taip;1;0;0;1
13693;Žemyna;Nykštukai;9556275322;Taip;6;1;0;7
13694;Žemyna;Nykštukai;65117735882;Taip;0;2;1;3
13695;Žemyna;Nykštukai;59441904717;Taip;16;0;0;16
13696;Žemyna;Nykštukai;97712802830;Taip;0;2;0;2
13697;Žemyna;Nykštukai;70694756261;Taip;12;2;0;14
13698;Žemyna;Nykštukai;45269313606;Taip;0;2;0;2
13699;Žemyna;Nykštukai;7670120949;Taip;0;0;2;2
13700;Žemyna;Nykštukai;78280621543;Taip;8;3;0;11
13701;Žemyna;Nykštukai;68982161758;Taip;0;0;4;4
13702;Žemyna;Nykštukai;1674165765;Taip;0;11;0;11
13703;Žemyna;Nykštukai;43708641831;Taip;10;7;0;17
13704;Žemyna;Nykštukai;2033947862;Taip;0;0;4;4
13705;Žemyna;Nykštukai;1337500221;Taip;0;6;0;6
13706;Žemyna;Nykštukai;6546437872;Taip;0;2;1;3
13707;Žemyna;Voveriukai;3135562485;Taip;4;0;0;4
13708;Žemyna;Voveriukai;2976467316;Taip;4;0;0;4
13709;Žemyna;Voveriukai;5940619734;Taip;3;0;0;3
13710;Žemyna;Voveriukai;6812823390;Taip;6;0;0;6
13711;Žemyna;Voveriukai;8500642069;Taip;10;0;0;10
13712;Žemyna;Voveriukai;6430348135;Taip;7;3;0;10
13713;Žemyna;Voveriukai;7925774308;Taip;5;0;0;5
13714;Žemyna;Voveriukai;2412956023;Taip;3;5;0;8
13715;Žemyna;Voveriukai;3938938667;Taip;1;0;0;1
13716;Žemyna;Voveriukai;9958040413;Taip;10;0;3;13
13717;Žemyna;Voveriukai;1114714466;Taip;6;0;9;15
13718;Žemyna;Voveriukai;1807466584;Taip;15;1;0;16
13719;Žemyna;Voveriukai;1543415914;Taip;7;0;1;8
13720;Žemyna;Voveriukai;7125026803;Taip;4;0;0;4
13721;Žemyna;Voveriukai;9148594407;Taip;11;0;3;14
13722;Žemyna;Voveriukai;6701717634;Taip;18;0;0;18
13723;Žemyna;Voveriukai;9866110744;Taip;3;0;0;3
13724;Žemyna;Voveriukai;7693278353;Taip;9;0;1;10
13725;Žemyna;Voveriukai;1118997229;Taip;13;1;2;16
13726;Žemyna;Kiškučiai;99073448709;Taip;2;2;0;4
13727;Žemyna;Kiškučiai;10048697347;Taip;0;0;9;9
13728;Žemyna;Kiškučiai;11629931607;Taip;0;1;0;1
13729;Žemyna;Kiškučiai;26634432947;Taip;0;10;0;10
13730;Žemyna;Kiškučiai;35576046194;Taip;3;0;0;3
13731;Žemyna;Kiškučiai;81211805661;Taip;0;1;0;1
13732;Žemyna;Kiškučiai;54667537300;Taip;8;1;0;9
13733;Žemyna;Kiškučiai;85184514538;Taip;0;1;0;1
13734;Žemyna;Kiškučiai;81784082355;Taip;0;0;10;10
13735;Žemyna;Kiškučiai;89531266711;Taip;0;0;1;1
13736;Žemyna;Kiškučiai;5730670827;Taip;3;11;0;14
13737;Žemyna;Kiškučiai;6766660258;Taip;0;5;0;5
13738;Žemyna;Kiškučiai;17162551563;Taip;1;0;1;2
13739;Žemyna;Kiškučiai;4928267472;Taip;0;5;4;9
13740;Žemyna;Vyturiukai;9232638767;Taip;5;0;0;5
13741;Žemyna;Vyturiukai;38769607968;Taip;5;0;0;5
13742;Žemyna;Vyturiukai;47470155594;Taip;0;0;2;2
13743;Žemyna;Vyturiukai;17098859260;Taip;0;1;0;1
13744;Žemyna;Vyturiukai;1687206394;Taip;9;0;2;11
13745;Žemyna;Vyturiukai;5508251792;Taip;0;2;0;2
13746;Žemyna;Vyturiukai;85135645557;Taip;5;1;0;6
13747;Žemyna;Vyturiukai;59506345859;Taip;1;2;0;3
13748;Žemyna;Vyturiukai;89787441782;Taip;0;2;0;2
13749;Žemyna;Vyturiukai;41538301616;Taip;0;0;4;4
13750;Žemyna;Vyturiukai;5506889213;Taip;1;1;0;2
13751;Žemyna;Vyturiukai;5306392307;Taip;6;11;0;17
13752;Žemyna;Vyturiukai;9018138289;Taip;7;0;1;8
13753;Žemyna;Vyturiukai;37570629861;Taip;10;6;0;16
13754;Žemyna;Vyturiukai;13242930752;Taip;2;1;1;4
13755;Žemyna;Vyturiukai;96473502730;Taip;5;0;9;14
13756;Žemyna;Vyturiukai;94548785045;Taip;5;0;0;5
13757;Žemyna;Vyturiukai;93423088394;Taip;0;3;0;3
13758;Žemyna;Vyturiukai;8040359407;Taip;7;0;0;7
13759;Žemyna;Vyturiukai;55161890341;Taip;11;2;0;13
13760;Žemyna;Vyturiukai;4524929331;Taip;0;4;0;4
13761;Žemyna;Pelėdžiukai;8415482981;Taip;5;1;0;6
13762;Žemyna;Pelėdžiukai;91945722729;Taip;0;6;0;6
13763;Žemyna;Pelėdžiukai;31409370999;Taip;5;1;1;7
13764;Žemyna;Pelėdžiukai;26452260516;Taip;0;1;0;1
13765;Žemyna;Pelėdžiukai;74855676264;Taip;15;0;0;15
13766;Žemyna;Pelėdžiukai;36180811193;Taip;5;1;0;6
13767;Žemyna;Pelėdžiukai;80111906824;Taip;0;0;5;5
13768;Žemyna;Pelėdžiukai;36616512238;Taip;0;3;0;3
13769;Žemyna;Pelėdžiukai;30019743988;Taip;0;4;0;4
13770;Žemyna;Pelėdžiukai;29377805386;Taip;0;2;1;3
13771;Žemyna;Pelėdžiukai;51131984130;Ne;1;0;2;3
13772;Žemyna;Pelėdžiukai;68149716927;Taip;0;2;0;2
13773;Žemyna;Pelėdžiukai;67275465624;Taip;0;4;0;4
13774;Žemyna;Pelėdžiukai;55015285610;Taip;0;0;3;3
13775;Žemyna;Pelėdžiukai;46049323529;Taip;18;0;0;18
13776;Žemyna;Pelėdžiukai;12251465809;Taip;2;1;1;4
13777;Žemyna;Pelėdžiukai;4680528929;Taip;0;6;0;6
13778;Žemyna;Pelėdžiukai;1218163998;Taip;0;1;1;2
13779;Žemyna;Pelėdžiukai;5183028594;Taip;4;1;6;11
13780;Žemyna;Pelėdžiukai;1717113454;Taip;12;1;1;14
13781;Žemyna;Vijurkai;3601375855;Taip;0;16;0;16
13782;Žemyna;Vijurkai;64499886011;Taip;2;1;2;5
13783;Žemyna;Vijurkai;95274028121;Taip;5;0;0;5
13784;Žemyna;Vijurkai;60950769448;Taip;5;0;0;5
13785;Žemyna;Vijurkai;1015193590;Taip;0;1;13;14
13786;Žemyna;Vijurkai;64066518112;Taip;0;2;1;3
13787;Žemyna;Vijurkai;38352111116;Taip;4;1;2;7
13788;Žemyna;Vijurkai;43441615793;Taip;0;0;2;2
13789;Žemyna;Vijurkai;1197264568;Taip;5;2;0;7
13790;Žemyna;Vijurkai;36873572743;Taip;5;0;4;9
13791;Žemyna;Vijurkai;63747644828;Taip;0;1;0;1
13792;Žemyna;Vijurkai;1725097139;Taip;0;1;2;3
13793;Žemyna;Vijurkai;76258813568;Taip;0;2;3;5
13794;Žemyna;Vijurkai;42384634418;Taip;8;1;0;9
13795;Žemyna;Vijurkai;38576112962;Taip;0;2;3;5
13796;Žemyna;Vijurkai;60321336886;Taip;6;0;1;7
13797;Žemyna;Vijurkai;72911809081;Taip;5;2;1;8
13798;Žemyna;Šnekučiai;88775150201;Taip;0;1;0;1
13799;Žemyna;Šnekučiai;1694969407;Taip;3;0;0;3
13800;Žemyna;Šnekučiai;58578414067;Taip;7;1;0;8
13801;Žemyna;Šnekučiai;9130965949;Taip;0;3;0;3
13802;Žemyna;Šnekučiai;1683299408;Taip;0;1;5;6
13803;Žemyna;Šnekučiai;35462796459;Taip;0;1;1;2
13804;Žemyna;Šnekučiai;50543973728;Taip;14;0;0;14
13805;Žemyna;Šnekučiai;1595030102;Taip;6;0;0;6
13806;Žemyna;Šnekučiai;6448628301;Taip;5;1;1;7
13807;Žemyna;Šnekučiai;1421842247;Taip;5;0;2;7
13808;Žemyna;Šnekučiai;47562685723;Taip;3;2;1;6
13809;Žemyna;Šnekučiai;32755929074;Taip;17;2;0;19
13810;Žemyna;Šnekučiai;54253890981;Taip;0;0;2;2
13811;Žemyna;Šnekučiai;54823974018;Taip;3;0;0;3
13812;Žemyna;Šnekučiai;1049546597;Taip;8;0;0;8
13813;Žemyna;Šnekučiai;99015221693;Taip;0;1;0;1
13814;Žemyna;Šnekučiai;38604851102;Taip;5;0;7;12
13815;Žemyna;Šnekučiai;2003368811;Taip;10;0;0;10
13816;Žemyna;Šnekučiai;1305667359;Taip;11;0;0;11
13817;Žemyna;Šnekučiai;6089122225;Taip;2;11;0;13
13818;Žemyna;Šnekučiai;55748223762;Taip;1;7;0;8
13819;Žemyna;Pabiručiai;88687293547;Taip;3;1;0;4
13820;Žemyna;Pabiručiai;43607772302;Taip;0;1;0;1
13821;Žemyna;Pabiručiai;1210307182;Taip;5;0;1;6
13822;Žemyna;Pabiručiai;1265326169;Taip;0;0;11;11
13823;Žemyna;Pabiručiai;2032992299;Taip;0;0;2;2
13824;Žemyna;Pabiručiai;4570281722;Taip;1;0;17;18
13825;Žemyna;Pabiručiai;2073608501;Taip;0;2;0;2
13826;Žemyna;Pabiručiai;92534877861;Taip;0;0;3;3
13827;Žemyna;Pabiručiai;1716821186;Taip;2;0;0;2
13828;Žemyna;Pabiručiai;75681135185;Taip;1;0;0;1
13829;Žemyna;Pabiručiai;3596822649;Taip;2;0;3;5
13830;Žemyna;Pabiručiai;86746604640;Taip;5;0;0;5
13831;Žemyna;Pabiručiai;6775880309;Taip;3;0;0;3
13832;Žemyna;Pabiručiai;82507236376;Taip;2;0;0;2
13833;Žemyna;Pabiručiai;84955588471;Taip;5;0;0;5
13834;Žemyna;Pabiručiai;80737839511;Taip;7;0;0;7
13835;Žemyna;Pabiručiai;82479499709;Taip;2;0;0;2
13836;Žemyna;Pabiručiai;60610765717;Taip;5;0;0;5
13837;Žemyna;Pabiručiai;14902924855;Taip;0;6;0;6
13838;Žemyna;Pabiručiai;1847882950;Taip;2;0;0;2
13839;Žemyna;Pabiručiai;15573695823;Taip;0;4;0;4
13840;Žemyna;Pabiručiai;2072914123;Taip;5;0;0;5
13841;Žemyna;Pabiručiai;50687988382;Taip;0;10;0;10
13842;Žemyna;Drugeliai;72801825176;Taip;0;3;0;3
13843;Žemyna;Drugeliai;32383247850;Taip;1;0;0;1
13844;Žemyna;Drugeliai;2100326039;Taip;6;0;1;7
13845;Žemyna;Drugeliai;84680481889;Taip;0;1;2;3
13846;Žemyna;Drugeliai;1471204471;Taip;0;1;0;1
13847;Žemyna;Drugeliai;1882507954;Taip;0;2;0;2
13848;Žemyna;Drugeliai;50369667193;Taip;16;0;0;16
13849;Žemyna;Drugeliai;1705971732;Taip;0;0;2;2
13850;Žemyna;Drugeliai;97625732866;Taip;1;0;1;2
13851;Žemyna;Drugeliai;45222048620;Taip;0;0;1;1
13852;Žemyna;Drugeliai;1654912072;Taip;0;0;1;1
13853;Žemyna;Drugeliai;1968337404;Taip;14;0;0;14
13854;Žemyna;Drugeliai;51870099224;Taip;0;0;4;4
13855;Žemyna;Drugeliai;1541156624;Taip;5;5;0;10
13856;Žemyna;Drugeliai;2113826378;Taip;0;0;4;4
13857;Žemyna;"ŽIRNIUKAI ";6116581655;Taip;6;0;0;6
13858;Žemyna;"ŽIRNIUKAI ";6856737270;Taip;0;5;4;9
13859;Žemyna;"ŽIRNIUKAI ";9912869400;Taip;16;0;0;16
13860;Žemyna;"ŽIRNIUKAI ";9818711030;Taip;8;0;0;8
13861;Žemyna;"ŽIRNIUKAI ";9219519029;Taip;6;2;0;8
13862;Žemyna;"ŽIRNIUKAI ";6293560729;Taip;16;0;0;16
13863;Žemyna;"ŽIRNIUKAI ";5868208651;Taip;18;0;0;18
13864;Žemyna;"ŽIRNIUKAI ";5188496664;Taip;17;0;0;17
13865;Žemyna;"ŽIRNIUKAI ";9668975591;Taip;0;0;1;1
13866;Žemyna;"ŽIRNIUKAI ";7367602247;Taip;0;6;0;6
13867;Žemyna;"ŽIRNIUKAI ";7280740926;Taip;11;0;1;12
13868;Žemyna;"ŽIRNIUKAI ";6419974691;Taip;0;0;3;3
13869;Žemyna;"ŽIRNIUKAI ";2006173745;Taip;0;0;1;1
13870;Žemyna;"ŽIRNIUKAI ";5727308039;Taip;5;6;0;11
13871;Žemyna;"ŽIRNIUKAI ";2792702536;Taip;0;0;2;2
13872;Žemyna;"ŽIRNIUKAI ";5714771643;Taip;5;0;0;5
13873;Žemyna;"ŽIRNIUKAI ";3992383447;Taip;6;0;1;7
13874;Žemyna;"ŽIRNIUKAI ";4693414703;Taip;6;0;0;6
13875;Žemyna;"ŽIOGELIAI ";3643594001;Taip;0;2;0;2
13876;Žemyna;"ŽIOGELIAI ";7508491119;Taip;2;0;0;2
13877;Žemyna;"ŽIOGELIAI ";7781924111;Taip;0;1;0;1
13878;Žemyna;"ŽIOGELIAI ";6958537154;Taip;0;2;0;2
13879;Žemyna;"ŽIOGELIAI ";4444870782;Taip;0;2;3;5
13880;Žemyna;"ŽIOGELIAI ";2034162734;Taip;3;0;0;3
13881;Žemyna;"ŽIOGELIAI ";9182709647;Taip;9;1;0;10
13882;Žemyna;"ŽIOGELIAI ";7121742098;Taip;12;0;0;12
13883;Žemyna;"ŽIOGELIAI ";1468040559;Taip;0;1;0;1
13884;Žemyna;"ŽIOGELIAI ";4322192775;Taip;16;0;0;16
13885;Žemyna;"ŽIOGELIAI ";6051208732;Taip;17;0;0;17
13886;Žemyna;"ŽIOGELIAI ";9653530823;Taip;10;0;0;10
13887;Žemyna;"ŽIOGELIAI ";2928125522;Taip;14;1;0;15
13888;Žemyna;"ŽIOGELIAI ";7005045961;Taip;2;0;0;2
13889;Žemyna;"ŽIOGELIAI ";5114094924;Taip;0;1;1;2
13890;Žemuogėlė;Boružiukai;64182347253;Taip;11;2;0;13
13891;Žemuogėlė;Boružiukai;89682626079;Taip;2;0;0;2
13892;Žemuogėlė;Boružiukai;21886029194;Taip;1;1;0;2
13893;Žemuogėlė;Boružiukai;95070515682;Taip;4;0;0;4
13894;Žemuogėlė;Boružiukai;7503799036;Taip;6;0;1;7
13895;Žemuogėlė;Boružiukai;95392130582;Taip;0;7;0;7
13896;Žemuogėlė;Boružiukai;3208009994;Taip;0;1;0;1
13897;Žemuogėlė;Boružiukai;1099252682;Taip;0;1;0;1
13898;Žemuogėlė;Boružiukai;2320908623;Taip;0;4;0;4
13899;Žemuogėlė;Boružiukai;2099256322;Taip;6;0;0;6
13900;Žemuogėlė;Boružiukai;1550066922;Taip;0;6;0;6
13901;Žemuogėlė;Boružiukai;1354590098;Taip;0;3;3;6
13902;Žemuogėlė;Boružiukai;1543283524;Taip;0;1;0;1
13903;Žemuogėlė;Boružiukai;1085793430;Taip;5;1;0;6
13904;Žemuogėlė;Boružiukai;52842591023;Taip;4;0;1;5
13905;Žemuogėlė;Boružiukai;97014601220;Taip;19;0;0;19
13906;Žemuogėlė;Boružiukai;5911529759;Taip;0;6;0;6
13907;Žemuogėlė;Boružiukai;31450036105;Taip;0;2;2;4
13908;Žemuogėlė;Boružiukai;93523683833;Taip;0;6;0;6
13909;Žemuogėlė;Boružiukai;1093128368;Taip;6;2;0;8
13910;Žemuogėlė;Boružiukai;70054283264;Taip;8;1;0;9
13911;Žemuogėlė;Boružiukai;40590616715;Taip;0;2;0;2
13912;Žemuogėlė;Boružiukai;1248683052;Taip;12;1;0;13
13913;Žemuogėlė;Šviesuliukai;4766971363;Taip;0;3;0;3
13914;Žemuogėlė;Šviesuliukai;8187939143;Taip;14;0;0;14
13915;Žemuogėlė;Šviesuliukai;96167322031;Taip;14;0;0;14
13916;Žemuogėlė;Šviesuliukai;73679997517;Taip;6;1;0;7
13917;Žemuogėlė;Šviesuliukai;29436958034;Taip;0;6;0;6
13918;Žemuogėlė;Šviesuliukai;1608544032;Taip;10;0;3;13
13919;Žemuogėlė;Šviesuliukai;9042246873;Taip;12;6;0;18
13920;Žemuogėlė;Šviesuliukai;1859848343;Taip;0;12;0;12
13921;Žemuogėlė;Šviesuliukai;4810459063;Taip;0;2;0;2
13922;Žemuogėlė;Šviesuliukai;57783467185;Taip;10;2;0;12
13923;Žemuogėlė;Šviesuliukai;75012082294;Taip;5;1;0;6
13924;Žemuogėlė;Šviesuliukai;5395954931;Taip;10;1;0;11
13925;Žemuogėlė;Šviesuliukai;1833523282;Taip;0;6;0;6
13926;Žemuogėlė;Šviesuliukai;3062268362;Taip;16;0;0;16
13927;Žemuogėlė;Šviesuliukai;9864664937;Taip;10;0;0;10
13928;Žemuogėlė;Šviesuliukai;3868254757;Taip;4;0;0;4
13929;Žemuogėlė;Šviesuliukai;1745679183;Taip;10;0;0;10
13930;Žemuogėlė;Šviesuliukai;9255723192;Taip;6;0;1;7
13931;Žemuogėlė;Šviesuliukai;2740942924;Taip;10;0;0;10
13932;Žemuogėlė;Šviesuliukai;5972567526;Taip;9;0;0;9
13933;Žemuogėlė;Šviesuliukai;1910570858;Taip;11;0;0;11
13934;Žemuogėlė;Lašiukai;88840615083;Ne;0;7;0;7
13935;Žemuogėlė;Lašiukai;32491995013;Taip;0;1;0;1
13936;Žemuogėlė;Lašiukai;10671271979;Taip;0;4;0;4
13937;Žemuogėlė;Lašiukai;84390824854;Taip;4;0;0;4
13938;Žemuogėlė;Lašiukai;95927288551;Taip;10;0;0;10
13939;Žemuogėlė;Lašiukai;91107541015;Taip;5;0;0;5
13940;Žemuogėlė;Lašiukai;53837299006;Taip;0;2;0;2
13941;Žemuogėlė;Lašiukai;12747214926;Taip;2;0;0;2
13942;Žemuogėlė;Lašiukai;51367008137;Taip;0;5;0;5
13943;Žemuogėlė;Lašiukai;46391565859;Taip;0;2;0;2
13944;Žemuogėlė;Lašiukai;23836253539;Taip;6;0;0;6
13945;Žemuogėlė;Lašiukai;35616013050;Taip;0;1;0;1
13946;Žemuogėlė;Lašiukai;86574419074;Taip;0;1;0;1
13947;Žemuogėlė;Lašiukai;71173323434;Taip;11;0;0;11
13948;Žemuogėlė;Lašiukai;84708796864;Taip;0;1;0;1
13949;Žemuogėlė;Lašiukai;78872439982;Taip;6;13;0;19
13950;Žemuogėlė;Skambaliukai;66580736408;Taip;4;4;0;8
13951;Žemuogėlė;Skambaliukai;84666403179;Taip;6;0;0;6
13952;Žemuogėlė;Skambaliukai;31759065949;Taip;3;5;0;8
13953;Žemuogėlė;Skambaliukai;9595187690;Taip;9;1;0;10
13954;Žemuogėlė;Skambaliukai;5784013969;Taip;11;1;0;12
13955;Žemuogėlė;Skambaliukai;4102456092;Taip;0;1;0;1
13956;Žemuogėlė;Skambaliukai;6181456167;Taip;0;1;0;1
13957;Žemuogėlė;Skambaliukai;3937319656;Taip;0;2;0;2
13958;Žemuogėlė;Skambaliukai;7593612588;Taip;0;16;0;16
13959;Žemuogėlė;Skambaliukai;9932212577;Taip;4;0;0;4
13960;Žemuogėlė;Skambaliukai;1461676033;Taip;6;2;0;8
13961;Žemuogėlė;Skambaliukai;8499817876;Taip;5;0;0;5
13962;Žemuogėlė;Skambaliukai;8208792552;Taip;6;1;0;7
13963;Žemuogėlė;Skambaliukai;48157970479;Taip;9;0;0;9
13964;Žemuogėlė;Skambaliukai;42192628191;Taip;10;1;0;11
13965;Žemuogėlė;Skambaliukai;2692095829;Taip;0;1;0;1
13966;Žemuogėlė;Skambaliukai;13566201686;Taip;10;3;0;13
13967;Žemuogėlė;Skambaliukai;2661677897;Taip;9;1;0;10
13968;Žemuogėlė;Spinduliukai;36386223863;Taip;11;0;0;11
13969;Žemuogėlė;Spinduliukai;62971657427;Taip;5;0;0;5
13970;Žemuogėlė;Spinduliukai;8330521602;Taip;0;1;0;1
13971;Žemuogėlė;Spinduliukai;62210251654;Taip;0;1;0;1
13972;Žemuogėlė;Spinduliukai;5888483930;Ne;0;13;0;13
13973;Žemuogėlė;Spinduliukai;91720422401;Taip;6;0;0;6
13974;Žemuogėlė;Spinduliukai;11571302488;Taip;7;4;0;11
13975;Žemuogėlė;Spinduliukai;54745410330;Taip;0;5;0;5
13976;Žemuogėlė;Spinduliukai;33317814956;Taip;6;1;0;7
13977;Žemuogėlė;Spinduliukai;97511628790;Taip;2;9;0;11
13978;Žemuogėlė;Spinduliukai;38094866639;Taip;17;1;0;18
13979;Žemuogėlė;Spinduliukai;23112873505;Taip;0;2;0;2
13980;Žemuogėlė;Spinduliukai;89042677798;Taip;0;4;0;4
13981;Žemuogėlė;Spinduliukai;64042870424;Taip;0;6;0;6
13982;Žemuogėlė;Spinduliukai;1296464444;Taip;0;2;0;2
13983;Žemuogėlė;Perliukai;37726841145;Taip;0;3;0;3
13984;Žemuogėlė;Perliukai;33112231008;Taip;6;13;0;19
13985;Žemuogėlė;Perliukai;28795421460;Taip;8;1;0;9
13986;Žemuogėlė;Perliukai;92317183904;Taip;10;0;0;10
13987;Žemuogėlė;Perliukai;66464155865;Taip;0;10;0;10
13988;Žemuogėlė;Perliukai;97664138036;Taip;0;1;0;1
13989;Žemuogėlė;Perliukai;87719167969;Taip;0;2;0;2
13990;Žemuogėlė;Perliukai;58604834495;Taip;5;2;0;7
13991;Žemuogėlė;Perliukai;1366286798;Taip;3;2;0;5
13992;Žemuogėlė;Perliukai;29973978107;Taip;1;1;0;2
13993;Žemuogėlė;Perliukai;53763899224;Taip;3;0;0;3
13994;Žemuogėlė;Perliukai;77880141132;Taip;6;0;0;6
13995;Žemuogėlė;Perliukai;8952696734;Taip;0;7;0;7
13996;Žemuogėlė;Perliukai;1844596636;Taip;6;0;0;6
13997;Žemuogėlė;Perliukai;13768771915;Taip;0;1;0;1
13998;Žemuogėlė;Perliukai;22761916112;Taip;0;8;0;8
13999;Žemuogėlė;Perliukai;60841198741;Taip;0;2;0;2
14000;Žemuogėlė;Perliukai;58679808617;Taip;0;4;0;4
14001;Žemuogėlė;Perliukai;34462365948;Taip;0;1;0;1
14002;Žemuogėlė;Perliukai;58894092756;Taip;5;0;0;5
14003;Žemuogėlė;Drugeliai;3854265246;Taip;0;1;0;1
14004;Žemuogėlė;Drugeliai;94792383091;Taip;10;0;0;10
14005;Žemuogėlė;Drugeliai;7403172794;Taip;0;2;0;2
14006;Žemuogėlė;Drugeliai;8023936861;Taip;3;0;0;3
14007;Žemuogėlė;Drugeliai;1223819270;Taip;0;1;0;1
14008;Žemuogėlė;Drugeliai;711908013;Taip;0;1;0;1
14009;Žemuogėlė;Drugeliai;1628749648;Taip;0;0;2;2
14010;Žemuogėlė;Drugeliai;6962103028;Taip;1;0;0;1
14011;Žemuogėlė;Drugeliai;3977351017;Taip;8;0;0;8
14012;Žemuogėlė;Drugeliai;4231767115;Taip;8;0;0;8
14013;Žemuogėlė;Drugeliai;8737612457;Taip;0;9;0;9
14014;Žemuogėlė;Drugeliai;5147617128;Taip;14;1;0;15
14015;Žemuogėlė;Drugeliai;5625943720;Taip;0;5;1;6
14016;Žemuogėlė;Drugeliai;1058207935;Taip;0;10;0;10
14017;Žemuogėlė;Drugeliai;7714826773;Taip;0;4;0;4
14018;Žemuogėlė;Drugeliai;1907004376;Taip;1;1;0;2
14019;Žemuogėlė;Drugeliai;9315711142;Taip;0;0;1;1
14020;Žemuogėlė;Drugeliai;2102057496;Taip;0;1;0;1
14021;Žemuogėlė;"VIEVERSIUKAI ";7804015060;Taip;11;0;0;11
14022;Žemuogėlė;"VIEVERSIUKAI ";3706531223;Taip;7;2;0;9
14023;Žemuogėlė;"VIEVERSIUKAI ";4565097904;Taip;0;8;0;8
14024;Žemuogėlė;"VIEVERSIUKAI ";1049009199;Taip;5;5;0;10
14025;Žemuogėlė;"VIEVERSIUKAI ";8644564820;Taip;9;0;0;9
14026;Žemuogėlė;"VIEVERSIUKAI ";9378432383;Taip;0;1;0;1
14027;Žemuogėlė;"VIEVERSIUKAI ";6747566307;Taip;5;1;0;6
14028;Žemuogėlė;"VIEVERSIUKAI ";4421397490;Taip;1;2;0;3
14029;Žemuogėlė;"VIEVERSIUKAI ";3714945248;Taip;21;0;0;21
14030;Žemuogėlė;"VIEVERSIUKAI ";2001471529;Taip;6;0;0;6
14031;Žemuogėlė;"VIEVERSIUKAI ";2841634296;Taip;11;3;0;14
14032;Žemuogėlė;"VIEVERSIUKAI ";6913038845;Taip;21;0;0;21
14033;Žemuogėlė;"VIEVERSIUKAI ";9579921777;Taip;2;1;0;3
14034;Žemuogėlė;"VIEVERSIUKAI ";6169845677;Taip;7;0;2;9
14035;Žemuogėlė;"VIEVERSIUKAI ";5532053268;Taip;0;3;0;3
14036;Žemuogėlė;"VIEVERSIUKAI ";1356340471;Taip;21;0;0;21
14037;Žemuogėlė;"NYKŠTUKAI ";3458374439;Taip;0;0;2;2
14038;Žemuogėlė;"NYKŠTUKAI ";3765022476;Taip;3;1;0;4
14039;Žemuogėlė;"NYKŠTUKAI ";9519563708;Taip;8;0;0;8
14040;Žemuogėlė;"NYKŠTUKAI ";9693894254;Taip;0;1;0;1
14041;Žemuogėlė;"NYKŠTUKAI ";2555902309;Taip;0;13;0;13
14042;Žemuogėlė;"NYKŠTUKAI ";4536398519;Taip;5;3;2;10
14043;Žemuogėlė;"NYKŠTUKAI ";8757701456;Taip;0;1;0;1
14044;Žemuogėlė;"NYKŠTUKAI ";1844299594;Taip;11;2;0;13
14045;Žemuogėlė;"NYKŠTUKAI ";2132549536;Taip;0;4;0;4
14046;Žemuogėlė;"NYKŠTUKAI ";8496353410;Taip;6;2;0;8
14047;Žemuogėlė;"NYKŠTUKAI ";9592456683;Taip;2;2;0;4
14048;Žemuogėlė;"NYKŠTUKAI ";6581889641;Taip;17;0;0;17
14049;Žemuogėlė;"NYKŠTUKAI ";5266493632;Taip;11;0;0;11
14050;Žemuogėlė;"NYKŠTUKAI ";3237083654;Taip;6;9;0;15
14051;Žemuogėlė;"NYKŠTUKAI ";2259779058;Taip;7;0;0;7
14052;Žemuogėlė;"NYKŠTUKAI ";5418395023;Taip;15;1;0;16
14053;Žemuogėlė;"NYKŠTUKAI ";1733808230;Taip;10;0;0;10
14054;Žemuogėlė;"NYKŠTUKAI ";1713927628;Taip;0;1;0;1
14055;Žemuogėlė;KIŠKUČIAI;3411390558;Taip;21;0;0;21
14056;Žemuogėlė;KIŠKUČIAI;6963684639;Taip;2;4;0;6
14057;Žemuogėlė;KIŠKUČIAI;1377813636;Taip;6;0;0;6
14058;Žemuogėlė;KIŠKUČIAI;9689082202;Taip;15;1;0;16
14059;Žemuogėlė;KIŠKUČIAI;8409711622;Taip;0;3;0;3
14060;Žemuogėlė;KIŠKUČIAI;9955429241;Taip;6;0;0;6
14061;Žemuogėlė;KIŠKUČIAI;5770044886;Taip;5;0;0;5
14062;Žemuogėlė;KIŠKUČIAI;6726124641;Taip;15;0;0;15
14063;Žemuogėlė;KIŠKUČIAI;5127370193;Taip;0;12;0;12
14064;Žemuogėlė;KIŠKUČIAI;5126348190;Taip;2;0;0;2
14065;Žemuogėlė;KIŠKUČIAI;7177725663;Taip;8;5;0;13
14066;Žemuogėlė;KIŠKUČIAI;9534937419;Taip;12;0;0;12
14067;Žemuogėlė;KIŠKUČIAI;2481547868;Taip;12;0;1;13
14068;Žemuogėlė;KIŠKUČIAI;3612833383;Taip;16;0;0;16
14069;Žemuogėlė;KIŠKUČIAI;3000676765;Taip;11;0;1;12
14070;Žemuogėlė;KIŠKUČIAI;4317453894;Taip;9;0;0;9
14071;Žemuogėlė;KIŠKUČIAI;1275552038;Taip;16;0;0;16
14072;Žibutė;PELĖDŽIUKAI;54535455969;Taip;0;0;2;2
14073;Žibutė;PELĖDŽIUKAI;62146271609;Taip;1;0;0;1
14074;Žibutė;PELĖDŽIUKAI;59824395612;Taip;5;1;0;6
14075;Žibutė;PELĖDŽIUKAI;2361682400;Taip;3;2;0;5
14076;Žibutė;PELĖDŽIUKAI;1826763192;Taip;0;1;0;1
14077;Žibutė;PELĖDŽIUKAI;1259481487;Taip;1;0;0;1
14078;Žibutė;PELĖDŽIUKAI;3826875107;Taip;6;4;0;10
14079;Žibutė;PELĖDŽIUKAI;7344095020;Taip;0;4;0;4
14080;Žibutė;PELĖDŽIUKAI;1078105287;Taip;0;2;0;2
14081;Žibutė;PELĖDŽIUKAI;2152452830;Taip;0;0;5;5
14082;Žibutė;PELĖDŽIUKAI;7095870173;Taip;0;6;0;6
14083;Žibutė;PELĖDŽIUKAI;2840754631;Taip;8;0;0;8
14084;Žibutė;PELĖDŽIUKAI;6089325755;Taip;6;0;1;7
14085;Žibutė;PELĖDŽIUKAI;1274409680;Taip;0;8;0;8
14086;Žibutė;KREGŽDUTĖS;10520617100;Taip;14;0;1;15
14087;Žibutė;KREGŽDUTĖS;41927765047;Taip;10;1;2;13
14088;Žibutė;KREGŽDUTĖS;27934987411;Taip;0;1;0;1
14089;Žibutė;KREGŽDUTĖS;69543986022;Taip;0;11;3;14
14090;Žibutė;KREGŽDUTĖS;58408466259;Taip;10;0;1;11
14091;Žibutė;KREGŽDUTĖS;76429804560;Taip;5;0;1;6
14092;Žibutė;KREGŽDUTĖS;70602200548;Taip;0;1;0;1
14093;Žibutė;KREGŽDUTĖS;27387035728;Taip;8;2;0;10
14094;Žibutė;KREGŽDUTĖS;16188398138;Taip;0;0;4;4
14095;Žibutė;KREGŽDUTĖS;74637399002;Taip;3;1;0;4
14096;Žibutė;KREGŽDUTĖS;72101352091;Taip;11;0;0;11
14097;Žibutė;KREGŽDUTĖS;61878941621;Taip;0;1;0;1
14098;Žibutė;KREGŽDUTĖS;68830297615;Taip;5;5;0;10
14099;Žibutė;KREGŽDUTĖS;89599338661;Taip;7;1;0;8
14100;Žibutė;KREGŽDUTĖS;30268398324;Taip;0;2;0;2
14101;Žibutė;KREGŽDUTĖS;19878972163;Taip;0;1;8;9
14102;Žibutė;KREGŽDUTĖS;12199795507;Taip;0;0;2;2
14103;Žibutė;KREGŽDUTĖS;21619209538;Taip;16;0;0;16
14104;Žibutė;KREGŽDUTĖS;72754807096;Taip;0;1;2;3
14105;Žibutė;KREGŽDUTĖS;1735074467;Taip;0;1;4;5
14106;Žibutė;BORUŽĖLĖS;9700866512;Taip;1;1;0;2
14107;Žibutė;BORUŽĖLĖS;3268141759;Taip;0;5;0;5
14108;Žibutė;BORUŽĖLĖS;7774532200;Taip;2;3;0;5
14109;Žibutė;BORUŽĖLĖS;1366469428;Taip;21;0;0;21
14110;Žibutė;BORUŽĖLĖS;2607509585;Taip;3;0;0;3
14111;Žibutė;BORUŽĖLĖS;4825064521;Taip;0;11;0;11
14112;Žibutė;BORUŽĖLĖS;5826523148;Taip;0;2;1;3
14113;Žibutė;BORUŽĖLĖS;5806696915;Taip;5;1;0;6
14114;Žibutė;BORUŽĖLĖS;3957898269;Taip;0;1;0;1
14115;Žibutė;BORUŽĖLĖS;4382812297;Taip;3;0;0;3
14116;Žibutė;BORUŽĖLĖS;1004098038;Taip;14;0;0;14
14117;Žibutė;BORUŽĖLĖS;7479437931;Taip;21;0;0;21
14118;Žibutė;BITUTĖS;3194445795;Taip;0;1;0;1
14119;Žibutė;BITUTĖS;14091973543;Taip;14;0;0;14
14120;Žibutė;BITUTĖS;29414890756;Taip;20;0;0;20
14121;Žibutė;BITUTĖS;27182644850;Taip;0;1;0;1
14122;Žibutė;BITUTĖS;9591439732;Taip;0;1;0;1
14123;Žibutė;BITUTĖS;4491727022;Taip;0;13;0;13
14124;Žibutė;BITUTĖS;90040902859;Taip;0;4;0;4
14125;Žibutė;BITUTĖS;12087873516;Taip;0;5;0;5
14126;Žibutė;BITUTĖS;39367516353;Taip;3;0;0;3
14127;Žibutė;BITUTĖS;1192143609;Taip;0;1;0;1
14128;Žibutė;BITUTĖS;72357016152;Taip;0;10;0;10
14129;Žibutė;BITUTĖS;1054908586;Taip;0;1;0;1
14130;Žibutė;BITUTĖS;2603387036;Taip;4;0;0;4
14131;Žibutė;BITUTĖS;1215072172;Taip;1;3;0;4
14132;Žibutė;BITUTĖS;1317512329;Taip;9;0;0;9
14133;Žibutė;BITUTĖS;2144866874;Ne;9;0;0;9
14134;Žibutė;BITUTĖS;1010766308;Taip;1;1;0;2
14135;Žibutė;BITUTĖS;1749323904;Taip;0;2;0;2
14136;Žibutė;BITUTĖS;19558564943;Taip;6;1;0;7
14137;Žibutė;BITUTĖS;9109825948;Taip;0;0;1;1
14138;Žibutė;BITUTĖS;6958822972;Taip;0;1;0;1
14139;Žibutė;BITUTĖS;62187632470;Taip;17;0;0;17
14140;Žibutė;KAČIUKAI;65433129636;Taip;0;0;8;8
14141;Žibutė;KAČIUKAI;94054589778;Taip;0;0;1;1
14142;Žibutė;KAČIUKAI;25658034484;Taip;0;0;5;5
14143;Žibutė;KAČIUKAI;2089960385;Taip;0;1;0;1
14144;Žibutė;KAČIUKAI;30838051846;Taip;0;1;0;1
14145;Žibutė;KAČIUKAI;29408732286;Taip;0;2;1;3
14146;Žibutė;KAČIUKAI;35959201106;Taip;0;0;10;10
14147;Žibutė;KAČIUKAI;67702702073;Taip;1;0;4;5
14148;Žibutė;KAČIUKAI;60756444655;Taip;1;0;3;4
14149;Žibutė;KAČIUKAI;33367530216;Taip;6;0;0;6
14150;Žibutė;KAČIUKAI;51435935201;Taip;0;1;2;3
14151;Žibutė;KAČIUKAI;14243834326;Taip;1;0;4;5
14152;Žibutė;KAČIUKAI;19029125959;Taip;0;1;0;1
14153;Žibutė;KAČIUKAI;1683770314;Taip;0;2;1;3
14154;Žibutė;KAČIUKAI;99502912405;Ne;0;1;0;1
14155;Žibutė;KAČIUKAI;10269347801;Taip;0;1;8;9
14156;Žibutė;KAČIUKAI;76137370554;Taip;0;2;1;3
14157;Žibutė;KAČIUKAI;4475507372;Taip;1;0;1;2
14158;Žibutė;KAČIUKAI;2120935059;Taip;0;1;0;1
14159;Žibutė;KAČIUKAI;9655499291;Taip;1;0;0;1
14160;Žibutė;KAČIUKAI;31084244709;Taip;0;0;18;18
14161;Žibutė;ZUIKIAI;6495108202;Taip;0;0;2;2
14162;Žibutė;ZUIKIAI;8715912139;Taip;5;0;0;5
14163;Žibutė;ZUIKIAI;5416015554;Taip;6;0;1;7
14164;Žibutė;ZUIKIAI;2406005105;Taip;16;0;0;16
14165;Žibutė;ZUIKIAI;3555071718;Taip;10;0;1;11
14166;Žibutė;ZUIKIAI;7531027545;Taip;10;0;1;11
14167;Žibutė;ZUIKIAI;3645481894;Taip;0;1;1;2
14168;Žibutė;ZUIKIAI;6074488747;Taip;7;0;1;8
14169;Žibutė;ZUIKIAI;8880329060;Taip;5;0;0;5
14170;Žibutė;ZUIKIAI;2957525481;Taip;4;2;0;6
14171;Žibutė;ZUIKIAI;5009495840;Taip;14;1;0;15
14172;Žibutė;ZUIKIAI;7136145033;Taip;0;0;2;2
14173;Žibutė;ZUIKIAI;5575614158;Taip;18;0;1;19
14174;Žibutė;ZUIKIAI;5190377896;Taip;20;1;0;21
14175;Žibutė;ZUIKIAI;3191351976;Taip;5;0;0;5
14176;Žibutė;ZUIKIAI;9498011134;Taip;5;1;0;6
14177;Žiedas;Bitutės;569146317;Taip;0;2;0;2
14178;Žiedas;Bitutės;52916954220;Taip;0;3;0;3
14179;Žiedas;Bitutės;94672053787;Taip;0;3;1;4
14180;Žiedas;Bitutės;70618764845;Ne;0;2;0;2
14181;Žiedas;Bitutės;86696082162;Ne;0;8;0;8
14182;Žiedas;Bitutės;59723024689;Taip;0;8;0;8
14183;Žiedas;Bitutės;35737299683;Taip;0;0;4;4
14184;Žiedas;Bitutės;35961318907;Ne;0;3;0;3
14185;Žiedas;Bitutės;55194855496;Taip;9;1;0;10
14186;Žiedas;Bitutės;69138351989;Taip;0;3;0;3
14187;Žiedas;Bitutės;31072310441;Taip;4;0;0;4
14188;Žiedas;Bitutės;42649178759;Taip;0;1;0;1
14189;Žiedas;Bitutės;1529539343;Taip;0;14;0;14
14190;Žiedas;Bitutės;4753427269;Taip;0;1;5;6
14191;Žiedas;Bitutės;45167345380;Taip;0;0;5;5
14192;Žiedas;Bitutės;20748238520;Taip;0;0;1;1
14193;Žiedas;Bitutės;53409153553;Taip;0;5;0;5
14194;Žiedas;Bitutės;7708303405;Taip;2;0;0;2
14195;Žiedas;Bitutės;79291005378;Taip;0;2;2;4
14196;Žiedas;Varpeliai;32671505578;Taip;0;2;0;2
14197;Žiedas;Varpeliai;50534384762;Taip;20;0;0;20
14198;Žiedas;Varpeliai;1733596148;Taip;0;2;1;3
14199;Žiedas;Varpeliai;55459877940;Taip;0;3;0;3
14200;Žiedas;Varpeliai;50069962197;Taip;0;9;0;9
14201;Žiedas;Varpeliai;59092030605;Taip;0;3;3;6
14202;Žiedas;Varpeliai;1748932818;Taip;9;1;0;10
14203;Žiedas;Varpeliai;17275054601;Taip;13;0;0;13
14204;Žiedas;Varpeliai;1897597456;Taip;0;3;0;3
14205;Žiedas;Varpeliai;1443451076;Taip;3;2;3;8
14206;Žiedas;Varpeliai;1491929025;Taip;7;2;0;9
14207;Žiedas;Varpeliai;2075892389;Taip;15;0;0;15
14208;Žiedas;Varpeliai;9044903345;Taip;6;0;1;7
14209;Žiedas;Varpeliai;85152640431;Taip;0;1;0;1
14210;Žiedas;Varpeliai;2147350804;Taip;11;2;0;13
14211;Žiedas;Varpeliai;1366570116;Taip;7;0;0;7
14212;Žiedas;Varpeliai;37314210812;Taip;7;0;0;7
14213;Žiedas;Varpeliai;52683198809;Taip;2;0;1;3
14214;Žiedas;Varpeliai;99985645406;Taip;1;0;0;1
14215;Žiedas;Varpeliai;39022317368;Taip;6;2;0;8
14216;Žiedas;Varpeliai;1618815502;Taip;3;0;0;3
14217;Žiedas;Varpeliai;1332249885;Taip;0;1;0;1
14218;Žiedas;Varpeliai;12622490543;Ne;6;3;0;9
14219;Žiedas;Varpeliai;1120478375;Taip;10;3;0;13
14220;Žiedas;Varpeliai;2081656643;Taip;0;4;0;4
14221;Žiedas;Žirniukai;65264733887;Ne;0;1;5;6
14222;Žiedas;Žirniukai;80003937908;Taip;0;1;0;1
14223;Žiedas;Žirniukai;4665596321;Taip;0;10;0;10
14224;Žiedas;Žirniukai;29411390190;Taip;4;5;0;9
14225;Žiedas;Žirniukai;20740539606;Taip;0;3;0;3
14226;Žiedas;Žirniukai;226707253;Taip;0;5;1;6
14227;Žiedas;Žirniukai;81304970766;Taip;1;3;0;4
14228;Žiedas;Žirniukai;66729734455;Taip;0;1;0;1
14229;Žiedas;Žirniukai;28885468502;Ne;14;0;0;14
14230;Žiedas;Žirniukai;50295529511;Taip;0;13;0;13
14231;Žiedas;Žirniukai;23936058075;Taip;4;1;0;5
14232;Žiedas;Žirniukai;29665685563;Taip;0;0;2;2
14233;Žiedas;Žirniukai;83630991208;Taip;0;6;0;6
14234;Žiedas;Žirniukai;33966765931;Taip;15;2;0;17
14235;Žiedas;Žirniukai;56303923223;Taip;0;1;0;1
14236;Žiedas;Žirniukai;39792014616;Taip;0;2;1;3
14237;Žiedas;Žirniukai;31369021056;Taip;0;6;0;6
14238;Žiedas;Žirniukai;34178608904;Taip;8;3;0;11
14239;Žiedas;Žirniukai;1398197280;Taip;0;3;0;3
14240;Žiedas;Žirniukai;1288374706;Taip;0;14;0;14
14241;Žiedas;Žirniukai;1631546874;Ne;0;2;0;2
14242;Žiedas;Žirniukai;1817676038;Taip;0;1;0;1
14243;Žiedas;Žirniukai;85519253910;Taip;0;2;0;2
14244;Žiedas;Žirniukai;2063680054;Taip;2;4;0;6
14245;Žiedas;Ramunėlės;9648580306;Taip;0;1;0;1
14246;Žiedas;Ramunėlės;9736967156;Taip;4;0;0;4
14247;Žiedas;Ramunėlės;4922560649;Taip;6;2;8;16
14248;Žiedas;Ramunėlės;7814504623;Taip;9;0;1;10
14249;Žiedas;Ramunėlės;2095655987;Taip;1;2;0;3
14250;Žiedas;Ramunėlės;7954517383;Taip;0;2;0;2
14251;Žiedas;Ramunėlės;9247088735;Taip;13;0;2;15
14252;Žiedas;Ramunėlės;9699668892;Taip;0;1;0;1
14253;Žiedas;Ramunėlės;6432090199;Taip;0;11;0;11
14254;Žiedas;Ramunėlės;1139186052;Taip;11;2;3;16
14255;Žiedas;Ramunėlės;5653785844;Taip;5;0;0;5
14256;Žiedas;Ramunėlės;5588136738;Taip;4;2;0;6
14257;Žiedas;Ramunėlės;5626494892;Taip;21;0;0;21
14258;Žiedas;Ramunėlės;2083493509;Taip;4;0;0;4
14259;Žiedas;Ramunėlės;7708360056;Taip;0;3;0;3
14260;Žiedas;Ramunėlės;7396006218;Taip;7;4;2;13
14261;Žiedas;Ramunėlės;3586376571;Taip;18;0;0;18
14262;Žiedas;Ramunėlės;6786526552;Taip;11;2;6;19
14263;Žiedas;Ramunėlės;3702078720;Taip;4;0;0;4
14264;Žiedas;Bruknelės;1772492727;Taip;10;0;0;10
14265;Žiedas;Bruknelės;6925923143;Taip;11;5;0;16
14266;Žiedas;Bruknelės;1781950568;Taip;0;1;0;1
14267;Žiedas;Bruknelės;1453937876;Taip;21;0;0;21
14268;Žiedas;Bruknelės;9573180529;Taip;11;4;0;15
14269;Žiedas;Bruknelės;3385568839;Taip;10;5;0;15
14270;Žiedas;Bruknelės;2718046390;Taip;0;4;0;4
14271;Žiedas;Bruknelės;9757771445;Taip;0;6;0;6
14272;Žiedas;Bruknelės;4749655084;Taip;5;2;0;7
14273;Žiedas;Bruknelės;5570910138;Taip;11;2;0;13
14274;Žiedas;Bruknelės;73923918829;Taip;0;1;0;1
14275;Žiedas;Bruknelės;3641595127;Taip;0;3;0;3
14276;Žiedas;Bruknelės;9894489800;Taip;15;0;0;15
14277;Žiedas;Bruknelės;3613860509;Taip;0;4;0;4
14278;Žiedas;Bruknelės;9702211410;Taip;0;1;0;1
14279;Žiedas;Bruknelės;3370495317;Taip;0;6;0;6
14280;Žiedas;Bruknelės;2026462074;Taip;7;0;1;8
14281;Žiedas;Bruknelės;1856012121;Taip;13;0;0;13
14282;Žiedas;Bruknelės;1534169381;Taip;0;4;0;4
14283;Žiedas;Bruknelės;4521161684;Taip;0;8;0;8
14284;Žiedas;Bruknelės;5537717174;Taip;0;12;0;12
14285;Žiedas;Bruknelės;8372385066;Taip;0;0;5;5
14286;Žiedas;Pakalnutės;42049755986;Taip;6;5;0;11
14287;Žiedas;Pakalnutės;52721173922;Taip;0;3;1;4
14288;Žiedas;Pakalnutės;58252361010;Taip;9;4;0;13
14289;Žiedas;Pakalnutės;2060067625;Taip;0;5;0;5
14290;Žiedas;Pakalnutės;2434909184;Taip;3;0;0;3
14291;Žiedas;Pakalnutės;3616767119;Taip;3;0;0;3
14292;Žiedas;Pakalnutės;1600420971;Taip;11;1;0;12
14293;Žiedas;Pakalnutės;3930283171;Taip;11;3;0;14
14294;Žiedas;Pakalnutės;1985949180;Taip;4;0;4;8
14295;Žiedas;Pakalnutės;1708363648;Taip;0;1;0;1
14296;Žiedas;Pakalnutės;1779122644;Taip;5;2;0;7
14297;Žiedas;Pakalnutės;9940683245;Taip;0;5;0;5
14298;Žiedas;Pakalnutės;1200692015;Taip;0;4;0;4
14299;Žiedas;Pakalnutės;1013773415;Taip;5;3;0;8
14300;Žiedas;Pakalnutės;27339844730;Taip;0;6;0;6
14301;Žiedas;Pakalnutės;5812737969;Taip;0;5;0;5
14302;Žiedas;Pakalnutės;1127645903;Taip;0;2;7;9
14303;Žiedas;Pakalnutės;1219022794;Taip;0;12;0;12
14304;Žiedas;Pakalnutės;7647496475;Taip;5;4;0;9
14305;Žiedas;Pakalnutės;1785446716;Taip;8;6;0;14
14306;Žiedas;Pakalnutės;12960180114;Taip;5;1;0;6
14307;Žiedas;Spanguolytės;1215443920;Taip;0;1;0;1
14308;Žiedas;Spanguolytės;5282211767;Taip;0;7;0;7
14309;Žiedas;Spanguolytės;53090437775;Taip;0;4;0;4
14310;Žiedas;Spanguolytės;69245659818;Taip;0;6;0;6
14311;Žiedas;Spanguolytės;9363714015;Taip;0;4;0;4
14312;Žiedas;Spanguolytės;1318132922;Taip;0;1;0;1
14313;Žiedas;Spanguolytės;2037477873;Taip;6;1;0;7
14314;Žiedas;Spanguolytės;5079107907;Taip;0;5;0;5
14315;Žiedas;Spanguolytės;1450251779;Taip;0;4;0;4
14316;Žiedas;Spanguolytės;4502784565;Taip;0;4;0;4
14317;Žiedas;Spanguolytės;7136135394;Taip;0;5;0;5
14318;Žiedas;Spanguolytės;6964047214;Taip;11;1;0;12
14319;Žiedas;Spanguolytės;8517250094;Taip;4;0;5;9
14320;Žiedas;Spanguolytės;6815408748;Taip;0;1;0;1
14321;Žiedas;Spanguolytės;36350993825;Taip;0;3;0;3
14322;Žiedas;Spanguolytės;8172222365;Taip;0;3;0;3
14323;Žiedas;Spanguolytės;9259436243;Taip;16;0;0;16
14324;Žiedas;Spanguolytės;3346603228;Taip;0;2;0;2
14325;Žiedas;Spanguolytės;5451923881;Taip;7;0;0;7
14326;Žiedas;Rožytės;4016573192;Taip;12;0;0;12
14327;Žiedas;Rožytės;1771805131;Taip;0;10;0;10
14328;Žiedas;Rožytės;83777073799;Taip;6;7;0;13
14329;Žiedas;Rožytės;65360328423;Taip;0;3;0;3
14330;Žiedas;Rožytės;8241660222;Taip;0;3;0;3
14331;Žiedas;Rožytės;4621822895;Ne;5;5;1;11
14332;Žiedas;Rožytės;18236935510;Taip;0;11;0;11
14333;Žiedas;Rožytės;37978194696;Taip;21;0;0;21
14334;Žiedas;Rožytės;98235996578;Taip;0;1;0;1
14335;Žiedas;Rožytės;1971475040;Taip;0;2;1;3
14336;Žiedas;Rožytės;2098165226;Taip;0;1;0;1
14337;Žiedas;Rožytės;1079445123;Taip;2;0;2;4
14338;Žiedas;Rožytės;6745229012;Taip;0;5;0;5
14339;Žiedas;Rožytės;1136010138;Taip;5;11;0;16
14340;Žiedas;Rožytės;74421578926;Taip;0;9;0;9
14341;Žiedas;Rožytės;1618505155;Taip;0;7;0;7
14342;Žiedas;Rožytės;47457128214;Taip;5;0;0;5
14343;Žiedas;Rožytės;40744263923;Taip;0;2;0;2
14344;Žiedas;Rožytės;33135652351;Taip;14;0;0;14
14345;Žiedas;Rožytės;87240375524;Taip;10;7;0;17
14346;Žiedas;Rožytės;1893226570;Taip;11;0;0;11
14347;Žiedas;Rožytės;54324583490;Taip;12;0;1;13
14348;Žiedas;Rožytės;7283725455;Taip;15;2;0;17
14349;Žiedas;Rožytės;56707734658;Taip;12;0;0;12
14350;Žiedas;Rožytės;2157262849;Taip;0;13;0;13
14351;Žiedas;Pumpurėliai;5647232875;Taip;10;0;0;10
14352;Žiedas;Pumpurėliai;1048272199;Taip;4;1;0;5
14353;Žiedas;Pumpurėliai;1645402434;Taip;16;1;0;17
14354;Žiedas;Pumpurėliai;5126173608;Taip;6;1;0;7
14355;Žiedas;Pumpurėliai;6443633568;Taip;0;21;0;21
14356;Žiedas;Pumpurėliai;5959899914;Taip;0;5;0;5
14357;Žiedas;Pumpurėliai;5885209631;Taip;9;0;0;9
14358;Žiedas;Pumpurėliai;7578964555;Taip;0;10;0;10
14359;Žiedas;Pumpurėliai;2134466899;Taip;10;2;4;16
14360;Žiedas;Pumpurėliai;1253833615;Taip;2;2;0;4
14361;Žiedas;Pumpurėliai;4497634040;Taip;3;0;5;8
14362;Žiedas;Pumpurėliai;6822887260;Taip;0;2;2;4
14363;Žiedas;Pumpurėliai;5420327672;Taip;0;1;2;3
14364;Žiedas;Pumpurėliai;5108263139;Taip;0;0;21;21
14365;Žiedas;Pumpurėliai;5703750436;Taip;0;1;0;1
14366;Žiedas;Pumpurėliai;3857121753;Taip;10;0;0;10
14367;Žiedas;Pumpurėliai;3715928992;Taip;5;0;5;10
14368;Žiedas;Pumpurėliai;9352485926;Taip;12;0;0;12
14369;Žiedas;Pumpurėliai;7333813704;Taip;0;2;4;6
14370;Žiedas;Žemuogėlės;7672879525;Taip;3;1;0;4
14371;Žiedas;Žemuogėlės;7097790025;Taip;10;0;0;10
14372;Žiedas;Žemuogėlės;3387263016;Taip;7;2;0;9
14373;Žiedas;Žemuogėlės;1219634640;Taip;0;11;0;11
14374;Žiedas;Žemuogėlės;8927034492;Taip;0;21;0;21
14375;Žiedas;Žemuogėlės;8208331527;Taip;11;2;0;13
14376;Žiedas;Žemuogėlės;1738121071;Taip;9;1;0;10
14377;Žiedas;Žemuogėlės;9037835899;Ne;1;6;0;7
14378;Žiedas;Žemuogėlės;5652936425;Taip;0;2;0;2
14379;Žiedas;Žemuogėlės;1583038469;Taip;11;2;0;13
14380;Žiedas;Žemuogėlės;8812316692;Taip;19;0;0;19
14381;Žiedas;Žemuogėlės;3178778438;Taip;16;2;1;19
14382;Žiedas;Žemuogėlės;2849254119;Taip;15;3;0;18
14383;Žiedas;Žemuogėlės;5914428064;Taip;0;6;0;6
14384;Žiedas;Žemuogėlės;3900091129;Taip;1;2;0;3
14385;Žiedas;Žemuogėlės;3067962647;Ne;0;0;1;1
14386;Žiedas;Žemuogėlės;9587581470;Taip;0;2;0;2
14387;Žiedas;Žemuogėlės;9218388800;Taip;15;1;0;16
14388;Žiedas;Žemuogėlės;9140396365;Taip;3;0;0;3
14389;Žiedas;Žemuogėlės;6444377924;Taip;7;0;0;7
14390;Žiedas;Žemuogėlės;7172793351;Taip;15;1;0;16
14391;Žiedas;Žemuogėlės;5578227349;Taip;10;1;0;11
14392;Žiedas;"Žibutė ";4983852075;Taip;1;0;0;1
14393;Žiedas;"Žibutė ";9129315784;Taip;9;5;0;14
14394;Žiedas;"Žibutė ";9750690920;Taip;6;1;0;7
14395;Žiedas;"Žibutė ";1333233100;Taip;4;0;0;4
14396;Žiedas;"Žibutė ";8645771800;Taip;21;0;0;21
14397;Žiedas;"Žibutė ";4556559021;Taip;17;0;0;17
14398;Žiedas;"Žibutė ";6041919197;Taip;12;0;0;12
14399;Žiedas;"Žibutė ";7187176169;Taip;10;3;0;13
14400;Žiedas;"Žibutė ";4222689492;Taip;13;0;0;13
14401;Žiedas;"Žibutė ";2182381160;Taip;6;0;0;6
14402;Žiedas;"Žibutė ";4284627073;Taip;15;0;0;15
14403;Žiedas;"Žibutė ";8822472312;Taip;0;6;0;6
14404;Žiedas;"Žibutė ";7952899220;Taip;0;6;0;6
14405;Žiedas;"Žibutė ";5020148822;Taip;6;4;0;10
14406;Žiedas;"Žibutė ";1043230748;Taip;5;4;0;9
14407;Žiedas;"Žibutė ";1844621525;Taip;15;1;0;16
14408;Žiedas;"Žibutė ";9021286246;Taip;0;3;0;3
14409;Žiedas;"Dobiliukai ";88471315730;Taip;1;1;0;2
14410;Žiedas;"Dobiliukai ";1484464986;Taip;0;5;0;5
14411;Žiedas;"Dobiliukai ";34193530;Taip;5;0;0;5
14412;Žiedas;"Dobiliukai ";1529988412;Taip;8;2;0;10
14413;Žiedas;"Dobiliukai ";78720591915;Taip;0;1;0;1
14414;Žiedas;"Dobiliukai ";1550350520;Taip;6;0;0;6
14415;Žiedas;"Dobiliukai ";86877563124;Taip;7;1;0;8
14416;Žiedas;"Dobiliukai ";1458152054;Taip;12;1;0;13
14417;Žiedas;"Dobiliukai ";3414702993;Taip;7;1;0;8
14418;Žiedas;"Dobiliukai ";69485023219;Taip;0;1;0;1
14419;Žiedas;"Dobiliukai ";1007894628;Taip;6;1;0;7
14420;Žiedas;"Dobiliukai ";1625009666;Taip;5;4;0;9
14421;Žiedas;"Dobiliukai ";1868951268;Taip;7;0;0;7
14422;Žiedas;"Dobiliukai ";1824692620;Taip;7;0;0;7
14423;Žiedas;"Dobiliukai ";9058688663;Taip;12;1;0;13
14424;Žiedas;"Dobiliukai ";2026728639;Taip;4;0;0;4
14425;Žiedas;"Dobiliukai ";7150433256;Taip;5;1;0;6
14426;Žiedas;"Dobiliukai ";6145720452;Taip;4;0;0;4
14427;Žiedas;"Dobiliukai ";1030089009;Taip;0;2;0;2
14428;Žiedas;"Dobiliukai ";4807479784;Taip;3;0;0;3
14429;Žiedas;"Dobiliukai ";2507543124;Taip;9;0;0;9
14430;Žiedas;Boružėlės;49024435947;Taip;0;6;0;6
14431;Žiedas;Boružėlės;32267919915;Taip;0;0;1;1
14432;Žiedas;Boružėlės;39480704602;Taip;0;1;0;1
14433;Žiedas;Boružėlės;48191698488;Taip;0;0;1;1
14434;Žiedas;Boružėlės;18549289812;Taip;0;1;0;1
14435;Žiedas;Boružėlės;71843517726;Taip;8;2;0;10
14436;Žiedas;Boružėlės;9117238535;Taip;0;5;0;5
14437;Žiedas;Boružėlės;23799596522;Ne;0;0;2;2
14438;Žiedas;Boružėlės;71876894781;Ne;0;0;1;1
14439;Žiedas;Boružėlės;18469282227;Taip;0;1;0;1
14440;Žiedas;Boružėlės;74893931156;Taip;0;0;1;1
14441;Žiedas;Boružėlės;25196433027;Taip;0;6;0;6
14442;Žiedas;Boružėlės;71241692542;Taip;0;10;0;10
14443;Žiedas;Boružėlės;1748516954;Taip;0;2;0;2
14444;Žiedas;Boružėlės;57434309890;Taip;0;3;0;3
14445;Žiedas;Boružėlės;55246099530;Taip;0;2;0;2
14446;Žiedas;Boružėlės;26141244088;Taip;0;0;3;3
14447;Žiedas;Boružėlės;12163984089;Taip;0;1;0;1
14448;Žiedas;Boružėlės;62185387860;Taip;0;3;0;3
14449;Žiedas;Boružėlės;95883894012;Ne;9;1;0;10
14450;Žiogelis;SKRUZDELYTĖS;4508141956;Taip;0;7;4;11
14451;Žiogelis;SKRUZDELYTĖS;4343510173;Taip;2;5;0;7
14452;Žiogelis;SKRUZDELYTĖS;6346503991;Taip;16;0;2;18
14453;Žiogelis;SKRUZDELYTĖS;18018505301;Taip;0;7;0;7
14454;Žiogelis;SKRUZDELYTĖS;3503872654;Taip;0;11;0;11
14455;Žiogelis;SKRUZDELYTĖS;8702710674;Taip;0;13;0;13
14456;Žiogelis;SKRUZDELYTĖS;4671356872;Taip;0;7;0;7
14457;Žiogelis;SKRUZDELYTĖS;7881358741;Taip;0;1;0;1
14458;Žiogelis;SKRUZDELYTĖS;3750023611;Taip;8;0;1;9
14459;Žiogelis;SKRUZDELYTĖS;3609961581;Taip;9;2;0;11
14460;Žiogelis;SKRUZDELYTĖS;64865699245;Taip;10;0;0;10
14461;Žiogelis;SKRUZDELYTĖS;60959051938;Taip;1;0;0;1
14462;Žiogelis;SKRUZDELYTĖS;95713316600;Taip;0;1;0;1
14463;Žiogelis;SKRUZDELYTĖS;24941867247;Taip;5;0;0;5
14464;Žiogelis;SKRUZDELYTĖS;6659086172;Taip;2;2;0;4
14465;Žiogelis;SKRUZDELYTĖS;2883732914;Taip;4;1;0;5
14466;Žiogelis;SKRUZDELYTĖS;3189872952;Taip;8;1;0;9
14467;Žiogelis;SKRUZDELYTĖS;9295720241;Taip;6;0;5;11
14468;Žiogelis;SKRUZDELYTĖS;1568915914;Taip;0;1;0;1
14469;Žiogelis;SKRUZDELYTĖS;3203359908;Taip;14;1;0;15
14470;Žiogelis;SKRUZDELYTĖS;3320077143;Taip;7;0;1;8
14471;Žiogelis;ŽIRNIUKAI;6701809272;Taip;0;2;1;3
14472;Žiogelis;ŽIRNIUKAI;8675451323;Taip;0;1;0;1
14473;Žiogelis;ŽIRNIUKAI;85437321236;Taip;2;0;0;2
14474;Žiogelis;ŽIRNIUKAI;1660784232;Taip;5;1;3;9
14475;Žiogelis;ŽIRNIUKAI;1320651707;Taip;0;2;0;2
14476;Žiogelis;ŽIRNIUKAI;1551989977;Taip;0;1;0;1
14477;Žiogelis;ŽIRNIUKAI;3310492752;Taip;0;0;2;2
14478;Žiogelis;ŽIRNIUKAI;5557800297;Taip;1;2;0;3
14479;Žiogelis;ŽIRNIUKAI;3392582853;Taip;1;2;0;3
14480;Žiogelis;ŽIRNIUKAI;2366095661;Taip;4;0;0;4
14481;Žiogelis;ŽIRNIUKAI;1320126836;Taip;0;2;0;2
14482;Žiogelis;ŽIRNIUKAI;1442866468;Taip;1;1;0;2
14483;Žiogelis;ŽIRNIUKAI;6697117406;Taip;10;0;0;10
14484;Žiogelis;ŽIRNIUKAI;9862582346;Taip;0;0;3;3
14485;Žiogelis;ŽIRNIUKAI;7087781379;Taip;0;4;2;6
14486;Žiogelis;ŽIRNIUKAI;4015109974;Taip;0;4;2;6
14487;Žiogelis;ŽIRNIUKAI;9406830518;Taip;0;5;1;6
14488;Žiogelis;ŽIRNIUKAI;4713696984;Taip;0;0;2;2
14489;Žiogelis;DOBILĖLIAI;66336692039;Taip;0;0;1;1
14490;Žiogelis;DOBILĖLIAI;80149085891;Taip;5;4;0;9
14491;Žiogelis;DOBILĖLIAI;62821992692;Taip;0;4;0;4
14492;Žiogelis;DOBILĖLIAI;54215852783;Taip;0;0;1;1
14493;Žiogelis;DOBILĖLIAI;86956642477;Taip;3;0;0;3
14494;Žiogelis;DOBILĖLIAI;52411020277;Taip;5;0;3;8
14495;Žiogelis;DOBILĖLIAI;98097805447;Taip;6;3;0;9
14496;Žiogelis;DOBILĖLIAI;62488730896;Taip;0;0;2;2
14497;Žiogelis;DOBILĖLIAI;50662980044;Taip;0;0;1;1
14498;Žiogelis;DOBILĖLIAI;3820146581;Taip;0;2;0;2
14499;Žiogelis;DOBILĖLIAI;82777324022;Taip;17;0;0;17
14500;Žiogelis;DOBILĖLIAI;1970044099;Taip;0;5;0;5
14501;Žiogelis;DOBILĖLIAI;41258844862;Taip;0;2;0;2
14502;Žiogelis;BORUŽĖLĖS;49537204301;Taip;0;4;0;4
14503;Žiogelis;BORUŽĖLĖS;79801107515;Taip;0;1;0;1
14504;Žiogelis;BORUŽĖLĖS;73428910367;Taip;0;1;0;1
14505;Žiogelis;BORUŽĖLĖS;3136149837;Taip;0;1;0;1
14506;Žiogelis;BORUŽĖLĖS;76191564181;Taip;1;0;0;1
14507;Žiogelis;BORUŽĖLĖS;41126779124;Taip;0;2;2;4
14508;Žiogelis;BORUŽĖLĖS;33241743715;Taip;18;0;0;18
14509;Žiogelis;BORUŽĖLĖS;57249343296;Taip;8;1;0;9
14510;Žiogelis;BORUŽĖLĖS;85673565399;Taip;5;3;0;8
14511;Žiogelis;BORUŽĖLĖS;30819925055;Taip;0;11;0;11
14512;Žiogelis;BORUŽĖLĖS;81464649021;Taip;0;0;5;5
14513;Žiogelis;BORUŽĖLĖS;74697514256;Ne;0;6;0;6
14514;Žiogelis;BORUŽĖLĖS;18978600625;Taip;0;3;0;3
14515;Žiogelis;BORUŽĖLĖS;89033004994;Taip;8;1;0;9
14516;Žiogelis;BORUŽĖLĖS;32543247974;Taip;0;1;0;1
14517;Žiogelis;BORUŽĖLĖS;73146584544;Taip;0;10;0;10
14518;Žiogelis;BORUŽĖLĖS;86839909955;Taip;0;1;0;1
14519;Žiogelis;BORUŽĖLĖS;78885512443;Ne;0;6;0;6
14520;Žiogelis;DRUGELIAI;9826756136;Taip;9;0;0;9
14521;Žiogelis;DRUGELIAI;40049935108;Taip;0;11;0;11
14522;Žiogelis;DRUGELIAI;37505015919;Taip;7;2;0;9
14523;Žiogelis;DRUGELIAI;85453441005;Taip;0;0;1;1
14524;Žiogelis;DRUGELIAI;25631779076;Taip;0;14;0;14
14525;Žiogelis;DRUGELIAI;91499233609;Taip;5;1;0;6
14526;Žiogelis;DRUGELIAI;40186714037;Taip;0;3;0;3
14527;Žiogelis;DRUGELIAI;52847485981;Taip;0;1;0;1
14528;Žiogelis;DRUGELIAI;96369154198;Taip;0;2;1;3
14529;Žiogelis;DRUGELIAI;56579227266;Taip;4;0;7;11
14530;Žiogelis;DRUGELIAI;66037746045;Taip;0;5;0;5
14531;Žiogelis;DRUGELIAI;68621438109;Taip;0;0;1;1
14532;Žiogelis;DRUGELIAI;18225364866;Taip;0;0;1;1
14533;Žiogelis;DRUGELIAI;18957711548;Taip;0;3;0;3
14534;Žiogelis;DRUGELIAI;52855728176;Ne;0;2;0;2
14535;Žiogelis;DRUGELIAI;35609682774;Taip;5;0;0;5
14536;Žiogelis;DRUGELIAI;1096666450;Taip;3;2;0;5
14537;Žiogelis;DRUGELIAI;1237788562;Taip;0;6;0;6
14538;Žiogelis;DRUGELIAI;1867019234;Taip;0;1;0;1
14539;Žiogelis;DRUGELIAI;1082983134;Taip;8;1;1;10
14540;Žiogelis;DRUGELIAI;97696839366;Taip;8;0;0;8
14541;Žiogelis;PELĖDŽIUKAI;25765405268;Taip;0;1;0;1
14542;Žiogelis;PELĖDŽIUKAI;40656416455;Taip;4;3;0;7
14543;Žiogelis;PELĖDŽIUKAI;58435832422;Taip;0;1;0;1
14544;Žiogelis;PELĖDŽIUKAI;54157468880;Taip;0;1;0;1
14545;Žiogelis;PELĖDŽIUKAI;4546122149;Taip;0;1;0;1
14546;Žiogelis;PELĖDŽIUKAI;75990939732;Taip;0;3;0;3
14547;Žiogelis;PELĖDŽIUKAI;99706324340;Taip;10;1;0;11
14548;Žiogelis;PELĖDŽIUKAI;88467192459;Taip;16;5;0;21
14549;Žiogelis;PELĖDŽIUKAI;9520854450;Taip;0;1;0;1
14550;Žiogelis;PELĖDŽIUKAI;1303123383;Taip;0;1;0;1
14551;Žiogelis;PELĖDŽIUKAI;2100993889;Taip;0;5;0;5
14552;Žiogelis;PELĖDŽIUKAI;82738581846;Taip;0;2;0;2
14553;Žiogelis;PELĖDŽIUKAI;80050087040;Taip;0;18;0;18
14554;Žiogelis;VARPELIAI;98313060080;Taip;0;4;0;4
14555;Žiogelis;VARPELIAI;63443494015;Taip;10;0;0;10
14556;Žiogelis;VARPELIAI;1069475442;Ne;0;6;0;6
14557;Žiogelis;VARPELIAI;81691405176;Taip;21;0;0;21
14558;Žiogelis;VARPELIAI;72043183625;Taip;0;1;0;1
14559;Žiogelis;VARPELIAI;42165847795;Taip;0;7;0;7
14560;Žiogelis;VARPELIAI;1198917418;Taip;3;1;0;4
14561;Žiogelis;VARPELIAI;1261679627;Taip;11;4;0;15
14562;Žiogelis;VARPELIAI;42895811959;Taip;0;4;0;4
14563;Žiogelis;VARPELIAI;44118139818;Taip;0;4;0;4
14564;Žiogelis;VARPELIAI;7708273984;Taip;14;1;0;15
14565;Žiogelis;VARPELIAI;12932356909;Taip;0;7;0;7
14566;Žiogelis;VARPELIAI;1060830668;Taip;15;3;0;18
14567;Žiogelis;VARPELIAI;9871477318;Taip;16;0;0;16
14568;Žiogelis;VARPELIAI;7824632294;Taip;0;1;0;1
14569;Žiogelis;VARPELIAI;6225523016;Taip;0;3;0;3
14570;Žiogelis;VARPELIAI;9436611716;Taip;5;9;0;14
14571;Žiogelis;VARPELIAI;2575280329;Taip;5;0;0;5
14572;Žiogelis;VARPELIAI;4402777236;Taip;11;2;0;13
14573;Žiogelis;VARPELIAI;1370071592;Taip;7;1;0;8
14574;Žiogelis;VARPELIAI;9416538794;Taip;6;1;0;7
14575;Žiogelis;VARPELIAI;7888873296;Taip;6;0;0;6
14576;Žiogelis;KREGŽDUTĖS;20399291813;Taip;14;0;0;14
14577;Žiogelis;KREGŽDUTĖS;52932005977;Taip;10;3;0;13
14578;Žiogelis;KREGŽDUTĖS;28585504631;Taip;9;0;0;9
14579;Žiogelis;KREGŽDUTĖS;71387182665;Taip;14;0;0;14
14580;Žiogelis;KREGŽDUTĖS;94313785346;Taip;0;5;0;5
14581;Žiogelis;KREGŽDUTĖS;88933947850;Taip;0;0;6;6
14582;Žiogelis;KREGŽDUTĖS;22969768169;Taip;0;6;0;6
14583;Žiogelis;KREGŽDUTĖS;1042591705;Taip;0;6;0;6
14584;Žiogelis;KREGŽDUTĖS;1162630845;Taip;0;1;2;3
14585;Žiogelis;KREGŽDUTĖS;2072071751;Taip;0;1;3;4
14586;Žiogelis;KREGŽDUTĖS;1200247527;Taip;21;0;0;21
14587;Žiogelis;KREGŽDUTĖS;41448152472;Taip;9;0;0;9
14588;Žiogelis;KREGŽDUTĖS;44023584723;Taip;7;1;1;9
14589;Žiogelis;KREGŽDUTĖS;1821759690;Taip;5;3;0;8
14590;Žiogelis;KREGŽDUTĖS;24010106626;Taip;0;9;0;9
14591;Žiogelis;ŽVIRBLIUKAI;5364996984;Taip;13;0;0;13
14592;Žiogelis;ŽVIRBLIUKAI;9568208184;Taip;13;0;0;13
14593;Žiogelis;ŽVIRBLIUKAI;2117192553;Taip;13;0;0;13
14594;Žiogelis;ŽVIRBLIUKAI;5961630249;Taip;8;0;0;8
14595;Žiogelis;ŽVIRBLIUKAI;8683148826;Taip;0;13;0;13
14596;Žiogelis;ŽVIRBLIUKAI;3502278745;Taip;2;0;0;2
14597;Žiogelis;ŽVIRBLIUKAI;5054228916;Taip;0;0;1;1
14598;Žiogelis;ŽVIRBLIUKAI;3308563362;Taip;6;0;0;6
14599;Žiogelis;ŽVIRBLIUKAI;3928697936;Taip;9;0;2;11
14600;Žiogelis;ŽVIRBLIUKAI;1190395481;Taip;8;0;0;8
14601;Žiogelis;ŽVIRBLIUKAI;1465027680;Taip;2;0;2;4
14602;Žiogelis;ŽVIRBLIUKAI;6495456608;Taip;0;1;0;1
14603;Žiogelis;ŽVIRBLIUKAI;3852211212;Taip;0;0;1;1
14604;Žiogelis;ŽVIRBLIUKAI;9813150014;Taip;0;0;2;2
14605;Žiogelis;BITUTĖS;5639046412;Ne;0;8;0;8
14606;Žiogelis;BITUTĖS;30488905109;Taip;0;1;0;1
14607;Žiogelis;BITUTĖS;98660118094;Taip;6;2;0;8
14608;Žiogelis;BITUTĖS;6963163354;Taip;0;3;0;3
14609;Žiogelis;BITUTĖS;29876596658;Taip;0;3;0;3
14610;Žiogelis;BITUTĖS;8169022043;Taip;0;1;0;1
14611;Žiogelis;BITUTĖS;84919810287;Taip;0;3;0;3
14612;Žiogelis;BITUTĖS;48896172781;Taip;0;1;0;1
14613;Žiogelis;BITUTĖS;14932261911;Taip;0;1;0;1
14614;Žiogelis;BITUTĖS;67475530006;Taip;0;7;0;7
14615;Žiogelis;BITUTĖS;49836275638;Taip;0;1;0;1
14616;Žiogelis;BITUTĖS;63719135594;Taip;0;1;0;1
14617;Žiogelis;BITUTĖS;8819549855;Taip;2;0;0;2
14618;Žiogelis;BITUTĖS;81608736626;Taip;0;1;0;1
14619;Žiogelis;BITUTĖS;73793165310;Taip;0;3;0;3
14620;Žiogelis;BITUTĖS;28788742249;Taip;0;3;0;3
14621;Žiogelis;BITUTĖS;4465151986;Taip;4;1;0;5
14622;Žiogelis;BITUTĖS;45051106222;Taip;0;1;0;1
14623;Žiogelis;BITUTĖS;87755643169;Taip;2;1;0;3
14624;Žiogelis;RIEŠUTĖLIAI;9981130790;Taip;16;3;0;19
14625;Žiogelis;RIEŠUTĖLIAI;9627583831;Taip;6;1;0;7
14626;Žiogelis;RIEŠUTĖLIAI;5042341085;Taip;17;0;0;17
14627;Žiogelis;RIEŠUTĖLIAI;3752355139;Taip;0;0;1;1
14628;Žiogelis;RIEŠUTĖLIAI;3820534331;Taip;0;1;0;1
14629;Žiogelis;RIEŠUTĖLIAI;1996517542;Taip;0;2;1;3
14630;Žiogelis;RIEŠUTĖLIAI;5545581078;Taip;0;1;0;1
14631;Žiogelis;RIEŠUTĖLIAI;4630381709;Taip;0;4;0;4
14632;Žiogelis;RIEŠUTĖLIAI;9790463889;Taip;17;0;0;17
14633;Žiogelis;RIEŠUTĖLIAI;6024752960;Taip;14;1;0;15
14634;Žiogelis;RIEŠUTĖLIAI;8853905367;Taip;14;1;0;15
14635;Žiogelis;RIEŠUTĖLIAI;1397686161;Taip;0;1;0;1
14636;Žiogelis;RIEŠUTĖLIAI;6760074113;Taip;9;0;0;9
14637;Žiogelis;RIEŠUTĖLIAI;3792114246;Taip;10;3;0;13
14638;Žiogelis;RIEŠUTĖLIAI;8293687695;Taip;6;5;0;11
14639;Žiogelis;RIEŠUTĖLIAI;2455244286;Taip;8;1;0;9
14640;Žolynėlis;Spanguolėlė;25151683915;Taip;0;1;0;1
14641;Žolynėlis;Spanguolėlė;8104525380;Taip;0;2;0;2
14642;Žolynėlis;Spanguolėlė;24353356454;Taip;0;12;0;12
14643;Žolynėlis;Spanguolėlė;97976573561;Taip;10;0;0;10
14644;Žolynėlis;Spanguolėlė;1920564803;Taip;12;4;0;16
14645;Žolynėlis;Spanguolėlė;95943166746;Taip;6;1;0;7
14646;Žolynėlis;Spanguolėlė;4109395683;Taip;21;0;0;21
14647;Žolynėlis;Spanguolėlė;5717038791;Taip;21;0;0;21
14648;Žolynėlis;Spanguolėlė;9128728457;Taip;0;5;0;5
14649;Žolynėlis;Spanguolėlė;1216568014;Taip;0;1;0;1
14650;Žolynėlis;Spanguolėlė;7438853916;Taip;3;5;4;12
14651;Žolynėlis;Spanguolėlė;44063150309;Taip;5;4;3;12
14652;Žolynėlis;Spanguolėlė;8700231970;Taip;2;1;0;3
14653;Žolynėlis;Spanguolėlė;7831076713;Ne;9;2;0;11
14654;Žolynėlis;Spanguolėlė;1901979061;Taip;5;0;0;5
14655;Žolynėlis;Spanguolėlė;2984354887;Taip;0;5;0;5
14656;Žolynėlis;"RŪTELĖ (spec)";49076759224;Taip;14;5;0;19
14657;Žolynėlis;"RŪTELĖ (spec)";44929463545;Taip;15;0;1;16
14658;Žolynėlis;"RŪTELĖ (spec)";88879292846;Taip;9;5;0;14
14659;Žolynėlis;"RŪTELĖ (spec)";1540454207;Taip;12;0;0;12
14660;Žolynėlis;"RŪTELĖ (spec)";1954888655;Taip;21;0;0;21
14661;Žolynėlis;"SAULUTĖ (spec)";89488434450;Ne;15;0;0;15
14662;Žolynėlis;"SAULUTĖ (spec)";78150115970;Taip;5;5;0;10
14663;Žolynėlis;"SAULUTĖ (spec)";9468040148;Taip;5;3;0;8
14664;Žolynėlis;"SAULUTĖ (spec)";1153167430;Taip;5;0;0;5
14665;Žolynėlis;"SAULUTĖ (spec)";4438939800;Taip;5;2;0;7
14666;Žolynėlis;"LINELIS (spec)";93519259505;Taip;0;14;0;14
14667;Žolynėlis;"LINELIS (spec)";7717415005;Taip;16;1;0;17
14668;Žolynėlis;"LINELIS (spec)";2665355759;Taip;16;1;0;17
14669;Žolynėlis;"RASAKILA (spec)";5957587644;Taip;0;10;0;10
14670;Žolynėlis;"RASAKILA (spec)";3337602618;Ne;4;0;0;4
14671;Žolynėlis;"RAMUNĖLĖS (spec)";91598708166;Taip;0;1;0;1
14672;Žolynėlis;"RAMUNĖLĖS (spec)";42425570226;Taip;0;2;0;2
14673;Žolynėlis;"RAMUNĖLĖS (spec)";6080154964;Taip;0;2;0;2
14674;Žolynėlis;"RAMUNĖLĖS (spec)";67411709338;Taip;0;2;1;3
14675;Žolynėlis;Dobiliukai;59125596894;Taip;0;4;0;4
14676;Žolynėlis;Dobiliukai;1123243743;Taip;0;0;2;2
14677;Žolynėlis;Dobiliukai;1655571687;Taip;10;3;0;13
14678;Žolynėlis;Dobiliukai;1197188528;Taip;6;3;3;12
14679;Žolynėlis;Dobiliukai;79759781705;Taip;0;1;0;1
14680;Žolynėlis;Dobiliukai;1833898567;Taip;4;1;0;5
14681;Žolynėlis;Dobiliukai;1331253673;Taip;0;1;0;1
14682;Žolynėlis;Dobiliukai;89750778560;Taip;0;1;0;1
14683;Žolynėlis;Dobiliukai;76688557717;Taip;7;1;0;8
14684;Žolynėlis;Dobiliukai;42333222214;Taip;5;2;0;7
14685;Žolynėlis;Dobiliukai;29420971822;Taip;0;1;0;1
14686;Žolynėlis;Dobiliukai;1080834237;Taip;0;9;0;9
14687;Žolynėlis;Dobiliukai;1619061427;Taip;1;1;0;2
14688;Žolynėlis;Dobiliukai;71887799705;Taip;18;0;0;18
14689;Žolynėlis;Dobiliukai;8872394996;Taip;0;3;0;3
14690;Žolynėlis;Dobiliukai;39450377869;Taip;21;0;0;21
14691;Žolynėlis;Dobiliukai;1933377698;Taip;0;1;0;1
14692;Žolynėlis;Aguonėlė;7313345140;Taip;7;0;0;7
14693;Žolynėlis;Aguonėlė;1620578562;Taip;0;13;0;13
14694;Žolynėlis;Aguonėlė;77707724932;Taip;0;2;2;4
14695;Žolynėlis;Aguonėlė;66167062016;Taip;3;0;0;3
14696;Žolynėlis;Aguonėlė;4545601535;Taip;0;7;0;7
14697;Žolynėlis;Aguonėlė;95007685205;Taip;0;4;0;4
14698;Žolynėlis;Aguonėlė;61475380296;Taip;0;4;0;4
14699;Žolynėlis;Aguonėlė;2051626484;Taip;8;2;0;10
14700;Žolynėlis;Aguonėlė;1348748628;Taip;0;5;0;5
14701;Žolynėlis;Aguonėlė;8027151284;Taip;0;2;7;9
14702;Žolynėlis;Aguonėlė;47825918748;Taip;0;5;0;5
14703;Žolynėlis;Aguonėlė;6169887781;Taip;0;0;9;9
14704;Žolynėlis;Aguonėlė;28730145668;Taip;13;0;5;18
14705;Žolynėlis;Aguonėlė;14877714964;Taip;0;0;2;2
14706;Žolynėlis;Aguonėlė;84849092452;Taip;0;1;0;1
14707;Žolynėlis;Aguonėlė;1257427271;Taip;0;1;0;1
14708;Žolynėlis;Aguonėlė;3263848791;Taip;10;0;4;14
14709;Žolynėlis;Aguonėlė;5827146071;Taip;0;3;0;3
14710;Žolynėlis;Aguonėlė;7256502393;Taip;0;2;4;6
14711;Žolynėlis;Aguonėlė;79704789499;Taip;0;2;1;3
14712;Žolynėlis;Pienė;3520272555;Taip;4;3;0;7
14713;Žolynėlis;Pienė;3088932720;Taip;0;4;0;4
14714;Žolynėlis;Pienė;2108221942;Taip;8;1;0;9
14715;Žolynėlis;Pienė;2934361190;Taip;10;8;0;18
14716;Žolynėlis;Pienė;7980206574;Taip;8;0;0;8
14717;Žolynėlis;Pienė;2460982987;Taip;4;0;1;5
14718;Žolynėlis;Pienė;7339110559;Taip;17;0;0;17
14719;Žolynėlis;Pienė;6763515483;Taip;8;0;0;8
14720;Žolynėlis;Pienė;8215427354;Taip;11;2;3;16
14721;Žolynėlis;Pienė;1485195267;Taip;15;3;0;18
14722;Žolynėlis;Pienė;1163753820;Taip;15;0;0;15
14723;Žolynėlis;Pienė;9106152447;Taip;0;5;0;5
14724;Žolynėlis;Pienė;1879046798;Taip;3;0;0;3
14725;Žolynėlis;Pienė;9941248291;Taip;21;0;0;21
14726;Žolynėlis;Pienė;7827343027;Taip;10;0;7;17
14727;Žolynėlis;Pienė;1338278043;Taip;0;0;21;21
14728;Žolynėlis;Čiobreliai;68439377746;Taip;7;2;0;9
14729;Žolynėlis;Čiobreliai;4379062413;Taip;5;7;0;12
14730;Žolynėlis;Čiobreliai;96960531652;Taip;0;4;0;4
14731;Žolynėlis;Čiobreliai;1135293576;Taip;0;3;0;3
14732;Žolynėlis;Čiobreliai;1188610173;Taip;0;8;0;8
14733;Žolynėlis;Čiobreliai;5262662371;Taip;10;2;0;12
14734;Žolynėlis;Čiobreliai;52441582081;Taip;2;3;0;5
14735;Žolynėlis;Čiobreliai;80589192193;Taip;17;0;0;17
14736;Žolynėlis;Čiobreliai;69270565365;Taip;1;2;0;3
14737;Žolynėlis;Čiobreliai;32852326605;Taip;0;2;0;2
14738;Žolynėlis;Čiobreliai;60635877748;Taip;9;0;0;9
14739;Žolynėlis;Čiobreliai;67610580721;Taip;0;14;0;14
14740;Žolynėlis;Čiobreliai;2142241983;Ne;8;2;0;10
14741;Žolynėlis;Čiobreliai;93243311709;Taip;0;13;0;13
14742;Žolynėlis;Čiobreliai;91866724044;Taip;0;14;0;14
14743;Žolynėlis;Čiobreliai;28388449859;Ne;5;1;0;6
14744;Žolynėlis;Čiobreliai;16469644694;Taip;0;3;0;3
14745;Žolynėlis;Čiobreliai;58271736414;Taip;0;1;0;1
14746;Žolynėlis;Čiobreliai;76160324851;Taip;0;5;0;5
14747;Žolynėlis;Avietėlė;1337138547;Taip;4;1;2;7
14748;Žolynėlis;Avietėlė;5432464074;Taip;0;2;1;3
14749;Žolynėlis;Avietėlė;3192462197;Taip;5;0;5;10
14750;Žolynėlis;Avietėlė;1189484802;Taip;6;0;0;6
14751;Žolynėlis;Avietėlė;2881461471;Taip;0;2;0;2
14752;Žolynėlis;Avietėlė;3984024179;Taip;20;0;0;20
14753;Žolynėlis;Avietėlė;3149718901;Taip;0;19;2;21
14754;Žolynėlis;Avietėlė;6829144389;Taip;0;2;4;6
14755;Žolynėlis;Avietėlė;6416217971;Taip;9;0;1;10
14756;Žolynėlis;Avietėlė;8646095992;Taip;7;1;8;16
14757;Žolynėlis;Rugiagėlė;5767549779;Taip;7;2;0;9
14758;Žolynėlis;Rugiagėlė;1997927874;Taip;7;0;0;7
14759;Žolynėlis;Rugiagėlė;1223126521;Taip;5;7;0;12
14760;Žolynėlis;Rugiagėlė;8547773739;Taip;0;2;0;2
14761;Žolynėlis;Rugiagėlė;25487230804;Taip;7;4;0;11
14762;Žolynėlis;Rugiagėlė;7870236961;Taip;0;17;0;17
14763;Žolynėlis;Rugiagėlė;2785156297;Taip;0;17;4;21
14764;Žolynėlis;Rugiagėlė;3198470147;Taip;0;2;0;2
14765;Žolynėlis;Rugiagėlė;2779563503;Taip;6;0;3;9
14766;Žolynėlis;Rugiagėlė;3422605135;Taip;5;2;0;7
14767;Žolynėlis;Rugiagėlė;5650427433;Taip;21;0;0;21
14768;Žolynėlis;Rugiagėlė;1473516753;Taip;0;0;3;3
14769;Žolynėlis;Rugiagėlė;5668288544;Taip;0;2;0;2
14770;Žolynėlis;Rugiagėlė;9997358375;Taip;10;0;1;11
14771;Žuvėdra;"JŪROS ŽVAIGŽDUTĖS";91701621174;Taip;0;0;8;8
14772;Žuvėdra;"JŪROS ŽVAIGŽDUTĖS";64256836669;Taip;0;0;5;5
14773;Žuvėdra;"JŪROS ŽVAIGŽDUTĖS";27394642359;Taip;0;10;0;10
14774;Žuvėdra;"JŪROS ŽVAIGŽDUTĖS";8495976081;Ne;8;3;0;11
14775;Žuvėdra;"JŪROS ŽVAIGŽDUTĖS";35541220076;Taip;0;17;0;17
14776;Žuvėdra;"JŪROS ŽVAIGŽDUTĖS";12396055288;Taip;9;0;0;9
14777;Žuvėdra;"JŪROS ŽVAIGŽDUTĖS";3516571980;Taip;6;0;0;6
14778;Žuvėdra;"JŪROS ŽVAIGŽDUTĖS";69459090757;Taip;0;7;0;7
14779;Žuvėdra;"JŪROS ŽVAIGŽDUTĖS";1088862044;Taip;0;6;0;6
14780;Žuvėdra;"JŪROS ŽVAIGŽDUTĖS";63818919795;Ne;6;0;0;6
14781;Žuvėdra;"JŪROS ŽVAIGŽDUTĖS";1132159017;Taip;0;2;0;2
14782;Žuvėdra;"JŪROS ŽVAIGŽDUTĖS";1553949223;Taip;9;1;1;11
14783;Žuvėdra;"JŪROS ŽVAIGŽDUTĖS";83557400243;Taip;0;12;0;12
14784;Žuvėdra;"JŪROS ŽVAIGŽDUTĖS";4572580937;Taip;2;0;1;3
14785;Žuvėdra;"JŪROS ŽVAIGŽDUTĖS";97427805302;Taip;11;0;0;11
14786;Žuvėdra;"JŪROS ŽVAIGŽDUTĖS";83890207087;Taip;0;10;0;10
14787;Žuvėdra;DELFINUKAI;1298316563;Ne;0;14;0;14
14788;Žuvėdra;DELFINUKAI;23851864127;Taip;7;2;0;9
14789;Žuvėdra;DELFINUKAI;8843700949;Ne;0;1;0;1
14790;Žuvėdra;DELFINUKAI;1203660127;Taip;0;8;0;8
14791;Žuvėdra;DELFINUKAI;87882215162;Taip;9;0;0;9
14792;Žuvėdra;DELFINUKAI;9911525172;Taip;0;8;0;8
14793;Žuvėdra;DELFINUKAI;34574939898;Taip;0;4;0;4
14794;Žuvėdra;DELFINUKAI;11300891895;Taip;9;2;0;11
14795;Žuvėdra;DELFINUKAI;42069870710;Taip;12;1;0;13
14796;Žuvėdra;DELFINUKAI;19471902337;Taip;0;17;0;17
14797;Žuvėdra;DELFINUKAI;28021807339;Taip;0;7;0;7
14798;Žuvėdra;DELFINUKAI;8096854841;Taip;9;1;0;10
14799;Žuvėdra;DELFINUKAI;3148638780;Taip;10;3;0;13
14800;Žuvėdra;DELFINUKAI;17110908746;Taip;0;4;0;4
14801;Žuvėdra;DELFINUKAI;3943563359;Taip;13;0;0;13
14802;Žuvėdra;DELFINUKAI;5472830961;Ne;13;0;0;13
14803;Žuvėdra;DELFINUKAI;1938808693;Taip;8;0;0;8
14804;Žuvėdra;DELFINUKAI;1147279898;Taip;0;20;0;20
14805;Žuvėdra;DELFINUKAI;2334342995;Taip;0;1;0;1
14806;Žuvėdra;DELFINUKAI;5558584030;Taip;8;0;0;8
14807;Žuvėdra;DELFINUKAI;5049101816;Taip;9;4;0;13
14808;Žuvėdra;OSMINOŽKI;3069966490;Taip;0;1;12;13
14809;Žuvėdra;OSMINOŽKI;27467834587;Taip;0;0;10;10
14810;Žuvėdra;OSMINOŽKI;65157356661;Taip;0;4;0;4
14811;Žuvėdra;OSMINOŽKI;47125994363;Taip;0;9;0;9
14812;Žuvėdra;OSMINOŽKI;21905924984;Taip;0;2;0;2
14813;Žuvėdra;OSMINOŽKI;82141291604;Taip;0;2;0;2
14814;Žuvėdra;OSMINOŽKI;64732685802;Taip;0;1;7;8
14815;Žuvėdra;OSMINOŽKI;1434244321;Taip;7;1;0;8
14816;Žuvėdra;OSMINOŽKI;960934150;Taip;3;6;0;9
14817;Žuvėdra;OSMINOŽKI;51868435508;Taip;0;4;0;4
14818;Žuvėdra;OSMINOŽKI;1762760384;Taip;4;0;0;4
14819;Žuvėdra;OSMINOŽKI;1963584073;Taip;0;4;0;4
14820;Žuvėdra;OSMINOŽKI;2136463079;Taip;0;3;0;3
14821;Žuvėdra;OSMINOŽKI;74446494235;Taip;0;8;0;8
14822;Žuvėdra;OSMINOŽKI;41564122720;Taip;0;4;0;4
14823;Žuvėdra;OSMINOŽKI;1639340750;Taip;0;2;0;2
14824;Žuvėdra;OSMINOŽKI;3487938908;Taip;8;0;0;8
14825;Žuvėdra;OSMINOŽKI;66236924555;Taip;0;2;0;2
14826;Žuvėdra;OSMINOŽKI;66973380124;Taip;21;0;0;21
14827;Žuvėdra;OSMINOŽKI;3862711062;Ne;2;6;0;8
14828;Žuvėdra;OSMINOŽKI;8134671188;Taip;0;0;5;5
14829;Žuvėdra;OSMINOŽKI;4588593273;Taip;0;0;5;5
14830;Žuvėdra;OSMINOŽKI;55687216943;Taip;5;6;0;11
14831;Žuvėdra;OSMINOŽKI;1236696072;Taip;3;0;0;3
14832;Žuvėdra;RUSALAČKA;1116645502;Taip;0;6;0;6
14833;Žuvėdra;RUSALAČKA;1195732987;Taip;0;3;0;3
14834;Žuvėdra;RUSALAČKA;1312918359;Taip;0;7;0;7
14835;Žuvėdra;RUSALAČKA;1923452638;Taip;0;0;1;1
14836;Žuvėdra;RUSALAČKA;6468506668;Ne;10;1;1;12
14837;Žuvėdra;RUSALAČKA;8408371550;Taip;4;0;0;4
14838;Žuvėdra;RUSALAČKA;2731016281;Taip;6;8;0;14
14839;Žuvėdra;RUSALAČKA;1164464390;Taip;10;7;0;17
14840;Žuvėdra;RUSALAČKA;1340241206;Taip;12;1;0;13
14841;Žuvėdra;RUSALAČKA;5021263583;Taip;5;7;0;12
14842;Žuvėdra;RUSALAČKA;5489757084;Taip;0;5;0;5
14843;Žuvėdra;RUSALAČKA;14760907606;Taip;0;0;10;10
14844;Žuvėdra;RUSALAČKA;4011849839;Taip;5;3;0;8
14845;Žuvėdra;RUSALAČKA;75901332720;Taip;0;4;0;4
14846;Žuvėdra;RUSALAČKA;5684848140;Taip;10;3;0;13
14847;Žuvėdra;RUSALAČKA;5496071972;Taip;16;0;0;16
14848;Žuvėdra;RUSALAČKA;63053155507;Taip;0;1;0;1
14849;Žuvėdra;JANTARIKI;5674529681;Taip;17;0;0;17
14850;Žuvėdra;JANTARIKI;9421259943;Taip;1;4;0;5
14851;Žuvėdra;JANTARIKI;1509519996;Taip;0;20;0;20
14852;Žuvėdra;JANTARIKI;6537464526;Taip;0;16;0;16
14853;Žuvėdra;JANTARIKI;9870595577;Taip;7;0;0;7
14854;Žuvėdra;JANTARIKI;6294045755;Taip;0;9;0;9
14855;Žuvėdra;JANTARIKI;7630057671;Taip;0;5;0;5
14856;Žuvėdra;JANTARIKI;7368183516;Taip;0;21;0;21
14857;Žuvėdra;JANTARIKI;3068069755;Taip;0;12;0;12
14858;Žuvėdra;JANTARIKI;5151984122;Taip;0;10;0;10
14859;Žuvėdra;JANTARIKI;3185158741;Taip;0;10;0;10
14860;Žuvėdra;JANTARIKI;1200084485;Taip;8;1;0;9
14861;Žuvėdra;JANTARIKI;2694424532;Taip;12;0;0;12
14862;Žuvėdra;JANTARIKI;5198825127;Taip;19;0;0;19
14863;Žuvėdra;JANTARIKI;4177319374;Taip;4;0;0;4
14864;Žuvėdra;JANTARIKI;5561903903;Taip;3;0;0;3
14865;Žuvėdra;"AUKSINĖ ŽUVELĖ";6547167325;Taip;10;0;0;10
14866;Žuvėdra;"AUKSINĖ ŽUVELĖ";8434697374;Taip;21;0;0;21
14867;Žuvėdra;"AUKSINĖ ŽUVELĖ";5157814568;Taip;13;0;0;13
14868;Žuvėdra;"AUKSINĖ ŽUVELĖ";7916717208;Taip;0;4;0;4
14869;Žuvėdra;"AUKSINĖ ŽUVELĖ";4497938258;Taip;0;1;0;1
14870;Žuvėdra;"AUKSINĖ ŽUVELĖ";2092890028;Taip;11;3;0;14
14871;Žuvėdra;"AUKSINĖ ŽUVELĖ";1311162040;Taip;7;5;0;12
14872;Žuvėdra;"AUKSINĖ ŽUVELĖ";3853045274;Taip;8;1;0;9
14873;Žuvėdra;"AUKSINĖ ŽUVELĖ";4864834075;Taip;0;4;0;4
14874;Žuvėdra;"AUKSINĖ ŽUVELĖ";5764128482;Taip;18;0;0;18
14875;Žuvėdra;"AUKSINĖ ŽUVELĖ";8512570256;Taip;5;0;0;5
14876;Žuvėdra;"AUKSINĖ ŽUVELĖ";9593426121;Taip;9;1;0;10
14877;Žuvėdra;"AUKSINĖ ŽUVELĖ";2019806688;Taip;9;1;0;10
14878;Žuvėdra;"AUKSINĖ ŽUVELĖ";3445649442;Taip;11;0;0;11
14879;Žuvėdra;"AUKSINĖ ŽUVELĖ";6602037942;Taip;1;20;0;21
14880;Žuvėdra;"AUKSINĖ ŽUVELĖ";3464935314;Taip;5;3;0;8
14881;Žvangutis;PELIUKŲ;1265027238;Taip;4;0;0;4
14882;Žvangutis;PELIUKŲ;6701947168;Taip;0;2;0;2
14883;Žvangutis;PELIUKŲ;6068428687;Taip;12;2;0;14
14884;Žvangutis;PELIUKŲ;50889154641;Taip;6;0;0;6
14885;Žvangutis;PELIUKŲ;1165172787;Taip;6;0;0;6
14886;Žvangutis;PELIUKŲ;1339151674;Taip;0;1;0;1
14887;Žvangutis;PELIUKŲ;1310113034;Taip;6;0;0;6
14888;Žvangutis;PELIUKŲ;7202747419;Taip;5;0;0;5
14889;Žvangutis;PELIUKŲ;9149037184;Taip;0;14;0;14
14890;Žvangutis;PELIUKŲ;3665275100;Taip;12;0;0;12
14891;Žvangutis;PELIUKŲ;7320625500;Taip;0;6;0;6
14892;Žvangutis;PELIUKŲ;3513746926;Taip;21;0;0;21
14893;Žvangutis;PELIUKŲ;4053450010;Taip;19;0;0;19
14894;Žvangutis;PELIUKŲ;9408369641;Taip;0;14;0;14
14895;Žvangutis;PELIUKŲ;6110958520;Taip;10;2;0;12
14896;Žvangutis;PELIUKŲ;5012996199;Taip;5;0;0;5
14897;Žvangutis;PELIUKŲ;8288997508;Taip;0;2;0;2
14898;Žvangutis;PELIUKŲ;3817258555;Taip;13;0;0;13
14899;Žvangutis;PELIUKŲ;6844824726;Taip;15;1;0;16
14900;Žvangutis;PELIUKŲ;3315858185;Taip;15;0;0;15
14901;Žvangutis;PELIUKŲ;92356998180;Taip;8;1;0;9
14902;Žvangutis;PELIUKŲ;6815104137;Taip;6;0;0;6
14903;Žvangutis;PELIUKŲ;5683601025;Taip;0;5;0;5
14904;Žvangutis;PELIUKŲ;8617941954;Taip;0;5;0;5
14905;Žvangutis;ANČIUKŲ;10323604113;Taip;0;8;0;8
14906;Žvangutis;ANČIUKŲ;26860427962;Taip;0;6;0;6
14907;Žvangutis;ANČIUKŲ;3753209769;Taip;0;5;0;5
14908;Žvangutis;ANČIUKŲ;5959638828;Ne;0;1;0;1
14909;Žvangutis;ANČIUKŲ;1008391034;Taip;0;4;0;4
14910;Žvangutis;ANČIUKŲ;1648977542;Taip;0;4;0;4
14911;Žvangutis;ANČIUKŲ;59628443049;Taip;0;9;0;9
14912;Žvangutis;ANČIUKŲ;72773865306;Taip;0;2;0;2
14913;Žvangutis;ANČIUKŲ;48094219446;Taip;0;7;0;7
14914;Žvangutis;ANČIUKŲ;40512304884;Taip;0;4;0;4
14915;Žvangutis;ANČIUKŲ;607103192;Ne;0;1;0;1
14916;Žvangutis;ANČIUKŲ;78462097679;Taip;0;1;0;1
14917;Žvangutis;ANČIUKŲ;77005496286;Taip;5;0;2;7
14918;Žvangutis;ANČIUKŲ;90542583948;Taip;0;0;1;1
14919;Žvangutis;ANČIUKŲ;40872355721;Taip;5;0;0;5
14920;Žvangutis;ANČIUKŲ;29578115987;Taip;0;1;0;1
14921;Žvangutis;ANČIUKŲ;7611207661;Taip;0;12;0;12
14922;Žvangutis;ANČIUKŲ;1416765181;Taip;0;7;0;7
14923;Žvangutis;ANČIUKŲ;4181261835;Taip;0;0;1;1
14924;Žvangutis;PELĖDŽIUKŲ;95130491335;Taip;0;1;0;1
14925;Žvangutis;PELĖDŽIUKŲ;16003414040;Taip;0;0;4;4
14926;Žvangutis;PELĖDŽIUKŲ;93175189832;Taip;6;0;2;8
14927;Žvangutis;PELĖDŽIUKŲ;1353686877;Taip;6;0;2;8
14928;Žvangutis;PELĖDŽIUKŲ;98607926663;Taip;5;1;2;8
14929;Žvangutis;PELĖDŽIUKŲ;9618217868;Taip;6;1;0;7
14930;Žvangutis;PELĖDŽIUKŲ;91140904183;Taip;12;0;2;14
14931;Žvangutis;PELĖDŽIUKŲ;30697407645;Ne;0;4;3;7
14932;Žvangutis;PELĖDŽIUKŲ;86145834840;Taip;0;6;0;6
14933;Žvangutis;PELĖDŽIUKŲ;93894162596;Taip;4;1;1;6
14934;Žvangutis;PELĖDŽIUKŲ;38451136109;Taip;4;3;0;7
14935;Žvangutis;PELĖDŽIUKŲ;39364323060;Taip;0;7;0;7
14936;Žvangutis;PELĖDŽIUKŲ;57033172828;Taip;11;2;1;14
14937;Žvangutis;PELĖDŽIUKŲ;80054829676;Taip;10;1;0;11
14938;Žvangutis;PELĖDŽIUKŲ;11053503331;Taip;11;0;2;13
14939;Žvangutis;PELĖDŽIUKŲ;96992002828;Taip;7;1;0;8
14940;Žvangutis;PELĖDŽIUKŲ;41703990445;Taip;0;6;0;6
14941;Žvangutis;PELĖDŽIUKŲ;5929099485;Taip;5;3;0;8
14942;Žvangutis;PELĖDŽIUKŲ;77044982999;Taip;0;21;0;21
14943;Žvangutis;PELĖDŽIUKŲ;46410307693;Taip;6;0;7;13
14944;Žvangutis;PELĖDŽIUKŲ;18751626988;Taip;0;8;0;8
14945;Žvangutis;PELĖDŽIUKŲ;3049348955;Taip;0;9;0;9
14946;Žvangutis;PELĖDŽIUKŲ;5616640228;Taip;5;0;0;5
14947;Žvangutis;PELĖDŽIUKŲ;1898484868;Taip;0;2;0;2
14948;Žvangutis;PELĖDŽIUKŲ;77459956838;Taip;0;4;0;4
14949;Žvangutis;PELĖDŽIUKŲ;46159057420;Taip;6;2;1;9
14950;Žvangutis;PELĖDŽIUKŲ;12457255518;Taip;0;12;0;12
14951;Žvangutis;KAČIUKŲ;2291142377;Taip;0;1;0;1
14952;Žvangutis;KAČIUKŲ;1882797491;Taip;0;1;0;1
14953;Žvangutis;KAČIUKŲ;65598561926;Taip;0;1;0;1
14954;Žvangutis;KAČIUKŲ;1845521463;Taip;0;0;1;1
14955;Žvangutis;KAČIUKŲ;52544167449;Taip;0;1;0;1
14956;Žvangutis;KAČIUKŲ;8697156717;Taip;0;1;2;3
14957;Žvangutis;KAČIUKŲ;23369081648;Taip;0;7;0;7
14958;Žvangutis;KAČIUKŲ;6989839997;Taip;2;1;2;5
14959;Žvangutis;KAČIUKŲ;1065463278;Ne;0;1;0;1
14960;Žvangutis;KAČIUKŲ;1369424754;Taip;0;12;0;12
14961;Žvangutis;KAČIUKŲ;1823402065;Taip;3;0;0;3
14962;Žvangutis;KAČIUKŲ;6343552093;Taip;0;16;0;16
14963;Žvangutis;KAČIUKŲ;2145325174;Taip;8;2;0;10
14964;Žvangutis;KAČIUKŲ;2251482949;Taip;0;6;0;6
14965;Žvangutis;KAČIUKŲ;45857502483;Taip;0;5;0;5
14966;Žvangutis;KAČIUKŲ;1642007971;Taip;0;13;0;13
14967;Žvangutis;KAČIUKŲ;4699447138;Taip;0;2;0;2
14968;Žvangutis;KAČIUKŲ;1862121693;Taip;0;6;0;6
14969;Žvangutis;KAČIUKŲ;9145365865;Taip;5;9;0;14
14970;Žvangutis;MEŠKUČIŲ;2755838558;Taip;0;9;0;9
14971;Žvangutis;MEŠKUČIŲ;2411307963;Taip;6;6;0;12
14972;Žvangutis;MEŠKUČIŲ;7581320158;Taip;0;1;0;1
14973;Žvangutis;MEŠKUČIŲ;1322688456;Taip;3;1;0;4
14974;Žvangutis;MEŠKUČIŲ;9468660351;Taip;0;5;0;5
14975;Žvangutis;MEŠKUČIŲ;1185135525;Taip;10;4;0;14
14976;Žvangutis;MEŠKUČIŲ;2600596320;Taip;5;0;0;5
14977;Žvangutis;MEŠKUČIŲ;7721746116;Taip;20;0;0;20
14978;Žvangutis;MEŠKUČIŲ;2623107843;Taip;0;3;0;3
14979;Žvangutis;MEŠKUČIŲ;2598842770;Taip;0;18;0;18
14980;Žvangutis;MEŠKUČIŲ;2570379643;Taip;10;1;0;11
14981;Žvangutis;MEŠKUČIŲ;6723079944;Taip;0;13;0;13
14982;Žvangutis;MEŠKUČIŲ;9036869235;Taip;0;13;0;13
14983;Žvangutis;MEŠKUČIŲ;2922083476;Taip;12;2;0;14
14984;Žvangutis;MEŠKUČIŲ;7483570779;Taip;0;13;0;13
14985;Žvangutis;MEŠKUČIŲ;1282567366;Taip;11;1;0;12
14986;Žvangutis;KIŠKUČIŲ;1687362077;Taip;0;11;0;11
14987;Žvangutis;KIŠKUČIŲ;1886637245;Taip;5;0;0;5
14988;Žvangutis;KIŠKUČIŲ;4249416168;Taip;11;0;0;11
14989;Žvangutis;KIŠKUČIŲ;6661791076;Taip;0;5;0;5
14990;Žvangutis;KIŠKUČIŲ;1615111824;Taip;1;0;0;1
14991;Žvangutis;KIŠKUČIŲ;1096499939;Taip;0;8;0;8
14992;Žvangutis;KIŠKUČIŲ;1481786579;Taip;0;2;1;3
14993;Žvangutis;KIŠKUČIŲ;1334567751;Taip;0;3;0;3
14994;Žvangutis;KIŠKUČIŲ;2138652487;Taip;21;0;0;21
14995;Žvangutis;KIŠKUČIŲ;1693249341;Taip;0;6;0;6
14996;Žvangutis;KIŠKUČIŲ;4798540560;Taip;0;2;0;2
14997;Žvangutis;KIŠKUČIŲ;1847928083;Taip;10;3;0;13
14998;Žvangutis;KIŠKUČIŲ;1665136168;Taip;0;12;0;12
14999;Žvangutis;KIŠKUČIŲ;1251015310;Taip;0;1;1;2
15000;Žvangutis;KIŠKUČIŲ;5563516622;Taip;0;5;0;5
15001;Žvangutis;KIŠKUČIŲ;74528704135;Taip;0;6;0;6
15002;Žvangutis;KIŠKUČIŲ;57385778197;Taip;10;0;7;17
15003;Žvangutis;KIŠKUČIŲ;3775960571;Taip;14;6;0;20
15004;Žvangutis;KIŠKUČIŲ;11567978993;Taip;18;0;0;18
15005;Žvangutis;KIŠKUČIŲ;79808715852;Taip;12;9;0;21
15006;Žirniukas;Boružiukų;85078595504;Ne;5;2;0;7
15007;Žirniukas;Boružiukų;87149595988;Taip;10;1;0;11
15008;Žirniukas;Boružiukų;57130875338;Taip;7;0;0;7
15009;Žirniukas;Boružiukų;63316123515;Taip;0;6;0;6
15010;Žirniukas;Boružiukų;7648905323;Taip;0;9;0;9
15011;Žirniukas;Boružiukų;25844087366;Taip;0;3;1;4
15012;Žirniukas;Boružiukų;37993215508;Taip;0;3;2;5
15013;Žirniukas;Boružiukų;86712175200;Taip;0;8;0;8
15014;Žirniukas;Boružiukų;68085114059;Ne;5;3;0;8
15015;Žirniukas;Boružiukų;79871296529;Taip;0;0;9;9
15016;Žirniukas;Boružiukų;74201207995;Taip;0;1;0;1
15017;Žirniukas;Boružiukų;5797345627;Taip;8;5;0;13
15018;Žirniukas;Boružiukų;27435013977;Taip;0;7;0;7
15019;Žirniukas;Boružiukų;93794255172;Taip;3;3;15;21
15020;Žirniukas;Boružiukų;63115775194;Taip;6;1;0;7
15021;Žirniukas;Boružiukų;97256249008;Taip;0;1;0;1
15022;Žirniukas;Boružiukų;70866622909;Taip;6;0;0;6
15023;Žirniukas;Boružiukų;35928289177;Taip;0;6;0;6
15024;Žirniukas;Boružiukų;67770044313;Taip;14;0;0;14
15025;Žirniukas;Boružiukų;52079839837;Taip;0;0;1;1
15026;Žirniukas;Boružiukų;1746748097;Taip;4;6;0;10
15027;Žirniukas;Smalsučiai;1701389895;Taip;0;5;0;5
15028;Žirniukas;Smalsučiai;65471257240;Taip;8;5;0;13
15029;Žirniukas;Smalsučiai;99019576563;Taip;0;1;0;1
15030;Žirniukas;Smalsučiai;56948775759;Taip;0;2;0;2
15031;Žirniukas;Smalsučiai;83035751096;Taip;0;4;0;4
15032;Žirniukas;Smalsučiai;23221186484;Taip;0;3;0;3
15033;Žirniukas;Smalsučiai;43241022100;Taip;0;0;1;1
15034;Žirniukas;Smalsučiai;54285529186;Taip;0;2;0;2
15035;Žirniukas;Smalsučiai;1382313386;Taip;5;1;6;12
15036;Žirniukas;Smalsučiai;49058747304;Taip;0;1;1;2
15037;Žirniukas;Smalsučiai;6718181545;Taip;21;0;0;21
15038;Žirniukas;Smalsučiai;59972903968;Taip;0;1;3;4
15039;Žirniukas;Smalsučiai;37416946100;Taip;0;4;0;4
15040;Žirniukas;Smalsučiai;3723155762;Taip;8;1;4;13
15041;Žirniukas;Smalsučiai;3239212369;Taip;0;2;0;2
15042;Žirniukas;Smalsučiai;83997736517;Taip;1;0;0;1
15043;Žirniukas;Smalsučiai;1150580143;Taip;6;0;6;12
15044;Žirniukas;Smalsučiai;7739943293;Taip;0;4;2;6
15045;Žirniukas;Gėlyčių;86374817570;Taip;0;0;16;16
15046;Žirniukas;Gėlyčių;51940895885;Taip;0;0;2;2
15047;Žirniukas;Gėlyčių;469740948;Taip;0;2;0;2
15048;Žirniukas;Gėlyčių;1514883654;Ne;0;8;0;8
15049;Žirniukas;Gėlyčių;3807957588;Taip;0;18;0;18
15050;Žirniukas;Gėlyčių;57834170089;Taip;0;5;0;5
15051;Žirniukas;Gėlyčių;9192660067;Taip;0;5;0;5
15052;Žirniukas;Gėlyčių;74425301830;Taip;7;4;0;11
15053;Žirniukas;Gėlyčių;3763537106;Taip;11;0;2;13
15054;Žirniukas;Gėlyčių;7809088591;Taip;6;0;2;8
15055;Žirniukas;Gėlyčių;6649555415;Taip;2;0;3;5
15056;Žirniukas;Gėlyčių;59028339197;Taip;0;0;21;21
15057;Žirniukas;Gėlyčių;32583177093;Taip;0;4;0;4
15058;Žirniukas;Gėlyčių;91259031678;Taip;0;0;3;3
15059;Žirniukas;Gėlyčių;1804181833;Taip;15;0;0;15
15060;Žirniukas;Gėlyčių;47573534391;Taip;0;7;0;7
15061;Žirniukas;Gėlyčių;5628943541;Taip;0;0;1;1
15062;Žirniukas;Gėlyčių;1878369945;Taip;6;0;0;6
15063;Žirniukas;Gėlyčių;2072018782;Taip;0;2;0;2
15064;Žirniukas;Gėlyčių;1378845384;Taip;6;3;0;9
15065;Žirniukas;Nykštukų;2309995947;Taip;7;0;0;7
15066;Žirniukas;Nykštukų;1944169398;Taip;0;1;0;1
15067;Žirniukas;Nykštukų;1514504241;Taip;0;0;6;6
15068;Žirniukas;Nykštukų;1064894307;Taip;0;0;4;4
15069;Žirniukas;Nykštukų;1162904969;Taip;0;1;0;1
15070;Žirniukas;Nykštukų;2049123663;Taip;0;0;1;1
15071;Žirniukas;Nykštukų;1017483419;Taip;3;0;0;3
15072;Žirniukas;Nykštukų;6957047759;Taip;3;0;0;3
15073;Žirniukas;Nykštukų;2151329751;Taip;0;8;0;8
15074;Žirniukas;Nykštukų;5939918015;Taip;11;0;0;11
15075;Žirniukas;Nykštukų;3010062747;Taip;11;0;0;11
15076;Žirniukas;Nykštukų;2162238771;Taip;0;1;3;4
15077;Žirniukas;Nykštukų;2029018108;Taip;10;1;0;11
15078;Žirniukas;Nykštukų;5104110821;Taip;8;0;3;11
15079;Žirniukas;Nykštukų;5471647472;Taip;0;0;1;1
15080;Žirniukas;Nykštukų;7644911127;Taip;5;0;0;5
15081;Žirniukas;Nykštukų;6180439078;Taip;5;0;1;6
15082;Žirniukas;Nykštukų;3808838764;Taip;0;1;8;9
15083;Žirniukas;Nykštukų;7975957714;Taip;5;0;3;8
15084;Žirniukas;Saulytės;37852143615;Taip;0;3;15;18
15085;Žirniukas;Saulytės;1409567693;Taip;7;3;0;10
15086;Žirniukas;Saulytės;2022475049;Taip;0;2;0;2
15087;Žirniukas;Saulytės;32419042337;Taip;1;2;0;3
15088;Žirniukas;Saulytės;71263500233;Taip;1;2;13;16
15089;Žirniukas;Saulytės;65898776759;Taip;0;1;0;1
15090;Žirniukas;Saulytės;51172128673;Taip;0;2;0;2
15091;Žirniukas;Saulytės;29420916883;Taip;0;5;0;5
15092;Žirniukas;Saulytės;5189034384;Taip;21;0;0;21
15093;Žirniukas;Saulytės;2294854901;Taip;1;0;7;8
15094;Žirniukas;Saulytės;5188013194;Taip;5;0;0;5
15095;Žirniukas;Saulytės;69810421328;Taip;2;2;1;5
15096;Žirniukas;Saulytės;66153778144;Taip;0;0;4;4
15097;Žirniukas;Saulytės;47491327916;Taip;5;0;0;5
15098;Žirniukas;Saulytės;28992463324;Taip;0;0;10;10
15099;Žirniukas;Saulytės;60060805955;Taip;3;0;2;5
15100;Žirniukas;Saulytės;71922426195;Taip;0;6;0;6
15101;Žirniukas;Drugelių;2141162140;Taip;5;4;0;9
15102;Žirniukas;Drugelių;1294183547;Taip;5;4;0;9
15103;Žirniukas;Drugelių;2557138057;Taip;0;1;0;1
15104;Žirniukas;Drugelių;3068684150;Taip;17;0;1;18
15105;Žirniukas;Drugelių;8644938346;Taip;3;2;0;5
15106;Žirniukas;Drugelių;2867806329;Taip;21;0;0;21
15107;Žirniukas;Drugelių;8190751348;Taip;18;0;0;18
15108;Žirniukas;Drugelių;2282495237;Taip;0;0;5;5
15109;Žirniukas;Drugelių;1961708150;Taip;0;8;0;8
15110;Žirniukas;Drugelių;1393738771;Taip;0;0;2;2
15111;Žirniukas;Drugelių;98962928727;Taip;0;1;0;1
15112;Žirniukas;Drugelių;6409900451;Taip;1;0;10;11
15113;Žirniukas;Drugelių;46265018782;Taip;0;1;0;1
15114;Žirniukas;Drugelių;7190628011;Taip;11;4;0;15
15115;Žirniukas;Drugelių;3248779733;Taip;0;5;2;7
15116;Žirniukas;Drugelių;9374080010;Taip;8;0;0;8
15117;Žirniukas;Drugelių;1095501791;Taip;4;6;0;10
15118;Žirniukas;Pelėdžiukai;1163690644;Taip;0;1;0;1
15119;Žirniukas;Pelėdžiukai;1685677297;Taip;5;2;5;12
15120;Žirniukas;Pelėdžiukai;9424009308;Taip;8;5;0;13
15121;Žirniukas;Pelėdžiukai;1542257475;Taip;0;11;0;11
15122;Žirniukas;Pelėdžiukai;98781117814;Taip;8;4;7;19
15123;Žirniukas;Pelėdžiukai;1158530590;Taip;0;2;6;8
15124;Žirniukas;Pelėdžiukai;1352159915;Taip;0;0;2;2
15125;Žirniukas;Pelėdžiukai;1096649614;Taip;6;2;0;8
15126;Žirniukas;Pelėdžiukai;1699821845;Taip;0;0;1;1
15127;Žirniukas;Pelėdžiukai;52845409413;Taip;1;0;0;1
15128;Žirniukas;Pelėdžiukai;1609778506;Taip;0;0;6;6
15129;Žirniukas;Pelėdžiukai;1506642709;Taip;6;2;4;12
15130;Žirniukas;Pelėdžiukai;4789330923;Taip;0;0;2;2
15131;Žirniukas;Pelėdžiukai;2118772211;Taip;12;0;1;13
15132;Žirniukas;Pelėdžiukai;1788183728;Taip;12;0;0;12
15133;Žirniukas;Pelėdžiukai;1907669506;Taip;0;0;1;1
15134;Žirniukas;Pelėdžiukai;1607867151;Taip;7;2;1;10
15135;Žirniukas;Pelėdžiukai;1586083174;Taip;0;15;0;15
15136;Žirniukas;Pelėdžiukai;52181077421;Taip;0;2;3;5
15137;Žirniukas;Pelėdžiukai;5479153220;Taip;6;1;0;7
15138;Žirniukas;Pelėdžiukai;4842182809;Taip;13;0;5;18
15139;Žirniukas;ZUIKUČIAI;9647374339;Taip;0;5;0;5
15140;Žirniukas;ZUIKUČIAI;1867254291;Taip;9;7;2;18
15141;Žirniukas;ZUIKUČIAI;8148254025;Taip;1;0;0;1
15142;Žirniukas;ZUIKUČIAI;6834792589;Ne;0;0;1;1
15143;Žirniukas;ZUIKUČIAI;2348752207;Taip;0;0;16;16
15144;Žirniukas;ZUIKUČIAI;7872611724;Taip;14;0;1;15
15145;Žirniukas;ZUIKUČIAI;2636634198;Taip;0;0;4;4
15146;Žirniukas;ZUIKUČIAI;6531175340;Taip;15;0;0;15
15147;Žirniukas;ZUIKUČIAI;8213507698;Taip;0;6;4;10
15148;Žirniukas;ZUIKUČIAI;2528905738;Taip;5;1;1;7
15149;Žirniukas;ZUIKUČIAI;6363169823;Taip;11;0;0;11
15150;Žirniukas;ZUIKUČIAI;5058103759;Taip;0;3;2;5
15151;Žirniukas;ZUIKUČIAI;3610402086;Taip;7;1;0;8
15152;Aušra;Kodėlčiukai;70233681803;Taip;1;0;0;1
15153;Aušra;Kodėlčiukai;40714551025;Taip;0;4;0;4
15154;Aušra;Kodėlčiukai;40499781883;Taip;0;6;0;6
15155;Aušra;Kodėlčiukai;27091243109;Taip;9;2;0;11
15156;Aušra;Kodėlčiukai;9605206310;Taip;6;0;0;6
15157;Aušra;Kodėlčiukai;19504477542;Taip;3;0;1;4
15158;Aušra;Kodėlčiukai;37104403122;Taip;5;1;0;6
15159;Aušra;Kodėlčiukai;88655846176;Taip;3;1;0;4
15160;Aušra;Kodėlčiukai;13157844661;Taip;0;1;0;1
15161;Aušra;Kodėlčiukai;22032396703;Taip;0;1;0;1
15162;Aušra;Kodėlčiukai;43666690361;Taip;0;6;0;6
15163;Aušra;Kodėlčiukai;97781409787;Ne;0;2;0;2
15164;Aušra;Kodėlčiukai;68160889669;Taip;3;3;0;6
15165;Aušra;Kodėlčiukai;69081281749;Taip;0;18;0;18
15166;Aušra;Kodėlčiukai;18987709566;Taip;3;3;0;6
15167;Aušra;Kodėlčiukai;10347002342;Taip;0;13;0;13
15168;Aušra;Kodėlčiukai;52958921337;Taip;0;5;0;5
15169;Aušra;Pelėdžiukai;8686777160;Taip;0;1;0;1
15170;Aušra;Pelėdžiukai;15657824495;Taip;6;4;0;10
15171;Aušra;Pelėdžiukai;1385844067;Taip;6;1;0;7
15172;Aušra;Pelėdžiukai;35429495907;Taip;20;0;0;20
15173;Aušra;Pelėdžiukai;79051821501;Taip;4;0;0;4
15174;Aušra;Pelėdžiukai;3001784066;Taip;0;3;3;6
15175;Aušra;Pelėdžiukai;14343589644;Taip;0;1;0;1
15176;Aušra;Pelėdžiukai;21234588466;Taip;4;3;0;7
15177;Aušra;Pelėdžiukai;5815377310;Taip;0;3;0;3
15178;Aušra;Pelėdžiukai;23609052737;Taip;0;5;0;5
15179;Aušra;Pelėdžiukai;3823619675;Taip;7;1;0;8
15180;Aušra;Pelėdžiukai;41017803426;Taip;2;0;1;3
15181;Aušra;Pelėdžiukai;13825730049;Taip;7;0;0;7
15182;Aušra;Pelėdžiukai;18943927144;Taip;15;6;0;21
15183;Aušra;Pelėdžiukai;1623803107;Taip;0;2;0;2
15184;Aušra;Pelėdžiukai;57469542504;Taip;6;0;0;6
15185;Aušra;Pelėdžiukai;2121418946;Taip;21;0;0;21
15186;Aušra;Pelėdžiukai;2227238810;Taip;5;1;0;6
15187;Aušra;Pelėdžiukai;2000206874;Taip;0;11;0;11
15188;Aušra;Pelėdžiukai;4325224130;Taip;3;0;0;3
15189;Aušra;Pelėdžiukai;59267104215;Taip;5;1;0;6
15190;Aušra;Smalsučiai;1049364899;Taip;7;3;0;10
15191;Aušra;Smalsučiai;1154675251;Taip;0;3;0;3
15192;Aušra;Smalsučiai;1473962346;Taip;7;3;0;10
15193;Aušra;Smalsučiai;1427235223;Taip;0;2;1;3
15194;Aušra;Smalsučiai;2128822237;Taip;0;3;0;3
15195;Aušra;Smalsučiai;81510885976;Taip;0;1;0;1
15196;Aušra;Smalsučiai;1767520195;Taip;4;0;0;4
15197;Aušra;Smalsučiai;97571593143;Taip;0;2;0;2
15198;Aušra;Smalsučiai;59235411329;Taip;6;3;1;10
15199;Aušra;Smalsučiai;42344686036;Taip;0;4;0;4
15200;Aušra;Smalsučiai;62209740677;Taip;11;0;0;11
15201;Aušra;Smalsučiai;2019580127;Taip;17;2;0;19
15202;Aušra;Smalsučiai;95586246863;Taip;6;6;0;12
15203;Aušra;Smalsučiai;1095212350;Taip;4;0;3;7
15204;Aušra;Smalsučiai;66203768924;Taip;0;1;0;1
15205;Aušra;Smalsučiai;7962184651;Taip;0;2;0;2
15206;Aušra;Smalsučiai;12689030409;Taip;0;1;2;3
15207;Aušra;Smalsučiai;98150444770;Taip;8;2;1;11
15208;Aušra;Smalsučiai;1167565535;Taip;0;8;0;8
15209;Aušra;Smalsučiai;52044254281;Taip;6;0;4;10
15210;Aušra;Smalsučiai;1831747749;Taip;0;8;0;8
15211;Aušra;Smalsučiai;5447986535;Taip;10;2;0;12
15212;Aušra;Smalsučiai;7222605763;Taip;8;0;0;8
15213;Aušra;Smalsučiai;4645855409;Taip;0;16;0;16
15214;Aušra;Pagrandukai;7043021721;Taip;20;1;0;21
15215;Aušra;Pagrandukai;2023718424;Taip;10;1;0;11
15216;Aušra;Pagrandukai;8709340592;Taip;0;1;20;21
15217;Aušra;Pagrandukai;5524681006;Taip;0;1;15;16
15218;Aušra;Pagrandukai;4404047456;Taip;16;0;0;16
15219;Aušra;Pagrandukai;3680329197;Taip;17;0;0;17
15220;Aušra;Pagrandukai;2288159223;Taip;21;0;0;21
15221;Aušra;Pagrandukai;4805298824;Taip;1;1;6;8
15222;Aušra;Pagrandukai;29499576216;Taip;3;0;2;5
15223;Aušra;Pagrandukai;7814902928;Taip;7;2;0;9
15224;Aušra;Pagrandukai;9702136789;Taip;0;2;3;5
15225;Aušra;Pagrandukai;6384243597;Taip;0;1;7;8
15226;Aušra;Pagrandukai;1612662076;Taip;12;0;0;12
15227;Aušra;Pagrandukai;3898178166;Taip;6;0;0;6
15228;Aušra;Pagrandukai;4352174590;Taip;11;0;4;15
15229;Aušra;Pagrandukai;1575761029;Taip;6;1;0;7
15230;Aušra;Pagrandukai;5673568541;Taip;9;1;0;10
15231;Aušra;Pagrandukai;1717797530;Taip;15;0;4;19
15232;Aušra;Pagrandukai;97102749430;Taip;5;0;0;5
15233;Aušra;Pagrandukai;5777939563;Taip;6;0;0;6
15234;Aušra;Pagrandukai;1956830515;Taip;1;1;0;2
15235;Aušra;Pagrandukai;8740755922;Taip;15;0;1;16
15236;Aušra;"1A klasė";81428848455;Taip;0;1;0;1
15237;Aušra;"1A klasė";52864653926;Taip;0;1;0;1
15238;Aušra;"1A klasė";5166358753;Taip;0;1;0;1
15239;Aušra;"1A klasė";78030425432;Taip;0;1;0;1
15240;Aušra;"1A klasė";77425098448;Taip;3;1;0;4
15241;Aušra;"1A klasė";13361663464;Taip;0;1;0;1
15242;Aušra;"1A klasė";21856009403;Taip;0;1;0;1
15243;Aušra;"1A klasė";93365393803;Taip;2;1;0;3
15244;Aušra;"1A klasė";44870195034;Taip;2;1;0;3
15245;Aušra;"1A klasė";10272136932;Taip;0;1;0;1
15246;Aušra;"1A klasė";34795588283;Taip;0;21;0;21
15247;Aušra;"1A klasė";29636399665;Taip;2;1;0;3
15248;Aušra;"1A klasė";42015974556;Taip;0;1;0;1
15249;Aušra;"1A klasė";26101766284;Taip;0;21;0;21
15250;Aušra;"1A klasė";19718806057;Taip;1;1;0;2
15251;Aušra;"1A klasė";19920237804;Taip;1;1;0;2
15252;Aušra;"1A klasė";2113586354;Taip;11;1;0;12
15253;Aušra;"1A klasė";70687041413;Taip;0;1;0;1
15254;Aušra;"1A klasė";47725613978;Taip;1;1;0;2
15255;Aušra;"1A klasė";94704151051;Taip;0;1;0;1
15256;Aušra;"1A klasė";20550256232;Taip;1;1;0;2
15257;Aušra;"1A klasė";95948867937;Taip;0;21;0;21
15258;Aušra;"1A klasė";99886964420;Taip;0;21;0;21
15259;Aušra;"1B klasė";35703433862;Taip;0;1;0;1
15260;Aušra;"1B klasė";41039525379;Taip;0;1;0;1
15261;Aušra;"1B klasė";59107169775;Taip;0;1;0;1
15262;Aušra;"1B klasė";41852924528;Taip;0;1;0;1
15263;Aušra;"1B klasė";58526614808;Taip;0;1;0;1
15264;Aušra;"1B klasė";64562667133;Taip;0;1;0;1
15265;Aušra;"1B klasė";36899257479;Ne;0;1;0;1
15266;Aušra;"1B klasė";95076478544;Ne;0;1;0;1
15267;Aušra;"1B klasė";83119050626;Taip;4;1;0;5
15268;Aušra;"1B klasė";52332096506;Taip;0;1;0;1
15269;Aušra;"1B klasė";45165946624;Taip;0;1;0;1
15270;Aušra;"1B klasė";39957179831;Taip;0;21;0;21
15271;Aušra;"1B klasė";22923377435;Taip;0;1;0;1
15272;Aušra;"1B klasė";71596384638;Taip;5;1;0;6
15273;Aušra;"1B klasė";36889923728;Taip;0;1;0;1
15274;Aušra;"1B klasė";48349819906;Ne;0;1;0;1
15275;Aušra;"1B klasė";1815771421;Taip;9;1;0;10
15276;Aušra;"1B klasė";75433637766;Taip;0;21;0;21
15277;Aušra;"1B klasė";92119607174;Taip;0;1;0;1
15278;Aušra;"1B klasė";37339481276;Taip;1;1;0;2
15279;Aušra;"1B klasė";6201728036;Taip;0;21;0;21
15280;Aušra;"1B klasė";57520886724;Taip;0;21;0;21
15281;Aušra;"1B klasė";63920629625;Taip;0;21;0;21
15282;Aušra;"1B klasė";8901585006;Taip;8;1;0;9
15283;Aušra;"1B klasė";52909474598;Ne;4;1;0;5
15284;Aušra;"2A klasė";8497743711;Ne;0;1;0;1
15285;Aušra;"2A klasė";9510786725;Ne;0;1;0;1
15286;Aušra;"2A klasė";5770340819;Ne;0;1;0;1
15287;Aušra;"2A klasė";5792862565;Ne;0;1;0;1
15288;Aušra;"2A klasė";8892613555;Ne;0;1;0;1
15289;Aušra;"2A klasė";7931858964;Ne;0;1;0;1
15290;Aušra;"2A klasė";4399210916;Ne;0;1;0;1
15291;Aušra;"2A klasė";1585279799;Ne;0;1;0;1
15292;Aušra;"2A klasė";2796012982;Ne;0;1;0;1
15293;Aušra;"2A klasė";9584232864;Ne;1;1;0;2
15294;Aušra;"2A klasė";7113793626;Ne;0;1;0;1
15295;Aušra;"2A klasė";2908360090;Ne;0;1;0;1
15296;Aušra;"2A klasė";5825720308;Ne;0;1;0;1
15297;Aušra;"2A klasė";8367064629;Taip;1;1;0;2
15298;Aušra;"2A klasė";7270744347;Ne;0;21;0;21
15299;Aušra;"2A klasė";8632721907;Ne;0;1;0;1
15300;Aušra;"2A klasė";3435983733;Ne;0;1;0;1
15301;Aušra;"2A klasė";7313001921;Ne;0;1;0;1
15302;Aušra;"2A klasė";6942076490;Ne;0;1;0;1
15303;Aušra;"2A klasė";2797588970;Ne;0;21;0;21
15304;Aušra;"2A klasė";6534693192;Ne;0;1;0;1
15305;Aušra;"2A klasė";5657162092;Ne;0;21;0;21
15306;Aušra;"2A klasė";7439801986;Ne;0;1;0;1
15307;Aušra;"2A klasė";4952796453;Ne;1;1;0;2
15308;Aušra;"2A klasė";1404310604;Ne;0;1;0;1
15309;Aušra;"2A klasė";2280410145;Ne;0;1;0;1
15310;Aušra;"2A klasė";75839555732;Taip;0;1;0;1
15311;Aušra;"2A klasė";29945175192;Taip;0;21;0;21
15312;Aušra;"2A klasė";30628368345;Taip;0;21;0;21
15313;Aušra;"2A klasė";96979357769;Taip;0;21;0;21
15314;Aušra;"3A klasė";2863356239;Ne;0;1;0;1
15315;Aušra;"3A klasė";6540515450;Ne;3;1;0;4
15316;Aušra;"3A klasė";6232778631;Ne;3;1;0;4
15317;Aušra;"3A klasė";3115696927;Ne;0;1;0;1
15318;Aušra;"3A klasė";8543429220;Ne;6;1;0;7
15319;Aušra;"3A klasė";1685764132;Ne;0;1;0;1
15320;Aušra;"3A klasė";5340257141;Ne;2;1;0;3
15321;Aušra;"3A klasė";8328298376;Ne;0;21;0;21
15322;Aušra;"3A klasė";4341245904;Ne;0;1;0;1
15323;Aušra;"3A klasė";9430084940;Ne;0;1;0;1
15324;Aušra;"3A klasė";2942755846;Ne;0;1;0;1
15325;Aušra;"3A klasė";3749854924;Ne;0;1;0;1
15326;Aušra;"3A klasė";1448718807;Ne;0;21;0;21
15327;Aušra;"3A klasė";2951199272;Ne;0;1;0;1
15328;Aušra;"3A klasė";2072790876;Ne;0;1;0;1
15329;Aušra;"3A klasė";1414034080;Ne;5;1;0;6
15330;Aušra;"3A klasė";8550981774;Ne;1;1;0;2
15331;Aušra;"3A klasė";4257487788;Ne;0;1;0;1
15332;Aušra;"3A klasė";9332506542;Ne;0;1;0;1
15333;Aušra;"3A klasė";7499852390;Ne;8;1;0;9
15334;Aušra;"3A klasė";8801106119;Ne;5;1;0;6
15335;Aušra;"3A klasė";7435902333;Ne;4;1;0;5
15336;Aušra;"3A klasė";4190936993;Ne;0;21;0;21
15337;Aušra;"3A klasė";4073898542;Ne;0;1;0;1
15338;Aušra;"3A klasė";54244461148;Ne;0;21;0;21
15339;Aušra;"3A klasė";62035537641;Taip;0;21;0;21
15340;Aušra;"4A klasė";7968234670;Ne;1;1;0;2
15341;Aušra;"4A klasė";5809362777;Ne;0;1;0;1
15342;Aušra;"4A klasė";6916574393;Ne;0;21;0;21
15343;Aušra;"4A klasė";6160171536;Ne;1;1;0;2
15344;Aušra;"4A klasė";6846696720;Ne;1;1;0;2
15345;Aušra;"4A klasė";7665944746;Ne;0;1;0;1
15346;Aušra;"4A klasė";1523223244;Ne;0;1;0;1
15347;Aušra;"4A klasė";4708591140;Ne;0;1;0;1
15348;Aušra;"4A klasė";6865621533;Ne;4;1;0;5
15349;Aušra;"4A klasė";9176277054;Ne;0;1;0;1
15350;Aušra;"4A klasė";1996371462;Ne;0;1;0;1
15351;Aušra;"4A klasė";4682402426;Ne;0;1;0;1
15352;Aušra;"4A klasė";3917149879;Ne;0;21;0;21
15353;Aušra;"4A klasė";6022331977;Ne;0;1;0;1
15354;Aušra;"4A klasė";6363653918;Ne;0;21;0;21
15355;Aušra;"4A klasė";3215515556;Ne;0;1;0;1
15356;Aušra;"4A klasė";4799894746;Taip;0;21;0;21
15357;Aušra;"4A klasė";5569669318;Taip;0;21;0;21
15358;Aušra;"4A klasė";4804202746;Taip;0;21;0;21
15359;Aušra;"4A klasė";3253972586;Taip;0;21;0;21
15360;Aušra;"4A klasė";8150460853;Taip;0;21;0;21
15361;Aušra;"2B klasė";7075053685;Ne;0;1;0;1
15362;Aušra;"2B klasė";7405776766;Ne;0;21;0;21
15363;Aušra;"2B klasė";8476695862;Ne;0;1;0;1
15364;Aušra;"2B klasė";2893668707;Ne;0;1;0;1
15365;Aušra;"2B klasė";7321317333;Ne;8;1;0;9
15366;Aušra;"2B klasė";9736905104;Ne;0;1;0;1
15367;Aušra;"2B klasė";4979458559;Ne;0;1;0;1
15368;Aušra;"2B klasė";7886658451;Ne;0;21;0;21
15369;Aušra;"2B klasė";2075587354;Ne;0;1;0;1
15370;Aušra;"2B klasė";5687605664;Ne;0;21;0;21
15371;Aušra;"2B klasė";2610054474;Ne;0;1;0;1
15372;Aušra;"2B klasė";2412235474;Ne;0;21;0;21
15373;Aušra;"2B klasė";9695887585;Ne;5;1;0;6
15374;Aušra;"2B klasė";7697924792;Ne;1;1;0;2
15375;Aušra;"2B klasė";7553225340;Ne;1;1;0;2
15376;Aušra;"2B klasė";5005513948;Ne;0;1;0;1
15377;Aušra;"2B klasė";3225989797;Ne;1;1;0;2
15378;Aušra;"2B klasė";3114317363;Ne;4;1;0;5
15379;Aušra;"2B klasė";7713995959;Ne;0;1;0;1
15380;Aušra;"2B klasė";9600565378;Ne;1;1;0;2
15381;Aušra;"2B klasė";65535488153;Taip;1;1;0;2
15382;Aušra;"2B klasė";98154599269;Taip;0;21;0;21
15383;Aušra;"2B klasė";95798840861;Taip;0;21;0;21
15384;Aušra;"2B klasė";11449775297;Taip;0;1;0;1
15385;Aušra;"2B klasė";2401823401;Ne;0;1;0;1
15386;Aušra;"2B klasė";70054065156;Taip;4;1;0;5
15387;Berželis;"BOŽJI KOROVKI";1612263252;Taip;0;3;0;3
15388;Berželis;"BOŽJI KOROVKI";59374659821;Taip;5;0;3;8
15389;Berželis;"BOŽJI KOROVKI";69799827219;Taip;5;0;0;5
15390;Berželis;"BOŽJI KOROVKI";75750848557;Ne;0;2;0;2
15391;Berželis;"BOŽJI KOROVKI";56738219250;Taip;0;7;2;9
15392;Berželis;"BOŽJI KOROVKI";56482980062;Ne;5;4;0;9
15393;Berželis;"BOŽJI KOROVKI";77431203813;Taip;3;0;1;4
15394;Berželis;"BOŽJI KOROVKI";27150769109;Taip;3;0;0;3
15395;Berželis;"BOŽJI KOROVKI";58375151019;Taip;0;6;2;8
15396;Berželis;"BOŽJI KOROVKI";33843845240;Taip;0;5;0;5
15397;Berželis;"BOŽJI KOROVKI";1249386338;Taip;7;0;0;7
15398;Berželis;"BOŽJI KOROVKI";24479725723;Taip;0;0;1;1
15399;Berželis;"BOŽJI KOROVKI";88322206113;Taip;0;0;2;2
15400;Berželis;"BOŽJI KOROVKI";79818178445;Taip;0;1;0;1
15401;Berželis;"BOŽJI KOROVKI";9901922166;Taip;0;3;0;3
15402;Berželis;PČIOLKI;1923453586;Taip;6;1;8;15
15403;Berželis;PČIOLKI;91965136118;Taip;5;0;3;8
15404;Berželis;PČIOLKI;83552840429;Taip;0;1;2;3
15405;Berželis;PČIOLKI;86666390300;Taip;4;0;0;4
15406;Berželis;PČIOLKI;93628329777;Taip;0;1;0;1
15407;Berželis;PČIOLKI;13541556141;Taip;0;1;0;1
15408;Berželis;PČIOLKI;4330158489;Taip;4;1;1;6
15409;Berželis;PČIOLKI;95780247776;Taip;0;1;1;2
15410;Berželis;PČIOLKI;79546239108;Taip;15;0;0;15
15411;Berželis;PČIOLKI;6959738006;Taip;0;1;0;1
15412;Berželis;PČIOLKI;37637382978;Taip;0;1;0;1
15413;Berželis;PČIOLKI;41988540665;Taip;6;1;0;7
15414;Berželis;PČIOLKI;2066819593;Taip;5;1;0;6
15415;Berželis;PČIOLKI;84379482983;Taip;0;3;0;3
15416;Berželis;PČIOLKI;37451475613;Taip;0;1;4;5
15417;Berželis;PČIOLKI;95587380846;Taip;5;0;0;5
15418;Berželis;PČIOLKI;48161697699;Taip;5;0;6;11
15419;Berželis;PČIOLKI;18002985276;Taip;0;11;0;11
15420;Berželis;PČIOLKI;1776837439;Taip;6;1;0;7
15421;Berželis;PČIOLKI;17710158252;Taip;0;1;0;1
15422;Berželis;PČIOLKI;36854023525;Taip;0;6;0;6
15423;Berželis;PČIOLKI;7512720601;Taip;5;1;0;6
15424;Berželis;SOLNYŠKO;1740077377;Taip;9;2;0;11
15425;Berželis;SOLNYŠKO;1855559693;Taip;0;11;0;11
15426;Berželis;SOLNYŠKO;91676607875;Taip;0;14;0;14
15427;Berželis;SOLNYŠKO;1729593575;Taip;16;0;0;16
15428;Berželis;SOLNYŠKO;2069597007;Taip;0;21;0;21
15429;Berželis;SOLNYŠKO;97145959022;Taip;17;0;0;17
15430;Berželis;SOLNYŠKO;7334971595;Taip;11;0;0;11
15431;Berželis;SOLNYŠKO;9022925550;Taip;0;9;0;9
15432;Berželis;SOLNYŠKO;68853290649;Taip;0;5;0;5
15433;Berželis;SOLNYŠKO;1929783185;Taip;0;10;0;10
15434;Berželis;SOLNYŠKO;1136612100;Taip;0;21;0;21
15435;Berželis;SOLNYŠKO;7713921014;Taip;5;0;0;5
15436;Berželis;SOLNYŠKO;50400542457;Taip;0;18;0;18
15437;Berželis;BABOČKI;5371508044;Taip;15;0;0;15
15438;Berželis;BABOČKI;1076719080;Taip;21;0;0;21
15439;Berželis;BABOČKI;2016194182;Taip;6;0;1;7
15440;Berželis;BABOČKI;2030770943;Taip;0;0;1;1
15441;Berželis;BABOČKI;1750209600;Taip;0;1;0;1
15442;Berželis;BABOČKI;9839929976;Taip;16;5;0;21
15443;Berželis;BABOČKI;4100740863;Taip;15;4;0;19
15444;Berželis;BABOČKI;2667957070;Taip;5;0;0;5
15445;Berželis;BABOČKI;7781031211;Taip;0;3;1;4
15446;Berželis;BABOČKI;2493612905;Taip;1;0;4;5
15447;Berželis;BABOČKI;5688897783;Taip;0;9;0;9
15448;Berželis;BABOČKI;6942559693;Taip;3;0;1;4
15449;Berželis;BABOČKI;9245706377;Taip;6;1;0;7
15450;Berželis;BABOČKI;6352635742;Taip;0;6;0;6
15451;Berželis;BABOČKI;3097809074;Taip;0;1;0;1
15452;Berželis;BABOČKI;3613459846;Taip;6;0;0;6
15453;Berželis;BABOČKI;8448872491;Taip;0;4;0;4
15454;Berželis;BABOČKI;5069322062;Taip;3;0;0;3
15455;Berželis;SOVUŠKI;8939353460;Taip;21;0;0;21
15456;Berželis;SOVUŠKI;5879965735;Taip;0;0;3;3
15457;Berželis;SOVUŠKI;1183377037;Taip;2;0;0;2
15458;Berželis;SOVUŠKI;61614684164;Taip;7;0;0;7
15459;Berželis;SOVUŠKI;1573177287;Taip;5;1;0;6
15460;Berželis;SOVUŠKI;48932211843;Taip;0;0;3;3
15461;Berželis;SOVUŠKI;11671380984;Taip;15;0;0;15
15462;Berželis;SOVUŠKI;1927042277;Taip;6;3;0;9
15463;Berželis;SOVUŠKI;1865658456;Taip;10;0;0;10
15464;Berželis;SOVUŠKI;1061894314;Taip;18;0;0;18
15465;Berželis;SOVUŠKI;5739686368;Taip;7;1;0;8
15466;Berželis;SOVUŠKI;25985469678;Taip;8;5;0;13
15467;Berželis;SOVUŠKI;2028316867;Ne;0;6;0;6
15468;Berželis;SOVUŠKI;83253240251;Taip;12;0;0;12
15469;Berželis;SOVUŠKI;1470907829;Taip;0;7;0;7
15470;Berželis;SOVUŠKI;9134420285;Taip;5;0;0;5
15471;Berželis;SOVUŠKI;9894036261;Taip;0;0;4;4
15472;Berželis;SOVUŠKI;4080387580;Taip;4;1;0;5
15473;Berželis;SOVUŠKI;1492203156;Taip;17;0;0;17
15474;Berželis;PODSOLNUŠKI;4521372127;Taip;6;2;0;8
15475;Berželis;PODSOLNUŠKI;2214171136;Taip;7;5;0;12
15476;Berželis;PODSOLNUŠKI;97218091736;Taip;0;0;6;6
15477;Berželis;PODSOLNUŠKI;1521982237;Taip;18;0;0;18
15478;Berželis;PODSOLNUŠKI;4013215941;Taip;11;0;0;11
15479;Berželis;PODSOLNUŠKI;7526006253;Taip;0;2;0;2
15480;Berželis;PODSOLNUŠKI;64214150955;Taip;6;0;0;6
15481;Berželis;PODSOLNUŠKI;9024992452;Taip;6;0;1;7
15482;Berželis;PODSOLNUŠKI;9644196870;Taip;0;0;1;1
15483;Berželis;PODSOLNUŠKI;5084171353;Taip;11;0;0;11
15484;Berželis;PODSOLNUŠKI;1225018351;Taip;0;2;0;2
15485;Berželis;PODSOLNUŠKI;6473498471;Taip;3;2;0;5
15486;Berželis;PODSOLNUŠKI;1067618571;Taip;8;0;0;8
15487;Berželis;PODSOLNUŠKI;3772780161;Taip;15;0;0;15
15488;Berželis;PODSOLNUŠKI;4563582416;Taip;15;0;0;15
15489;Berželis;PODSOLNUŠKI;7227603702;Taip;2;0;0;2
15490;Berželis;PODSOLNUŠKI;6113571093;Taip;0;4;0;4
15491;Berželis;PODSOLNUŠKI;1036370516;Taip;0;0;3;3
15492;Berželis;PODSOLNUŠKI;4284157599;Taip;1;0;2;3
15493;Berželis;PODSOLNUŠKI;2615440913;Taip;11;0;0;11
15494;Berželis;"1 klasė";93543942806;Taip;6;1;0;7
15495;Berželis;"1 klasė";68739754511;Taip;5;1;0;6
15496;Berželis;"1 klasė";5442568208;Taip;5;1;0;6
15497;Berželis;"1 klasė";9168601277;Taip;3;1;0;4
15498;Berželis;"1 klasė";2412399682;Taip;10;1;0;11
15499;Berželis;"1 klasė";34721593327;Taip;0;1;0;1
15500;Berželis;"1 klasė";40956353978;Taip;1;1;0;2
15501;Berželis;"1 klasė";12564193771;Taip;0;1;0;1
15502;Berželis;"1 klasė";3658542055;Taip;0;21;0;21
15503;Berželis;"1 klasė";945754955;Taip;1;1;0;2
15504;Berželis;"1 klasė";84043380820;Taip;0;1;0;1
15505;Berželis;"2 klasė";66532479024;Ne;0;21;0;21
15506;Berželis;"2 klasė";3554738276;Taip;0;21;0;21
15507;Berželis;"2 klasė";4750570367;Ne;0;21;0;21
15508;Berželis;"2 klasė";67358830655;Taip;0;21;0;21
15509;Berželis;"2 klasė";13521812215;Taip;0;21;0;21
15510;Berželis;"2 klasė";4263364972;Taip;0;1;0;1
15511;Berželis;"2 klasė";4381565277;Ne;3;1;0;4
15512;Berželis;"2 klasė";7489328291;Ne;8;1;0;9
15513;Berželis;"2 klasė";8888053187;Ne;0;1;0;1
15514;Berželis;"2 klasė";6442475480;Ne;0;1;0;1
15515;Berželis;"2 klasė";3576772433;Ne;0;1;0;1
15516;Berželis;"2 klasė";7835087499;Ne;1;1;0;2
15517;Berželis;"2 klasė";5004603567;Ne;6;1;0;7
15518;Berželis;"2 klasė";9657020323;Ne;0;1;0;1
15519;Berželis;"2 klasė";8433247380;Ne;0;1;0;1
15520;Berželis;"2 klasė";4941738193;Ne;2;1;0;3
15521;Berželis;"2 klasė";1448407405;Ne;0;1;0;1
15522;Berželis;"3 klasė";2501433917;Ne;0;1;0;1
15523;Berželis;"3 klasė";1161378829;Ne;1;1;0;2
15524;Berželis;"3 klasė";8322372921;Ne;0;1;0;1
15525;Berželis;"3 klasė";5856177876;Ne;0;1;0;1
15526;Berželis;"3 klasė";6702857359;Ne;6;1;0;7
15527;Berželis;"3 klasė";4245771747;Ne;0;1;0;1
15528;Berželis;"3 klasė";3149377224;Ne;0;1;0;1
15529;Berželis;"3 klasė";3064700283;Ne;2;1;0;3
15530;Berželis;"3 klasė";9998560354;Ne;0;1;0;1
15531;Berželis;"3 klasė";8143634742;Ne;0;1;0;1
15532;Berželis;"3 klasė";9486991928;Ne;0;1;0;1
15533;Berželis;"3 klasė";8921842915;Ne;0;1;0;1
15534;Berželis;"3 klasė";7728620622;Ne;0;1;0;1
15535;Berželis;"3 klasė";2691853015;Ne;11;1;0;12
15536;Berželis;"3 klasė";2955045450;Ne;0;1;0;1
15537;Berželis;"3 klasė";5616257764;Taip;0;21;0;21
15538;Berželis;"3 klasė";62987603892;Taip;2;1;0;3
15539;Berželis;"3 klasė";50930845005;Taip;0;1;0;1
15540;Berželis;"4 klasė";9853596804;Ne;0;21;0;21
15541;Berželis;"4 klasė";9397809279;Ne;0;21;0;21
15542;Berželis;"4 klasė";2332539534;Ne;2;1;0;3
15543;Berželis;"4 klasė";5637244096;Ne;0;1;0;1
15544;Berželis;"4 klasė";3565822447;Ne;8;1;0;9
15545;Berželis;"4 klasė";9635029366;Ne;2;1;0;3
15546;Berželis;"4 klasė";3773489172;Ne;0;1;0;1
15547;Berželis;"4 klasė";4354272806;Ne;0;1;0;1
15548;Berželis;"4 klasė";2827130989;Ne;6;1;0;7
15549;Berželis;"4 klasė";2155354527;Ne;5;1;0;6
15550;Berželis;"4 klasė";5467777166;Ne;0;1;0;1
15551;Berželis;"4 klasė";6588688183;Taip;1;1;0;2
15552;Saulutė;Drugeliai;66108847230;Taip;5;3;0;8
15553;Saulutė;Drugeliai;1513449225;Taip;10;1;0;11
15554;Saulutė;Drugeliai;1556270046;Taip;0;2;0;2
15555;Saulutė;Drugeliai;3064199909;Taip;3;0;3;6
15556;Saulutė;Drugeliai;2097055107;Taip;0;2;0;2
15557;Saulutė;Drugeliai;1717909005;Taip;0;1;1;2
15558;Saulutė;Drugeliai;1283800571;Taip;6;0;1;7
15559;Saulutė;Drugeliai;8599199376;Taip;6;0;0;6
15560;Saulutė;Drugeliai;1750571258;Taip;2;0;0;2
15561;Saulutė;Drugeliai;87814849917;Taip;0;1;1;2
15562;Saulutė;Drugeliai;1609952589;Taip;5;1;0;6
15563;Saulutė;Drugeliai;1386800520;Taip;11;1;1;13
15564;Saulutė;Drugeliai;1261384337;Taip;0;4;0;4
15565;Saulutė;Drugeliai;1320018338;Taip;0;0;21;21
15566;Saulutė;Drugeliai;1291318940;Taip;21;0;0;21
15567;Saulutė;Drugeliai;2162114750;Ne;0;0;7;7
15568;Saulutė;Drugeliai;9550046358;Taip;6;1;2;9
15569;Saulutė;Drugeliai;1391904744;Taip;10;1;1;12
15570;Saulutė;Drugeliai;8944601874;Taip;6;4;0;10
15571;Saulutė;Drugeliai;1421523719;Taip;5;0;1;6
15572;Saulutė;Drugeliai;67332285574;Taip;3;0;7;10
15573;Saulutė;Drugeliai;4272320685;Taip;5;2;0;7
15574;Saulutė;Drugeliai;1020606591;Taip;0;2;1;3
15575;Saulutė;"Saulės zuikučiai";8946107286;Taip;10;0;0;10
15576;Saulutė;"Saulės zuikučiai";2397257894;Taip;4;6;0;10
15577;Saulutė;"Saulės zuikučiai";1888990522;Taip;0;3;0;3
15578;Saulutė;"Saulės zuikučiai";1686338325;Taip;1;0;6;7
15579;Saulutė;"Saulės zuikučiai";2010774109;Taip;10;6;0;16
15580;Saulutė;"Saulės zuikučiai";3089541630;Taip;3;0;0;3
15581;Saulutė;"Saulės zuikučiai";5148542811;Taip;18;0;0;18
15582;Saulutė;"Saulės zuikučiai";9269501176;Taip;6;0;0;6
15583;Saulutė;"Saulės zuikučiai";2259917151;Taip;12;0;0;12
15584;Saulutė;"Saulės zuikučiai";3749374270;Taip;0;0;3;3
15585;Saulutė;"Saulės zuikučiai";9146298505;Taip;0;2;1;3
15586;Saulutė;"Saulės zuikučiai";8242602551;Taip;14;0;0;14
15587;Saulutė;"Saulės zuikučiai";1324799653;Taip;5;3;0;8
15588;Saulutė;"Saulės zuikučiai";5247769309;Taip;0;2;1;3
15589;Saulutė;"Saulės zuikučiai";1855999738;Ne;0;1;0;1
15590;Saulutė;"Saulės zuikučiai";2816806902;Taip;0;2;0;2
15591;Saulutė;"Saulės zuikučiai";7844396402;Taip;10;1;0;11
15592;Saulutė;"Saulės zuikučiai";2781003892;Taip;0;0;1;1
15593;Saulutė;Boružėlės;36955032265;Taip;10;1;1;12
15594;Saulutė;Boružėlės;44452051978;Ne;0;1;1;2
15595;Saulutė;Boružėlės;25124975646;Taip;0;0;3;3
15596;Saulutė;Boružėlės;36414547943;Taip;0;0;1;1
15597;Saulutė;Boružėlės;54950572289;Taip;0;2;1;3
15598;Saulutė;Boružėlės;92695618159;Taip;0;1;3;4
15599;Saulutė;Boružėlės;87409240076;Taip;0;2;0;2
15600;Saulutė;Boružėlės;1337654926;Taip;12;2;0;14
15601;Saulutė;Boružėlės;97296161595;Taip;0;3;0;3
15602;Saulutė;Boružėlės;1804521229;Taip;16;1;0;17
15603;Saulutė;Boružėlės;1005459768;Taip;0;3;8;11
15604;Saulutė;Boružėlės;1205642335;Taip;13;1;0;14
15605;Saulutė;Boružėlės;43512415452;Taip;8;0;0;8
15606;Saulutė;Boružėlės;1644704074;Taip;8;0;1;9
15607;Saulutė;Boružėlės;1217446865;Taip;0;1;3;4
15608;Saulutė;Boružėlės;8168961080;Ne;10;1;1;12
15609;Saulutė;Boružėlės;89710141573;Taip;0;1;2;3
15610;Saulutė;Boružėlės;46280382280;Taip;3;0;1;4
15611;Saulutė;Boružėlės;10893091651;Taip;6;0;1;7
15612;Saulutė;Boružėlės;70392220915;Taip;0;9;0;9
15613;Saulutė;Nykštukai;34712531615;Taip;2;0;0;2
15614;Saulutė;Nykštukai;10407286767;Taip;0;7;1;8
15615;Saulutė;Nykštukai;95826894716;Taip;0;1;0;1
15616;Saulutė;Nykštukai;6406135063;Ne;0;0;5;5
15617;Saulutė;Nykštukai;59825470089;Taip;0;1;1;2
15618;Saulutė;Nykštukai;65195759604;Taip;0;3;0;3
15619;Saulutė;Nykštukai;84984808072;Taip;0;4;0;4
15620;Saulutė;Nykštukai;46092441981;Taip;0;4;0;4
15621;Saulutė;Nykštukai;37119876987;Taip;0;1;0;1
15622;Saulutė;Nykštukai;63869261653;Taip;13;1;0;14
15623;Saulutė;Nykštukai;9583443237;Taip;0;6;0;6
15624;Saulutė;Nykštukai;10595557639;Taip;3;0;2;5
15625;Saulutė;Nykštukai;7318452189;Taip;0;6;0;6
15626;Saulutė;Nykštukai;78558743548;Taip;0;1;2;3
15627;Saulutė;Nykštukai;91371507376;Ne;5;1;0;6
15628;Saulutė;Nykštukai;1332002470;Taip;5;3;0;8
15629;Saulutė;Nykštukai;1911318708;Taip;0;0;2;2
15630;Saulutė;Nykštukai;9081236999;Ne;0;0;5;5
15631;Saulutė;Nykštukai;9565528566;Taip;17;0;0;17
15632;Saulutė;Meškiukai;8433646525;Taip;5;1;0;6
15633;Saulutė;Meškiukai;3410606033;Taip;13;0;0;13
15634;Saulutė;Meškiukai;9314889468;Taip;15;0;0;15
15635;Saulutė;Meškiukai;6608003946;Taip;0;21;0;21
15636;Saulutė;Meškiukai;8257363228;Taip;17;0;1;18
15637;Saulutė;Meškiukai;7764493159;Taip;5;1;1;7
15638;Saulutė;Meškiukai;5565832676;Taip;5;1;1;7
15639;Saulutė;Meškiukai;9173336078;Taip;4;0;0;4
15640;Saulutė;Meškiukai;3026114869;Taip;15;0;0;15
15641;Saulutė;Meškiukai;6057668143;Taip;15;0;0;15
15642;Saulutė;Meškiukai;8736917541;Taip;7;0;0;7
15643;Saulutė;Meškiukai;7413098580;Taip;5;8;0;13
15644;Saulutė;Meškiukai;5999318972;Taip;6;0;2;8
15645;Saulutė;Meškiukai;2074473832;Taip;9;0;2;11
15646;Saulutė;Meškiukai;7574225926;Taip;0;0;4;4
15647;Saulutė;Ežiukai;19918665437;Taip;6;0;0;6
15648;Saulutė;Ežiukai;63481737955;Taip;0;0;9;9
15649;Saulutė;Ežiukai;55160240384;Taip;2;3;0;5
15650;Saulutė;Ežiukai;1861612651;Taip;4;0;0;4
15651;Saulutė;Ežiukai;19852146326;Taip;0;4;0;4
15652;Saulutė;Ežiukai;1745560688;Taip;16;0;0;16
15653;Saulutė;Ežiukai;32539394191;Taip;5;3;0;8
15654;Saulutė;Ežiukai;1913500127;Taip;0;1;0;1
15655;Saulutė;Ežiukai;3608072547;Taip;0;1;0;1
15656;Saulutė;Ežiukai;6099238784;Taip;0;0;5;5
15657;Saulutė;Ežiukai;12674831673;Taip;2;0;14;16
15658;Saulutė;Ežiukai;1546200973;Taip;11;0;5;16
15659;Saulutė;Ežiukai;1077526046;Taip;0;0;4;4
15660;Saulutė;Ežiukai;1917058710;Taip;6;0;0;6
15661;Saulutė;Ežiukai;1212865434;Ne;10;0;0;10
15662;Saulutė;Ežiukai;2190922941;Taip;15;0;0;15
15663;Saulutė;Ežiukai;5326279083;Taip;0;0;1;1
15664;Saulutė;Ežiukai;2813274509;Taip;16;0;0;16
15665;Saulutė;Bitutės;9892855816;Taip;1;0;0;1
15666;Saulutė;Bitutės;4510990261;Taip;13;0;0;13
15667;Saulutė;Bitutės;3272296969;Taip;2;8;0;10
15668;Saulutė;Bitutės;2545930114;Taip;18;0;0;18
15669;Saulutė;Bitutės;2140277182;Taip;6;0;0;6
15670;Saulutė;Bitutės;6044672321;Taip;10;0;1;11
15671;Saulutė;Bitutės;6396954377;Taip;17;0;0;17
15672;Saulutė;Bitutės;3295289082;Taip;0;5;0;5
15673;Saulutė;Bitutės;8390767549;Taip;21;0;0;21
15674;Saulutė;Bitutės;1056158093;Taip;10;0;7;17
15675;Saulutė;Bitutės;7888435573;Taip;4;0;0;4
15676;Saulutė;Bitutės;7297886198;Taip;6;1;14;21
15677;Saulutė;Bitutės;7576532632;Taip;0;0;4;4
15678;Saulutė;Bitutės;8708184278;Taip;15;0;0;15
15679;Saulutė;Bitutės;8040751073;Taip;5;0;1;6
15680;Saulutė;Bitutės;1587328722;Taip;7;0;0;7
15681;Saulutė;Bitutės;8512137633;Taip;17;4;0;21
15682;Saulutė;Bitutės;2725491887;Taip;10;0;0;10
15683;Saulutė;Bitutės;4123500930;Ne;15;1;2;18
15684;Saulutė;Pelėdžiukai;3445723020;Ne;0;2;2;4
15685;Saulutė;Pelėdžiukai;1785740531;Taip;0;2;0;2
15686;Saulutė;Pelėdžiukai;1534183935;Taip;0;0;1;1
15687;Saulutė;Pelėdžiukai;27386434894;Taip;7;1;0;8
15688;Saulutė;Pelėdžiukai;23640604487;Taip;0;0;1;1
15689;Saulutė;Pelėdžiukai;27752316336;Taip;0;2;0;2
15690;Saulutė;Pelėdžiukai;65492344097;Taip;0;0;2;2
15691;Saulutė;Pelėdžiukai;1935503629;Taip;0;0;2;2
15692;Saulutė;Pelėdžiukai;77923802656;Taip;10;0;0;10
15693;Saulutė;Pelėdžiukai;79919438191;Taip;0;8;2;10
15694;Saulutė;Pelėdžiukai;31705050946;Taip;5;0;2;7
15695;Saulutė;Pelėdžiukai;45306237230;Taip;0;4;2;6
15696;Saulutė;Pelėdžiukai;14195215027;Taip;5;1;2;8
15697;Saulutė;Pelėdžiukai;28772515317;Ne;0;0;4;4
15698;Saulutė;Pelėdžiukai;50944263059;Taip;0;0;3;3
15699;Saulutė;Pelėdžiukai;1510434265;Taip;7;0;0;7
15700;Saulutė;Pelėdžiukai;5574049005;Taip;13;0;2;15
15701;Saulutė;Pelėdžiukai;77170708225;Taip;14;0;0;14
15702;Saulutė;Pelėdžiukai;4312318284;Taip;18;1;0;19
15703;Saulutė;Zylutės;91834332717;Taip;0;13;0;13
15704;Saulutė;Zylutės;1277263391;Taip;10;0;2;12
15705;Saulutė;Zylutės;37315117916;Taip;7;0;0;7
15706;Saulutė;Zylutės;75405796772;Taip;7;0;5;12
15707;Saulutė;Zylutės;35570367633;Taip;7;0;3;10
15708;Saulutė;Zylutės;6557918941;Taip;0;2;3;5
15709;Saulutė;Zylutės;78967475616;Ne;0;3;7;10
15710;Saulutė;Zylutės;1786491396;Taip;0;5;0;5
15711;Saulutė;Zylutės;55982591521;Taip;10;0;1;11
15712;Saulutė;Zylutės;3246485288;Taip;0;0;1;1
15713;Saulutė;Zylutės;21703177024;Taip;7;2;3;12
15714;Saulutė;Zylutės;54373231773;Taip;0;5;0;5
15715;Saulutė;Zylutės;88168936754;Taip;9;0;1;10
15716;Saulutė;Zylutės;85182498024;Taip;0;1;2;3
15717;Saulutė;Zylutės;98979263108;Taip;0;7;0;7
15718;Saulutė;Zylutės;16622528829;Taip;8;6;0;14
15719;Saulutė;Zylutės;1475031090;Taip;10;1;0;11
15720;Saulutė;Zylutės;57283533169;Taip;0;0;3;3
15721;Saulutė;Zylutės;3450668814;Taip;12;1;0;13
15722;Saulutė;Zylutės;13147367113;Taip;0;5;0;5
15723;Saulutė;"1 klasė";5997216605;Taip;18;4;0;22
15724;Saulutė;"1 klasė";92198716772;Taip;10;4;0;14
15725;Saulutė;"1 klasė";8632066475;Ne;18;4;0;22
15726;Saulutė;"1 klasė";67739063665;Taip;4;4;0;8
15727;Saulutė;"1 klasė";50110262859;Taip;0;4;0;4
15728;Saulutė;"1 klasė";6469772450;Taip;18;4;0;22
15729;Saulutė;"1 klasė";4302511346;Ne;18;4;0;22
15730;Saulutė;"1 klasė";18122758338;Taip;0;4;0;4
15731;Saulutė;"1 klasė";8962761979;Taip;18;4;0;22
15732;Saulutė;"1 klasė";7785909571;Ne;0;4;0;4
15733;Saulutė;"1 klasė";5822529731;Taip;0;4;0;4
15734;Saulutė;"1 klasė";2095347468;Taip;2;4;0;6
15735;Saulutė;"1 klasė";56289088231;Taip;0;4;0;4
15736;Saulutė;"1 klasė";1418237274;Taip;3;4;0;7
15737;Saulutė;"1 klasė";13916981850;Taip;2;4;0;6
15738;Saulutė;"1 klasė";61123463673;Taip;2;4;0;6
15739;Saulutė;"1 klasė";39606108938;Ne;3;4;0;7
15740;Saulutė;"1 klasė";82106514982;Taip;0;4;0;4
15741;Saulutė;"1 klasė";58163470119;Taip;1;4;0;5
15742;Saulutė;"1 klasė";81191097069;Taip;0;4;0;4
15743;Saulutė;"1 klasė";37839378248;Taip;0;4;0;4
15744;Saulutė;"1 klasė";90078805222;Taip;0;4;0;4
15745;Saulutė;"1 klasė";61113930769;Taip;3;4;0;7
15746;Saulutė;"1 klasė";42204884890;Ne;0;4;0;4
15747;Saulutė;"1 klasė";12964000357;Taip;0;4;0;4
15748;Saulutė;"1 klasė";25720655179;Taip;7;4;0;11
15749;Saulutė;"1 klasė";30863736694;Taip;1;4;0;5
15750;Saulutė;"1 klasė";45877127245;Taip;0;4;0;4
15751;Saulutė;"1 klasė";8308288099;Ne;1;4;0;5
15752;Saulutė;"1 klasė";54726632101;Taip;0;4;0;4
15753;Saulutė;"1 klasė";16523279366;Taip;2;4;0;6
15754;Saulutė;"2 klasė";1701868565;Taip;0;4;0;4
15755;Saulutė;"2 klasė";6924270821;Ne;3;4;0;7
15756;Saulutė;"2 klasė";3450860412;Ne;0;4;0;4
15757;Saulutė;"2 klasė";1081812391;Taip;0;4;0;4
15758;Saulutė;"2 klasė";1436690766;Taip;0;4;0;4
15759;Saulutė;"2 klasė";7577219457;Taip;0;4;0;4
15760;Saulutė;"2 klasė";2517511237;Taip;0;4;0;4
15761;Saulutė;"2 klasė";1153099638;Taip;1;4;0;5
15762;Saulutė;"2 klasė";5786453424;Taip;1;4;0;5
15763;Saulutė;"2 klasė";8531372660;Taip;0;4;0;4
15764;Saulutė;"2 klasė";1117229507;Taip;0;4;0;4
15765;Saulutė;"2 klasė";4342595483;Taip;4;4;0;8
15766;Saulutė;"2 klasė";3614749034;Taip;5;4;0;9
15767;Saulutė;"2 klasė";3937034221;Ne;4;4;0;8
15768;Saulutė;"2 klasė";7543978588;Taip;0;4;0;4
15769;Saulutė;"2 klasė";7696948081;Taip;5;4;0;9
15770;Saulutė;"2 klasė";4252242862;Taip;0;4;0;4
15771;Saulutė;"2 klasė";2957436888;Taip;6;4;0;10
15772;Saulutė;"2 klasė";1312993030;Taip;1;4;0;5
15773;Saulutė;"2 klasė";3755300838;Taip;5;4;0;9
15774;Saulutė;"2 klasė";9744870287;Taip;7;4;0;11
15775;Saulutė;"2 klasė";8953313952;Ne;2;4;0;6
15776;Saulutė;"2 klasė";8192525690;Taip;0;4;0;4
15777;Saulutė;"2 klasė";6025668467;Taip;0;4;0;4
15778;Saulutė;"3 klasė";1604607524;Ne;7;4;0;11
15779;Saulutė;"3 klasė";1787634725;Ne;3;4;0;7
15780;Saulutė;"3 klasė";6128992723;Ne;0;4;0;4
15781;Saulutė;"3 klasė";3806787884;Ne;9;4;0;13
15782;Saulutė;"3 klasė";9155511473;Ne;0;4;0;4
15783;Saulutė;"3 klasė";3302267009;Ne;5;4;0;9
15784;Saulutė;"3 klasė";1659579883;Ne;2;4;0;6
15785;Saulutė;"3 klasė";9833653313;Ne;5;4;0;9
15786;Saulutė;"3 klasė";5193599921;Ne;3;4;0;7
15787;Saulutė;"3 klasė";9113434597;Ne;0;4;0;4
15788;Saulutė;"3 klasė";8601544457;Taip;1;4;0;5
15789;Saulutė;"3 klasė";8506064421;Ne;1;4;0;5
15790;Saulutė;"3 klasė";7700196440;Ne;0;4;0;4
15791;Saulutė;"3 klasė";9621988308;Ne;18;4;0;22
15792;Saulutė;"3 klasė";4189732482;Ne;18;4;0;22
15793;Saulutė;"3 klasė";2638495931;Ne;18;4;0;22
15794;Saulutė;"3 klasė";6797161399;Ne;3;4;0;7
15795;Saulutė;"3 klasė";9885756874;Ne;6;4;0;10
15796;Saulutė;"3 klasė";6957680310;Ne;10;4;0;14
15797;Saulutė;"3 klasė";7343265118;Ne;18;4;0;22
15798;Saulutė;"3 klasė";2374587130;Ne;1;4;0;5
15799;Saulutė;"4 klasė";5056875822;Ne;1;4;0;5
15800;Saulutė;"4 klasė";9319954066;Ne;3;4;0;7
15801;Saulutė;"4 klasė";6584576600;Ne;0;7;0;7
15802;Saulutė;"4 klasė";5395865996;Ne;0;4;0;4
15803;Saulutė;"4 klasė";7115874340;Ne;11;4;0;15
15804;Saulutė;"4 klasė";4407219804;Ne;9;4;0;13
15805;Saulutė;"4 klasė";7050670622;Ne;2;4;0;6
15806;Saulutė;"4 klasė";4724713439;Ne;0;4;0;4
15807;Saulutė;"4 klasė";7656351068;Ne;6;4;0;10
15808;Saulutė;"4 klasė";3798600407;Ne;2;4;0;6
15809;Saulutė;"4 klasė";9802910644;Ne;2;4;0;6
15810;Saulutė;"4 klasė";4804531706;Ne;0;4;0;4
15811;Saulutė;"4 klasė";2876473029;Ne;1;4;0;5
15812;Svaja;"1 A klasė";72655912805;Taip;0;2;0;2
15813;Svaja;"1 A klasė";49184638535;Taip;0;21;0;21
15814;Svaja;"1 A klasė";2019179013;Taip;0;3;0;3
15815;Svaja;"1 A klasė";69928474471;Taip;0;10;0;10
15816;Svaja;"1 A klasė";56095979514;Taip;0;2;0;2
15817;Svaja;"1 A klasė";20363553383;Taip;0;3;0;3
15818;Svaja;"1 A klasė";70513111186;Ne;0;2;0;2
15819;Svaja;"1 A klasė";31604152893;Taip;0;2;0;2
15820;Svaja;"1 A klasė";96680395594;Taip;0;2;0;2
15821;Svaja;"1 A klasė";58497063533;Taip;0;1;0;1
15822;Svaja;"4 A klasė";8379446890;Taip;0;3;0;3
15823;Svaja;"4 A klasė";4502453706;Taip;0;2;0;2
15824;Svaja;"4 A klasė";2634945863;Taip;0;2;0;2
15825;Svaja;"4 A klasė";2809419614;Taip;0;2;0;2
15826;Svaja;"4 A klasė";7907240014;Taip;0;4;0;4
15827;Svaja;"4 A klasė";1879036130;Taip;0;2;0;2
15828;Svaja;"4 A klasė";3557342819;Taip;0;4;0;4
15829;Svaja;"4 A klasė";1541293330;Taip;0;3;0;3
15830;Svaja;"4 A klasė";9632176714;Taip;0;2;0;2
15831;Svaja;"4 A klasė";5365820503;Taip;0;21;0;21
15832;Svaja;"4 A klasė";5377640073;Taip;0;2;0;2
15833;Svaja;"4 A klasė";5932025585;Taip;0;21;0;21
15834;Svaja;"4 A klasė";4448306552;Taip;0;2;0;2
15835;Svaja;"4 A klasė";3819417941;Taip;0;4;0;4
15836;Svaja;"4 A klasė";5422477471;Taip;0;6;0;6
15837;Svaja;"4 A klasė";9560407704;Taip;0;2;0;2
15838;Svaja;"4 A klasė";6887675378;Taip;0;4;0;4
15839;Svaja;"4 A klasė";5552969529;Taip;0;21;0;21
15840;Svaja;"4 A klasė";6527332163;Ne;0;21;0;21
15841;Svaja;"4 A klasė";4420778031;Ne;0;4;0;4
15842;Svaja;"4 A klasė";1318515776;Ne;0;13;0;13
15843;Svaja;"4 A klasė";6591381153;Taip;0;7;0;7
15844;Vaduvos;PAGRANDUKAI;1048630061;Taip;12;0;0;12
15845;Vaduvos;PAGRANDUKAI;1431863758;Taip;3;0;0;3
15846;Vaduvos;PAGRANDUKAI;8408017356;Taip;9;6;0;15
15847;Vaduvos;PAGRANDUKAI;72724196791;Taip;1;18;0;19
15848;Vaduvos;PAGRANDUKAI;9371067563;Taip;0;5;0;5
15849;Vaduvos;PAGRANDUKAI;9987311980;Taip;0;7;0;7
15850;Vaduvos;PAGRANDUKAI;6425640531;Taip;17;0;0;17
15851;Vaduvos;PAGRANDUKAI;4029586203;Taip;5;0;0;5
15852;Vaduvos;PAGRANDUKAI;18035723255;Taip;11;0;0;11
15853;Vaduvos;PAGRANDUKAI;5954492368;Taip;6;0;0;6
15854;Vaduvos;PAGRANDUKAI;7397068779;Ne;0;7;0;7
15855;Vaduvos;PAGRANDUKAI;8875709110;Taip;0;5;0;5
15856;Vaduvos;PAGRANDUKAI;4789480822;Taip;5;1;0;6
15857;Vaduvos;PAGRANDUKAI;7305111076;Taip;6;1;0;7
15858;Vaduvos;PAGRANDUKAI;2897226343;Taip;5;0;0;5
15859;Vaduvos;PAGRANDUKAI;68848152670;Taip;20;0;0;20
15860;Vaduvos;PAGRANDUKAI;4105978403;Taip;4;5;0;9
15861;Vaduvos;PAGRANDUKAI;3111866557;Taip;21;0;0;21
15862;Vaduvos;PAGRANDUKAI;5428067167;Taip;0;5;0;5
15863;Vaduvos;PAGRANDUKAI;3699578284;Taip;15;0;0;15
15864;Vaduvos;KODĖLČIUKAI;53866301875;Ne;15;0;1;16
15865;Vaduvos;KODĖLČIUKAI;67324784528;Taip;0;1;0;1
15866;Vaduvos;KODĖLČIUKAI;78245732319;Taip;4;0;0;4
15867;Vaduvos;KODĖLČIUKAI;38504924027;Taip;10;0;0;10
15868;Vaduvos;KODĖLČIUKAI;17473821556;Taip;0;11;1;12
15869;Vaduvos;KODĖLČIUKAI;41272273463;Taip;5;0;0;5
15870;Vaduvos;KODĖLČIUKAI;1532675814;Taip;5;5;0;10
15871;Vaduvos;KODĖLČIUKAI;33277362439;Ne;0;1;0;1
15872;Vaduvos;KODĖLČIUKAI;27419094487;Taip;0;4;0;4
15873;Vaduvos;KODĖLČIUKAI;61243424057;Taip;9;0;0;9
15874;Vaduvos;KODĖLČIUKAI;81605493207;Taip;6;1;0;7
15875;Vaduvos;KODĖLČIUKAI;36931517006;Taip;9;0;0;9
15876;Vaduvos;KODĖLČIUKAI;90211578805;Taip;5;0;0;5
15877;Vaduvos;KODĖLČIUKAI;2019573643;Taip;6;1;0;7
15878;Vaduvos;KODĖLČIUKAI;96148085691;Taip;0;1;0;1
15879;Vaduvos;KODĖLČIUKAI;2181614424;Taip;7;1;0;8
15880;Vaduvos;KODĖLČIUKAI;97878811046;Taip;6;0;0;6
15881;Vaduvos;KODĖLČIUKAI;89793734700;Taip;0;0;2;2
15882;Vaduvos;KODĖLČIUKAI;48433447683;Taip;3;1;0;4
15883;Vaduvos;KODĖLČIUKAI;32138087379;Taip;0;7;0;7
15884;Vaduvos;SMALSUČIAI;7786986697;Taip;0;2;0;2
15885;Vaduvos;SMALSUČIAI;12330772986;Taip;0;3;1;4
15886;Vaduvos;SMALSUČIAI;25732368565;Taip;0;0;21;21
15887;Vaduvos;SMALSUČIAI;54606265707;Taip;0;2;0;2
15888;Vaduvos;SMALSUČIAI;85090873161;Taip;0;1;2;3
15889;Vaduvos;SMALSUČIAI;98259624669;Taip;0;2;0;2
15890;Vaduvos;SMALSUČIAI;8183322974;Taip;7;2;0;9
15891;Vaduvos;SMALSUČIAI;78931952732;Taip;0;2;0;2
15892;Vaduvos;SMALSUČIAI;3632802933;Ne;3;0;0;3
15893;Vaduvos;SMALSUČIAI;1107557891;Ne;10;4;0;14
15894;Vaduvos;SMALSUČIAI;4807104855;Taip;10;1;2;13
15895;Vaduvos;SMALSUČIAI;2605583220;Taip;0;0;2;2
15896;Vaduvos;SMALSUČIAI;54193761898;Taip;0;0;1;1
15897;Vaduvos;SMALSUČIAI;5307128703;Taip;7;0;0;7
15898;Vaduvos;SMALSUČIAI;1139509471;Taip;11;0;0;11
15899;Vaduvos;SMALSUČIAI;13178417729;Taip;10;9;0;19
15900;Vaduvos;SMALSUČIAI;72018210447;Taip;0;1;2;3
15901;Vaduvos;SMALSUČIAI;6121365922;Taip;10;0;0;10
15902;Vaduvos;SMALSUČIAI;62183976729;Taip;13;0;0;13
15903;Vaduvos;GILIUKAI;11202010413;Taip;11;1;0;12
15904;Vaduvos;GILIUKAI;1046867513;Ne;10;1;0;11
15905;Vaduvos;GILIUKAI;15757662594;Taip;6;0;0;6
15906;Vaduvos;GILIUKAI;41870343319;Taip;0;3;0;3
15907;Vaduvos;GILIUKAI;97007740148;Taip;11;0;4;15
15908;Vaduvos;GILIUKAI;93702732546;Taip;5;0;1;6
15909;Vaduvos;GILIUKAI;1464016847;Taip;10;0;3;13
15910;Vaduvos;GILIUKAI;2006018986;Taip;7;2;0;9
15911;Vaduvos;GILIUKAI;46608435244;Taip;10;0;1;11
15912;Vaduvos;GILIUKAI;86095539298;Taip;6;0;2;8
15913;Vaduvos;GILIUKAI;21499108813;Taip;5;0;1;6
15914;Vaduvos;GILIUKAI;59616893535;Taip;8;0;2;10
15915;Vaduvos;GILIUKAI;22641388717;Taip;7;0;0;7
15916;Vaduvos;GILIUKAI;61046090149;Taip;11;0;1;12
15917;Vaduvos;GILIUKAI;87008942241;Taip;11;0;0;11
15918;Vaduvos;GILIUKAI;56280470781;Taip;17;0;0;17
15919;Vaduvos;GILIUKAI;79437154441;Taip;12;0;0;12
15920;Vaduvos;GILIUKAI;68937983441;Taip;0;1;0;1
15921;Vaduvos;GILIUKAI;1176603533;Taip;5;0;2;7
15922;Vaduvos;GILIUKAI;1703266825;Taip;10;0;0;10
15923;Vaduvos;GILIUKAI;65843855427;Taip;7;3;0;10
15924;Vaduvos;BORUŽĖLĖS;24887196729;Taip;0;6;0;6
15925;Vaduvos;BORUŽĖLĖS;16882774330;Taip;4;1;0;5
15926;Vaduvos;BORUŽĖLĖS;70693742936;Taip;6;6;0;12
15927;Vaduvos;BORUŽĖLĖS;4670249904;Taip;0;0;3;3
15928;Vaduvos;BORUŽĖLĖS;1385184350;Taip;0;0;2;2
15929;Vaduvos;BORUŽĖLĖS;65647119496;Taip;11;1;0;12
15930;Vaduvos;BORUŽĖLĖS;96803174459;Taip;6;3;0;9
15931;Vaduvos;BORUŽĖLĖS;47465933557;Taip;12;0;0;12
15932;Vaduvos;BORUŽĖLĖS;55138588393;Taip;0;1;0;1
15933;Vaduvos;BORUŽĖLĖS;3172047211;Taip;5;0;1;6
15934;Vaduvos;BORUŽĖLĖS;62521006557;Taip;0;1;1;2
15935;Vaduvos;BORUŽĖLĖS;93924290247;Taip;0;1;6;7
15936;Vaduvos;BORUŽĖLĖS;61243200177;Taip;0;1;0;1
15937;Vaduvos;BORUŽĖLĖS;95104294893;Taip;5;0;8;13
15938;Vaduvos;BORUŽĖLĖS;6155494370;Ne;12;0;0;12
15939;Vaduvos;BORUŽĖLĖS;97423576166;Taip;0;1;0;1
15940;Vaduvos;BORUŽĖLĖS;94906586734;Taip;4;2;0;6
15941;Vaduvos;DRUGELIAI;39687066893;Taip;0;0;4;4
15942;Vaduvos;DRUGELIAI;6192828320;Taip;7;2;0;9
15943;Vaduvos;DRUGELIAI;40872193458;Taip;0;0;1;1
15944;Vaduvos;DRUGELIAI;76644896831;Taip;0;2;0;2
15945;Vaduvos;DRUGELIAI;1241148402;Taip;0;0;5;5
15946;Vaduvos;DRUGELIAI;93406851755;Taip;5;0;0;5
15947;Vaduvos;DRUGELIAI;14297366745;Taip;0;5;0;5
15948;Vaduvos;DRUGELIAI;13888236429;Taip;1;0;4;5
15949;Vaduvos;DRUGELIAI;13203715320;Taip;4;0;0;4
15950;Vaduvos;DRUGELIAI;26736566969;Taip;4;0;0;4
15951;Vaduvos;DRUGELIAI;64074141491;Taip;0;11;2;13
15952;Vaduvos;DRUGELIAI;66359913774;Taip;0;7;0;7
15953;Vaduvos;DRUGELIAI;49738318631;Taip;0;6;0;6
15954;Vaduvos;DRUGELIAI;3174998523;Taip;2;0;0;2
15955;Vaduvos;DRUGELIAI;8802765960;Taip;0;0;2;2
15956;Vaduvos;RIEŠUTĖLIAI;9429028460;Taip;0;2;0;2
15957;Vaduvos;RIEŠUTĖLIAI;9072097216;Taip;3;0;1;4
15958;Vaduvos;RIEŠUTĖLIAI;9178907705;Taip;16;0;0;16
15959;Vaduvos;RIEŠUTĖLIAI;6210729584;Taip;0;2;0;2
15960;Vaduvos;RIEŠUTĖLIAI;4365144594;Taip;11;0;3;14
15961;Vaduvos;RIEŠUTĖLIAI;9606193112;Taip;13;0;0;13
15962;Vaduvos;RIEŠUTĖLIAI;9540008495;Taip;7;0;1;8
15963;Vaduvos;RIEŠUTĖLIAI;9983148737;Taip;13;0;0;13
15964;Vaduvos;RIEŠUTĖLIAI;9062135043;Taip;3;7;0;10
15965;Vaduvos;RIEŠUTĖLIAI;1422507884;Taip;3;0;2;5
15966;Vaduvos;RIEŠUTĖLIAI;6810198013;Taip;4;5;1;10
15967;Vaduvos;RIEŠUTĖLIAI;4270137614;Taip;0;1;0;1
15968;Vaduvos;RIEŠUTĖLIAI;3682708061;Taip;16;0;0;16
15969;Vaduvos;RIEŠUTĖLIAI;7181151562;Taip;0;0;1;1
15970;Vaduvos;RIEŠUTĖLIAI;3641822841;Taip;10;0;1;11
15971;Vaduvos;"1 klasė";96473212525;Taip;0;2;0;2
15972;Vaduvos;"1 klasė";75428164558;Taip;0;1;0;1
15973;Vaduvos;"1 klasė";13721939854;Taip;0;1;0;1
15974;Vaduvos;"1 klasė";35999855339;Taip;0;21;0;21
15975;Vaduvos;"1 klasė";62612515593;Taip;0;21;0;21
15976;Vaduvos;"1 klasė";61830127618;Taip;0;1;0;1
15977;Vaduvos;"1 klasė";4591744662;Taip;0;21;0;21
15978;Vaduvos;"1 klasė";9149523910;Taip;0;21;0;21
15979;Vaduvos;"1 klasė";76662161382;Taip;0;1;0;1
15980;Vaduvos;"1 klasė";18300713872;Taip;0;21;0;21
15981;Vaduvos;"1 klasė";1768173501;Taip;0;2;0;2
15982;Vaduvos;"1 klasė";768455288;Ne;0;1;0;1
15983;Vaduvos;"1 klasė";60531886576;Taip;0;1;0;1
15984;Vaduvos;"1 klasė";38462664426;Ne;0;2;0;2
15985;Vaduvos;"1 klasė";63286903462;Taip;0;1;0;1
15986;Vaduvos;"1 klasė";20841176336;Taip;0;21;0;21
15987;Vaduvos;"1 klasė";6049882391;Ne;0;3;0;3
15988;Vaduvos;"1 klasė";38013859931;Taip;0;1;0;1
15989;Vaduvos;"1 klasė";2004208381;Taip;0;1;0;1
15990;Vaduvos;"1 klasė";1821644443;Ne;0;4;0;4
15991;Vaduvos;"1 klasė";26934740147;Taip;0;21;0;21
15992;Vaduvos;"1 klasė";7172286009;Taip;0;2;0;2
15993;Vaduvos;"1 klasė";2029363844;Taip;0;21;0;21
15994;Vaduvos;"1 klasė";8188624118;Ne;0;21;0;21
15995;Vaduvos;"2 klasė";8594896510;Taip;0;1;0;1
15996;Vaduvos;"2 klasė";8009941823;Taip;0;2;0;2
15997;Vaduvos;"2 klasė";1060727236;Taip;0;1;0;1
15998;Vaduvos;"2 klasė";2423925079;Taip;0;21;0;21
15999;Vaduvos;"2 klasė";7410760461;Taip;0;21;0;21
16000;Vaduvos;"2 klasė";6487033699;Taip;0;2;0;2
16001;Vaduvos;"2 klasė";1671409152;Taip;0;1;0;1
16002;Vaduvos;"2 klasė";5072769647;Taip;0;1;0;1
16003;Vaduvos;"2 klasė";4637670260;Taip;0;10;0;10
16004;Vaduvos;"2 klasė";7236550835;Taip;0;1;0;1
16005;Vaduvos;"2 klasė";9372936408;Taip;0;1;0;1
16006;Vaduvos;"2 klasė";7243175751;Taip;0;1;0;1
16007;Vaduvos;"2 klasė";2482212122;Taip;0;1;0;1
16008;Vaduvos;"2 klasė";1982860223;Taip;0;1;0;1
16009;Vaduvos;"2 klasė";4447152355;Taip;0;1;0;1
16010;Vaduvos;"2 klasė";3325229112;Taip;0;1;0;1
16011;Vaduvos;"2 klasė";5531150399;Taip;0;21;0;21
16012;Vaduvos;"2 klasė";6980440631;Taip;0;8;0;8
16013;Vaduvos;"2 klasė";1091221509;Taip;0;10;0;10
16014;Vaduvos;"2 klasė";7614692200;Taip;0;1;0;1
16015;Vaduvos;"2 klasė";8216757208;Taip;0;21;0;21
16016;Vaduvos;"2 klasė";5459268700;Taip;0;21;0;21
16017;Vaduvos;"2 klasė";5593756016;Taip;0;1;0;1
16018;Vaduvos;"2 klasė";1642242442;Taip;0;1;0;1
16019;Vaduvos;"2 klasė";8928517238;Taip;0;1;0;1
16020;Vaduvos;"2 klasė";5099560123;Taip;0;1;0;1
16021;Vaduvos;"2 klasė";7899239147;Taip;0;1;0;1
16022;Vaduvos;"3 klasė";9644782309;Taip;0;2;0;2
16023;Vaduvos;"3 klasė";7719637673;Taip;0;1;0;1
16024;Vaduvos;"3 klasė";3784730324;Taip;0;1;0;1
16025;Vaduvos;"3 klasė";6964778383;Taip;0;2;0;2
16026;Vaduvos;"3 klasė";1841919654;Taip;0;3;0;3
16027;Vaduvos;"3 klasė";8241399720;Taip;0;1;0;1
16028;Vaduvos;"3 klasė";1086186628;Taip;0;2;0;2
16029;Vaduvos;"3 klasė";7838224919;Ne;0;1;0;1
16030;Vaduvos;"3 klasė";9494193819;Taip;0;21;0;21
16031;Vaduvos;"3 klasė";3755145838;Taip;0;21;0;21
16032;Vaduvos;"3 klasė";2149582337;Taip;0;2;0;2
16033;Vaduvos;"3 klasė";6896561963;Taip;0;4;0;4
16034;Vaduvos;"3 klasė";6748405557;Taip;0;2;0;2
16035;Vaduvos;"3 klasė";5523290081;Taip;0;1;0;1
16036;Vaduvos;"3 klasė";5786723345;Ne;0;12;0;12
16037;Vaduvos;"3 klasė";1730710569;Taip;0;1;0;1
16038;Vaduvos;"3 klasė";1461738157;Taip;0;1;0;1
16039;Vaduvos;"3 klasė";6744521293;Taip;0;1;0;1
16040;Vaduvos;"3 klasė";7786044620;Taip;0;21;0;21
16041;Vaduvos;"3 klasė";4347558872;Taip;0;1;0;1
16042;Vaduvos;"3 klasė";1954540001;Taip;0;9;0;9
16043;Vaduvos;"3 klasė";8801412437;Taip;0;3;0;3
16044;Vaduvos;"3 klasė";3583694770;Taip;0;1;0;1
16045;Vaduvos;"3 klasė";9271050464;Taip;0;1;0;1
16046;Vaduvos;"3 klasė";9441676636;Ne;0;2;0;2
16047;Vaduvos;"4 klasė";6654601642;Taip;0;6;0;6
16048;Vaduvos;"4 klasė";8237000050;Taip;0;1;0;1
16049;Vaduvos;"4 klasė";3145407318;Ne;0;2;0;2
16050;Vaduvos;"4 klasė";3333293097;Taip;0;2;0;2
16051;Vaduvos;"4 klasė";5309061557;Taip;0;1;0;1
16052;Vaduvos;"4 klasė";6371618427;Taip;0;3;0;3
16053;Vaduvos;"4 klasė";4965870077;Taip;0;21;0;21
16054;Vaduvos;"4 klasė";3290259977;Taip;0;2;0;2
16055;Vaduvos;"4 klasė";7585921384;Taip;0;1;0;1
16056;Vaduvos;"4 klasė";8971158534;Taip;0;4;0;4
16057;Vaduvos;"4 klasė";4629364623;Taip;0;1;0;1
16058;Vaduvos;"4 klasė";4106358850;Taip;0;3;0;3
16059;Vaduvos;"4 klasė";7163757633;Taip;0;4;0;4
16060;Vaduvos;"4 klasė";3710305066;Taip;0;1;0;1
16061;Vaduvos;"4 klasė";8401121977;Taip;0;3;0;3
16062;Vaduvos;"4 klasė";1682529973;Ne;0;21;0;21
16063;Vaduvos;"4 klasė";5094558878;Taip;0;2;0;2
16064;Vaduvos;"4 klasė";1741464526;Taip;0;9;0;9
16065;Vaduvos;"4 klasė";3868511136;Taip;0;1;0;1
16066;Vaduvos;"4 klasė";9224232442;Taip;0;11;0;11
16067;Vaduvos;"4 klasė";6583877755;Taip;0;21;0;21
16068;Vilkpėdės;BORUŽĖLĖS;79390794424;Taip;5;3;0;8
16069;Vilkpėdės;BORUŽĖLĖS;61899409496;Ne;4;1;0;5
16070;Vilkpėdės;BORUŽĖLĖS;64143309761;Taip;6;0;0;6
16071;Vilkpėdės;BORUŽĖLĖS;34554036711;Ne;8;1;0;9
16072;Vilkpėdės;BORUŽĖLĖS;64276583853;Taip;10;0;0;10
16073;Vilkpėdės;BORUŽĖLĖS;93369779426;Taip;2;7;0;9
16074;Vilkpėdės;BORUŽĖLĖS;18177210107;Taip;5;0;0;5
16075;Vilkpėdės;BORUŽĖLĖS;94327243660;Taip;5;3;0;8
16076;Vilkpėdės;BORUŽĖLĖS;25560685550;Taip;3;1;0;4
16077;Vilkpėdės;BORUŽĖLĖS;69023855545;Taip;10;0;0;10
16078;Vilkpėdės;BORUŽĖLĖS;72601980553;Taip;6;0;0;6
16079;Vilkpėdės;BORUŽĖLĖS;40684269684;Taip;0;4;0;4
16080;Vilkpėdės;BORUŽĖLĖS;70459205616;Taip;6;1;0;7
16081;Vilkpėdės;BORUŽĖLĖS;18795042529;Taip;3;0;0;3
16082;Vilkpėdės;BORUŽĖLĖS;77110534762;Taip;5;3;0;8
16083;Vilkpėdės;BORUŽĖLĖS;18926013798;Taip;5;4;0;9
16084;Vilkpėdės;BORUŽĖLĖS;96241777448;Ne;7;0;0;7
16085;Vilkpėdės;BORUŽĖLĖS;1468040255;Taip;5;1;0;6
16086;Vilkpėdės;BORUŽĖLĖS;40831777471;Taip;5;1;0;6
16087;Vilkpėdės;BORUŽĖLĖS;73735463059;Taip;0;5;0;5
16088;Vilkpėdės;BORUŽĖLĖS;12155790021;Taip;6;0;0;6
16089;Vilkpėdės;SKRUZDĖLIUKAI;32683398503;Taip;0;3;0;3
16090;Vilkpėdės;SKRUZDĖLIUKAI;41394645789;Taip;0;2;0;2
16091;Vilkpėdės;SKRUZDĖLIUKAI;61457409195;Taip;0;7;0;7
16092;Vilkpėdės;SKRUZDĖLIUKAI;90226911248;Taip;0;7;0;7
16093;Vilkpėdės;SKRUZDĖLIUKAI;73812058890;Taip;0;6;0;6
16094;Vilkpėdės;SKRUZDĖLIUKAI;18860888473;Taip;0;1;0;1
16095;Vilkpėdės;SKRUZDĖLIUKAI;19719432462;Taip;0;5;0;5
16096;Vilkpėdės;SKRUZDĖLIUKAI;70184817311;Taip;7;0;0;7
16097;Vilkpėdės;SKRUZDĖLIUKAI;93775558547;Taip;5;2;1;8
16098;Vilkpėdės;SKRUZDĖLIUKAI;90816091771;Taip;3;0;0;3
16099;Vilkpėdės;SKRUZDĖLIUKAI;26983231264;Taip;9;3;0;12
16100;Vilkpėdės;SKRUZDĖLIUKAI;89124218945;Taip;0;1;0;1
16101;Vilkpėdės;SKRUZDĖLIUKAI;21841574426;Taip;0;5;0;5
16102;Vilkpėdės;SKRUZDĖLIUKAI;89601406730;Taip;6;0;0;6
16103;Vilkpėdės;SKRUZDĖLIUKAI;81712437117;Taip;0;1;0;1
16104;Vilkpėdės;SKRUZDĖLIUKAI;60687258266;Taip;1;8;0;9
16105;Vilkpėdės;SKRUZDĖLIUKAI;95408044297;Taip;0;1;0;1
16106;Vilkpėdės;SKRUZDĖLIUKAI;58037049872;Taip;0;3;0;3
16107;Vilkpėdės;SKRUZDĖLIUKAI;63180329851;Ne;2;7;0;9
16108;Vilkpėdės;SKRUZDĖLIUKAI;3001209213;Taip;2;2;0;4
16109;Vilkpėdės;SKRUZDĖLIUKAI;95615604947;Taip;0;3;0;3
16110;Vilkpėdės;SKRUZDĖLIUKAI;33842357499;Taip;0;3;0;3
16111;Vilkpėdės;SKRUZDĖLIUKAI;64155507543;Taip;15;0;0;15
16112;Vilkpėdės;"1 klasė";37450374921;Taip;4;0;0;4
16113;Vilkpėdės;"1 klasė";14499651046;Ne;0;5;0;5
16114;Vilkpėdės;"1 klasė";64898472080;Taip;9;0;0;9
16115;Vilkpėdės;DRUGELIAI;2420271759;Taip;8;2;0;10
16116;Vilkpėdės;DRUGELIAI;2377248778;Taip;13;1;0;14
16117;Vilkpėdės;DRUGELIAI;7698759895;Taip;7;0;0;7
16118;Vilkpėdės;DRUGELIAI;3351309750;Taip;17;0;0;17
16119;Vilkpėdės;DRUGELIAI;1019057127;Taip;11;0;0;11
16120;Vilkpėdės;DRUGELIAI;1807884737;Taip;15;1;0;16
16121;Vilkpėdės;DRUGELIAI;9894466439;Taip;2;0;0;2
16122;Vilkpėdės;DRUGELIAI;6816745585;Taip;9;0;0;9
16123;Vilkpėdės;DRUGELIAI;9460356725;Taip;8;8;0;16
16124;Vilkpėdės;DRUGELIAI;8015392054;Taip;11;0;0;11
16125;Vilkpėdės;DRUGELIAI;8693750994;Taip;20;0;0;20
16126;Vilkpėdės;DRUGELIAI;2320350937;Taip;12;1;0;13
16127;Vilkpėdės;DRUGELIAI;7795186132;Taip;9;0;0;9
16128;Vilkpėdės;DRUGELIAI;6762306583;Taip;21;0;0;21
16129;Vilkpėdės;DRUGELIAI;9795696242;Taip;10;0;0;10
16130;Vilkpėdės;DRUGELIAI;8581661608;Taip;5;0;0;5
16131;Vilkpėdės;DRUGELIAI;6261547304;Taip;11;0;0;11
16132;Vilkpėdės;ŽIOGELIAI;2065010940;Taip;0;8;0;8
16133;Vilkpėdės;ŽIOGELIAI;1137529145;Taip;0;0;1;1
16134;Vilkpėdės;ŽIOGELIAI;13241568469;Taip;5;0;0;5
16135;Vilkpėdės;ŽIOGELIAI;1052719398;Taip;0;5;0;5
16136;Vilkpėdės;ŽIOGELIAI;1145968615;Taip;3;0;0;3
16137;Vilkpėdės;ŽIOGELIAI;55747681017;Taip;3;0;0;3
16138;Vilkpėdės;ŽIOGELIAI;1136036746;Taip;7;2;0;9
16139;Vilkpėdės;ŽIOGELIAI;51976067616;Taip;0;0;2;2
16140;Vilkpėdės;ŽIOGELIAI;73470824566;Taip;9;0;1;10
16141;Vilkpėdės;ŽIOGELIAI;5912919726;Taip;6;0;0;6
16142;Vilkpėdės;ŽIOGELIAI;40385792431;Taip;4;0;0;4
16143;Vilkpėdės;ŽIOGELIAI;72227817278;Taip;0;1;0;1
16144;Vilkpėdės;ŽIOGELIAI;1795879331;Taip;7;0;0;7
16145;Vilkpėdės;ŽIOGELIAI;2000428715;Taip;2;0;0;2
16146;Vilkpėdės;ŽIOGELIAI;72899151328;Taip;8;0;0;8
16147;Vilkpėdės;ŽIOGELIAI;1527272055;Ne;0;2;0;2
16148;Vilkpėdės;ŽIOGELIAI;1384224802;Taip;0;1;0;1
16149;Vilkpėdės;ŽIOGELIAI;25008201566;Taip;1;0;4;5
16150;Vilkpėdės;ŽIOGELIAI;9393571483;Taip;15;1;2;18
16151;Vilkpėdės;BITUTĖS;9605399822;Taip;0;1;0;1
16152;Vilkpėdės;BITUTĖS;9589862809;Taip;9;0;0;9
16153;Vilkpėdės;BITUTĖS;7875898177;Taip;16;0;0;16
16154;Vilkpėdės;BITUTĖS;3935245964;Taip;0;2;0;2
16155;Vilkpėdės;BITUTĖS;9867411687;Taip;2;2;0;4
16156;Vilkpėdės;BITUTĖS;4735164204;Taip;11;0;0;11
16157;Vilkpėdės;BITUTĖS;46561435465;Taip;0;8;0;8
16158;Vilkpėdės;BITUTĖS;48059844727;Taip;0;4;0;4
16159;Vilkpėdės;BITUTĖS;1195392132;Taip;0;1;0;1
16160;Vilkpėdės;BITUTĖS;4392760215;Taip;7;4;0;11
16161;Vilkpėdės;BITUTĖS;2955411131;Taip;5;2;0;7
16162;Vilkpėdės;BITUTĖS;2736368118;Taip;0;6;0;6
16163;Vilkpėdės;BITUTĖS;4515945951;Taip;0;0;1;1
16164;Vilkpėdės;BITUTĖS;2900581406;Taip;6;1;0;7
16165;Vilkpėdės;BITUTĖS;7527929277;Taip;19;0;0;19
16166;Vilkpėdės;BITUTĖS;8865545376;Taip;6;5;0;11
16167;Vilkpėdės;BITUTĖS;7889480219;Taip;3;2;0;5
16168;Vilkpėdės;BITUTĖS;8128254701;Taip;10;2;0;12
16169;Vilkpėdės;"2 klasė";4562930821;Ne;1;1;0;2
16170;Vilkpėdės;"2 klasė";4450490805;Ne;0;1;0;1
16171;Vilkpėdės;"2 klasė";5753361387;Ne;0;1;0;1
16172;Vilkpėdės;"2 klasė";3330174377;Ne;0;1;0;1
16173;Vilkpėdės;"2 klasė";7678586010;Ne;0;1;0;1
16174;Vilkpėdės;"2 klasė";9422266523;Ne;0;2;0;2
16175;Vilkpėdės;"2 klasė";7567054902;Ne;4;1;0;5
16176;Vilkpėdės;"2 klasė";1894949069;Ne;2;1;0;3
16177;Vilkpėdės;"2 klasė";6750171948;Ne;5;3;0;8
16178;Vilkpėdės;"2 klasė";2877690064;Ne;0;2;0;2
16179;Vilkpėdės;"2 klasė";4975532783;Ne;0;1;0;1
16180;Vilkpėdės;"2 klasė";3096541013;Ne;0;1;0;1
16181;Vilkpėdės;"2 klasė";4467711387;Ne;2;1;0;3
16182;Vilkpėdės;"2 klasė";6334059519;Ne;0;2;0;2
16183;Vilkpėdės;"3 klasė";5948799757;Ne;5;0;0;5
16184;Vilkpėdės;"3 klasė";7851213782;Ne;5;0;0;5
16185;Vilkpėdės;"3 klasė";6408620430;Ne;3;0;0;3
16186;Vilkpėdės;"3 klasė";2407908295;Ne;2;0;0;2
16187;Vilkpėdės;"3 klasė";6786266832;Ne;7;0;0;7
16188;Vilkpėdės;"4 klasė";5691976624;Ne;0;3;0;3
16189;Vilkpėdės;"4 klasė";5064616447;Ne;6;1;0;7
16190;Vilkpėdės;"4 klasė";5959800100;Ne;0;1;0;1
16191;Vilkpėdės;"4 klasė";9264492438;Ne;3;2;0;5
16192;Vilkpėdės;"4 klasė";4656816734;Ne;9;1;0;10
16193;Vilkpėdės;"4 klasė";3688858757;Ne;4;1;0;5
16194;Vilkpėdės;"4 klasė";5115595730;Ne;3;1;0;4
16195;Vilkpėdės;"4 klasė";5877781210;Ne;0;1;0;1
16196;Vilkpėdės;"4 klasė";6917717899;Ne;4;1;0;5
16197;Vilkpėdės;"4 klasė";4672603333;Ne;5;1;0;6
16198;Vilkpėdės;"4 klasė";9436443664;Ne;3;1;0;4
16199;Vilkpėdės;"4 klasė";5522788819;Ne;2;1;0;3
16200;Vilkpėdės;"4 klasė";1115530668;Ne;0;1;0;1
16201;Vilkpėdės;"4 klasė";6851966570;Ne;0;1;0;1
16202;Vilkpėdės;"4 klasė";5191937870;Ne;0;1;0;1
16203;Vilkpėdės;"4 klasė";9953554437;Taip;0;1;0;1
16204;Žiburėlis;Nykštukai;45509849089;Taip;0;3;0;3
16205;Žiburėlis;Nykštukai;32837087738;Taip;0;4;0;4
16206;Žiburėlis;Nykštukai;57892276898;Taip;0;6;0;6
16207;Žiburėlis;Nykštukai;87417486808;Taip;0;2;0;2
16208;Žiburėlis;Nykštukai;82679341920;Taip;0;1;0;1
16209;Žiburėlis;Nykštukai;73054546792;Taip;0;7;0;7
16210;Žiburėlis;Nykštukai;98670272543;Taip;0;10;0;10
16211;Žiburėlis;Nykštukai;61148040564;Taip;0;1;0;1
16212;Žiburėlis;Nykštukai;77674964341;Taip;0;6;0;6
16213;Žiburėlis;Nykštukai;16215414453;Taip;3;0;1;4
16214;Žiburėlis;Nykštukai;58253869146;Taip;0;10;0;10
16215;Žiburėlis;Nykštukai;49081936325;Taip;0;10;0;10
16216;Žiburėlis;Nykštukai;25826760783;Taip;8;1;0;9
16217;Žiburėlis;Nykštukai;13256396372;Taip;0;1;0;1
16218;Žiburėlis;Nykštukai;68423991252;Taip;0;9;0;9
16219;Žiburėlis;Nykštukai;7135920347;Taip;0;2;0;2
16220;Žiburėlis;Nykštukai;1133294157;Taip;0;7;0;7
16221;Žiburėlis;"Žiniukai ";18125169377;Taip;0;4;0;4
16222;Žiburėlis;"Žiniukai ";29552486526;Taip;0;21;0;21
16223;Žiburėlis;"Žiniukai ";92036821482;Taip;1;0;1;2
16224;Žiburėlis;"Žiniukai ";70925677727;Taip;0;19;0;19
16225;Žiburėlis;"Žiniukai ";1858285649;Taip;0;1;0;1
16226;Žiburėlis;"Žiniukai ";5412445634;Taip;0;1;0;1
16227;Žiburėlis;"Žiniukai ";1673061718;Taip;11;5;0;16
16228;Žiburėlis;"Žiniukai ";6517292491;Taip;0;17;0;17
16229;Žiburėlis;"Žiniukai ";70987307796;Taip;7;0;0;7
16230;Žiburėlis;"Žiniukai ";5778346952;Taip;0;1;0;1
16231;Žiburėlis;"Žiniukai ";74200469110;Ne;12;5;0;17
16232;Žiburėlis;"Žiniukai ";1770523114;Ne;0;1;0;1
16233;Žiburėlis;"Žiniukai ";90967310390;Taip;0;1;0;1
16234;Žiburėlis;"Žiniukai ";19010380383;Taip;0;5;0;5
16235;Žiburėlis;"Smalsiukai ";5914668910;Ne;10;1;0;11
16236;Žiburėlis;"Smalsiukai ";1673873271;Taip;4;7;0;11
16237;Žiburėlis;"Smalsiukai ";3128936681;Taip;7;6;0;13
16238;Žiburėlis;"Smalsiukai ";31082738591;Taip;10;0;0;10
16239;Žiburėlis;"Smalsiukai ";6669203205;Ne;0;1;0;1
16240;Žiburėlis;"Smalsiukai ";78850854161;Taip;6;0;0;6
16241;Žiburėlis;"Smalsiukai ";95216886081;Taip;6;1;0;7
16242;Žiburėlis;"Smalsiukai ";87512265546;Taip;11;0;0;11
16243;Žiburėlis;"Smalsiukai ";69181720507;Taip;0;5;0;5
16244;Žiburėlis;"Smalsiukai ";54487369856;Taip;7;5;0;12
16245;Žiburėlis;"Smalsiukai ";81892440397;Taip;1;0;0;1
16246;Žiburėlis;"Smalsiukai ";89219215887;Taip;1;0;0;1
16247;Žiburėlis;"Smalsiukai ";93584914250;Taip;7;2;0;9
16248;Žiburėlis;"Smalsiukai ";10273480129;Taip;7;0;0;7
16249;Žiburėlis;"Smalsiukai ";58094756644;Taip;6;1;0;7
16250;Žiburėlis;"Giliukai ";52216192635;Taip;12;0;0;12
16251;Žiburėlis;"Giliukai ";4355778076;Taip;0;1;0;1
16252;Žiburėlis;"Giliukai ";92490398630;Taip;11;0;0;11
16253;Žiburėlis;"Giliukai ";67168630669;Taip;0;6;0;6
16254;Žiburėlis;"Giliukai ";3867540155;Taip;0;2;0;2
16255;Žiburėlis;"Giliukai ";9253393819;Taip;2;1;0;3
16256;Žiburėlis;"Giliukai ";8677998615;Taip;5;0;0;5
16257;Žiburėlis;"Giliukai ";2796489509;Taip;2;0;0;2
16258;Žiburėlis;"Giliukai ";18739941845;Taip;0;3;0;3
16259;Žiburėlis;"Giliukai ";24639355056;Taip;13;1;0;14
16260;Žiburėlis;"Giliukai ";6519139977;Taip;0;12;0;12
16261;Žiburėlis;"Giliukai ";7861704875;Taip;7;1;0;8
16262;Žiburėlis;"Giliukai ";34873231652;Taip;0;1;0;1
16263;Žiburėlis;"Giliukai ";1125662904;Taip;6;0;0;6
16264;Žiburėlis;"Giliukai ";2175751377;Taip;9;0;0;9
16265;Žiburėlis;"Giliukai ";8531121002;Taip;0;1;0;1
16266;Žiburėlis;"Giliukai ";28985997205;Taip;8;0;0;8
16267;Žiburėlis;"1 klasė";1551527192;Ne;2;5;0;7
16268;Žiburėlis;"1 klasė";9177048702;Taip;0;21;0;21
16269;Žiburėlis;"1 klasė";40167464240;Taip;0;5;0;5
16270;Žiburėlis;"1 klasė";91489560481;Taip;0;5;0;5
16271;Žiburėlis;"1 klasė";83887875309;Taip;0;5;0;5
16272;Žiburėlis;"1 klasė";50386629614;Taip;0;5;0;5
16273;Žiburėlis;"1 klasė";78965453247;Ne;0;5;0;5
16274;Žiburėlis;"1 klasė";29289711001;Ne;0;5;0;5
16275;Žiburėlis;"1 klasė";67880120356;Taip;0;5;0;5
16276;Žiburėlis;"1 klasė";97596344387;Taip;4;5;0;9
16277;Žiburėlis;"1 klasė";75779767358;Taip;0;5;0;5
16278;Žiburėlis;"1 klasė";19924188057;Taip;0;5;0;5
16279;Žiburėlis;"1 klasė";56929631997;Taip;0;5;0;5
16280;Žiburėlis;"1 klasė";10039457828;Taip;0;5;0;5
16281;Žiburėlis;"1 klasė";33877368082;Taip;0;5;0;5
16282;Žiburėlis;"1 klasė";1266445858;Taip;0;5;0;5
16283;Žiburėlis;"1 klasė";23334642950;Taip;0;5;0;5
16284;Žiburėlis;"1 klasė";86214644730;Taip;3;5;0;8
16285;Žiburėlis;"1 klasė";91397954329;Taip;0;5;0;5
16286;Žiburėlis;"1 klasė";16657264022;Taip;0;5;0;5
16287;Žiburėlis;"1 klasė";3462265950;Taip;0;21;0;21
16288;Žiburėlis;"1 klasė";4909760547;Taip;0;5;0;5
16289;Žiburėlis;Meškiukai;7070952018;Taip;0;5;0;5
16290;Žiburėlis;Meškiukai;874653320;Taip;0;4;0;4
16291;Žiburėlis;Meškiukai;38096163093;Taip;2;0;0;2
16292;Žiburėlis;Meškiukai;96004573835;Taip;8;7;0;15
16293;Žiburėlis;Meškiukai;549348368;Taip;0;9;0;9
16294;Žiburėlis;Meškiukai;2270893326;Taip;0;10;0;10
16295;Žiburėlis;Meškiukai;1728059994;Taip;0;1;0;1
16296;Žiburėlis;Meškiukai;1523632106;Taip;16;0;0;16
16297;Žiburėlis;Meškiukai;3678560815;Taip;0;0;2;2
16298;Žiburėlis;Meškiukai;57749440744;Taip;14;1;0;15
16299;Žiburėlis;Meškiukai;808556747;Taip;0;18;0;18
16300;Žiburėlis;Meškiukai;43206636255;Taip;0;1;0;1
16301;Žiburėlis;Meškiukai;60150682872;Taip;0;3;0;3
16302;Žiburėlis;Meškiukai;50869669391;Taip;7;5;0;12
16303;Žiburėlis;Meškiukai;31669188580;Taip;5;0;0;5
16304;Žiburėlis;Meškiukai;5495813195;Taip;14;1;0;15
16305;Žiburėlis;Meškiukai;42442737710;Taip;12;0;0;12
16306;Žiburėlis;Viščiukai;7402647048;Taip;18;0;0;18
16307;Žiburėlis;Viščiukai;8215816053;Taip;4;8;0;12
16308;Žiburėlis;Viščiukai;9352485231;Taip;0;1;0;1
16309;Žiburėlis;Viščiukai;4710995351;Taip;4;1;0;5
16310;Žiburėlis;Viščiukai;3646988912;Taip;12;1;0;13
16311;Žiburėlis;Viščiukai;7633450988;Taip;15;0;0;15
16312;Žiburėlis;Viščiukai;2292895729;Taip;0;1;0;1
16313;Žiburėlis;Viščiukai;7273838695;Taip;0;2;0;2
16314;Žiburėlis;Viščiukai;5098955523;Taip;21;0;0;21
16315;Žiburėlis;Viščiukai;6250610187;Taip;0;7;0;7
16316;Žiburėlis;Viščiukai;5629404179;Taip;6;1;0;7
16317;Žiburėlis;Viščiukai;1764592065;Taip;2;0;0;2
16318;Žiburėlis;Viščiukai;8686565770;Taip;2;2;0;4
16319;Žiburėlis;Viščiukai;6696156248;Taip;2;0;0;2
16320;Žiburėlis;Viščiukai;3938379566;Taip;6;0;0;6
16321;Žiburėlis;Viščiukai;5556807335;Taip;10;1;0;11
16322;Žiburėlis;"Drambliukai ";8535429783;Taip;0;10;0;10
16323;Žiburėlis;"Drambliukai ";9670396828;Taip;21;0;0;21
16324;Žiburėlis;"Drambliukai ";1720078356;Taip;7;0;0;7
16325;Žiburėlis;"Drambliukai ";5517458323;Taip;11;0;0;11
16326;Žiburėlis;"Drambliukai ";2982016133;Taip;0;0;1;1
16327;Žiburėlis;"Drambliukai ";7424129974;Taip;10;2;0;12
16328;Žiburėlis;"Drambliukai ";5816890413;Taip;18;0;0;18
16329;Žiburėlis;"Drambliukai ";9336617879;Taip;6;0;0;6
16330;Žiburėlis;"Drambliukai ";2928528630;Taip;0;7;0;7
16331;Žiburėlis;"Drambliukai ";8109335587;Taip;0;1;0;1
16332;Žiburėlis;"Drambliukai ";4187381976;Taip;11;2;0;13
16333;Žiburėlis;"Drambliukai ";2624326930;Taip;6;0;0;6
16334;Žiburėlis;"Drambliukai ";6300247811;Taip;5;5;0;10
16335;Žiburėlis;"Drambliukai ";3033049328;Taip;0;2;0;2
16336;Žiburėlis;"Drambliukai ";3687703187;Taip;1;0;0;1
16337;Žiburėlis;"Drambliukai ";1876645582;Taip;3;0;1;4
16338;Žiburėlis;"Drambliukai ";5006361324;Taip;6;0;0;6
16339;Žiburėlis;"Drambliukai ";5303511810;Taip;6;0;0;6
16340;Žiburėlis;"Drambliukai ";3262856058;Taip;18;0;0;18
16341;Žiburėlis;"Drambliukai ";7211961512;Taip;0;6;0;6
16342;Žiburėlis;"2 klasė";5587135070;Ne;10;5;0;15
16343;Žiburėlis;"2 klasė";5154752431;Ne;0;5;0;5
16344;Žiburėlis;"2 klasė";2980656238;Ne;0;5;0;5
16345;Žiburėlis;"2 klasė";9444201589;Ne;0;5;0;5
16346;Žiburėlis;"2 klasė";4955196776;Ne;0;5;0;5
16347;Žiburėlis;"2 klasė";7328501055;Ne;4;5;0;9
16348;Žiburėlis;"2 klasė";6555937866;Ne;6;5;0;11
16349;Žiburėlis;"2 klasė";6532799193;Ne;0;5;0;5
16350;Žiburėlis;"2 klasė";5801758386;Ne;0;5;0;5
16351;Žiburėlis;"2 klasė";8108287017;Ne;0;21;0;21
16352;Žiburėlis;"2 klasė";9986286327;Ne;0;5;0;5
16353;Žiburėlis;"2 klasė";8967516850;Ne;0;5;0;5
16354;Žiburėlis;"2 klasė";5730454385;Ne;0;5;0;5
16355;Žiburėlis;"2 klasė";7420310542;Ne;0;5;0;5
16356;Žiburėlis;"2 klasė";9030168070;Ne;5;5;0;10
16357;Žiburėlis;"2 klasė";1040139766;Ne;0;5;0;5
16358;Žiburėlis;"2 klasė";2895056046;Ne;1;5;1;7
16359;Žiburėlis;"2 klasė";7971654401;Ne;0;21;0;21
16360;Žiburėlis;"2 klasė";7244452816;Ne;3;5;0;8
16361;Žiburėlis;"2 klasė";5120367724;Ne;0;5;0;5
16362;Žiburėlis;"3 klasė";8539444386;Ne;0;5;0;5
16363;Žiburėlis;"3 klasė";2145461317;Ne;1;5;0;6
16364;Žiburėlis;"3 klasė";9676316394;Ne;0;5;0;5
16365;Žiburėlis;"3 klasė";4612471196;Ne;0;5;0;5
16366;Žiburėlis;"3 klasė";8942909201;Ne;5;5;0;10
16367;Žiburėlis;"3 klasė";6088424692;Ne;0;26;0;26
16368;Žiburėlis;"3 klasė";3493549126;Ne;0;26;0;26
16369;Žiburėlis;"3 klasė";4444164248;Ne;1;5;0;6
16370;Žiburėlis;"3 klasė";1769155142;Ne;0;5;0;5
16371;Žiburėlis;"3 klasė";8755335337;Ne;0;26;0;26
16372;Žiburėlis;"3 klasė";7451312098;Ne;0;5;0;5
16373;Žiburėlis;"3 klasė";7239532785;Ne;0;5;0;5
16374;Žiburėlis;"3 klasė";5999075406;Ne;0;26;0;26
16375;Žiburėlis;"3 klasė";6548933505;Ne;4;5;0;9
16376;Žiburėlis;"3 klasė";9803636658;Ne;0;26;0;26
16377;Žiburėlis;"3 klasė";6992801094;Ne;7;5;0;12
16378;Žiburėlis;"3 klasė";3931688013;Ne;0;26;0;26
16379;Žiburėlis;"4 klasė";7864773283;Ne;0;5;0;5
16380;Žiburėlis;"4 klasė";5224982445;Ne;0;5;0;5
16381;Žiburėlis;"4 klasė";9535229323;Ne;0;5;0;5
16382;Žiburėlis;"4 klasė";6872226065;Ne;0;5;0;5
16383;Žiburėlis;"4 klasė";9952387998;Ne;0;5;0;5
16384;Žiburėlis;"4 klasė";8525158050;Ne;4;5;0;9
16385;Žiburėlis;"4 klasė";6800376566;Ne;0;5;0;5
16386;Žiburėlis;"4 klasė";4261473166;Ne;0;5;0;5
16387;Žiburėlis;"4 klasė";4768463997;Ne;0;5;0;5
16388;Žiburėlis;"4 klasė";5990820199;Ne;0;5;1;6
16389;Žiburėlis;"4 klasė";2645591088;Ne;0;5;0;5
16390;Žiburėlis;"4 klasė";6362934592;Ne;0;25;0;25
16391;Žiburėlis;"4 klasė";8758526732;Ne;0;25;0;25
16392;Žiburėlis;"4 klasė";2638686151;Ne;1;5;0;6
16393;Žiburėlis;"4 klasė";8496410382;Ne;4;5;0;9
16394;Žiburėlis;"4 klasė";4067505776;Ne;1;5;0;6
16395;Žiburėlis;"4 klasė";6388681440;Ne;2;5;0;7
16396;Žiburėlis;"4 klasė";5014047026;Ne;2;5;0;7
16397;Žiburėlis;"4 klasė";4827287214;Ne;2;5;1;8
16398;Žiburėlis;"4 klasė";5943397400;Ne;0;5;0;5
16399;Žiburėlis;"4 klasė";8711998371;Ne;2;5;0;7
16400;Žiburėlis;"4 klasė";2354284014;Ne;0;25;0;25
16401;Justinukas;SMALSUČIŲ;7005815238;Taip;21;0;0;21
16402;Justinukas;SMALSUČIŲ;13170636069;Taip;0;3;0;3
16403;Justinukas;SMALSUČIŲ;3118698712;Taip;0;3;0;3
16404;Justinukas;SMALSUČIŲ;3312575449;Taip;10;0;0;10
16405;Justinukas;SMALSUČIŲ;1773690115;Taip;17;0;2;19
16406;Justinukas;SMALSUČIŲ;1121936989;Taip;0;2;0;2
16407;Justinukas;SMALSUČIŲ;49343952061;Taip;0;3;0;3
16408;Justinukas;SMALSUČIŲ;8741735734;Taip;21;0;0;21
16409;Justinukas;SMALSUČIŲ;2160609412;Taip;5;2;0;7
16410;Justinukas;SMALSUČIŲ;8529082669;Taip;0;10;0;10
16411;Justinukas;SMALSUČIŲ;7678062264;Taip;14;2;0;16
16412;Justinukas;SMALSUČIŲ;1830060403;Taip;0;5;0;5
16413;Justinukas;SMALSUČIŲ;6597383913;Taip;3;0;0;3
16414;Justinukas;SMALSUČIŲ;67366895767;Taip;6;5;0;11
16415;Justinukas;SMALSUČIŲ;9349373645;Taip;5;0;0;5
16416;Justinukas;SMALSUČIŲ;3062444365;Taip;10;2;0;12
16417;Justinukas;SMALSUČIŲ;93600065957;Taip;10;0;0;10
16418;Justinukas;SMALSUČIŲ;2317566323;Taip;5;0;4;9
16419;Justinukas;SMALSUČIŲ;1704933971;Taip;0;0;4;4
16420;Justinukas;SVAJOKLIŲ;9822696769;Taip;0;10;0;10
16421;Justinukas;SVAJOKLIŲ;1627717901;Taip;5;5;0;10
16422;Justinukas;SVAJOKLIŲ;6234625191;Taip;8;3;0;11
16423;Justinukas;SVAJOKLIŲ;3863971540;Taip;0;2;0;2
16424;Justinukas;SVAJOKLIŲ;43527855441;Taip;0;1;0;1
16425;Justinukas;SVAJOKLIŲ;16029286933;Taip;0;7;0;7
16426;Justinukas;SVAJOKLIŲ;8971898312;Taip;0;19;0;19
16427;Justinukas;SVAJOKLIŲ;48101258124;Taip;0;1;0;1
16428;Justinukas;SVAJOKLIŲ;1216138998;Taip;0;9;0;9
16429;Justinukas;SVAJOKLIŲ;7316804839;Taip;5;3;0;8
16430;Justinukas;SVAJOKLIŲ;3790209561;Taip;13;0;0;13
16431;Justinukas;SVAJOKLIŲ;9558483512;Taip;5;0;0;5
16432;Justinukas;SVAJOKLIŲ;1814943669;Taip;15;1;0;16
16433;Justinukas;SVAJOKLIŲ;37288931495;Taip;0;1;0;1
16434;Justinukas;SVAJOKLIŲ;8636869322;Taip;17;0;0;17
16435;Justinukas;SVAJOKLIŲ;6766493175;Taip;13;2;0;15
16436;Justinukas;SVAJOKLIŲ;5494500249;Taip;13;2;0;15
16437;Justinukas;SVAJOKLIŲ;6816901962;Taip;0;5;0;5
16438;Justinukas;SVAJOKLIŲ;3657642693;Taip;3;3;0;6
16439;Justinukas;"SAULĖS ZUIKIŲ";1550323727;Taip;3;2;1;6
16440;Justinukas;"SAULĖS ZUIKIŲ";1801800210;Taip;5;0;0;5
16441;Justinukas;"SAULĖS ZUIKIŲ";29875250126;Taip;5;0;3;8
16442;Justinukas;"SAULĖS ZUIKIŲ";3813820356;Taip;12;5;0;17
16443;Justinukas;"SAULĖS ZUIKIŲ";3215259838;Taip;16;1;0;17
16444;Justinukas;"SAULĖS ZUIKIŲ";66240994100;Taip;4;0;0;4
16445;Justinukas;"SAULĖS ZUIKIŲ";8350429513;Taip;0;8;0;8
16446;Justinukas;"SAULĖS ZUIKIŲ";2532510817;Taip;0;8;0;8
16447;Justinukas;"SAULĖS ZUIKIŲ";52253951149;Taip;0;9;0;9
16448;Justinukas;"SAULĖS ZUIKIŲ";9411813711;Taip;6;0;0;6
16449;Justinukas;"SAULĖS ZUIKIŲ";4887565054;Taip;0;2;2;4
16450;Justinukas;"SAULĖS ZUIKIŲ";1806484271;Taip;0;4;0;4
16451;Justinukas;"SAULĖS ZUIKIŲ";8716574742;Taip;8;0;0;8
16452;Justinukas;"SAULĖS ZUIKIŲ";78270625975;Taip;15;3;0;18
16453;Justinukas;"SAULĖS ZUIKIŲ";5215250778;Taip;10;0;0;10
16454;Justinukas;"SAULĖS ZUIKIŲ";2018007566;Taip;0;0;2;2
16455;Justinukas;"SAULĖS ZUIKIŲ";1590855655;Taip;0;1;0;1
16456;Justinukas;"SAULĖS ZUIKIŲ";49880907488;Taip;7;0;0;7
16457;Justinukas;"SAULĖS ZUIKIŲ";76257661228;Taip;4;1;0;5
16458;Justinukas;"SAULĖS ZUIKIŲ";56402748009;Taip;6;1;6;13
16459;Justinukas;PABIRUČIŲ;1996480143;Taip;4;4;0;8
16460;Justinukas;PABIRUČIŲ;76659578448;Taip;0;2;0;2
16461;Justinukas;PABIRUČIŲ;1655237708;Taip;10;1;0;11
16462;Justinukas;PABIRUČIŲ;1206482166;Taip;4;0;0;4
16463;Justinukas;PABIRUČIŲ;42308434800;Taip;6;1;0;7
16464;Justinukas;PABIRUČIŲ;20865224818;Taip;0;1;0;1
16465;Justinukas;PABIRUČIŲ;37019368317;Taip;10;0;0;10
16466;Justinukas;PABIRUČIŲ;23762150256;Taip;5;0;0;5
16467;Justinukas;PABIRUČIŲ;62276887757;Taip;5;5;0;10
16468;Justinukas;PABIRUČIŲ;28457909446;Ne;0;9;0;9
16469;Justinukas;PABIRUČIŲ;70334519732;Taip;5;2;1;8
16470;Justinukas;PABIRUČIŲ;94562009887;Taip;5;1;0;6
16471;Justinukas;PABIRUČIŲ;31817312555;Taip;6;2;5;13
16472;Justinukas;PABIRUČIŲ;46373287636;Taip;5;0;0;5
16473;Justinukas;PABIRUČIŲ;72517122863;Taip;0;3;0;3
16474;Justinukas;PABIRUČIŲ;42486181827;Taip;0;2;3;5
16475;Justinukas;PABIRUČIŲ;45490599266;Taip;0;4;0;4
16476;Justinukas;PABIRUČIŲ;41914970891;Taip;0;1;0;1
16477;Justinukas;PABIRUČIŲ;1557388485;Taip;7;5;0;12
16478;Justinukas;VYTURIUKŲ;1585956968;Taip;0;2;3;5
16479;Justinukas;VYTURIUKŲ;4056697803;Taip;5;4;0;9
16480;Justinukas;VYTURIUKŲ;1181972027;Taip;0;1;0;1
16481;Justinukas;VYTURIUKŲ;59176678396;Taip;0;1;0;1
16482;Justinukas;VYTURIUKŲ;1598234416;Taip;0;1;0;1
16483;Justinukas;VYTURIUKŲ;1511044883;Taip;0;13;0;13
16484;Justinukas;VYTURIUKŲ;1555183700;Taip;0;3;0;3
16485;Justinukas;VYTURIUKŲ;1785794727;Taip;0;3;3;6
16486;Justinukas;VYTURIUKŲ;99512297006;Taip;5;0;0;5
16487;Justinukas;VYTURIUKŲ;28095047700;Taip;0;2;1;3
16488;Justinukas;VYTURIUKŲ;91620507403;Taip;2;0;0;2
16489;Justinukas;VYTURIUKŲ;35192728896;Taip;0;3;0;3
16490;Justinukas;VYTURIUKŲ;1005872691;Taip;5;8;0;13
16491;Justinukas;VYTURIUKŲ;13774489893;Taip;14;0;0;14
16492;Justinukas;VYTURIUKŲ;2002649360;Taip;0;4;0;4
16493;Justinukas;VYTURIUKŲ;30823793919;Taip;21;0;0;21
16494;Justinukas;VYTURIUKŲ;1956705813;Taip;3;0;3;6
16495;Justinukas;VYTURIUKŲ;89330918024;Taip;10;0;0;10
16496;Justinukas;VYTURIUKŲ;49578167204;Taip;5;0;0;5
16497;Justinukas;KODĖLČIUKŲ;1378219785;Taip;0;0;1;1
16498;Justinukas;KODĖLČIUKŲ;4946448574;Taip;0;1;0;1
16499;Justinukas;KODĖLČIUKŲ;1022310072;Taip;0;0;6;6
16500;Justinukas;KODĖLČIUKŲ;33481357566;Taip;0;8;0;8
16501;Justinukas;KODĖLČIUKŲ;67436657541;Taip;0;0;1;1
16502;Justinukas;KODĖLČIUKŲ;29009575642;Taip;0;1;0;1
16503;Justinukas;KODĖLČIUKŲ;55428936508;Taip;0;0;1;1
16504;Justinukas;KODĖLČIUKŲ;60187200;Taip;0;0;1;1
16505;Justinukas;KODĖLČIUKŲ;11824002845;Taip;3;2;0;5
16506;Justinukas;KODĖLČIUKŲ;29696816177;Taip;0;3;0;3
16507;Justinukas;KODĖLČIUKŲ;50050288702;Taip;0;4;0;4
16508;Justinukas;KODĖLČIUKŲ;65541524010;Taip;0;7;0;7
16509;Justinukas;KODĖLČIUKŲ;70144957042;Taip;0;1;0;1
16510;Justinukas;KODĖLČIUKŲ;21904117684;Taip;0;1;0;1
16511;Justinukas;KODĖLČIUKŲ;95563958391;Taip;0;0;2;2
16512;Justinukas;KODĖLČIUKŲ;38087400506;Taip;0;1;0;1
16513;Justinukas;KODĖLČIUKŲ;51111749099;Taip;0;8;0;8
16514;Justinukas;KODĖLČIUKŲ;79380650760;Taip;0;8;0;8
16515;Justinukas;KODĖLČIUKŲ;42959183109;Taip;0;15;0;15
16516;Justinukas;KODĖLČIUKŲ;84179174899;Taip;5;2;1;8
16517;Justinukas;KODĖLČIUKŲ;1820490979;Taip;5;0;0;5
16518;Justinukas;KODĖLČIUKŲ;1962802968;Taip;0;9;0;9
16519;Justinukas;VIKRUOLIŲ;57621616956;Taip;13;0;0;13
16520;Justinukas;VIKRUOLIŲ;59108759161;Taip;5;8;2;15
16521;Justinukas;VIKRUOLIŲ;2776259830;Taip;0;8;0;8
16522;Justinukas;VIKRUOLIŲ;79934530654;Taip;3;0;0;3
16523;Justinukas;VIKRUOLIŲ;95467011497;Taip;8;2;1;11
16524;Justinukas;VIKRUOLIŲ;48732379120;Ne;6;1;0;7
16525;Justinukas;VIKRUOLIŲ;1844038414;Taip;0;5;0;5
16526;Justinukas;VIKRUOLIŲ;2952798555;Taip;20;0;0;20
16527;Justinukas;VIKRUOLIŲ;54102488427;Taip;0;15;0;15
16528;Justinukas;VIKRUOLIŲ;28543773229;Taip;6;2;4;12
16529;Justinukas;VIKRUOLIŲ;68853730495;Taip;20;0;0;20
16530;Justinukas;VIKRUOLIŲ;70062275466;Taip;5;0;0;5
16531;Justinukas;VIKRUOLIŲ;80827159258;Taip;21;0;0;21
16532;Justinukas;VIKRUOLIŲ;311074533;Taip;14;0;0;14
16533;Justinukas;VIKRUOLIŲ;55151392377;Taip;7;0;0;7
16534;Justinukas;VIKRUOLIŲ;97284171512;Taip;10;0;0;10
16535;Justinukas;VIKRUOLIŲ;1955952962;Taip;0;2;0;2
16536;Justinukas;VIKRUOLIŲ;1480054888;Taip;18;0;0;18
16537;Justinukas;VIKRUOLIŲ;5199005933;Taip;6;3;0;9
16538;Justinukas;VIKRUOLIŲ;2120659659;Taip;0;10;0;10
16539;Justinukas;PELEDŽIUKŲ;1789533195;Taip;5;3;1;9
16540;Justinukas;PELEDŽIUKŲ;74887990218;Taip;4;0;0;4
16541;Justinukas;PELEDŽIUKŲ;1937753510;Taip;0;0;2;2
16542;Justinukas;PELEDŽIUKŲ;6268022925;Taip;10;0;2;12
16543;Justinukas;PELEDŽIUKŲ;1405642653;Taip;6;1;0;7
16544;Justinukas;PELEDŽIUKŲ;89934673064;Taip;4;2;0;6
16545;Justinukas;PELEDŽIUKŲ;90692179185;Taip;0;7;0;7
16546;Justinukas;PELEDŽIUKŲ;61301662234;Taip;0;5;0;5
16547;Justinukas;PELEDŽIUKŲ;2027779101;Taip;15;0;0;15
16548;Justinukas;PELEDŽIUKŲ;8742157840;Taip;0;2;0;2
16549;Justinukas;PELEDŽIUKŲ;55089909579;Taip;0;4;0;4
16550;Justinukas;PELEDŽIUKŲ;12741015006;Taip;11;1;0;12
16551;Justinukas;PELEDŽIUKŲ;6961211392;Taip;4;0;0;4
16552;Justinukas;PELEDŽIUKŲ;48908098476;Taip;5;6;0;11
16553;Justinukas;PELEDŽIUKŲ;6604163285;Taip;0;17;0;17
16554;Justinukas;PELEDŽIUKŲ;1266695122;Taip;10;1;0;11
16555;Justinukas;PELEDŽIUKŲ;1956136425;Taip;0;1;0;1
16556;Justinukas;PELEDŽIUKŲ;1846303993;Taip;0;4;0;4
16557;Justinukas;ŽIRNIUKŲ;5876182759;Taip;0;3;0;3
16558;Justinukas;ŽIRNIUKŲ;5978993456;Taip;17;0;0;17
16559;Justinukas;ŽIRNIUKŲ;5870609685;Taip;12;1;0;13
16560;Justinukas;ŽIRNIUKŲ;8965456115;Taip;0;5;0;5
16561;Justinukas;ŽIRNIUKŲ;8455069158;Taip;6;0;2;8
16562;Justinukas;ŽIRNIUKŲ;3193143474;Taip;14;0;1;15
16563;Justinukas;ŽIRNIUKŲ;1540892686;Taip;17;0;0;17
16564;Justinukas;ŽIRNIUKŲ;1341026177;Taip;12;0;0;12
16565;Justinukas;ŽIRNIUKŲ;3729297918;Taip;0;0;7;7
16566;Justinukas;ŽIRNIUKŲ;2268124610;Taip;5;4;0;9
16567;Justinukas;GUDRUČIŲ;2241816838;Taip;16;0;0;16
16568;Justinukas;GUDRUČIŲ;4756483798;Taip;6;0;0;6
16569;Justinukas;GUDRUČIŲ;3206751576;Taip;5;0;0;5
16570;Justinukas;GUDRUČIŲ;6470287041;Taip;5;0;2;7
16571;Justinukas;GUDRUČIŲ;3268913601;Taip;14;0;0;14
16572;Justinukas;GUDRUČIŲ;2017929633;Taip;8;0;0;8
16573;Justinukas;GUDRUČIŲ;7710916537;Taip;16;2;0;18
16574;Justinukas;GUDRUČIŲ;4194429972;Taip;10;2;0;12
16575;Justinukas;GUDRUČIŲ;8913463448;Taip;14;1;0;15
16576;Justinukas;GUDRUČIŲ;7854674833;Taip;5;8;0;13
16577;Justinukas;GUDRUČIŲ;3768735503;Taip;2;0;0;2
16578;Justinukas;GUDRUČIŲ;8086378912;Taip;11;0;0;11
16579;Justinukas;GUDRUČIŲ;4271601149;Taip;5;1;0;6
16580;Justinukas;BORUŽIUKŲ;6897988246;Taip;0;1;0;1
16581;Justinukas;BORUŽIUKŲ;4542350401;Taip;16;0;0;16
16582;Justinukas;BORUŽIUKŲ;4347647695;Taip;0;10;0;10
16583;Justinukas;BORUŽIUKŲ;3388483002;Taip;13;0;1;14
16584;Justinukas;BORUŽIUKŲ;9998493076;Taip;4;1;0;5
16585;Justinukas;BORUŽIUKŲ;1129392970;Taip;4;0;0;4
16586;Justinukas;BORUŽIUKŲ;8281005516;Taip;1;0;1;2
16587;Justinukas;BORUŽIUKŲ;1398976932;Taip;0;3;0;3
16588;Justinukas;BORUŽIUKŲ;1977242147;Taip;12;0;1;13
16589;Justinukas;BORUŽIUKŲ;29165025048;Taip;3;0;0;3
16590;Justinukas;BORUŽIUKŲ;5258444578;Taip;6;0;1;7
16591;Justinukas;BORUŽIUKŲ;4574673585;Taip;5;1;0;6
16592;Justinukas;BORUŽIUKŲ;7006338378;Taip;10;3;0;13
16593;Justinukas;BORUŽIUKŲ;7166828675;Taip;0;13;2;15
16594;Justinukas;BORUŽIUKŲ;4010638658;Taip;5;1;0;6
16595;Justinukas;BORUŽIUKŲ;1172609518;Taip;7;3;0;10
16596;Justinukas;BORUŽIUKŲ;1616324236;Taip;0;3;0;3
16597;Justinukas;BORUŽIUKŲ;3030820917;Taip;10;4;0;14
16598;Aidas;Boružėlių;8915901727;Taip;1;0;0;1
16599;Aidas;Boružėlių;5311183877;Taip;1;6;0;7
16600;Aidas;Drugelių;3473596157;Taip;0;1;0;1
16601;Aidas;Drugelių;15257986685;Taip;0;15;0;15
16602;Aidas;Drugelių;1653793823;Taip;8;2;0;10
16603;Aidas;Drugelių;2954393415;Taip;4;4;0;8
16604;Aidas;Drugelių;6835234112;Taip;0;1;0;1
16605;Aidas;Aitvariukų;17920063762;Taip;0;1;0;1
16606;Aidas;Aitvariukų;30954912922;Taip;10;9;0;19
16607;Aidas;Aitvariukų;6700193362;Taip;0;2;0;2
16608;Aidas;Aitvariukų;3127870635;Taip;5;0;0;5
16609;Aidas;Aitvariukų;3366848846;Taip;0;9;0;9
16610;Aidas;"Meškučių kl.";9456640135;Ne;4;0;0;4
16611;Aidas;"Meškučių kl.";3496627131;Ne;8;1;0;9
16612;Aidas;"Gaidelių kl.";8642665550;Ne;0;1;0;1
16613;Aidas;"Gaidelių kl.";5806540190;Ne;6;0;0;6
16614;Aidas;"Gaidelių kl.";7803641933;Ne;1;1;0;2
16615;Aidas;"Gaidelių kl.";2501187241;Ne;0;3;0;3
16616;Aidas;"Kiškelių kl";6213577188;Ne;0;2;0;2
16617;Aidas;"Kiškelių kl";2681438925;Taip;4;0;0;4
16618;Aidas;"Kiškelių kl";5388697695;Ne;0;5;0;5
16619;Aidas;"Kiškelių kl";6868265902;Ne;0;5;0;5
16620;Aidas;"Kiškelių kl";2446003793;Ne;0;1;0;1
16621;Aidas;"Ančiukų kl.";2672192094;Ne;9;0;0;9
16622;Aidas;"Ančiukų kl.";1742331213;Ne;0;1;0;1
16623;Aidas;"Ančiukų kl.";92425322676;Ne;4;6;0;10
16624;Aidas;"Ančiukų kl.";81654551230;Taip;0;3;0;3
16625;Aidas;"Ančiukų kl.";9816043688;Ne;0;2;0;2
16626;Aidas;"Ančiukų kl.";20604410476;Ne;0;1;0;1
16627;Aidas;"Ančiukų kl.";63508565206;Ne;0;2;0;2
16628;Aidas;"Ančiukų kl.";1079077463;Taip;0;1;0;1
16629;Aidas;"Ančiukų kl.";72751441075;Taip;11;0;0;11
16630;Aidas;"Pelėdžiukų kl.";5712688030;Ne;5;3;0;8
16631;Aidas;"Pelėdžiukų kl.";3279914631;Ne;0;1;0;1
16632;Aidas;"Pelėdžiukų kl.";7148658584;Ne;0;1;0;1
16633;Aidas;"Papūgėlių kl.";3447250754;Ne;0;1;0;1
16634;Aidas;"Papūgėlių kl.";2184123290;Taip;10;0;0;10
16635;Aidas;"Papūgėlių kl.";8490224829;Ne;0;1;0;1
16636;Aidas;"Papūgėlių kl.";5905008395;Taip;0;5;0;5
16637;Aidas;"Papūgėlių kl.";9613466086;Taip;10;1;0;11
16638;Aidas;"Saulutės kl.";1535004699;Ne;0;15;0;15
16639;Aidas;"Saulutės kl.";6356218442;Taip;0;9;0;9
16640;Aidas;"Saulutės kl.";9944901942;Ne;0;7;0;7
16641;Aidas;"Saulutės kl.";74897451962;Taip;0;1;0;1
16642;Aidas;"Saulutės kl.";4890362155;Taip;6;5;0;11
16643;Aidas;"Saulutės kl.";6778658540;Taip;1;5;0;6
16644;Aidas;"Saulutės kl.";2000234311;Taip;0;2;0;2
16645;Aidas;"Saulutės kl.";4990112920;Taip;0;6;0;6
16646;Aidas;"Katinėlių kl.";4367406525;Taip;8;0;0;8
16647;Aidas;"Katinėlių kl.";7821044288;Taip;2;2;0;4
16648;Gėlynas;PAKALNUTĖ;95681874019;Taip;0;1;0;1
16649;Gėlynas;PAKALNUTĖ;22067595840;Taip;6;0;0;6
16650;Gėlynas;PAKALNUTĖ;7735904549;Taip;12;0;0;12
16651;Gėlynas;PAKALNUTĖ;72991081966;Taip;1;2;0;3
16652;Gėlynas;PAKALNUTĖ;85912494214;Taip;0;3;0;3
16653;Gėlynas;PAKALNUTĖ;23134075402;Taip;4;0;0;4
16654;Gėlynas;PAKALNUTĖ;93919808581;Taip;0;9;0;9
16655;Gėlynas;PAKALNUTĖ;65634206992;Taip;0;6;0;6
16656;Gėlynas;PAKALNUTĖ;31532261756;Taip;6;5;0;11
16657;Gėlynas;PAKALNUTĖ;91530210644;Taip;0;4;1;5
16658;Gėlynas;PAKALNUTĖ;72544014665;Taip;0;10;1;11
16659;Gėlynas;PAKALNUTĖ;40702362906;Taip;12;2;0;14
16660;Gėlynas;PAKALNUTĖ;75222833700;Taip;8;7;0;15
16661;Gėlynas;PAKALNUTĖ;55177015936;Taip;10;1;0;11
16662;Gėlynas;PAKALNUTĖ;58542813068;Taip;0;3;0;3
16663;Gėlynas;PAKALNUTĖ;1406567756;Taip;0;7;0;7
16664;Gėlynas;PAKALNUTĖ;6375754699;Taip;5;0;1;6
16665;Gėlynas;VARPELIS;10328968209;Taip;3;0;1;4
16666;Gėlynas;VARPELIS;31203005706;Taip;4;8;0;12
16667;Gėlynas;VARPELIS;69440015944;Taip;7;0;0;7
16668;Gėlynas;VARPELIS;88267408077;Taip;8;0;0;8
16669;Gėlynas;VARPELIS;79659995227;Taip;0;10;0;10
16670;Gėlynas;VARPELIS;83480285704;Taip;1;0;0;1
16671;Gėlynas;VARPELIS;32029146963;Taip;0;3;0;3
16672;Gėlynas;VARPELIS;49356547308;Taip;6;0;0;6
16673;Gėlynas;VARPELIS;96358879500;Taip;0;1;0;1
16674;Gėlynas;VARPELIS;64162031157;Taip;10;0;0;10
16675;Gėlynas;VARPELIS;81669521777;Ne;15;0;0;15
16676;Gėlynas;VARPELIS;51078077889;Taip;12;1;0;13
16677;Gėlynas;VARPELIS;95226235881;Taip;0;8;0;8
16678;Gėlynas;VARPELIS;1321152075;Taip;0;7;0;7
16679;Gėlynas;VARPELIS;87982340000;Taip;0;6;0;6
16680;Gėlynas;VARPELIS;85776411183;Taip;1;0;0;1
16681;Gėlynas;RAKTAŽOLĖ;1418321973;Taip;6;0;0;6
16682;Gėlynas;RAKTAŽOLĖ;93572183033;Taip;4;0;0;4
16683;Gėlynas;RAKTAŽOLĖ;4508497773;Taip;0;1;0;1
16684;Gėlynas;RAKTAŽOLĖ;84522552145;Taip;0;4;0;4
16685;Gėlynas;RAKTAŽOLĖ;33068084227;Taip;3;0;0;3
16686;Gėlynas;RAKTAŽOLĖ;1797681067;Taip;8;0;0;8
16687;Gėlynas;RAKTAŽOLĖ;1117528954;Taip;1;6;0;7
16688;Gėlynas;RAKTAŽOLĖ;57429063547;Taip;16;3;0;19
16689;Gėlynas;RAKTAŽOLĖ;1483072450;Taip;1;0;0;1
16690;Gėlynas;RAKTAŽOLĖ;7796794153;Taip;0;0;2;2
16691;Gėlynas;RAKTAŽOLĖ;6264361257;Taip;13;0;0;13
16692;Gėlynas;RAKTAŽOLĖ;1047462165;Taip;0;1;0;1
16693;Gėlynas;RAKTAŽOLĖ;1754734306;Taip;2;5;0;7
16694;Gėlynas;RAKTAŽOLĖ;9780911032;Taip;0;1;0;1
16695;Gėlynas;RAKTAŽOLĖ;84546885977;Taip;0;6;0;6
16696;Gėlynas;RAKTAŽOLĖ;5135747448;Taip;6;0;0;6
16697;Gėlynas;RAKTAŽOLĖ;7808971151;Taip;0;0;1;1
16698;Gėlynas;RAKTAŽOLĖ;1036951275;Taip;1;0;0;1
16699;Gėlynas;SAULĖGRĄŽA;1995694892;Taip;0;0;1;1
16700;Gėlynas;SAULĖGRĄŽA;1191494598;Taip;6;0;1;7
16701;Gėlynas;SAULĖGRĄŽA;1676904275;Taip;6;1;0;7
16702;Gėlynas;SAULĖGRĄŽA;1338585475;Ne;13;0;0;13
16703;Gėlynas;SAULĖGRĄŽA;2050384850;Taip;9;0;0;9
16704;Gėlynas;SAULĖGRĄŽA;85310323038;Taip;7;0;0;7
16705;Gėlynas;SAULĖGRĄŽA;47220216751;Taip;0;4;0;4
16706;Gėlynas;SAULĖGRĄŽA;2099722437;Taip;0;7;0;7
16707;Gėlynas;SAULĖGRĄŽA;86881175896;Taip;4;0;0;4
16708;Gėlynas;SAULĖGRĄŽA;1608626732;Taip;0;9;0;9
16709;Gėlynas;SAULĖGRĄŽA;44391516295;Taip;10;0;0;10
16710;Gėlynas;SAULĖGRĄŽA;1363040744;Taip;0;2;1;3
16711;Gėlynas;SAULĖGRĄŽA;2018911523;Taip;20;1;0;21
16712;Gėlynas;SAULĖGRĄŽA;1431418368;Taip;0;1;0;1
16713;Gėlynas;SAULĖGRĄŽA;15277524754;Taip;4;3;0;7
16714;Gėlynas;RAMUNĖLĖ;4382465307;Taip;0;18;0;18
16715;Gėlynas;RAMUNĖLĖ;7814357385;Taip;0;7;0;7
16716;Gėlynas;RAMUNĖLĖ;8464074679;Taip;0;0;3;3
16717;Gėlynas;RAMUNĖLĖ;7562201835;Taip;0;2;0;2
16718;Gėlynas;RAMUNĖLĖ;8615943743;Taip;6;0;0;6
16719;Gėlynas;RAMUNĖLĖ;3572020585;Taip;1;0;0;1
16720;Gėlynas;RAMUNĖLĖ;1674569569;Taip;3;1;0;4
16721;Gėlynas;RAMUNĖLĖ;5695333666;Taip;6;1;0;7
16722;Gėlynas;RAMUNĖLĖ;90046802421;Taip;6;0;0;6
16723;Gėlynas;RAMUNĖLĖ;1557503831;Taip;8;0;2;10
16724;Gėlynas;RAMUNĖLĖ;2230224971;Taip;2;6;0;8
16725;Gėlynas;RAMUNĖLĖ;5395474698;Taip;13;0;0;13
16726;Gėlynas;RAMUNĖLĖ;2348787949;Taip;6;1;0;7
16727;Gėlynas;RAMUNĖLĖ;3890687425;Taip;11;0;0;11
16728;Gėlynas;RAMUNĖLĖ;5124029118;Taip;0;18;0;18
16729;Gėlynas;RAMUNĖLĖ;9026298982;Taip;5;1;0;6
16730;Gėlynas;RAMUNĖLĖ;6815740588;Taip;9;1;0;10
16731;Gėlynas;RAMUNĖLĖ;5541707540;Taip;11;0;0;11
16732;Gėlynas;ŽIBUTĖ;6898127005;Taip;7;1;0;8
16733;Gėlynas;ŽIBUTĖ;77283628988;Taip;0;6;0;6
16734;Gėlynas;ŽIBUTĖ;2417880374;Taip;10;0;7;17
16735;Gėlynas;ŽIBUTĖ;2349352560;Taip;10;0;0;10
16736;Gėlynas;ŽIBUTĖ;4445250490;Taip;8;0;0;8
16737;Gėlynas;ŽIBUTĖ;6528464599;Taip;16;0;0;16
16738;Gėlynas;ŽIBUTĖ;2906909558;Taip;11;0;0;11
16739;Gėlynas;ŽIBUTĖ;9911225363;Taip;4;1;0;5
16740;Gėlynas;ŽIBUTĖ;2400929266;Taip;7;0;0;7
16741;Gėlynas;ŽIBUTĖ;1897547388;Taip;12;0;0;12
16742;Gėlynas;ŽIBUTĖ;3365442661;Taip;6;0;10;16
16743;Gėlynas;ŽIBUTĖ;7337987259;Taip;3;2;0;5
16744;Gėlynas;ŽIBUTĖ;6042268146;Taip;0;0;3;3
16745;Gėlynas;ŽIBUTĖ;5634213306;Taip;4;0;0;4
16746;Gėlynas;ŽIBUTĖ;5320531856;Taip;2;1;0;3
16747;Gėlynas;ŽIBUTĖ;9724668402;Taip;6;0;0;6
16748;Gėlynas;ŽIBUTĖ;2520059010;Taip;16;0;0;16
16749;Obelėlė;Bildukai;43664898514;Taip;4;0;1;5
16750;Obelėlė;Bildukai;58388471530;Taip;6;0;2;8
16751;Obelėlė;Bildukai;34628612328;Taip;6;0;2;8
16752;Obelėlė;Bildukai;2024391462;Taip;7;0;0;7
16753;Obelėlė;Bildukai;15196087730;Taip;0;6;0;6
16754;Obelėlė;Bildukai;75737109657;Taip;0;6;3;9
16755;Obelėlė;Bildukai;1466324860;Taip;5;1;0;6
16756;Obelėlė;Bildukai;52857531341;Taip;9;0;0;9
16757;Obelėlė;Bildukai;68222818886;Taip;0;0;2;2
16758;Obelėlė;Bildukai;1831642058;Taip;0;8;0;8
16759;Obelėlė;Bildukai;13913516066;Taip;5;0;1;6
16760;Obelėlė;Bildukai;14986936220;Taip;0;2;0;2
16761;Obelėlė;Bildukai;88058597079;Taip;0;1;1;2
16762;Obelėlė;Bildukai;22986329944;Ne;9;0;0;9
16763;Obelėlė;Bildukai;29677456066;Taip;0;0;1;1
16764;Obelėlė;Bildukai;646883449;Taip;11;2;0;13
16765;Obelėlė;Bildukai;65936525141;Taip;0;1;0;1
16766;Obelėlė;Bildukai;1816297607;Taip;5;0;2;7
16767;Obelėlė;Bildukai;19376935875;Taip;0;0;2;2
16768;Obelėlė;Gudručiai;72489178187;Taip;4;0;0;4
16769;Obelėlė;Gudručiai;83283114997;Taip;0;7;0;7
16770;Obelėlė;Gudručiai;25763539568;Taip;0;8;0;8
16771;Obelėlė;Gudručiai;22021301000;Taip;5;0;0;5
16772;Obelėlė;Gudručiai;72425110965;Taip;5;0;0;5
16773;Obelėlė;Gudručiai;42893341690;Taip;5;0;2;7
16774;Obelėlė;Gudručiai;77857591361;Taip;0;1;0;1
16775;Obelėlė;Gudručiai;36963205388;Taip;5;1;0;6
16776;Obelėlė;Gudručiai;50335422474;Taip;0;1;1;2
16777;Obelėlė;Gudručiai;15681100220;Taip;10;1;0;11
16778;Obelėlė;Gudručiai;30827740191;Taip;0;6;0;6
16779;Obelėlė;Gudručiai;49086730989;Taip;0;21;0;21
16780;Obelėlė;Gudručiai;1425516089;Taip;0;10;2;12
16781;Obelėlė;Gudručiai;1379383341;Taip;0;1;0;1
16782;Obelėlė;Gudručiai;1582535117;Taip;0;4;0;4
16783;Obelėlė;Drugeliai;5960204860;Taip;0;5;0;5
16784;Obelėlė;Drugeliai;1874574001;Taip;11;0;0;11
16785;Obelėlė;Drugeliai;1271351257;Taip;21;0;0;21
16786;Obelėlė;Drugeliai;1980250599;Taip;0;0;6;6
16787;Obelėlė;Drugeliai;1185247095;Taip;0;0;2;2
16788;Obelėlė;Drugeliai;4111486929;Taip;3;0;1;4
16789;Obelėlė;Drugeliai;8115772385;Taip;0;0;1;1
16790;Obelėlė;Drugeliai;1248853135;Taip;8;0;0;8
16791;Obelėlė;Drugeliai;7120041402;Taip;3;0;1;4
16792;Obelėlė;Drugeliai;4404544549;Taip;6;9;1;16
16793;Obelėlė;Drugeliai;9059791812;Taip;0;0;3;3
16794;Obelėlė;Drugeliai;4835765774;Taip;0;0;2;2
16795;Obelėlė;Drugeliai;65578250853;Taip;10;0;5;15
16796;Obelėlė;Drugeliai;1044733634;Taip;0;0;2;2
16797;Obelėlė;Drugeliai;1847501295;Taip;10;0;1;11
16798;Obelėlė;Drugeliai;6006139132;Taip;6;0;0;6
16799;Obelėlė;Pasakaitė;1695933896;Taip;4;0;0;4
16800;Obelėlė;Pasakaitė;1833543299;Taip;5;0;0;5
16801;Obelėlė;Pasakaitė;1555780072;Taip;7;0;0;7
16802;Obelėlė;Pasakaitė;1543298097;Taip;4;0;0;4
16803;Obelėlė;Pasakaitė;79601449969;Taip;13;0;1;14
16804;Obelėlė;Pasakaitė;3330983614;Taip;3;1;1;5
16805;Obelėlė;Pasakaitė;4257479486;Taip;0;0;9;9
16806;Obelėlė;Pasakaitė;8394566707;Taip;6;0;0;6
16807;Obelėlė;Pasakaitė;9527363918;Taip;0;0;1;1
16808;Obelėlė;Pasakaitė;10939948244;Taip;0;0;2;2
16809;Obelėlė;Pasakaitė;1707652145;Taip;12;0;0;12
16810;Obelėlė;Pasakaitė;1141707374;Taip;5;0;1;6
16811;Obelėlė;Pasakaitė;6789881144;Taip;1;0;0;1
16812;Obelėlė;Pasakaitė;6253266504;Taip;10;0;0;10
16813;Obelėlė;Pasakaitė;9934596750;Taip;8;0;0;8
16814;Obelėlė;Pasakaitė;6036130112;Taip;0;6;3;9
16815;Obelėlė;Pasakaitė;8324404990;Taip;11;0;6;17
16816;Obelėlė;Pasakaitė;1893470952;Taip;6;0;1;7
16817;Obelėlė;Pasakaitė;7754276632;Taip;0;21;0;21
16818;Obelėlė;Svajokliai;23509261393;Taip;0;7;0;7
16819;Obelėlė;Svajokliai;6994800595;Taip;8;0;4;12
16820;Obelėlė;Svajokliai;4692022329;Taip;1;0;2;3
16821;Obelėlė;Svajokliai;7041085872;Taip;0;7;6;13
16822;Obelėlė;Svajokliai;35070707820;Taip;0;12;0;12
16823;Obelėlė;Svajokliai;97950830777;Taip;0;0;2;2
16824;Obelėlė;Svajokliai;80357143791;Taip;0;5;2;7
16825;Obelėlė;Svajokliai;97594253013;Taip;3;0;2;5
16826;Obelėlė;Svajokliai;76646326936;Taip;0;0;3;3
16827;Obelėlė;Svajokliai;17252134237;Taip;0;5;0;5
16828;Obelėlė;Svajokliai;15750481943;Taip;0;8;0;8
16829;Obelėlė;Svajokliai;67212667852;Taip;11;0;3;14
16830;Obelėlė;Svajokliai;11195901899;Taip;4;0;0;4
16831;Obelėlė;Svajokliai;64573865421;Taip;8;0;0;8
16832;Obelėlė;Svajokliai;75091826601;Taip;8;0;0;8
16833;Obelėlė;Smalsučiai;6347375324;Taip;8;0;0;8
16834;Obelėlė;Smalsučiai;1337679766;Taip;5;0;0;5
16835;Obelėlė;Smalsučiai;2107924334;Taip;0;0;4;4
16836;Obelėlė;Smalsučiai;75387550210;Taip;9;0;0;9
16837;Obelėlė;Smalsučiai;72224972200;Taip;0;1;0;1
16838;Obelėlė;Smalsučiai;72467035839;Taip;0;0;2;2
16839;Obelėlė;Smalsučiai;3220190193;Ne;0;0;9;9
16840;Obelėlė;Smalsučiai;27275867716;Taip;0;2;0;2
16841;Obelėlė;Smalsučiai;20691217408;Taip;0;0;1;1
16842;Obelėlė;Smalsučiai;35495444231;Ne;0;10;1;11
16843;Obelėlė;Smalsučiai;97298049429;Taip;0;0;2;2
16844;Obelėlė;Smalsučiai;68776273648;Taip;0;0;6;6
16845;Obelėlė;Smalsučiai;78242377913;Taip;8;2;0;10
16846;Obelėlė;Smalsučiai;2995640371;Taip;0;0;3;3
16847;Obelėlė;Smalsučiai;1758206243;Taip;0;0;14;14
16848;Obelėlė;Pabiručiai;1547195948;Taip;0;1;0;1
16849;Obelėlė;Pabiručiai;94350358246;Taip;0;0;1;1
16850;Obelėlė;Pabiručiai;74915473313;Taip;3;0;1;4
16851;Obelėlė;Pabiručiai;79388410820;Taip;0;1;0;1
16852;Obelėlė;Pabiručiai;40103909643;Taip;0;6;0;6
16853;Obelėlė;Pabiručiai;2662966388;Taip;2;0;1;3
16854;Obelėlė;Pabiručiai;2678719111;Taip;2;0;2;4
16855;Obelėlė;Pabiručiai;1420633482;Taip;2;0;0;2
16856;Obelėlė;Pabiručiai;1698995389;Taip;5;0;1;6
16857;Obelėlė;Pabiručiai;31018018065;Taip;5;0;2;7
16858;Obelėlė;Pabiručiai;2015165566;Taip;0;0;1;1
16859;Obelėlė;Pabiručiai;16430825029;Taip;0;8;0;8
16860;Obelėlė;Pabiručiai;8882103124;Taip;1;0;3;4
16861;Obelėlė;Pabiručiai;5471194804;Taip;4;0;1;5
16862;Obelėlė;Pabiručiai;69055416041;Taip;0;8;0;8
16863;Obelėlė;Pabiručiai;1576498450;Taip;5;0;0;5
16864;Obelėlė;Pabiručiai;74455701543;Taip;10;0;1;11
16865;Obelėlė;Strakaliukai;7647724926;Taip;11;0;0;11
16866;Obelėlė;Strakaliukai;2105005710;Taip;0;0;1;1
16867;Obelėlė;Strakaliukai;5512990125;Taip;2;0;1;3
16868;Obelėlė;Strakaliukai;1210385417;Taip;2;0;0;2
16869;Obelėlė;Strakaliukai;1536889615;Taip;16;0;1;17
16870;Obelėlė;Strakaliukai;1670594471;Taip;0;3;0;3
16871;Obelėlė;Strakaliukai;1770448857;Taip;6;0;1;7
16872;Obelėlė;Strakaliukai;1484822838;Taip;0;0;1;1
16873;Obelėlė;Strakaliukai;82119081040;Taip;1;0;6;7
16874;Obelėlė;Strakaliukai;8202131299;Taip;14;0;2;16
16875;Obelėlė;Strakaliukai;49378314043;Taip;0;6;0;6
16876;Obelėlė;Strakaliukai;57788788343;Taip;0;7;0;7
16877;Obelėlė;Strakaliukai;1824412493;Taip;3;13;0;16
16878;Obelėlė;Strakaliukai;31721462678;Taip;4;0;1;5
16879;Obelėlė;Strakaliukai;52277220462;Taip;0;0;5;5
16880;Obelėlė;Strakaliukai;74564453474;Taip;6;0;4;10
16881;Obelėlė;Strakaliukai;8904956649;Taip;0;0;4;4
16882;Obelėlė;Saulutė;98290583667;Taip;13;0;0;13
16883;Obelėlė;Saulutė;77954383604;Taip;2;0;1;3
16884;Obelėlė;Saulutė;1826138505;Taip;2;0;2;4
16885;Obelėlė;Saulutė;1987783063;Taip;2;0;0;2
16886;Obelėlė;Saulutė;38968623613;Taip;2;0;1;3
16887;Obelėlė;Saulutė;1741425229;Taip;0;0;3;3
16888;Obelėlė;Saulutė;1336592238;Taip;6;0;0;6
16889;Obelėlė;Saulutė;1240673124;Taip;2;0;0;2
16890;Obelėlė;Saulutė;24010838180;Taip;0;8;0;8
16891;Obelėlė;Saulutė;1935023634;Taip;2;0;3;5
16892;Obelėlė;Saulutė;1061262980;Taip;0;0;4;4
16893;Obelėlė;Saulutė;2099500866;Taip;8;2;0;10
16894;Obelėlė;Saulutė;1352415596;Ne;0;0;3;3
16895;Obelėlė;Saulutė;6054898307;Taip;10;1;0;11
16896;Obelėlė;Saulutė;3076493150;Taip;5;0;2;7
16897;Obelėlė;Saulutė;1521926754;Taip;0;0;11;11
16898;Obelėlė;Saulutė;6720229368;Ne;13;0;2;15
16899;Obelėlė;Saulutė;1601102808;Taip;2;0;0;2
16900;Obelėlė;Saulutė;1021948127;Taip;10;0;0;10
16901;Obelėlė;Rieduliukai;8173307704;Taip;0;21;0;21
16902;Obelėlė;Rieduliukai;1706102918;Taip;12;1;5;18
16903;Obelėlė;Rieduliukai;8682794598;Taip;5;0;3;8
16904;Obelėlė;Rieduliukai;8754552660;Taip;7;4;3;14
16905;Obelėlė;Rieduliukai;8092024850;Taip;10;0;0;10
16906;Obelėlė;Rieduliukai;9716500560;Taip;8;0;0;8
16907;Obelėlė;Rieduliukai;3604960887;Taip;5;6;0;11
16908;Obelėlė;Rieduliukai;4251418414;Taip;0;1;3;4
16909;Obelėlė;Rieduliukai;7128421330;Taip;0;0;5;5
16910;Obelėlė;Rieduliukai;5943314566;Taip;0;21;0;21
16911;Obelėlė;Rieduliukai;6364101139;Taip;6;0;0;6
16912;Obelėlė;Rieduliukai;6691540418;Taip;20;0;0;20
16913;Obelėlė;Rieduliukai;5326258755;Taip;0;13;0;13
16914;Obelėlė;Rieduliukai;2770477678;Taip;0;1;1;2
16915;Obelėlė;Žirniukai;2014314139;Taip;4;0;0;4
16916;Obelėlė;Žirniukai;9900484892;Taip;11;10;0;21
16917;Obelėlė;Žirniukai;6145113624;Taip;7;0;0;7
16918;Obelėlė;Žirniukai;9586720282;Taip;0;21;0;21
16919;Obelėlė;Žirniukai;9567704282;Taip;5;0;0;5
16920;Obelėlė;Žirniukai;8231489868;Taip;5;0;1;6
16921;Obelėlė;Žirniukai;9305279614;Taip;3;1;1;5
16922;Obelėlė;Žirniukai;4995817505;Taip;10;0;0;10
16923;Obelėlė;Žirniukai;4015702815;Taip;2;1;0;3
16924;Obelėlė;Žirniukai;4309139638;Taip;13;0;0;13
16925;Obelėlė;Žirniukai;9736557012;Taip;0;21;0;21
16926;Obelėlė;Žirniukai;6720058972;Taip;7;0;0;7
16927;Obelėlė;Žirniukai;5141585309;Taip;0;0;7;7
16928;Obelėlė;Bičiuliai;9031690002;Taip;5;0;2;7
16929;Obelėlė;Bičiuliai;3425736276;Taip;7;0;0;7
16930;Obelėlė;Bičiuliai;1507072248;Taip;16;0;0;16
16931;Obelėlė;Bičiuliai;5776116844;Taip;5;1;1;7
16932;Obelėlė;Bičiuliai;8487088625;Taip;12;0;0;12
16933;Obelėlė;Bičiuliai;1630067014;Taip;0;7;0;7
16934;Obelėlė;Bičiuliai;1537769810;Taip;6;0;0;6
16935;Obelėlė;Bičiuliai;8371648703;Taip;8;0;1;9
16936;Obelėlė;Bičiuliai;3517342646;Taip;0;0;2;2
16937;Obelėlė;Bičiuliai;8757731600;Taip;0;14;2;16
16938;Obelėlė;Bičiuliai;1419189517;Taip;21;0;0;21
16939;Obelėlė;Bičiuliai;5933910526;Taip;3;0;2;5
16940;Obelėlė;Bičiuliai;4220808775;Taip;7;0;1;8
16941;Obelėlė;Bičiuliai;8155712451;Taip;0;0;2;2
16942;Obelėlė;Bičiuliai;7934760271;Taip;6;0;9;15
16943;Obelėlė;Bičiuliai;4849175527;Taip;3;0;1;4
16944;Obelėlė;Bičiuliai;9805481603;Taip;9;0;0;9
16945;Spygliukas;Bitutės;49406606185;Taip;0;12;3;15
16946;Spygliukas;Bitutės;97773415559;Taip;2;5;0;7
16947;Spygliukas;Bitutės;48097650803;Taip;10;1;0;11
16948;Spygliukas;Bitutės;68487983068;Taip;0;0;3;3
16949;Spygliukas;Bitutės;47077562116;Taip;9;0;0;9
16950;Spygliukas;Bitutės;56991221970;Taip;10;1;0;11
16951;Spygliukas;Bitutės;45296663285;Taip;1;0;0;1
16952;Spygliukas;Bitutės;21074122407;Taip;2;2;0;4
16953;Spygliukas;Bitutės;12711940653;Taip;9;0;0;9
16954;Spygliukas;Bitutės;26697357569;Taip;8;3;0;11
16955;Spygliukas;Bitutės;77970187363;Taip;0;1;1;2
16956;Spygliukas;Bitutės;7829656569;Taip;11;0;0;11
16957;Spygliukas;Bitutės;94937084882;Ne;0;0;1;1
16958;Spygliukas;Bitutės;1076152986;Taip;8;0;1;9
16959;Spygliukas;Bitutės;1122973994;Taip;6;0;0;6
16960;Spygliukas;Bitutės;1341415412;Taip;7;0;1;8
16961;Spygliukas;Bitutės;1227595604;Ne;6;3;0;9
16962;Spygliukas;Bitutės;1971162865;Taip;17;0;0;17
16963;Spygliukas;Bitutės;7020789651;Taip;0;1;0;1
16964;Spygliukas;Kiškučiai;9001243644;Taip;16;0;0;16
16965;Spygliukas;Kiškučiai;2058015313;Taip;4;0;2;6
16966;Spygliukas;Kiškučiai;2980459339;Taip;12;0;0;12
16967;Spygliukas;Kiškučiai;4430242310;Taip;3;1;0;4
16968;Spygliukas;Kiškučiai;7250958367;Taip;11;0;0;11
16969;Spygliukas;Kiškučiai;9392554576;Taip;5;1;0;6
16970;Spygliukas;Kiškučiai;8646122773;Taip;17;0;0;17
16971;Spygliukas;Kiškučiai;1940209166;Taip;4;0;3;7
16972;Spygliukas;Kiškučiai;2935281062;Taip;12;0;0;12
16973;Spygliukas;Kiškučiai;8048474808;Taip;5;0;1;6
16974;Spygliukas;Kiškučiai;1679263120;Taip;9;4;0;13
16975;Spygliukas;Kiškučiai;5022615426;Taip;5;0;0;5
16976;Spygliukas;Kiškučiai;4933577424;Taip;0;1;2;3
16977;Spygliukas;Kiškučiai;1855897974;Taip;0;0;2;2
16978;Spygliukas;Kiškučiai;1228469923;Taip;0;7;0;7
16979;Spygliukas;Kiškučiai;8103481313;Taip;6;0;8;14
16980;Spygliukas;Kiškučiai;8992822256;Taip;9;1;0;10
16981;Spygliukas;Kiškučiai;7421000718;Taip;15;0;0;15
16982;Spygliukas;Boružėlės;1939828587;Taip;0;0;2;2
16983;Spygliukas;Boružėlės;1238940921;Taip;14;1;0;15
16984;Spygliukas;Boružėlės;93029375520;Taip;0;1;0;1
16985;Spygliukas;Boružėlės;1163722642;Taip;3;0;0;3
16986;Spygliukas;Boružėlės;9288806012;Taip;0;1;0;1
16987;Spygliukas;Boružėlės;1151844475;Taip;0;1;0;1
16988;Spygliukas;Boružėlės;4104158994;Taip;11;0;1;12
16989;Spygliukas;Boružėlės;10858715103;Taip;0;5;0;5
16990;Spygliukas;Boružėlės;1002603766;Taip;2;5;0;7
16991;Spygliukas;Boružėlės;34209607173;Taip;1;0;0;1
16992;Spygliukas;Boružėlės;1842315404;Taip;7;0;0;7
16993;Spygliukas;Boružėlės;73047963456;Taip;7;0;1;8
16994;Spygliukas;Boružėlės;7114613140;Taip;3;1;0;4
16995;Spygliukas;Boružėlės;92279064240;Taip;3;4;0;7
16996;Spygliukas;Boružėlės;1323720621;Taip;0;1;0;1
16997;Spygliukas;Boružėlės;30201229961;Taip;0;1;3;4
16998;Spygliukas;Boružėlės;79584454527;Taip;0;1;0;1
16999;Spygliukas;Boružėlės;47977103711;Taip;0;0;6;6
17000;Spygliukas;Boružėlės;1321926079;Taip;1;0;2;3
17001;Spygliukas;Boružėlės;9513387087;Ne;6;1;6;13
17002;Spygliukas;Boružėlės;1193015656;Taip;13;0;0;13
17003;Spygliukas;Ežiukai;1832756255;Taip;3;1;0;4
17004;Spygliukas;Ežiukai;9593700812;Taip;8;0;1;9
17005;Spygliukas;Ežiukai;2126162527;Taip;6;1;0;7
17006;Spygliukas;Ežiukai;1260920726;Taip;16;0;0;16
17007;Spygliukas;Ežiukai;42285404110;Taip;20;0;0;20
17008;Spygliukas;Ežiukai;2040903312;Taip;18;1;0;19
17009;Spygliukas;Ežiukai;3037648954;Taip;0;1;2;3
17010;Spygliukas;Ežiukai;1211969263;Taip;16;1;0;17
17011;Spygliukas;Ežiukai;7219659640;Taip;0;2;1;3
17012;Spygliukas;Ežiukai;1881745347;Taip;0;3;0;3
17013;Spygliukas;Ežiukai;53324066837;Ne;5;1;0;6
17014;Spygliukas;Ežiukai;9957292202;Taip;16;0;0;16
17015;Spygliukas;Ežiukai;1298381738;Taip;13;0;0;13
17016;Spygliukas;Ežiukai;7649832094;Taip;16;1;0;17
17017;Spygliukas;Ežiukai;5780485510;Taip;0;0;4;4
17018;Spygliukas;Ežiukai;8686118262;Taip;5;0;0;5
17019;Spygliukas;Ežiukai;5253108181;Taip;14;0;0;14
17020;Spygliukas;Ežiukai;3785469286;Taip;0;0;3;3
17021;Spygliukas;Ežiukai;29015391754;Taip;10;1;0;11
17022;Spygliukas;Ežiukai;84556142803;Taip;7;2;0;9
17023;Spygliukas;Geniukai;42786380899;Taip;0;1;0;1
17024;Spygliukas;Geniukai;52719709314;Taip;4;0;0;4
17025;Spygliukas;Geniukai;20248450562;Ne;5;1;0;6
17026;Spygliukas;Geniukai;35839138942;Taip;0;7;0;7
17027;Spygliukas;Geniukai;45881077771;Taip;0;12;0;12
17028;Spygliukas;Geniukai;28639466275;Taip;0;0;3;3
17029;Spygliukas;Geniukai;15887839786;Taip;10;0;0;10
17030;Spygliukas;Geniukai;90555084491;Taip;0;2;0;2
17031;Spygliukas;Geniukai;80768950728;Ne;0;3;0;3
17032;Spygliukas;Geniukai;38040423877;Taip;0;4;0;4
17033;Spygliukas;Geniukai;91727550789;Taip;0;1;0;1
17034;Spygliukas;Geniukai;1482370515;Taip;9;3;0;12
17035;Spygliukas;Geniukai;1908975286;Taip;0;1;2;3
17036;Spygliukas;Geniukai;1012592509;Taip;3;2;0;5
17037;Spygliukas;Geniukai;1847162482;Taip;15;0;1;16
17038;Spygliukas;Geniukai;1398592801;Taip;18;0;0;18
17039;Spygliukas;Riešutėliai;88173456147;Taip;0;6;0;6
17040;Spygliukas;Riešutėliai;72370650994;Taip;0;6;0;6
17041;Spygliukas;Riešutėliai;29046559255;Taip;0;1;2;3
17042;Spygliukas;Riešutėliai;76913033601;Taip;0;1;0;1
17043;Spygliukas;Riešutėliai;15330844181;Taip;0;2;0;2
17044;Spygliukas;Riešutėliai;42616212;Taip;11;0;0;11
17045;Spygliukas;Riešutėliai;80514549747;Taip;0;1;1;2
17046;Spygliukas;Riešutėliai;60381587208;Taip;0;1;4;5
17047;Spygliukas;Riešutėliai;40730123107;Taip;0;1;0;1
17048;Spygliukas;Riešutėliai;86636385350;Taip;3;0;2;5
17049;Spygliukas;Riešutėliai;14061921481;Taip;0;0;1;1
17050;Spygliukas;Riešutėliai;73975304558;Taip;5;0;0;5
17051;Spygliukas;Riešutėliai;77665543739;Taip;0;1;2;3
17052;Spygliukas;Riešutėliai;1580382515;Taip;0;10;0;10
17053;Spygliukas;Riešutėliai;4219250715;Taip;18;0;1;19
17054;Spygliukas;Riešutėliai;1429385840;Taip;4;4;0;8
17055;Spygliukas;Pelėdžiukai;91102341053;Taip;11;1;0;12
17056;Spygliukas;Pelėdžiukai;6104639970;Taip;1;0;0;1
17057;Spygliukas;Pelėdžiukai;85751149838;Taip;1;1;1;3
17058;Spygliukas;Pelėdžiukai;17541702082;Ne;0;3;0;3
17059;Spygliukas;Pelėdžiukai;20304216159;Taip;0;1;0;1
17060;Spygliukas;Pelėdžiukai;78680910249;Taip;0;1;0;1
17061;Spygliukas;Pelėdžiukai;88974807409;Taip;0;0;2;2
17062;Spygliukas;Pelėdžiukai;66170193369;Ne;0;1;4;5
17063;Spygliukas;Pelėdžiukai;33559493599;Taip;8;0;2;10
17064;Spygliukas;Pelėdžiukai;41129167567;Taip;0;2;0;2
17065;Spygliukas;Pelėdžiukai;54932584770;Taip;1;3;0;4
17066;Spygliukas;Pelėdžiukai;71499872240;Taip;1;0;2;3
17067;Spygliukas;Pelėdžiukai;31918025260;Taip;5;6;0;11
17068;Spygliukas;Pelėdžiukai;57098709793;Taip;0;15;0;15
17069;Spygliukas;Pelėdžiukai;96967766273;Taip;0;1;0;1
17070;Spygliukas;Pelėdžiukai;1447408559;Taip;0;5;0;5
17071;Spygliukas;Pelėdžiukai;63899991046;Taip;0;6;0;6
17072;Spygliukas;Pelėdžiukai;8252228033;Taip;0;1;1;2
17073;Spygliukas;Pelėdžiukai;67896776952;Taip;0;6;0;6
17074;Spygliukas;Zylutės;6242194100;Taip;0;0;1;1
17075;Spygliukas;Zylutės;5962360012;Taip;2;0;2;4
17076;Spygliukas;Zylutės;2739564216;Taip;16;0;0;16
17077;Spygliukas;Zylutės;4721066953;Taip;0;0;5;5
17078;Spygliukas;Zylutės;2463585133;Taip;4;0;0;4
17079;Spygliukas;Zylutės;7900652746;Taip;7;0;1;8
17080;Spygliukas;Zylutės;4949371837;Taip;11;0;0;11
17081;Spygliukas;Zylutės;6457632191;Taip;13;1;0;14
17082;Spygliukas;Zylutės;4650693672;Taip;6;0;4;10
17083;Spygliukas;Zylutės;9178184431;Taip;5;0;0;5
17084;Spygliukas;Zylutės;1691209405;Taip;9;0;0;9
17085;Spygliukas;Zylutės;4577592862;Taip;9;0;1;10
17086;Spygliukas;Zylutės;4610504338;Taip;1;0;0;1
17087;Spygliukas;Zylutės;6835488489;Taip;0;0;1;1
17088;Spygliukas;Zylutės;3365209400;Taip;4;0;7;11
17089;Spygliukas;Zylutės;3658613027;Ne;5;0;2;7
17090;Spygliukas;Skruzdėliukai;2177856916;Taip;10;0;1;11
17091;Spygliukas;Skruzdėliukai;8825264090;Taip;0;2;3;5
17092;Spygliukas;Skruzdėliukai;8404929784;Taip;11;0;0;11
17093;Spygliukas;Skruzdėliukai;6931145017;Taip;11;0;1;12
17094;Spygliukas;Skruzdėliukai;3041184642;Taip;5;1;1;7
17095;Spygliukas;Skruzdėliukai;9070219319;Taip;0;7;0;7
17096;Spygliukas;Skruzdėliukai;9285259322;Taip;5;1;1;7
17097;Spygliukas;Skruzdėliukai;8806126755;Taip;13;0;1;14
17098;Spygliukas;Skruzdėliukai;8476882854;Taip;21;0;0;21
17099;Spygliukas;Skruzdėliukai;4245624629;Taip;6;0;2;8
17100;Spygliukas;Skruzdėliukai;6332646009;Taip;6;0;0;6
17101;Spygliukas;Skruzdėliukai;3706443395;Taip;0;1;1;2
17102;Spygliukas;Skruzdėliukai;9112172144;Taip;10;0;2;12
17103;Spygliukas;Skruzdėliukai;2395961015;Taip;11;0;0;11
17104;Spygliukas;Voveraitės;5049529300;Taip;16;0;0;16
17105;Spygliukas;Voveraitės;1987926577;Taip;0;0;1;1
17106;Spygliukas;Voveraitės;1367964100;Taip;0;9;1;10
17107;Spygliukas;Voveraitės;1773639994;Taip;16;0;0;16
17108;Spygliukas;Voveraitės;2066739772;Taip;5;0;2;7
17109;Spygliukas;Voveraitės;8596667547;Taip;6;0;4;10
17110;Spygliukas;Voveraitės;1042495269;Taip;7;0;1;8
17111;Spygliukas;Voveraitės;1590677993;Taip;5;0;14;19
17112;Spygliukas;Voveraitės;1030973848;Taip;5;0;1;6
17113;Spygliukas;Voveraitės;1935233612;Taip;0;7;0;7
17114;Spygliukas;Voveraitės;8801225066;Taip;6;0;2;8
17115;Spygliukas;Voveraitės;8453683673;Ne;1;0;2;3
17116;Spygliukas;Voveraitės;4653108810;Taip;4;7;0;11
17117;Spygliukas;Voveraitės;1045253540;Taip;15;0;0;15
17118;Spygliukas;Voveraitės;2671842885;Taip;0;1;0;1
17119;Spygliukas;Voveraitės;6460911796;Taip;6;0;1;7
17120;Spygliukas;Giliukų;7271659513;Taip;5;6;0;11
17121;Spygliukas;Giliukų;8708083787;Taip;10;5;0;15
17122;Spygliukas;Giliukų;9413950200;Taip;10;7;0;17
17123;Spygliukas;Giliukų;1664878188;Taip;8;0;0;8
17124;Spygliukas;Giliukų;8604767396;Taip;0;5;5;10
17125;Spygliukas;Giliukų;4634660174;Taip;4;5;1;10
17126;Spygliukas;Giliukų;4368224847;Taip;12;0;0;12
17127;Spygliukas;Giliukų;1333556956;Taip;5;0;2;7
17128;Spygliukas;Giliukų;9316731983;Taip;11;0;2;13
17129;Spygliukas;Giliukų;5012876830;Taip;11;0;2;13
17130;Spygliukas;Giliukų;2315421636;Taip;11;0;0;11
17131;Spygliukas;Giliukų;7125425492;Taip;5;1;5;11
17132;Spygliukas;Giliukų;7928675053;Taip;10;0;0;10
17133;Spygliukas;Giliukų;1974541155;Taip;0;0;7;7
17134;Spygliukas;Giliukų;4505044604;Taip;6;0;0;6
17135;Spygliukas;Giliukų;2989701249;Taip;18;0;0;18
17136;Vieversys;Žirniukai;1149316471;Taip;0;1;0;1
17137;Vieversys;Žirniukai;1728554204;Taip;0;1;0;1
17138;Vieversys;Žirniukai;9612415733;Taip;0;2;0;2
17139;Vieversys;Žirniukai;5917328379;Taip;21;0;0;21
17140;Vieversys;Žirniukai;82594887399;Taip;0;1;0;1
17141;Vieversys;Žirniukai;7500147648;Taip;2;2;0;4
17142;Vieversys;Žirniukai;2621046003;Taip;16;0;1;17
17143;Vieversys;Žirniukai;9835682858;Taip;0;9;0;9
17144;Vieversys;Žirniukai;6596979763;Taip;0;6;0;6
17145;Vieversys;Žirniukai;5286521728;Taip;0;14;0;14
17146;Vieversys;Žirniukai;6720355390;Taip;0;0;1;1
17147;Vieversys;Žirniukai;4313822180;Taip;0;2;0;2
17148;Vieversys;Žirniukai;7812227428;Taip;0;1;0;1
17149;Vieversys;Žirniukai;4455039401;Taip;0;4;0;4
17150;Vieversys;Žirniukai;5810605263;Taip;0;0;2;2
17151;Vieversys;Varpelių;38299255111;Taip;0;15;0;15
17152;Vieversys;Varpelių;62353706235;Taip;0;6;0;6
17153;Vieversys;Varpelių;45357053527;Taip;0;8;0;8
17154;Vieversys;Varpelių;44390886220;Taip;0;10;0;10
17155;Vieversys;Varpelių;46546501255;Taip;0;1;0;1
17156;Vieversys;Varpelių;34243919860;Taip;0;1;0;1
17157;Vieversys;Varpelių;75611111703;Taip;0;2;0;2
17158;Vieversys;Varpelių;7125531057;Taip;5;1;0;6
17159;Vieversys;Varpelių;47592438021;Taip;0;1;0;1
17160;Vieversys;Varpelių;99472642769;Taip;0;2;0;2
17161;Vieversys;Varpelių;69205152313;Taip;6;1;0;7
17162;Vieversys;Varpelių;24253818919;Taip;0;5;0;5
17163;Vieversys;Varpelių;12049674063;Taip;0;1;0;1
17164;Vieversys;Kiškučių;30327960835;Taip;0;2;0;2
17165;Vieversys;Kiškučių;39075572706;Taip;0;1;0;1
17166;Vieversys;Kiškučių;96715131735;Taip;0;2;0;2
17167;Vieversys;Kiškučių;64744067804;Taip;0;4;0;4
17168;Vieversys;Kiškučių;14962042306;Taip;0;6;0;6
17169;Vieversys;Kiškučių;66729897399;Taip;0;3;2;5
17170;Vieversys;Kiškučių;1718832864;Taip;0;1;0;1
17171;Vieversys;Kiškučių;1013523504;Taip;0;1;0;1
17172;Vieversys;Kiškučių;2880573300;Taip;0;8;0;8
17173;Vieversys;Kiškučių;27461921981;Taip;0;4;0;4
17174;Vieversys;Kiškučių;1239896208;Taip;0;5;0;5
17175;Vieversys;Kiškučių;1076420513;Taip;0;1;2;3
17176;Vieversys;Kiškučių;9869051482;Taip;0;2;0;2
17177;Vieversys;Kiškučių;1685871173;Taip;0;3;3;6
17178;Vieversys;Kiškučių;6589649248;Taip;0;4;0;4
17179;Vieversys;Kiškučių;6241670100;Taip;2;1;0;3
17180;Vieversys;Kiškučių;9050145547;Taip;5;0;0;5
17181;Vieversys;Kiškučių;9126904852;Taip;16;0;0;16
17182;Vieversys;Kiškučių;70851901929;Taip;4;3;0;7
17183;Vieversys;Kiškučių;81372830000;Taip;0;1;0;1
17184;Vieversys;Kiškučių;55017305306;Taip;0;1;0;1
17185;Vieversys;Kiškučių;7445136223;Taip;0;1;0;1
17186;Vieversys;Pelėdžiukų;8421719030;Taip;6;0;0;6
17187;Vieversys;Pelėdžiukų;77272293257;Taip;5;0;0;5
17188;Vieversys;Pelėdžiukų;94463134058;Taip;5;5;0;10
17189;Vieversys;Pelėdžiukų;5434952733;Taip;7;1;0;8
17190;Vieversys;Pelėdžiukų;7578552471;Taip;15;0;0;15
17191;Vieversys;Pelėdžiukų;2193074123;Taip;16;0;0;16
17192;Vieversys;Pelėdžiukų;6314183312;Taip;3;17;0;20
17193;Vieversys;Pelėdžiukų;7007620994;Taip;0;2;3;5
17194;Vieversys;Pelėdžiukų;9499315463;Taip;10;1;0;11
17195;Vieversys;Pelėdžiukų;9774365819;Taip;5;6;0;11
17196;Vieversys;Pelėdžiukų;2521488728;Taip;10;0;1;11
17197;Vieversys;Pelėdžiukų;6473759470;Taip;6;2;0;8
17198;Vieversys;Pelėdžiukų;1120594293;Taip;0;1;3;4
17199;Vieversys;Pelėdžiukų;1273951001;Taip;0;0;5;5
17200;Vieversys;Pelėdžiukų;48430863473;Taip;11;3;0;14
17201;Vieversys;Pelėdžiukų;50181034746;Taip;6;0;1;7
17202;Vieversys;Pelėdžiukų;52420072025;Taip;7;0;0;7
17203;Vieversys;Pelėdžiukų;1338476746;Taip;0;1;0;1
17204;Vieversys;Pelėdžiukų;1027693153;Taip;2;0;0;2
17205;Vieversys;Pelėdžiukų;5871715452;Taip;0;0;1;1
17206;Vieversys;Pelėdžiukų;7676796264;Taip;0;3;0;3
17207;Vieversys;Pelėdžiukų;9659337657;Taip;10;1;0;11
17208;Vieversys;Pelėdžiukų;3458399180;Taip;8;9;0;17
17209;Vieversys;Saulučių;1541501314;Taip;0;7;0;7
17210;Vieversys;Saulučių;7570842283;Taip;0;6;0;6
17211;Vieversys;Saulučių;77521284935;Ne;0;1;0;1
17212;Vieversys;Saulučių;61390281978;Taip;0;0;2;2
17213;Vieversys;Saulučių;8356022906;Taip;8;0;0;8
17214;Vieversys;Saulučių;1061337795;Taip;10;0;0;10
17215;Vieversys;Saulučių;9504543902;Taip;21;0;0;21
17216;Vieversys;Saulučių;1015724611;Taip;21;0;0;21
17217;Vieversys;Saulučių;85223909900;Taip;5;11;0;16
17218;Vieversys;Saulučių;63958110408;Ne;0;12;0;12
17219;Vieversys;Saulučių;27991039593;Taip;5;2;0;7
17220;Vieversys;Saulučių;53189421149;Taip;7;0;0;7
17221;Vieversys;Saulučių;49209207608;Taip;0;1;0;1
17222;Vieversys;Saulučių;94076718641;Taip;0;5;0;5
17223;Vieversys;Saulučių;97077298066;Taip;3;0;0;3
17224;Vieversys;Saulučių;99897529822;Taip;0;1;0;1
17225;Vieversys;Saulučių;95352162960;Taip;0;2;0;2
17226;Vieversys;Saulučių;81494754248;Taip;7;2;5;14
17227;Vieversys;Saulučių;12419984038;Taip;0;2;5;7
17228;Vieversys;Saulučių;18608150261;Taip;0;4;0;4
17229;Vieversys;Saulučių;81766053731;Taip;4;0;0;4
17230;Vieversys;Saulučių;67610801335;Taip;0;0;3;3
17231;Vieversys;Kregždučių;55553505459;Taip;0;5;0;5
17232;Vieversys;Kregždučių;16002848795;Taip;0;5;0;5
17233;Vieversys;Kregždučių;1933907389;Taip;0;1;1;2
17234;Vieversys;Kregždučių;1462608187;Taip;4;0;0;4
17235;Vieversys;Kregždučių;44086673096;Taip;0;1;0;1
17236;Vieversys;Kregždučių;89223502405;Taip;10;1;0;11
17237;Vieversys;Kregždučių;41215224179;Taip;0;2;9;11
17238;Vieversys;Kregždučių;938801303;Taip;0;1;0;1
17239;Vieversys;Kregždučių;62465517391;Taip;0;1;0;1
17240;Vieversys;Kregždučių;5123994167;Taip;5;0;2;7
17241;Vieversys;Kregždučių;12524976076;Taip;0;5;0;5
17242;Vieversys;Kregždučių;1300013110;Taip;0;1;0;1
17243;Vieversys;Kregždučių;61101237391;Taip;0;5;0;5
17244;Vieversys;Kregždučių;1716198618;Taip;0;4;0;4
17245;Vieversys;Kregždučių;8213134622;Taip;2;16;0;18
17246;Vieversys;Kregždučių;2879546284;Taip;0;0;1;1
17247;Vieversys;Kregždučių;3839507103;Taip;0;1;0;1
17248;Vieversys;Kregždučių;6077365803;Taip;0;0;1;1
17249;Vieversys;Kregždučių;46624143347;Taip;3;0;0;3
17250;Vieversys;Kregždučių;73657188876;Taip;3;0;0;3
17251;Vieversys;Boružėlių;6236703869;Taip;2;0;0;2
17252;Vieversys;Boružėlių;6116471730;Taip;1;1;0;2
17253;Vieversys;Boružėlių;20960056744;Taip;5;0;4;9
17254;Vieversys;Boružėlių;95472887427;Taip;0;1;0;1
17255;Vieversys;Boružėlių;63262366859;Taip;6;2;5;13
17256;Vieversys;Boružėlių;58287759954;Taip;6;0;0;6
17257;Vieversys;Boružėlių;1580917200;Taip;8;6;0;14
17258;Vieversys;Boružėlių;86213464121;Taip;2;1;0;3
17259;Vieversys;Boružėlių;55764266970;Taip;11;7;0;18
17260;Vieversys;Boružėlių;1588939300;Taip;0;0;1;1
17261;Vieversys;Boružėlių;86119860485;Taip;4;1;0;5
17262;Vieversys;Boružėlių;1028950997;Taip;21;0;0;21
17263;Vieversys;Boružėlių;14574836082;Taip;0;1;0;1
17264;Vieversys;Boružėlių;95886969053;Taip;7;1;0;8
17265;Vieversys;Boružėlių;95891054066;Taip;4;1;0;5
17266;Vieversys;Boružėlių;5197639355;Taip;9;0;2;11
17267;Vieversys;Boružėlių;8744701209;Taip;0;11;0;11
17268;Vieversys;Boružėlių;50192413803;Taip;4;0;0;4
17269;Vieversys;Boružėlių;1700010494;Taip;0;9;0;9
17270;Vieversys;Boružėlių;1715902540;Taip;0;6;0;6
17271;Vieversys;Bitučių;75434941104;Taip;5;7;0;12
17272;Vieversys;Bitučių;25198979253;Taip;4;2;0;6
17273;Vieversys;Bitučių;2034386236;Taip;1;19;0;20
17274;Vieversys;Bitučių;83420473111;Taip;0;6;0;6
17275;Vieversys;Bitučių;22717987850;Taip;11;0;0;11
17276;Vieversys;Bitučių;26092685300;Taip;11;5;0;16
17277;Vieversys;Bitučių;93582609868;Taip;10;1;0;11
17278;Vieversys;Bitučių;22275121492;Taip;0;7;0;7
17279;Vieversys;Bitučių;34494816770;Taip;5;0;0;5
17280;Vieversys;Bitučių;27123496741;Taip;10;2;0;12
17281;Vieversys;Bitučių;63139698249;Taip;0;9;0;9
17282;Vieversys;Bitučių;66155667200;Taip;5;1;0;6
17283;Vieversys;Bitučių;68374560306;Taip;0;0;1;1
17284;Vieversys;Bitučių;78901148667;Taip;10;1;0;11
17285;Vieversys;Bitučių;7126970560;Taip;0;3;0;3
17286;Vieversys;Bitučių;5157022077;Taip;0;0;1;1
17287;Vieversys;Bitučių;1371669237;Taip;0;6;0;6
17288;Vieversys;Smalsučių;1307701524;Taip;1;7;0;8
17289;Vieversys;Smalsučių;89564962534;Taip;5;0;2;7
17290;Vieversys;Smalsučių;8966153890;Taip;5;0;0;5
17291;Vieversys;Smalsučių;65696183376;Taip;0;9;0;9
17292;Vieversys;Smalsučių;50929651251;Taip;0;3;0;3
17293;Vieversys;Smalsučių;65625227882;Taip;0;3;0;3
17294;Vieversys;Smalsučių;29002693436;Taip;0;0;4;4
17295;Vieversys;Smalsučių;84134333980;Taip;0;0;9;9
17296;Vieversys;Smalsučių;9980447111;Taip;0;2;0;2
17297;Vieversys;Smalsučių;41282339758;Taip;0;7;0;7
17298;Vieversys;Smalsučių;2733479642;Taip;0;1;0;1
17299;Vieversys;Smalsučių;25843076066;Taip;3;0;0;3
17300;Vieversys;Smalsučių;72475350152;Taip;0;3;0;3
17301;Vieversys;Smalsučių;61074394922;Taip;1;0;0;1
17302;Vieversys;Smalsučių;11528430680;Taip;3;1;0;4
17303;Vieversys;Smalsučių;67471794738;Taip;3;3;0;6
17304;Vieversys;Smalsučių;13768739410;Taip;0;1;0;1
17305;Vieversys;Smalsučių;45707453869;Taip;3;0;0;3
17306;Vieversys;Smalsučių;79197759451;Taip;7;12;0;19
17307;Vieversys;Smalsučių;6427430220;Taip;10;1;10;21
17308;Vieversys;Smalsučių;2010825247;Taip;17;3;0;20
17309;Vieversys;Smalsučių;2561825171;Taip;0;0;2;2
17310;Vieversys;Smalsučių;1025794194;Taip;10;0;0;10
17311;Vieversys;Kodėlčiukų;2006826758;Taip;2;0;0;2
17312;Vieversys;Kodėlčiukų;3907748584;Taip;6;0;0;6
17313;Vieversys;Kodėlčiukų;16928192553;Taip;0;12;0;12
17314;Vieversys;Kodėlčiukų;2756075736;Taip;7;0;0;7
17315;Vieversys;Kodėlčiukų;69275621813;Taip;6;12;0;18
17316;Vieversys;Kodėlčiukų;1455615413;Taip;15;0;1;16
17317;Vieversys;Kodėlčiukų;1970088958;Taip;15;1;0;16
17318;Vieversys;Kodėlčiukų;1586720551;Taip;1;0;0;1
17319;Vieversys;Kodėlčiukų;9012978017;Taip;0;13;0;13
17320;Vieversys;Kodėlčiukų;1738313365;Taip;0;0;13;13
17321;Vieversys;Kodėlčiukų;1766638116;Taip;0;0;1;1
17322;Vieversys;Kodėlčiukų;1599787985;Taip;11;0;2;13
17323;Vieversys;Kodėlčiukų;1491424075;Taip;18;0;0;18
17324;Vieversys;Kodėlčiukų;1361494430;Taip;6;0;10;16
17325;Vieversys;Kodėlčiukų;9829388743;Taip;0;12;0;12
17326;Vieversys;Kodėlčiukų;1878278158;Taip;7;0;0;7
17327;Vieversys;Kodėlčiukų;7315438787;Taip;0;2;0;2
17328;Vieversys;Kodėlčiukų;16617102917;Taip;8;0;0;8
17329;Vieversys;Kodėlčiukų;93675768307;Taip;0;3;0;3
17330;Vieversys;Kodėlčiukų;3792076932;Taip;12;0;0;12
17331;Vieversys;NYKŠTUKAI;5769453869;Taip;0;10;0;10
17332;Vieversys;NYKŠTUKAI;3917758713;Taip;7;0;0;7
17333;Vieversys;NYKŠTUKAI;9164615794;Taip;1;3;0;4
17334;Vieversys;NYKŠTUKAI;2096514775;Taip;1;0;0;1
17335;Vieversys;NYKŠTUKAI;3684937630;Taip;4;0;0;4
17336;Vieversys;NYKŠTUKAI;6563139211;Taip;0;1;0;1
17337;Vieversys;NYKŠTUKAI;4294676988;Taip;0;1;0;1
17338;Vieversys;NYKŠTUKAI;4835022593;Taip;8;0;0;8
17339;Vieversys;NYKŠTUKAI;4778339658;Taip;13;2;0;15
17340;Vieversys;NYKŠTUKAI;3249717073;Taip;11;0;0;11
17341;Vieversys;NYKŠTUKAI;7120329258;Taip;0;1;0;1
17342;Vieversys;NYKŠTUKAI;9387421639;Taip;11;0;0;11
17343;Vieversys;NYKŠTUKAI;8174124875;Taip;9;1;0;10
17344;Vieversys;NYKŠTUKAI;4187114865;Taip;0;2;0;2
17345;Vieversys;DRUGELIAI;4024758152;Taip;0;2;0;2
17346;Vieversys;DRUGELIAI;6194712643;Taip;0;2;0;2
17347;Vieversys;DRUGELIAI;3405502715;Taip;5;0;0;5
17348;Vieversys;DRUGELIAI;5654533451;Taip;0;1;0;1
17349;Vieversys;DRUGELIAI;9972526744;Taip;0;2;0;2
17350;Vieversys;DRUGELIAI;7998100115;Taip;0;2;0;2
17351;Vieversys;DRUGELIAI;6031200259;Taip;1;0;0;1
17352;Vieversys;DRUGELIAI;6110034652;Taip;9;0;0;9
17353;Vieversys;DRUGELIAI;2663322242;Taip;4;0;0;4
17354;Vieversys;DRUGELIAI;7596355010;Taip;1;16;0;17
17355;Vieversys;DRUGELIAI;9308040716;Taip;13;0;0;13
17356;Vieversys;DRUGELIAI;4741252829;Taip;13;0;0;13
17357;Vieversys;DRUGELIAI;4072323869;Taip;0;4;0;4
17358;Vieversys;DRUGELIAI;1931955562;Taip;0;0;10;10
17359;Žirmūnėliai;SAULUTĖS;8030469722;Taip;0;2;0;2
17360;Žirmūnėliai;SAULUTĖS;73664204182;Taip;5;0;0;5
17361;Žirmūnėliai;SAULUTĖS;1725143117;Taip;13;1;0;14
17362;Žirmūnėliai;SAULUTĖS;1073135587;Taip;0;15;0;15
17363;Žirmūnėliai;SAULUTĖS;4598761492;Taip;0;9;0;9
17364;Žirmūnėliai;SAULUTĖS;3128190518;Taip;8;1;0;9
17365;Žirmūnėliai;SAULUTĖS;8317328771;Taip;0;1;0;1
17366;Žirmūnėliai;SAULUTĖS;7562464310;Taip;15;1;0;16
17367;Žirmūnėliai;SAULUTĖS;1478039469;Taip;6;0;0;6
17368;Žirmūnėliai;SAULUTĖS;6896145409;Taip;0;1;0;1
17369;Žirmūnėliai;SAULUTĖS;1255857051;Taip;5;0;0;5
17370;Žirmūnėliai;SAULUTĖS;5009619812;Taip;0;2;0;2
17371;Žirmūnėliai;SAULUTĖS;4517290068;Taip;0;1;1;2
17372;Žirmūnėliai;SAULUTĖS;1582563837;Taip;6;3;0;9
17373;Žirmūnėliai;SAULUTĖS;1381923106;Taip;12;0;0;12
17374;Žirmūnėliai;SAULUTĖS;5037669167;Taip;10;0;4;14
17375;Žirmūnėliai;SAULUTĖS;1761284228;Taip;3;0;0;3
17376;Žirmūnėliai;SAULUTĖS;41018224936;Taip;0;0;3;3
17377;Žirmūnėliai;SAULUTĖS;1894070647;Taip;5;5;0;10
17378;Žirmūnėliai;SAULUTĖS;1347664230;Taip;0;1;0;1
17379;Žirmūnėliai;GILIUKAI;37231106844;Taip;6;1;0;7
17380;Žirmūnėliai;GILIUKAI;68678277635;Taip;13;0;0;13
17381;Žirmūnėliai;GILIUKAI;1401250193;Taip;7;0;1;8
17382;Žirmūnėliai;GILIUKAI;1818060330;Taip;0;1;0;1
17383;Žirmūnėliai;GILIUKAI;1963980356;Taip;0;1;0;1
17384;Žirmūnėliai;GILIUKAI;17294365627;Taip;4;0;0;4
17385;Žirmūnėliai;GILIUKAI;1816123753;Taip;0;11;0;11
17386;Žirmūnėliai;GILIUKAI;1308593517;Taip;8;3;0;11
17387;Žirmūnėliai;GILIUKAI;53028161711;Taip;7;3;0;10
17388;Žirmūnėliai;GILIUKAI;6578685370;Taip;0;2;3;5
17389;Žirmūnėliai;GILIUKAI;1493536049;Taip;5;1;0;6
17390;Žirmūnėliai;GILIUKAI;1734624632;Taip;14;0;0;14
17391;Žirmūnėliai;GILIUKAI;1626619024;Taip;5;5;0;10
17392;Žirmūnėliai;GILIUKAI;8824743884;Taip;5;1;0;6
17393;Žirmūnėliai;GILIUKAI;1039316424;Taip;8;1;0;9
17394;Žirmūnėliai;GILIUKAI;1556389237;Taip;2;5;0;7
17395;Žirmūnėliai;GILIUKAI;1764226619;Taip;8;0;2;10
17396;Žirmūnėliai;DAINORĖLIAI;31231655300;Taip;5;0;13;18
17397;Žirmūnėliai;DAINORĖLIAI;1563132542;Taip;0;0;8;8
17398;Žirmūnėliai;DAINORĖLIAI;1235090013;Taip;5;3;0;8
17399;Žirmūnėliai;DAINORĖLIAI;6274222785;Taip;0;0;1;1
17400;Žirmūnėliai;DAINORĖLIAI;1395294607;Taip;7;0;7;14
17401;Žirmūnėliai;DAINORĖLIAI;7777166572;Taip;0;2;2;4
17402;Žirmūnėliai;DAINORĖLIAI;4136421440;Taip;0;15;0;15
17403;Žirmūnėliai;DAINORĖLIAI;36822027549;Taip;6;0;15;21
17404;Žirmūnėliai;DAINORĖLIAI;33296480709;Taip;4;0;0;4
17405;Žirmūnėliai;DAINORĖLIAI;1017903291;Taip;7;7;0;14
17406;Žirmūnėliai;DAINORĖLIAI;52524235797;Taip;2;0;0;2
17407;Žirmūnėliai;DAINORĖLIAI;5450253994;Taip;0;0;2;2
17408;Žirmūnėliai;DAINORĖLIAI;97123184267;Taip;8;0;1;9
17409;Žirmūnėliai;DAINORĖLIAI;81408646754;Taip;0;11;0;11
17410;Žirmūnėliai;DAINORĖLIAI;67024451309;Taip;9;5;0;14
17411;Žirmūnėliai;DAINORĖLIAI;87693490164;Taip;10;0;2;12
17412;Žirmūnėliai;DAINORĖLIAI;39347099487;Taip;5;1;0;6
17413;Žirmūnėliai;DAINORĖLIAI;6380354636;Taip;0;0;1;1
17414;Žirmūnėliai;DAINORĖLIAI;2548081116;Taip;0;0;1;1
17415;Žirmūnėliai;DRUGELIAI;5276699877;Taip;0;2;1;3
17416;Žirmūnėliai;DRUGELIAI;6531982232;Taip;5;3;0;8
17417;Žirmūnėliai;DRUGELIAI;57457297276;Taip;0;1;0;1
17418;Žirmūnėliai;DRUGELIAI;20851917855;Taip;0;15;0;15
17419;Žirmūnėliai;DRUGELIAI;26463655365;Taip;0;2;0;2
17420;Žirmūnėliai;DRUGELIAI;28826938550;Taip;0;0;3;3
17421;Žirmūnėliai;DRUGELIAI;12766765793;Taip;0;10;0;10
17422;Žirmūnėliai;DRUGELIAI;51268874840;Taip;0;14;0;14
17423;Žirmūnėliai;DRUGELIAI;65010448998;Taip;0;2;0;2
17424;Žirmūnėliai;DRUGELIAI;45541156029;Taip;0;3;2;5
17425;Žirmūnėliai;DRUGELIAI;30933761145;Taip;0;1;0;1
17426;Žirmūnėliai;DRUGELIAI;20902834369;Taip;1;0;0;1
17427;Žirmūnėliai;DRUGELIAI;63972399637;Taip;0;2;0;2
17428;Žirmūnėliai;DRUGELIAI;96121856269;Taip;0;4;0;4
17429;Žirmūnėliai;DRUGELIAI;65810358813;Taip;0;1;0;1
17430;Žirmūnėliai;DRUGELIAI;32213803056;Taip;0;1;0;1
17431;Žirmūnėliai;DRUGELIAI;61531418513;Taip;0;4;0;4
17432;Žirmūnėliai;DRUGELIAI;1157270725;Taip;0;11;0;11
17433;Žirmūnėliai;DRUGELIAI;1914464845;Taip;0;1;0;1
17434;Žirmūnėliai;BORUŽIUKAI;78370998321;Taip;0;5;0;5
17435;Žirmūnėliai;BORUŽIUKAI;1372276406;Taip;0;1;0;1
17436;Žirmūnėliai;BORUŽIUKAI;1035797918;Taip;0;3;10;13
17437;Žirmūnėliai;BORUŽIUKAI;18304538215;Taip;5;0;2;7
17438;Žirmūnėliai;BORUŽIUKAI;95773705800;Taip;0;4;0;4
17439;Žirmūnėliai;BORUŽIUKAI;8102425956;Taip;0;2;1;3
17440;Žirmūnėliai;BORUŽIUKAI;90766071337;Taip;0;11;0;11
17441;Žirmūnėliai;BORUŽIUKAI;15975463125;Taip;5;1;0;6
17442;Žirmūnėliai;BORUŽIUKAI;1657682030;Taip;0;0;3;3
17443;Žirmūnėliai;BORUŽIUKAI;19381396167;Taip;0;1;0;1
17444;Žirmūnėliai;BORUŽIUKAI;50544167833;Taip;0;1;1;2
17445;Žirmūnėliai;BORUŽIUKAI;80136538031;Taip;0;10;0;10
17446;Žirmūnėliai;BORUŽIUKAI;85416619940;Taip;0;0;2;2
17447;Žirmūnėliai;BORUŽIUKAI;21555650432;Taip;0;2;0;2
17448;Žirmūnėliai;BORUŽIUKAI;74577288891;Taip;5;0;1;6
17449;Žirmūnėliai;BORUŽIUKAI;66321657576;Taip;0;7;0;7
17450;Žirmūnėliai;BORUŽIUKAI;86703668087;Taip;6;1;0;7
17451;Žirmūnėliai;BORUŽIUKAI;39102695648;Taip;0;12;0;12
17452;Žirmūnėliai;EŽIUKAI;92309760554;Taip;0;2;2;4
17453;Žirmūnėliai;EŽIUKAI;44456428269;Taip;5;1;4;10
17454;Žirmūnėliai;EŽIUKAI;35616673148;Taip;0;2;0;2
17455;Žirmūnėliai;EŽIUKAI;48862129796;Taip;0;2;0;2
17456;Žirmūnėliai;EŽIUKAI;54806598855;Taip;0;5;0;5
17457;Žirmūnėliai;EŽIUKAI;46197353715;Taip;0;14;0;14
17458;Žirmūnėliai;EŽIUKAI;17545423567;Taip;17;1;3;21
17459;Žirmūnėliai;EŽIUKAI;52242309849;Taip;0;1;1;2
17460;Žirmūnėliai;EŽIUKAI;85930381350;Taip;0;1;0;1
17461;Žirmūnėliai;EŽIUKAI;35378773414;Taip;4;0;0;4
17462;Žirmūnėliai;EŽIUKAI;33734698275;Taip;6;1;7;14
17463;Žirmūnėliai;EŽIUKAI;83168188715;Taip;0;19;0;19
17464;Žirmūnėliai;EŽIUKAI;61198138773;Taip;0;1;0;1
17465;Žirmūnėliai;ŽVIRBLIUKAI;19423526288;Taip;0;9;0;9
17466;Žirmūnėliai;ŽVIRBLIUKAI;15705213099;Taip;10;1;0;11
17467;Žirmūnėliai;ŽVIRBLIUKAI;60871701395;Taip;0;2;0;2
17468;Žirmūnėliai;ŽVIRBLIUKAI;30822135334;Taip;0;2;0;2
17469;Žirmūnėliai;ŽVIRBLIUKAI;55413493068;Taip;0;6;0;6
17470;Žirmūnėliai;ŽVIRBLIUKAI;77610647849;Taip;1;3;0;4
17471;Žirmūnėliai;ŽVIRBLIUKAI;39786518345;Taip;0;4;0;4
17472;Žirmūnėliai;ŽVIRBLIUKAI;53003464638;Taip;11;0;0;11
17473;Žirmūnėliai;ŽVIRBLIUKAI;49856210236;Taip;10;3;0;13
17474;Žirmūnėliai;ŽVIRBLIUKAI;34535851773;Taip;2;2;0;4
17475;Žirmūnėliai;ŽVIRBLIUKAI;1150419333;Taip;8;0;0;8
17476;Žirmūnėliai;ŽVIRBLIUKAI;6262600436;Taip;0;2;1;3
17477;Žirmūnėliai;ŽVIRBLIUKAI;73552867802;Taip;6;0;0;6
17478;Žirmūnėliai;ŽVIRBLIUKAI;38316483993;Taip;0;1;0;1
17479;Žirmūnėliai;ŽVIRBLIUKAI;1250060420;Taip;16;0;0;16
17480;Žirmūnėliai;ŽVIRBLIUKAI;1477593223;Taip;9;3;0;12
17481;Žirmūnėliai;ŽVIRBLIUKAI;3896978775;Taip;5;0;1;6
17482;Žirmūnėliai;ŽVIRBLIUKAI;7165846395;Taip;17;0;0;17
17483;Žirmūnėliai;ŽVIRBLIUKAI;1049041500;Taip;5;0;1;6
17484;Žirmūnėliai;ŽVIRBLIUKAI;50088185187;Taip;0;6;0;6
17485;Žirmūnėliai;SPALVELĖS;1634724759;Taip;14;6;0;20
17486;Žirmūnėliai;SPALVELĖS;99980167497;Taip;0;1;0;1
17487;Žirmūnėliai;SPALVELĖS;88436070676;Taip;0;8;2;10
17488;Žirmūnėliai;SPALVELĖS;18266666204;Taip;0;2;0;2
17489;Žirmūnėliai;SPALVELĖS;2538608908;Taip;0;2;0;2
17490;Žirmūnėliai;SPALVELĖS;22592450568;Taip;0;2;0;2
17491;Žirmūnėliai;SPALVELĖS;85286691926;Taip;0;6;0;6
17492;Žirmūnėliai;SPALVELĖS;4986702792;Taip;0;3;4;7
17493;Žirmūnėliai;SPALVELĖS;86501162211;Taip;1;0;0;1
17494;Žirmūnėliai;SPALVELĖS;3691651489;Taip;6;0;8;14
17495;Žirmūnėliai;SPALVELĖS;1120531178;Taip;0;2;2;4
17496;Žirmūnėliai;SPALVELĖS;1273301982;Taip;0;0;2;2
17497;Žirmūnėliai;SPALVELĖS;29952298800;Taip;5;0;3;8
17498;Žirmūnėliai;SPALVELĖS;8348616350;Taip;0;2;3;5
17499;Žirmūnėliai;SPALVELĖS;1080735912;Taip;3;0;0;3
17500;Žirmūnėliai;SPALVELĖS;2127930970;Taip;8;1;0;9
17501;Žirmūnėliai;SPALVELĖS;3150467744;Taip;8;0;0;8
17502;Žirmūnėliai;SPALVELĖS;4710829908;Taip;5;1;0;6
17503;Žirmūnėliai;SPALVELĖS;7918747416;Taip;5;0;1;6
17504;Žirmūnėliai;SPALVELĖS;1865240339;Taip;16;0;0;16
17505;Žirmūnėliai;SPALVELĖS;51723882387;Taip;0;2;3;5
17506;Žirmūnėliai;SPALVELĖS;8308074932;Taip;5;1;0;6
17507;Žirmūnėliai;DEBESĖLIAI;1119678857;Taip;0;3;0;3
17508;Žirmūnėliai;DEBESĖLIAI;37429281370;Taip;0;1;0;1
17509;Žirmūnėliai;DEBESĖLIAI;76779474158;Taip;21;0;0;21
17510;Žirmūnėliai;DEBESĖLIAI;18242077086;Taip;0;2;0;2
17511;Žirmūnėliai;DEBESĖLIAI;64969220116;Taip;0;16;0;16
17512;Žirmūnėliai;DEBESĖLIAI;1690539251;Taip;0;1;0;1
17513;Žirmūnėliai;DEBESĖLIAI;5527904792;Taip;0;21;0;21
17514;Žirmūnėliai;DEBESĖLIAI;77024387002;Taip;6;0;0;6
17515;Žirmūnėliai;DEBESĖLIAI;2263604297;Taip;10;4;0;14
17516;Žirmūnėliai;DEBESĖLIAI;1885292520;Taip;0;0;1;1
17517;Žirmūnėliai;DEBESĖLIAI;1618573494;Taip;1;20;0;21
17518;Žirmūnėliai;DEBESĖLIAI;5611315994;Taip;5;5;2;12
17519;Žirmūnėliai;DEBESĖLIAI;6337036947;Taip;4;0;0;4
17520;Žirmūnėliai;DEBESĖLIAI;2739395691;Taip;12;4;0;16
17521;Žirmūnėliai;DEBESĖLIAI;7528704460;Taip;5;5;2;12
17522;Žirmūnėliai;DEBESĖLIAI;8623037038;Taip;6;0;0;6
17523;Žirmūnėliai;DEBESĖLIAI;3006508357;Taip;7;0;2;9
17524;Žirmūnėliai;DEBESĖLIAI;5125341440;Taip;8;0;0;8
17525;Žirmūnėliai;VIŠČIUKAI;6493142538;Taip;10;0;0;10
17526;Žirmūnėliai;VIŠČIUKAI;7892626521;Taip;5;3;0;8
17527;Žirmūnėliai;VIŠČIUKAI;1655437833;Taip;13;0;2;15
17528;Žirmūnėliai;VIŠČIUKAI;8999160836;Taip;10;1;0;11
17529;Žirmūnėliai;VIŠČIUKAI;8209309240;Taip;5;10;0;15
17530;Žirmūnėliai;VIŠČIUKAI;2693415717;Taip;11;0;0;11
17531;Žirmūnėliai;VIŠČIUKAI;8930536051;Taip;9;0;0;9
17532;Žirmūnėliai;VIŠČIUKAI;2837129621;Taip;13;0;0;13
17533;Žirmūnėliai;VIŠČIUKAI;1273684243;Taip;9;0;0;9
17534;Žirmūnėliai;VIŠČIUKAI;2971175236;Taip;0;0;2;2
17535;Žirmūnėliai;VIŠČIUKAI;7953019230;Taip;16;1;0;17
17536;Žirmūnėliai;VIŠČIUKAI;6982109508;Taip;13;0;1;14
17537;Žirmūnėliai;VIŠČIUKAI;6594728970;Taip;15;0;0;15
17538;Žirmūnėliai;VIŠČIUKAI;9478256549;Taip;13;1;2;16
17539;Žirmūnėliai;VIŠČIUKAI;5090067954;Taip;0;0;1;1
17540;Žirmūnėliai;VIŠČIUKAI;7422544482;Taip;5;0;0;5
17541;Žirmūnėliai;VIŠČIUKAI;4336415033;Taip;3;0;1;4
17542;Žirmūnėliai;VIŠČIUKAI;5209700153;Taip;3;0;0;3
17543;Žirmūnėliai;ZUIKUČIŲ;9378860669;Taip;6;4;0;10
17544;Žirmūnėliai;ZUIKUČIŲ;4218266688;Taip;11;0;2;13
17545;Žirmūnėliai;ZUIKUČIŲ;8607934394;Taip;4;1;1;6
17546;Žirmūnėliai;ZUIKUČIŲ;3449815783;Taip;6;1;0;7
17547;Žirmūnėliai;ZUIKUČIŲ;7996709950;Taip;0;2;0;2
17548;Žirmūnėliai;ZUIKUČIŲ;4638575301;Taip;0;1;3;4
17549;Žirmūnėliai;ZUIKUČIŲ;3562689670;Taip;0;11;0;11
17550;Žirmūnėliai;ZUIKUČIŲ;7020486370;Taip;14;0;0;14
17551;Žirmūnėliai;ZUIKUČIŲ;3274576752;Taip;21;0;0;21
17552;Žirmūnėliai;ZUIKUČIŲ;9541122034;Taip;5;0;0;5
17553;Žirmūnėliai;ZUIKUČIŲ;1571242696;Taip;1;1;6;8
17554;Žirmūnėliai;ZUIKUČIŲ;5736502380;Taip;5;1;9;15
17555;Žirmūnėliai;ZUIKUČIŲ;9154874729;Taip;7;1;1;9
17556;Žirmūnėliai;ZUIKUČIŲ;8631248243;Taip;5;1;5;11
17557;Žirmūnėliai;ZUIKUČIŲ;5723289396;Taip;19;0;0;19
17558;Žirmūnėliai;OBUOLIUKAI;9666769523;Taip;0;5;0;5
17559;Žirmūnėliai;OBUOLIUKAI;24877884441;Taip;0;6;0;6
17560;Žirmūnėliai;OBUOLIUKAI;85408994677;Taip;0;0;1;1
17561;Žirmūnėliai;OBUOLIUKAI;2336720944;Taip;4;1;0;5
17562;Žirmūnėliai;OBUOLIUKAI;1110585472;Taip;0;1;1;2
17563;Žirmūnėliai;OBUOLIUKAI;93072181228;Taip;0;1;0;1
17564;Žirmūnėliai;OBUOLIUKAI;1259227112;Taip;0;0;5;5
17565;Žirmūnėliai;OBUOLIUKAI;155054610;Taip;1;0;0;1
17566;Žirmūnėliai;OBUOLIUKAI;89429083939;Taip;11;0;0;11
17567;Žirmūnėliai;OBUOLIUKAI;35353356752;Taip;9;0;0;9
17568;Žirmūnėliai;OBUOLIUKAI;36305353664;Taip;4;0;0;4
17569;Žirmūnėliai;OBUOLIUKAI;4030572434;Taip;0;5;0;5
17570;Žirmūnėliai;OBUOLIUKAI;6758118659;Taip;0;5;0;5
17571;Žirmūnėliai;OBUOLIUKAI;24035212527;Taip;5;1;3;9
17572;Žirmūnėliai;OBUOLIUKAI;65907675470;Taip;12;1;0;13
17573;Žirmūnėliai;OBUOLIUKAI;4675716163;Taip;0;0;11;11
17574;Žirmūnėliai;OBUOLIUKAI;2216383670;Taip;19;0;0;19
17575;Žirmūnėliai;OBUOLIUKAI;47645482781;Taip;5;0;0;5
17576;Žirmūnėliai;OBUOLIUKAI;9232201424;Taip;7;0;0;7
17577;Žirmūnėliai;OBUOLIUKAI;9448136354;Taip;0;1;9;10
17578;Dainorėliai;SAULUTĖS;79461209783;Ne;10;1;0;11
17579;Dainorėliai;SAULUTĖS;18741625569;Ne;0;1;0;1
17580;Dainorėliai;SAULUTĖS;98830139164;Taip;0;0;3;3
17581;Dainorėliai;SAULUTĖS;8762386907;Taip;0;2;0;2
17582;Dainorėliai;SAULUTĖS;15654726109;Taip;11;0;0;11
17583;Dainorėliai;SAULUTĖS;10679627657;Taip;0;1;0;1
17584;Dainorėliai;SAULUTĖS;84424772471;Taip;0;6;0;6
17585;Dainorėliai;SAULUTĖS;98796240124;Taip;0;0;2;2
17586;Dainorėliai;SAULUTĖS;69556449215;Taip;0;0;2;2
17587;Dainorėliai;SAULUTĖS;84084897419;Taip;0;6;3;9
17588;Dainorėliai;SAULUTĖS;34686211072;Taip;6;0;0;6
17589;Dainorėliai;SAULUTĖS;64977015444;Taip;0;0;13;13
17590;Dainorėliai;SAULUTĖS;47323045857;Taip;0;0;1;1
17591;Dainorėliai;SAULUTĖS;18744882489;Taip;0;1;0;1
17592;Dainorėliai;SAULUTĖS;25073134850;Taip;0;1;1;2
17593;Dainorėliai;SAULUTĖS;37660372564;Taip;0;1;1;2
17594;Dainorėliai;SAULUTĖS;84999972369;Taip;0;1;1;2
17595;Dainorėliai;SAULUTĖS;13138644060;Taip;0;1;0;1
17596;Dainorėliai;SAULUTĖS;5155175570;Taip;7;0;0;7
17597;Dainorėliai;SAULUTĖS;92644746397;Taip;0;1;1;2
17598;Dainorėliai;SAULUTĖS;2922026996;Taip;0;1;0;1
17599;Dainorėliai;SAULUTĖS;1889037823;Taip;0;1;4;5
17600;Dainorėliai;SAULUTĖS;2441164154;Taip;21;0;0;21
17601;Dainorėliai;VARPELIAI;11506295275;Taip;0;2;0;2
17602;Dainorėliai;VARPELIAI;87242570532;Taip;0;1;0;1
17603;Dainorėliai;VARPELIAI;18233813290;Taip;0;3;0;3
17604;Dainorėliai;VARPELIAI;6176171443;Taip;0;1;0;1
17605;Dainorėliai;VARPELIAI;88781762328;Taip;21;0;0;21
17606;Dainorėliai;VARPELIAI;9319771186;Taip;0;0;16;16
17607;Dainorėliai;VARPELIAI;8719834064;Taip;0;4;0;4
17608;Dainorėliai;VARPELIAI;5693385617;Taip;0;5;2;7
17609;Dainorėliai;VARPELIAI;8267213392;Taip;0;3;0;3
17610;Dainorėliai;VARPELIAI;5959380807;Taip;0;2;0;2
17611;Dainorėliai;VARPELIAI;3183793211;Taip;0;2;0;2
17612;Dainorėliai;VARPELIAI;65467351140;Taip;0;2;0;2
17613;Dainorėliai;VARPELIAI;8521878734;Taip;15;1;0;16
17614;Dainorėliai;VARPELIAI;1928369859;Taip;0;0;2;2
17615;Dainorėliai;VARPELIAI;6909583023;Taip;6;1;0;7
17616;Dainorėliai;VARPELIAI;4269946363;Taip;0;2;3;5
17617;Dainorėliai;ŽIOGELIAI;99597416067;Taip;0;2;0;2
17618;Dainorėliai;ŽIOGELIAI;88201007119;Taip;3;3;0;6
17619;Dainorėliai;ŽIOGELIAI;31267856584;Taip;0;4;0;4
17620;Dainorėliai;ŽIOGELIAI;18936645521;Ne;3;3;2;8
17621;Dainorėliai;ŽIOGELIAI;35528654099;Taip;0;2;0;2
17622;Dainorėliai;ŽIOGELIAI;16780418740;Ne;0;2;0;2
17623;Dainorėliai;ŽIOGELIAI;29132059636;Taip;0;1;0;1
17624;Dainorėliai;ŽIOGELIAI;32573583030;Taip;0;1;0;1
17625;Dainorėliai;ŽIOGELIAI;35134511946;Taip;0;0;1;1
17626;Dainorėliai;ŽIOGELIAI;67124516230;Taip;0;3;0;3
17627;Dainorėliai;ŽIOGELIAI;17358842027;Taip;0;2;0;2
17628;Dainorėliai;ŽIOGELIAI;54344466523;Taip;3;0;4;7
17629;Dainorėliai;ŽIOGELIAI;63211091321;Taip;0;1;0;1
17630;Dainorėliai;ŽIOGELIAI;45577031767;Taip;0;3;0;3
17631;Dainorėliai;ŽIOGELIAI;92157879830;Taip;0;1;0;1
17632;Dainorėliai;ŽIOGELIAI;80499999855;Taip;0;0;2;2
17633;Dainorėliai;ŽIOGELIAI;72073028506;Taip;0;2;0;2
17634;Dainorėliai;ŽIOGELIAI;78002267589;Taip;0;21;0;21
17635;Dainorėliai;ŽIOGELIAI;3761026792;Taip;3;1;2;6
17636;Dainorėliai;DRUGELIAI;65253606353;Taip;0;1;0;1
17637;Dainorėliai;DRUGELIAI;26916172990;Ne;4;1;0;5
17638;Dainorėliai;DRUGELIAI;6411939690;Taip;0;1;0;1
17639;Dainorėliai;DRUGELIAI;19286303769;Taip;0;1;0;1
17640;Dainorėliai;DRUGELIAI;2483267929;Taip;5;0;0;5
17641;Dainorėliai;DRUGELIAI;1015870220;Taip;4;1;0;5
17642;Dainorėliai;DRUGELIAI;5212308610;Taip;0;1;0;1
17643;Dainorėliai;DRUGELIAI;6404337541;Taip;3;0;2;5
17644;Dainorėliai;DRUGELIAI;94480397292;Taip;0;0;2;2
17645;Dainorėliai;DRUGELIAI;53935690864;Taip;3;0;1;4
17646;Dainorėliai;DRUGELIAI;27521381629;Taip;0;0;3;3
17647;Dainorėliai;DRUGELIAI;86187568203;Taip;0;0;1;1
17648;Dainorėliai;DRUGELIAI;5238082419;Taip;0;0;1;1
17649;Dainorėliai;DRUGELIAI;49483881135;Taip;0;0;2;2
17650;Dainorėliai;DRUGELIAI;3789809082;Taip;21;0;0;21
17651;Dainorėliai;DRUGELIAI;1626877066;Taip;4;0;2;6
17652;Dainorėliai;DRUGELIAI;1158895670;Taip;8;0;0;8
17653;Dainorėliai;DRUGELIAI;4087344015;Taip;0;3;1;4
17654;Dainorėliai;DRUGELIAI;3128897752;Taip;2;0;0;2
17655;Dainorėliai;DRUGELIAI;1357413314;Taip;0;0;8;8
17656;Dainorėliai;DRUGELIAI;1515552402;Taip;0;2;1;3
17657;Dainorėliai;DRUGELIAI;36313982965;Taip;0;3;7;10
17658;Dainorėliai;"1 klasė";48245075123;Taip;0;1;0;1
17659;Dainorėliai;"1 klasė";5010994621;Taip;0;1;0;1
17660;Dainorėliai;"1 klasė";57618865048;Taip;0;1;0;1
17661;Dainorėliai;"1 klasė";29726515194;Taip;3;1;0;4
17662;Dainorėliai;"1 klasė";26315465923;Taip;0;1;0;1
17663;Dainorėliai;"1 klasė";6203511535;Taip;0;1;0;1
17664;Dainorėliai;"1 klasė";93738984644;Taip;1;1;0;2
17665;Dainorėliai;"1 klasė";81956978417;Taip;1;1;0;2
17666;Dainorėliai;"1 klasė";24048489264;Taip;0;1;0;1
17667;Dainorėliai;"1 klasė";8562371599;Taip;0;1;0;1
17668;Dainorėliai;"1 klasė";19292860218;Taip;1;1;0;2
17669;Dainorėliai;"1 klasė";14664307658;Taip;1;1;0;2
17670;Dainorėliai;"1 klasė";23144978287;Taip;0;1;0;1
17671;Dainorėliai;"1 klasė";77907054102;Taip;0;1;0;1
17672;Dainorėliai;"1 klasė";9447513737;Taip;2;1;0;3
17673;Dainorėliai;"1 klasė";63052774196;Taip;0;1;0;1
17674;Dainorėliai;"1 klasė";65982869126;Taip;0;1;0;1
17675;Dainorėliai;"1 klasė";97182565649;Taip;0;1;0;1
17676;Dainorėliai;"1 klasė";91457137356;Taip;1;1;0;2
17677;Dainorėliai;"1 klasė";13846131820;Taip;0;1;0;1
17678;Dainorėliai;"1 klasė";69409530494;Taip;0;1;0;1
17679;Dainorėliai;"1 klasė";84749521489;Taip;0;1;0;1
17680;Dainorėliai;"1 klasė";57179351170;Taip;0;1;0;1
17681;Dainorėliai;"1 klasė";4773358825;Taip;0;1;0;1
17682;Dainorėliai;"1 klasė";3018657993;Taip;1;1;0;2
17683;Dainorėliai;"2 klasė";8014881349;Taip;0;1;0;1
17684;Dainorėliai;"2 klasė";4309610318;Taip;0;1;0;1
17685;Dainorėliai;"2 klasė";1629229178;Ne;0;1;0;1
17686;Dainorėliai;"2 klasė";7589862952;Taip;0;1;0;1
17687;Dainorėliai;"2 klasė";1734712911;Taip;0;1;0;1
17688;Dainorėliai;"2 klasė";1472986325;Taip;0;1;0;1
17689;Dainorėliai;"2 klasė";6898321145;Taip;0;1;0;1
17690;Dainorėliai;"2 klasė";4642369086;Taip;3;1;0;4
17691;Dainorėliai;"2 klasė";3713835329;Taip;1;1;0;2
17692;Dainorėliai;"2 klasė";5181789063;Taip;4;1;0;5
17693;Dainorėliai;"2 klasė";4792505132;Taip;0;1;0;1
17694;Dainorėliai;"2 klasė";4631981231;Taip;2;1;0;3
17695;Dainorėliai;"2 klasė";2685423821;Taip;0;1;0;1
17696;Dainorėliai;"2 klasė";2991348691;Taip;8;1;0;9
17697;Dainorėliai;"2 klasė";3109138914;Taip;0;1;0;1
17698;Dainorėliai;"2 klasė";6576505338;Ne;0;1;0;1
17699;Dainorėliai;"2 klasė";9028699114;Taip;0;1;0;1
17700;Dainorėliai;"2 klasė";1185255904;Taip;3;1;0;4
17701;Dainorėliai;"2 klasė";9691052273;Taip;1;1;0;2
17702;Dainorėliai;"2 klasė";2135997501;Taip;3;1;0;4
17703;Dainorėliai;"2 klasė";7013545705;Taip;1;1;0;2
17704;Dainorėliai;"2 klasė";6735081184;Taip;5;1;0;6
17705;Dainorėliai;"2 klasė";7332518731;Taip;0;1;0;1
17706;Dainorėliai;"2 klasė";6513001151;Taip;0;1;0;1
17707;Dainorėliai;"2 klasė";47031645815;Taip;2;1;0;3
17708;Dainorėliai;"3 klasė";5468429196;Taip;0;1;0;1
17709;Dainorėliai;"3 klasė";6497830034;Taip;0;1;0;1
17710;Dainorėliai;"3 klasė";4497264004;Taip;5;1;0;6
17711;Dainorėliai;"3 klasė";2704452184;Taip;6;1;0;7
17712;Dainorėliai;"3 klasė";5072041112;Taip;0;1;0;1
17713;Dainorėliai;"3 klasė";2164782968;Ne;0;1;0;1
17714;Dainorėliai;"3 klasė";4275023010;Taip;0;1;0;1
17715;Dainorėliai;"3 klasė";4490125789;Taip;0;1;0;1
17716;Dainorėliai;"3 klasė";1311444933;Taip;0;1;0;1
17717;Dainorėliai;"3 klasė";8569165891;Taip;0;1;0;1
17718;Dainorėliai;"3 klasė";9630477900;Taip;0;1;0;1
17719;Dainorėliai;"3 klasė";2519518637;Taip;0;1;0;1
17720;Dainorėliai;"3 klasė";5177714429;Taip;0;1;0;1
17721;Dainorėliai;"3 klasė";7309477306;Taip;5;1;0;6
17722;Dainorėliai;"3 klasė";3683531357;Taip;5;1;0;6
17723;Dainorėliai;"3 klasė";3053044929;Taip;0;1;0;1
17724;Dainorėliai;"3 klasė";1289801462;Taip;0;1;0;1
17725;Dainorėliai;"3 klasė";7327414673;Taip;0;1;0;1
17726;Dainorėliai;"3 klasė";1347410803;Taip;0;1;0;1
17727;Dainorėliai;"3 klasė";8916859571;Taip;0;1;0;1
17728;Dainorėliai;"4 klasė";8177540512;Taip;0;1;0;1
17729;Dainorėliai;"4 klasė";1682094268;Taip;0;1;0;1
17730;Dainorėliai;"4 klasė";8913783842;Taip;0;1;0;1
17731;Dainorėliai;"4 klasė";1689787684;Taip;5;1;0;6
17732;Dainorėliai;"4 klasė";4956275684;Taip;0;1;0;1
17733;Dainorėliai;"4 klasė";3140143126;Taip;1;1;0;2
17734;Dainorėliai;"4 klasė";7972267725;Taip;0;1;0;1
17735;Dainorėliai;"4 klasė";6647480988;Taip;0;1;0;1
17736;Dainorėliai;"4 klasė";9012668384;Taip;0;1;0;1
17737;Dainorėliai;"4 klasė";3707864997;Taip;0;1;0;1
17738;Dainorėliai;"4 klasė";4557048583;Taip;0;1;0;1
17739;Dainorėliai;"4 klasė";1744536400;Ne;1;1;0;2
17740;Dainorėliai;"4 klasė";2936271822;Taip;0;1;0;1
17741;Dainorėliai;"4 klasė";4825947023;Ne;0;1;0;1
17742;Dainorėliai;"4 klasė";7116837311;Taip;0;1;0;1
17743;Dainorėliai;"4 klasė";1676986825;Taip;0;1;0;1
17744;Dainorėliai;"4 klasė";4853813247;Taip;0;1;0;1
17745;Dainorėliai;"4 klasė";6181648900;Taip;0;1;0;1
17746;Dainorėliai;"4 klasė";7179140869;Taip;2;1;0;3
17747;Dainorėliai;"4 klasė";4182527951;Taip;0;1;0;1
17748;Dainorėliai;"4 klasė";6267160193;Taip;0;1;0;1
17749;Dainorėliai;"4 klasė";4684100461;Taip;0;1;0;1
17750;Dainorėliai;"4 klasė";1175747348;Taip;3;1;0;4
17751;Dainorėliai;"4 klasė";1593283963;Taip;4;1;0;5
17752;Dainorėliai;"4 klasė";8612758782;Taip;1;1;0;2
17753;Lokiukas;BITUTĖS;6758550653;Taip;10;5;0;15
17754;Lokiukas;BITUTĖS;1040288021;Taip;10;1;0;11
17755;Lokiukas;BITUTĖS;1733486244;Taip;0;2;0;2
17756;Lokiukas;BITUTĖS;6336140882;Taip;0;1;2;3
17757;Lokiukas;BITUTĖS;9142262360;Taip;0;1;0;1
17758;Lokiukas;BITUTĖS;8775608581;Taip;5;0;0;5
17759;Lokiukas;BITUTĖS;1752784666;Taip;10;2;0;12
17760;Lokiukas;BITUTĖS;34546519642;Taip;5;0;0;5
17761;Lokiukas;BITUTĖS;2166382346;Taip;0;2;0;2
17762;Lokiukas;BITUTĖS;7305062511;Taip;3;0;0;3
17763;Lokiukas;BITUTĖS;1025576053;Taip;0;0;3;3
17764;Lokiukas;BITUTĖS;6069516217;Taip;4;5;0;9
17765;Lokiukas;BITUTĖS;7943213321;Taip;0;5;0;5
17766;Lokiukas;BITUTĖS;8915504279;Taip;3;1;0;4
17767;Lokiukas;BITUTĖS;8796640190;Taip;8;1;0;9
17768;Lokiukas;BITUTĖS;5943412920;Taip;0;2;1;3
17769;Lokiukas;BITUTĖS;2885398200;Taip;0;1;1;2
17770;Lokiukas;BITUTĖS;3694653020;Taip;2;9;0;11
17771;Lokiukas;BITUTĖS;4379238557;Taip;0;1;1;2
17772;Lokiukas;BITUTĖS;2052174669;Taip;4;1;5;10
17773;Lokiukas;BITUTĖS;8902619265;Taip;10;1;0;11
17774;Lokiukas;"1 B klasė";60370754283;Taip;1;1;0;2
17775;Lokiukas;"1 B klasė";3262579895;Taip;2;1;0;3
17776;Lokiukas;"1 B klasė";17034757778;Taip;9;1;0;10
17777;Lokiukas;"1 B klasė";79301547085;Taip;1;1;0;2
17778;Lokiukas;"1 B klasė";16889795010;Taip;0;21;0;21
17779;Lokiukas;"1 B klasė";18432518932;Taip;3;1;0;4
17780;Lokiukas;"1 B klasė";2004606839;Taip;0;21;0;21
17781;Lokiukas;"1 B klasė";88947878548;Taip;1;1;0;2
17782;Lokiukas;"1 B klasė";45805925058;Taip;3;1;0;4
17783;Lokiukas;"1 B klasė";70028115546;Taip;1;1;0;2
17784;Lokiukas;"1 B klasė";29198900240;Taip;1;1;0;2
17785;Lokiukas;"1 B klasė";10897713744;Taip;0;21;0;21
17786;Lokiukas;"1 B klasė";77441549037;Taip;2;1;0;3
17787;Lokiukas;"1 B klasė";69089214980;Taip;1;1;0;2
17788;Lokiukas;"1 B klasė";2353550739;Taip;1;1;0;2
17789;Lokiukas;"1 B klasė";17622979450;Taip;6;1;0;7
17790;Lokiukas;"1 B klasė";98289469398;Taip;16;1;0;17
17791;Lokiukas;"1 B klasė";51554951703;Taip;3;1;0;4
17792;Lokiukas;"1 B klasė";45735190114;Taip;0;21;0;21
17793;Lokiukas;"1 B klasė";79597160668;Taip;1;1;0;2
17794;Lokiukas;"1 B klasė";37669645510;Taip;1;1;0;2
17795;Lokiukas;"1 B klasė";15004419516;Taip;1;1;0;2
17796;Lokiukas;"1 B klasė";10240586503;Taip;0;21;0;21
17797;Lokiukas;"1 B klasė";5067673212;Taip;2;1;0;3
17798;Lokiukas;"1 B klasė";66392613629;Taip;2;1;0;3
17799;Lokiukas;"1 B klasė";15445053855;Taip;1;1;0;2
17800;Lokiukas;"1 B klasė";1104333637;Taip;2;1;0;3
17801;Lokiukas;"1 B klasė";35018370441;Taip;1;1;0;2
17802;Lokiukas;"1 B klasė";1716358913;Taip;2;1;0;3
17803;Lokiukas;"1 A klasė";72167964645;Taip;1;1;0;2
17804;Lokiukas;"1 A klasė";67818191566;Taip;0;1;0;1
17805;Lokiukas;"1 A klasė";75613665040;Taip;0;1;0;1
17806;Lokiukas;"1 A klasė";23222644824;Taip;1;1;0;2
17807;Lokiukas;"1 A klasė";52296454506;Taip;8;1;0;9
17808;Lokiukas;"1 A klasė";25058082693;Taip;0;21;0;21
17809;Lokiukas;"1 A klasė";6702448475;Taip;2;1;0;3
17810;Lokiukas;"1 A klasė";42292408557;Taip;7;1;0;8
17811;Lokiukas;"1 A klasė";2143040924;Taip;0;21;0;21
17812;Lokiukas;"1 A klasė";45280536946;Taip;12;1;0;13
17813;Lokiukas;"1 A klasė";82966541165;Taip;1;1;0;2
17814;Lokiukas;"1 A klasė";80180114948;Taip;18;1;0;19
17815;Lokiukas;"1 A klasė";66999644935;Taip;0;21;0;21
17816;Lokiukas;"1 A klasė";43389930516;Taip;1;1;0;2
17817;Lokiukas;"1 A klasė";86623153797;Taip;1;1;0;2
17818;Lokiukas;"1 A klasė";53245573692;Taip;2;1;0;3
17819;Lokiukas;"1 A klasė";14341255985;Taip;1;1;0;2
17820;Lokiukas;"1 A klasė";3206276637;Taip;0;21;0;21
17821;Lokiukas;"1 A klasė";27050402360;Taip;0;1;0;1
17822;Lokiukas;"1 A klasė";38636200254;Ne;2;1;0;3
17823;Lokiukas;"1 A klasė";53544600623;Taip;0;21;0;21
17824;Lokiukas;"1 A klasė";53087036306;Taip;0;21;0;21
17825;Lokiukas;"1 A klasė";5775631777;Ne;1;1;0;2
17826;Lokiukas;"1 A klasė";1143130271;Taip;1;1;0;2
17827;Lokiukas;"1 A klasė";47410036889;Taip;0;1;0;1
17828;Lokiukas;"1 A klasė";79223457439;Taip;11;1;0;12
17829;Lokiukas;GUDRUČIAI;43070670534;Taip;4;0;0;4
17830;Lokiukas;GUDRUČIAI;5198408183;Taip;0;4;0;4
17831;Lokiukas;GUDRUČIAI;88415635113;Taip;0;7;0;7
17832;Lokiukas;GUDRUČIAI;1227430275;Taip;0;5;0;5
17833;Lokiukas;GUDRUČIAI;9747265775;Taip;0;1;1;2
17834;Lokiukas;GUDRUČIAI;95910336503;Taip;12;1;0;13
17835;Lokiukas;GUDRUČIAI;7903535850;Taip;0;5;0;5
17836;Lokiukas;GUDRUČIAI;7497324442;Taip;0;4;0;4
17837;Lokiukas;GUDRUČIAI;93374754851;Taip;5;1;0;6
17838;Lokiukas;GUDRUČIAI;96046361641;Taip;0;1;0;1
17839;Lokiukas;GUDRUČIAI;6628530877;Taip;18;1;0;19
17840;Lokiukas;GUDRUČIAI;25170045140;Taip;13;1;0;14
17841;Lokiukas;GUDRUČIAI;84273668685;Taip;0;2;0;2
17842;Lokiukas;GUDRUČIAI;10948160841;Taip;0;3;0;3
17843;Lokiukas;GUDRUČIAI;4608275224;Taip;4;1;0;5
17844;Lokiukas;GUDRUČIAI;75296600945;Taip;0;2;0;2
17845;Lokiukas;GUDRUČIAI;59840033826;Taip;0;1;1;2
17846;Lokiukas;GUDRUČIAI;1855267362;Taip;3;1;0;4
17847;Lokiukas;BORUŽĖLĖS;1333650630;Ne;16;0;0;16
17848;Lokiukas;BORUŽĖLĖS;67133709394;Taip;5;0;1;6
17849;Lokiukas;BORUŽĖLĖS;66528256040;Taip;0;1;0;1
17850;Lokiukas;BORUŽĖLĖS;4906784415;Taip;20;1;0;21
17851;Lokiukas;BORUŽĖLĖS;1119814512;Taip;20;1;0;21
17852;Lokiukas;BORUŽĖLĖS;1056075876;Taip;0;1;2;3
17853;Lokiukas;BORUŽĖLĖS;52940830874;Taip;0;5;0;5
17854;Lokiukas;BORUŽĖLĖS;1201125655;Taip;0;2;1;3
17855;Lokiukas;BORUŽĖLĖS;82025637099;Taip;5;9;0;14
17856;Lokiukas;BORUŽĖLĖS;131300206;Taip;12;5;0;17
17857;Lokiukas;BORUŽĖLĖS;8846527481;Taip;0;7;0;7
17858;Lokiukas;BORUŽĖLĖS;24601126170;Taip;10;0;0;10
17859;Lokiukas;BORUŽĖLĖS;83528495608;Ne;0;3;0;3
17860;Lokiukas;BORUŽĖLĖS;83086633109;Taip;3;0;2;5
17861;Lokiukas;BORUŽĖLĖS;40082135876;Taip;0;0;4;4
17862;Lokiukas;BORUŽĖLĖS;29396361769;Taip;0;5;0;5
17863;Lokiukas;BORUŽĖLĖS;41809745552;Taip;10;0;0;10
17864;Lokiukas;BORUŽĖLĖS;73515179103;Taip;10;1;0;11
17865;Lokiukas;BORUŽĖLĖS;73696992182;Taip;5;1;0;6
17866;Lokiukas;BORUŽĖLĖS;8240261104;Taip;7;2;0;9
17867;Lokiukas;BORUŽĖLĖS;99183628764;Taip;0;2;0;2
17868;Lokiukas;BORUŽĖLĖS;61807094999;Taip;1;0;0;1
17869;Lokiukas;BORUŽĖLĖS;7495691956;Ne;5;0;0;5
17870;Lokiukas;BORUŽĖLĖS;51059574159;Taip;10;1;0;11
17871;Lokiukas;ANČIUKAI;4617372387;Taip;0;0;3;3
17872;Lokiukas;ANČIUKAI;8630112458;Taip;17;1;0;18
17873;Lokiukas;ANČIUKAI;5518041213;Taip;0;1;0;1
17874;Lokiukas;ANČIUKAI;8738488104;Taip;0;1;0;1
17875;Lokiukas;ANČIUKAI;3744484616;Taip;0;4;0;4
17876;Lokiukas;ANČIUKAI;2625981190;Taip;4;1;0;5
17877;Lokiukas;ANČIUKAI;4442073527;Taip;0;3;0;3
17878;Lokiukas;ANČIUKAI;9307491947;Taip;10;0;0;10
17879;Lokiukas;ANČIUKAI;4849031542;Taip;0;21;0;21
17880;Lokiukas;ANČIUKAI;8286358519;Taip;5;1;0;6
17881;Lokiukas;ANČIUKAI;4585621105;Taip;16;1;0;17
17882;Lokiukas;ANČIUKAI;5522089503;Taip;4;0;0;4
17883;Lokiukas;ANČIUKAI;4206181176;Taip;5;11;0;16
17884;Lokiukas;ANČIUKAI;8576418875;Taip;10;11;0;21
17885;Lokiukas;ANČIUKAI;4858829710;Taip;14;0;1;15
17886;Lokiukas;ANČIUKAI;8329540746;Taip;0;1;0;1
17887;Lokiukas;ANČIUKAI;6869785650;Taip;5;4;0;9
17888;Lokiukas;KODĖLČIUKAI;45122233067;Taip;0;3;0;3
17889;Lokiukas;KODĖLČIUKAI;21802863853;Taip;0;1;1;2
17890;Lokiukas;KODĖLČIUKAI;22979689191;Taip;0;8;0;8
17891;Lokiukas;KODĖLČIUKAI;70730972654;Taip;0;2;0;2
17892;Lokiukas;KODĖLČIUKAI;80754592972;Taip;0;2;5;7
17893;Lokiukas;KODĖLČIUKAI;99706061553;Taip;3;5;0;8
17894;Lokiukas;KODĖLČIUKAI;42138783794;Taip;0;1;0;1
17895;Lokiukas;KODĖLČIUKAI;7785940412;Taip;0;1;1;2
17896;Lokiukas;KODĖLČIUKAI;24099693663;Taip;0;0;7;7
17897;Lokiukas;KODĖLČIUKAI;72092394330;Taip;0;1;2;3
17898;Lokiukas;KODĖLČIUKAI;7324496782;Taip;0;4;0;4
17899;Lokiukas;KODĖLČIUKAI;35769782473;Taip;5;0;0;5
17900;Lokiukas;KODĖLČIUKAI;10811780420;Taip;0;3;0;3
17901;Lokiukas;KODĖLČIUKAI;1151938436;Taip;0;2;0;2
17902;Lokiukas;KODĖLČIUKAI;91855230473;Taip;6;1;1;8
17903;Lokiukas;KODĖLČIUKAI;38531751377;Taip;5;2;0;7
17904;Lokiukas;KODĖLČIUKAI;28796727185;Taip;4;1;2;7
17905;Lokiukas;KODĖLČIUKAI;80793623068;Ne;7;2;0;9
17906;Lokiukas;DRUGELIAI;7942641594;Taip;15;1;0;16
17907;Lokiukas;DRUGELIAI;8568285232;Taip;5;5;0;10
17908;Lokiukas;DRUGELIAI;5453470660;Taip;6;4;0;10
17909;Lokiukas;DRUGELIAI;5879386524;Taip;9;0;1;10
17910;Lokiukas;DRUGELIAI;14605095801;Taip;0;3;0;3
17911;Lokiukas;DRUGELIAI;46838695582;Taip;0;8;0;8
17912;Lokiukas;DRUGELIAI;2642065594;Taip;0;2;0;2
17913;Lokiukas;DRUGELIAI;1626698185;Taip;0;2;0;2
17914;Lokiukas;DRUGELIAI;39222094073;Taip;0;2;0;2
17915;Lokiukas;DRUGELIAI;1695680881;Taip;15;0;0;15
17916;Lokiukas;DRUGELIAI;69364831994;Taip;0;1;0;1
17917;Lokiukas;DRUGELIAI;76969210386;Taip;0;1;0;1
17918;Lokiukas;DRUGELIAI;74169282323;Taip;0;15;0;15
17919;Lokiukas;DRUGELIAI;1625137322;Taip;0;4;0;4
17920;Lokiukas;DRUGELIAI;1381505711;Taip;7;7;0;14
17921;Lokiukas;DRUGELIAI;8452600632;Taip;9;0;1;10
17922;Lokiukas;DRUGELIAI;7386571822;Ne;2;1;1;4
17923;Lokiukas;DRUGELIAI;35890122494;Taip;0;9;0;9
17924;Lokiukas;DRUGELIAI;1210407640;Taip;0;2;0;2
17925;Lokiukas;DRUGELIAI;7591418969;Taip;0;1;0;1
17926;Lokiukas;DRUGELIAI;8270572748;Taip;4;0;0;4
17927;Lokiukas;DRUGELIAI;8036643654;Taip;3;1;1;5
17928;Lokiukas;"2 A klasė";7060929950;Taip;2;0;0;2
17929;Lokiukas;"2 A klasė";8499895935;Taip;1;20;0;21
17930;Lokiukas;"2 A klasė";5737714024;Ne;2;0;0;2
17931;Lokiukas;"2 A klasė";5889819809;Ne;5;0;0;5
17932;Lokiukas;"2 A klasė";6496662759;Taip;13;0;0;13
17933;Lokiukas;"2 A klasė";5700685872;Ne;11;0;0;11
17934;Lokiukas;"2 A klasė";1555365851;Ne;16;0;0;16
17935;Lokiukas;"2 A klasė";2374089307;Taip;12;0;0;12
17936;Lokiukas;"2 A klasė";2607988265;Taip;2;0;0;2
17937;Lokiukas;"2 A klasė";4992275038;Taip;2;0;0;2
17938;Lokiukas;"2 A klasė";1492303633;Taip;3;0;0;3
17939;Lokiukas;"2 A klasė";6856770462;Ne;5;0;0;5
17940;Lokiukas;"2 A klasė";8766212402;Ne;2;0;0;2
17941;Lokiukas;"2 A klasė";5559967651;Taip;13;0;0;13
17942;Lokiukas;"2 A klasė";3528533437;Taip;21;0;0;21
17943;Lokiukas;"2 A klasė";5465758477;Taip;3;0;0;3
17944;Lokiukas;"2 A klasė";7069020705;Taip;3;0;0;3
17945;Lokiukas;"2 A klasė";6129602024;Ne;2;0;0;2
17946;Lokiukas;"2 A klasė";9199283952;Taip;21;0;0;21
17947;Lokiukas;"2 A klasė";8378630091;Taip;7;0;0;7
17948;Lokiukas;"2 A klasė";3138145333;Ne;21;0;0;21
17949;Lokiukas;"2 A klasė";3506723678;Taip;1;20;0;21
17950;Lokiukas;"2 A klasė";4615481025;Ne;2;0;0;2
17951;Lokiukas;"2 A klasė";7553457572;Ne;8;0;0;8
17952;Lokiukas;"2 A klasė";1571404671;Taip;2;0;0;2
17953;Lokiukas;"2 A klasė";1729941577;Taip;5;0;0;5
17954;Lokiukas;"2 B klasė";9114504810;Taip;10;1;0;11
17955;Lokiukas;"2 B klasė";7595514531;Taip;6;1;0;7
17956;Lokiukas;"2 B klasė";7144013238;Taip;0;21;0;21
17957;Lokiukas;"2 B klasė";8235437961;Taip;1;1;0;2
17958;Lokiukas;"2 B klasė";2905935730;Taip;11;1;0;12
17959;Lokiukas;"2 B klasė";8304439625;Taip;6;1;0;7
17960;Lokiukas;"2 B klasė";8954484534;Taip;1;1;0;2
17961;Lokiukas;"2 B klasė";1388342336;Taip;3;1;0;4
17962;Lokiukas;"2 B klasė";4418425219;Taip;2;1;0;3
17963;Lokiukas;"2 B klasė";3364994110;Taip;5;1;0;6
17964;Lokiukas;"2 B klasė";6063796643;Taip;8;1;0;9
17965;Lokiukas;"2 B klasė";6663700618;Taip;2;1;0;3
17966;Lokiukas;"2 B klasė";6151885589;Taip;2;1;0;3
17967;Lokiukas;"2 B klasė";1440437389;Taip;2;1;0;3
17968;Lokiukas;"2 B klasė";2059112380;Taip;2;1;0;3
17969;Lokiukas;"2 B klasė";5745254234;Taip;1;1;0;2
17970;Lokiukas;"2 B klasė";8189433550;Taip;0;21;0;21
17971;Lokiukas;"2 B klasė";5918592397;Taip;3;1;0;4
17972;Lokiukas;"2 B klasė";7722830021;Taip;4;1;0;5
17973;Lokiukas;"2 B klasė";9681048306;Taip;1;1;0;2
17974;Lokiukas;"2 B klasė";1048772300;Taip;7;1;0;8
17975;Lokiukas;"2 B klasė";2021690274;Taip;2;1;0;3
17976;Lokiukas;"2 B klasė";6538311120;Taip;2;1;0;3
17977;Lokiukas;"2 B klasė";8395026474;Taip;4;1;0;5
17978;Lokiukas;"2 B klasė";7439047502;Taip;2;1;0;3
17979;Lokiukas;"2 B klasė";1746819279;Taip;4;1;0;5
17980;Lokiukas;"3 A klasė";2220223549;Taip;0;21;0;21
17981;Lokiukas;"3 A klasė";7349936354;Ne;0;2;0;2
17982;Lokiukas;"3 A klasė";8192834838;Taip;0;2;0;2
17983;Lokiukas;"3 A klasė";7086818828;Taip;3;2;0;5
17984;Lokiukas;"3 A klasė";8959417696;Taip;0;21;0;21
17985;Lokiukas;"3 A klasė";1362995666;Taip;0;2;0;2
17986;Lokiukas;"3 A klasė";4873942674;Taip;6;2;0;8
17987;Lokiukas;"3 A klasė";2745780921;Taip;3;2;0;5
17988;Lokiukas;"3 A klasė";3007573139;Taip;0;2;0;2
17989;Lokiukas;"3 A klasė";5058488696;Taip;2;2;0;4
17990;Lokiukas;"3 A klasė";6008557035;Taip;1;2;0;3
17991;Lokiukas;"3 A klasė";1243245356;Taip;3;2;0;5
17992;Lokiukas;"3 A klasė";9322204885;Taip;1;2;0;3
17993;Lokiukas;"3 A klasė";1822055099;Taip;0;2;0;2
17994;Lokiukas;"3 A klasė";5199360470;Taip;4;2;0;6
17995;Lokiukas;"3 A klasė";5384844998;Taip;0;21;0;21
17996;Lokiukas;"3 A klasė";6353653831;Taip;0;21;0;21
17997;Lokiukas;"3 A klasė";3700837936;Taip;6;2;0;8
17998;Lokiukas;"3 A klasė";6022402998;Taip;1;2;0;3
17999;Lokiukas;"3 A klasė";5942416530;Taip;3;2;0;5
18000;Lokiukas;"3 A klasė";9743363133;Taip;9;2;0;11
18001;Lokiukas;"3 A klasė";2029507962;Taip;5;2;0;7
18002;Lokiukas;"3 A klasė";44496777103;Taip;0;21;0;21
18003;Lokiukas;"3 A klasė";94528954912;Taip;4;2;0;6
18004;Lokiukas;"3 B klasė";9922964495;Taip;6;1;0;7
18005;Lokiukas;"3 B klasė";5562737843;Taip;7;1;0;8
18006;Lokiukas;"3 B klasė";6110849113;Taip;0;21;0;21
18007;Lokiukas;"3 B klasė";8822883914;Taip;0;21;0;21
18008;Lokiukas;"3 B klasė";1860245985;Taip;0;21;0;21
18009;Lokiukas;"3 B klasė";1692231191;Taip;1;1;0;2
18010;Lokiukas;"3 B klasė";4160279615;Taip;9;1;0;10
18011;Lokiukas;"3 B klasė";4368235682;Taip;3;1;0;4
18012;Lokiukas;"3 B klasė";9376247296;Taip;1;1;0;2
18013;Lokiukas;"3 B klasė";7943448919;Taip;0;21;0;21
18014;Lokiukas;"3 B klasė";6270747705;Taip;2;1;0;3
18015;Lokiukas;"3 B klasė";9390626220;Taip;20;1;0;21
18016;Lokiukas;"3 B klasė";4467643205;Taip;3;1;0;4
18017;Lokiukas;"3 B klasė";8175005473;Taip;1;1;0;2
18018;Lokiukas;"3 B klasė";4504812769;Taip;1;1;0;2
18019;Lokiukas;"3 B klasė";6210160161;Taip;1;1;0;2
18020;Lokiukas;"3 B klasė";1727242060;Taip;0;21;0;21
18021;Lokiukas;"3 B klasė";8300861451;Taip;1;1;0;2
18022;Lokiukas;"3 B klasė";7692067948;Taip;4;1;0;5
18023;Lokiukas;"3 B klasė";7728788069;Taip;20;1;0;21
18024;Lokiukas;"3 B klasė";9985555940;Taip;20;1;0;21
18025;Lokiukas;"3 B klasė";4447860405;Taip;3;1;0;4
18026;Lokiukas;"3 B klasė";3823547337;Taip;1;1;0;2
18027;Lokiukas;"3 B klasė";5496591880;Taip;0;21;0;21
18028;Lokiukas;"3 B klasė";1491789191;Taip;1;1;0;2
18029;Lokiukas;"3 B klasė";1419846182;Taip;1;1;0;2
18030;Lokiukas;"3 B klasė";9310088026;Taip;7;1;0;8
18031;Lokiukas;"3 B klasė";1787800667;Taip;5;1;0;6
18032;Lokiukas;"3 B klasė";2284932363;Taip;4;1;0;5
18033;Lokiukas;"4 A klasė";8522739824;Taip;0;21;0;21
18034;Lokiukas;"4 A klasė";6642105064;Taip;8;1;0;9
18035;Lokiukas;"4 A klasė";5852545576;Taip;0;21;0;21
18036;Lokiukas;"4 A klasė";1179863043;Taip;0;21;0;21
18037;Lokiukas;"4 A klasė";4976080351;Taip;2;1;0;3
18038;Lokiukas;"4 A klasė";5300309689;Taip;0;21;0;21
18039;Lokiukas;"4 A klasė";3023836997;Taip;0;21;0;21
18040;Lokiukas;"4 A klasė";6539032697;Ne;0;21;0;21
18041;Lokiukas;"4 A klasė";8651567498;Taip;4;1;0;5
18042;Lokiukas;"4 A klasė";6880671721;Taip;0;21;0;21
18043;Lokiukas;"4 A klasė";2890728780;Taip;0;21;0;21
18044;Lokiukas;"4 A klasė";1275739989;Taip;0;21;0;21
18045;Lokiukas;"4 A klasė";5810597393;Ne;0;21;0;21
18046;Lokiukas;"4 A klasė";3297734813;Taip;0;21;0;21
18047;Lokiukas;"4 A klasė";3216247517;Taip;6;1;0;7
18048;Lokiukas;"4 A klasė";2946985384;Taip;0;21;0;21
18049;Lokiukas;"4 A klasė";4908935009;Taip;3;1;0;4
18050;Lokiukas;"4 A klasė";8585585715;Taip;9;1;0;10
18051;Lokiukas;"4 A klasė";8746221351;Taip;1;1;0;2
18052;Lokiukas;"4 A klasė";7385810354;Taip;1;1;0;2
18053;Lokiukas;"4 A klasė";7202328703;Taip;7;1;0;8
18054;Lokiukas;"4 B klasė";3253826820;Ne;9;0;0;9
18055;Lokiukas;"4 B klasė";8577804440;Taip;7;0;0;7
18056;Lokiukas;"4 B klasė";3401446820;Taip;11;0;0;11
18057;Lokiukas;"4 B klasė";3941060152;Taip;21;0;0;21
18058;Lokiukas;"4 B klasė";6034080022;Taip;16;0;0;16
18059;Lokiukas;"4 B klasė";7802721046;Taip;21;0;0;21
18060;Lokiukas;"4 B klasė";5579944645;Taip;13;0;0;13
18061;Lokiukas;"4 B klasė";1798330886;Taip;7;0;0;7
18062;Lokiukas;"4 B klasė";6827396461;Taip;7;0;0;7
18063;Lokiukas;"4 B klasė";2096424992;Taip;0;21;0;21
18064;Lokiukas;"4 B klasė";7221776688;Taip;21;0;0;21
18065;Lokiukas;"4 B klasė";7010375151;Taip;4;0;0;4
18066;Lokiukas;"4 B klasė";3862533006;Taip;10;0;0;10
18067;Lokiukas;"4 B klasė";8123166445;Ne;6;0;0;6
18068;Lokiukas;"4 B klasė";9742540759;Taip;0;21;0;21
18069;Lokiukas;"4 B klasė";5301990414;Taip;2;0;0;2
18070;Lokiukas;"4 B klasė";4755673524;Taip;15;0;0;15
18071;Lokiukas;"4 B klasė";7851458821;Taip;19;0;0;19
18072;Lokiukas;"4 B klasė";4537888646;Taip;11;0;0;11
18073;Lokiukas;"4 B klasė";9786431252;Taip;7;0;0;7
18074;Lokiukas;"4 B klasė";1956140793;Taip;21;0;0;21
18075;Lokiukas;"4 B klasė";6116726536;Taip;14;0;0;14
18076;Lokiukas;"4 B klasė";3276273861;Taip;4;0;0;4
18077;Lokiukas;"4 B klasė";4648324338;Taip;12;0;0;12
18078;Šaltinėlis;Ančiukų;3011747942;Taip;0;8;0;8
18079;Šaltinėlis;Ančiukų;1811886320;Taip;10;1;0;11
18080;Šaltinėlis;Ančiukų;9769491789;Taip;0;8;0;8
18081;Šaltinėlis;Ančiukų;56396772538;Taip;10;2;0;12
18082;Šaltinėlis;Ančiukų;6462738640;Taip;13;1;0;14
18083;Šaltinėlis;Ančiukų;3493429067;Taip;0;1;0;1
18084;Šaltinėlis;Ančiukų;77872075694;Taip;13;0;0;13
18085;Šaltinėlis;Ančiukų;9218883174;Taip;1;1;0;2
18086;Šaltinėlis;Ančiukų;7133143923;Taip;0;6;0;6
18087;Šaltinėlis;Ančiukų;9820788524;Taip;16;0;0;16
18088;Šaltinėlis;Ančiukų;3691635011;Taip;7;0;0;7
18089;Šaltinėlis;Ančiukų;2630875135;Taip;12;1;0;13
18090;Šaltinėlis;Ančiukų;2973820849;Taip;20;0;0;20
18091;Šaltinėlis;Ančiukų;6487378225;Taip;11;0;0;11
18092;Šaltinėlis;Ančiukų;1464992631;Taip;11;2;0;13
18093;Šaltinėlis;Ančiukų;9274165569;Taip;0;4;0;4
18094;Šaltinėlis;Ančiukų;8500790262;Taip;6;0;0;6
18095;Šaltinėlis;Ančiukų;4332884673;Taip;11;0;0;11
18096;Šaltinėlis;Ančiukų;9362495172;Taip;7;6;0;13
18097;Šaltinėlis;Ančiukų;7737797979;Taip;0;4;0;4
18098;Šaltinėlis;Bitučių;54025577281;Taip;5;7;0;12
18099;Šaltinėlis;Bitučių;6669392157;Taip;0;1;2;3
18100;Šaltinėlis;Bitučių;28956971978;Taip;7;1;0;8
18101;Šaltinėlis;Bitučių;14213856824;Taip;0;1;1;2
18102;Šaltinėlis;Bitučių;80649337160;Taip;0;2;0;2
18103;Šaltinėlis;Bitučių;92958012146;Taip;0;2;0;2
18104;Šaltinėlis;Bitučių;84656960510;Taip;10;1;1;12
18105;Šaltinėlis;Bitučių;83621946293;Taip;0;7;0;7
18106;Šaltinėlis;Bitučių;67808618878;Ne;0;3;0;3
18107;Šaltinėlis;Bitučių;1278910777;Taip;0;4;0;4
18108;Šaltinėlis;Bitučių;9647785988;Taip;0;2;0;2
18109;Šaltinėlis;Bitučių;82671662416;Taip;5;1;0;6
18110;Šaltinėlis;Bitučių;29482180151;Taip;0;1;0;1
18111;Šaltinėlis;Bitučių;64821172553;Taip;0;1;3;4
18112;Šaltinėlis;Bitučių;25459069972;Ne;0;1;0;1
18113;Šaltinėlis;Bitučių;5056986469;Taip;4;1;1;6
18114;Šaltinėlis;Bitučių;89358384113;Taip;0;1;2;3
18115;Šaltinėlis;Bitučių;4050444191;Taip;0;9;0;9
18116;Šaltinėlis;Bitučių;89093437170;Taip;0;8;0;8
18117;Šaltinėlis;Bitučių;51872331010;Taip;6;1;4;11
18118;Šaltinėlis;Bitučių;5744976843;Taip;0;6;0;6
18119;Šaltinėlis;Saulutės;72372808270;Taip;0;1;0;1
18120;Šaltinėlis;Saulutės;70315400705;Taip;0;5;0;5
18121;Šaltinėlis;Saulutės;57847832778;Taip;0;6;0;6
18122;Šaltinėlis;Saulutės;74337710550;Taip;0;1;0;1
18123;Šaltinėlis;Saulutės;59164202996;Taip;0;5;0;5
18124;Šaltinėlis;Saulutės;3626545396;Ne;0;10;0;10
18125;Šaltinėlis;Saulutės;95542489944;Taip;0;3;0;3
18126;Šaltinėlis;Saulutės;39088869084;Taip;0;1;0;1
18127;Šaltinėlis;Saulutės;83173349544;Taip;0;5;0;5
18128;Šaltinėlis;Saulutės;19630605543;Taip;6;1;0;7
18129;Šaltinėlis;Saulutės;93256161233;Taip;0;2;0;2
18130;Šaltinėlis;Saulutės;3072314714;Taip;0;1;0;1
18131;Šaltinėlis;Saulutės;1924418657;Taip;0;2;0;2
18132;Šaltinėlis;Saulutės;23090033086;Taip;6;1;0;7
18133;Šaltinėlis;Meškiukų;3264138693;Taip;2;2;0;4
18134;Šaltinėlis;Meškiukų;2013810425;Taip;0;2;0;2
18135;Šaltinėlis;Meškiukų;46159500221;Taip;0;0;3;3
18136;Šaltinėlis;Meškiukų;1044723472;Taip;0;0;11;11
18137;Šaltinėlis;Meškiukų;1045163890;Taip;0;0;2;2
18138;Šaltinėlis;Meškiukų;8776976566;Taip;0;3;0;3
18139;Šaltinėlis;Meškiukų;4749756473;Taip;0;0;2;2
18140;Šaltinėlis;Meškiukų;5215769929;Taip;0;3;0;3
18141;Šaltinėlis;Meškiukų;8555517284;Taip;11;0;0;11
18142;Šaltinėlis;Meškiukų;29359826470;Taip;4;0;0;4
18143;Šaltinėlis;Meškiukų;1073305554;Taip;7;0;3;10
18144;Šaltinėlis;Meškiukų;1614411921;Ne;0;11;0;11
18145;Šaltinėlis;Meškiukų;77518622497;Taip;8;2;0;10
18146;Šaltinėlis;Meškiukų;6887838949;Taip;0;0;5;5
18147;Šaltinėlis;Meškiukų;7483928256;Taip;5;0;0;5
18148;Šaltinėlis;Nykštukai;1390316465;Taip;13;0;0;13
18149;Šaltinėlis;Nykštukai;1955018380;Ne;5;3;0;8
18150;Šaltinėlis;Nykštukai;1718488108;Taip;11;2;0;13
18151;Šaltinėlis;Nykštukai;7073644279;Taip;8;0;0;8
18152;Šaltinėlis;Nykštukai;37786438977;Taip;8;3;0;11
18153;Šaltinėlis;Nykštukai;48525545812;Taip;0;6;0;6
18154;Šaltinėlis;Nykštukai;1658370782;Ne;15;1;0;16
18155;Šaltinėlis;Nykštukai;32264290873;Taip;0;7;0;7
18156;Šaltinėlis;Nykštukai;66575684640;Taip;4;1;0;5
18157;Šaltinėlis;Nykštukai;13808708760;Taip;0;0;1;1
18158;Šaltinėlis;Nykštukai;10918276041;Taip;4;0;1;5
18159;Šaltinėlis;Nykštukai;1456486363;Taip;10;2;0;12
18160;Šaltinėlis;Nykštukai;79406746980;Taip;0;4;0;4
18161;Šaltinėlis;Nykštukai;32949623652;Taip;0;16;0;16
18162;Šaltinėlis;Nykštukai;1767635282;Taip;2;0;1;3
18163;Šaltinėlis;Nykštukai;1190394855;Taip;4;0;0;4
18164;Šaltinėlis;Nykštukai;6764006747;Taip;0;1;0;1
18165;Šaltinėlis;Nykštukai;3577137327;Taip;9;1;0;10
18166;Šaltinėlis;Nykštukai;1580090516;Taip;1;0;1;2
18167;Šaltinėlis;Nykštukai;2333071711;Taip;0;0;1;1
18168;Šaltinėlis;Nykštukai;4901977623;Taip;7;0;1;8
18169;Šaltinėlis;Nykštukai;5442943843;Taip;12;2;0;14
18170;Šaltinėlis;Perliukų;17147527171;Taip;0;2;0;2
18171;Šaltinėlis;Perliukų;11083638216;Taip;6;0;0;6
18172;Šaltinėlis;Perliukų;1091056386;Taip;0;1;0;1
18173;Šaltinėlis;Perliukų;52507085619;Taip;5;0;0;5
18174;Šaltinėlis;Perliukų;2146141461;Taip;0;1;1;2
18175;Šaltinėlis;Perliukų;1958647188;Taip;0;19;0;19
18176;Šaltinėlis;Perliukų;2034838765;Taip;1;0;0;1
18177;Šaltinėlis;Perliukų;1935762293;Taip;6;0;1;7
18178;Šaltinėlis;Perliukų;1583520894;Taip;0;17;0;17
18179;Šaltinėlis;Perliukų;1023238509;Taip;1;0;0;1
18180;Šaltinėlis;Perliukų;84494627465;Taip;0;1;0;1
18181;Šaltinėlis;Perliukų;1130153806;Taip;14;1;0;15
18182;Šaltinėlis;Perliukų;98941037508;Taip;0;1;2;3
18183;Šaltinėlis;Perliukų;2125176999;Ne;5;1;2;8
18184;Šaltinėlis;Perliukų;9425353041;Taip;0;10;0;10
18185;Šaltinėlis;Perliukų;526307704;Taip;6;13;0;19
18186;Šaltinėlis;Perliukų;7262120071;Ne;0;1;3;4
18187;Šaltinėlis;Perliukų;6068980312;Taip;11;0;0;11
18188;Šaltinėlis;Perliukų;5869977541;Taip;1;0;0;1
18189;Šaltinėlis;Perliukų;4416064304;Ne;6;1;0;7
18190;Šaltinėlis;BORUŽĖLĖS;9762392403;Taip;17;0;0;17
18191;Šaltinėlis;BORUŽĖLĖS;9522524163;Taip;0;14;0;14
18192;Šaltinėlis;BORUŽĖLĖS;7311831014;Taip;0;1;1;2
18193;Šaltinėlis;BORUŽĖLĖS;5854723120;Taip;0;9;0;9
18194;Šaltinėlis;BORUŽĖLĖS;5833136956;Taip;0;1;0;1
18195;Šaltinėlis;BORUŽĖLĖS;3483756240;Taip;13;0;0;13
18196;Šaltinėlis;BORUŽĖLĖS;6380346298;Taip;13;0;0;13
18197;Šaltinėlis;BORUŽĖLĖS;5799032398;Taip;0;15;0;15
18198;Šaltinėlis;BORUŽĖLĖS;5525740049;Taip;0;4;0;4
18199;Šaltinėlis;BORUŽĖLĖS;4681460322;Taip;8;5;0;13
18200;Šaltinėlis;BORUŽĖLĖS;1978469605;Ne;6;1;0;7
18201;Šaltinėlis;BORUŽĖLĖS;7650840990;Taip;10;1;0;11
18202;Šaltinėlis;BORUŽĖLĖS;4430546695;Taip;7;1;0;8
18203;Šaltinėlis;BORUŽĖLĖS;4743907195;Taip;13;0;0;13
18204;Šaltinėlis;1A;86995081866;Taip;0;6;0;6
18205;Šaltinėlis;1A;4587186145;Taip;0;2;0;2
18206;Šaltinėlis;1A;89489007301;Taip;0;21;0;21
18207;Šaltinėlis;1A;66754907606;Taip;0;21;0;21
18208;Šaltinėlis;1A;50972894040;Ne;0;1;0;1
18209;Šaltinėlis;1A;9705941341;Taip;0;21;0;21
18210;Šaltinėlis;1A;36718328105;Taip;0;1;0;1
18211;Šaltinėlis;1A;47045578599;Taip;0;2;0;2
18212;Šaltinėlis;1A;35387543586;Taip;0;2;0;2
18213;Šaltinėlis;1A;40769315138;Taip;0;4;0;4
18214;Šaltinėlis;1A;83657465071;Taip;0;1;0;1
18215;Šaltinėlis;1A;70948186548;Taip;0;2;0;2
18216;Šaltinėlis;1A;62612067151;Taip;0;4;0;4
18217;Šaltinėlis;1A;38496350161;Taip;0;1;0;1
18218;Šaltinėlis;1A;86309198604;Taip;0;1;0;1
18219;Šaltinėlis;1A;29683761586;Ne;0;7;0;7
18220;Šaltinėlis;1A;2323456393;Taip;0;21;0;21
18221;Šaltinėlis;1A;9927833966;Ne;0;4;0;4
18222;Šaltinėlis;1A;56279691365;Taip;0;1;0;1
18223;Šaltinėlis;1A;96133834896;Taip;0;21;0;21
18224;Šaltinėlis;1A;7929809205;Ne;0;2;0;2
18225;Šaltinėlis;1A;7563879445;Taip;0;2;0;2
18226;Šaltinėlis;"2A klasė";4843823058;Ne;0;2;0;2
18227;Šaltinėlis;"2A klasė";7264810605;Ne;0;1;0;1
18228;Šaltinėlis;"2A klasė";6044895102;Ne;0;1;0;1
18229;Šaltinėlis;"2A klasė";8680271000;Ne;0;2;0;2
18230;Šaltinėlis;"2A klasė";1839665658;Ne;0;1;0;1
18231;Šaltinėlis;"2A klasė";2076892804;Ne;0;2;0;2
18232;Šaltinėlis;"2A klasė";7967108692;Ne;0;2;0;2
18233;Šaltinėlis;"2A klasė";7058348243;Ne;0;1;0;1
18234;Šaltinėlis;"2A klasė";5012608633;Ne;0;2;0;2
18235;Šaltinėlis;"2A klasė";8445115141;Ne;0;2;0;2
18236;Šaltinėlis;"2A klasė";7214517805;Ne;0;21;0;21
18237;Šaltinėlis;"2A klasė";6876036723;Ne;0;21;0;21
18238;Šaltinėlis;"2A klasė";9978493148;Ne;0;2;0;2
18239;Šaltinėlis;"2A klasė";6171441011;Ne;0;5;0;5
18240;Šaltinėlis;"2A klasė";1450894955;Ne;0;21;0;21
18241;Šaltinėlis;"2A klasė";8898225999;Ne;0;21;0;21
18242;Šaltinėlis;"2A klasė";92001008485;Taip;0;2;0;2
18243;Šaltinėlis;"2B klasė";3329317171;Ne;0;2;0;2
18244;Šaltinėlis;"2B klasė";2089316824;Ne;0;2;0;2
18245;Šaltinėlis;"2B klasė";5776007602;Ne;0;3;0;3
18246;Šaltinėlis;"2B klasė";7420737103;Ne;0;2;0;2
18247;Šaltinėlis;"2B klasė";4141263000;Ne;0;1;0;1
18248;Šaltinėlis;"2B klasė";5999279571;Ne;0;1;0;1
18249;Šaltinėlis;"2B klasė";7142082502;Ne;0;21;0;21
18250;Šaltinėlis;"2B klasė";3037854361;Ne;0;2;0;2
18251;Šaltinėlis;"2B klasė";8219291385;Ne;0;1;0;1
18252;Šaltinėlis;"2B klasė";3863654037;Ne;0;2;0;2
18253;Šaltinėlis;"2B klasė";8380122669;Ne;0;1;0;1
18254;Šaltinėlis;"2B klasė";6719801285;Ne;0;6;0;6
18255;Šaltinėlis;"2B klasė";49275031765;Taip;0;2;0;2
18256;Šaltinėlis;"2B klasė";82404351290;Taip;0;1;0;1
18257;Šaltinėlis;"2B klasė";1756003648;Taip;0;21;0;21
18258;Šaltinėlis;"2B klasė";2002711790;Taip;0;1;0;1
18259;Šaltinėlis;"3A klasė";2010277249;Ne;0;1;0;1
18260;Šaltinėlis;"3A klasė";3553168020;Ne;0;10;0;10
18261;Šaltinėlis;"3A klasė";9341104954;Ne;0;2;0;2
18262;Šaltinėlis;"3A klasė";8714253922;Ne;0;4;0;4
18263;Šaltinėlis;"3A klasė";6948074305;Ne;0;5;0;5
18264;Šaltinėlis;"3A klasė";6765467361;Ne;0;7;0;7
18265;Šaltinėlis;"3A klasė";9057225956;Ne;0;1;0;1
18266;Šaltinėlis;"3A klasė";8503985429;Ne;0;10;0;10
18267;Šaltinėlis;"3A klasė";6443537515;Ne;0;12;0;12
18268;Šaltinėlis;"3A klasė";2154195956;Ne;0;1;0;1
18269;Šaltinėlis;"3A klasė";3636296862;Ne;0;3;0;3
18270;Šaltinėlis;"3A klasė";4062628468;Ne;0;2;0;2
18271;Šaltinėlis;"3A klasė";4977611599;Ne;0;1;0;1
18272;Šaltinėlis;"3A klasė";47857916979;Taip;0;21;0;21
18273;Šaltinėlis;"3A klasė";57928407025;Ne;0;21;0;21
18274;Šaltinėlis;"3A klasė";24414070672;Ne;0;21;0;21
18275;Šaltinėlis;"3A klasė";4884745983;Taip;0;21;0;21
18276;Šaltinėlis;"4A klasė";9593691923;Ne;0;2;0;2
18277;Šaltinėlis;"4A klasė";6511702530;Ne;0;21;0;21
18278;Šaltinėlis;"4A klasė";4852664619;Ne;0;1;0;1
18279;Šaltinėlis;"4A klasė";5000390873;Ne;0;3;0;3
18280;Šaltinėlis;"4A klasė";4673345747;Ne;0;2;0;2
18281;Šaltinėlis;"4A klasė";2890127126;Ne;0;1;0;1
18282;Šaltinėlis;"4A klasė";6507364244;Ne;0;1;0;1
18283;Šaltinėlis;"4A klasė";6109577947;Ne;0;1;0;1
18284;Šaltinėlis;"4A klasė";7820579483;Ne;0;1;0;1
18285;Šaltinėlis;"4A klasė";6716488827;Ne;0;3;0;3
18286;Šaltinėlis;"4A klasė";8503609901;Ne;0;21;0;21
18287;Šaltinėlis;"4A klasė";5212176791;Ne;0;1;0;1
18288;Šaltinėlis;"4A klasė";6810655952;Ne;0;2;0;2
18289;Šaltinėlis;"4A klasė";4699743123;Ne;0;6;0;6
18290;Šaltinėlis;"4A klasė";4989298444;Ne;0;1;0;1
18291;Šaltinėlis;"4A klasė";5234879459;Ne;0;1;0;1
18292;Šaltinėlis;"4A klasė";7307538614;Ne;0;2;0;2
18293;Šaltinėlis;"4A klasė";1322088652;Ne;0;1;0;1
18294;Šaltinėlis;"4A klasė";9980670695;Ne;0;2;0;2
18295;Šaltinėlis;"4A klasė";5574115620;Ne;0;2;0;2
18296;Šaltinėlis;"4A klasė";1765082898;Taip;0;21;0;21
18297;Šaltinėlis;"4A klasė";5623289398;Taip;0;21;0;21
18298;Šaltinėlis;"4A klasė";2310958087;Taip;0;3;0;3
18299;Šaltinėlis;"4A klasė";8431234082;Taip;0;21;0;21
18300;Šaltinėlis;3B;7917468152;Taip;0;1;0;1
18301;Šaltinėlis;3B;5181754988;Ne;0;4;0;4
18302;Šaltinėlis;3B;2413295020;Ne;0;21;0;21
18303;Šaltinėlis;3B;3680528737;Ne;0;2;0;2
18304;Šaltinėlis;3B;7404225862;Ne;0;1;0;1
18305;Šaltinėlis;3B;4335720836;Ne;0;1;0;1
18306;Šaltinėlis;3B;7121732840;Ne;0;2;0;2
18307;Šaltinėlis;3B;5105961386;Ne;0;7;0;7
18308;Šaltinėlis;3B;7316939619;Ne;0;2;0;2
18309;Šaltinėlis;3B;4543101402;Ne;0;1;0;1
18310;Šaltinėlis;3B;4994088781;Ne;0;4;0;4
18311;Šaltinėlis;3B;1687964284;Ne;0;3;0;3
18312;Šaltinėlis;3B;6381956693;Ne;0;1;0;1
18313;Šaltinėlis;3B;3375856084;Ne;0;3;0;3
18314;Šaltinėlis;3B;9708038079;Ne;0;3;0;3
18315;Šaltinėlis;3B;2160937385;Ne;0;1;0;1
18316;Šaltinėlis;3B;8670777468;Ne;0;1;0;1
18317;Gabijėlė;GANDRIUKŲ;80074896113;Taip;0;1;4;5
18318;Gabijėlė;GANDRIUKŲ;57976186090;Taip;0;1;2;3
18319;Gabijėlė;GANDRIUKŲ;78228886019;Taip;0;2;0;2
18320;Gabijėlė;GANDRIUKŲ;65824488786;Taip;0;17;0;17
18321;Gabijėlė;GANDRIUKŲ;58145931856;Taip;7;3;0;10
18322;Gabijėlė;GANDRIUKŲ;92468615840;Taip;4;0;0;4
18323;Gabijėlė;GANDRIUKŲ;17501127436;Taip;0;6;1;7
18324;Gabijėlė;GANDRIUKŲ;54616199708;Taip;3;1;0;4
18325;Gabijėlė;GANDRIUKŲ;82760473229;Taip;0;1;0;1
18326;Gabijėlė;GANDRIUKŲ;54950294060;Taip;0;1;0;1
18327;Gabijėlė;GANDRIUKŲ;1606787727;Taip;0;11;0;11
18328;Gabijėlė;GANDRIUKŲ;38806631565;Taip;0;2;0;2
18329;Gabijėlė;GANDRIUKŲ;43769142642;Taip;0;0;2;2
18330;Gabijėlė;GANDRIUKŲ;54152752437;Taip;5;2;0;7
18331;Gabijėlė;GANDRIUKŲ;36611753307;Taip;0;2;0;2
18332;Gabijėlė;GANDRIUKŲ;99562533454;Taip;0;1;0;1
18333;Gabijėlė;GANDRIUKŲ;77966124767;Taip;0;1;0;1
18334;Gabijėlė;GANDRIUKŲ;96909582388;Taip;0;1;0;1
18335;Gabijėlė;GANDRIUKŲ;26666095358;Taip;0;16;0;16
18336;Gabijėlė;GANDRIUKŲ;53845659478;Taip;2;5;1;8
18337;Gabijėlė;GANDRIUKŲ;68031503463;Taip;11;1;2;14
18338;Gabijėlė;GANDRIUKŲ;27958163601;Taip;0;0;4;4
18339;Gabijėlė;GANDRIUKŲ;12305494453;Taip;0;2;0;2
18340;Gabijėlė;GANDRIUKŲ;3694438650;Taip;0;0;4;4
18341;Gabijėlė;GANDRIUKŲ;96878883328;Taip;0;0;1;1
18342;Gabijėlė;GANDRIUKŲ;62369588485;Taip;0;1;13;14
18343;Gabijėlė;LAKŠTINGALIUKŲ;94564160237;Taip;0;3;0;3
18344;Gabijėlė;LAKŠTINGALIUKŲ;92624581275;Taip;0;1;0;1
18345;Gabijėlė;LAKŠTINGALIUKŲ;38094271521;Taip;16;0;1;17
18346;Gabijėlė;LAKŠTINGALIUKŲ;87667047750;Taip;0;5;1;6
18347;Gabijėlė;LAKŠTINGALIUKŲ;34977494652;Taip;0;14;0;14
18348;Gabijėlė;LAKŠTINGALIUKŲ;24034107401;Taip;8;0;3;11
18349;Gabijėlė;LAKŠTINGALIUKŲ;57442572439;Taip;2;2;0;4
18350;Gabijėlė;LAKŠTINGALIUKŲ;15974374755;Taip;0;2;0;2
18351;Gabijėlė;LAKŠTINGALIUKŲ;53325200270;Taip;3;3;0;6
18352;Gabijėlė;LAKŠTINGALIUKŲ;44723366493;Taip;0;0;2;2
18353;Gabijėlė;LAKŠTINGALIUKŲ;78764062355;Taip;3;2;3;8
18354;Gabijėlė;LAKŠTINGALIUKŲ;94096115282;Taip;0;1;0;1
18355;Gabijėlė;LAKŠTINGALIUKŲ;80865629865;Taip;0;2;0;2
18356;Gabijėlė;LAKŠTINGALIUKŲ;87107559087;Taip;0;6;0;6
18357;Gabijėlė;LAKŠTINGALIUKŲ;58162540225;Taip;7;1;0;8
18358;Gabijėlė;LAKŠTINGALIUKŲ;49652680743;Taip;10;2;0;12
18359;Gabijėlė;LAKŠTINGALIUKŲ;64279008849;Taip;0;1;0;1
18360;Gabijėlė;LAKŠTINGALIUKŲ;69244396670;Taip;0;2;8;10
18361;Gabijėlė;LAKŠTINGALIUKŲ;8729544694;Taip;0;0;3;3
18362;Gabijėlė;LAKŠTINGALIUKŲ;10026417844;Taip;5;4;0;9
18363;Gabijėlė;LAKŠTINGALIUKŲ;80650155819;Taip;0;8;0;8
18364;Gabijėlė;LAKŠTINGALIUKŲ;3114114973;Taip;0;8;0;8
18365;Gabijėlė;ŽVIRBLIUKŲ;4475530177;Taip;3;10;0;13
18366;Gabijėlė;ŽVIRBLIUKŲ;5743861607;Taip;3;0;0;3
18367;Gabijėlė;ŽVIRBLIUKŲ;7410541320;Taip;0;19;0;19
18368;Gabijėlė;ŽVIRBLIUKŲ;8036572198;Taip;0;20;0;20
18369;Gabijėlė;ŽVIRBLIUKŲ;4493192224;Taip;13;0;1;14
18370;Gabijėlė;ŽVIRBLIUKŲ;2491503656;Taip;0;6;0;6
18371;Gabijėlė;ŽVIRBLIUKŲ;9259964641;Taip;6;0;0;6
18372;Gabijėlė;ŽVIRBLIUKŲ;3268231136;Taip;0;18;0;18
18373;Gabijėlė;ŽVIRBLIUKŲ;8879972953;Taip;6;11;0;17
18374;Gabijėlė;ŽVIRBLIUKŲ;5332825339;Taip;11;0;0;11
18375;Gabijėlė;ŽVIRBLIUKŲ;9627906252;Taip;6;0;1;7
18376;Gabijėlė;ŽVIRBLIUKŲ;1725665169;Taip;1;0;0;1
18377;Gabijėlė;ŽVIRBLIUKŲ;2264669298;Taip;15;0;2;17
18378;Gabijėlė;ŽVIRBLIUKŲ;5942625633;Taip;0;0;3;3
18379;Gabijėlė;ŽVIRBLIUKŲ;7417179112;Taip;8;0;1;9
18380;Gabijėlė;ŽVIRBLIUKŲ;5387026410;Taip;5;0;4;9
18381;Gabijėlė;ŽVIRBLIUKŲ;8292463617;Taip;12;0;0;12
18382;Gabijėlė;GENIUKŲ;3445433386;Taip;0;13;0;13
18383;Gabijėlė;GENIUKŲ;1862655595;Taip;0;1;0;1
18384;Gabijėlė;GENIUKŲ;7312628876;Taip;0;3;0;3
18385;Gabijėlė;GENIUKŲ;1581688238;Taip;1;1;0;2
18386;Gabijėlė;GENIUKŲ;5301905117;Taip;0;9;0;9
18387;Gabijėlė;GENIUKŲ;3176075887;Taip;0;7;0;7
18388;Gabijėlė;GENIUKŲ;6866641272;Taip;4;0;0;4
18389;Gabijėlė;GENIUKŲ;9972967198;Taip;0;0;1;1
18390;Gabijėlė;GENIUKŲ;8305098808;Taip;7;0;0;7
18391;Gabijėlė;GENIUKŲ;4880174255;Taip;6;0;0;6
18392;Gabijėlė;GENIUKŲ;1589534853;Taip;6;2;1;9
18393;Gabijėlė;GENIUKŲ;3020599503;Taip;6;7;0;13
18394;Gabijėlė;GENIUKŲ;1922979974;Taip;6;0;0;6
18395;Gabijėlė;GENIUKŲ;6482824000;Taip;5;0;0;5
18396;Gabijėlė;GENIUKŲ;5962852108;Taip;1;0;0;1
18397;Gabijėlė;GENIUKŲ;7178676049;Taip;11;0;0;11
18398;Gabijėlė;DAGILIUKŲ;9348393550;Taip;4;4;1;9
18399;Gabijėlė;DAGILIUKŲ;4264925447;Taip;4;4;1;9
18400;Gabijėlė;DAGILIUKŲ;9120107749;Taip;15;0;0;15
18401;Gabijėlė;DAGILIUKŲ;7426579018;Taip;21;0;0;21
18402;Gabijėlė;DAGILIUKŲ;9783343968;Taip;0;0;1;1
18403;Gabijėlė;DAGILIUKŲ;3017939983;Taip;1;0;1;2
18404;Gabijėlė;DAGILIUKŲ;8384795164;Taip;12;0;0;12
18405;Gabijėlė;DAGILIUKŲ;4462129182;Taip;21;0;0;21
18406;Gabijėlė;DAGILIUKŲ;8662914262;Taip;15;1;0;16
18407;Gabijėlė;DAGILIUKŲ;9280283478;Taip;10;0;1;11
18408;Gabijėlė;DAGILIUKŲ;1988597157;Taip;20;0;0;20
18409;Gabijėlė;PELEDŽIUKŲ;94478599707;Taip;0;6;1;7
18410;Gabijėlė;PELEDŽIUKŲ;2067646395;Taip;0;6;2;8
18411;Gabijėlė;PELEDŽIUKŲ;1068556799;Taip;8;2;4;14
18412;Gabijėlė;PELEDŽIUKŲ;1171257945;Taip;3;2;2;7
18413;Gabijėlė;PELEDŽIUKŲ;8044682830;Taip;0;2;0;2
18414;Gabijėlė;PELEDŽIUKŲ;43109352262;Taip;0;8;0;8
18415;Gabijėlė;PELEDŽIUKŲ;1747282196;Taip;4;0;0;4
18416;Gabijėlė;PELEDŽIUKŲ;39679870094;Taip;6;1;0;7
18417;Gabijėlė;PELEDŽIUKŲ;36642141718;Taip;6;1;0;7
18418;Gabijėlė;PELEDŽIUKŲ;1491653325;Taip;0;1;1;2
18419;Gabijėlė;PELEDŽIUKŲ;1608940997;Taip;2;2;0;4
18420;Gabijėlė;PELEDŽIUKŲ;3610392405;Taip;11;0;0;11
18421;Gabijėlė;PELEDŽIUKŲ;4916964663;Taip;0;2;1;3
18422;Gabijėlė;PELEDŽIUKŲ;17443601729;Taip;0;0;1;1
18423;Gabijėlė;PELEDŽIUKŲ;1286307671;Taip;0;4;4;8
18424;Gabijėlė;PELEDŽIUKŲ;37544281230;Taip;12;0;1;13
18425;Gabijėlė;PELEDŽIUKŲ;8428069167;Taip;7;0;0;7
18426;Gabijėlė;PELEDŽIUKŲ;4726771205;Taip;0;1;5;6
18427;Gabijėlė;PELEDŽIUKŲ;24035160251;Taip;0;0;8;8
18428;Gabijėlė;PELEDŽIUKŲ;38497069329;Taip;2;0;0;2
18429;Gabijėlė;PELEDŽIUKŲ;54948441867;Taip;0;0;2;2
18430;Gabijėlė;PELEDŽIUKŲ;57559227292;Taip;1;0;0;1
18431;Gabijėlė;PELEDŽIUKŲ;65735862964;Taip;1;0;0;1
18432;Gabijėlė;PELEDŽIUKŲ;8746641978;Taip;0;2;0;2
18433;Gabijėlė;KREGZDŽIUKŲ;84945768423;Taip;0;2;2;4
18434;Gabijėlė;KREGZDŽIUKŲ;41661694634;Taip;11;2;1;14
18435;Gabijėlė;KREGZDŽIUKŲ;1743647754;Taip;0;4;1;5
18436;Gabijėlė;KREGZDŽIUKŲ;79544806044;Taip;0;0;1;1
18437;Gabijėlė;KREGZDŽIUKŲ;34683603878;Taip;5;2;0;7
18438;Gabijėlė;KREGZDŽIUKŲ;13013873198;Taip;0;8;0;8
18439;Gabijėlė;KREGZDŽIUKŲ;91643373754;Taip;5;2;3;10
18440;Gabijėlė;KREGZDŽIUKŲ;7298662616;Taip;0;1;1;2
18441;Gabijėlė;KREGZDŽIUKŲ;5884453557;Taip;0;2;0;2
18442;Gabijėlė;KREGZDŽIUKŲ;61217725255;Taip;0;0;1;1
18443;Gabijėlė;KREGZDŽIUKŲ;53576382572;Taip;0;2;0;2
18444;Gabijėlė;KREGZDŽIUKŲ;2958504770;Taip;0;0;2;2
18445;Gabijėlė;KREGZDŽIUKŲ;16720415967;Taip;12;0;1;13
18446;Gabijėlė;KREGZDŽIUKŲ;34998957585;Taip;16;0;2;18
18447;Gabijėlė;KREGZDŽIUKŲ;1770578935;Taip;0;2;0;2
18448;Gabijėlė;KREGZDŽIUKŲ;1455625997;Taip;0;1;2;3
18449;Gabijėlė;KREGZDŽIUKŲ;1937862725;Taip;4;0;1;5
18450;Gabijėlė;KREGZDŽIUKŲ;25732601952;Taip;0;1;0;1
18451;Gabijėlė;KREGZDŽIUKŲ;1217019582;Taip;0;1;2;3
18452;Gabijėlė;KREGZDŽIUKŲ;46552208567;Taip;0;4;0;4
18453;Gabijėlė;KREGZDŽIUKŲ;2075744479;Taip;1;0;0;1
18454;Gabijėlė;KREGZDŽIUKŲ;62457368692;Taip;2;0;0;2
18455;Gabijėlė;KREGZDŽIUKŲ;36447115547;Taip;0;1;2;3
18456;Gabijėlė;KREGZDŽIUKŲ;69294465170;Taip;0;5;0;5
18457;Gabijėlė;ZYLIUKŲ;41421082754;Taip;11;0;0;11
18458;Gabijėlė;ZYLIUKŲ;90540638931;Taip;11;0;0;11
18459;Gabijėlė;ZYLIUKŲ;20248530233;Taip;0;0;4;4
18460;Gabijėlė;ZYLIUKŲ;25691510343;Taip;1;0;2;3
18461;Gabijėlė;ZYLIUKŲ;70110432877;Taip;11;0;0;11
18462;Gabijėlė;ZYLIUKŲ;84464214049;Taip;0;8;0;8
18463;Gabijėlė;ZYLIUKŲ;62562568076;Taip;0;1;0;1
18464;Gabijėlė;ZYLIUKŲ;89100449385;Taip;0;1;0;1
18465;Gabijėlė;ZYLIUKŲ;1505873499;Taip;0;0;1;1
18466;Gabijėlė;ZYLIUKŲ;1523021309;Taip;0;1;1;2
18467;Gabijėlė;ZYLIUKŲ;32203098792;Taip;0;8;0;8
18468;Gabijėlė;ZYLIUKŲ;67189240970;Taip;0;4;0;4
18469;Gabijėlė;ZYLIUKŲ;1036201997;Taip;5;5;0;10
18470;Gabijėlė;ZYLIUKŲ;1240051312;Taip;0;0;3;3
18471;Gabijėlė;ZYLIUKŲ;60548215051;Taip;6;0;1;7
18472;Gabijėlė;ZYLIUKŲ;64168611850;Taip;3;1;2;6
18473;Gabijėlė;ZYLIUKŲ;1988838165;Taip;0;2;0;2
18474;Gabijėlė;ZYLIUKŲ;7778613039;Taip;0;2;0;2
18475;Gabijėlė;ZYLIUKŲ;1583728977;Taip;0;2;0;2
18476;Gabijėlė;ZYLIUKŲ;31458685084;Taip;0;2;0;2
18477;Gabijėlė;ZYLIUKŲ;16804922682;Taip;0;4;4;8
18478;Gabijėlė;ZYLIUKŲ;2010619186;Taip;0;0;2;2
18479;Gabijėlė;VOLUNGĖLIŲ;1779924073;Taip;5;1;0;6
18480;Gabijėlė;VOLUNGĖLIŲ;4166739739;Taip;0;9;0;9
18481;Gabijėlė;VOLUNGĖLIŲ;1492231030;Taip;0;9;0;9
18482;Gabijėlė;VOLUNGĖLIŲ;1317309811;Taip;10;2;0;12
18483;Gabijėlė;VOLUNGĖLIŲ;1523331860;Taip;0;2;0;2
18484;Gabijėlė;VOLUNGĖLIŲ;21740150080;Taip;0;9;0;9
18485;Gabijėlė;VOLUNGĖLIŲ;92191048844;Taip;4;0;0;4
18486;Gabijėlė;VOLUNGĖLIŲ;9683524530;Taip;16;0;3;19
18487;Gabijėlė;VOLUNGĖLIŲ;59837942520;Taip;10;0;0;10
18488;Gabijėlė;VOLUNGĖLIŲ;46021970332;Taip;10;0;0;10
18489;Gabijėlė;VOLUNGĖLIŲ;8480479946;Taip;15;0;0;15
18490;Gabijėlė;VOLUNGĖLIŲ;13265905500;Taip;6;0;2;8
18491;Gabijėlė;VOLUNGĖLIŲ;43737170074;Taip;6;0;2;8
18492;Gabijėlė;VOLUNGĖLIŲ;1480704497;Taip;0;6;0;6
18493;Gabijėlė;VOLUNGĖLIŲ;1669529717;Taip;3;0;0;3
18494;Gabijėlė;VOLUNGĖLIŲ;5704281727;Taip;3;0;5;8
18495;Gabijėlė;VOLUNGĖLIŲ;95685721388;Taip;0;3;0;3
18496;Gabijėlė;VOLUNGĖLIŲ;29328876924;Taip;10;0;0;10
18497;Gabijėlė;VOLUNGĖLIŲ;76416239647;Taip;0;0;1;1
18498;Gabijėlė;VOLUNGĖLIŲ;2102821834;Taip;0;0;1;1
18499;Gabijėlė;VOLUNGĖLIŲ;6271780003;Taip;0;2;0;2
18500;Gabijėlė;VOLUNGĖLIŲ;2051109865;Taip;4;10;0;14
18501;Gabijėlė;VOLUNGĖLIŲ;4662981914;Taip;21;0;0;21
18502;Gabijėlė;VOLUNGĖLIŲ;64252867351;Taip;0;17;0;17
18503;Gabijėlė;ANČIUKŲ;43123279348;Taip;0;8;0;8
18504;Gabijėlė;ANČIUKŲ;2036978425;Taip;0;0;4;4
18505;Gabijėlė;ANČIUKŲ;5219706067;Taip;5;9;0;14
18506;Gabijėlė;ANČIUKŲ;10796114623;Taip;0;8;0;8
18507;Gabijėlė;ANČIUKŲ;3454412432;Taip;6;0;0;6
18508;Gabijėlė;ANČIUKŲ;4752631976;Taip;0;2;1;3
18509;Gabijėlė;ANČIUKŲ;9822093084;Taip;6;1;0;7
18510;Gabijėlė;ANČIUKŲ;1415184607;Taip;10;1;2;13
18511;Gabijėlė;ANČIUKŲ;85836097485;Taip;14;0;1;15
18512;Gabijėlė;ANČIUKŲ;28017865889;Taip;0;6;0;6
18513;Gabijėlė;ANČIUKŲ;1917587420;Taip;0;19;0;19
18514;Gabijėlė;ANČIUKŲ;1465584524;Taip;8;0;0;8
18515;Gabijėlė;ANČIUKŲ;5783373671;Taip;0;9;0;9
18516;Gabijėlė;ANČIUKŲ;7948343328;Taip;0;0;13;13
18517;Gabijėlė;ANČIUKŲ;2052892422;Taip;0;4;0;4
18518;Gabijėlė;ANČIUKŲ;8111239476;Taip;18;0;1;19
18519;Gabijėlė;ANČIUKŲ;6766770793;Taip;6;0;1;7
18520;Gabijėlė;ANČIUKŲ;8778396292;Taip;6;0;0;6
18521;Gabijėlė;ANČIUKŲ;4085049535;Taip;0;17;0;17
18522;Gabijėlė;BALANDŽIUKŲ;4110081664;Taip;5;0;0;5
18523;Gabijėlė;BALANDŽIUKŲ;9157819780;Taip;10;3;0;13
18524;Gabijėlė;BALANDŽIUKŲ;1045338865;Taip;5;0;0;5
18525;Gabijėlė;BALANDŽIUKŲ;4330624300;Taip;0;0;21;21
18526;Gabijėlė;BALANDŽIUKŲ;33124420723;Taip;0;1;8;9
18527;Gabijėlė;BALANDŽIUKŲ;2097260657;Taip;5;0;0;5
18528;Gabijėlė;BALANDŽIUKŲ;8131229306;Taip;8;0;4;12
18529;Gabijėlė;BALANDŽIUKŲ;8525869648;Taip;11;2;0;13
18530;Gabijėlė;BALANDŽIUKŲ;1010721404;Taip;2;0;0;2
18531;Gabijėlė;BALANDŽIUKŲ;56914218692;Taip;0;0;6;6
18532;Gabijėlė;BALANDŽIUKŲ;2070050969;Taip;0;1;0;1
18533;Gabijėlė;BALANDŽIUKŲ;2260623869;Taip;5;1;11;17
18534;Gabijėlė;BALANDŽIUKŲ;7144977279;Taip;6;0;0;6
18535;Gabijėlė;BALANDŽIUKŲ;15049855022;Taip;6;1;0;7
18536;Gabijėlė;BALANDŽIUKŲ;2776579713;Taip;5;0;0;5
18537;Gabijėlė;BALANDŽIUKŲ;7977751362;Taip;5;0;0;5
18538;Gabijėlė;BALANDŽIUKŲ;5906952432;Taip;5;0;0;5
18539;Gabijėlė;BALANDŽIUKŲ;9197020006;Taip;0;2;0;2
18540;Gabijėlė;VYTURIUKŲ;2059859352;Taip;1;0;0;1
18541;Gabijėlė;VYTURIUKŲ;3484413830;Taip;0;1;1;2
18542;Gabijėlė;VYTURIUKŲ;1859288888;Taip;6;0;0;6
18543;Gabijėlė;VYTURIUKŲ;44322663690;Taip;5;0;1;6
18544;Gabijėlė;VYTURIUKŲ;1479311429;Taip;0;11;0;11
18545;Gabijėlė;VYTURIUKŲ;4765125810;Taip;3;0;0;3
18546;Gabijėlė;VYTURIUKŲ;1219257874;Taip;12;0;0;12
18547;Gabijėlė;VYTURIUKŲ;39269336820;Taip;1;2;0;3
18548;Gabijėlė;VYTURIUKŲ;1829866148;Taip;0;0;1;1
18549;Gabijėlė;VYTURIUKŲ;1949644078;Taip;5;3;0;8
18550;Gabijėlė;VYTURIUKŲ;47989272121;Taip;0;12;0;12
18551;Gabijėlė;VYTURIUKŲ;5736000160;Taip;12;0;0;12
18552;Gabijėlė;VYTURIUKŲ;9320327120;Taip;10;0;0;10
18553;Gabijėlė;VYTURIUKŲ;4632508075;Taip;2;10;0;12
18554;Gabijėlė;VYTURIUKŲ;1426802917;Taip;19;0;0;19
18555;Gabijėlė;VYTURIUKŲ;41212490042;Taip;10;0;3;13
18556;Gabijėlė;VYTURIUKŲ;1852597048;Taip;10;1;0;11
18557;Gabijėlė;VYTURIUKŲ;1287165224;Taip;0;5;0;5
18558;Gabijėlė;VYTURIUKŲ;34609028374;Taip;15;1;0;16
18559;Gabijėlė;VYTURIUKŲ;48342584892;Taip;8;0;1;9
18560;Gabijėlė;VYTURIUKŲ;1185452849;Taip;3;0;0;3
18561;Gabijėlė;VYTURIUKŲ;11048695176;Taip;8;0;0;8
18562;Gabijėlė;VYTURIUKŲ;6492199649;Taip;6;0;0;6
18563;Pilaitukas;BITUTĖS;27134663020;Taip;21;0;0;21
18564;Pilaitukas;BITUTĖS;93292073339;Taip;21;0;0;21
18565;Pilaitukas;BITUTĖS;25872504305;Taip;11;0;0;11
18566;Pilaitukas;BITUTĖS;99558991322;Taip;7;4;0;11
18567;Pilaitukas;BITUTĖS;46467461875;Taip;20;1;0;21
18568;Pilaitukas;BITUTĖS;97868106590;Taip;5;1;1;7
18569;Pilaitukas;BITUTĖS;56237836622;Taip;0;2;0;2
18570;Pilaitukas;BITUTĖS;98123777614;Taip;8;0;0;8
18571;Pilaitukas;BITUTĖS;29035791508;Taip;13;1;1;15
18572;Pilaitukas;BITUTĖS;88894299577;Taip;5;0;0;5
18573;Pilaitukas;BITUTĖS;49882457703;Taip;21;0;0;21
18574;Pilaitukas;BITUTĖS;98876022289;Taip;8;0;0;8
18575;Pilaitukas;BITUTĖS;32580431386;Taip;8;1;0;9
18576;Pilaitukas;BITUTĖS;61458733284;Taip;11;0;0;11
18577;Pilaitukas;BITUTĖS;68262699910;Taip;0;0;2;2
18578;Pilaitukas;BITUTĖS;36677686051;Taip;10;1;0;11
18579;Pilaitukas;BITUTĖS;89335569661;Taip;5;0;0;5
18580;Pilaitukas;BITUTĖS;74933839730;Taip;5;0;0;5
18581;Pilaitukas;BITUTĖS;26318820010;Taip;9;0;0;9
18582;Pilaitukas;BITUTĖS;61725559703;Taip;4;5;0;9
18583;Pilaitukas;BITUTĖS;68819621853;Taip;10;0;0;10
18584;Pilaitukas;BITUTĖS;17314387753;Taip;5;0;2;7
18585;Pilaitukas;BITUTĖS;1854471823;Taip;0;2;1;3
18586;Pilaitukas;BITUTĖS;95753711905;Taip;0;2;0;2
18587;Pilaitukas;ZUIKUČIAI;66377321935;Taip;0;1;0;1
18588;Pilaitukas;ZUIKUČIAI;27233065857;Taip;0;1;0;1
18589;Pilaitukas;ZUIKUČIAI;74367577786;Taip;4;1;0;5
18590;Pilaitukas;ZUIKUČIAI;37415672544;Taip;6;0;0;6
18591;Pilaitukas;ZUIKUČIAI;50368168240;Taip;2;1;1;4
18592;Pilaitukas;ZUIKUČIAI;21795184411;Taip;10;3;0;13
18593;Pilaitukas;ZUIKUČIAI;63470473930;Taip;0;3;0;3
18594;Pilaitukas;ZUIKUČIAI;49728283339;Taip;5;0;0;5
18595;Pilaitukas;ZUIKUČIAI;49542027658;Taip;2;1;3;6
18596;Pilaitukas;ZUIKUČIAI;62992423192;Taip;4;1;1;6
18597;Pilaitukas;ZUIKUČIAI;6913383121;Ne;0;3;0;3
18598;Pilaitukas;ZUIKUČIAI;53049608654;Taip;0;1;8;9
18599;Pilaitukas;ZUIKUČIAI;79398058989;Taip;0;1;3;4
18600;Pilaitukas;ZUIKUČIAI;8441380474;Taip;0;5;0;5
18601;Pilaitukas;ZUIKUČIAI;1286286153;Taip;0;0;1;1
18602;Pilaitukas;ZUIKUČIAI;3723836301;Taip;1;1;0;2
18603;Pilaitukas;ZUIKUČIAI;1896452184;Taip;0;6;0;6
18604;Pilaitukas;ZUIKUČIAI;81347327136;Taip;0;1;0;1
18605;Pilaitukas;ANČIUKAI;5949185075;Taip;0;1;0;1
18606;Pilaitukas;ANČIUKAI;36338976218;Taip;5;1;0;6
18607;Pilaitukas;ANČIUKAI;1114477688;Taip;15;1;0;16
18608;Pilaitukas;ANČIUKAI;1512181401;Taip;0;0;2;2
18609;Pilaitukas;ANČIUKAI;3821748678;Taip;6;0;0;6
18610;Pilaitukas;ANČIUKAI;6222888898;Taip;5;0;0;5
18611;Pilaitukas;ANČIUKAI;8319676743;Taip;0;1;0;1
18612;Pilaitukas;ANČIUKAI;4505384039;Taip;6;0;2;8
18613;Pilaitukas;ANČIUKAI;5206439753;Taip;0;3;1;4
18614;Pilaitukas;ANČIUKAI;79485847381;Taip;6;0;2;8
18615;Pilaitukas;ANČIUKAI;5211988291;Taip;1;0;0;1
18616;Pilaitukas;ANČIUKAI;2117570444;Taip;0;1;1;2
18617;Pilaitukas;ANČIUKAI;87760608710;Taip;10;1;7;18
18618;Pilaitukas;ANČIUKAI;7909465673;Taip;8;1;0;9
18619;Pilaitukas;ANČIUKAI;2298935154;Taip;1;0;1;2
18620;Pilaitukas;ANČIUKAI;4694691187;Taip;5;1;1;7
18621;Pilaitukas;ANČIUKAI;9224653856;Taip;6;1;1;8
18622;Pilaitukas;MEŠKIUKAI;57931719105;Taip;9;2;0;11
18623;Pilaitukas;MEŠKIUKAI;14554050141;Taip;3;0;0;3
18624;Pilaitukas;MEŠKIUKAI;9015675095;Taip;7;0;0;7
18625;Pilaitukas;MEŠKIUKAI;2929868229;Taip;2;0;0;2
18626;Pilaitukas;MEŠKIUKAI;1135880899;Taip;13;0;0;13
18627;Pilaitukas;MEŠKIUKAI;4505147961;Taip;4;0;0;4
18628;Pilaitukas;MEŠKIUKAI;9618329726;Taip;7;0;1;8
18629;Pilaitukas;MEŠKIUKAI;6514784647;Taip;0;0;1;1
18630;Pilaitukas;MEŠKIUKAI;9732741366;Taip;5;0;0;5
18631;Pilaitukas;MEŠKIUKAI;4038320896;Taip;0;0;2;2
18632;Pilaitukas;MEŠKIUKAI;3794882532;Taip;8;0;0;8
18633;Pilaitukas;MEŠKIUKAI;18466900688;Taip;0;8;0;8
18634;Pilaitukas;MEŠKIUKAI;2736736697;Taip;15;0;1;16
18635;Pilaitukas;MEŠKIUKAI;39600380611;Taip;8;0;6;14
18636;Pilaitukas;MEŠKIUKAI;5604992163;Taip;8;2;0;10
18637;Pilaitukas;MEŠKIUKAI;9450834035;Taip;8;2;0;10
18638;Pilaitukas;MEŠKIUKAI;5689385925;Taip;16;1;0;17
18639;Pilaitukas;MEŠKIUKAI;1003278169;Taip;10;0;0;10
18640;Pilaitukas;MEŠKIUKAI;6117985788;Taip;13;0;1;14
18641;Pilaitukas;MEŠKIUKAI;9924612250;Taip;7;0;0;7
18642;Pilaitukas;ŽUVYTĖS;10478661553;Taip;5;0;0;5
18643;Pilaitukas;ŽUVYTĖS;4068489824;Taip;7;0;0;7
18644;Pilaitukas;ŽUVYTĖS;81748034503;Taip;0;3;0;3
18645;Pilaitukas;ŽUVYTĖS;44575161837;Taip;0;1;1;2
18646;Pilaitukas;ŽUVYTĖS;16099834356;Taip;0;19;0;19
18647;Pilaitukas;ŽUVYTĖS;83211068266;Taip;0;1;0;1
18648;Pilaitukas;ŽUVYTĖS;75122672596;Taip;0;0;1;1
18649;Pilaitukas;ŽUVYTĖS;20879249256;Taip;5;0;0;5
18650;Pilaitukas;ŽUVYTĖS;7328603850;Taip;0;1;0;1
18651;Pilaitukas;ŽUVYTĖS;61755266054;Taip;10;1;0;11
18652;Pilaitukas;ŽUVYTĖS;63984542506;Taip;4;1;1;6
18653;Pilaitukas;ŽUVYTĖS;95470553230;Taip;4;0;1;5
18654;Pilaitukas;ŽUVYTĖS;93690180882;Taip;0;1;0;1
18655;Pilaitukas;ŽUVYTĖS;86867736047;Taip;5;1;0;6
18656;Pilaitukas;ŽUVYTĖS;20697780436;Ne;5;1;1;7
18657;Pilaitukas;ŽUVYTĖS;17844195687;Taip;0;1;0;1
18658;Pilaitukas;PAUKŠTELIAI;9471549377;Taip;13;1;0;14
18659;Pilaitukas;PAUKŠTELIAI;76405230943;Taip;0;0;2;2
18660;Pilaitukas;PAUKŠTELIAI;63957573208;Taip;0;1;0;1
18661;Pilaitukas;PAUKŠTELIAI;15970261850;Taip;0;1;0;1
18662;Pilaitukas;PAUKŠTELIAI;67100267095;Taip;0;0;3;3
18663;Pilaitukas;PAUKŠTELIAI;98711809989;Taip;8;1;0;9
18664;Pilaitukas;PAUKŠTELIAI;59647179478;Taip;1;0;2;3
18665;Pilaitukas;PAUKŠTELIAI;18957334122;Taip;4;1;1;6
18666;Pilaitukas;PAUKŠTELIAI;46383254281;Taip;0;0;1;1
18667;Pilaitukas;PAUKŠTELIAI;61157601075;Taip;0;1;0;1
18668;Pilaitukas;PAUKŠTELIAI;97891667232;Taip;3;1;2;6
18669;Pilaitukas;PAUKŠTELIAI;41623603103;Taip;0;1;1;2
18670;Pilaitukas;PAUKŠTELIAI;67880125472;Taip;0;0;1;1
18671;Pilaitukas;PAUKŠTELIAI;89662617221;Taip;2;5;0;7
18672;Pilaitukas;PAUKŠTELIAI;40315977143;Taip;0;1;0;1
18673;Pilaitukas;PAUKŠTELIAI;1836597284;Ne;5;1;0;6
18674;Pilaitukas;PAUKŠTELIAI;86837043817;Taip;0;9;0;9
18675;Pilaitukas;PAUKŠTELIAI;94197429703;Taip;5;9;0;14
18676;Pilaitukas;BORUŽĖLĖS;98045145204;Taip;0;1;3;4
18677;Pilaitukas;BORUŽĖLĖS;26354100027;Taip;6;0;0;6
18678;Pilaitukas;BORUŽĖLĖS;2145561638;Taip;13;2;0;15
18679;Pilaitukas;BORUŽĖLĖS;14937983736;Taip;0;1;3;4
18680;Pilaitukas;BORUŽĖLĖS;1704733670;Ne;5;0;0;5
18681;Pilaitukas;BORUŽĖLĖS;8693280134;Taip;0;0;15;15
18682;Pilaitukas;BORUŽĖLĖS;2308673826;Taip;0;1;3;4
18683;Pilaitukas;BORUŽĖLĖS;1714711904;Taip;6;0;1;7
18684;Pilaitukas;BORUŽĖLĖS;2436416327;Taip;12;0;0;12
18685;Pilaitukas;BORUŽĖLĖS;2561804291;Taip;9;0;0;9
18686;Pilaitukas;BORUŽĖLĖS;9414846817;Taip;11;0;3;14
18687;Pilaitukas;BORUŽĖLĖS;56069293343;Taip;7;0;0;7
18688;Pilaitukas;BORUŽĖLĖS;7156205658;Taip;11;1;0;12
18689;Pilaitukas;BORUŽĖLĖS;1142014148;Taip;1;2;0;3
18690;Pilaitukas;BORUŽĖLĖS;95439358242;Ne;5;0;0;5
18691;Pilaitukas;BORUŽĖLĖS;6024861998;Taip;11;0;0;11
18692;Pilaitukas;BORUŽĖLĖS;58416972423;Taip;17;0;0;17
18693;Pilaitukas;BORUŽĖLĖS;1779631590;Taip;0;1;0;1
18694;Pilaitukas;BORUŽĖLĖS;3198896300;Taip;10;9;2;21
18695;Pilaitukas;DRUGELIAI;70499278669;Taip;0;5;7;12
18696;Pilaitukas;DRUGELIAI;86192743256;Taip;0;6;0;6
18697;Pilaitukas;DRUGELIAI;1126288017;Taip;0;0;3;3
18698;Pilaitukas;DRUGELIAI;89880758183;Taip;0;0;2;2
18699;Pilaitukas;DRUGELIAI;1726899445;Taip;2;0;0;2
18700;Pilaitukas;DRUGELIAI;1586157196;Taip;0;6;0;6
18701;Pilaitukas;DRUGELIAI;7961518607;Taip;0;1;0;1
18702;Pilaitukas;DRUGELIAI;7082054458;Taip;0;1;0;1
18703;Pilaitukas;DRUGELIAI;1290119150;Taip;17;0;0;17
18704;Pilaitukas;DRUGELIAI;64601938351;Taip;0;3;0;3
18705;Pilaitukas;DRUGELIAI;64496490473;Taip;0;1;0;1
18706;Pilaitukas;DRUGELIAI;93217431744;Taip;5;2;3;10
18707;Pilaitukas;DRUGELIAI;62416017620;Taip;0;2;3;5
18708;Pilaitukas;DRUGELIAI;58250008277;Taip;11;0;3;14
18709;Pilaitukas;DRUGELIAI;38456484551;Taip;0;2;0;2
18710;Pilaitukas;DRUGELIAI;7838787153;Taip;9;0;1;10
18711;Pilaitukas;DRUGELIAI;2613078582;Taip;0;6;0;6
18712;Pilaitukas;PELIUKAI;89730708991;Taip;5;0;0;5
18713;Pilaitukas;PELIUKAI;71302602535;Taip;0;12;0;12
18714;Pilaitukas;PELIUKAI;54387359229;Taip;10;1;0;11
18715;Pilaitukas;PELIUKAI;29229117661;Taip;0;6;0;6
18716;Pilaitukas;PELIUKAI;12327235652;Ne;0;3;0;3
18717;Pilaitukas;PELIUKAI;26063381713;Taip;10;3;0;13
18718;Pilaitukas;PELIUKAI;90148331957;Taip;7;1;0;8
18719;Pilaitukas;PELIUKAI;89719236172;Taip;0;8;0;8
18720;Pilaitukas;PELIUKAI;49084081967;Taip;4;0;0;4
18721;Pilaitukas;PELIUKAI;3685682772;Taip;0;21;0;21
18722;Pilaitukas;PELIUKAI;54706920576;Taip;2;0;0;2
18723;Pilaitukas;PELIUKAI;1168958446;Taip;6;0;0;6
18724;Pilaitukas;PELIUKAI;8152280709;Taip;4;1;0;5
18725;Pilaitukas;PELIUKAI;1613536796;Taip;10;0;1;11
18726;Pilaitukas;PELIUKAI;42514613325;Taip;11;1;0;12
18727;Pilaitukas;PELIUKAI;1611616941;Taip;0;2;0;2
18728;Pilaitukas;PELIUKAI;1726805610;Taip;3;0;0;3
18729;Pilaitukas;KAČIUKAI;74264627858;Taip;15;6;0;21
18730;Pilaitukas;KAČIUKAI;71072645939;Taip;0;1;0;1
18731;Pilaitukas;KAČIUKAI;70465651068;Taip;0;1;0;1
18732;Pilaitukas;KAČIUKAI;4283157555;Taip;5;0;0;5
18733;Pilaitukas;KAČIUKAI;90472705680;Taip;2;1;0;3
18734;Pilaitukas;KAČIUKAI;92823052045;Taip;2;0;0;2
18735;Pilaitukas;KAČIUKAI;82030031331;Taip;1;0;0;1
18736;Pilaitukas;KAČIUKAI;28902841059;Taip;2;1;0;3
18737;Pilaitukas;KAČIUKAI;78048449266;Taip;0;2;0;2
18738;Pilaitukas;KAČIUKAI;82688660737;Taip;0;1;0;1
18739;Pilaitukas;KAČIUKAI;1508672511;Taip;4;0;0;4
18740;Pilaitukas;KAČIUKAI;34346418650;Taip;2;0;0;2
18741;Pilaitukas;KAČIUKAI;9496336005;Taip;0;6;0;6
18742;Pilaitukas;KAČIUKAI;6069797837;Taip;11;0;0;11
18743;Pilaitukas;SAULUTĖS;6646474196;Taip;15;0;1;16
18744;Pilaitukas;SAULUTĖS;9414051187;Taip;6;4;0;10
18745;Pilaitukas;SAULUTĖS;3037850837;Taip;12;0;0;12
18746;Pilaitukas;SAULUTĖS;4745358362;Taip;15;0;0;15
18747;Pilaitukas;SAULUTĖS;1677962644;Taip;15;0;0;15
18748;Pilaitukas;SAULUTĖS;7568744500;Taip;5;0;0;5
18749;Pilaitukas;SAULUTĖS;5407354218;Taip;7;0;0;7
18750;Pilaitukas;SAULUTĖS;6525191057;Taip;13;0;0;13
18751;Pilaitukas;SAULUTĖS;6838035491;Taip;14;0;0;14
18752;Pilaitukas;SAULUTĖS;1611371690;Taip;7;0;1;8
18753;Pilaitukas;SAULUTĖS;3483758882;Taip;7;5;0;12
18754;Pilaitukas;SAULUTĖS;7853910193;Taip;11;0;4;15
18755;Pilaitukas;SAULUTĖS;5710747769;Taip;16;0;1;17
18756;Pilaitukas;SAULUTĖS;9974310580;Taip;7;3;0;10
18757;Pilaitukas;SAULUTĖS;9126553732;Taip;15;0;0;15
18758;Pilaitukas;SAULUTĖS;7438112270;Taip;11;0;2;13
18759;Pilaitukas;SAULUTĖS;7594484959;Taip;8;4;0;12
18760;Pilaitukas;MENULIUKAI;2406183145;Taip;0;1;0;1
18761;Pilaitukas;MENULIUKAI;2379660463;Taip;0;1;0;1
18762;Pilaitukas;MENULIUKAI;2862447956;Taip;13;0;0;13
18763;Pilaitukas;MENULIUKAI;8727175656;Taip;12;0;0;12
18764;Pilaitukas;MENULIUKAI;5353687011;Taip;6;0;0;6
18765;Pilaitukas;MENULIUKAI;9988041515;Taip;9;1;2;12
18766;Pilaitukas;MENULIUKAI;9108428738;Taip;9;1;2;12
18767;Pilaitukas;MENULIUKAI;1585341963;Taip;10;0;0;10
18768;Pilaitukas;MENULIUKAI;9260893320;Taip;0;0;1;1
18769;Pilaitukas;MENULIUKAI;5640802570;Taip;0;0;6;6
18770;Pilaitukas;MENULIUKAI;9878890346;Taip;0;0;1;1
18771;Pilaitukas;MENULIUKAI;7334494990;Taip;17;0;0;17
18772;Pilaitukas;MENULIUKAI;8207194955;Taip;9;0;0;9
18773;Pilaitukas;MENULIUKAI;1607454890;Taip;5;0;0;5
18774;Pilaitukas;MENULIUKAI;6102253106;Taip;5;0;1;6
18775;Pilaitukas;ĖŽIUKAI;9793278788;Taip;0;0;1;1
18776;Pilaitukas;ĖŽIUKAI;5740951665;Taip;10;5;5;20
18777;Pilaitukas;ĖŽIUKAI;6308557885;Taip;17;0;0;17
18778;Pilaitukas;ĖŽIUKAI;6514731102;Taip;17;0;0;17
18779;Pilaitukas;ĖŽIUKAI;4591799893;Taip;17;0;0;17
18780;Pilaitukas;ĖŽIUKAI;9653647227;Taip;15;1;5;21
18781;Pilaitukas;ĖŽIUKAI;5326689274;Taip;15;1;5;21
18782;Pilaitukas;ĖŽIUKAI;3541354283;Taip;5;4;0;9
18783;Pilaitukas;ĖŽIUKAI;5988165204;Taip;9;0;0;9
18784;Pilaitukas;ĖŽIUKAI;4082490488;Taip;6;0;1;7
18785;Pilaitukas;ĖŽIUKAI;1729494874;Taip;0;0;1;1
18786;Pilaitukas;ĖŽIUKAI;2242454299;Taip;1;0;0;1
18787;Pilaitukas;ĖŽIUKAI;3345387791;Taip;9;0;0;9
18788;Pilaitukas;ĖŽIUKAI;3913169122;Taip;1;0;0;1
18789;Pilaitukas;ĖŽIUKAI;7342388716;Taip;1;0;1;2
18790;Pilaitukas;ĖŽIUKAI;1253300093;Taip;0;0;1;1
18791;Pilaitukas;ĖŽIUKAI;9038324313;Taip;10;0;0;10
18792;"Naujųjų verkių";Lopšelinė;9840473841;Taip;5;0;0;5
18793;"Naujųjų verkių";Lopšelinė;63932903598;Taip;5;0;0;5
18794;"Naujųjų verkių";Lopšelinė;3572188688;Taip;1;0;0;1
18795;"Naujųjų verkių";Lopšelinė;7872515649;Taip;21;0;0;21
18796;"Naujųjų verkių";Lopšelinė;9200073539;Taip;5;0;0;5
18797;"Naujųjų verkių";Lopšelinė;1693323032;Taip;10;0;0;10
18798;"Naujųjų verkių";Lopšelinė;1536075084;Taip;0;2;0;2
18799;"Naujųjų verkių";Lopšelinė;7010430969;Taip;3;6;0;9
18800;"Naujųjų verkių";Lopšelinė;9462019924;Taip;0;2;0;2
18801;"Naujųjų verkių";Lopšelinė;7734802846;Taip;0;7;0;7
18802;"Naujųjų verkių";Darželinė;52116449181;Taip;0;3;0;3
18803;"Naujųjų verkių";Darželinė;31334483791;Taip;0;9;0;9
18804;"Naujųjų verkių";Darželinė;91710448735;Taip;0;6;0;6
18805;"Naujųjų verkių";Darželinė;70974231925;Taip;0;1;0;1
18806;"Naujųjų verkių";Darželinė;96956603806;Taip;0;3;0;3
18807;"Naujųjų verkių";Darželinė;2636744220;Taip;7;0;0;7
18808;"Naujųjų verkių";Darželinė;1273331977;Taip;2;0;0;2
18809;"Naujųjų verkių";Darželinė;45101251137;Taip;0;4;0;4
18810;"Naujųjų verkių";Darželinė;1321551506;Taip;0;9;0;9
18811;"Naujųjų verkių";Darželinė;1061601585;Taip;0;3;0;3
18812;"Naujųjų verkių";Darželinė;4727762605;Taip;0;8;0;8
18813;"Naujųjų verkių";Darželinė;19360482785;Taip;0;12;0;12
18814;"Naujųjų verkių";Darželinė;49937307547;Taip;5;14;0;19
18815;Švelnukas;Pelėdžiukai;97312326369;Taip;0;4;0;4
18816;Švelnukas;Pelėdžiukai;35501839416;Taip;0;1;2;3
18817;Švelnukas;Pelėdžiukai;1102317067;Taip;0;0;2;2
18818;Švelnukas;Pelėdžiukai;54159329795;Taip;0;3;0;3
18819;Švelnukas;Pelėdžiukai;56353311492;Taip;6;0;8;14
18820;Švelnukas;Pelėdžiukai;73720184241;Taip;0;1;0;1
18821;Švelnukas;Pelėdžiukai;94832155557;Taip;9;0;5;14
18822;Švelnukas;Pelėdžiukai;1398812288;Taip;5;11;0;16
18823;Švelnukas;Pelėdžiukai;4006769867;Taip;6;8;0;14
18824;Švelnukas;Pelėdžiukai;39249642586;Taip;7;0;4;11
18825;Švelnukas;Pelėdžiukai;81569596159;Taip;0;0;1;1
18826;Švelnukas;Pelėdžiukai;12011187563;Taip;7;0;5;12
18827;Švelnukas;Pelėdžiukai;59229958089;Taip;6;3;0;9
18828;Švelnukas;Pelėdžiukai;57026029080;Taip;0;6;0;6
18829;Švelnukas;Pelėdžiukai;30679686753;Taip;0;1;5;6
18830;Švelnukas;Pelėdžiukai;32473329970;Taip;0;10;0;10
18831;Švelnukas;Pelėdžiukai;50326830712;Taip;0;0;6;6
18832;Švelnukas;Pelėdžiukai;88430357193;Taip;8;0;0;8
18833;Švelnukas;Pelėdžiukai;52477782880;Taip;9;0;0;9
18834;Švelnukas;Pelėdžiukai;2123115761;Taip;9;0;1;10
18835;Švelnukas;Ežiukai;65123682919;Taip;0;1;0;1
18836;Švelnukas;Ežiukai;59113412340;Ne;0;2;0;2
18837;Švelnukas;Ežiukai;95227249637;Taip;0;8;0;8
18838;Švelnukas;Ežiukai;68248605297;Taip;0;1;0;1
18839;Švelnukas;Ežiukai;94799905208;Taip;0;3;0;3
18840;Švelnukas;Ežiukai;41867077386;Taip;18;0;0;18
18841;Švelnukas;Ežiukai;41365412569;Taip;0;5;0;5
18842;Švelnukas;Ežiukai;55258226673;Taip;0;11;0;11
18843;Švelnukas;Ežiukai;25374873288;Taip;0;0;5;5
18844;Švelnukas;Ežiukai;6670022613;Taip;5;0;0;5
18845;Švelnukas;Ežiukai;68667782880;Taip;5;0;4;9
18846;Švelnukas;Ežiukai;15308444101;Taip;6;0;2;8
18847;Švelnukas;Ežiukai;6282389058;Taip;0;0;4;4
18848;Švelnukas;Ežiukai;84293714890;Taip;1;0;3;4
18849;Švelnukas;Ežiukai;1755384216;Taip;0;0;12;12
18850;Švelnukas;Ežiukai;23795609183;Taip;5;0;0;5
18851;Švelnukas;Švelnukai;50827155608;Taip;0;4;0;4
18852;Švelnukas;Švelnukai;67100479000;Taip;0;0;2;2
18853;Švelnukas;Švelnukai;37816683435;Taip;0;0;1;1
18854;Švelnukas;Švelnukai;6143538084;Taip;0;3;2;5
18855;Švelnukas;Švelnukai;16527728167;Taip;4;7;0;11
18856;Švelnukas;Švelnukai;55308151865;Taip;7;0;0;7
18857;Švelnukas;Švelnukai;2637595842;Taip;8;0;0;8
18858;Švelnukas;Švelnukai;75449064275;Taip;3;0;0;3
18859;Švelnukas;Švelnukai;64875997364;Taip;0;7;0;7
18860;Švelnukas;Švelnukai;32133621075;Taip;0;0;6;6
18861;Švelnukas;Švelnukai;94946505347;Taip;0;1;0;1
18862;Švelnukas;Švelnukai;96723762013;Taip;0;4;0;4
18863;Švelnukas;Švelnukai;85650663405;Taip;8;1;0;9
18864;Švelnukas;Švelnukai;25672016811;Ne;0;9;0;9
18865;Švelnukas;Švelnukai;52909536851;Taip;0;0;1;1
18866;Švelnukas;Švelnukai;80109886791;Taip;0;0;1;1
18867;Švelnukas;Švelnukai;14616126488;Taip;0;1;0;1
18868;Švelnukas;Švelnukai;84455755281;Taip;0;2;0;2
18869;Švelnukas;Švelnukai;94117802668;Taip;0;1;0;1
18870;Švelnukas;Švelnukai;1795843646;Ne;0;11;1;12
18871;Švelnukas;Boružiukai;1951447127;Taip;6;0;0;6
18872;Švelnukas;Boružiukai;8681264696;Taip;5;2;0;7
18873;Švelnukas;Boružiukai;4711482287;Taip;14;0;3;17
18874;Švelnukas;Boružiukai;8510195634;Taip;1;0;6;7
18875;Švelnukas;Boružiukai;3849957906;Taip;11;0;0;11
18876;Švelnukas;Boružiukai;5550841477;Taip;15;0;0;15
18877;Švelnukas;Boružiukai;5974324302;Taip;7;0;3;10
18878;Švelnukas;Boružiukai;9722532034;Taip;15;0;0;15
18879;Švelnukas;Boružiukai;2400781175;Taip;16;0;0;16
18880;Švelnukas;Boružiukai;1264256177;Taip;9;0;11;20
18881;Švelnukas;Boružiukai;8847738918;Taip;11;10;0;21
18882;Švelnukas;Boružiukai;1332533332;Taip;11;0;0;11
18883;Švelnukas;Boružiukai;8787505507;Taip;0;0;1;1
18884;Švelnukas;Boružiukai;4134678301;Taip;2;0;0;2
18885;Švelnukas;Boružiukai;8458233793;Taip;0;0;1;1
18886;Švelnukas;Smalsučiai;76418408780;Taip;0;1;0;1
18887;Švelnukas;Smalsučiai;82202942341;Taip;0;6;0;6
18888;Švelnukas;Smalsučiai;63394075248;Taip;0;1;4;5
18889;Švelnukas;Smalsučiai;53619702326;Taip;0;10;0;10
18890;Švelnukas;Smalsučiai;87770765141;Taip;0;1;2;3
18891;Švelnukas;Smalsučiai;47645479348;Taip;0;5;0;5
18892;Švelnukas;Smalsučiai;26077395334;Taip;8;8;0;16
18893;Švelnukas;Smalsučiai;15711256627;Taip;2;5;0;7
18894;Švelnukas;Smalsučiai;76563731138;Taip;0;15;0;15
18895;Švelnukas;Smalsučiai;3388721433;Taip;0;1;0;1
18896;Švelnukas;Smalsučiai;1742714140;Taip;0;2;5;7
18897;Švelnukas;Smalsučiai;91569132037;Taip;0;14;0;14
18898;Švelnukas;Smalsučiai;34570338962;Taip;19;0;0;19
18899;Švelnukas;Smalsučiai;78611632021;Taip;0;3;0;3
18900;Švelnukas;Smalsučiai;15774114007;Taip;11;0;10;21
18901;Švelnukas;Smalsučiai;26312856720;Taip;12;0;0;12
18902;Švelnukas;Nykštukai;2141519946;Taip;0;2;0;2
18903;Švelnukas;Nykštukai;8771953161;Taip;0;3;3;6
18904;Švelnukas;Nykštukai;5327209876;Taip;0;2;0;2
18905;Švelnukas;Nykštukai;2282356211;Taip;5;0;0;5
18906;Švelnukas;Nykštukai;7387060610;Taip;0;3;0;3
18907;Švelnukas;Nykštukai;1762528313;Taip;0;1;6;7
18908;Švelnukas;Nykštukai;7380948648;Taip;1;1;0;2
18909;Švelnukas;Nykštukai;3473146893;Taip;1;1;0;2
18910;Švelnukas;Nykštukai;3370028567;Taip;3;0;0;3
18911;Švelnukas;Nykštukai;62969317035;Taip;10;0;0;10
18912;Švelnukas;Nykštukai;2106591525;Taip;7;5;1;13
18913;Švelnukas;Nykštukai;93497358197;Taip;5;5;0;10
18914;Švelnukas;Nykštukai;2971380970;Taip;3;0;0;3
18915;Švelnukas;Nykštukai;3389897065;Taip;3;0;0;3
18916;Švelnukas;Nykštukai;4302735157;Taip;0;0;4;4
18917;Švelnukas;Nykštukai;2785396019;Taip;4;0;1;5
18918;Švelnukas;Nykštukai;6195335543;Taip;0;0;2;2
18919;Boružėlė;"Nykštukai gudručiai";16750834044;Taip;6;0;0;6
18920;Boružėlė;"Nykštukai gudručiai";17133057179;Taip;0;9;0;9
18921;Boružėlė;"Nykštukai gudručiai";61157651941;Ne;4;0;0;4
18922;Boružėlė;"Nykštukai gudručiai";89164129422;Taip;5;6;0;11
18923;Boružėlė;"Nykštukai gudručiai";61086657300;Taip;2;0;0;2
18924;Boružėlė;"Nykštukai gudručiai";27819440058;Taip;6;0;0;6
18925;Boružėlė;"Nykštukai gudručiai";62849453206;Taip;0;8;0;8
18926;Boružėlė;"Nykštukai gudručiai";650307889;Taip;0;7;0;7
18927;Boružėlė;"Nykštukai gudručiai";90752643228;Taip;0;1;0;1
18928;Boružėlė;"Nykštukai gudručiai";91349343635;Taip;0;1;0;1
18929;Boružėlė;"Nykštukai gudručiai";52470353273;Taip;10;3;2;15
18930;Boružėlė;"Nykštukai gudručiai";38216036757;Taip;14;2;0;16
18931;Boružėlė;"Nykštukai gudručiai";28726593347;Taip;9;1;0;10
18932;Boružėlė;"Nykštukai gudručiai";47122226309;Taip;0;2;0;2
18933;Boružėlė;"Nykštukai gudručiai";13957276157;Taip;0;4;2;6
18934;Boružėlė;"Nykštukai gudručiai";29807061047;Taip;0;2;0;2
18935;Boružėlė;"Nykštukai gudručiai";55985459125;Ne;0;2;0;2
18936;Boružėlė;"Nykštukai gudručiai";68875252308;Taip;3;1;0;4
18937;Boružėlė;"Nykštukai gudručiai";229765248;Taip;0;1;0;1
18938;Boružėlė;"Nykštukai gudručiai";16899340397;Taip;0;1;0;1
18939;Boružėlė;"Nykštukai gudručiai";82591189080;Taip;5;3;0;8
18940;Boružėlė;"Nykštukai gudručiai";5105514215;Taip;5;2;0;7
18941;Boružėlė;"Nykštukai gudručiai";64502791927;Taip;0;2;0;2
18942;Boružėlė;"Nykštukai gudručiai";95194187600;Taip;0;3;0;3
18943;Boružėlė;"Nykštukai gudručiai";37447518757;Taip;0;8;0;8
18944;Boružėlė;"Saulės zuikučiai";85989907396;Taip;5;0;0;5
18945;Boružėlė;"Saulės zuikučiai";19859029063;Taip;0;14;1;15
18946;Boružėlė;"Saulės zuikučiai";32378073529;Taip;0;6;0;6
18947;Boružėlė;"Saulės zuikučiai";69391016485;Taip;0;1;0;1
18948;Boružėlė;"Saulės zuikučiai";31002497704;Taip;0;6;0;6
18949;Boružėlė;"Saulės zuikučiai";24149763183;Taip;4;1;0;5
18950;Boružėlė;"Saulės zuikučiai";8746617807;Taip;6;0;0;6
18951;Boružėlė;"Saulės zuikučiai";25311512878;Taip;6;2;0;8
18952;Boružėlė;"Saulės zuikučiai";34268210765;Taip;0;1;0;1
18953;Boružėlė;"Saulės zuikučiai";85800258410;Taip;0;0;1;1
18954;Boružėlė;"Saulės zuikučiai";5636816841;Taip;0;8;0;8
18955;Boružėlė;"Saulės zuikučiai";90270691161;Taip;0;1;0;1
18956;Boružėlė;"Saulės zuikučiai";92488927896;Taip;0;1;0;1
18957;Boružėlė;"Saulės zuikučiai";52262961972;Taip;0;2;0;2
18958;Boružėlė;"Saulės zuikučiai";59772973857;Taip;0;4;0;4
18959;Boružėlė;"Saulės zuikučiai";44064549128;Taip;5;0;0;5
18960;Boružėlė;"Saulės zuikučiai";2322009943;Taip;0;1;0;1
18961;Boružėlė;"Saulės zuikučiai";39495849527;Ne;0;3;0;3
18962;Boružėlė;"Saulės zuikučiai";21573376804;Taip;10;0;0;10
18963;Boružėlė;"Saulės zuikučiai";44480055238;Taip;8;1;0;9
18964;Boružėlė;"Saulės zuikučiai";33333115262;Taip;10;0;0;10
18965;Boružėlė;Gėlytės;4023646693;Taip;6;0;0;6
18966;Boružėlė;Gėlytės;1259739396;Taip;5;0;0;5
18967;Boružėlė;Gėlytės;62298785353;Taip;10;0;1;11
18968;Boružėlė;Gėlytės;84087304104;Taip;10;0;0;10
18969;Boružėlė;Gėlytės;28968535453;Taip;0;3;2;5
18970;Boružėlė;Gėlytės;41726574939;Taip;0;1;0;1
18971;Boružėlė;Gėlytės;51923600458;Taip;0;0;1;1
18972;Boružėlė;Gėlytės;77207874939;Taip;0;1;0;1
18973;Boružėlė;Gėlytės;60999303687;Taip;0;1;0;1
18974;Boružėlė;Gėlytės;69393873241;Taip;9;1;0;10
18975;Boružėlė;Gėlytės;54530233692;Taip;0;1;0;1
18976;Boružėlė;Gėlytės;3118969668;Taip;0;7;2;9
18977;Boružėlė;Gėlytės;56693699464;Taip;6;2;1;9
18978;Boružėlė;Gėlytės;1010790194;Taip;0;1;0;1
18979;Boružėlė;Gėlytės;1813949172;Taip;5;0;0;5
18980;Boružėlė;Gėlytės;5306841409;Taip;15;1;0;16
18981;Boružėlė;Smalsutis;5129244830;Taip;0;6;0;6
18982;Boružėlė;Smalsutis;6927100979;Taip;6;1;0;7
18983;Boružėlė;Smalsutis;2887130633;Taip;11;0;0;11
18984;Boružėlė;Smalsutis;5267216044;Taip;6;0;0;6
18985;Boružėlė;Smalsutis;2917508421;Taip;10;0;0;10
18986;Boružėlė;Smalsutis;7263730692;Taip;10;0;0;10
18987;Boružėlė;Smalsutis;5708558321;Taip;0;4;0;4
18988;Boružėlė;Smalsutis;6484173786;Taip;7;0;0;7
18989;Boružėlė;Smalsutis;2132904457;Taip;5;2;0;7
18990;Boružėlė;Smalsutis;77513300382;Taip;0;2;0;2
18991;Boružėlė;Smalsutis;39553430808;Taip;5;0;0;5
18992;Boružėlė;Smalsutis;4958704459;Taip;5;1;0;6
18993;Boružėlė;Smalsutis;5618586722;Taip;0;3;0;3
18994;Boružėlė;Smalsutis;2447148171;Taip;0;2;0;2
18995;Boružėlė;Drugeliai;22364321459;Taip;0;2;0;2
18996;Boružėlė;Drugeliai;92489123105;Taip;0;2;0;2
18997;Boružėlė;Drugeliai;62673076395;Taip;0;1;0;1
18998;Boružėlė;Drugeliai;7846729818;Taip;8;1;0;9
18999;Boružėlė;Drugeliai;17934430709;Taip;0;1;0;1
19000;Boružėlė;Drugeliai;2832927610;Taip;0;14;0;14
19001;Boružėlė;Drugeliai;91514253954;Ne;0;3;1;4
19002;Boružėlė;Drugeliai;60850304458;Taip;0;2;1;3
19003;Boružėlė;Drugeliai;61687966416;Ne;0;6;0;6
19004;Boružėlė;Drugeliai;64005720465;Ne;0;1;0;1
19005;Boružėlė;Drugeliai;1317543345;Taip;0;1;0;1
19006;Boružėlė;Drugeliai;87323054466;Taip;0;2;3;5
19007;Boružėlė;Drugeliai;89040863632;Taip;2;2;0;4
19008;Boružėlė;Drugeliai;37727831095;Taip;8;5;0;13
19009;Boružėlė;Drugeliai;98019366092;Taip;0;3;0;3
19010;Boružėlė;Drugeliai;38702331698;Taip;0;3;3;6
19011;Boružėlė;Drugeliai;39872094732;Taip;0;1;0;1
19012;Boružėlė;Drugeliai;51684663458;Taip;0;4;1;5
19013;Boružėlė;Drugeliai;4219138834;Ne;0;2;0;2
19014;Boružėlė;Drugeliai;88659085306;Taip;2;2;0;4
19015;Boružėlė;Drugeliai;68002181211;Taip;0;3;0;3
19016;Boružėlė;Drugeliai;56479442138;Taip;14;3;0;17
19017;Boružėlė;Vyturėliai;1913540317;Taip;5;1;3;9
19018;Boružėlė;Vyturėliai;1950269258;Taip;0;10;0;10
19019;Boružėlė;Vyturėliai;1591582954;Taip;2;7;0;9
19020;Boružėlė;Vyturėliai;3322567969;Taip;0;1;0;1
19021;Boružėlė;Vyturėliai;8311383437;Taip;0;0;21;21
19022;Boružėlė;Vyturėliai;7534482245;Taip;0;1;13;14
19023;Boružėlė;Vyturėliai;87834777247;Taip;6;3;0;9
19024;Boružėlė;Vyturėliai;50071056728;Taip;1;16;0;17
19025;Boružėlė;Vyturėliai;43300167107;Taip;0;1;0;1
19026;Boružėlė;Vyturėliai;2098408445;Taip;0;2;0;2
19027;Boružėlė;Vyturėliai;8706461730;Taip;1;0;0;1
19028;Boružėlė;Vyturėliai;5337704114;Taip;5;0;0;5
19029;Boružėlė;Vyturėliai;8146684259;Taip;9;6;0;15
19030;Boružėlė;Vyturėliai;8225622711;Taip;0;2;0;2
19031;Boružėlė;Vyturėliai;9150703371;Taip;5;0;0;5
19032;Boružėlė;Vyturėliai;5811751925;Taip;0;2;4;6
19033;Boružėlė;Žvaigždutės;44535075266;Taip;0;0;5;5
19034;Boružėlė;Žvaigždutės;43607170469;Taip;0;1;0;1
19035;Boružėlė;Žvaigždutės;52277326311;Taip;0;1;0;1
19036;Boružėlė;Žvaigždutės;45978328301;Taip;10;0;1;11
19037;Boružėlė;Žvaigždutės;57677692109;Taip;0;2;0;2
19038;Boružėlė;Žvaigždutės;11257181283;Taip;0;1;0;1
19039;Boružėlė;Žvaigždutės;71560111993;Taip;0;0;1;1
19040;Boružėlė;Žvaigždutės;55597294544;Taip;4;11;0;15
19041;Boružėlė;Žvaigždutės;56257835408;Taip;5;5;0;10
19042;Boružėlė;Žvaigždutės;14720838994;Taip;2;0;0;2
19043;Boružėlė;Žvaigždutės;59360834739;Taip;3;0;0;3
19044;Boružėlė;Žvaigždutės;75023176711;Taip;0;0;6;6
19045;Boružėlė;Žvaigždutės;73627228099;Taip;1;5;0;6
19046;Boružėlė;Žvaigždutės;53465974644;Taip;10;0;0;10
19047;Boružėlė;Žvaigždutės;18917842445;Taip;0;2;0;2
19048;Boružėlė;Ąžuoliukai;5774358876;Taip;0;4;0;4
19049;Boružėlė;Ąžuoliukai;4519645340;Taip;6;2;0;8
19050;Boružėlė;Ąžuoliukai;24315678618;Taip;0;0;1;1
19051;Boružėlė;Ąžuoliukai;5138737297;Taip;5;0;0;5
19052;Boružėlė;Ąžuoliukai;2618814096;Taip;8;1;0;9
19053;Boružėlė;Ąžuoliukai;6439902117;Taip;0;2;0;2
19054;Boružėlė;Ąžuoliukai;3040376382;Taip;6;2;0;8
19055;Boružėlė;Ąžuoliukai;3840860155;Taip;0;0;2;2
19056;Boružėlė;Ąžuoliukai;3869817904;Taip;5;1;0;6
19057;Boružėlė;Ąžuoliukai;7722277859;Taip;6;0;0;6
19058;Boružėlė;Ąžuoliukai;6954794465;Taip;0;1;0;1
19059;Boružėlė;Ąžuoliukai;6545116373;Taip;0;5;0;5
19060;Boružėlė;Ąžuoliukai;5832223872;Taip;7;0;3;10
19061;Boružėlė;Ąžuoliukai;3695411422;Taip;8;2;0;10
19062;Boružėlė;Ąžuoliukai;1143453501;Taip;7;0;0;7
19063;Boružėlė;Ąžuoliukai;5490593122;Taip;9;0;0;9
19064;Boružėlė;Ąžuoliukai;5148410392;Taip;8;0;1;9
19065;Boružėlė;Ąžuoliukai;45181369655;Taip;0;6;0;6
19066;Boružėlė;Ąžuoliukai;6022191251;Taip;0;0;3;3
19067;Boružėlė;Saulutės;55049551150;Taip;0;4;1;5
19068;Boružėlė;Saulutės;46425201501;Taip;0;10;0;10
19069;Boružėlė;Saulutės;1399195259;Taip;9;4;0;13
19070;Boružėlė;Saulutės;1247185819;Taip;0;2;0;2
19071;Boružėlė;Saulutės;1910653135;Taip;0;6;10;16
19072;Boružėlė;Saulutės;8814486475;Taip;0;4;3;7
19073;Boružėlė;Saulutės;48414697489;Taip;0;2;0;2
19074;Boružėlė;Saulutės;4567360023;Taip;5;2;0;7
19075;Boružėlė;Saulutės;96500755145;Ne;0;2;0;2
19076;Boružėlė;Saulutės;1506999888;Taip;3;4;0;7
19077;Boružėlė;Saulutės;2402968573;Taip;3;4;0;7
19078;Boružėlė;Saulutės;2690216341;Taip;10;1;0;11
19079;Boružėlė;Saulutės;1456577285;Taip;14;1;0;15
19080;Boružėlė;Saulutės;8659850691;Taip;0;3;0;3
19081;Boružėlė;Saulutės;4562962568;Taip;0;3;0;3
19082;Boružėlė;Saulutės;64347371263;Taip;0;3;0;3
19083;Boružėlė;Saulutės;28382049716;Taip;10;3;0;13
19084;Boružėlė;Saulutės;1040409859;Taip;0;1;0;1
19085;Boružėlė;Saulutės;1750151078;Taip;1;2;0;3
19086;Boružėlė;Ežiukai;1637965530;Taip;0;1;0;1
19087;Boružėlė;Ežiukai;80490841186;Taip;16;0;0;16
19088;Boružėlė;Ežiukai;9645420240;Taip;0;2;0;2
19089;Boružėlė;Ežiukai;97765175729;Taip;0;2;0;2
19090;Boružėlė;Ežiukai;9436674675;Taip;0;1;0;1
19091;Boružėlė;Ežiukai;58923894463;Taip;5;2;0;7
19092;Boružėlė;Ežiukai;27456755162;Taip;0;2;0;2
19093;Boružėlė;Ežiukai;1339605077;Taip;0;7;0;7
19094;Boružėlė;Ežiukai;80239337645;Taip;7;1;0;8
19095;Boružėlė;Ežiukai;1007058344;Taip;6;2;0;8
19096;Boružėlė;Ežiukai;86859788504;Taip;9;3;0;12
19097;Boružėlė;Ežiukai;2138048547;Taip;11;0;0;11
19098;Boružėlė;Ežiukai;1431869021;Taip;11;1;0;12
19099;Boružėlė;Ežiukai;1474967056;Taip;9;1;0;10
19100;Boružėlė;Ežiukai;87991501724;Taip;15;2;0;17
19101;Boružėlė;Ežiukai;17258743024;Taip;0;2;0;2
19102;Boružėlė;Ežiukai;31109596405;Taip;0;7;0;7
19103;Boružėlė;Ežiukai;3702413611;Taip;14;0;0;14
19104;Boružėlė;Ežiukai;49403734292;Taip;13;0;0;13
19105;Boružėlė;Ežiukai;39704329817;Ne;0;3;0;3
19106;Boružėlė;Ežiukai;61932744418;Taip;10;2;0;12
19107;Boružėlė;Ežiukai;1459630343;Taip;0;2;0;2
19108;Boružėlė;Ežiukai;8266904750;Taip;2;0;0;2
19109;Boružėlė;Ežiukai;80378241169;Taip;0;3;0;3
19110;Boružėlė;Ežiukai;73347816357;Taip;6;2;0;8
19111;Boružėlė;Boružiukai;3140264242;Taip;1;4;0;5
19112;Boružėlė;Boružiukai;7901880926;Taip;2;0;0;2
19113;Boružėlė;Boružiukai;9720535449;Taip;7;1;0;8
19114;Boružėlė;Boružiukai;6435556131;Taip;7;1;0;8
19115;Boružėlė;Boružiukai;1583223569;Taip;0;4;0;4
19116;Boružėlė;Boružiukai;3955841578;Taip;0;3;0;3
19117;Boružėlė;Boružiukai;8259586236;Taip;0;3;0;3
19118;Boružėlė;Boružiukai;1663216529;Taip;12;0;0;12
19119;Boružėlė;Boružiukai;9271331800;Taip;14;0;0;14
19120;Boružėlė;Boružiukai;8357946299;Taip;16;0;0;16
19121;Boružėlė;Boružiukai;9838823214;Taip;15;2;0;17
19122;Boružėlė;Boružiukai;5298170118;Taip;0;1;0;1
19123;Boružėlė;Boružiukai;7825636053;Taip;0;1;0;1
19124;Boružėlė;Boružiukai;6242220139;Taip;5;8;0;13
19125;Boružėlė;Boružiukai;5274016839;Taip;0;2;0;2
19126;Boružėlė;Boružiukai;6972646373;Taip;5;0;0;5
19127;Boružėlė;Boružiukai;7216558291;Taip;1;4;0;5
19128;Boružėlė;Nykštukai;9913813461;Taip;7;0;0;7
19129;Boružėlė;Nykštukai;6049501362;Taip;0;4;0;4
19130;Boružėlė;Nykštukai;8683282162;Taip;1;5;0;6
19131;Boružėlė;Nykštukai;8141240094;Taip;0;2;0;2
19132;Boružėlė;Nykštukai;5187411500;Taip;7;0;0;7
19133;Boružėlė;Nykštukai;1130980139;Taip;0;2;0;2
19134;Boružėlė;Nykštukai;6463583187;Taip;6;2;0;8
19135;Boružėlė;Nykštukai;4509233532;Taip;5;3;0;8
19136;Boružėlė;Nykštukai;3136028536;Taip;14;2;0;16
19137;Boružėlė;Nykštukai;6724101421;Taip;0;4;2;6
19138;Boružėlė;Nykštukai;2211576663;Taip;5;2;0;7
19139;Boružėlė;Nykštukai;1559001916;Taip;1;0;0;1
19140;Boružėlė;Nykštukai;3129825206;Taip;1;7;0;8
19141;Boružėlė;Nykštukai;3952645542;Taip;20;1;0;21
19142;Boružėlė;Nykštukai;4233602822;Taip;0;1;0;1
19143;Boružėlė;Nykštukai;6990311896;Taip;0;2;0;2
19144;Žaliakalnio;Drugeliai;13682689553;Taip;5;1;1;7
19145;Žaliakalnio;Drugeliai;27904847662;Ne;1;0;0;1
19146;Žaliakalnio;Drugeliai;46069159390;Taip;0;4;0;4
19147;Žaliakalnio;Drugeliai;86878699666;Taip;0;2;0;2
19148;Žaliakalnio;Drugeliai;31358267062;Ne;6;1;0;7
19149;Žaliakalnio;Drugeliai;25885672997;Ne;5;0;1;6
19150;Žaliakalnio;Drugeliai;32706729925;Taip;0;1;0;1
19151;Žaliakalnio;Drugeliai;66150716129;Taip;0;1;0;1
19152;Žaliakalnio;Drugeliai;25938547290;Taip;2;0;0;2
19153;Žaliakalnio;Drugeliai;6781426791;Taip;0;1;0;1
19154;Žaliakalnio;Drugeliai;2049672202;Taip;0;1;0;1
19155;Žaliakalnio;Drugeliai;7563809721;Taip;0;2;0;2
19156;Žaliakalnio;Drugeliai;3711311672;Taip;0;2;0;2
19157;Žaliakalnio;Boružėlių;82492655622;Taip;0;1;0;1
19158;Žaliakalnio;Boružėlių;47810583989;Taip;2;0;1;3
19159;Žaliakalnio;Boružėlių;33301958715;Taip;0;6;0;6
19160;Žaliakalnio;Boružėlių;3965607452;Ne;0;3;0;3
19161;Žaliakalnio;Boružėlių;75317286407;Taip;1;0;0;1
19162;Žaliakalnio;Boružėlių;4250791818;Taip;0;8;0;8
19163;Žaliakalnio;Boružėlių;93570287071;Ne;0;0;3;3
19164;Žaliakalnio;Boružėlių;1083342257;Taip;0;3;0;3
19165;Žaliakalnio;Boružėlių;46244764767;Ne;0;8;0;8
19166;Žaliakalnio;Boružėlių;75758855114;Taip;2;0;3;5
19167;Žaliakalnio;Boružėlių;50460143975;Taip;0;0;1;1
19168;Žaliakalnio;Boružėlių;91780252395;Ne;0;9;0;9
19169;Žaliakalnio;Boružėlių;60736665152;Taip;10;2;0;12
19170;Žaliakalnio;Boružėlių;82839531225;Taip;0;3;0;3
19171;Žaliakalnio;Zuikučiai;1592051491;Taip;0;5;0;5
19172;Žaliakalnio;Zuikučiai;6088333997;Taip;6;7;0;13
19173;Žaliakalnio;Zuikučiai;2621828772;Taip;0;3;0;3
19174;Žaliakalnio;Zuikučiai;2673619031;Taip;0;2;0;2
19175;Žaliakalnio;Zuikučiai;5843314345;Taip;0;1;0;1
19176;Žaliakalnio;Zuikučiai;7447278960;Taip;0;10;0;10
19177;Žaliakalnio;Zuikučiai;2180165053;Taip;17;0;0;17
19178;Žaliakalnio;Zuikučiai;6823528666;Taip;10;0;0;10
19179;Žaliakalnio;Zuikučiai;3509064089;Taip;0;2;0;2
19180;Žaliakalnio;Zuikučiai;7000429934;Taip;0;2;0;2
19181;Žaliakalnio;Zuikučiai;6881070397;Taip;0;5;0;5
19182;Žaliakalnio;Zuikučiai;8209559343;Taip;9;4;0;13
19183;Žaliakalnio;Zuikučiai;3835667120;Taip;0;6;0;6
19184;Žaliakalnio;Zuikučiai;5422289286;Taip;0;6;0;6
19185;Žaliakalnio;Zuikučiai;9331287916;Taip;0;7;0;7
19186;Žaliakalnio;Zuikučiai;6726832258;Taip;0;7;0;7
19187;Žaliakalnio;Bitutė;23692122313;Ne;3;4;0;7
19188;Žaliakalnio;Bitutė;5761499050;Taip;0;17;0;17
19189;Žaliakalnio;Bitutė;47735728560;Taip;0;1;0;1
19190;Žaliakalnio;Bitutė;1581365258;Taip;0;4;0;4
19191;Žaliakalnio;Bitutė;1902477771;Taip;3;0;0;3
19192;Žaliakalnio;Bitutė;26003637304;Taip;0;2;0;2
19193;Žaliakalnio;Bitutė;1673236492;Taip;8;0;0;8
19194;Žaliakalnio;Bitutė;46360583256;Taip;11;0;0;11
19195;Žaliakalnio;Bitutė;1027036769;Ne;2;2;0;4
19196;Žaliakalnio;Bitutė;2059763621;Taip;0;1;0;1
19197;Žaliakalnio;Bitutė;21032761681;Taip;4;1;0;5
19198;Žaliakalnio;Bitutė;1275007023;Taip;0;7;0;7
19199;Žaliakalnio;Bitutė;1142844672;Taip;0;18;0;18
19200;Žaliakalnio;Bitutė;1447567627;Taip;0;18;0;18
19201;Žaliakalnio;Bitutė;1919996835;Taip;0;5;0;5
19202;Žaliakalnio;Bitutė;1824370122;Taip;0;12;0;12
19203;Žaliakalnio;Bitutė;64628389691;Taip;0;1;0;1
19204;Žaliakalnio;Bitutė;56508324349;Taip;0;13;0;13
19205;Žaliakalnio;Bitutė;52109524827;Taip;0;19;0;19
19206;Žaliakalnio;Nykštukų;9057678671;Ne;0;6;0;6
19207;Žaliakalnio;Nykštukų;8640423692;Taip;4;0;0;4
19208;Žaliakalnio;Nykštukų;19192494119;Taip;2;1;0;3
19209;Žaliakalnio;Nykštukų;91524700281;Taip;0;7;0;7
19210;Žaliakalnio;Nykštukų;1932906021;Taip;0;4;0;4
19211;Žaliakalnio;Nykštukų;1753760382;Taip;0;1;0;1
19212;Žaliakalnio;Nykštukų;61215164827;Taip;0;3;0;3
19213;Žaliakalnio;Nykštukų;1657390839;Taip;5;3;0;8
19214;Žaliakalnio;Nykštukų;2655227703;Taip;0;6;0;6
19215;Žaliakalnio;Nykštukų;8085215871;Taip;0;12;0;12
19216;Žaliakalnio;Nykštukų;8469042778;Taip;2;10;0;12
19217;Žaliakalnio;Nykštukų;6638075273;Ne;0;15;0;15
19218;Žaliakalnio;Nykštukų;21744638321;Taip;0;3;0;3
19219;Žaliakalnio;Nykštukų;1514982516;Taip;16;1;0;17
19220;Žaliakalnio;Nykštukų;9918175249;Ne;0;5;0;5
19221;Žaliakalnio;Nykštukų;5946168564;Ne;0;11;0;11
19222;Žaliakalnio;ŽIOGELIAI;2607433844;Taip;13;0;0;13
19223;Žaliakalnio;ŽIOGELIAI;2432935088;Ne;0;13;0;13
19224;Žaliakalnio;ŽIOGELIAI;7862756576;Ne;2;0;2;4
19225;Žaliakalnio;ŽIOGELIAI;3058369504;Ne;6;3;0;9
19226;Žaliakalnio;ŽIOGELIAI;5428225559;Taip;15;0;0;15
19227;Žaliakalnio;ŽIOGELIAI;38025903441;Taip;0;1;0;1
19228;Žaliakalnio;ŽIOGELIAI;96127127960;Taip;0;1;0;1
19229;Žaliakalnio;ŽIOGELIAI;15344653714;Taip;2;7;0;9
19230;Žaliakalnio;ŽIOGELIAI;69892069029;Taip;1;1;0;2
19231;Žaliakalnio;ŽIOGELIAI;1589546605;Taip;0;10;0;10
19232;Žaliakalnio;ŽIOGELIAI;1012597457;Taip;0;10;0;10
19233;Žaliakalnio;ŽIOGELIAI;24900419959;Taip;0;7;0;7
19234;Žaliakalnio;ŽIOGELIAI;1357321617;Taip;0;1;0;1
19235;Žaliakalnio;ŽIOGELIAI;98394011032;Ne;0;1;0;1
19236;Žaliakalnio;ŽIOGELIAI;2201538495;Taip;16;0;0;16
19237;Žaliakalnio;ŽIOGELIAI;1967580906;Ne;3;0;0;3
19238;Žaliakalnio;ŽIOGELIAI;55967554391;Taip;10;0;0;10
19239;Žaliakalnio;ŽIOGELIAI;6919074533;Taip;0;1;0;1
19240;Žaliakalnio;ŽIOGELIAI;44058368949;Ne;0;1;0;1
19241;Volungė;Bitutės;2549910818;Ne;0;0;16;16
19242;Volungė;Bitutės;47050212421;Taip;0;1;1;2
19243;Volungė;Bitutės;12723194236;Ne;5;0;1;6
19244;Volungė;Bitutės;13542355518;Taip;0;0;6;6
19245;Volungė;Bitutės;82311993400;Taip;4;8;0;12
19246;Volungė;Bitutės;1437653430;Ne;6;5;1;12
19247;Volungė;Bitutės;1046956717;Ne;0;0;3;3
19248;Volungė;Bitutės;18885218232;Taip;0;0;1;1
19249;Volungė;Bitutės;1213909538;Taip;0;0;1;1
19250;Volungė;Bitutės;1900962235;Taip;0;10;0;10
19251;Volungė;Bitutės;53305676926;Taip;0;6;0;6
19252;Volungė;Bitutės;1173228172;Taip;0;0;7;7
19253;Volungė;Bitutės;1433101716;Ne;1;0;0;1
19254;Volungė;Bitutės;1234100483;Taip;3;0;2;5
19255;Volungė;Bitutės;63185257654;Taip;0;1;0;1
19256;Volungė;Bitutės;1938817757;Ne;0;0;3;3
19257;Volungė;Bitutės;1601358808;Taip;0;0;1;1
19258;Volungė;Bitutės;1605974968;Taip;0;0;1;1
19259;Volungė;Boružiukai;70594069052;Taip;15;0;0;15
19260;Volungė;Boružiukai;29221149335;Taip;5;0;1;6
19261;Volungė;Boružiukai;1044330259;Taip;0;0;6;6
19262;Volungė;Boružiukai;83724618799;Taip;0;0;1;1
19263;Volungė;Boružiukai;17939180277;Taip;4;0;0;4
19264;Volungė;Boružiukai;3924673024;Taip;0;0;2;2
19265;Volungė;Boružiukai;74451460970;Taip;0;4;0;4
19266;Volungė;Boružiukai;50076033275;Taip;0;0;1;1
19267;Volungė;Boružiukai;28521139566;Ne;5;0;0;5
19268;Volungė;Boružiukai;96547780998;Taip;11;0;2;13
19269;Volungė;Boružiukai;64735215987;Taip;0;8;0;8
19270;Volungė;Boružiukai;33643259323;Taip;0;16;2;18
19271;Volungė;Boružiukai;32259897897;Taip;5;3;0;8
19272;Volungė;Boružiukai;15495903063;Ne;10;0;4;14
19273;Volungė;Boružiukai;63789721631;Taip;1;0;2;3
19274;Volungė;Boružiukai;92516817330;Taip;0;0;13;13
19275;Volungė;Boružiukai;19870362159;Taip;0;0;2;2
19276;Volungė;Boružiukai;1699471816;Taip;5;0;0;5
19277;Volungė;Boružiukai;1695388167;Taip;0;0;7;7
19278;Volungė;Žvirbliukai;1862673253;Taip;0;0;11;11
19279;Volungė;Žvirbliukai;87185412767;Ne;0;0;6;6
19280;Volungė;Žvirbliukai;38549010202;Taip;10;0;2;12
19281;Volungė;Žvirbliukai;73677227470;Taip;0;0;3;3
19282;Volungė;Žvirbliukai;33864104545;Taip;0;8;0;8
19283;Volungė;Žvirbliukai;51999447522;Taip;10;0;0;10
19284;Volungė;Žvirbliukai;33437446320;Taip;0;0;2;2
19285;Volungė;Žvirbliukai;1673755671;Taip;0;0;1;1
19286;Volungė;Žvirbliukai;58770101384;Taip;1;14;0;15
19287;Volungė;Žvirbliukai;77965211614;Taip;0;0;21;21
19288;Volungė;Žvirbliukai;54054647743;Taip;0;0;1;1
19289;Volungė;Žvirbliukai;50724446122;Taip;0;0;3;3
19290;Volungė;Žvirbliukai;1866419277;Taip;0;0;11;11
19291;Volungė;Žvirbliukai;1400614987;Taip;0;0;1;1
19292;Volungė;Žvirbliukai;1002996169;Taip;5;4;0;9
19293;Volungė;Žvirbliukai;57009443613;Taip;0;7;0;7
19294;Volungė;Žvirbliukai;1184098245;Taip;5;0;1;6
19295;Volungė;Žvirbliukai;1177104323;Taip;8;0;7;15
19296;Volungė;Žvirbliukai;7623915697;Taip;0;0;6;6
19297;Volungė;Žvirbliukai;6426464927;Taip;0;0;8;8
19298;Volungė;Žiogeliai;20829614346;Taip;0;0;1;1
19299;Volungė;Žiogeliai;6453272974;Taip;0;0;13;13
19300;Volungė;Žiogeliai;1766449043;Taip;0;0;1;1
19301;Volungė;Žiogeliai;16359638255;Taip;3;0;0;3
19302;Volungė;Žiogeliai;4472358109;Taip;0;0;8;8
19303;Volungė;Žiogeliai;18572342676;Taip;8;0;1;9
19304;Volungė;Žiogeliai;1574141255;Taip;0;0;5;5
19305;Volungė;Žiogeliai;83169035513;Taip;5;0;3;8
19306;Volungė;Žiogeliai;52112359999;Taip;0;0;1;1
19307;Volungė;Žiogeliai;55892369610;Taip;0;0;1;1
19308;Volungė;Žiogeliai;73555360631;Ne;0;0;7;7
19309;Volungė;Žiogeliai;71074516561;Taip;0;0;10;10
19310;Volungė;Žiogeliai;11298375135;Taip;0;18;0;18
19311;Volungė;Žiogeliai;55920793056;Taip;5;0;0;5
19312;Volungė;Žiogeliai;1812871720;Taip;5;8;0;13
19313;Volungė;Žiogeliai;23806383679;Taip;0;10;2;12
19314;Volungė;Pelėdžiukai;1032406917;Taip;0;2;0;2
19315;Volungė;Pelėdžiukai;2106837525;Taip;0;0;1;1
19316;Volungė;Pelėdžiukai;1105647976;Taip;2;0;0;2
19317;Volungė;Pelėdžiukai;1705153224;Taip;0;0;2;2
19318;Volungė;Pelėdžiukai;2048619311;Taip;0;21;0;21
19319;Volungė;Pelėdžiukai;3675279848;Taip;0;1;0;1
19320;Volungė;Pelėdžiukai;1938717633;Taip;0;0;9;9
19321;Volungė;Pelėdžiukai;56766828567;Taip;3;0;0;3
19322;Volungė;Pelėdžiukai;6977873198;Taip;0;0;3;3
19323;Volungė;Pelėdžiukai;1917593287;Taip;0;0;3;3
19324;Volungė;Pelėdžiukai;2558681375;Taip;0;0;3;3
19325;Volungė;Pelėdžiukai;85731265908;Taip;0;0;3;3
19326;Volungė;Pelėdžiukai;1861218588;Taip;0;0;2;2
19327;Volungė;Pelėdžiukai;8236836742;Taip;0;0;1;1
19328;Volungė;Pelėdžiukai;1158253769;Taip;0;0;2;2
19329;Volungė;Pelėdžiukai;3632828615;Taip;0;0;1;1
19330;Volungė;Drugeliai;1742777458;Taip;0;0;1;1
19331;Volungė;Drugeliai;2139675610;Taip;0;1;1;2
19332;Volungė;Drugeliai;1752357091;Taip;0;0;7;7
19333;Volungė;Drugeliai;1974360497;Taip;0;0;7;7
19334;Volungė;Drugeliai;86784613109;Taip;0;0;3;3
19335;Volungė;Drugeliai;3803129970;Taip;11;0;0;11
19336;Volungė;Drugeliai;1726933019;Taip;0;0;6;6
19337;Volungė;Drugeliai;1333045175;Taip;0;0;8;8
19338;Volungė;Drugeliai;1173302471;Taip;0;21;0;21
19339;Volungė;Drugeliai;1900204936;Taip;0;7;0;7
19340;Volungė;Drugeliai;1333755594;Taip;0;0;9;9
19341;Volungė;Drugeliai;1539188909;Taip;0;0;5;5
19342;Volungė;Drugeliai;1731981819;Taip;0;5;0;5
19343;Volungė;Drugeliai;44878463386;Taip;0;5;5;10
19344;Volungė;Drugeliai;19340864795;Taip;0;0;3;3
19345;Volungė;Drugeliai;3155184296;Taip;0;0;7;7
19346;Volungė;Drugeliai;7075466773;Taip;5;0;7;12
19347;Volungė;Drugeliai;1291153830;Taip;0;0;13;13
19348;Volungė;Drugeliai;1167124464;Taip;5;0;1;6
19349;Volungė;"SKRUZDĖLIUKAI ";8174587725;Taip;0;12;3;15
19350;Volungė;"SKRUZDĖLIUKAI ";7521910384;Taip;8;0;1;9
19351;Volungė;"SKRUZDĖLIUKAI ";5240126123;Taip;0;0;3;3
19352;Volungė;"SKRUZDĖLIUKAI ";8268202101;Taip;0;0;1;1
19353;Volungė;"SKRUZDĖLIUKAI ";2566901599;Taip;8;0;1;9
19354;Volungė;"SKRUZDĖLIUKAI ";3215314804;Taip;0;0;2;2
19355;Volungė;"SKRUZDĖLIUKAI ";2420242319;Taip;0;0;5;5
19356;Volungė;"SKRUZDĖLIUKAI ";1120682487;Taip;5;0;0;5
19357;Volungė;"SKRUZDĖLIUKAI ";1366066359;Taip;5;0;0;5
19358;Volungė;"SKRUZDĖLIUKAI ";9068889427;Taip;0;0;1;1
19359;Volungė;"SKRUZDĖLIUKAI ";1225378067;Taip;15;0;0;15
19360;Volungė;"SKRUZDĖLIUKAI ";3356901662;Taip;10;0;3;13
19361;Volungė;"SKRUZDĖLIUKAI ";9082860913;Taip;6;0;4;10
19362;Volungė;"SKRUZDĖLIUKAI ";9629567682;Taip;10;0;3;13
19363;Volungė;"SKRUZDĖLIUKAI ";2187800215;Taip;4;3;0;7
19364;Volungė;"SKRUZDĖLIUKAI ";3814647332;Taip;0;0;4;4
19365;Volungė;Zylutės;8784150784;Taip;3;0;0;3
19366;Volungė;Zylutės;7965601199;Taip;0;1;0;1
19367;Volungė;Zylutės;8287344195;Taip;0;8;0;8
19368;Volungė;Zylutės;5710662590;Taip;0;16;2;18
19369;Volungė;Zylutės;1164632050;Taip;0;0;2;2
19370;Volungė;Zylutės;1642961608;Taip;0;21;0;21
19371;Volungė;Zylutės;4839484528;Taip;3;0;0;3
19372;Volungė;Zylutės;9188994935;Taip;5;6;0;11
19373;Volungė;Zylutės;8285309230;Taip;0;21;0;21
19374;Volungė;Zylutės;7149986415;Taip;0;0;2;2
19375;Volungė;Zylutės;5174427959;Taip;5;0;2;7
19376;Volungė;Zylutės;7867741556;Taip;0;6;0;6
19377;Volungė;Zylutės;3430719834;Taip;0;0;2;2
19378;Volungė;Zylutės;8459167833;Taip;6;0;0;6
19379;Volungė;Zylutės;6028582927;Taip;5;0;0;5
19380;Volungė;Zylutės;2547777148;Taip;21;0;0;21
19381;Giliukas;SMALSUČIAI;84750777858;Taip;18;0;0;18
19382;Giliukas;SMALSUČIAI;4145860286;Taip;6;0;0;6
19383;Giliukas;SMALSUČIAI;1869027087;Taip;8;1;0;9
19384;Giliukas;SMALSUČIAI;80254838594;Taip;0;21;0;21
19385;Giliukas;SMALSUČIAI;4163391813;Taip;0;21;0;21
19386;Giliukas;SMALSUČIAI;1431811346;Taip;0;1;0;1
19387;Giliukas;SMALSUČIAI;1910800137;Taip;0;7;2;9
19388;Giliukas;SMALSUČIAI;8284364049;Taip;0;2;0;2
19389;Giliukas;SMALSUČIAI;1733875411;Taip;5;1;0;6
19390;Giliukas;SMALSUČIAI;2617670085;Taip;0;6;0;6
19391;Giliukas;SMALSUČIAI;51201920656;Taip;17;0;0;17
19392;Giliukas;SMALSUČIAI;1771662094;Taip;6;2;5;13
19393;Giliukas;SMALSUČIAI;60766023175;Taip;1;0;0;1
19394;Giliukas;SMALSUČIAI;50289768374;Taip;0;21;0;21
19395;Giliukas;SMALSUČIAI;76716908362;Taip;3;1;0;4
19396;Giliukas;SMALSUČIAI;7223355423;Taip;15;0;0;15
19397;Giliukas;SMALSUČIAI;1649456516;Taip;18;0;0;18
19398;Giliukas;SMALSUČIAI;51723671912;Taip;11;0;0;11
19399;Giliukas;SMALSUČIAI;1665908531;Taip;4;2;0;6
19400;Giliukas;SMALSUČIAI;1969508164;Ne;1;1;0;2
19401;Giliukas;SMALSUČIAI;1624952768;Taip;0;2;2;4
19402;Giliukas;GUDRUČIAI;47667170356;Taip;0;3;0;3
19403;Giliukas;GUDRUČIAI;44324261160;Taip;0;21;0;21
19404;Giliukas;GUDRUČIAI;2051045114;Taip;0;21;0;21
19405;Giliukas;GUDRUČIAI;20294403486;Taip;0;2;0;2
19406;Giliukas;GUDRUČIAI;13047826874;Taip;10;4;0;14
19407;Giliukas;GUDRUČIAI;45976793843;Taip;0;1;0;1
19408;Giliukas;GUDRUČIAI;96391124646;Taip;0;9;0;9
19409;Giliukas;GUDRUČIAI;77697629121;Taip;5;1;5;11
19410;Giliukas;GUDRUČIAI;25587077047;Taip;0;1;0;1
19411;Giliukas;GUDRUČIAI;135044370;Taip;0;2;0;2
19412;Giliukas;GUDRUČIAI;41761163148;Taip;8;0;0;8
19413;Giliukas;GUDRUČIAI;9254755937;Ne;4;3;0;7
19414;Giliukas;GUDRUČIAI;13279159942;Taip;0;1;0;1
19415;Giliukas;GUDRUČIAI;65254984026;Taip;0;4;0;4
19416;Giliukas;GUDRUČIAI;13946513947;Taip;12;1;5;18
19417;Giliukas;GUDRUČIAI;41666529831;Ne;0;4;1;5
19418;Giliukas;GUDRUČIAI;26006763829;Taip;0;11;0;11
19419;Giliukas;GUDRUČIAI;9455477992;Taip;0;21;0;21
19420;Giliukas;GUDRUČIAI;2157057125;Taip;0;21;0;21
19421;Giliukas;ŠNEKUČIAI;1463748654;Taip;0;13;0;13
19422;Giliukas;ŠNEKUČIAI;1664239181;Taip;0;2;0;2
19423;Giliukas;ŠNEKUČIAI;9461909264;Taip;7;0;0;7
19424;Giliukas;ŠNEKUČIAI;34155615138;Taip;6;2;1;9
19425;Giliukas;ŠNEKUČIAI;14318411597;Taip;12;0;0;12
19426;Giliukas;ŠNEKUČIAI;2006450088;Taip;5;1;0;6
19427;Giliukas;ŠNEKUČIAI;89954209937;Taip;0;2;1;3
19428;Giliukas;ŠNEKUČIAI;40373221046;Taip;0;2;9;11
19429;Giliukas;ŠNEKUČIAI;8575067944;Taip;0;3;0;3
19430;Giliukas;ŠNEKUČIAI;26109227683;Taip;4;7;0;11
19431;Giliukas;ŠNEKUČIAI;1417138570;Taip;0;2;0;2
19432;Giliukas;ŠNEKUČIAI;4053376466;Taip;6;2;0;8
19433;Giliukas;ŠNEKUČIAI;1406371374;Taip;0;2;0;2
19434;Giliukas;ŠNEKUČIAI;10326073797;Taip;11;2;0;13
19435;Giliukas;ŠNEKUČIAI;7732836522;Taip;9;0;0;9
19436;Giliukas;ŠNEKUČIAI;5914236976;Taip;0;0;21;21
19437;Giliukas;ŠNEKUČIAI;6453425490;Taip;0;0;21;21
19438;Giliukas;ŠNEKUČIAI;1190611675;Taip;14;0;0;14
19439;Giliukas;ŠNEKUČIAI;9747155435;Taip;0;21;0;21
19440;Giliukas;ŠNEKUČIAI;6154379463;Taip;0;21;0;21
19441;Giliukas;PABIRUČIAI;9401247559;Taip;9;2;0;11
19442;Giliukas;PABIRUČIAI;6384202904;Taip;5;0;0;5
19443;Giliukas;PABIRUČIAI;3691791222;Taip;5;0;0;5
19444;Giliukas;PABIRUČIAI;24030146209;Taip;0;21;0;21
19445;Giliukas;PABIRUČIAI;3847358328;Taip;1;10;0;11
19446;Giliukas;PABIRUČIAI;1890147760;Taip;0;21;0;21
19447;Giliukas;PABIRUČIAI;1469477982;Taip;2;2;0;4
19448;Giliukas;PABIRUČIAI;3983555939;Taip;0;2;0;2
19449;Giliukas;PABIRUČIAI;7780118692;Taip;0;7;0;7
19450;Giliukas;PABIRUČIAI;2951628295;Taip;0;2;0;2
19451;Giliukas;PABIRUČIAI;5994213515;Taip;0;21;0;21
19452;Giliukas;PABIRUČIAI;5787041097;Taip;17;0;0;17
19453;Giliukas;PABIRUČIAI;4854370266;Taip;0;4;0;4
19454;Giliukas;PABIRUČIAI;4987348316;Taip;9;1;0;10
19455;Giliukas;PABIRUČIAI;7159681896;Taip;2;0;0;2
19456;Giliukas;PABIRUČIAI;4916844983;Taip;8;0;0;8
19457;"Lazdynų mokykla";Drugeliai;10453975773;Taip;0;18;0;18
19458;"Lazdynų mokykla";Drugeliai;1246702054;Taip;0;0;3;3
19459;"Lazdynų mokykla";Drugeliai;93091209041;Taip;0;2;0;2
19460;"Lazdynų mokykla";Drugeliai;89878430155;Taip;0;1;0;1
19461;"Lazdynų mokykla";Drugeliai;43541072654;Taip;3;9;0;12
19462;"Lazdynų mokykla";Drugeliai;1117304239;Taip;0;1;5;6
19463;"Lazdynų mokykla";Drugeliai;9890308887;Taip;2;0;0;2
19464;"Lazdynų mokykla";Drugeliai;2079967590;Taip;1;0;0;1
19465;"Lazdynų mokykla";Drugeliai;9380814933;Taip;0;0;1;1
19466;"Lazdynų mokykla";Drugeliai;6209271043;Taip;0;1;6;7
19467;"Lazdynų mokykla";Drugeliai;7154882168;Taip;0;21;0;21
19468;"Lazdynų mokykla";Drugeliai;28132502877;Taip;0;1;0;1
19469;"Lazdynų mokykla";Drugeliai;6835150864;Taip;0;10;0;10
19470;"Lazdynų mokykla";Drugeliai;7772177095;Taip;1;0;0;1
19471;"Lazdynų mokykla";Drugeliai;9449948668;Taip;0;7;0;7
19472;"Lazdynų mokykla";Drugeliai;4520091712;Taip;5;0;1;6
19473;"Lazdynų mokykla";Drugeliai;1177208864;Taip;5;0;2;7
19474;"Lazdynų mokykla";Drugeliai;3711708570;Ne;19;0;0;19
19475;"Lazdynų mokykla";Zuikučiai;1837465174;Taip;0;12;0;12
19476;"Lazdynų mokykla";Zuikučiai;1065999533;Taip;0;6;0;6
19477;"Lazdynų mokykla";Zuikučiai;5613360688;Taip;21;0;0;21
19478;"Lazdynų mokykla";Zuikučiai;40995112936;Taip;13;0;0;13
19479;"Lazdynų mokykla";Zuikučiai;9591838054;Taip;0;6;0;6
19480;"Lazdynų mokykla";Zuikučiai;8847547438;Ne;14;1;1;16
19481;"Lazdynų mokykla";Zuikučiai;6615724604;Taip;0;1;0;1
19482;"Lazdynų mokykla";Zuikučiai;9386629495;Taip;8;0;0;8
19483;"Lazdynų mokykla";Zuikučiai;1817040419;Taip;5;1;0;6
19484;"Lazdynų mokykla";Zuikučiai;1910670134;Taip;0;4;0;4
19485;"Lazdynų mokykla";Zuikučiai;25106446270;Taip;0;6;0;6
19486;"Lazdynų mokykla";Zuikučiai;9123178095;Taip;0;12;0;12
19487;"Lazdynų mokykla";Zuikučiai;6848743350;Taip;0;8;0;8
19488;"Lazdynų mokykla";Zuikučiai;1365362641;Taip;7;0;0;7
19489;"Lazdynų mokykla";Zuikučiai;3435025978;Taip;0;0;8;8
19490;"Lazdynų mokykla";Zuikučiai;7549389699;Ne;15;1;1;17
19491;"Lazdynų mokykla";RUPG;14305754762;Taip;5;0;0;5
19492;"Lazdynų mokykla";RUPG;40990471173;Taip;10;7;0;17
19493;"Lazdynų mokykla";RUPG;36268808517;Taip;0;21;0;21
19494;"Lazdynų mokykla";RUPG;4867721872;Taip;4;2;2;8
19495;"Lazdynų mokykla";RUPG;9840858941;Taip;0;1;1;2
19496;"Lazdynų mokykla";RUPG;3702185382;Taip;9;1;2;12
19497;"Lazdynų mokykla";RUPG;12946825485;Taip;0;4;0;4
19498;"Lazdynų mokykla";RUPG;2010518086;Ne;0;2;1;3
19499;"Lazdynų mokykla";RUPG;9341499222;Taip;19;2;0;21
19500;"Lazdynų mokykla";RUPG;85389197930;Taip;4;2;2;8
19501;"Lazdynų mokykla";PG;8081211948;Taip;0;2;0;2
19502;"Lazdynų mokykla";PG;28609993291;Taip;0;6;0;6
19503;"Lazdynų mokykla";PG;72136845605;Taip;0;1;0;1
19504;"Lazdynų mokykla";PG;1422035829;Taip;0;1;1;2
19505;"Lazdynų mokykla";PG;9770196122;Taip;0;1;0;1
19506;"Lazdynų mokykla";PG;87269519104;Taip;0;1;0;1
19507;"Lazdynų mokykla";PG;32859635045;Taip;0;16;0;16
19508;"„Atžalyno” mokykla-darželis";Giliukai;20731737855;Taip;0;1;5;6
19509;"„Atžalyno” mokykla-darželis";Giliukai;4689820608;Taip;0;1;5;6
19510;"„Atžalyno” mokykla-darželis";Giliukai;96760511860;Taip;0;1;1;2
19511;"„Atžalyno” mokykla-darželis";Giliukai;43653378110;Taip;7;1;0;8
19512;"„Atžalyno” mokykla-darželis";Giliukai;11283726979;Taip;5;5;0;10
19513;"„Atžalyno” mokykla-darželis";Giliukai;79370702446;Taip;5;5;0;10
19514;"„Atžalyno” mokykla-darželis";Giliukai;5473807824;Taip;0;1;0;1
19515;"„Atžalyno” mokykla-darželis";Giliukai;16939194895;Taip;0;1;0;1
19516;"„Atžalyno” mokykla-darželis";Giliukai;1360239148;Taip;0;9;0;9
19517;"„Atžalyno” mokykla-darželis";Giliukai;21100054429;Taip;2;2;0;4
19518;"„Atžalyno” mokykla-darželis";Giliukai;75040764923;Taip;0;0;1;1
19519;"„Atžalyno” mokykla-darželis";Giliukai;9526480686;Taip;11;0;0;11
19520;"„Atžalyno” mokykla-darželis";Giliukai;63188100368;Taip;5;0;1;6
19521;"„Atžalyno” mokykla-darželis";Giliukai;24751884646;Taip;0;1;1;2
19522;"„Atžalyno” mokykla-darželis";Giliukai;1687257249;Taip;0;2;0;2
19523;"„Atžalyno” mokykla-darželis";Giliukai;94861364423;Taip;0;1;0;1
19524;"„Atžalyno” mokykla-darželis";Giliukai;8477084613;Taip;6;3;0;9
19525;"„Atžalyno” mokykla-darželis";Giliukai;45828419259;Taip;6;0;0;6
19526;"„Atžalyno” mokykla-darželis";Giliukai;9671080677;Taip;0;1;1;2
19527;"„Atžalyno” mokykla-darželis";Giliukai;87635454714;Taip;0;0;6;6
19528;"„Atžalyno” mokykla-darželis";Riešutėliai;62142172359;Taip;8;2;0;10
19529;"„Atžalyno” mokykla-darželis";Riešutėliai;3632328378;Taip;5;0;0;5
19530;"„Atžalyno” mokykla-darželis";Riešutėliai;31330839773;Taip;10;1;0;11
19531;"„Atžalyno” mokykla-darželis";Riešutėliai;1035650951;Taip;6;1;0;7
19532;"„Atžalyno” mokykla-darželis";Riešutėliai;74843613898;Ne;0;1;0;1
19533;"„Atžalyno” mokykla-darželis";Riešutėliai;27965090417;Ne;6;3;0;9
19534;"„Atžalyno” mokykla-darželis";Riešutėliai;4309031068;Ne;0;1;2;3
19535;"„Atžalyno” mokykla-darželis";Riešutėliai;6177714133;Taip;0;1;2;3
19536;"„Atžalyno” mokykla-darželis";Riešutėliai;1298900423;Taip;5;1;0;6
19537;"„Atžalyno” mokykla-darželis";Riešutėliai;64311414937;Taip;8;6;1;15
19538;"„Atžalyno” mokykla-darželis";Riešutėliai;2172405172;Ne;8;1;0;9
19539;"„Atžalyno” mokykla-darželis";Riešutėliai;23426260453;Taip;0;1;0;1
19540;"„Atžalyno” mokykla-darželis";Riešutėliai;9783561315;Taip;0;1;0;1
19541;"„Atžalyno” mokykla-darželis";Riešutėliai;79970541004;Taip;17;1;1;19
19542;"„Atžalyno” mokykla-darželis";Riešutėliai;94770065539;Taip;0;2;0;2
19543;"„Atžalyno” mokykla-darželis";Riešutėliai;79939366466;Taip;6;1;1;8
19544;"„Atžalyno” mokykla-darželis";Riešutėliai;78155776901;Taip;4;1;0;5
19545;"„Atžalyno” mokykla-darželis";Riešutėliai;10955918317;Taip;17;1;1;19
19546;"„Atžalyno” mokykla-darželis";Riešutėliai;19312623259;Taip;10;1;0;11
19547;"„Atžalyno” mokykla-darželis";Riešutėliai;5921479520;Taip;8;1;3;12
19548;"Vilniaus Emilijos Pliaterytės progimnazija";PELĖDŽIUKAI;1475766630;Taip;0;21;0;21
19549;"Vilniaus Emilijos Pliaterytės progimnazija";PELĖDŽIUKAI;6025990670;Taip;3;0;0;3
19550;"Vilniaus Emilijos Pliaterytės progimnazija";PELĖDŽIUKAI;1758561647;Taip;3;1;0;4
19551;"Vilniaus Emilijos Pliaterytės progimnazija";PELĖDŽIUKAI;11101488283;Taip;0;0;2;2
19552;"Vilniaus Emilijos Pliaterytės progimnazija";PELĖDŽIUKAI;1551926849;Taip;0;0;4;4
19553;"Vilniaus Emilijos Pliaterytės progimnazija";PELĖDŽIUKAI;9980215936;Ne;0;2;6;8
19554;"Vilniaus Emilijos Pliaterytės progimnazija";PELĖDŽIUKAI;6406833864;Taip;0;12;0;12
19555;"Vilniaus Emilijos Pliaterytės progimnazija";PELĖDŽIUKAI;7540156488;Taip;0;8;0;8
19556;"Vilniaus Emilijos Pliaterytės progimnazija";PELĖDŽIUKAI;4146983741;Taip;0;2;5;7
19557;"Vilniaus Emilijos Pliaterytės progimnazija";PELĖDŽIUKAI;9886869275;Taip;6;1;0;7
19558;"Vilniaus Emilijos Pliaterytės progimnazija";PELĖDŽIUKAI;63585262568;Taip;0;0;2;2
19559;"Vilniaus Emilijos Pliaterytės progimnazija";PELĖDŽIUKAI;8202177756;Taip;0;0;2;2
19560;"Vilniaus Emilijos Pliaterytės progimnazija";PELĖDŽIUKAI;1362468297;Ne;0;3;0;3
19561;"Vilniaus Emilijos Pliaterytės progimnazija";PELĖDŽIUKAI;96590022188;Taip;1;0;2;3
19562;"Vilniaus Emilijos Pliaterytės progimnazija";PELĖDŽIUKAI;2787942076;Taip;0;1;0;1
19563;"Vilniaus Emilijos Pliaterytės progimnazija";BITUTĖS;1266987365;Taip;0;3;3;6
19564;"Vilniaus Emilijos Pliaterytės progimnazija";BITUTĖS;1381033889;Taip;0;3;1;4
19565;"Vilniaus Emilijos Pliaterytės progimnazija";BITUTĖS;4569189295;Taip;0;2;0;2
19566;"Vilniaus Emilijos Pliaterytės progimnazija";BITUTĖS;48399220211;Taip;4;0;0;4
19567;"Vilniaus Emilijos Pliaterytės progimnazija";BITUTĖS;2514450574;Taip;0;3;2;5
19568;"Vilniaus Emilijos Pliaterytės progimnazija";BITUTĖS;16065326151;Taip;2;3;4;9
19569;"Vilniaus Emilijos Pliaterytės progimnazija";BITUTĖS;21354424968;Taip;0;21;0;21
19570;"Vilniaus Emilijos Pliaterytės progimnazija";BITUTĖS;9056362645;Taip;12;3;0;15
19571;"Vilniaus Emilijos Pliaterytės progimnazija";BITUTĖS;39510115701;Ne;0;3;3;6
19572;"Vilniaus Emilijos Pliaterytės progimnazija";BITUTĖS;6725344622;Taip;0;14;0;14
19573;"Vilniaus Emilijos Pliaterytės progimnazija";BITUTĖS;6010639117;Taip;5;2;0;7
19574;"Vilniaus Emilijos Pliaterytės progimnazija";BITUTĖS;9725646179;Taip;0;1;1;2
19575;"Vilniaus Emilijos Pliaterytės progimnazija";BITUTĖS;1601646622;Taip;0;0;2;2
19576;"Vilniaus Emilijos Pliaterytės progimnazija";BITUTĖS;4795999477;Ne;0;3;6;9
19577;"Vilniaus Emilijos Pliaterytės progimnazija";BITUTĖS;9872199634;Taip;0;2;0;2
19578;"Vilniaus Emilijos Pliaterytės progimnazija";BITUTĖS;6105675285;Ne;0;1;6;7
19579;"Vilniaus Emilijos Pliaterytės progimnazija";BITUTĖS;2149264761;Taip;0;1;3;4
19580;"Vilniaus Emilijos Pliaterytės progimnazija";BITUTĖS;1212916505;Taip;6;2;0;8
19581;"Vilniaus Emilijos Pliaterytės progimnazija";BITUTĖS;61614055656;Taip;10;1;0;11
19582;"Vilniaus Emilijos Pliaterytės progimnazija";BITUTĖS;2046056078;Taip;1;0;0;1
19583;"Vilniaus Emilijos Pliaterytės progimnazija";BITUTĖS;1323653656;Taip;0;1;0;1
19584;"Vilniaus Emilijos Pliaterytės progimnazija";BITUTĖS;5322173245;Taip;0;1;0;1
19585;"Vilniaus Emilijos Pliaterytės progimnazija";BITUTĖS;3416526776;Taip;0;14;0;14
19586;"Vilniaus Karaliaus Mindaugo pagrindinė mokykla";"NAUJA 1";8096536272;Ne;3;1;0;4
19587;"Vilniaus Karaliaus Mindaugo pagrindinė mokykla";"NAUJA 1";7596203918;Taip;21;0;0;21
19588;"Vilniaus Karaliaus Mindaugo pagrindinė mokykla";"NAUJA 1";45774870210;Taip;5;0;1;6
19589;"Vilniaus Karaliaus Mindaugo pagrindinė mokykla";"NAUJA 1";3680257542;Ne;0;0;9;9
19590;"Vilniaus Karaliaus Mindaugo pagrindinė mokykla";"NAUJA 1";3447871828;Taip;5;0;0;5
19591;"Vilniaus Karaliaus Mindaugo pagrindinė mokykla";"NAUJA 1";1401502095;Taip;0;0;9;9
19592;"Vilniaus Karaliaus Mindaugo pagrindinė mokykla";"NAUJA 1";1969208564;Ne;0;0;4;4
19593;"Vilniaus Karaliaus Mindaugo pagrindinė mokykla";"NAUJA 1";1860540266;Taip;0;0;13;13
19594;"Vilniaus Karaliaus Mindaugo pagrindinė mokykla";"NAUJA 1";47224065699;Taip;0;0;1;1
19595;"Vilniaus Karaliaus Mindaugo pagrindinė mokykla";"NAUJA 1";9555191234;Taip;0;0;17;17
19596;"Vilniaus Karaliaus Mindaugo pagrindinė mokykla";"NAUJA 1";18362159086;Taip;0;0;8;8
19597;"Vilniaus Karaliaus Mindaugo pagrindinė mokykla";"NAUJA 1";9136681731;Taip;0;0;5;5
19598;"Vilniaus Karaliaus Mindaugo pagrindinė mokykla";"NAUJA 2";6139759777;Taip;0;0;3;3
19599;"Vilniaus Karaliaus Mindaugo pagrindinė mokykla";"NAUJA 2";1244335689;Ne;0;0;9;9
19600;"Vilniaus Karaliaus Mindaugo pagrindinė mokykla";"NAUJA 2";30247081871;Taip;5;0;1;6
19601;"Vilniaus Karaliaus Mindaugo pagrindinė mokykla";"NAUJA 2";42856875754;Taip;0;0;9;9
19602;"Vilniaus Karaliaus Mindaugo pagrindinė mokykla";"NAUJA 2";66357034848;Taip;0;1;2;3
19603;"Vilniaus Karaliaus Mindaugo pagrindinė mokykla";"NAUJA 2";9926365944;Taip;11;5;2;18
19604;"Vilniaus Karaliaus Mindaugo pagrindinė mokykla";"NAUJA 2";34474268952;Taip;0;0;4;4
19605;"Vilniaus Karaliaus Mindaugo pagrindinė mokykla";"NAUJA 2";51014054575;Taip;0;0;1;1
19606;"Vilniaus Karaliaus Mindaugo pagrindinė mokykla";"NAUJA 2";6408313774;Taip;0;0;1;1
19607;"Vilniaus Karaliaus Mindaugo pagrindinė mokykla";"NAUJA 2";1161763218;Taip;5;0;0;5
19608;"Vilniaus Karaliaus Mindaugo pagrindinė mokykla";"NAUJA 2";2941071757;Taip;0;1;1;2
19609;"Vilniaus Karaliaus Mindaugo pagrindinė mokykla";"NAUJA 2";66035912812;Ne;9;0;1;10
19610;"Vilniaus Karaliaus Mindaugo pagrindinė mokykla";"NAUJA 2";45248429076;Taip;4;0;0;4
19611;"Vilniaus Karaliaus Mindaugo pagrindinė mokykla";"NAUJA 2";3763454607;Taip;0;0;5;5
19612;"Vilniaus Karaliaus Mindaugo pagrindinė mokykla";"NAUJA 3";76067902652;Taip;0;0;5;5
19613;"Vilniaus Karaliaus Mindaugo pagrindinė mokykla";"NAUJA 3";22824695222;Taip;0;6;0;6
19614;"Vilniaus Karaliaus Mindaugo pagrindinė mokykla";"NAUJA 3";15620943297;Taip;0;9;0;9
19615;"Vilniaus Karaliaus Mindaugo pagrindinė mokykla";"NAUJA 3";29462854972;Ne;1;4;0;5
19616;"Vilniaus Karaliaus Mindaugo pagrindinė mokykla";"NAUJA 3";46789173270;Ne;0;2;3;5
19617;"Vilniaus Karaliaus Mindaugo pagrindinė mokykla";"NAUJA 3";97658239591;Ne;0;1;0;1
19618;"Vilniaus Karaliaus Mindaugo pagrindinė mokykla";"NAUJA 3";93362540292;Taip;6;0;0;6
19619;"Vilniaus Karaliaus Mindaugo pagrindinė mokykla";"NAUJA 3";39314644760;Taip;0;8;0;8
19620;"Vilniaus Karaliaus Mindaugo pagrindinė mokykla";"NAUJA 3";63005020529;Taip;1;0;1;2
19621;"Vilniaus Karaliaus Mindaugo pagrindinė mokykla";"NAUJA 3";69875233191;Taip;0;5;0;5
19622;"Vilniaus Karaliaus Mindaugo pagrindinė mokykla";"NAUJA 3";81435594438;Taip;0;2;5;7
19623;"Vilniaus Karaliaus Mindaugo pagrindinė mokykla";"NAUJA 3";1933781186;Ne;0;6;0;6
19624;"Vilniaus Karaliaus Mindaugo pagrindinė mokykla";"NAUJA 3";5728013837;Taip;0;0;11;11
19625;"Vilniaus Karaliaus Mindaugo pagrindinė mokykla";"NAUJA 3";14289501964;Taip;2;0;2;4
19626;"Vilniaus Karaliaus Mindaugo pagrindinė mokykla";"NAUJA 3";29504643080;Taip;0;21;0;21
19627;"Vilniaus Karaliaus Mindaugo pagrindinė mokykla";"NAUJA 3";23714493433;Taip;0;0;12;12
19628;"Vilniaus Karaliaus Mindaugo pagrindinė mokykla";"NAUJA 3";22976659798;Taip;0;0;2;2
19629;"Vilniaus Karaliaus Mindaugo pagrindinė mokykla";"NAUJA 3";1480855516;Taip;0;0;3;3
19630;"Vilniaus Karaliaus Mindaugo pagrindinė mokykla";"NAUJA 3";82128363155;Taip;9;1;0;10
19631;"Vilniaus Karaliaus Mindaugo pagrindinė mokykla";"NAUJA 3";3974287828;Ne;0;1;14;15
19632;"Vilniaus Baltupių progimnazija";Kodėlčiukai;39367902407;Taip;0;2;0;2
19633;"Vilniaus Baltupių progimnazija";Kodėlčiukai;54861855254;Taip;6;0;0;6
19634;"Vilniaus Baltupių progimnazija";Kodėlčiukai;71242132208;Taip;9;2;0;11
19635;"Vilniaus Baltupių progimnazija";Kodėlčiukai;32755901956;Taip;0;2;0;2
19636;"Vilniaus Baltupių progimnazija";Kodėlčiukai;85383004980;Taip;0;1;1;2
19637;"Vilniaus Baltupių progimnazija";Kodėlčiukai;39643159605;Taip;0;1;0;1
19638;"Vilniaus Baltupių progimnazija";Kodėlčiukai;44658552984;Taip;0;1;0;1
19639;"Vilniaus Baltupių progimnazija";Kodėlčiukai;55625325952;Taip;0;2;1;3
19640;"Vilniaus Baltupių progimnazija";Kodėlčiukai;29812449566;Taip;0;0;1;1
19641;"Vilniaus Baltupių progimnazija";Kodėlčiukai;41941052897;Taip;0;1;1;2
19642;"Vilniaus Baltupių progimnazija";Kodėlčiukai;43948925208;Taip;0;2;0;2
19643;"Vilniaus Baltupių progimnazija";Kodėlčiukai;41791737317;Taip;0;4;0;4
19644;"Vilniaus Baltupių progimnazija";Kodėlčiukai;69400709859;Taip;0;2;0;2
19645;"Vilniaus Baltupių progimnazija";Kodėlčiukai;43266943346;Taip;0;2;0;2
19646;"Vilniaus Baltupių progimnazija";Smalsučiai;6378279947;Taip;0;3;0;3
19647;"Vilniaus Baltupių progimnazija";Smalsučiai;98879417665;Taip;0;0;5;5
19648;"Vilniaus Baltupių progimnazija";Smalsučiai;72920136125;Taip;0;2;0;2
19649;"Vilniaus Baltupių progimnazija";Smalsučiai;6691656559;Taip;0;0;2;2
19650;"Vilniaus Baltupių progimnazija";Smalsučiai;26377121363;Taip;0;0;1;1
19651;"Vilniaus Baltupių progimnazija";Smalsučiai;54374237984;Taip;0;0;8;8
19652;"Vilniaus Baltupių progimnazija";Smalsučiai;44112608775;Taip;0;3;6;9
19653;"Vilniaus Baltupių progimnazija";Smalsučiai;14961029346;Taip;3;7;0;10
19654;"Vilniaus Baltupių progimnazija";Smalsučiai;55042661269;Taip;6;0;0;6
19655;"Vilniaus Baltupių progimnazija";Smalsučiai;34661197670;Taip;0;2;4;6
19656;"Vilniaus Baltupių progimnazija";Smalsučiai;85563395776;Taip;0;4;0;4
19657;"Vilniaus Baltupių progimnazija";Smalsučiai;88349018506;Taip;0;1;0;1
19658;"Vilniaus Baltupių progimnazija";Smalsučiai;1474110400;Taip;0;1;5;6
19659;"Vilniaus Baltupių progimnazija";Smalsučiai;58618032928;Taip;0;2;1;3
19660;"Vilniaus Baltupių progimnazija";Smalsučiai;8033817151;Taip;0;1;2;3
19661;"Vilniaus Baltupių progimnazija";Smalsučiai;1377633427;Ne;0;1;6;7
19662;"Vilniaus Baltupių progimnazija";Smalsučiai;9561915342;Taip;0;2;0;2
19663;"Vilniaus Baltupių progimnazija";Svajokliai;77443527742;Taip;0;1;0;1
19664;"Vilniaus Baltupių progimnazija";Svajokliai;2783585739;Taip;0;1;0;1
19665;"Vilniaus Baltupių progimnazija";Svajokliai;84147129210;Taip;0;1;1;2
19666;"Vilniaus Baltupių progimnazija";Svajokliai;99951182202;Taip;0;2;2;4
19667;"Vilniaus Baltupių progimnazija";Svajokliai;44197089077;Taip;7;2;1;10
19668;"Vilniaus Baltupių progimnazija";Svajokliai;10296915277;Taip;0;1;0;1
19669;"Vilniaus Baltupių progimnazija";Svajokliai;6141821323;Taip;0;2;0;2
19670;"Vilniaus Baltupių progimnazija";Svajokliai;9897957182;Taip;5;1;0;6
19671;"Vilniaus Baltupių progimnazija";Svajokliai;6836526948;Taip;0;1;4;5
19672;"Vilniaus Baltupių progimnazija";Svajokliai;50679337916;Taip;0;2;0;2
19673;"Vilniaus Baltupių progimnazija";Svajokliai;86159748827;Taip;0;2;2;4
19674;"Vilniaus Baltupių progimnazija";Svajokliai;7315821989;Taip;0;2;1;3
19675;"Vilniaus Baltupių progimnazija";Svajokliai;85006202845;Taip;0;1;7;8
19676;"Vilniaus Baltupių progimnazija";Svajokliai;73329089772;Taip;5;2;0;7
19677;"Vilniaus Baltupių progimnazija";Svajokliai;53079636572;Ne;0;2;0;2
19678;"Vilniaus Baltupių progimnazija";Svajokliai;5165936773;Taip;0;2;1;3
19679;"Vilniaus Baltupių progimnazija";Svajokliai;3555057263;Taip;0;21;0;21
19680;"Vilniaus Baltupių progimnazija";Žiniukai;4438092778;Taip;0;1;0;1
19681;"Vilniaus Baltupių progimnazija";Žiniukai;49864549520;Ne;0;2;0;2
19682;"Vilniaus Baltupių progimnazija";Žiniukai;45338766326;Taip;1;2;1;4
19683;"Vilniaus Baltupių progimnazija";Žiniukai;7172910408;Taip;0;1;0;1
19684;"Vilniaus Baltupių progimnazija";Žiniukai;83439477631;Taip;0;1;1;2
19685;"Vilniaus Baltupių progimnazija";Žiniukai;96970348855;Taip;2;1;1;4
19686;"Vilniaus Baltupių progimnazija";Žiniukai;22749485803;Taip;0;1;4;5
19687;"Vilniaus Baltupių progimnazija";Žiniukai;21356492489;Taip;3;2;0;5
19688;"Vilniaus Baltupių progimnazija";Žiniukai;66442714295;Taip;0;12;0;12
19689;"Vilniaus Baltupių progimnazija";Žiniukai;69737288391;Taip;0;2;0;2
19690;"Vilniaus Baltupių progimnazija";Žiniukai;23763005302;Taip;3;1;1;5
19691;"Vilniaus Baltupių progimnazija";Žiniukai;59153301160;Taip;0;2;0;2
19692;"Vilniaus Baltupių progimnazija";Žiniukai;7935037685;Taip;0;1;0;1
19693;"Vilniaus Baltupių progimnazija";Žiniukai;3909042390;Taip;0;2;3;5
19694;"Vilniaus Baltupių progimnazija";Žiniukai;6434969626;Taip;3;4;0;7
19695;"Vilniaus Baltupių progimnazija";Žiniukai;52985512945;Taip;0;6;0;6
19696;"Vilniaus Levo Karsavimo vidurinė mokykla";"Priešmokyklinukai A";14440714117;Taip;0;1;4;5
19697;"Vilniaus Levo Karsavimo vidurinė mokykla";"Priešmokyklinukai A";93157311332;Taip;13;0;0;13
19698;"Vilniaus Levo Karsavimo vidurinė mokykla";"Priešmokyklinukai A";28093592809;Taip;0;1;0;1
19699;"Vilniaus Levo Karsavimo vidurinė mokykla";"Priešmokyklinukai A";70364015727;Taip;0;2;0;2
19700;"Vilniaus Levo Karsavimo vidurinė mokykla";"Priešmokyklinukai A";4273890878;Taip;7;0;0;7
19701;"Vilniaus Levo Karsavimo vidurinė mokykla";"Priešmokyklinukai A";77019635269;Taip;0;3;0;3
19702;"Vilniaus Levo Karsavimo vidurinė mokykla";"Priešmokyklinukai A";15574258138;Taip;5;0;0;5
19703;"Vilniaus Levo Karsavimo vidurinė mokykla";"Priešmokyklinukai A";7147965267;Taip;0;21;0;21
19704;"Vilniaus Levo Karsavimo vidurinė mokykla";"Priešmokyklinukai A";58496565193;Taip;5;1;0;6
19705;"Vilniaus Levo Karsavimo vidurinė mokykla";"Priešmokyklinukai A";25498748126;Ne;0;1;0;1
19706;"Vilniaus Levo Karsavimo vidurinė mokykla";"Priešmokyklinukai A";36430214688;Taip;0;1;0;1
19707;"Vilniaus Levo Karsavimo vidurinė mokykla";"Priešmokyklinukai A";94004273598;Taip;0;1;0;1
19708;"Vilniaus Levo Karsavimo vidurinė mokykla";"Priešmokyklinukai A";1371307111;Taip;5;0;1;6
19709;"Vilniaus Levo Karsavimo vidurinė mokykla";"Priešmokyklinukai b";90184376409;Taip;7;2;0;9
19710;"Vilniaus Levo Karsavimo vidurinė mokykla";"Priešmokyklinukai b";6151061931;Taip;4;1;2;7
19711;"Vilniaus Levo Karsavimo vidurinė mokykla";"Priešmokyklinukai b";1938391715;Taip;0;3;0;3
19712;"Vilniaus Levo Karsavimo vidurinė mokykla";"Priešmokyklinukai b";66160874700;Taip;0;1;3;4
19713;"Vilniaus Levo Karsavimo vidurinė mokykla";"Priešmokyklinukai b";38820365517;Taip;0;3;0;3
19714;"Vilniaus Levo Karsavimo vidurinė mokykla";"Priešmokyklinukai b";22149054613;Taip;0;2;0;2
19715;"Vilniaus Levo Karsavimo vidurinė mokykla";"Priešmokyklinukai b";78913604764;Taip;0;2;0;2
19716;"Vilniaus Levo Karsavimo vidurinė mokykla";"Priešmokyklinukai b";89656947611;Taip;0;1;6;7
19717;"Vilniaus Levo Karsavimo vidurinė mokykla";"Priešmokyklinukai b";56625898576;Taip;0;0;2;2
19718;"Vilniaus Levo Karsavimo vidurinė mokykla";"Priešmokyklinukai b";66998252884;Taip;0;6;0;6
19719;"Vilniaus Levo Karsavimo vidurinė mokykla";"Priešmokyklinukai b";30728353672;Ne;8;0;0;8
19720;"Vilniaus Levo Karsavimo vidurinė mokykla";"Priešmokyklinukai b";31278810938;Taip;0;3;0;3
19721;"Vilniaus Levo Karsavimo vidurinė mokykla";"Priešmokyklinukai b";3893943727;Ne;7;1;1;9
19722;"Vilniaus Levo Karsavimo vidurinė mokykla";"Priešmokyklinukai b";51125720677;Taip;0;5;0;5
19723;"Vilniaus Liepkalnio Pagrindinė Mokykla";Bitutės;85942649944;Taip;3;0;6;9
19724;"Vilniaus Liepkalnio Pagrindinė Mokykla";Bitutės;15384883293;Taip;0;0;4;4
19725;"Vilniaus Liepkalnio Pagrindinė Mokykla";Bitutės;41301452936;Ne;0;0;3;3
19726;"Vilniaus Liepkalnio Pagrindinė Mokykla";Bitutės;68347661358;Taip;1;0;0;1
19727;"Vilniaus Liepkalnio Pagrindinė Mokykla";Bitutės;4760866352;Taip;0;0;1;1
19728;"Vilniaus Liepkalnio Pagrindinė Mokykla";Bitutės;70408565216;Ne;0;0;7;7
19729;"Vilniaus Liepkalnio Pagrindinė Mokykla";Bitutės;11323385715;Taip;8;0;1;9
19730;"Vilniaus Liepkalnio Pagrindinė Mokykla";Bitutės;2118993423;Taip;0;0;3;3
19731;"Vilniaus Liepkalnio Pagrindinė Mokykla";Bitutės;53619465080;Taip;0;0;1;1
19732;"Vilniaus Liepkalnio Pagrindinė Mokykla";Bitutės;52218753980;Taip;0;0;2;2
19733;"Vilniaus Liepkalnio Pagrindinė Mokykla";Bitutės;3007372384;Taip;0;21;0;21
19734;"Vilniaus Liepkalnio Pagrindinė Mokykla";Bitutės;4972232696;Taip;0;21;0;21
19735;"Vilniaus Liepkalnio Pagrindinė Mokykla";Bitutės;7760450278;Ne;0;0;1;1
19736;"Vilniaus Pranciškaus Skorinos gimnazija";Saulytė;8111363055;Taip;11;6;0;17
19737;"Vilniaus Pranciškaus Skorinos gimnazija";Saulytė;2930371388;Taip;0;2;3;5
19738;"Vilniaus Pranciškaus Skorinos gimnazija";Saulytė;70791039097;Ne;0;5;0;5
19739;"Vilniaus Pranciškaus Skorinos gimnazija";Saulytė;8632571006;Taip;8;4;0;12
19740;"Vilniaus Pranciškaus Skorinos gimnazija";Saulytė;66664410121;Taip;0;3;0;3
19741;"Vilniaus Pranciškaus Skorinos gimnazija";Saulytė;3790508177;Taip;0;4;0;4
19742;"Vilniaus Pranciškaus Skorinos gimnazija";Saulytė;27125411489;Taip;0;2;2;4
19743;"Vilniaus Pranciškaus Skorinos gimnazija";Saulytė;72738955088;Taip;0;10;0;10
19744;"Vilniaus Pranciškaus Skorinos gimnazija";Saulytė;67729297941;Ne;0;6;0;6
19745;"Vilniaus Pranciškaus Skorinos gimnazija";Saulytė;2386940016;Taip;0;2;2;4
19746;"Vilniaus Pranciškaus Skorinos gimnazija";Saulytė;1483885253;Taip;2;2;1;5
19747;"Vilniaus Pranciškaus Skorinos gimnazija";Saulytė;4909904794;Taip;0;2;1;3
19748;"Vilniaus Pranciškaus Skorinos gimnazija";Saulytė;4666237893;Taip;0;5;0;5
19749;"Vilniaus Pranciškaus Skorinos gimnazija";Saulytė;87925810917;Taip;0;3;0;3
19750;"Vilniaus Pranciškaus Skorinos gimnazija";Saulytė;9701472893;Taip;0;13;0;13
19751;"Vilniaus Pranciškaus Skorinos gimnazija";Saulytė;31343765777;Taip;0;3;0;3
19752;"Vilniaus Pranciškaus Skorinos gimnazija";Saulytė;55421475688;Taip;0;2;1;3
19753;"Vilniaus Pranciškaus Skorinos gimnazija";Saulytė;55086628871;Taip;0;2;5;7
19754;"Vilniaus Simono Konarskio vidurinės mokykla";"1 gr.";9759567795;Taip;5;1;0;6
19755;"Vilniaus Simono Konarskio vidurinės mokykla";"1 gr.";40561567890;Taip;20;1;0;21
19756;"Vilniaus Simono Konarskio vidurinės mokykla";"1 gr.";5884520114;Ne;0;1;0;1
19757;"Vilniaus Simono Konarskio vidurinės mokykla";"1 gr.";3165852410;Ne;14;1;0;15
19758;"Vilniaus Simono Konarskio vidurinės mokykla";"1 gr.";9585599736;Taip;0;1;0;1
19759;"Vilniaus Simono Konarskio vidurinės mokykla";"1 gr.";38075556139;Taip;5;1;0;6
19760;"Vilniaus Simono Konarskio vidurinės mokykla";"1 gr.";90764462777;Taip;0;1;0;1
19761;"Vilniaus Simono Konarskio vidurinės mokykla";"1 gr.";15628069778;Taip;6;1;0;7
19762;"Vilniaus Simono Konarskio vidurinės mokykla";"1 gr.";59785459193;Taip;0;1;0;1
19763;"Vilniaus Simono Konarskio vidurinės mokykla";"1 gr.";8708972546;Taip;0;1;0;1
19764;"Vilniaus Simono Konarskio vidurinės mokykla";"1 gr.";78809378214;Taip;0;1;0;1
19765;"Vilniaus Simono Konarskio vidurinės mokykla";"1 gr.";5553972538;Taip;0;1;0;1
19766;"Vilniaus Simono Konarskio vidurinės mokykla";"1 gr.";37201396276;Taip;0;1;0;1
19767;"Vilniaus Simono Konarskio vidurinės mokykla";"1 gr.";77024512167;Taip;5;1;0;6
19768;"Vilniaus Simono Konarskio vidurinės mokykla";"1 gr.";8786280855;Taip;4;1;0;5
19769;"Vilniaus Simono Konarskio vidurinės mokykla";"1 gr.";7881088760;Taip;1;1;0;2
19770;"Vilniaus Trakų Vokės gimnazija";Priešmokyklinė;86951309976;Taip;0;0;2;2
19771;"Vilniaus Trakų Vokės gimnazija";Priešmokyklinė;68332465021;Taip;0;0;4;4
19772;"Vilniaus Trakų Vokės gimnazija";Priešmokyklinė;98279169682;Ne;0;0;1;1
19773;"Vilniaus Trakų Vokės gimnazija";Priešmokyklinė;89375639444;Taip;0;0;4;4
19774;"Vilniaus Trakų Vokės gimnazija";Priešmokyklinė;86317439855;Taip;0;0;3;3
19775;"Vilniaus Trakų Vokės gimnazija";Priešmokyklinė;5104422489;Taip;0;0;4;4
19776;"Vilniaus Trakų Vokės gimnazija";Priešmokyklinė;80454463606;Taip;0;0;2;2
19777;"Vilniaus Trakų Vokės gimnazija";Priešmokyklinė;63420742280;Taip;0;15;0;15
19778;"Vilniaus Trakų Vokės gimnazija";Priešmokyklinė;3795096854;Taip;0;0;4;4
19779;"Vilniaus Trakų Vokės gimnazija";Priešmokyklinė;94248843596;Taip;5;0;0;5
19780;"Vilniaus Trakų Vokės gimnazija";Priešmokyklinė;55269223931;Taip;0;0;2;2
19781;"Vilniaus Trakų Vokės gimnazija";Priešmokyklinė;30728775392;Taip;9;0;1;10
19782;"Vilniaus Trakų Vokės gimnazija";Priešmokyklinė;93253698828;Taip;0;4;0;4
19783;"Vilniaus Trakų Vokės gimnazija";Priešmokyklinė;13225336236;Ne;0;0;1;1
19784;"Vilniaus Trakų Vokės gimnazija";Priešmokyklinė;28771899278;Taip;20;0;4;24
19785;"Vilniaus Trakų Vokės gimnazija";Priešmokyklinė;98169988178;Taip;7;4;1;12
19786;"Vilniaus Trakų Vokės gimnazija";Priešmokyklinė;6066619225;Taip;0;0;2;2
19787;"Vilniaus Trakų Vokės gimnazija";Priešmokyklinė;45478578368;Taip;0;0;1;1
19788;"Vilniaus Trakų Vokės gimnazija";Priešmokyklinė;1591065244;Ne;0;0;11;11
19789;"Vilniaus Trakų Vokės gimnazija";Priešmokyklinė;50146560386;Taip;0;0;4;4
19790;"Vilniaus Trakų Vokės gimnazija";Priešmokyklinė;1442702945;Ne;3;10;0;13
19791;"Vilniaus Trakų Vokės gimnazija";Priešmokyklinė;53040741124;Taip;0;0;3;3
19792;"Vilniaus Trakų Vokės gimnazija";Priešmokyklinė;2981889811;Taip;0;8;0;8
19793;"Vilniaus Trakų Vokės gimnazija";Priešmokyklinė;3385439676;Ne;0;5;1;6
19794;"Vilniaus Trakų Vokės gimnazija";Priešmokyklinė;1007914987;Taip;0;0;19;19
19795;"Vilniaus Salininkų gimnazija";"Priešmokyklinė A";1394788152;Taip;0;2;0;2
19796;"Vilniaus Salininkų gimnazija";"Priešmokyklinė A";70212262471;Taip;12;2;0;14
19797;"Vilniaus Salininkų gimnazija";"Priešmokyklinė A";77895776678;Taip;0;1;2;3
19798;"Vilniaus Salininkų gimnazija";"Priešmokyklinė A";92807961547;Taip;0;2;0;2
19799;"Vilniaus Salininkų gimnazija";"Priešmokyklinė A";1263382031;Taip;4;2;1;7
19800;"Vilniaus Salininkų gimnazija";"Priešmokyklinė A";50041849206;Taip;0;2;0;2
19801;"Vilniaus Salininkų gimnazija";"Priešmokyklinė A";9898078093;Taip;5;2;0;7
19802;"Vilniaus Salininkų gimnazija";"Priešmokyklinė A";1540549473;Taip;5;2;1;8
19803;"Vilniaus Salininkų gimnazija";"Priešmokyklinė A";72769378676;Taip;0;3;0;3
19804;"Vilniaus Salininkų gimnazija";"Priešmokyklinė A";12284569395;Taip;0;2;0;2
19805;"Vilniaus Salininkų gimnazija";"Priešmokyklinė A";67687224119;Taip;0;3;0;3
19806;"Vilniaus Salininkų gimnazija";"Priešmokyklinė A";49134796971;Ne;0;2;1;3
19807;"Vilniaus Salininkų gimnazija";"Priešmokyklinė A";18097700548;Taip;0;2;4;6
19808;"Vilniaus Salininkų gimnazija";"Priešmokyklinė A";85552015560;Taip;0;4;0;4
19809;"Vilniaus Salininkų gimnazija";"Priešmokyklinė A";18610156473;Taip;4;2;0;6
19810;"Vilniaus Salininkų gimnazija";"Priešmokyklinė A";43805658510;Taip;0;2;0;2
19811;"Vilniaus Salininkų gimnazija";"Priešmokyklinė A";20709806421;Taip;4;2;0;6
19812;"Vilniaus Salininkų gimnazija";"Priešmokyklinė A";43256013546;Taip;0;2;0;2
19813;"Vilniaus Salininkų gimnazija";"Priešmokyklinė A";7344435191;Taip;0;2;0;2
19814;"Vilniaus Salininkų gimnazija";"Priešmokyklinė A";34881195086;Taip;19;2;0;21
19815;"Vilniaus Spindulio pagrindinė mokykla";PM3;8795608401;Taip;8;0;2;10
19816;"Vilniaus Spindulio pagrindinė mokykla";PM3;2103735244;Ne;7;0;2;9
19817;"Vilniaus Spindulio pagrindinė mokykla";PM3;50072501914;Taip;0;0;4;4
19818;"Vilniaus Spindulio pagrindinė mokykla";PM3;41136453710;Taip;0;21;0;21
19819;"Vilniaus Spindulio pagrindinė mokykla";PM3;70574764659;Taip;4;0;0;4
19820;"Vilniaus Spindulio pagrindinė mokykla";PM3;17630756294;Taip;6;5;0;11
19821;"Vilniaus Spindulio pagrindinė mokykla";PM3;54486099400;Ne;0;5;0;5
19822;"Vilniaus Spindulio pagrindinė mokykla";PM3;5781921709;Taip;0;21;0;21
19823;"Vilniaus Spindulio pagrindinė mokykla";PM3;99658181383;Taip;0;21;0;21
19824;"Vilniaus Spindulio pagrindinė mokykla";PM3;1284623590;Taip;0;0;5;5
19825;"Vilniaus Spindulio pagrindinė mokykla";PM3;17822017066;Taip;0;0;1;1
19826;"Vilniaus Spindulio pagrindinė mokykla";PM3;33144992509;Taip;4;0;0;4
19827;"Vilniaus Spindulio pagrindinė mokykla";PM3;2987981987;Taip;0;0;5;5
19828;"Vilniaus Spindulio pagrindinė mokykla";PM3;2917212490;Taip;6;0;5;11
19829;"Vilniaus Spindulio pagrindinė mokykla";PM3;88363839374;Taip;0;21;0;21
19830;"Vilniaus Spindulio pagrindinė mokykla";PM3;1894317616;Taip;15;0;0;15
19831;"Vilniaus Spindulio pagrindinė mokykla";PM3;8898033177;Taip;0;0;1;1
19832;"Vilniaus Spindulio pagrindinė mokykla";PM2;27440263748;Taip;0;2;0;2
19833;"Vilniaus Spindulio pagrindinė mokykla";PM2;51690968594;Taip;4;0;0;4
19834;"Vilniaus Spindulio pagrindinė mokykla";PM2;5161772691;Taip;0;7;0;7
19835;"Vilniaus Spindulio pagrindinė mokykla";PM2;48405198914;Taip;21;0;0;21
19836;"Vilniaus Spindulio pagrindinė mokykla";PM2;18833749556;Ne;1;0;1;2
19837;"Vilniaus Spindulio pagrindinė mokykla";PM2;1848422504;Taip;6;1;4;11
19838;"Vilniaus Spindulio pagrindinė mokykla";PM2;52558402241;Ne;0;0;4;4
19839;"Vilniaus Spindulio pagrindinė mokykla";PM2;1681147196;Taip;0;3;0;3
19840;"Vilniaus Spindulio pagrindinė mokykla";PM2;3743948734;Taip;1;3;4;8
19841;"Vilniaus Spindulio pagrindinė mokykla";PM2;522862985;Taip;5;1;0;6
19842;"Vilniaus Spindulio pagrindinė mokykla";PM2;1973616698;Taip;6;0;9;15
19843;"Vilniaus Spindulio pagrindinė mokykla";PM2;98043756261;Taip;0;2;0;2
19844;"Vilniaus Spindulio pagrindinė mokykla";PM2;22505400502;Taip;0;0;9;9
19845;"Vilniaus Spindulio pagrindinė mokykla";PM2;73482318690;Taip;0;1;0;1
19846;"Vilniaus Spindulio pagrindinė mokykla";PM2;87635746750;Taip;0;0;1;1
19847;"Vilniaus Spindulio pagrindinė mokykla";PM2;67686277420;Taip;0;0;8;8
19848;"Vilniaus Spindulio pagrindinė mokykla";PM1;98100269824;Taip;0;3;0;3
19849;"Vilniaus Spindulio pagrindinė mokykla";PM1;57584604376;Taip;9;0;0;9
19850;"Vilniaus Spindulio pagrindinė mokykla";PM1;58599577293;Taip;0;1;0;1
19851;"Vilniaus Spindulio pagrindinė mokykla";PM1;11041001881;Taip;8;0;0;8
19852;"Vilniaus Spindulio pagrindinė mokykla";PM1;87462575095;Ne;0;2;0;2
19853;"Vilniaus Spindulio pagrindinė mokykla";PM1;84379794486;Taip;0;1;0;1
19854;"Vilniaus Spindulio pagrindinė mokykla";PM1;56969518152;Taip;9;0;0;9
19855;"Vilniaus Spindulio pagrindinė mokykla";PM1;5245636522;Ne;1;0;0;1
19856;"Vilniaus Spindulio pagrindinė mokykla";PM1;96702943483;Taip;0;11;0;11
19857;"Vilniaus Spindulio pagrindinė mokykla";PM1;1365783673;Taip;5;4;0;9
19858;"Vilniaus Spindulio pagrindinė mokykla";PM1;4290344470;Taip;9;0;0;9
19859;"Vilniaus Spindulio pagrindinė mokykla";PM1;35360386686;Taip;7;0;0;7
19860;"Vilniaus Spindulio pagrindinė mokykla";PM1;66762368813;Taip;5;0;0;5
19861;"Vilniaus Spindulio pagrindinė mokykla";PM1;64966809812;Taip;0;2;0;2
19862;"Vilniaus Vladislavo Sirokomlės vidurinė mokykla";Nykštukai;5907733019;Taip;0;1;7;8
19863;"Vilniaus Vladislavo Sirokomlės vidurinė mokykla";Nykštukai;55996765657;Taip;0;1;1;2
19864;"Vilniaus Vladislavo Sirokomlės vidurinė mokykla";Nykštukai;29678276716;Taip;0;1;1;2
19865;"Vilniaus Vladislavo Sirokomlės vidurinė mokykla";Nykštukai;33995576904;Taip;0;1;3;4
19866;"Vilniaus Vladislavo Sirokomlės vidurinė mokykla";Nykštukai;1147411049;Taip;5;1;0;6
19867;"Vilniaus Vladislavo Sirokomlės vidurinė mokykla";Nykštukai;24628844486;Taip;0;25;0;25
19868;"Vilniaus Vladislavo Sirokomlės vidurinė mokykla";Nykštukai;67322017045;Taip;0;1;3;4
19869;"Vilniaus Vladislavo Sirokomlės vidurinė mokykla";Nykštukai;1288513624;Taip;6;1;1;8
19870;"Vilniaus Vladislavo Sirokomlės vidurinė mokykla";Nykštukai;75293895773;Taip;0;1;2;3
19871;"Vilniaus Vladislavo Sirokomlės vidurinė mokykla";Nykštukai;19225308100;Taip;0;25;0;25
19872;"Vilniaus Vladislavo Sirokomlės vidurinė mokykla";Nykštukai;54815489159;Taip;0;1;0;1
19873;"Vilniaus Vladislavo Sirokomlės vidurinė mokykla";Nykštukai;78888983611;Taip;0;10;0;10
19874;"Vilniaus Vladislavo Sirokomlės vidurinė mokykla";Nykštukai;95872052773;Taip;0;1;4;5
19875;"Vilniaus Vladislavo Sirokomlės vidurinė mokykla";Nykštukai;9991093616;Taip;0;2;6;8
19876;"Vilniaus Vladislavo Sirokomlės vidurinė mokykla";Nykštukai;86336781386;Taip;0;25;0;25
19877;"Vilniaus Vladislavo Sirokomlės vidurinė mokykla";Smurfai;2896777542;Taip;0;25;0;25
19878;"Vilniaus Vladislavo Sirokomlės vidurinė mokykla";Smurfai;1649779105;Taip;0;1;0;1
19879;"Vilniaus Vladislavo Sirokomlės vidurinė mokykla";Smurfai;23540725045;Taip;0;4;0;4
19880;"Vilniaus Vladislavo Sirokomlės vidurinė mokykla";Smurfai;94242891208;Taip;0;25;0;25
19881;"Vilniaus Vladislavo Sirokomlės vidurinė mokykla";Smurfai;42097592326;Ne;5;6;0;11
19882;"Vilniaus Vladislavo Sirokomlės vidurinė mokykla";Smurfai;5042045981;Taip;0;5;1;6
19883;"Vilniaus Vladislavo Sirokomlės vidurinė mokykla";Smurfai;9509140514;Taip;0;8;1;9
19884;"Vilniaus Vladislavo Sirokomlės vidurinė mokykla";Smurfai;86662025175;Taip;0;3;0;3
19885;"Vilniaus Vladislavo Sirokomlės vidurinė mokykla";Smurfai;4227711744;Taip;0;25;0;25
19886;"Vilniaus Vladislavo Sirokomlės vidurinė mokykla";Smurfai;1464969756;Taip;8;3;0;11
19887;"Vilniaus Vladislavo Sirokomlės vidurinė mokykla";Smurfai;1087544768;Taip;0;25;0;25
19888;"Vilniaus Vladislavo Sirokomlės vidurinė mokykla";Smurfai;2272950944;Taip;0;8;1;9
19889;"Vilniaus Vladislavo Sirokomlės vidurinė mokykla";Smurfai;1804439867;Ne;0;1;0;1
19890;"Vilniaus Vladislavo Sirokomlės vidurinė mokykla";Smurfai;4742282433;Taip;6;1;4;11
19891;"Vilniaus „Pelėdos” pradinė mokykla";Bitutės;2071487643;Taip;0;3;0;3
19892;"Vilniaus „Pelėdos” pradinė mokykla";Bitutės;6832201394;Taip;0;1;3;4
19893;"Vilniaus „Pelėdos” pradinė mokykla";Bitutės;6652853494;Ne;0;1;0;1
19894;"Vilniaus „Pelėdos” pradinė mokykla";Bitutės;22352755573;Taip;0;1;2;3
19895;"Vilniaus „Pelėdos” pradinė mokykla";Bitutės;41693125052;Taip;0;4;0;4
19896;"Vilniaus „Pelėdos” pradinė mokykla";Bitutės;4748207005;Taip;4;1;0;5
19897;"Vilniaus „Pelėdos” pradinė mokykla";Bitutės;95143505795;Taip;0;1;3;4
19898;"Vilniaus „Pelėdos” pradinė mokykla";Bitutės;35501298377;Taip;5;5;0;10
19899;"Vilniaus „Pelėdos” pradinė mokykla";Bitutės;96374638070;Taip;0;0;4;4
19900;"Vilniaus „Pelėdos” pradinė mokykla";Bitutės;42360927832;Taip;0;10;0;10
19901;"Vilniaus „Pelėdos” pradinė mokykla";Bitutės;6900693954;Taip;0;6;0;6
19902;"Vilniaus „Pelėdos” pradinė mokykla";Bitutės;42778766894;Taip;0;1;7;8
19903;"Vilniaus „Pelėdos” pradinė mokykla";Bitutės;1269674740;Taip;0;2;4;6
19904;"Vilniaus „Pelėdos” pradinė mokykla";Bitutės;54002272670;Taip;0;6;0;6
19905;"Vilniaus „Pelėdos” pradinė mokykla";Bitutės;45993070238;Taip;0;3;0;3
19906;"Vilniaus „Pelėdos” pradinė mokykla";Bitutės;9108397707;Taip;0;2;2;4
19907;"Vilniaus „Pelėdos” pradinė mokykla";Bitutės;59056959064;Taip;0;1;0;1
19908;"Vilniaus „Pelėdos” pradinė mokykla";Bitutės;96481283521;Taip;0;7;0;7
19909;"Vilniaus „Pelėdos” pradinė mokykla";Boružėlės;30916402061;Taip;0;3;0;3
19910;"Vilniaus „Pelėdos” pradinė mokykla";Boružėlės;33487848367;Taip;0;1;0;1
19911;"Vilniaus „Pelėdos” pradinė mokykla";Boružėlės;4489830831;Ne;0;2;0;2
19912;"Vilniaus „Pelėdos” pradinė mokykla";Boružėlės;12734259561;Taip;1;1;3;5
19913;"Vilniaus „Pelėdos” pradinė mokykla";Boružėlės;79520961509;Taip;0;1;0;1
19914;"Vilniaus „Pelėdos” pradinė mokykla";Boružėlės;7162837286;Taip;0;0;10;10
19915;"Vilniaus „Pelėdos” pradinė mokykla";Boružėlės;46876861220;Taip;0;1;7;8
19916;"Vilniaus „Pelėdos” pradinė mokykla";Boružėlės;71191048199;Taip;0;7;0;7
19917;"Vilniaus „Pelėdos” pradinė mokykla";Boružėlės;48135022147;Taip;0;1;0;1
19918;"Vilniaus „Pelėdos” pradinė mokykla";Boružėlės;63082461930;Ne;3;0;1;4
19919;"Vilniaus „Pelėdos” pradinė mokykla";Boružėlės;4532680677;Taip;1;0;0;1
19920;"Vilniaus „Pelėdos” pradinė mokykla";Boružėlės;4103101479;Taip;0;1;6;7
19921;"Vilniaus „Pelėdos” pradinė mokykla";Boružėlės;89825498541;Taip;0;9;0;9
19922;"Vilniaus „Pelėdos” pradinė mokykla";Boružėlės;91937671865;Taip;0;0;8;8
19923;"Vilniaus „Pelėdos” pradinė mokykla";Boružėlės;10329586004;Taip;3;0;0;3
19924;"Vilniaus Joachimo Lelevelio vidurinė mokykla";0A;48625188486;Taip;8;0;0;8
19925;"Vilniaus Joachimo Lelevelio vidurinė mokykla";0A;30530145422;Taip;10;0;4;14
19926;"Vilniaus Joachimo Lelevelio vidurinė mokykla";0A;22182253769;Taip;5;0;0;5
19927;"Vilniaus Joachimo Lelevelio vidurinė mokykla";0A;22490145919;Taip;5;0;0;5
19928;"Vilniaus Joachimo Lelevelio vidurinė mokykla";0A;79489468964;Ne;1;7;1;9
19929;"Vilniaus Joachimo Lelevelio vidurinė mokykla";0A;1139560173;Taip;0;0;7;7
19930;"Vilniaus Joachimo Lelevelio vidurinė mokykla";0A;29594212376;Taip;0;0;1;1
19931;"Vilniaus Joachimo Lelevelio vidurinė mokykla";0A;37558958175;Taip;0;0;2;2
19932;"Vilniaus Joachimo Lelevelio vidurinė mokykla";0A;37117140680;Taip;0;3;0;3
19933;"Vilniaus Joachimo Lelevelio vidurinė mokykla";0A;1387685923;Ne;4;0;1;5
19934;"Vilniaus Joachimo Lelevelio vidurinė mokykla";0A;2854451964;Taip;6;1;0;7
19935;"Vilniaus Joachimo Lelevelio vidurinė mokykla";0A;87447355522;Taip;3;1;0;4
19936;"Vilniaus Joachimo Lelevelio vidurinė mokykla";0A;9406527428;Ne;4;0;3;7
19937;"Vilniaus Joachimo Lelevelio vidurinė mokykla";0A;82446674090;Taip;3;0;0;3
19938;"Vilniaus Joachimo Lelevelio vidurinė mokykla";0A;6764953389;Taip;0;0;2;2
19939;"Vilniaus Joachimo Lelevelio vidurinė mokykla";0A;6406533101;Taip;9;0;0;9
19940;"Vilniaus Joachimo Lelevelio vidurinė mokykla";0B;38745665842;Taip;0;1;0;1
19941;"Vilniaus Joachimo Lelevelio vidurinė mokykla";0B;8972073812;Taip;2;0;0;2
19942;"Vilniaus Joachimo Lelevelio vidurinė mokykla";0B;83279104490;Taip;5;0;0;5
19943;"Vilniaus Joachimo Lelevelio vidurinė mokykla";0B;23254881487;Taip;0;0;3;3
19944;"Vilniaus Joachimo Lelevelio vidurinė mokykla";0B;67336376881;Taip;13;2;0;15
19945;"Vilniaus Joachimo Lelevelio vidurinė mokykla";0B;9032277414;Taip;10;0;2;12
19946;"Vilniaus Joachimo Lelevelio vidurinė mokykla";0B;3392530766;Taip;0;7;0;7
19947;"Vilniaus Joachimo Lelevelio vidurinė mokykla";0B;52675265822;Taip;1;0;0;1
19948;"Vilniaus Joachimo Lelevelio vidurinė mokykla";0B;37365823648;Ne;0;1;0;1
19949;"Vilniaus Joachimo Lelevelio vidurinė mokykla";0B;20323559123;Taip;2;0;1;3
19950;"Vilniaus Joachimo Lelevelio vidurinė mokykla";0B;1992741773;Taip;0;4;0;4
19951;"Vilniaus Joachimo Lelevelio vidurinė mokykla";0B;94980538706;Taip;12;2;0;14
19952;"Vilniaus Joachimo Lelevelio vidurinė mokykla";0B;9917295097;Taip;6;7;0;13
19953;"Vilniaus Joachimo Lelevelio vidurinė mokykla";0B;3385391317;Taip;0;25;0;25
19954;"Vilniaus Joachimo Lelevelio vidurinė mokykla";0B;6777530638;Taip;0;0;4;4
19955;"Vilniaus Joachimo Lelevelio vidurinė mokykla";0B;3507030971;Taip;0;0;10;10
19956;"Vilniaus Joachimo Lelevelio vidurinė mokykla";0B;8900287515;Taip;1;0;6;7
19957;"Vilniaus Joachimo Lelevelio vidurinė mokykla";0B;78820258664;Taip;9;1;0;10
19958;"Vilniaus Joachimo Lelevelio vidurinė mokykla";0B;32468645385;Taip;0;25;0;25
19959;"Vilniaus Joachimo Lelevelio vidurinė mokykla";0B;46936589086;Taip;0;0;2;2
19960;"Vilniaus Joachimo Lelevelio vidurinė mokykla";0C;7785594191;Taip;0;3;0;3
19961;"Vilniaus Joachimo Lelevelio vidurinė mokykla";0C;543596002;Taip;0;1;0;1
19962;"Vilniaus Joachimo Lelevelio vidurinė mokykla";0C;64132212674;Taip;0;0;2;2
19963;"Vilniaus Joachimo Lelevelio vidurinė mokykla";0C;63270263063;Taip;0;2;0;2
19964;"Vilniaus Joachimo Lelevelio vidurinė mokykla";0C;77834846979;Taip;0;25;0;25
19965;"Vilniaus Joachimo Lelevelio vidurinė mokykla";0C;10836076854;Taip;4;0;0;4
19966;"Vilniaus Joachimo Lelevelio vidurinė mokykla";0C;4064562873;Taip;0;0;2;2
19967;"Vilniaus Joachimo Lelevelio vidurinė mokykla";0C;7474239709;Taip;0;25;0;25
19968;"Vilniaus Juzefo Ignacijaus Kraševskio gimnazija";Priešmokyklinė;3992602769;Ne;0;0;1;1
19969;"Vilniaus Juzefo Ignacijaus Kraševskio gimnazija";Priešmokyklinė;1636593104;Taip;0;0;3;3
19970;"Vilniaus Juzefo Ignacijaus Kraševskio gimnazija";Priešmokyklinė;2386972224;Taip;0;0;2;2
19971;"Vilniaus Juzefo Ignacijaus Kraševskio gimnazija";Priešmokyklinė;87397764928;Taip;0;2;0;2
19972;"Vilniaus Juzefo Ignacijaus Kraševskio gimnazija";Priešmokyklinė;7947779677;Taip;13;0;1;14
19973;"Vilniaus Juzefo Ignacijaus Kraševskio gimnazija";Priešmokyklinė;7348967815;Taip;0;0;9;9
19974;"Vilniaus Juzefo Ignacijaus Kraševskio gimnazija";Priešmokyklinė;91109920216;Taip;0;0;3;3
19975;"Vilniaus Juzefo Ignacijaus Kraševskio gimnazija";Priešmokyklinė;18683776970;Taip;0;1;0;1
19976;"Vilniaus Juzefo Ignacijaus Kraševskio gimnazija";Priešmokyklinė;45246620717;Taip;9;3;0;12
19977;"Vilniaus Juzefo Ignacijaus Kraševskio gimnazija";Priešmokyklinė;3286294868;Ne;0;0;2;2
19978;"Vilniaus Juzefo Ignacijaus Kraševskio gimnazija";Priešmokyklinė;3025885967;Ne;0;0;1;1
19979;"Vilniaus Juzefo Ignacijaus Kraševskio gimnazija";Priešmokyklinė;13035175969;Taip;9;2;0;11
19980;"Vilniaus Juzefo Ignacijaus Kraševskio gimnazija";Priešmokyklinė;1744052084;Ne;6;0;5;11
19981;"Vilniaus Juzefo Ignacijaus Kraševskio gimnazija";Priešmokyklinė;3454973035;Taip;0;6;0;6
19982;"Vilniaus Juzefo Ignacijaus Kraševskio gimnazija";Priešmokyklinė;9640287886;Ne;6;0;6;12
19983;"Vilniaus Juzefo Ignacijaus Kraševskio gimnazija";Priešmokyklinė;17989172493;Ne;0;8;0;8
19984;"Vilniaus Juzefo Ignacijaus Kraševskio gimnazija";Priešmokyklinė;7866325130;Taip;0;1;18;19
19985;"Vilniaus Jono Pauliaus II progimnazija";Bitutės;2221329657;Taip;5;1;0;6
19986;"Vilniaus Jono Pauliaus II progimnazija";Bitutės;1787688071;Taip;0;1;0;1
19987;"Vilniaus Jono Pauliaus II progimnazija";Bitutės;74095271790;Taip;0;1;6;7
19988;"Vilniaus Jono Pauliaus II progimnazija";Bitutės;75018613955;Taip;0;1;0;1
19989;"Vilniaus Jono Pauliaus II progimnazija";Bitutės;41958962804;Taip;0;2;0;2
19990;"Vilniaus Jono Pauliaus II progimnazija";Bitutės;5290505392;Taip;0;1;2;3
19991;"Vilniaus Jono Pauliaus II progimnazija";Bitutės;62687105812;Taip;0;5;0;5
19992;"Vilniaus Jono Pauliaus II progimnazija";Bitutės;50802361323;Ne;0;1;0;1
19993;"Vilniaus Jono Pauliaus II progimnazija";Bitutės;1051397178;Taip;5;1;0;6
19994;"Vilniaus Jono Pauliaus II progimnazija";Bitutės;18366436287;Taip;0;1;0;1
19995;"Vilniaus Jono Pauliaus II progimnazija";Bitutės;98525894524;Taip;0;6;0;6
19996;"Vilniaus Jono Pauliaus II progimnazija";Bitutės;66886951759;Taip;6;3;0;9
19997;"Vilniaus Jono Pauliaus II progimnazija";Bitutės;1678282458;Taip;0;2;0;2
19998;"Vilniaus Jono Pauliaus II progimnazija";Bitutės;23410902042;Taip;0;2;0;2
19999;"Vilniaus Jono Pauliaus II progimnazija";Bitutės;38208558755;Taip;0;1;0;1
20000;"Vilniaus Jono Pauliaus II progimnazija";Bitutės;1498711260;Taip;0;7;0;7
20001;"Vilniaus Jono Pauliaus II progimnazija";Bitutės;94323422162;Taip;0;1;5;6
20002;"Vilniaus Jono Pauliaus II progimnazija";Bitutės;6373945450;Taip;0;6;0;6
20003;"Vilniaus Jono Pauliaus II progimnazija";Bitutės;1834961037;Taip;20;1;0;21
20004;"Vilniaus Jono Pauliaus II progimnazija";Bitutės;7289945805;Ne;6;1;0;7
20005;"Vilniaus Jono Pauliaus II progimnazija";Bitutės;52202199212;Taip;0;1;3;4
20006;"Vilniaus Jono Pauliaus II progimnazija";Nykštukai;56882212708;Taip;0;1;0;1
20007;"Vilniaus Jono Pauliaus II progimnazija";Nykštukai;84864692736;Taip;4;1;0;5
20008;"Vilniaus Jono Pauliaus II progimnazija";Nykštukai;19330722623;Taip;3;2;5;10
20009;"Vilniaus Jono Pauliaus II progimnazija";Nykštukai;41798150203;Taip;0;21;0;21
20010;"Vilniaus Jono Pauliaus II progimnazija";Nykštukai;1497044775;Taip;0;21;0;21
20011;"Vilniaus Jono Pauliaus II progimnazija";Nykštukai;18174475384;Taip;1;2;1;4
20012;"Vilniaus Jono Pauliaus II progimnazija";Nykštukai;29793632667;Taip;0;2;0;2
20013;"Vilniaus Jono Pauliaus II progimnazija";Nykštukai;2067239710;Taip;6;2;0;8
20014;"Vilniaus Jono Pauliaus II progimnazija";Nykštukai;95238329605;Taip;0;5;0;5
20015;"Vilniaus Jono Pauliaus II progimnazija";Nykštukai;66947843128;Taip;0;1;0;1
20016;"Vilniaus Jono Pauliaus II progimnazija";Nykštukai;96241985330;Taip;0;1;1;2
20017;"Vilniaus Jono Pauliaus II progimnazija";Nykštukai;98624493006;Taip;0;1;0;1
20018;"Vilniaus Jono Pauliaus II progimnazija";Nykštukai;1538884930;Taip;0;1;1;2
20019;"Vilniaus Jono Pauliaus II progimnazija";Nykštukai;97057444920;Taip;0;1;0;1
20020;"Vilniaus Jono Pauliaus II progimnazija";Nykštukai;58033050070;Taip;9;3;0;12
20021;"Vilniaus Jono Pauliaus II progimnazija";Nykštukai;5744439022;Taip;0;1;5;6
20022;"Vilniaus Jono Pauliaus II progimnazija";Nykštukai;30095924180;Taip;0;2;2;4
20023;"Vilniaus Jono Pauliaus II progimnazija";Nykštukai;17663780748;Taip;0;10;0;10
20024;"Vilniaus Jono Pauliaus II progimnazija";Nykštukai;33970738232;Taip;4;2;3;9
20025;"Vilniaus Jono Pauliaus II progimnazija";Nykštukai;28504232181;Taip;0;1;0;1
20026;"Vilniaus Jono Pauliaus II progimnazija";Nykštukai;65927108137;Taip;0;2;5;7
20027;"Vilniaus Jono Pauliaus II progimnazija";Nykštukai;5282646148;Ne;0;4;0;4
20028;"Vilniaus Jono Pauliaus II progimnazija";Nykštukai;29750547072;Taip;0;1;0;1
20029;"Vilniaus Jono Pauliaus II progimnazija";Nykštukai;6636967120;Taip;0;1;1;2
20030;"Vilniaus Jono Pauliaus II progimnazija";Nykštukai;76004865730;Taip;0;5;0;5
20031;"Vilniaus Jono Pauliaus II progimnazija";Nykštukai;1681910702;Taip;0;21;0;21
20032;"Vilniaus Jono Pauliaus II progimnazija";Spindulėlis;86349879099;Taip;0;10;2;12
20033;"Vilniaus Jono Pauliaus II progimnazija";Spindulėlis;71621781260;Taip;0;2;0;2
20034;"Vilniaus Jono Pauliaus II progimnazija";Spindulėlis;40232303318;Taip;0;0;1;1
20035;"Vilniaus Jono Pauliaus II progimnazija";Spindulėlis;2092126666;Taip;0;1;0;1
20036;"Vilniaus Jono Pauliaus II progimnazija";Spindulėlis;18296155488;Taip;0;7;0;7
20037;"Vilniaus Jono Pauliaus II progimnazija";Spindulėlis;82826774977;Taip;0;2;0;2
20038;"Vilniaus Jono Pauliaus II progimnazija";Spindulėlis;27320886907;Taip;3;0;0;3
20039;"Vilniaus Jono Pauliaus II progimnazija";Spindulėlis;90544626686;Ne;0;0;1;1
20040;"Vilniaus Jono Pauliaus II progimnazija";Spindulėlis;50461103065;Taip;10;0;0;10
20041;"Vilniaus Jono Pauliaus II progimnazija";Spindulėlis;23815562807;Taip;0;2;0;2
20042;"Vilniaus Jono Pauliaus II progimnazija";Spindulėlis;9433070239;Taip;4;0;0;4
20043;"Vilniaus Jono Pauliaus II progimnazija";Spindulėlis;14763149919;Taip;10;9;0;19
20044;"Vilniaus Jono Pauliaus II progimnazija";Spindulėlis;13620421173;Ne;0;0;1;1
20045;"Vilniaus Jono Pauliaus II progimnazija";Spindulėlis;9413926262;Ne;0;25;0;25
20046;"Vilniaus Jono Pauliaus II progimnazija";Spindulėlis;1881484420;Ne;4;0;1;5
20047;"Vilniaus Jono Pauliaus II progimnazija";Žiniukai;18666752189;Taip;0;1;0;1
20048;"Vilniaus Jono Pauliaus II progimnazija";Žiniukai;85578252258;Ne;1;1;3;5
20049;"Vilniaus Jono Pauliaus II progimnazija";Žiniukai;16243269254;Taip;5;7;0;12
20050;"Vilniaus Jono Pauliaus II progimnazija";Žiniukai;2268141397;Taip;6;2;0;8
20051;"Vilniaus Jono Pauliaus II progimnazija";Žiniukai;15095928335;Taip;0;1;0;1
20052;"Vilniaus Jono Pauliaus II progimnazija";Žiniukai;97421699352;Taip;6;1;0;7
20053;"Vilniaus Jono Pauliaus II progimnazija";Žiniukai;87167492911;Taip;6;3;0;9
20054;"Vilniaus Jono Pauliaus II progimnazija";Žiniukai;86166153049;Ne;4;3;0;7
20055;"Vilniaus Jono Pauliaus II progimnazija";Žiniukai;23756278273;Taip;0;5;0;5
20056;"Vilniaus Jono Pauliaus II progimnazija";Žiniukai;76860078254;Taip;0;4;0;4
20057;"Vilniaus Jono Pauliaus II progimnazija";Žiniukai;59698476683;Taip;0;1;1;2
20058;"Vilniaus Jono Pauliaus II progimnazija";Žiniukai;1265276800;Taip;15;1;0;16
20059;"Vilniaus Jono Pauliaus II progimnazija";Žiniukai;52145954352;Taip;0;3;3;6
20060;"Vilniaus Jono Pauliaus II progimnazija";Žiniukai;13144507021;Taip;7;1;0;8
20061;"Vilniaus Jono Pauliaus II progimnazija";Žiniukai;2145527582;Ne;0;3;0;3
20062;"Vilniaus Jono Pauliaus II progimnazija";Žiniukai;74531978509;Taip;0;4;0;4
20063;"Vilniaus Jono Pauliaus II progimnazija";Žiniukai;45823285175;Taip;7;1;0;8
20064;"Vilniaus Jono Pauliaus II progimnazija";Žiniukai;63967215708;Taip;8;1;0;9
20065;"Vilniaus Jono Pauliaus II progimnazija";Žiniukai;88089833901;Ne;0;1;0;1
20066;"Vilniaus Jono Pauliaus II progimnazija";Žiniukai;71421862891;Taip;7;1;1;9
20067;"Vilniaus Jono Pauliaus II progimnazija";Žiniukai;94546685371;Taip;12;4;0;16
20068;"Vilniaus Jono Pauliaus II progimnazija";Žiniukai;1883620780;Taip;0;1;0;1
20069;"Vilniaus Jono Pauliaus II progimnazija";Žiniukai;64083158642;Taip;3;1;3;7
20070;"Vilniaus Senamiesčio vidurinė mokykla";PG1;1059396976;Taip;1;6;0;7
20071;"Vilniaus Senamiesčio vidurinė mokykla";PG1;2094485999;Taip;0;6;1;7
20072;"Vilniaus Senamiesčio vidurinė mokykla";PG1;4793402013;Taip;0;6;1;7
20073;"Vilniaus Senamiesčio vidurinė mokykla";PG1;30428486005;Ne;0;6;0;6
20074;"Vilniaus Senamiesčio vidurinė mokykla";PG1;1369622524;Taip;0;22;0;22
20075;"Vilniaus Senamiesčio vidurinė mokykla";PG1;56224529599;Ne;0;6;0;6
20076;"Vilniaus Senamiesčio vidurinė mokykla";PG1;65977368065;Taip;0;14;0;14
20077;"Vilniaus Senamiesčio vidurinė mokykla";PG1;54923779499;Taip;0;8;0;8
20078;"Vilniaus Senamiesčio vidurinė mokykla";PG1;5575633653;Taip;2;6;0;8
20079;"Vilniaus Senamiesčio vidurinė mokykla";PG1;1813072867;Taip;7;12;0;19
20080;"Vilniaus Senamiesčio vidurinė mokykla";PG1;7764171885;Taip;4;6;0;10
20081;"Vilniaus Senamiesčio vidurinė mokykla";PG1;152363521;Taip;0;22;0;22
