Nr.;"Darželio pavadinimas";"Grupės pavadinimas";"Vaiko Identifikacinis Nr.";"Deklaruotas mieste";"Pateisintos dėl ligos";"Pateisintos dėl kitų priežasčių";"Nepateisintos dienos";"Praleistos dienos Viso"
1;Aitvaras;"VIJURKAI (ALERG.)";8610723991;Taip;1;1;0;2
2;Aitvaras;"VIJURKAI (ALERG.)";82386048619;Taip;5;0;13;18
3;Aitvaras;"VIJURKAI (ALERG.)";86008218554;Taip;5;2;0;7
4;Aitvaras;"VIJURKAI (ALERG.)";44900473149;Taip;0;2;2;4
5;Aitvaras;"VIJURKAI (ALERG.)";9065712699;Taip;6;10;0;16
6;Aitvaras;"VIJURKAI (ALERG.)";63345306760;Ne;0;0;1;1
7;Aitvaras;"VIJURKAI (ALERG.)";84623684490;Taip;0;2;2;4
8;Aitvaras;"VIJURKAI (ALERG.)";16402806518;Taip;0;0;2;2
9;Aitvaras;"VIJURKAI (ALERG.)";74266054705;Taip;0;2;1;3
10;Aitvaras;"VIJURKAI (ALERG.)";40455080945;Taip;0;4;0;4
11;Aitvaras;"VIJURKAI (ALERG.)";1156348512;Taip;0;1;0;1
12;Aitvaras;"VIJURKAI (ALERG.)";3724722474;Taip;0;7;0;7
13;Aitvaras;"VIJURKAI (ALERG.)";15430509460;Taip;0;2;5;7
14;Aitvaras;"VIJURKAI (ALERG.)";1795308718;Taip;0;2;0;2
15;Aitvaras;"VIJURKAI (ALERG.)";1130945040;Taip;0;0;3;3
16;Aitvaras;"VIJURKAI (ALERG.)";1652249394;Taip;0;2;1;3
17;Aitvaras;"VIJURKAI (ALERG.)";33729670803;Taip;5;0;2;7
18;Aitvaras;"SMALSUČIAI (ALERG.)";1396233353;Taip;0;8;0;8
19;Aitvaras;"SMALSUČIAI (ALERG.)";7062437676;Taip;0;1;0;1
20;Aitvaras;"SMALSUČIAI (ALERG.)";19974574043;Taip;0;1;0;1
21;Aitvaras;"SMALSUČIAI (ALERG.)";8756767379;Taip;0;1;0;1
22;Aitvaras;"SMALSUČIAI (ALERG.)";28583194438;Taip;0;5;0;5
23;Aitvaras;"SMALSUČIAI (ALERG.)";23092799474;Taip;0;1;0;1
24;Aitvaras;"SMALSUČIAI (ALERG.)";1286577536;Taip;0;0;7;7
25;Aitvaras;"SMALSUČIAI (ALERG.)";63572158244;Taip;0;2;0;2
26;Aitvaras;"SMALSUČIAI (ALERG.)";2259914595;Taip;0;2;0;2
27;Aitvaras;"SMALSUČIAI (ALERG.)";33421843741;Taip;6;0;0;6
28;Aitvaras;"SMALSUČIAI (ALERG.)";56144623807;Taip;0;1;0;1
29;Aitvaras;"SMALSUČIAI (ALERG.)";35714998920;Taip;0;5;0;5
30;Aitvaras;"SMALSUČIAI (ALERG.)";65184449922;Taip;1;0;1;2
31;Aitvaras;"SMALSUČIAI (ALERG.)";35989222658;Taip;0;1;0;1
32;Aitvaras;"SMALSUČIAI (ALERG.)";38025877986;Ne;0;4;0;4
33;Aitvaras;"SMALSUČIAI (ALERG.)";2758970705;Taip;0;0;6;6
34;Aitvaras;"SMALSUČIAI (ALERG.)";64844875547;Taip;0;1;0;1
35;Aitvaras;"SMALSUČIAI (ALERG.)";91112093978;Taip;2;2;0;4
36;Aitvaras;PADAUŽIUKAI;891634233;Taip;18;2;0;20
37;Aitvaras;PADAUŽIUKAI;37239090522;Ne;11;0;0;11
38;Aitvaras;PADAUŽIUKAI;51360850840;Taip;4;0;1;5
39;Aitvaras;PADAUŽIUKAI;56549255312;Taip;0;2;2;4
40;Aitvaras;PADAUŽIUKAI;23252314829;Taip;0;2;0;2
41;Aitvaras;PADAUŽIUKAI;2910005555;Taip;0;6;1;7
42;Aitvaras;PADAUŽIUKAI;18037655336;Taip;0;1;0;1
43;Aitvaras;PADAUŽIUKAI;53743278288;Taip;0;2;3;5
44;Aitvaras;PADAUŽIUKAI;80728374682;Taip;6;0;1;7
45;Aitvaras;PADAUŽIUKAI;81647038853;Taip;0;0;1;1
46;Aitvaras;PADAUŽIUKAI;22518124043;Taip;0;0;6;6
47;Aitvaras;"AITVARIUKAI (ALERG.)";37391225613;Taip;0;1;0;1
48;Aitvaras;"AITVARIUKAI (ALERG.)";76280361479;Taip;0;1;0;1
49;Aitvaras;"AITVARIUKAI (ALERG.)";2674192321;Taip;0;0;2;2
50;Aitvaras;"AITVARIUKAI (ALERG.)";13670186807;Taip;22;0;0;22
51;Aitvaras;"AITVARIUKAI (ALERG.)";31074942686;Taip;0;3;0;3
52;Aitvaras;"AITVARIUKAI (ALERG.)";12962784212;Ne;4;6;0;10
53;Aitvaras;"AITVARIUKAI (ALERG.)";1542575012;Taip;0;1;0;1
54;Aitvaras;"AITVARIUKAI (ALERG.)";3471031093;Taip;14;2;0;16
55;Aitvaras;"AITVARIUKAI (ALERG.)";9810370596;Taip;2;0;1;3
56;Aitvaras;"AITVARIUKAI (ALERG.)";34735287315;Taip;2;1;3;6
57;Aitvaras;"AITVARIUKAI (ALERG.)";84919478493;Taip;8;0;0;8
58;Aitvaras;"AITVARIUKAI (ALERG.)";9745864667;Taip;16;3;0;19
59;Aitvaras;"AITVARIUKAI (ALERG.)";5389627560;Taip;0;0;6;6
60;Aitvaras;"AITVARIUKAI (ALERG.)";5956333024;Taip;0;12;0;12
61;Aitvaras;"AITVARIUKAI (ALERG.)";1636794584;Taip;8;0;0;8
62;Aitvaras;"AITVARIUKAI (ALERG.)";2953536545;Taip;0;2;1;3
63;Aitvaras;"AITVARIUKAI (ALERG.)";3535659630;Taip;0;0;5;5
64;Aitvaras;"AITVARIUKAI (ALERG.)";2566375128;Taip;0;2;0;2
65;Aitvaras;"AITVARIUKAI (ALERG.)";6356432078;Taip;0;11;0;11
66;Aitvaras;"SAULĖS ZUIKUČIAI  (ALERG.)";1019661577;Taip;0;2;0;2
67;Aitvaras;"SAULĖS ZUIKUČIAI  (ALERG.)";55369747065;Ne;22;0;0;22
68;Aitvaras;"SAULĖS ZUIKUČIAI  (ALERG.)";5204534227;Taip;0;2;0;2
69;Aitvaras;"SAULĖS ZUIKUČIAI  (ALERG.)";89623351867;Taip;0;2;0;2
70;Aitvaras;"SAULĖS ZUIKUČIAI  (ALERG.)";837021325;Taip;0;1;0;1
71;Aitvaras;"SAULĖS ZUIKUČIAI  (ALERG.)";1207249857;Taip;2;2;2;6
72;Aitvaras;"SAULĖS ZUIKUČIAI  (ALERG.)";30174058452;Taip;4;0;0;4
73;Aitvaras;"SAULĖS ZUIKUČIAI  (ALERG.)";24247118884;Taip;0;2;0;2
74;Aitvaras;"SAULĖS ZUIKUČIAI  (ALERG.)";1516018865;Taip;0;5;0;5
75;Aitvaras;"SAULĖS ZUIKUČIAI  (ALERG.)";1392528718;Taip;5;2;0;7
76;Aitvaras;"SAULĖS ZUIKUČIAI  (ALERG.)";1892295973;Ne;0;5;0;5
77;Aitvaras;"SAULĖS ZUIKUČIAI  (ALERG.)";1011446683;Taip;0;0;7;7
78;Aitvaras;"SAULĖS ZUIKUČIAI  (ALERG.)";2021772475;Ne;0;0;3;3
79;Aitvaras;"SAULĖS ZUIKUČIAI  (ALERG.)";1872130301;Taip;4;6;0;10
80;Aitvaras;"SAULĖS ZUIKUČIAI  (ALERG.)";6745376381;Taip;0;1;0;1
81;Aitvaras;"SAULĖS ZUIKUČIAI  (ALERG.)";3433178644;Ne;0;7;0;7
82;Aitvaras;"SAULĖS ZUIKUČIAI  (ALERG.)";69352006024;Taip;0;3;0;3
83;Aitvaras;"SAULĖS ZUIKUČIAI  (ALERG.)";2083332491;Ne;0;8;0;8
84;Aitvaras;"SAULĖS ZUIKUČIAI  (ALERG.)";61721665912;Taip;0;2;1;3
85;Aitvaras;"SAULĖS ZUIKUČIAI  (ALERG.)";6238828251;Taip;2;8;2;12
86;Aitvaras;"SAULĖS ZUIKUČIAI  (ALERG.)";99037281876;Taip;0;2;0;2
87;Aitvaras;"ŽEMYNUKAI (ALERG.)";1301667420;Taip;0;9;0;9
88;Aitvaras;"ŽEMYNUKAI (ALERG.)";47686798724;Taip;0;1;10;11
89;Aitvaras;"ŽEMYNUKAI (ALERG.)";94080483856;Taip;0;4;0;4
90;Aitvaras;"ŽEMYNUKAI (ALERG.)";1621302802;Taip;0;2;0;2
91;Aitvaras;"ŽEMYNUKAI (ALERG.)";7592535089;Taip;22;0;0;22
92;Aitvaras;"ŽEMYNUKAI (ALERG.)";5083382326;Taip;0;8;0;8
93;Aitvaras;"ŽEMYNUKAI (ALERG.)";3001619281;Taip;5;14;0;19
94;Aitvaras;"ŽEMYNUKAI (ALERG.)";4708741626;Ne;7;2;0;9
95;Aitvaras;"ŽEMYNUKAI (ALERG.)";85826303673;Taip;0;1;1;2
96;Aitvaras;"ŽEMYNUKAI (ALERG.)";44139920757;Ne;3;1;0;4
97;Aitvaras;"ŽEMYNUKAI (ALERG.)";9845539641;Taip;12;1;0;13
98;Aitvaras;"ŽEMYNUKAI (ALERG.)";1600657305;Taip;0;1;0;1
99;Aitvaras;"ŽEMYNUKAI (ALERG.)";1652681820;Taip;5;2;0;7
100;Aitvaras;"ŽEMYNUKAI (ALERG.)";6166757095;Taip;0;12;3;15
101;Aitvaras;"ŽEMYNUKAI (ALERG.)";1201862001;Ne;17;1;0;18
102;Aitvaras;"ŽEMYNUKAI (ALERG.)";5595233402;Taip;5;1;0;6
103;Aitvaras;"ŽEMYNUKAI (ALERG.)";2650483861;Taip;21;0;1;22
104;Aitvaras;"ŽEMYNUKAI (ALERG.)";5922357091;Taip;11;2;1;14
105;Aitvaras;"ŽEMYNUKAI (ALERG.)";6951219468;Taip;5;0;0;5
106;Aitvaras;"ŽEMYNUKAI (ALERG.)";4868552034;Taip;0;1;1;2
107;Aitvaras;"ŽEMYNUKAI (ALERG.)";8970519668;Ne;0;8;0;8
108;Aitvaras;"ŽEMYNUKAI (ALERG.)";84922258988;Taip;5;10;0;15
109;Aitvaras;"ŽEMYNUKAI (ALERG.)";1494094426;Taip;3;8;0;11
110;Aitvaras;"LINKSMUČIAI (ALERG.)";5238819066;Taip;7;0;0;7
111;Aitvaras;"LINKSMUČIAI (ALERG.)";7109001184;Taip;0;0;2;2
112;Aitvaras;"LINKSMUČIAI (ALERG.)";5378212904;Ne;22;0;0;22
113;Aitvaras;"LINKSMUČIAI (ALERG.)";3655710511;Taip;12;0;0;12
114;Aitvaras;"LINKSMUČIAI (ALERG.)";1091372798;Taip;0;1;0;1
115;Aitvaras;"LINKSMUČIAI (ALERG.)";6572235324;Taip;19;0;0;19
116;Aitvaras;"LINKSMUČIAI (ALERG.)";8666824607;Ne;0;1;4;5
117;Aitvaras;"LINKSMUČIAI (ALERG.)";5612991255;Taip;0;1;0;1
118;Aitvaras;"LINKSMUČIAI (ALERG.)";5330618557;Taip;20;0;0;20
119;Aitvaras;"LINKSMUČIAI (ALERG.)";5504431748;Taip;10;0;0;10
120;Aitvaras;"LINKSMUČIAI (ALERG.)";8206046301;Taip;18;0;0;18
121;Aitvaras;"LINKSMUČIAI (ALERG.)";4480921300;Taip;10;5;3;18
122;Aitvaras;"LINKSMUČIAI (ALERG.)";8178703988;Taip;20;0;2;22
123;Aitvaras;"LINKSMUČIAI (ALERG.)";1532588441;Taip;0;1;0;1
124;Aitvaras;"LINKSMUČIAI (ALERG.)";7260577885;Taip;0;2;0;2
125;Aitvaras;"LINKSMUČIAI (ALERG.)";1599183050;Taip;9;0;1;10
126;Aitvaras;"LINKSMUČIAI (ALERG.)";3944373116;Taip;10;1;1;12
127;Aitvaras;"LINKSMUČIAI (ALERG.)";1115202169;Taip;5;1;1;7
128;Aitvaras;"LINKSMUČIAI (ALERG.)";7029464687;Taip;7;0;0;7
129;Aitvaras;"LINKSMUČIAI (ALERG.)";4613894944;Taip;12;0;0;12
130;Aitvaras;"LINKSMUČIAI (ALERG.)";2760970218;Taip;10;0;0;10
131;Aitvaras;"LINKSMUČIAI (ALERG.)";4120515569;Taip;16;0;0;16
132;Aitvaras;NAMINUKAI;40344230133;Taip;5;0;0;5
133;Aitvaras;NAMINUKAI;1493048970;Ne;10;0;1;11
134;Aitvaras;NAMINUKAI;1306408890;Taip;0;1;0;1
135;Aitvaras;NAMINUKAI;59572108690;Taip;6;0;0;6
136;Aitvaras;NAMINUKAI;74628671065;Taip;0;12;0;12
137;Aitvaras;NAMINUKAI;70367340825;Taip;0;6;0;6
138;Aitvaras;NAMINUKAI;62126044317;Taip;0;8;0;8
139;Aitvaras;NAMINUKAI;1790437467;Taip;0;3;0;3
140;Aitvaras;NAMINUKAI;46021715174;Taip;0;0;3;3
141;Aitvaras;NAMINUKAI;85560586048;Taip;0;0;2;2
142;Aitvaras;NAMINUKAI;26906648835;Taip;0;0;1;1
143;Aitvaras;NAMINUKAI;1681260995;Taip;0;0;1;1
144;Aitvaras;NAMINUKAI;42556460388;Taip;10;0;0;10
145;Aitvaras;NAMINUKAI;54496602809;Ne;9;4;1;14
146;Aitvaras;NAMINUKAI;1487264184;Taip;0;0;3;3
147;Aitvaras;NAMINUKAI;97382092851;Taip;6;6;0;12
148;Aitvaras;NAMINUKAI;1886917840;Taip;22;0;0;22
149;Aitvaras;NAMINUKAI;6647800967;Ne;1;6;0;7
150;Aitvaras;NAMINUKAI;52679806772;Taip;0;0;2;2
151;Aitvaras;NAMINUKAI;5103057090;Taip;1;0;1;2
152;Aitvaras;NAMINUKAI;3836513736;Taip;20;0;1;21
153;Aitvaras;ŠELMIAI;9332771711;Taip;6;3;0;9
154;Aitvaras;ŠELMIAI;6550426644;Taip;15;5;0;20
155;Aitvaras;ŠELMIAI;5818794912;Taip;0;0;1;1
156;Aitvaras;ŠELMIAI;58780461337;Taip;0;1;0;1
157;Aitvaras;ŠELMIAI;1116271183;Taip;10;0;0;10
158;Aitvaras;ŠELMIAI;44046627149;Taip;0;9;0;9
159;Aitvaras;ŠELMIAI;43711349817;Taip;2;0;0;2
160;Aitvaras;ŠELMIAI;7469656671;Taip;3;0;0;3
161;Aitvaras;ŠELMIAI;2408952971;Taip;6;1;0;7
162;Aitvaras;ŠELMIAI;47875842134;Taip;4;0;0;4
163;Aitvaras;ŠELMIAI;40799643122;Taip;13;0;0;13
164;Aitvaras;ŠELMIAI;8784628567;Taip;7;2;1;10
165;Aitvaras;ŠELMIAI;2601983670;Taip;9;0;0;9
166;Aitvaras;ŠELMIAI;1387254053;Taip;0;0;3;3
167;Aitvaras;ŠELMIAI;8503279655;Taip;0;1;2;3
168;Aitvaras;ŠELMIAI;1105354193;Taip;5;0;0;5
169;Aitvaras;ŠELMIAI;2034293999;Taip;22;0;0;22
170;Aitvaras;ŠELMIAI;1996524718;Taip;11;1;1;13
171;Aitvaras;ŠELMIAI;4110585744;Ne;0;13;4;17
172;Aitvaras;ŠELMIAI;6010324894;Taip;13;0;1;14
173;Aitvaras;KODĖLČIUKAI;403821197;Taip;0;2;0;2
174;Aitvaras;KODĖLČIUKAI;64683090780;Taip;0;7;0;7
175;Aitvaras;KODĖLČIUKAI;87846069433;Taip;8;1;0;9
176;Aitvaras;KODĖLČIUKAI;12216502128;Taip;0;3;0;3
177;Aitvaras;KODĖLČIUKAI;46998364516;Taip;0;2;0;2
178;Aitvaras;KODĖLČIUKAI;45833790181;Taip;10;2;0;12
179;Aitvaras;KODĖLČIUKAI;89194677727;Taip;0;1;0;1
180;Aitvaras;KODĖLČIUKAI;24017694836;Taip;0;0;4;4
181;Aitvaras;KODĖLČIUKAI;64205113506;Taip;0;2;2;4
182;Aitvaras;KODĖLČIUKAI;54438500410;Taip;0;1;0;1
183;Aitvaras;KODĖLČIUKAI;25117529505;Taip;0;11;0;11
184;Aitvaras;KODĖLČIUKAI;2136550853;Ne;5;2;4;11
185;Aitvaras;KODĖLČIUKAI;75662895254;Taip;0;1;0;1
186;Aitvaras;KODĖLČIUKAI;1355296093;Taip;5;7;0;12
187;Aitvaras;KODĖLČIUKAI;1850900990;Taip;0;4;0;4
188;Aitvaras;KODĖLČIUKAI;30517554931;Ne;2;3;0;5
189;Aitvaras;KODĖLČIUKAI;2092431875;Taip;8;9;0;17
190;Aitvaras;KODĖLČIUKAI;1371102633;Taip;7;2;2;11
191;Aitvaras;KODĖLČIUKAI;1641140396;Ne;5;2;6;13
192;Aitvaras;KODĖLČIUKAI;9649742132;Taip;0;3;0;3
193;Aitvaras;KODĖLČIUKAI;1476238636;Taip;0;0;4;4
194;Aitvaras;KODĖLČIUKAI;1315081684;Taip;0;0;3;3
195;Aitvaras;PABIRUČIAI;1288810999;Taip;10;0;4;14
196;Aitvaras;PABIRUČIAI;3178965623;Taip;0;1;0;1
197;Aitvaras;PABIRUČIAI;8065540507;Taip;10;11;0;21
198;Aitvaras;PABIRUČIAI;6501943902;Taip;0;0;22;22
199;Aitvaras;PABIRUČIAI;3101015381;Taip;0;0;3;3
200;Aitvaras;PABIRUČIAI;4350590529;Taip;10;0;0;10
201;Aitvaras;PABIRUČIAI;7777235021;Taip;10;1;1;12
202;Aitvaras;PABIRUČIAI;5641224483;Taip;0;1;0;1
203;Aitvaras;PABIRUČIAI;1830134108;Taip;0;14;0;14
204;Aitvaras;PABIRUČIAI;8121858940;Taip;0;0;4;4
205;Aitvaras;PABIRUČIAI;2452780076;Taip;11;0;0;11
206;Aitvaras;PABIRUČIAI;5905456814;Ne;15;0;1;16
207;Aitvaras;PABIRUČIAI;1761446849;Taip;9;0;0;9
208;Aitvaras;PABIRUČIAI;6739827530;Taip;0;0;3;3
209;Aitvaras;PABIRUČIAI;2807595769;Ne;0;6;1;7
210;Aitvaras;PABIRUČIAI;1252145346;Taip;0;0;3;3
211;Aitvaras;PABIRUČIAI;7455895024;Taip;5;0;0;5
212;Aitvaras;PABIRUČIAI;8439586875;Taip;0;0;1;1
213;Aitvaras;PABIRUČIAI;8043062737;Taip;8;0;0;8
214;Aitvaras;"SVAJOKLIAI  (ALERG.)";5770779699;Taip;0;2;0;2
215;Aitvaras;"SVAJOKLIAI  (ALERG.)";2159901439;Taip;0;8;0;8
216;Aitvaras;"SVAJOKLIAI  (ALERG.)";1553462849;Ne;0;8;0;8
217;Aitvaras;"SVAJOKLIAI  (ALERG.)";8366627546;Taip;0;10;0;10
218;Aitvaras;"SVAJOKLIAI  (ALERG.)";1398792964;Taip;0;2;0;2
219;Aitvaras;"SVAJOKLIAI  (ALERG.)";1834535594;Taip;7;1;0;8
220;Aitvaras;"SVAJOKLIAI  (ALERG.)";7083046536;Taip;7;1;0;8
221;Aitvaras;"SVAJOKLIAI  (ALERG.)";3716313515;Taip;4;2;0;6
222;Aitvaras;"SVAJOKLIAI  (ALERG.)";1606267845;Taip;10;0;0;10
223;Aitvaras;"SVAJOKLIAI  (ALERG.)";5856250605;Taip;19;0;0;19
224;Aitvaras;"SVAJOKLIAI  (ALERG.)";2004112424;Taip;18;2;0;20
225;Aitvaras;"SVAJOKLIAI  (ALERG.)";6084096300;Taip;0;7;0;7
226;Aitvaras;"SVAJOKLIAI  (ALERG.)";5750154036;Taip;0;5;0;5
227;Aitvaras;"SVAJOKLIAI  (ALERG.)";6201118021;Taip;5;0;0;5
228;Aitvaras;"SVAJOKLIAI  (ALERG.)";1773366241;Taip;0;1;0;1
229;Aitvaras;"SVAJOKLIAI  (ALERG.)";1940545723;Taip;0;10;0;10
230;Aitvaras;"SVAJOKLIAI  (ALERG.)";3133031845;Taip;0;2;0;2
231;Aitvaras;"SVAJOKLIAI  (ALERG.)";1275561645;Ne;6;2;0;8
232;Aitvaras;"SVAJOKLIAI  (ALERG.)";1481849611;Taip;22;0;0;22
233;Aitvaras;"SVAJOKLIAI  (ALERG.)";1090979323;Taip;5;1;0;6
234;Aitvaras;"SVAJOKLIAI  (ALERG.)";1879540041;Taip;10;3;0;13
235;Aitvaras;"SVAJOKLIAI  (ALERG.)";1347364985;Taip;15;7;0;22
236;Aitvaras;"SVAJOKLIAI  (ALERG.)";5425259260;Taip;12;3;0;15
237;Atžalėlės;Gėlytės;28219993536;Taip;0;0;2;2
238;Atžalėlės;Gėlytės;63065430971;Taip;0;0;2;2
239;Atžalėlės;Gėlytės;42516348711;Ne;0;0;4;4
240;Atžalėlės;Gėlytės;91973899274;Taip;3;0;1;4
241;Atžalėlės;Gėlytės;67614970563;Taip;0;0;8;8
242;Atžalėlės;Gėlytės;23898319471;Ne;0;0;3;3
243;Atžalėlės;Gėlytės;46113919448;Taip;0;0;3;3
244;Atžalėlės;Gėlytės;28334054013;Taip;1;0;0;1
245;Atžalėlės;Gėlytės;84635439691;Taip;0;0;5;5
246;Atžalėlės;Gėlytės;20861477621;Taip;0;1;3;4
247;Atžalėlės;Gėlytės;6248765693;Taip;0;0;9;9
248;Atžalėlės;Gėlytės;74767205037;Taip;2;0;2;4
249;Atžalėlės;Gėlytės;45220122220;Taip;2;0;0;2
250;Atžalėlės;Gėlytės;51485435726;Taip;0;0;3;3
251;Atžalėlės;Gėlytės;16280202740;Taip;5;0;0;5
252;Atžalėlės;Gėlytės;67950853185;Taip;0;6;0;6
253;Atžalėlės;Gėlytės;95195013544;Taip;0;0;6;6
254;Atžalėlės;Gėlytės;2004639307;Taip;5;0;4;9
255;Atžalėlės;Gėlytės;7157406678;Taip;0;0;1;1
256;Atžalėlės;Gėlytės;98084870071;Taip;6;0;0;6
257;Atžalėlės;Drugeliai;4643154006;Taip;7;1;0;8
258;Atžalėlės;Drugeliai;6903666624;Taip;5;17;0;22
259;Atžalėlės;Drugeliai;6570245757;Taip;17;0;2;19
260;Atžalėlės;Drugeliai;9491132884;Taip;6;0;0;6
261;Atžalėlės;Drugeliai;6132569107;Taip;0;0;1;1
262;Atžalėlės;Drugeliai;2315790531;Taip;2;0;0;2
263;Atžalėlės;Drugeliai;6782007470;Taip;0;7;0;7
264;Atžalėlės;Drugeliai;8393217418;Taip;0;10;0;10
265;Atžalėlės;Drugeliai;1805496887;Taip;0;0;7;7
266;Atžalėlės;Drugeliai;5417971068;Ne;0;0;1;1
267;Atžalėlės;Drugeliai;9463215947;Taip;0;2;0;2
268;Atžalėlės;Drugeliai;7953922166;Taip;6;1;0;7
269;Atžalėlės;Drugeliai;1830572633;Taip;0;0;2;2
270;Atžalėlės;Drugeliai;9222670655;Taip;5;7;0;12
271;Atžalėlės;Drugeliai;1429493246;Taip;3;1;0;4
272;Atžalėlės;Drugeliai;6114426973;Taip;7;12;0;19
273;Atžalėlės;Drugeliai;1456979448;Taip;9;3;0;12
274;Atžalėlės;Drugeliai;4884599397;Taip;0;0;1;1
275;Atžalėlės;Drugeliai;8718036014;Taip;0;0;1;1
276;Atžalėlės;Drugeliai;3571134734;Taip;22;0;0;22
277;Atžalėlės;Gandriukai;93452036571;Taip;5;5;0;10
278;Atžalėlės;Gandriukai;4483002806;Taip;10;0;0;10
279;Atžalėlės;Gandriukai;87334806437;Taip;0;2;0;2
280;Atžalėlės;Gandriukai;1204800605;Taip;5;6;0;11
281;Atžalėlės;Gandriukai;1074259644;Taip;8;2;0;10
282;Atžalėlės;Gandriukai;66107666615;Taip;8;0;1;9
283;Atžalėlės;Gandriukai;2124150483;Taip;5;0;0;5
284;Atžalėlės;Gandriukai;63867153552;Taip;0;4;0;4
285;Atžalėlės;Gandriukai;78120202936;Taip;8;1;0;9
286;Atžalėlės;Gandriukai;1011601294;Taip;0;5;0;5
287;Atžalėlės;Gandriukai;80500800894;Taip;0;0;2;2
288;Atžalėlės;Gandriukai;519493490;Ne;5;8;0;13
289;Atžalėlės;Gandriukai;82777644548;Taip;5;0;10;15
290;Atžalėlės;Gandriukai;23453799177;Taip;0;12;0;12
291;Atžalėlės;Gandriukai;78664848612;Taip;5;0;0;5
292;Atžalėlės;Voveriukai;70223507658;Taip;1;0;1;2
293;Atžalėlės;Voveriukai;21599916055;Taip;7;0;0;7
294;Atžalėlės;Voveriukai;52803011399;Taip;3;0;0;3
295;Atžalėlės;Voveriukai;30370285022;Taip;0;3;0;3
296;Atžalėlės;Voveriukai;1447259034;Taip;5;3;0;8
297;Atžalėlės;Voveriukai;64596277701;Taip;0;0;2;2
298;Atžalėlės;Voveriukai;3379307367;Taip;0;0;1;1
299;Atžalėlės;Voveriukai;1312772153;Taip;7;0;0;7
300;Atžalėlės;Voveriukai;53559306492;Taip;0;5;0;5
301;Atžalėlės;Voveriukai;2488405485;Taip;7;2;0;9
302;Atžalėlės;Voveriukai;39714182342;Taip;14;1;0;15
303;Atžalėlės;Voveriukai;6975941393;Taip;10;3;0;13
304;Atžalėlės;Voveriukai;1865339755;Taip;0;10;2;12
305;Atžalėlės;Voveriukai;8138683218;Taip;1;10;0;11
306;Atžalėlės;Voveriukai;4467364336;Taip;1;0;1;2
307;Atžalėlės;Voveriukai;1804802235;Taip;3;0;0;3
308;Atžalėlės;Voveriukai;1316154666;Taip;0;3;5;8
309;Atžalėlės;Voveriukai;9699811980;Ne;0;6;0;6
310;Atžalėlės;Voveriukai;8847754477;Taip;0;3;0;3
311;Atžalėlės;Voveriukai;7689394485;Taip;7;0;3;10
312;Atžalėlės;Žirniukai;4098210138;Ne;0;0;1;1
313;Atžalėlės;Žirniukai;1500456945;Taip;0;0;3;3
314;Atžalėlės;Žirniukai;1450609695;Taip;0;1;0;1
315;Atžalėlės;Žirniukai;1844980319;Ne;3;0;8;11
316;Atžalėlės;Žirniukai;5997958773;Ne;10;0;5;15
317;Atžalėlės;Žirniukai;6177038838;Taip;0;3;3;6
318;Atžalėlės;Žirniukai;1722233272;Taip;0;16;0;16
319;Atžalėlės;Žirniukai;5310990513;Taip;7;0;0;7
320;Atžalėlės;Žirniukai;8524244526;Taip;10;0;4;14
321;Atžalėlės;Žirniukai;1704679306;Taip;2;14;1;17
322;Atžalėlės;Žirniukai;7702502252;Taip;0;9;0;9
323;Atžalėlės;Žirniukai;9189223222;Taip;7;0;1;8
324;Atžalėlės;Žirniukai;3283415814;Taip;2;0;1;3
325;Atžalėlės;Žirniukai;1146492807;Taip;8;0;3;11
326;Atžalėlės;Žirniukai;7356877676;Taip;0;1;0;1
327;Atžalėlės;Ežiukai;5432433423;Taip;0;12;0;12
328;Atžalėlės;Ežiukai;8819893830;Taip;5;0;1;6
329;Atžalėlės;Ežiukai;8695865604;Ne;5;10;0;15
330;Atžalėlės;Ežiukai;4284673729;Taip;11;0;9;20
331;Atžalėlės;Ežiukai;1431197358;Taip;5;0;0;5
332;Atžalėlės;Ežiukai;4177753994;Taip;0;0;9;9
333;Atžalėlės;Ežiukai;5742471497;Taip;1;0;5;6
334;Atžalėlės;Ežiukai;2385614957;Taip;4;0;0;4
335;Atžalėlės;Ežiukai;9715625283;Taip;0;0;21;21
336;Atžalėlės;Ežiukai;6202250600;Taip;10;5;1;16
337;Atžalėlės;Ežiukai;6024189665;Taip;5;0;5;10
338;Atžalėlės;Ežiukai;4238773173;Taip;0;0;1;1
339;Atžalėlės;Ežiukai;2131592139;Taip;15;5;0;20
340;Atžalėlės;Ežiukai;8201582382;Taip;6;0;1;7
341;Atžalėlės;Ežiukai;4362058013;Taip;6;0;1;7
342;Atžalėlės;Ežiukai;3191066669;Taip;7;0;0;7
343;Atžalėlės;Ežiukai;1137741059;Taip;12;0;0;12
344;Atžalėlės;Paukšteliai;77693032830;Ne;0;6;0;6
345;Atžalėlės;Paukšteliai;99097316080;Taip;0;0;11;11
346;Atžalėlės;Paukšteliai;1576891322;Ne;5;0;0;5
347;Atžalėlės;Paukšteliai;18833055728;Taip;0;0;2;2
348;Atžalėlės;Paukšteliai;72360139252;Taip;0;15;0;15
349;Atžalėlės;Paukšteliai;89028851257;Taip;0;0;1;1
350;Atžalėlės;Paukšteliai;54417643140;Taip;7;0;0;7
351;Atžalėlės;Paukšteliai;91411809951;Taip;0;4;0;4
352;Atžalėlės;Paukšteliai;1046971571;Taip;18;0;0;18
353;Atžalėlės;Paukšteliai;50283267330;Taip;3;0;1;4
354;Atžalėlės;Paukšteliai;93709702327;Taip;0;12;2;14
355;Atžalėlės;Paukšteliai;90664899396;Taip;5;0;0;5
356;Atžalėlės;Paukšteliai;93762990685;Taip;0;0;1;1
357;Atžalėlės;Paukšteliai;42752976301;Taip;7;0;5;12
358;Atžalėlės;Paukšteliai;27330226432;Taip;0;0;12;12
359;Atžalėlės;Paukšteliai;1714011798;Taip;0;0;1;1
360;Atžalėlės;Paukšteliai;57459192709;Ne;0;6;0;6
361;Atžalėlės;Paukšteliai;5438129052;Taip;0;0;3;3
362;Atžalėlės;Paukšteliai;1772202805;Taip;15;0;0;15
363;Atžalėlės;Meškiukai;26878092629;Taip;10;3;0;13
364;Atžalėlės;Meškiukai;1083996834;Taip;0;11;0;11
365;Atžalėlės;Meškiukai;53385285795;Ne;7;0;0;7
366;Atžalėlės;Meškiukai;57197465236;Taip;5;0;0;5
367;Atžalėlės;Meškiukai;96954269567;Taip;8;0;1;9
368;Atžalėlės;Meškiukai;91094623082;Taip;9;4;0;13
369;Atžalėlės;Meškiukai;52163840804;Taip;6;0;3;9
370;Atžalėlės;Meškiukai;97667536161;Taip;0;5;0;5
371;Atžalėlės;Meškiukai;32165722689;Taip;9;0;3;12
372;Atžalėlės;Meškiukai;59994970570;Taip;11;0;5;16
373;Atžalėlės;Meškiukai;60841336326;Taip;0;0;1;1
374;Atžalėlės;Meškiukai;83433461267;Taip;0;5;0;5
375;Atžalėlės;Meškiukai;78909909613;Taip;5;0;0;5
376;Atžalėlės;Meškiukai;46263888918;Taip;7;2;0;9
377;Atžalėlės;Meškiukai;7315734265;Taip;0;1;0;1
378;Atžalėlės;Meškiukai;30776087985;Taip;0;0;2;2
379;Atžalėlės;Meškiukai;74153703568;Taip;10;0;0;10
380;Atžalėlės;Meškiukai;939302682;Taip;0;1;0;1
381;Atžalėlės;Meškiukai;40388417436;Taip;0;2;0;2
382;Atžalėlės;Meškiukai;45860181171;Taip;0;1;0;1
383;Atžalėlės;Meškiukai;1512766841;Taip;5;0;1;6
384;Atžalėlės;Meškiukai;76280495364;Taip;10;3;0;13
385;Atžalėlės;Meškiukai;1448431632;Taip;0;8;0;8
386;Atžalėlės;Meškiukai;4702130326;Taip;0;3;0;3
387;Aušrelė;PASAKIUKAI;66290556450;Taip;0;3;0;3
388;Aušrelė;PASAKIUKAI;9759865004;Ne;0;0;9;9
389;Aušrelė;PASAKIUKAI;1552951030;Taip;0;1;2;3
390;Aušrelė;PASAKIUKAI;73000891950;Taip;0;3;0;3
391;Aušrelė;PASAKIUKAI;93192830033;Taip;0;1;0;1
392;Aušrelė;PASAKIUKAI;31870837550;Taip;0;1;1;2
393;Aušrelė;PASAKIUKAI;89564834407;Taip;19;0;2;21
394;Aušrelė;PASAKIUKAI;4475401842;Taip;0;4;0;4
395;Aušrelė;PASAKIUKAI;2771851348;Ne;0;9;0;9
396;Aušrelė;PASAKIUKAI;4988271727;Taip;8;0;3;11
397;Aušrelė;PASAKIUKAI;5713243418;Taip;0;0;4;4
398;Aušrelė;PASAKIUKAI;76179424646;Taip;0;1;0;1
399;Aušrelė;PASAKIUKAI;41231905740;Taip;0;3;0;3
400;Aušrelė;PASAKIUKAI;58007820848;Taip;0;0;2;2
401;Aušrelė;PASAKIUKAI;4631390072;Taip;0;6;0;6
402;Aušrelė;BORUŽĖLĖS;87964799762;Taip;0;11;0;11
403;Aušrelė;BORUŽĖLĖS;61325054660;Taip;0;22;0;22
404;Aušrelė;BORUŽĖLĖS;83835736230;Taip;0;2;0;2
405;Aušrelė;BORUŽĖLĖS;59306871998;Taip;0;1;0;1
406;Aušrelė;BORUŽĖLĖS;48228818029;Taip;0;21;1;22
407;Aušrelė;BORUŽĖLĖS;1392484369;Taip;0;0;9;9
408;Aušrelė;BORUŽĖLĖS;4180888362;Taip;0;8;0;8
409;Aušrelė;BORUŽĖLĖS;20968351121;Taip;0;7;0;7
410;Aušrelė;BORUŽĖLĖS;82713803790;Taip;0;5;0;5
411;Aušrelė;BORUŽĖLĖS;1380454183;Taip;8;0;4;12
412;Aušrelė;BORUŽĖLĖS;48794175299;Taip;10;0;4;14
413;Aušrelė;BORUŽĖLĖS;1578867221;Ne;0;0;7;7
414;Aušrelė;BORUŽĖLĖS;18863314278;Ne;9;0;0;9
415;Aušrelė;BORUŽĖLĖS;58941591666;Taip;0;4;0;4
416;Aušrelė;BORUŽĖLĖS;93138986438;Taip;0;1;0;1
417;Aušrelė;BORUŽĖLĖS;1985405666;Taip;12;0;1;13
418;Aušrelė;BORUŽĖLĖS;26547524160;Taip;6;14;0;20
419;Aušrelė;BORUŽĖLĖS;9818954496;Ne;0;0;22;22
420;Aušrelė;BORUŽĖLĖS;6109287607;Taip;0;4;0;4
421;Aušrelė;SMALSUČIAI;76459345433;Ne;8;1;0;9
422;Aušrelė;SMALSUČIAI;17931731597;Taip;6;0;0;6
423;Aušrelė;SMALSUČIAI;8572216200;Taip;0;10;0;10
424;Aušrelė;SMALSUČIAI;1951435363;Taip;0;0;2;2
425;Aušrelė;SMALSUČIAI;3392276890;Taip;0;0;6;6
426;Aušrelė;SMALSUČIAI;14080739740;Taip;0;14;0;14
427;Aušrelė;SMALSUČIAI;73050137188;Taip;0;8;0;8
428;Aušrelė;SMALSUČIAI;49563719275;Taip;0;5;0;5
429;Aušrelė;SMALSUČIAI;7859894371;Taip;0;8;0;8
430;Aušrelė;SMALSUČIAI;68223308125;Ne;0;0;1;1
431;Aušrelė;SMALSUČIAI;90185478786;Taip;0;3;0;3
432;Aušrelė;SMALSUČIAI;95035102498;Taip;0;5;0;5
433;Aušrelė;SMALSUČIAI;26235102809;Taip;0;2;1;3
434;Aušrelė;SMALSUČIAI;42158121278;Taip;0;5;0;5
435;Aušrelė;SMALSUČIAI;78823564616;Taip;0;12;0;12
436;Aušrelė;SMALSUČIAI;1944021609;Taip;0;3;0;3
437;Aušrelė;SMALSUČIAI;1322089393;Taip;0;4;0;4
438;Aušrelė;KODĖLČIUKAI;12032618723;Taip;2;1;0;3
439;Aušrelė;KODĖLČIUKAI;18676216802;Taip;0;3;0;3
440;Aušrelė;KODĖLČIUKAI;75580617180;Taip;0;4;0;4
441;Aušrelė;KODĖLČIUKAI;24202090947;Ne;0;9;0;9
442;Aušrelė;KODĖLČIUKAI;50864528673;Ne;5;0;5;10
443;Aušrelė;KODĖLČIUKAI;76302896259;Taip;0;17;0;17
444;Aušrelė;KODĖLČIUKAI;2427329184;Taip;0;0;4;4
445;Aušrelė;KODĖLČIUKAI;24201363476;Taip;0;9;3;12
446;Aušrelė;KODĖLČIUKAI;39887348225;Taip;0;1;0;1
447;Aušrelė;KODĖLČIUKAI;1535153901;Taip;0;1;5;6
448;Aušrelė;KODĖLČIUKAI;46259963888;Taip;0;6;1;7
449;Aušrelė;KODĖLČIUKAI;63497657826;Taip;5;0;0;5
450;Aušrelė;KODĖLČIUKAI;8837069458;Taip;0;5;2;7
451;Aušrelė;KODĖLČIUKAI;36096756485;Taip;0;2;0;2
452;Aušrelė;KODĖLČIUKAI;1058114795;Taip;10;0;0;10
453;Aušrelė;KODĖLČIUKAI;19415824416;Taip;10;1;0;11
454;Aušrelė;KODĖLČIUKAI;44971525276;Taip;1;0;0;1
455;Aušrelė;KODĖLČIUKAI;26185247513;Taip;0;22;0;22
456;Aušrelė;PELĖDŽIUKAI;34891640909;Taip;0;1;0;1
457;Aušrelė;PELĖDŽIUKAI;1792774415;Taip;0;11;0;11
458;Aušrelė;PELĖDŽIUKAI;5955421544;Ne;0;12;0;12
459;Aušrelė;PELĖDŽIUKAI;31441512644;Taip;0;2;0;2
460;Aušrelė;PELĖDŽIUKAI;2030362509;Taip;0;14;0;14
461;Aušrelė;PELĖDŽIUKAI;1296552763;Taip;0;9;2;11
462;Aušrelė;PELĖDŽIUKAI;1160772086;Taip;4;8;0;12
463;Aušrelė;PELĖDŽIUKAI;1352195876;Taip;0;0;1;1
464;Aušrelė;PELĖDŽIUKAI;1599595256;Taip;0;1;0;1
465;Aušrelė;PELĖDŽIUKAI;2125080379;Taip;0;0;5;5
466;Aušrelė;PELĖDŽIUKAI;1539176090;Taip;0;3;0;3
467;Aušrelė;PELĖDŽIUKAI;2987088389;Ne;0;0;12;12
468;Aušrelė;PELĖDŽIUKAI;6909708079;Ne;0;0;3;3
469;Aušrelė;PELĖDŽIUKAI;1506444915;Taip;0;18;0;18
470;Aušrelė;PELĖDŽIUKAI;5304765447;Taip;0;8;0;8
471;Aušrelė;PELĖDŽIUKAI;85739624682;Taip;0;0;2;2
472;Aušrelė;AITVARIUKAI;49583107808;Taip;5;0;0;5
473;Aušrelė;AITVARIUKAI;2045076279;Taip;0;1;2;3
474;Aušrelė;AITVARIUKAI;1153416324;Taip;0;22;0;22
475;Aušrelė;AITVARIUKAI;1340754039;Taip;0;1;0;1
476;Aušrelė;AITVARIUKAI;79695989966;Taip;0;9;0;9
477;Aušrelė;AITVARIUKAI;1045290039;Taip;0;14;0;14
478;Aušrelė;AITVARIUKAI;1511069809;Taip;5;3;0;8
479;Aušrelė;AITVARIUKAI;51119593813;Taip;0;0;1;1
480;Aušrelė;AITVARIUKAI;5813735533;Taip;0;5;0;5
481;Aušrelė;AITVARIUKAI;18117725053;Taip;0;0;1;1
482;Aušrelė;AITVARIUKAI;1036752305;Taip;0;16;0;16
483;Aušrelė;AITVARIUKAI;27629722512;Taip;0;3;0;3
484;Aušrelė;AITVARIUKAI;1830501248;Taip;0;0;2;2
485;Aušrelė;AITVARIUKAI;65369497777;Taip;0;22;0;22
486;Aušrelė;AITVARIUKAI;1750555187;Taip;6;0;0;6
487;Aušrelė;AITVARIUKAI;8221635058;Taip;0;1;11;12
488;Aušrelė;AITVARIUKAI;1163757003;Taip;0;6;0;6
489;Aušrelė;AITVARIUKAI;4865289474;Taip;0;18;0;18
490;Aušrelė;BITUTĖS;6519246290;Taip;14;5;0;19
491;Aušrelė;BITUTĖS;54807413055;Taip;0;6;0;6
492;Aušrelė;BITUTĖS;7915176432;Taip;0;2;0;2
493;Aušrelė;BITUTĖS;2085252423;Taip;0;15;0;15
494;Aušrelė;BITUTĖS;1039658170;Taip;0;13;0;13
495;Aušrelė;BITUTĖS;7887450828;Taip;0;10;0;10
496;Aušrelė;BITUTĖS;1496680911;Ne;0;12;0;12
497;Aušrelė;BITUTĖS;1680740501;Taip;0;2;0;2
498;Aušrelė;BITUTĖS;1666951645;Taip;0;8;0;8
499;Aušrelė;BITUTĖS;1372660806;Taip;0;2;0;2
500;Aušrelė;BITUTĖS;1958425979;Taip;0;5;0;5
501;Aušrelė;BITUTĖS;72441793163;Ne;0;19;0;19
502;Aušrelė;ŽIRNIUKAI;6761263775;Taip;7;0;2;9
503;Aušrelė;ŽIRNIUKAI;3015028879;Taip;2;1;0;3
504;Aušrelė;ŽIRNIUKAI;8503309819;Taip;5;2;0;7
505;Aušrelė;ŽIRNIUKAI;3553233149;Taip;6;2;0;8
506;Aušrelė;ŽIRNIUKAI;2827216981;Taip;0;1;0;1
507;Aušrelė;ŽIRNIUKAI;2852596989;Taip;0;22;0;22
508;Aušrelė;ŽIRNIUKAI;7930717076;Taip;7;1;0;8
509;Aušrelė;ŽIRNIUKAI;4942168388;Taip;0;16;6;22
510;Aušrelė;ŽIRNIUKAI;2266390402;Taip;0;6;0;6
511;Aušrelė;ŽIRNIUKAI;8032661062;Taip;0;0;1;1
512;Aušrelė;ŽIRNIUKAI;2390128933;Taip;0;4;0;4
513;Aušrelė;ŽIRNIUKAI;1556010005;Taip;5;0;0;5
514;Aušrelė;ŽIRNIUKAI;7609339123;Taip;7;8;0;15
515;Aušrelė;ŽIRNIUKAI;7070013052;Taip;5;0;0;5
516;Aušrelė;GRYBUKAI;6002434911;Taip;0;3;0;3
517;Aušrelė;GRYBUKAI;4288695809;Taip;0;2;1;3
518;Aušrelė;GRYBUKAI;5312189552;Taip;9;0;0;9
519;Aušrelė;GRYBUKAI;7327544406;Ne;1;1;1;3
520;Aušrelė;GRYBUKAI;5046027475;Taip;11;4;0;15
521;Aušrelė;GRYBUKAI;3320399046;Taip;8;0;1;9
522;Aušrelė;GRYBUKAI;7723159748;Taip;22;0;0;22
523;Aušrelė;GRYBUKAI;7367268748;Taip;15;0;0;15
524;Aušrelė;GRYBUKAI;6109859056;Ne;14;1;0;15
525;Aušrelė;GRYBUKAI;3581155949;Taip;7;2;0;9
526;Aušrelė;GRYBUKAI;2030555139;Taip;0;9;0;9
527;Aušrelė;GRYBUKAI;1976613166;Taip;0;8;0;8
528;Aušrelė;GRYBUKAI;8338569001;Taip;0;5;0;5
529;Aušrelė;GRYBUKAI;6186758486;Taip;0;5;0;5
530;Aušrelė;DRUGELIAI;1408751702;Taip;0;5;0;5
531;Aušrelė;DRUGELIAI;5055972872;Taip;7;2;0;9
532;Aušrelė;DRUGELIAI;2974714806;Taip;0;4;0;4
533;Aušrelė;DRUGELIAI;5935579452;Taip;0;6;0;6
534;Aušrelė;DRUGELIAI;8960462835;Taip;0;10;10;20
535;Aušrelė;DRUGELIAI;7682402576;Taip;0;5;0;5
536;Aušrelė;DRUGELIAI;5478028396;Ne;20;0;0;20
537;Aušrelė;DRUGELIAI;8230362307;Taip;3;2;0;5
538;Aušrelė;DRUGELIAI;2751501830;Taip;5;0;0;5
539;Aušrelė;DRUGELIAI;1327431679;Taip;0;4;0;4
540;Aušrelė;DRUGELIAI;9440600785;Taip;0;1;0;1
541;Aušrelė;DRUGELIAI;6037757548;Taip;0;9;0;9
542;Aušrelė;DRUGELIAI;6995749373;Taip;0;1;0;1
543;Aušrelė;NYKŠTUKAI;6886505025;Taip;0;4;0;4
544;Aušrelė;NYKŠTUKAI;6673034329;Taip;7;1;0;8
545;Aušrelė;NYKŠTUKAI;8243716759;Taip;0;3;1;4
546;Aušrelė;NYKŠTUKAI;5777214701;Taip;0;1;0;1
547;Aušrelė;NYKŠTUKAI;3165692699;Ne;0;5;0;5
548;Aušrelė;NYKŠTUKAI;91282753561;Taip;1;12;0;13
549;Aušrelė;NYKŠTUKAI;4306578299;Taip;7;5;0;12
550;Aušrelė;NYKŠTUKAI;6084682084;Taip;0;2;0;2
551;Aušrelė;NYKŠTUKAI;3682523696;Taip;10;2;0;12
552;Aušrelė;NYKŠTUKAI;1928260563;Taip;2;1;0;3
553;Aušrelė;NYKŠTUKAI;4957581753;Ne;10;0;2;12
554;Aušrelė;NYKŠTUKAI;6277405405;Taip;0;3;0;3
555;Aušrelė;NYKŠTUKAI;1549962200;Taip;0;2;0;2
556;Aušrelė;NYKŠTUKAI;2626569015;Taip;17;5;0;22
557;Aušrelė;NYKŠTUKAI;2574681867;Taip;20;2;0;22
558;Beržynėlis;SVIRPLIUKAI;29356394553;Taip;5;9;0;14
559;Beržynėlis;SVIRPLIUKAI;45685658789;Taip;0;1;0;1
560;Beržynėlis;SVIRPLIUKAI;7649359221;Taip;3;0;0;3
561;Beržynėlis;SVIRPLIUKAI;74856278886;Taip;0;1;0;1
562;Beržynėlis;SVIRPLIUKAI;1207208151;Taip;5;0;0;5
563;Beržynėlis;SVIRPLIUKAI;1895493234;Ne;6;0;0;6
564;Beržynėlis;SVIRPLIUKAI;1583090840;Taip;11;0;0;11
565;Beržynėlis;SVIRPLIUKAI;7289803632;Taip;2;7;0;9
566;Beržynėlis;SVIRPLIUKAI;1612137286;Taip;5;0;0;5
567;Beržynėlis;SVIRPLIUKAI;71505149611;Ne;7;8;0;15
568;Beržynėlis;SVIRPLIUKAI;5196910604;Taip;2;1;0;3
569;Beržynėlis;SVIRPLIUKAI;1395819329;Taip;1;0;0;1
570;Beržynėlis;SVIRPLIUKAI;7248602510;Taip;12;0;0;12
571;Beržynėlis;SVIRPLIUKAI;3641421009;Ne;0;6;0;6
572;Beržynėlis;SVIRPLIUKAI;9566341884;Taip;9;2;0;11
573;Beržynėlis;SVIRPLIUKAI;3278699117;Taip;0;2;0;2
574;Beržynėlis;SVIRPLIUKAI;1838631438;Taip;6;0;0;6
575;Beržynėlis;SVIRPLIUKAI;1639928056;Ne;4;1;0;5
576;Beržynėlis;SVIRPLIUKAI;1136091326;Taip;0;2;0;2
577;Beržynėlis;SVIRPLIUKAI;1516309509;Taip;0;2;0;2
578;Beržynėlis;SVIRPLIUKAI;6395436937;Taip;5;5;0;10
579;Beržynėlis;PELEDŽIUKAI;2121542860;Taip;0;7;0;7
580;Beržynėlis;PELEDŽIUKAI;38733472229;Taip;0;1;0;1
581;Beržynėlis;PELEDŽIUKAI;10345838607;Ne;0;12;0;12
582;Beržynėlis;PELEDŽIUKAI;38966821601;Taip;0;10;0;10
583;Beržynėlis;PELEDŽIUKAI;98803060215;Taip;0;0;1;1
584;Beržynėlis;PELEDŽIUKAI;18199829748;Ne;0;0;5;5
585;Beržynėlis;PELEDŽIUKAI;62599537262;Ne;0;0;1;1
586;Beržynėlis;PELEDŽIUKAI;50307051477;Taip;0;0;5;5
587;Beržynėlis;PELEDŽIUKAI;45266242827;Taip;11;2;0;13
588;Beržynėlis;PELEDŽIUKAI;32134295447;Taip;0;7;0;7
589;Beržynėlis;ŽIOGELIAI;73555363332;Taip;0;14;0;14
590;Beržynėlis;ŽIOGELIAI;50686761208;Ne;2;8;1;11
591;Beržynėlis;ŽIOGELIAI;11586645391;Taip;0;0;4;4
592;Beržynėlis;ŽIOGELIAI;19892724367;Taip;5;2;0;7
593;Beržynėlis;ŽIOGELIAI;46844790286;Taip;0;2;0;2
594;Beržynėlis;ŽIOGELIAI;23484694902;Taip;0;5;0;5
595;Beržynėlis;ŽIOGELIAI;6082843533;Taip;0;5;0;5
596;Beržynėlis;ŽIOGELIAI;48258183822;Taip;1;2;0;3
597;Beržynėlis;ŽIOGELIAI;87966535672;Taip;0;1;0;1
598;Beržynėlis;ŽIOGELIAI;48768116923;Taip;0;0;2;2
599;Beržynėlis;ŽIOGELIAI;80418262829;Taip;0;2;0;2
600;Beržynėlis;ŽIOGELIAI;69508373227;Taip;5;7;9;21
601;Beržynėlis;ŽIOGELIAI;59717323779;Ne;12;1;0;13
602;Beržynėlis;ŽIOGELIAI;6002421623;Ne;0;17;0;17
603;Beržynėlis;ŽIOGELIAI;69893760439;Taip;8;0;0;8
604;Beržynėlis;ŽIOGELIAI;1893270997;Taip;0;3;0;3
605;Beržynėlis;ŽIOGELIAI;7929997884;Ne;2;1;0;3
606;Beržynėlis;ŽIOGELIAI;5114301953;Taip;0;10;0;10
607;Beržynėlis;ŽVIRBLIUKAI;7520394353;Taip;5;0;0;5
608;Beržynėlis;ŽVIRBLIUKAI;95544821432;Ne;0;2;1;3
609;Beržynėlis;ŽVIRBLIUKAI;1426962644;Taip;7;2;0;9
610;Beržynėlis;ŽVIRBLIUKAI;1910024785;Taip;13;0;0;13
611;Beržynėlis;ŽVIRBLIUKAI;1823144276;Taip;0;2;1;3
612;Beržynėlis;ŽVIRBLIUKAI;1464556813;Taip;0;7;1;8
613;Beržynėlis;ŽVIRBLIUKAI;1945230630;Taip;7;0;3;10
614;Beržynėlis;ŽVIRBLIUKAI;1466742506;Taip;5;0;4;9
615;Beržynėlis;ŽVIRBLIUKAI;2023412985;Taip;0;0;1;1
616;Beržynėlis;ŽVIRBLIUKAI;96946855305;Taip;0;0;1;1
617;Beržynėlis;ŽVIRBLIUKAI;2067928004;Taip;0;2;0;2
618;Beržynėlis;ŽVIRBLIUKAI;87592204193;Taip;0;2;0;2
619;Beržynėlis;ŽVIRBLIUKAI;62962970458;Taip;0;10;0;10
620;Beržynėlis;ŽVIRBLIUKAI;17743947386;Taip;0;1;0;1
621;Beržynėlis;ŽVIRBLIUKAI;80762814965;Taip;0;0;5;5
622;Beržynėlis;ŽVIRBLIUKAI;30539063473;Taip;8;0;0;8
623;Beržynėlis;ŽVIRBLIUKAI;1885972165;Taip;0;1;0;1
624;Beržynėlis;ŽVIRBLIUKAI;75283423384;Taip;18;0;0;18
625;Beržynėlis;ŽVIRBLIUKAI;81022321678;Taip;10;0;0;10
626;Beržynėlis;ŽVIRBLIUKAI;1391844432;Taip;0;7;6;13
627;Beržynėlis;ŽVIRBLIUKAI;1014895926;Taip;0;7;6;13
628;Beržynėlis;ŽIRNIUKAI;6334152631;Taip;13;0;0;13
629;Beržynėlis;ŽIRNIUKAI;2971686368;Taip;0;2;0;2
630;Beržynėlis;ŽIRNIUKAI;8591800387;Taip;0;3;0;3
631;Beržynėlis;ŽIRNIUKAI;7589778533;Taip;11;3;0;14
632;Beržynėlis;ŽIRNIUKAI;4577837021;Taip;0;22;0;22
633;Beržynėlis;ŽIRNIUKAI;9409317403;Taip;0;2;0;2
634;Beržynėlis;ŽIRNIUKAI;5473666098;Taip;6;2;0;8
635;Beržynėlis;ŽIRNIUKAI;5189335842;Taip;15;0;0;15
636;Beržynėlis;ŽIRNIUKAI;6293884233;Taip;3;0;0;3
637;Beržynėlis;ŽIRNIUKAI;4270889499;Taip;4;0;0;4
638;Beržynėlis;ŽIRNIUKAI;3209966996;Taip;0;2;0;2
639;Beržynėlis;VIŠČIUKAI;9996171088;Ne;0;2;2;4
640;Beržynėlis;VIŠČIUKAI;8688852668;Taip;0;2;3;5
641;Beržynėlis;VIŠČIUKAI;6713134631;Taip;1;0;0;1
642;Beržynėlis;VIŠČIUKAI;5593146590;Taip;1;0;0;1
643;Beržynėlis;VIŠČIUKAI;9088059487;Taip;6;0;0;6
644;Beržynėlis;VIŠČIUKAI;9540292311;Taip;0;5;0;5
645;Beržynėlis;VIŠČIUKAI;1325972861;Taip;5;1;0;6
646;Beržynėlis;VIŠČIUKAI;4970999989;Taip;0;2;0;2
647;Beržynėlis;VIŠČIUKAI;4035764376;Taip;5;2;0;7
648;Beržynėlis;VIŠČIUKAI;5308596559;Ne;5;2;2;9
649;Beržynėlis;VIŠČIUKAI;8881566865;Taip;5;0;0;5
650;Beržynėlis;VIŠČIUKAI;5194416351;Taip;15;0;0;15
651;Beržynėlis;VIŠČIUKAI;5069929376;Taip;5;0;3;8
652;Bildukas;"Svetliački savaitinė";39959905586;Taip;0;9;0;9
653;Bildukas;"Svetliački savaitinė";40673143772;Ne;6;0;0;6
654;Bildukas;"Svetliački savaitinė";51199543540;Taip;0;2;12;14
655;Bildukas;"Svetliački savaitinė";10255936371;Taip;0;0;9;9
656;Bildukas;"Svetliački savaitinė";80327840821;Taip;0;0;3;3
657;Bildukas;"Svetliački savaitinė";96874940646;Taip;0;2;1;3
658;Bildukas;"Svetliački savaitinė";27240409925;Taip;0;2;0;2
659;Bildukas;"Svetliački savaitinė";6441340680;Taip;0;7;0;7
660;Bildukas;"Svetliački savaitinė";5968419467;Ne;10;4;0;14
661;Bildukas;"Svetliački savaitinė";1029617146;Taip;0;5;0;5
662;Bildukas;"Svetliački savaitinė";1643122874;Taip;0;3;0;3
663;Bildukas;"Svetliački savaitinė";8968652761;Taip;5;3;0;8
664;Bildukas;"Svetliački savaitinė";70033583066;Taip;0;7;0;7
665;Bildukas;"Svetliački savaitinė";1023163775;Ne;0;8;0;8
666;Bildukas;"Svetliački savaitinė";25050688839;Ne;8;1;0;9
667;Bildukas;"Svetliački savaitinė";57163941360;Taip;0;10;0;10
668;Bildukas;"Svetliački savaitinė";9535522910;Ne;0;0;1;1
669;Bildukas;"Svetliački savaitinė";1183272346;Ne;6;0;0;6
670;Bildukas;"Svetliački savaitinė";1165636981;Taip;11;0;3;14
671;Bildukas;"Zaičiata savaitinė ( keli alergiški vaikai)";9229489686;Ne;0;1;0;1
672;Bildukas;"Zaičiata savaitinė ( keli alergiški vaikai)";3531285331;Taip;0;1;5;6
673;Bildukas;"Zaičiata savaitinė ( keli alergiški vaikai)";3654667879;Taip;7;1;0;8
674;Bildukas;"Zaičiata savaitinė ( keli alergiški vaikai)";2091204077;Taip;7;3;0;10
675;Bildukas;"Zaičiata savaitinė ( keli alergiški vaikai)";1047459617;Taip;5;1;0;6
676;Bildukas;"Zaičiata savaitinė ( keli alergiški vaikai)";5668878259;Taip;15;1;0;16
677;Bildukas;"Zaičiata savaitinė ( keli alergiški vaikai)";6219872984;Taip;12;0;0;12
678;Bildukas;"Zaičiata savaitinė ( keli alergiški vaikai)";8382899180;Taip;11;1;0;12
679;Bildukas;"Zaičiata savaitinė ( keli alergiški vaikai)";9756326725;Taip;7;0;2;9
680;Bildukas;"Zaičiata savaitinė ( keli alergiški vaikai)";4392299046;Taip;0;0;3;3
681;Bildukas;"Zaičiata savaitinė ( keli alergiški vaikai)";9835391223;Taip;5;5;0;10
682;Bildukas;"Zaičiata savaitinė ( keli alergiški vaikai)";9156801640;Ne;0;5;0;5
683;Bildukas;"Zaičiata savaitinė ( keli alergiški vaikai)";4112888719;Taip;7;1;4;12
684;Bildukas;Gnomiki;1113168085;Taip;0;0;1;1
685;Bildukas;Gnomiki;1125206576;Taip;0;20;0;20
686;Bildukas;Gnomiki;1502213914;Taip;7;0;0;7
687;Bildukas;Gnomiki;7898746258;Taip;5;0;8;13
688;Bildukas;Gnomiki;1376514473;Taip;6;3;0;9
689;Bildukas;Gnomiki;4014493868;Taip;0;7;0;7
690;Bildukas;Gnomiki;4623727349;Taip;0;1;5;6
691;Bildukas;Gnomiki;4377803110;Taip;0;3;0;3
692;Bildukas;Gnomiki;5217751936;Taip;0;12;0;12
693;Bildukas;Gnomiki;9569296370;Taip;9;0;3;12
694;Bildukas;Gnomiki;5844470373;Taip;0;0;9;9
695;Bildukas;Gnomiki;6548776238;Taip;0;2;6;8
696;Bildukas;Gnomiki;6388514464;Taip;0;7;0;7
697;Bildukas;Gnomiki;3226370339;Taip;0;0;2;2
698;Bildukas;Zvonočki;1475108434;Taip;0;1;10;11
699;Bildukas;Zvonočki;60443994539;Ne;0;1;5;6
700;Bildukas;Zvonočki;12186791267;Taip;5;1;3;9
701;Bildukas;Zvonočki;16923577010;Ne;0;1;6;7
702;Bildukas;Zvonočki;84771452636;Ne;0;8;0;8
703;Bildukas;Zvonočki;1180357950;Taip;13;2;4;19
704;Bildukas;Zvonočki;99302309410;Taip;0;2;5;7
705;Bildukas;Zvonočki;52281960273;Taip;0;0;1;1
706;Bildukas;Zvonočki;48069555680;Taip;0;1;5;6
707;Bildukas;Zvonočki;82932493433;Taip;0;11;0;11
708;Bildukas;Zvonočki;1409708149;Taip;5;9;0;14
709;Bildukas;Zvonočki;89499132098;Taip;0;0;3;3
710;Bildukas;Zvonočki;91777282521;Taip;0;4;0;4
711;Bildukas;Zvonočki;1713133196;Ne;0;1;7;8
712;Bildukas;Zvonočki;1956741726;Taip;3;0;0;3
713;Bildukas;Zvonočki;1234033395;Ne;0;1;5;6
714;Bildukas;Zvonočki;9575263475;Taip;0;6;1;7
715;Bildukas;Zvonočki;4404602365;Taip;0;13;0;13
716;Birutės;SKRUZDELIUKŲ;83624863787;Taip;7;3;0;10
717;Birutės;SKRUZDELIUKŲ;29496817352;Taip;0;3;0;3
718;Birutės;SKRUZDELIUKŲ;8361780904;Taip;1;0;0;1
719;Birutės;SKRUZDELIUKŲ;58791168169;Taip;0;1;0;1
720;Birutės;SKRUZDELIUKŲ;99346448051;Taip;5;2;0;7
721;Birutės;SKRUZDELIUKŲ;19076257808;Taip;0;1;0;1
722;Birutės;SKRUZDELIUKŲ;99534190736;Taip;5;8;0;13
723;Birutės;SKRUZDELIUKŲ;64883674106;Taip;1;0;0;1
724;Birutės;SKRUZDELIUKŲ;92392234959;Taip;0;4;0;4
725;Birutės;SKRUZDELIUKŲ;5948430712;Taip;0;3;0;3
726;Birutės;SKRUZDELIUKŲ;1227083798;Taip;0;1;0;1
727;Birutės;SKRUZDELIUKŲ;19555366863;Taip;4;3;0;7
728;Birutės;SKRUZDELIUKŲ;1517824834;Taip;3;3;0;6
729;Birutės;SKRUZDELIUKŲ;43601620086;Taip;0;7;0;7
730;Birutės;SKRUZDELIUKŲ;1123582705;Taip;7;0;0;7
731;Birutės;BITUČIŲ;7678475961;Ne;0;9;0;9
732;Birutės;BITUČIŲ;1599159924;Taip;7;0;0;7
733;Birutės;BITUČIŲ;4427232735;Taip;0;0;5;5
734;Birutės;BITUČIŲ;33770983649;Taip;22;0;0;22
735;Birutės;BITUČIŲ;87693588654;Taip;0;1;0;1
736;Birutės;BITUČIŲ;1234596925;Taip;0;0;1;1
737;Birutės;BITUČIŲ;2975442228;Taip;0;0;5;5
738;Birutės;BITUČIŲ;5770026060;Taip;5;0;0;5
739;Birutės;BITUČIŲ;98391790116;Taip;5;0;2;7
740;Birutės;BITUČIŲ;5947971037;Taip;7;2;0;9
741;Birutės;BITUČIŲ;7149060118;Ne;0;13;0;13
742;Birutės;BITUČIŲ;1064449916;Taip;0;8;0;8
743;Birutės;BITUČIŲ;3436637062;Taip;4;1;0;5
744;Birutės;BITUČIŲ;6748290604;Taip;13;0;0;13
745;Birutės;BITUČIŲ;9769645272;Taip;0;0;3;3
746;Birutės;BITUČIŲ;8465645434;Taip;11;0;1;12
747;Birutės;BITUČIŲ;6006110601;Ne;0;0;1;1
748;Birutės;BITUČIŲ;9722922540;Ne;8;0;0;8
749;Birutės;BITUČIŲ;6115354862;Taip;6;0;0;6
750;Birutės;BITUČIŲ;7386694567;Taip;1;0;9;10
751;Birutės;BORUŽIUKAI;40376432941;Taip;0;1;0;1
752;Birutės;BORUŽIUKAI;83627433055;Taip;0;0;1;1
753;Birutės;BORUŽIUKAI;1244627213;Taip;0;9;8;17
754;Birutės;BORUŽIUKAI;44098551169;Ne;5;0;2;7
755;Birutės;BORUŽIUKAI;1228407191;Taip;14;0;0;14
756;Birutės;BORUŽIUKAI;76900751891;Taip;0;1;0;1
757;Birutės;BORUŽIUKAI;78441249067;Taip;11;11;0;22
758;Birutės;BORUŽIUKAI;1735549924;Taip;5;0;2;7
759;Birutės;BORUŽIUKAI;1905393478;Taip;2;0;0;2
760;Birutės;BORUŽIUKAI;1427891290;Taip;5;5;0;10
761;Birutės;BORUŽIUKAI;44844176536;Taip;6;0;0;6
762;Birutės;BORUŽIUKAI;81284166606;Taip;1;0;1;2
763;Birutės;BORUŽIUKAI;2014751710;Ne;0;10;0;10
764;Birutės;BORUŽIUKAI;22452517583;Taip;0;5;0;5
765;Birutės;BORUŽIUKAI;9450257904;Taip;14;0;0;14
766;Birutės;BORUŽIUKAI;1596098119;Taip;4;0;1;5
767;Birutės;BORUŽIUKAI;60466633757;Ne;2;2;6;10
768;Birutės;BORUŽIUKAI;4217246188;Taip;22;0;0;22
769;Birutės;BORUŽIUKAI;70370187632;Taip;0;10;0;10
770;Birutės;DRUGELIAI;91202819016;Taip;0;0;1;1
771;Birutės;DRUGELIAI;1884820602;Taip;1;0;0;1
772;Birutės;DRUGELIAI;77244600491;Taip;6;0;4;10
773;Birutės;DRUGELIAI;22036269009;Taip;0;3;0;3
774;Birutės;DRUGELIAI;3213573357;Taip;5;0;0;5
775;Birutės;DRUGELIAI;6880300182;Taip;0;0;2;2
776;Birutės;DRUGELIAI;23540610503;Ne;5;0;0;5
777;Birutės;DRUGELIAI;32780299044;Taip;3;0;0;3
778;Birutės;DRUGELIAI;1346957081;Taip;11;0;0;11
779;Birutės;DRUGELIAI;88939598407;Taip;0;3;0;3
780;Birutės;DRUGELIAI;1950295916;Taip;5;0;2;7
781;Birutės;DRUGELIAI;5272792732;Taip;7;0;2;9
782;Birutės;DRUGELIAI;9886554192;Ne;0;9;0;9
783;Birutės;DRUGELIAI;9662009307;Ne;22;0;0;22
784;Birutės;DRUGELIAI;9860683556;Taip;0;0;1;1
785;Birutės;DRUGELIAI;32821891070;Taip;3;15;0;18
786;Birutės;DRUGELIAI;3682136019;Ne;0;0;17;17
787;Bitutė;Aitvariukų;3254061362;Taip;0;1;0;1
788;Bitutė;Aitvariukų;6674923740;Taip;0;5;0;5
789;Bitutė;Aitvariukų;8394685672;Taip;5;1;1;7
790;Bitutė;Aitvariukų;3796188100;Taip;3;16;0;19
791;Bitutė;Aitvariukų;1564763789;Taip;0;3;0;3
792;Bitutė;Aitvariukų;1846974702;Taip;2;8;0;10
793;Bitutė;Aitvariukų;1162903905;Taip;22;3;0;25
794;Bitutė;Aitvariukų;1560715159;Taip;0;23;0;23
795;Bitutė;Aitvariukų;7456328992;Taip;3;1;0;4
796;Bitutė;Aitvariukų;6204566294;Taip;5;0;0;5
797;Bitutė;Aitvariukų;2518730247;Taip;22;3;0;25
798;Bitutė;Aitvariukų;5895868876;Taip;22;3;0;25
799;Bitutė;Aitvariukų;8743734366;Taip;0;16;0;16
800;Bitutė;Aitvariukų;7036780275;Taip;10;15;0;25
801;Bitutė;Aitvariukų;2804203556;Taip;7;12;0;19
802;Bitutė;Aitvariukų;5455919343;Taip;0;10;0;10
803;Bitutė;Aitvariukų;6737174004;Taip;12;6;0;18
804;Bitutė;Aitvariukų;3432065233;Taip;5;5;0;10
805;Bitutė;Aitvariukų;5679397165;Taip;20;3;0;23
806;Bitutė;Ežiukų;25827361426;Taip;7;0;0;7
807;Bitutė;Ežiukų;43167655810;Ne;5;0;0;5
808;Bitutė;Ežiukų;38137764071;Taip;0;3;0;3
809;Bitutė;Ežiukų;40949937934;Taip;0;1;0;1
810;Bitutė;Ežiukų;67601917966;Taip;6;1;0;7
811;Bitutė;Ežiukų;75254163778;Taip;0;5;0;5
812;Bitutė;Ežiukų;1824939092;Taip;10;0;0;10
813;Bitutė;Ežiukų;1262030751;Taip;0;2;0;2
814;Bitutė;Ežiukų;57841590670;Taip;10;0;0;10
815;Bitutė;Ežiukų;70388118169;Taip;5;0;0;5
816;Bitutė;Ežiukų;9838379838;Taip;22;0;0;22
817;Bitutė;Ežiukų;80674416290;Taip;5;3;0;8
818;Bitutė;Ežiukų;42098027592;Ne;0;1;0;1
819;Bitutė;Ežiukų;17953339860;Taip;0;3;0;3
820;Bitutė;Žvirbliukų;76504719475;Taip;0;5;0;5
821;Bitutė;Žvirbliukų;29837823635;Taip;0;1;0;1
822;Bitutė;Žvirbliukų;96246198900;Taip;2;1;0;3
823;Bitutė;Žvirbliukų;73214901448;Taip;0;4;0;4
824;Bitutė;Žvirbliukų;239058855;Ne;0;13;0;13
825;Bitutė;Žvirbliukų;94263857872;Taip;0;6;0;6
826;Bitutė;Žvirbliukų;4311138099;Ne;0;13;0;13
827;Bitutė;Žvirbliukų;87682328632;Taip;6;0;0;6
828;Bitutė;Žvirbliukų;93097026538;Taip;0;4;0;4
829;Bitutė;Žvirbliukų;2045667491;Taip;5;0;0;5
830;Bitutė;Žvirbliukų;1342209916;Taip;0;2;0;2
831;Bitutė;Žvirbliukų;1799005979;Taip;0;9;0;9
832;Bitutė;Žvirbliukų;1235354320;Taip;0;2;0;2
833;Bitutė;Žvirbliukų;1086803168;Taip;6;3;0;9
834;Bitutė;Žvirbliukų;54838528906;Taip;0;3;0;3
835;Bitutė;Žvirbliukų;5365203210;Taip;0;7;0;7
836;Bitutė;Gandriukų;3966405515;Taip;0;7;0;7
837;Bitutė;Gandriukų;7514115839;Taip;0;12;0;12
838;Bitutė;Gandriukų;51971919596;Ne;0;4;0;4
839;Bitutė;Gandriukų;1344880094;Taip;0;1;0;1
840;Bitutė;Gandriukų;98415490683;Taip;0;10;0;10
841;Bitutė;Gandriukų;23567520688;Taip;5;0;0;5
842;Bitutė;Gandriukų;81321203386;Taip;5;0;0;5
843;Bitutė;Gandriukų;79414646688;Taip;2;0;0;2
844;Bitutė;Gandriukų;53324014378;Taip;0;9;1;10
845;Bitutė;Gandriukų;92442852696;Taip;0;6;0;6
846;Bitutė;Gandriukų;93924466303;Taip;0;2;0;2
847;Bitutė;Gandriukų;85983344716;Taip;0;5;0;5
848;Bitutė;Gandriukų;2144684074;Taip;0;4;0;4
849;Bitutė;Gandriukų;27322436232;Taip;0;5;0;5
850;Bitutė;Gandriukų;69158292877;Taip;0;5;0;5
851;Bitutė;Gandriukų;98973241374;Taip;3;7;0;10
852;Bitutė;Gandriukų;66620895469;Taip;0;1;0;1
853;Bitutė;Gandriukų;1131101584;Taip;0;4;3;7
854;Bitutė;Pelėdžiukai;33881269329;Taip;0;7;0;7
855;Bitutė;Pelėdžiukai;72420328957;Taip;0;1;0;1
856;Bitutė;Pelėdžiukai;7262132445;Taip;0;2;0;2
857;Bitutė;Pelėdžiukai;69535700910;Taip;3;9;0;12
858;Bitutė;Pelėdžiukai;6951613601;Taip;10;2;1;13
859;Bitutė;Pelėdžiukai;44798518501;Taip;0;1;0;1
860;Bitutė;Pelėdžiukai;83983037344;Taip;0;9;0;9
861;Bitutė;Pelėdžiukai;70745977571;Taip;0;8;0;8
862;Bitutė;Pelėdžiukai;28682412356;Taip;0;2;0;2
863;Bitutė;Pelėdžiukai;63918223424;Taip;0;2;0;2
864;Bitutė;Pelėdžiukai;3850772845;Taip;1;2;0;3
865;Bitutė;Pelėdžiukai;1347785713;Taip;1;2;0;3
866;Bitutė;Pelėdžiukai;43022564131;Taip;0;1;0;1
867;Bitutė;Pelėdžiukai;82195110042;Taip;0;1;2;3
868;Bitutė;Pelėdžiukai;1915447382;Ne;0;2;0;2
869;Bitutė;Pelėdžiukai;68998683110;Taip;0;9;0;9
870;Bitutė;Pelėdžiukai;38867323639;Taip;0;1;0;1
871;Bitutė;Boružėlių;8519978626;Taip;0;9;0;9
872;Bitutė;Boružėlių;6586888742;Taip;0;6;0;6
873;Bitutė;Boružėlių;5783154071;Taip;0;22;0;22
874;Bitutė;Boružėlių;6052204491;Taip;0;5;1;6
875;Bitutė;Boružėlių;37105491775;Taip;13;3;0;16
876;Bitutė;Boružėlių;50869152455;Taip;0;15;0;15
877;Bitutė;Boružėlių;1783776913;Ne;0;9;1;10
878;Bitutė;Boružėlių;9683582019;Taip;2;5;0;7
879;Bitutė;Boružėlių;7352524951;Taip;5;8;0;13
880;Bitutė;Boružėlių;27144303911;Taip;0;6;0;6
881;Bitutė;Boružėlių;1802887869;Taip;6;8;0;14
882;Bitutė;Boružėlių;51054491845;Taip;13;3;0;16
883;Bitutė;Boružėlių;5653055907;Taip;0;13;0;13
884;Bitutė;Boružėlių;1809034174;Ne;12;8;0;20
885;Bitutė;Boružėlių;5644789669;Taip;7;2;2;11
886;Bitutė;Boružėlių;2350260809;Taip;5;12;0;17
887;Bitutė;Boružėlių;1307749129;Taip;0;2;0;2
888;Bitutė;Boružėlių;3980455738;Taip;0;6;1;7
889;Bitutė;Boružėlių;6678928989;Taip;11;4;0;15
890;Bitutė;Šokliukų;2775304620;Taip;2;0;0;2
891;Bitutė;Šokliukų;8754340459;Taip;17;0;0;17
892;Bitutė;Šokliukų;22504941477;Taip;0;1;0;1
893;Bitutė;Šokliukų;84694903978;Taip;0;1;0;1
894;Bitutė;Šokliukų;1385876629;Taip;7;0;0;7
895;Bitutė;Šokliukų;4054959628;Taip;0;10;0;10
896;Bitutė;Šokliukų;2104500642;Taip;0;1;0;1
897;Bitutė;Šokliukų;74038944722;Taip;0;3;0;3
898;Bitutė;Šokliukų;9314363274;Taip;0;22;0;22
899;Bitutė;Šokliukų;1703630417;Taip;0;1;0;1
900;Bitutė;Šokliukų;80788107109;Taip;0;6;0;6
901;Bitutė;Šokliukų;14787330368;Taip;0;3;0;3
902;Bitutė;Šokliukų;11128936533;Taip;0;4;0;4
903;Bitutė;Šokliukų;26573486858;Taip;0;3;0;3
904;Bitutė;Šokliukų;6591291681;Taip;6;0;0;6
905;Bitutė;Šokliukų;86636444738;Taip;0;16;0;16
906;Bitutė;Šokliukų;1956718350;Taip;10;2;0;12
907;Bitutė;Drugelių;57770829048;Taip;0;2;0;2
908;Bitutė;Drugelių;2531472741;Taip;0;2;0;2
909;Bitutė;Drugelių;74525712637;Taip;0;1;0;1
910;Bitutė;Drugelių;56620848568;Taip;3;7;0;10
911;Bitutė;Drugelių;58668298206;Taip;5;4;0;9
912;Bitutė;Drugelių;1863634233;Taip;11;1;0;12
913;Bitutė;Drugelių;72872147664;Taip;0;1;0;1
914;Bitutė;Drugelių;9550491607;Taip;0;4;0;4
915;Bitutė;Drugelių;48695762145;Taip;0;16;0;16
916;Bitutė;Drugelių;3982159333;Taip;14;7;0;21
917;Bitutė;Drugelių;27461264704;Taip;0;6;0;6
918;Bitutė;Drugelių;29300327608;Taip;0;2;0;2
919;Bitutė;Drugelių;50605497381;Taip;15;4;0;19
920;Bitutė;Drugelių;1030677273;Taip;5;1;0;6
921;Bitutė;Drugelių;92700808654;Ne;0;1;0;1
922;Bitutė;Drugelių;3319657847;Taip;0;2;0;2
923;Bitutė;Kiškučių;1926912966;Taip;0;20;0;20
924;Bitutė;Kiškučių;41598049089;Taip;0;7;0;7
925;Bitutė;Kiškučių;20823074269;Taip;0;9;1;10
926;Bitutė;Kiškučių;2004589442;Taip;0;5;0;5
927;Bitutė;Kiškučių;1514919519;Taip;0;10;0;10
928;Bitutė;Kiškučių;1756799209;Taip;0;4;0;4
929;Bitutė;Kiškučių;7858925572;Taip;0;2;0;2
930;Bitutė;Kiškučių;1946893053;Taip;0;9;0;9
931;Bitutė;Kiškučių;55394933894;Taip;0;2;0;2
932;Bitutė;Kiškučių;34076798361;Taip;0;8;0;8
933;Bitutė;Kiškučių;83034164893;Taip;0;6;0;6
934;Bitutė;Kiškučių;28698703670;Taip;0;4;0;4
935;Bitutė;Kiškučių;51014007755;Taip;0;12;0;12
936;Bitutė;Kiškučių;85845989245;Taip;0;8;0;8
937;Bitutė;Kiškučių;23952001143;Taip;0;5;0;5
938;Bitutė;Kiškučių;55763538285;Taip;0;3;0;3
939;Bitutė;Kiškučių;55722176820;Taip;0;8;0;8
940;Bitutė;Kiškučių;41836931870;Taip;0;11;0;11
941;Bitutė;Kiškučių;16096919364;Ne;0;2;0;2
942;Bitutė;"Viščiukų ";3723040682;Taip;0;2;0;2
943;Bitutė;"Viščiukų ";3804171750;Taip;0;3;0;3
944;Bitutė;"Viščiukų ";8545377054;Taip;0;7;0;7
945;Bitutė;"Viščiukų ";5406667195;Taip;0;13;0;13
946;Bitutė;"Viščiukų ";4458990772;Ne;5;1;0;6
947;Bitutė;"Viščiukų ";7113693496;Taip;0;9;0;9
948;Bitutė;"Viščiukų ";8186706520;Taip;0;22;0;22
949;Bitutė;"Viščiukų ";3688744506;Taip;5;3;0;8
950;Bitutė;"Viščiukų ";6044969600;Taip;0;10;0;10
951;Bitutė;"Viščiukų ";9602659259;Taip;2;8;0;10
952;Bitutė;"Viščiukų ";2190439190;Taip;6;3;0;9
953;Bitutė;"Viščiukų ";9855080887;Taip;0;1;0;1
954;Bitutė;"Viščiukų ";4177331531;Taip;7;0;0;7
955;Bitutė;"Viščiukų ";2483462846;Taip;10;0;0;10
956;Bitutė;"Viščiukų ";2886154457;Taip;7;0;0;7
957;Bitutė;"Viščiukų ";7678106084;Taip;6;0;0;6
958;Bitutė;"Skruzdėliukai ";37364063140;Ne;0;15;0;15
959;Bitutė;"Skruzdėliukai ";95252521365;Taip;11;5;0;16
960;Bitutė;"Skruzdėliukai ";1590580158;Taip;0;22;0;22
961;Bitutė;"Skruzdėliukai ";5910842956;Taip;5;9;0;14
962;Bitutė;"Skruzdėliukai ";1913421864;Taip;0;9;0;9
963;Bitutė;"Skruzdėliukai ";38436660859;Taip;9;13;0;22
964;Bitutė;"Skruzdėliukai ";2126118124;Taip;5;10;0;15
965;Bitutė;"Skruzdėliukai ";2031043488;Taip;0;3;0;3
966;Bitutė;"Skruzdėliukai ";55469634385;Taip;5;0;0;5
967;Bitutė;"Skruzdėliukai ";1130379531;Taip;8;3;0;11
968;Bitutė;"Skruzdėliukai ";87960363246;Taip;2;8;0;10
969;Bitutė;"Skruzdėliukai ";1064809221;Ne;22;0;0;22
970;Bitutė;"Skruzdėliukai ";1521753712;Taip;15;7;0;22
971;Bitutė;"Skruzdėliukai ";1354608761;Taip;0;8;0;8
972;Bitutė;"Skruzdėliukai ";1307910515;Taip;0;2;0;2
973;Bitutė;"Skruzdėliukai ";2311037144;Taip;0;2;0;2
974;Bitutė;"Skruzdėliukai ";41659768159;Taip;8;1;0;9
975;Bitutė;"Skruzdėliukai ";5886190377;Taip;0;7;0;7
976;Bitutė;"Skruzdėliukai ";61233878620;Ne;5;17;0;22
977;Bitutė;"Nykštukų ";1733189730;Taip;0;1;0;1
978;Bitutė;"Nykštukų ";2740656695;Taip;10;1;0;11
979;Bitutė;"Nykštukų ";3227252972;Taip;0;1;0;1
980;Bitutė;"Nykštukų ";4764586168;Taip;9;0;0;9
981;Bitutė;"Nykštukų ";5126303823;Taip;5;4;0;9
982;Bitutė;"Nykštukų ";1904108612;Taip;0;1;0;1
983;Bitutė;"Nykštukų ";5109258680;Taip;0;1;0;1
984;Bitutė;"Nykštukų ";1423694056;Taip;6;2;0;8
985;Bitutė;"Nykštukų ";2812580726;Taip;13;4;0;17
986;Bitutė;"Nykštukų ";4913483444;Taip;0;3;0;3
987;Bitutė;"Nykštukų ";1907876695;Taip;0;6;0;6
988;Bitutė;"Nykštukų ";7720798466;Taip;0;6;0;6
989;Bitutė;"Nykštukų ";1662815358;Taip;0;7;0;7
990;Bitutė;"Nykštukų ";9966437881;Taip;0;1;0;1
991;Bitutė;"Nykštukų ";6169426273;Taip;7;1;0;8
992;Bitutė;"Nykštukų ";9166624750;Taip;15;3;0;18
993;Coliukė;DRUGELIAI;4408284518;Taip;5;6;0;11
994;Coliukė;DRUGELIAI;3919482569;Taip;8;0;0;8
995;Coliukė;DRUGELIAI;3346269598;Taip;10;0;1;11
996;Coliukė;DRUGELIAI;1600495468;Taip;6;6;0;12
997;Coliukė;DRUGELIAI;9183391434;Taip;6;11;0;17
998;Coliukė;DRUGELIAI;2159103903;Taip;7;1;0;8
999;Coliukė;DRUGELIAI;1458763954;Ne;1;0;2;3
1000;Coliukė;DRUGELIAI;7920728387;Taip;6;0;0;6
1001;Coliukė;DRUGELIAI;6860757091;Taip;5;0;0;5
1002;Coliukė;DRUGELIAI;6011110970;Ne;3;0;1;4
1003;Coliukė;DRUGELIAI;1968467455;Taip;9;4;0;13
1004;Coliukė;DRUGELIAI;1240946719;Taip;7;12;0;19
1005;Coliukė;DRUGELIAI;4645245689;Taip;13;0;0;13
1006;Coliukė;DRUGELIAI;1882520335;Taip;0;2;0;2
1007;Coliukė;DRUGELIAI;8517128464;Taip;13;0;0;13
1008;Coliukė;DRUGELIAI;1328505569;Ne;15;4;0;19
1009;Coliukė;DRUGELIAI;5678858566;Taip;8;2;0;10
1010;Coliukė;BITUTĖS;2006601280;Taip;0;8;0;8
1011;Coliukė;BITUTĖS;44291325944;Ne;0;10;0;10
1012;Coliukė;BITUTĖS;50210836203;Taip;1;0;0;1
1013;Coliukė;BITUTĖS;8017702268;Ne;0;1;0;1
1014;Coliukė;BITUTĖS;30220840133;Ne;0;1;0;1
1015;Coliukė;BITUTĖS;41174692847;Taip;1;5;0;6
1016;Coliukė;BITUTĖS;82989338835;Taip;1;1;0;2
1017;Coliukė;BITUTĖS;77967081365;Taip;10;2;0;12
1018;Coliukė;BITUTĖS;77204026281;Taip;3;8;0;11
1019;Coliukė;BITUTĖS;25298531632;Taip;1;1;0;2
1020;Coliukė;BITUTĖS;1199350941;Taip;0;17;0;17
1021;Coliukė;BITUTĖS;1960898805;Taip;1;4;0;5
1022;Coliukė;BITUTĖS;58421006265;Taip;0;7;0;7
1023;Coliukė;BITUTĖS;6926730624;Taip;7;2;0;9
1024;Coliukė;BITUTĖS;8457120425;Taip;3;0;0;3
1025;Coliukė;BITUTĖS;9311775782;Taip;12;0;0;12
1026;Coliukė;BITUTĖS;81003830638;Taip;0;5;0;5
1027;Coliukė;BITUTĖS;36554487034;Taip;6;5;0;11
1028;Coliukė;BITUTĖS;1423711475;Taip;7;4;0;11
1029;Coliukė;VABALIUKAI;62876576078;Taip;0;1;0;1
1030;Coliukė;VABALIUKAI;51782207208;Taip;7;4;0;11
1031;Coliukė;VABALIUKAI;26012978171;Taip;0;0;1;1
1032;Coliukė;VABALIUKAI;18718511212;Taip;0;5;0;5
1033;Coliukė;VABALIUKAI;26698840369;Taip;0;11;0;11
1034;Coliukė;VABALIUKAI;78760440826;Taip;0;10;0;10
1035;Coliukė;VABALIUKAI;6025281817;Ne;0;1;0;1
1036;Coliukė;VABALIUKAI;22951260339;Taip;12;3;0;15
1037;Coliukė;VABALIUKAI;33587152454;Taip;8;7;0;15
1038;Coliukė;VABALIUKAI;82064520362;Taip;12;0;0;12
1039;Coliukė;VABALIUKAI;57504928606;Taip;15;1;0;16
1040;Coliukė;VABALIUKAI;1654628972;Taip;9;0;0;9
1041;Coliukė;VABALIUKAI;5944299310;Taip;2;1;0;3
1042;Coliukė;VABALIUKAI;4649987214;Taip;11;1;0;12
1043;Coliukė;VABALIUKAI;5672562299;Taip;0;0;1;1
1044;Coliukė;VABALIUKAI;63258983714;Taip;10;0;0;10
1045;Coliukė;VABALIUKAI;99200764707;Taip;10;0;0;10
1046;Coliukė;VABALIUKAI;1476750428;Taip;14;2;0;16
1047;Coliukė;VABALIUKAI;6775470024;Taip;8;0;0;8
1048;Coliukė;VABALIUKAI;8323242104;Taip;5;8;0;13
1049;Coliukė;NYKŠTUKAI;1659532709;Taip;0;0;2;2
1050;Coliukė;NYKŠTUKAI;88866481329;Taip;0;5;0;5
1051;Coliukė;NYKŠTUKAI;1812071213;Taip;0;5;0;5
1052;Coliukė;NYKŠTUKAI;43313407836;Taip;6;0;1;7
1053;Coliukė;NYKŠTUKAI;3738703854;Taip;17;0;0;17
1054;Coliukė;NYKŠTUKAI;1997515382;Taip;5;6;0;11
1055;Coliukė;NYKŠTUKAI;1267427191;Taip;0;0;3;3
1056;Coliukė;NYKŠTUKAI;1963122314;Taip;0;22;0;22
1057;Coliukė;NYKŠTUKAI;4917899323;Taip;0;8;0;8
1058;Coliukė;NYKŠTUKAI;4747481676;Ne;0;3;0;3
1059;Coliukė;NYKŠTUKAI;83027842354;Ne;7;6;0;13
1060;Coliukė;NYKŠTUKAI;2168987649;Taip;11;0;0;11
1061;Coliukė;NYKŠTUKAI;2684151591;Taip;4;4;0;8
1062;Coliukė;NYKŠTUKAI;4499924331;Taip;0;4;0;4
1063;Coliukė;NYKŠTUKAI;9383567339;Taip;5;7;0;12
1064;Coliukė;NYKŠTUKAI;7566429633;Taip;2;3;0;5
1065;Coliukė;NYKŠTUKAI;9542366183;Taip;12;2;0;14
1066;Coliukė;NYKŠTUKAI;7670166244;Taip;0;4;0;4
1067;Coliukė;NYKŠTUKAI;7622526793;Taip;0;2;0;2
1068;Coliukė;GĖLYTĖS;8835394030;Taip;0;8;0;8
1069;Coliukė;GĖLYTĖS;3427704550;Taip;2;7;0;9
1070;Coliukė;GĖLYTĖS;7248705010;Taip;14;0;0;14
1071;Coliukė;GĖLYTĖS;1318558913;Taip;5;0;0;5
1072;Coliukė;GĖLYTĖS;4022408510;Taip;0;3;0;3
1073;Coliukė;GĖLYTĖS;3318808813;Taip;10;0;0;10
1074;Coliukė;GĖLYTĖS;4498253271;Taip;8;0;0;8
1075;Coliukė;GĖLYTĖS;3323738649;Taip;0;3;0;3
1076;Coliukė;GĖLYTĖS;9331485675;Taip;19;0;0;19
1077;Coliukė;GĖLYTĖS;8149118599;Taip;8;0;0;8
1078;Coliukė;GĖLYTĖS;8209209881;Taip;11;0;0;11
1079;Coliukė;GĖLYTĖS;5139645108;Taip;6;1;0;7
1080;Coliukė;"BORUŽĖLĖS (SPEC.)";1988394967;Taip;2;10;0;12
1081;Coliukė;"BORUŽĖLĖS (SPEC.)";3746858489;Taip;0;3;0;3
1082;Coliukė;"BORUŽĖLĖS (SPEC.)";2080118127;Taip;0;2;0;2
1083;Coliukė;"BORUŽĖLĖS (SPEC.)";8070499557;Taip;0;7;0;7
1084;Coliukė;"BORUŽĖLĖS (SPEC.)";2617816991;Taip;5;0;0;5
1085;Coliukė;"BORUŽĖLĖS (SPEC.)";9368334915;Taip;5;9;0;14
1086;Coliukė;"BORUŽĖLĖS (SPEC.)";1644303265;Taip;5;7;0;12
1087;Coliukė;"BORUŽĖLĖS (SPEC.)";60578936717;Taip;0;8;0;8
1088;Čiauškutis;BITUTĖS;78373250443;Taip;22;0;0;22
1089;Čiauškutis;BITUTĖS;7755428393;Taip;5;0;0;5
1090;Čiauškutis;BITUTĖS;3499391608;Taip;5;3;0;8
1091;Čiauškutis;BITUTĖS;1443155220;Taip;0;7;0;7
1092;Čiauškutis;BITUTĖS;2012201854;Taip;0;0;4;4
1093;Čiauškutis;BITUTĖS;38387916428;Taip;4;0;3;7
1094;Čiauškutis;BITUTĖS;1804509009;Taip;9;0;0;9
1095;Čiauškutis;BITUTĖS;22717947028;Taip;0;7;0;7
1096;Čiauškutis;BITUTĖS;3917667527;Ne;4;0;0;4
1097;Čiauškutis;BITUTĖS;4600623461;Taip;0;3;0;3
1098;Čiauškutis;BITUTĖS;27158851138;Taip;0;3;0;3
1099;Čiauškutis;BITUTĖS;8030685444;Ne;0;6;0;6
1100;Čiauškutis;ŽVIRBLIUKAI;1298724775;Taip;0;1;0;1
1101;Čiauškutis;ŽVIRBLIUKAI;1301573542;Ne;0;1;3;4
1102;Čiauškutis;ŽVIRBLIUKAI;2554011985;Ne;10;0;0;10
1103;Čiauškutis;ŽVIRBLIUKAI;2044220236;Taip;22;0;0;22
1104;Čiauškutis;ŽVIRBLIUKAI;2633243682;Taip;0;0;3;3
1105;Čiauškutis;ŽVIRBLIUKAI;5900996969;Taip;1;0;0;1
1106;Čiauškutis;ŽVIRBLIUKAI;6170362846;Taip;18;0;0;18
1107;Čiauškutis;ŽVIRBLIUKAI;1036358147;Ne;0;4;3;7
1108;Čiauškutis;ŽVIRBLIUKAI;9072764004;Ne;22;0;0;22
1109;Čiauškutis;ŽVIRBLIUKAI;8690876173;Ne;0;1;7;8
1110;Čiauškutis;SAULUTĖS;95495836415;Taip;0;1;0;1
1111;Čiauškutis;SAULUTĖS;2976888531;Taip;0;2;0;2
1112;Čiauškutis;SAULUTĖS;1798962981;Taip;6;1;1;8
1113;Čiauškutis;SAULUTĖS;6279678482;Taip;0;1;0;1
1114;Čiauškutis;SAULUTĖS;93468721158;Taip;0;0;5;5
1115;Čiauškutis;SAULUTĖS;5739889733;Taip;0;0;5;5
1116;Čiauškutis;SAULUTĖS;35965163532;Taip;0;1;0;1
1117;Čiauškutis;SAULUTĖS;2312273972;Taip;22;0;0;22
1118;Čiauškutis;EŽIUKAI;1824372731;Taip;7;0;0;7
1119;Čiauškutis;EŽIUKAI;1960094598;Taip;20;0;0;20
1120;Čiauškutis;EŽIUKAI;1575387912;Taip;0;0;3;3
1121;Čiauškutis;EŽIUKAI;37100318588;Taip;0;0;2;2
1122;Čiauškutis;EŽIUKAI;32956407401;Taip;0;19;0;19
1123;Čiauškutis;DRUGELIAI;1332686904;Taip;2;0;1;3
1124;Čiauškutis;DRUGELIAI;1404146538;Taip;10;0;1;11
1125;Čiauškutis;DRUGELIAI;8974089037;Taip;0;0;2;2
1126;Čiauškutis;DRUGELIAI;1417978731;Taip;0;0;1;1
1127;Čiauškutis;DRUGELIAI;7011763860;Taip;0;0;9;9
1128;Čiauškutis;DRUGELIAI;1503190001;Taip;1;0;1;2
1129;Čiauškutis;DRUGELIAI;55539901360;Taip;0;0;2;2
1130;Čiauškutis;DRUGELIAI;47625081475;Taip;2;0;0;2
1131;Čiauškutis;DRUGELIAI;45303538716;Taip;20;0;0;20
1132;Čiauškutis;GENELIAI;3888278518;Ne;6;0;1;7
1133;Čiauškutis;GENELIAI;4442345827;Taip;17;0;1;18
1134;Čiauškutis;GENELIAI;6476417522;Taip;11;0;0;11
1135;Čiauškutis;GENELIAI;9679979305;Taip;3;0;5;8
1136;Čiauškutis;GENELIAI;32342661810;Taip;0;0;4;4
1137;Čiauškutis;GENELIAI;76993441149;Taip;5;0;0;5
1138;Čiauškutis;GENELIAI;48375767334;Taip;2;0;0;2
1139;Čiauškutis;GENELIAI;34341858813;Taip;2;0;2;4
1140;Čiauškutis;GENELIAI;48881709481;Taip;2;0;2;4
1141;Čiauškutis;GENELIAI;47866559654;Taip;7;0;0;7
1142;Čiauškutis;GENELIAI;1330717109;Taip;6;0;0;6
1143;Čiauškutis;LINKSMUČIAI;3127896063;Ne;0;0;3;3
1144;Čiauškutis;LINKSMUČIAI;1691137830;Ne;0;0;8;8
1145;Čiauškutis;LINKSMUČIAI;70507237430;Taip;0;0;9;9
1146;Čiauškutis;LINKSMUČIAI;65948673886;Taip;0;2;0;2
1147;Čiauškutis;LINKSMUČIAI;32426102534;Taip;0;0;8;8
1148;Čiauškutis;LINKSMUČIAI;9722014294;Taip;2;0;6;8
1149;Čiauškutis;LINKSMUČIAI;54471558189;Taip;0;0;3;3
1150;Čiauškutis;LINKSMUČIAI;13187502295;Taip;5;1;0;6
1151;Čiauškutis;LINKSMUČIAI;1452900014;Taip;0;2;2;4
1152;Čiauškutis;LINKSMUČIAI;2049302005;Taip;0;2;2;4
1153;Čiauškutis;KIŠKUČIAI;1380571576;Taip;0;8;0;8
1154;Čiauškutis;KIŠKUČIAI;4817007142;Taip;10;5;0;15
1155;Čiauškutis;KIŠKUČIAI;2019831231;Taip;0;0;1;1
1156;Čiauškutis;KIŠKUČIAI;9603569117;Ne;0;1;0;1
1157;Čiauškutis;KIŠKUČIAI;1474355889;Ne;3;2;0;5
1158;Čiauškutis;KIŠKUČIAI;26779062894;Ne;10;0;0;10
1159;Čiauškutis;KIŠKUČIAI;1109018212;Taip;9;0;0;9
1160;Čiauškutis;KIŠKUČIAI;72264057427;Taip;7;6;0;13
1161;Čiauškutis;KIŠKUČIAI;3080441515;Taip;0;2;3;5
1162;Čiauškutis;KIŠKUČIAI;8884708945;Taip;10;0;5;15
1163;Čiauškutis;KIŠKUČIAI;2099735647;Taip;5;0;1;6
1164;Čiauškutis;LAPIUKAI;1486206292;Taip;5;0;0;5
1165;Čiauškutis;LAPIUKAI;1719875491;Taip;0;0;2;2
1166;Čiauškutis;LAPIUKAI;1849532875;Ne;0;1;1;2
1167;Čiauškutis;LAPIUKAI;60265156684;Taip;0;0;4;4
1168;Čiauškutis;LAPIUKAI;1938531597;Ne;0;3;0;3
1169;Čiauškutis;LAPIUKAI;31203540590;Taip;6;0;0;6
1170;Čiauškutis;LAPIUKAI;8857039064;Taip;2;1;0;3
1171;Čiauškutis;MEŠKUČIAI;6193581306;Taip;7;0;0;7
1172;Čiauškutis;MEŠKUČIAI;95088279233;Taip;5;0;0;5
1173;Čiauškutis;MEŠKUČIAI;4341825486;Taip;3;0;0;3
1174;Čiauškutis;PELĖDŽIUKAI;6572444114;Taip;0;0;1;1
1175;Čiauškutis;PELĖDŽIUKAI;7060197354;Taip;0;2;0;2
1176;Čiauškutis;PELĖDŽIUKAI;7961309940;Taip;6;1;0;7
1177;Čiauškutis;PELĖDŽIUKAI;8728572783;Ne;0;1;0;1
1178;Čiauškutis;PELĖDŽIUKAI;1253449294;Taip;0;0;2;2
1179;Čiauškutis;PELĖDŽIUKAI;82575455120;Taip;7;0;0;7
1180;Čiauškutis;PELĖDŽIUKAI;6165710260;Taip;0;1;3;4
1181;Čiauškutis;PELĖDŽIUKAI;1546096184;Taip;0;17;0;17
1182;Čiauškutis;PELĖDŽIUKAI;4135020826;Taip;10;0;0;10
1183;Čiauškutis;PELĖDŽIUKAI;30480486366;Taip;5;0;0;5
1184;Čiauškutis;PELĖDŽIUKAI;70690874267;Taip;2;12;0;14
1185;Čiauškutis;NYKŠTUKAI;6258150407;Taip;2;1;2;5
1186;Čiauškutis;NYKŠTUKAI;1621605644;Taip;6;0;0;6
1187;Čiauškutis;NYKŠTUKAI;1778900145;Taip;15;1;0;16
1188;Čiauškutis;NYKŠTUKAI;4846025153;Taip;1;0;0;1
1189;Čiauškutis;NYKŠTUKAI;4898534899;Taip;13;0;0;13
1190;Čiauškutis;NYKŠTUKAI;8896526358;Taip;0;1;1;2
1191;Čiauškutis;NYKŠTUKAI;7367933940;Ne;11;1;0;12
1192;Čiauškutis;NYKŠTUKAI;8346845876;Taip;0;8;0;8
1193;Čiauškutis;NYKŠTUKAI;24468474924;Taip;0;6;0;6
1194;Delfinukas;Boružėlių;4713803167;Taip;0;0;21;21
1195;Delfinukas;Boružėlių;1873630966;Taip;2;0;0;2
1196;Delfinukas;Boružėlių;6531930806;Taip;8;0;1;9
1197;Delfinukas;Boružėlių;8076961367;Ne;12;1;3;16
1198;Delfinukas;Boružėlių;8439204095;Taip;7;0;0;7
1199;Delfinukas;Boružėlių;2010703982;Taip;0;2;0;2
1200;Delfinukas;Boružėlių;8728791932;Taip;0;0;1;1
1201;Delfinukas;Boružėlių;6700068320;Taip;5;0;3;8
1202;Delfinukas;Boružėlių;7277680544;Taip;5;0;4;9
1203;Delfinukas;Boružėlių;9099945815;Ne;18;0;0;18
1204;Delfinukas;Boružėlių;1212995285;Taip;2;0;0;2
1205;Delfinukas;Saulytės;1293348150;Taip;12;2;0;14
1206;Delfinukas;Saulytės;65798709244;Ne;12;0;0;12
1207;Delfinukas;Saulytės;76643778833;Taip;5;4;0;9
1208;Delfinukas;Saulytės;35058841521;Taip;10;2;0;12
1209;Delfinukas;Saulytės;9918028862;Taip;12;0;0;12
1210;Delfinukas;Saulytės;1260108624;Ne;1;0;0;1
1211;Delfinukas;Saulytės;79934072325;Taip;0;5;0;5
1212;Delfinukas;Saulytės;2096874518;Taip;0;3;0;3
1213;Delfinukas;Saulytės;5912904296;Taip;5;0;0;5
1214;Delfinukas;Saulytės;2009324145;Taip;11;5;0;16
1215;Delfinukas;Saulytės;27140729689;Taip;0;7;2;9
1216;Delfinukas;Saulytės;46847640903;Taip;6;0;4;10
1217;Delfinukas;Saulytės;4142864015;Ne;0;10;0;10
1218;Delfinukas;Saulytės;16785309188;Taip;9;8;0;17
1219;Delfinukas;Saulytės;34563800372;Taip;0;2;0;2
1220;Delfinukas;Saulytės;2074439295;Taip;10;0;0;10
1221;Delfinukas;Saulytės;1364873935;Taip;7;2;0;9
1222;Delfinukas;Saulytės;1939499375;Taip;11;3;0;14
1223;Delfinukas;Pelėdžiukų;9520598359;Taip;9;1;0;10
1224;Delfinukas;Pelėdžiukų;8938997208;Taip;17;0;0;17
1225;Delfinukas;Pelėdžiukų;6572690788;Taip;0;2;2;4
1226;Delfinukas;Pelėdžiukų;4631456002;Taip;2;0;1;3
1227;Delfinukas;Pelėdžiukų;3804996594;Taip;0;5;6;11
1228;Delfinukas;Pelėdžiukų;1136182876;Taip;0;1;0;1
1229;Delfinukas;Pelėdžiukų;8936645508;Taip;0;0;1;1
1230;Delfinukas;Pelėdžiukų;2869506388;Taip;0;2;1;3
1231;Delfinukas;Pelėdžiukų;6844500395;Taip;0;1;0;1
1232;Delfinukas;Pelėdžiukų;9074294473;Taip;0;0;6;6
1233;Delfinukas;Varliukų;1153333591;Ne;0;4;6;10
1234;Delfinukas;Varliukų;1091165849;Taip;0;0;4;4
1235;Delfinukas;Varliukų;1421633312;Taip;5;0;0;5
1236;Delfinukas;Varliukų;9573336239;Ne;10;1;0;11
1237;Delfinukas;Varliukų;1251961268;Taip;16;2;0;18
1238;Delfinukas;Varliukų;1789047913;Taip;0;13;4;17
1239;Delfinukas;Varliukų;3678131609;Ne;0;2;4;6
1240;Delfinukas;Varliukų;1194444282;Taip;5;0;0;5
1241;Delfinukas;Varliukų;9347513042;Taip;0;5;1;6
1242;Delfinukas;Varliukų;8875479631;Taip;0;7;1;8
1243;Delfinukas;Varliukų;3344476309;Taip;5;0;0;5
1244;Delfinukas;Varliukų;3955783379;Taip;0;8;0;8
1245;Delfinukas;Varliukų;9502789660;Taip;5;0;6;11
1246;Delfinukas;Varliukų;3489297719;Taip;4;1;1;6
1247;Delfinukas;Varliukų;1948438336;Ne;5;0;5;10
1248;Delfinukas;Varliukų;9266646602;Taip;22;0;0;22
1249;Delfinukas;Varliukų;3674481373;Taip;0;2;1;3
1250;Delfinukas;Varpelių;1201971467;Taip;0;5;0;5
1251;Delfinukas;Varpelių;17472648959;Taip;0;1;0;1
1252;Delfinukas;Varpelių;73187227229;Taip;0;2;0;2
1253;Delfinukas;Varpelių;89455376961;Taip;3;10;0;13
1254;Delfinukas;Varpelių;62769117892;Taip;7;8;0;15
1255;Delfinukas;Varpelių;46792667256;Taip;5;1;0;6
1256;Delfinukas;Varpelių;70985723823;Ne;0;13;0;13
1257;Delfinukas;Varpelių;8855690221;Taip;22;0;0;22
1258;Delfinukas;Varpelių;64913771294;Ne;7;0;0;7
1259;Delfinukas;Varpelių;3093606855;Taip;15;0;5;20
1260;Delfinukas;Varpelių;6393090675;Taip;7;0;0;7
1261;Delfinukas;Varpelių;1268754720;Taip;0;11;0;11
1262;Delfinukas;Varpelių;1959331544;Taip;6;0;0;6
1263;Delfinukas;Varpelių;3718612458;Taip;22;0;0;22
1264;Delfinukas;Varpelių;43859975789;Taip;7;4;0;11
1265;Delfinukas;Varpelių;2531571615;Taip;2;5;0;7
1266;Delfinukas;Varpelių;91028452879;Taip;7;5;0;12
1267;Delfinukas;Varpelių;1325054642;Ne;0;7;0;7
1268;Delfinukas;Varpelių;7163839896;Ne;0;5;0;5
1269;Delfinukas;Varpelių;7493037613;Ne;0;5;0;5
1270;Delfinukas;Varpelių;4239224971;Taip;9;2;0;11
1271;Delfinukas;Varpelių;5123666058;Taip;0;7;0;7
1272;Delfinukas;Delfinukai;5093418481;Taip;2;0;0;2
1273;Delfinukas;Delfinukai;6190642132;Taip;4;8;0;12
1274;Delfinukas;Delfinukai;57676205527;Taip;0;6;0;6
1275;Delfinukas;Delfinukai;71523999168;Taip;0;6;0;6
1276;Delfinukas;Delfinukai;46276990963;Taip;0;1;0;1
1277;Delfinukas;Delfinukai;7528505426;Taip;4;0;0;4
1278;Delfinukas;Delfinukai;7509276953;Ne;5;0;0;5
1279;Delfinukas;Delfinukai;6561536457;Taip;12;2;0;14
1280;Delfinukas;Delfinukai;545765924;Taip;12;0;0;12
1281;Delfinukas;Delfinukai;1517834246;Taip;2;0;0;2
1282;Delfinukas;Delfinukai;1430155044;Taip;3;2;0;5
1283;Delfinukas;Delfinukai;8227660508;Taip;9;0;0;9
1284;Delfinukas;Delfinukai;7886801955;Taip;0;0;22;22
1285;Delfinukas;Delfinukai;1160537966;Taip;17;0;0;17
1286;Delfinukas;Delfinukai;26626004000;Taip;0;0;22;22
1287;Delfinukas;Drugeliai;83704349624;Taip;0;2;0;2
1288;Delfinukas;Drugeliai;74847760830;Taip;4;0;0;4
1289;Delfinukas;Drugeliai;35812802830;Taip;0;9;0;9
1290;Delfinukas;Drugeliai;2960662435;Taip;0;7;0;7
1291;Delfinukas;Drugeliai;11940207202;Taip;0;3;3;6
1292;Delfinukas;Drugeliai;94713648240;Taip;0;2;2;4
1293;Delfinukas;Drugeliai;1882976317;Taip;5;0;0;5
1294;Delfinukas;Drugeliai;9168812609;Taip;0;6;5;11
1295;Delfinukas;Drugeliai;5024726028;Taip;8;2;0;10
1296;Delfinukas;Drugeliai;88370692635;Taip;5;1;0;6
1297;Delfinukas;Drugeliai;4435982727;Taip;0;2;1;3
1298;Delfinukas;Drugeliai;33466088300;Taip;0;10;0;10
1299;Delfinukas;Drugeliai;8782782031;Taip;0;5;0;5
1300;Delfinukas;Žuvytės;31776667512;Taip;0;7;1;8
1301;Delfinukas;Žuvytės;47377556072;Taip;0;2;0;2
1302;Delfinukas;Žuvytės;82176273307;Taip;5;2;0;7
1303;Delfinukas;Žuvytės;53152433196;Taip;5;2;0;7
1304;Delfinukas;Žuvytės;94392092103;Ne;7;0;0;7
1305;Delfinukas;Žuvytės;57461575212;Taip;8;0;0;8
1306;Delfinukas;Žuvytės;40665480700;Taip;0;2;0;2
1307;Delfinukas;Žuvytės;3310208029;Taip;0;13;0;13
1308;Delfinukas;Žuvytės;1693121016;Taip;0;8;0;8
1309;Delfinukas;Žuvytės;82936702613;Taip;10;0;0;10
1310;Delfinukas;Žuvytės;30104416225;Taip;0;2;0;2
1311;Delfinukas;Žuvytės;31006890017;Taip;13;0;4;17
1312;Delfinukas;Žuvytės;30064453011;Taip;0;17;0;17
1313;Delfinukas;Žuvytės;59541249199;Taip;0;3;0;3
1314;Delfinukas;Delfinai;8335398345;Taip;3;0;0;3
1315;Delfinukas;Delfinai;37530814188;Taip;0;4;2;6
1316;Delfinukas;Delfinai;1435104895;Taip;10;0;0;10
1317;Delfinukas;Delfinai;2308733347;Taip;0;5;0;5
1318;Delfinukas;Delfinai;1876110301;Taip;18;0;0;18
1319;Delfinukas;Delfinai;1101237825;Taip;10;3;0;13
1320;Delfinukas;Delfinai;11528618044;Taip;0;10;0;10
1321;Delfinukas;Delfinai;26554152266;Taip;6;2;2;10
1322;Delfinukas;Delfinai;51442842468;Taip;8;3;0;11
1323;Delfinukas;Delfinai;84024727184;Taip;8;1;0;9
1324;Delfinukas;Delfinai;1515422367;Taip;0;1;0;1
1325;Delfinukas;Delfinai;71828460624;Taip;0;2;0;2
1326;Delfinukas;Delfinai;4549364929;Taip;0;11;0;11
1327;Delfinukas;Delfinai;4497323553;Taip;0;11;0;11
1328;Delfinukas;Delfinai;1037795359;Taip;0;2;0;2
1329;Delfinukas;Delfinai;83920976768;Taip;0;9;0;9
1330;Delfinukas;Delfinai;1963422247;Taip;0;5;0;5
1331;Delfinukas;Delfinai;9821969586;Taip;0;7;0;7
1332;Delfinukas;Delfinai;4569691896;Taip;14;0;0;14
1333;Delfinukas;Paukšteliai;6047881184;Taip;1;0;0;1
1334;Delfinukas;Paukšteliai;8038737019;Taip;5;0;0;5
1335;Delfinukas;Paukšteliai;9628317328;Taip;2;5;0;7
1336;Delfinukas;Paukšteliai;5797308373;Taip;8;0;0;8
1337;Delfinukas;Paukšteliai;5241426445;Ne;4;0;0;4
1338;Delfinukas;Paukšteliai;8099120371;Taip;0;0;22;22
1339;Delfinukas;Paukšteliai;3108430680;Taip;5;0;0;5
1340;Delfinukas;Paukšteliai;7663934825;Taip;5;5;0;10
1341;Delfinukas;Paukšteliai;2382077576;Taip;0;4;0;4
1342;Delfinukas;Paukšteliai;1200205376;Taip;10;0;0;10
1343;Delfinukas;Paukšteliai;4347116918;Taip;1;0;0;1
1344;Delfinukas;Paukšteliai;1922513830;Taip;8;4;0;12
1345;Delfinukas;Paukšteliai;7629622746;Ne;5;1;0;6
1346;Delfinukas;Paukšteliai;8335034956;Taip;22;0;0;22
1347;Delfinukas;Paukšteliai;6337962165;Taip;7;0;0;7
1348;Delfinukas;Kiškučiai;67554154339;Taip;0;5;0;5
1349;Delfinukas;Kiškučiai;7766292005;Taip;0;3;0;3
1350;Delfinukas;Kiškučiai;98742243823;Taip;7;9;0;16
1351;Delfinukas;Kiškučiai;1498120150;Taip;5;6;0;11
1352;Delfinukas;Kiškučiai;7920401664;Taip;0;7;0;7
1353;Delfinukas;Kiškučiai;1767369189;Taip;17;3;0;20
1354;Delfinukas;Kiškučiai;1495145663;Taip;0;4;0;4
1355;Delfinukas;Kiškučiai;1301231548;Taip;0;1;2;3
1356;Delfinukas;Kiškučiai;1613911039;Taip;0;1;0;1
1357;Delfinukas;Kiškučiai;1477374660;Taip;7;0;0;7
1358;Delfinukas;Kiškučiai;2993704795;Taip;0;2;1;3
1359;Delfinukas;Kiškučiai;1487082744;Taip;0;2;1;3
1360;Delfinukas;Kiškučiai;99919425286;Taip;7;0;0;7
1361;Delfinukas;Kiškučiai;1011101007;Ne;0;1;0;1
1362;Delfinukas;Kiškučiai;2063259303;Taip;0;4;0;4
1363;Delfinukas;Kiškučiai;1166370228;Taip;0;7;0;7
1364;Delfinukas;Kiškučiai;96861425670;Taip;0;1;0;1
1365;Delfinukas;Kiškučiai;60320557464;Ne;12;0;0;12
1366;Delfinukas;Kiškučiai;1594700604;Taip;5;1;0;6
1367;Dobilėlis;"I grupė";28814860843;Taip;0;2;0;2
1368;Dobilėlis;"I grupė";2487908650;Taip;0;2;0;2
1369;Dobilėlis;"I grupė";8709039752;Taip;10;12;0;22
1370;Dobilėlis;"I grupė";6561825173;Ne;20;0;0;20
1371;Dobilėlis;"I grupė";7122041826;Taip;4;3;0;7
1372;Dobilėlis;"II grupė";17440499472;Taip;0;1;0;1
1373;Dobilėlis;"II grupė";92147631467;Taip;3;0;0;3
1374;Dobilėlis;"II grupė";68068847689;Taip;0;8;0;8
1375;Dobilėlis;"II grupė";1173849791;Taip;7;2;1;10
1376;Drevinukas;ZUIKUČIAI;8180027849;Taip;6;0;1;7
1377;Drevinukas;ZUIKUČIAI;5686116320;Taip;5;0;1;6
1378;Drevinukas;ZUIKUČIAI;85288014888;Taip;0;3;0;3
1379;Drevinukas;ZUIKUČIAI;56028675283;Taip;5;1;0;6
1380;Drevinukas;ZUIKUČIAI;4784716615;Taip;11;0;0;11
1381;Drevinukas;ZUIKUČIAI;2070374746;Taip;0;0;4;4
1382;Drevinukas;ZUIKUČIAI;16952164778;Taip;0;7;0;7
1383;Drevinukas;ZUIKUČIAI;7632515230;Taip;7;0;0;7
1384;Drevinukas;ZUIKUČIAI;1019214451;Taip;3;0;2;5
1385;Drevinukas;ZUIKUČIAI;2074070030;Taip;0;3;2;5
1386;Drevinukas;ZUIKUČIAI;6304169257;Taip;0;5;0;5
1387;Drevinukas;ZUIKUČIAI;3657451903;Taip;14;0;2;16
1388;Drevinukas;ZUIKUČIAI;4332606643;Ne;0;0;3;3
1389;Drevinukas;ZUIKUČIAI;1987939679;Taip;7;0;9;16
1390;Drevinukas;ZUIKUČIAI;1123115847;Taip;14;0;2;16
1391;Drevinukas;ZUIKUČIAI;9336227821;Taip;0;0;3;3
1392;Drevinukas;ZUIKUČIAI;6425268903;Taip;0;3;8;11
1393;Drevinukas;AŽUOLIUKŲ;64560340218;Taip;0;12;0;12
1394;Drevinukas;AŽUOLIUKŲ;17456144256;Taip;14;0;1;15
1395;Drevinukas;AŽUOLIUKŲ;3066586415;Taip;0;0;9;9
1396;Drevinukas;AŽUOLIUKŲ;22050717457;Taip;0;1;1;2
1397;Drevinukas;AŽUOLIUKŲ;1798044901;Taip;8;0;1;9
1398;Drevinukas;AŽUOLIUKŲ;73923305630;Ne;7;1;2;10
1399;Drevinukas;AŽUOLIUKŲ;96655135353;Taip;0;5;0;5
1400;Drevinukas;AŽUOLIUKŲ;1254845545;Taip;10;0;0;10
1401;Drevinukas;AŽUOLIUKŲ;46006802320;Taip;7;3;0;10
1402;Drevinukas;AŽUOLIUKŲ;9657606451;Taip;0;5;0;5
1403;Drevinukas;AŽUOLIUKŲ;4150306697;Taip;0;10;0;10
1404;Drevinukas;AŽUOLIUKŲ;71447591085;Taip;4;6;0;10
1405;Drevinukas;PELĖDŽIUKAI;4694536057;Taip;0;0;1;1
1406;Drevinukas;PELĖDŽIUKAI;3114995856;Taip;0;0;2;2
1407;Drevinukas;PELĖDŽIUKAI;49359528680;Taip;0;0;7;7
1408;Drevinukas;PELĖDŽIUKAI;51830569951;Taip;0;0;3;3
1409;Drevinukas;PELĖDŽIUKAI;24866634007;Taip;0;0;8;8
1410;Drevinukas;PELĖDŽIUKAI;98431492077;Taip;0;0;4;4
1411;Drevinukas;PELĖDŽIUKAI;54578654099;Taip;0;0;1;1
1412;Drevinukas;PELĖDŽIUKAI;62264151217;Taip;0;3;0;3
1413;Drevinukas;PELĖDŽIUKAI;45489453961;Ne;0;0;2;2
1414;Drevinukas;PELĖDŽIUKAI;11985365230;Taip;0;6;3;9
1415;Drevinukas;PELĖDŽIUKAI;59835545517;Taip;2;4;0;6
1416;Drevinukas;PELĖDŽIUKAI;12709943846;Taip;0;2;0;2
1417;Drevinukas;PELĖDŽIUKAI;69217298162;Taip;0;0;3;3
1418;Drevinukas;PELĖDŽIUKAI;47576956459;Taip;0;1;6;7
1419;Drevinukas;PELĖDŽIUKAI;61881364454;Taip;0;0;2;2
1420;Drevinukas;BORUŽĖLĖS;24300552411;Taip;0;2;0;2
1421;Drevinukas;BORUŽĖLĖS;3625661236;Taip;7;5;0;12
1422;Drevinukas;BORUŽĖLĖS;41776089342;Taip;0;7;0;7
1423;Drevinukas;BORUŽĖLĖS;46323011887;Taip;5;4;0;9
1424;Drevinukas;BORUŽĖLĖS;17722412785;Taip;2;2;1;5
1425;Drevinukas;BORUŽĖLĖS;1437074990;Taip;0;0;6;6
1426;Drevinukas;BORUŽĖLĖS;1577311253;Taip;0;0;3;3
1427;Drevinukas;BORUŽĖLĖS;6539595624;Taip;5;0;7;12
1428;Drevinukas;BORUŽĖLĖS;7570410899;Ne;22;0;0;22
1429;Drevinukas;BORUŽĖLĖS;1929303009;Taip;5;2;2;9
1430;Drevinukas;BORUŽĖLĖS;59090501289;Taip;10;0;0;10
1431;Drevinukas;BORUŽĖLĖS;1585468549;Taip;5;8;0;13
1432;Drevinukas;BORUŽĖLĖS;1276720097;Taip;0;6;3;9
1433;Drevinukas;BORUŽĖLĖS;47549756124;Taip;0;0;2;2
1434;Drevinukas;BORUŽĖLĖS;3604979285;Taip;17;0;1;18
1435;Drevinukas;BORUŽĖLĖS;78348414683;Taip;3;0;0;3
1436;Drevinukas;BORUŽĖLĖS;1970787957;Taip;0;12;0;12
1437;Drevinukas;BORUŽĖLĖS;30667895560;Taip;10;0;0;10
1438;Drevinukas;BORUŽĖLĖS;83194462453;Taip;0;7;0;7
1439;Drevinukas;BORUŽĖLĖS;63665560323;Taip;0;0;3;3
1440;Drevinukas;BITUTĖS;81036035477;Taip;0;4;0;4
1441;Drevinukas;BITUTĖS;96688324084;Taip;0;1;1;2
1442;Drevinukas;BITUTĖS;70347618653;Taip;0;0;2;2
1443;Drevinukas;BITUTĖS;24223024745;Taip;0;0;4;4
1444;Drevinukas;BITUTĖS;7088781332;Taip;0;4;0;4
1445;Drevinukas;BITUTĖS;79654459964;Taip;0;1;0;1
1446;Drevinukas;BITUTĖS;7874030637;Taip;0;4;0;4
1447;Drevinukas;BITUTĖS;86268382049;Taip;0;4;0;4
1448;Drevinukas;BITUTĖS;73165075762;Taip;0;4;0;4
1449;Drevinukas;BITUTĖS;91352351942;Taip;0;7;1;8
1450;Drevinukas;BITUTĖS;43573400232;Taip;0;1;0;1
1451;Drevinukas;BITUTĖS;43087053446;Taip;2;1;1;4
1452;Drevinukas;BITUTĖS;81362980445;Taip;5;0;0;5
1453;Drevinukas;BITUTĖS;66058660804;Taip;5;13;0;18
1454;Drevinukas;BITUTĖS;56016757119;Taip;6;0;6;12
1455;Drevinukas;BITUTĖS;62294117396;Taip;0;0;7;7
1456;Drevinukas;BITUTĖS;71273092994;Taip;0;2;0;2
1457;Drevinukas;NYKŠTUKAI;1720464417;Taip;0;0;7;7
1458;Drevinukas;NYKŠTUKAI;6095020718;Taip;10;0;1;11
1459;Drevinukas;NYKŠTUKAI;7753238387;Taip;5;0;6;11
1460;Drevinukas;NYKŠTUKAI;3981507849;Taip;0;10;1;11
1461;Drevinukas;NYKŠTUKAI;5679723776;Taip;0;9;0;9
1462;Drevinukas;NYKŠTUKAI;2857797268;Taip;3;0;0;3
1463;Drevinukas;NYKŠTUKAI;3875062228;Taip;0;4;2;6
1464;Drevinukas;NYKŠTUKAI;8479979176;Taip;15;0;0;15
1465;Drevinukas;NYKŠTUKAI;2531207946;Taip;15;0;0;15
1466;Drevinukas;NYKŠTUKAI;1152161183;Taip;5;0;8;13
1467;Drevinukas;NYKŠTUKAI;6256572875;Taip;13;0;0;13
1468;Drevinukas;NYKŠTUKAI;8936058501;Taip;18;0;1;19
1469;Drevinukas;NYKŠTUKAI;8130416781;Taip;7;0;0;7
1470;Drevinukas;NYKŠTUKAI;3972897839;Taip;6;0;0;6
1471;Drevinukas;NYKŠTUKAI;9772484901;Taip;0;2;0;2
1472;Drevinukas;NYKŠTUKAI;7520907833;Taip;0;3;0;3
1473;Drevinukas;NYKŠTUKAI;8625382465;Taip;7;0;0;7
1474;Drevinukas;SMALSUČIAI;3032536983;Taip;5;0;2;7
1475;Drevinukas;SMALSUČIAI;8556218971;Taip;16;0;2;18
1476;Drevinukas;SMALSUČIAI;9016985238;Taip;0;2;0;2
1477;Drevinukas;SMALSUČIAI;2929598743;Taip;0;5;0;5
1478;Drevinukas;SMALSUČIAI;6373230526;Taip;10;0;0;10
1479;Drevinukas;SMALSUČIAI;4404254932;Taip;6;0;3;9
1480;Drevinukas;SMALSUČIAI;5620887702;Taip;0;1;0;1
1481;Drevinukas;SMALSUČIAI;2281463885;Ne;2;1;2;5
1482;Drevinukas;SMALSUČIAI;7218201733;Taip;5;0;1;6
1483;Drevinukas;ŽVIRBLIUKAI;5348609358;Taip;3;0;0;3
1484;Drevinukas;ŽVIRBLIUKAI;2312241894;Taip;6;0;2;8
1485;Drevinukas;ŽVIRBLIUKAI;5394143000;Taip;0;7;0;7
1486;Drevinukas;ŽVIRBLIUKAI;3871506691;Taip;3;2;0;5
1487;Drevinukas;ŽVIRBLIUKAI;6914111231;Taip;3;2;0;5
1488;Drevinukas;ŽVIRBLIUKAI;3377957769;Taip;6;1;5;12
1489;Drevinukas;ŽVIRBLIUKAI;3779983775;Taip;5;0;0;5
1490;Drevinukas;ŽVIRBLIUKAI;1343431478;Taip;0;0;4;4
1491;Drevinukas;ŽVIRBLIUKAI;1829421385;Taip;5;0;0;5
1492;Drevinukas;ŽVIRBLIUKAI;8262224710;Taip;6;0;0;6
1493;Drevinukas;ŽVIRBLIUKAI;2935175014;Taip;0;1;9;10
1494;Drevinukas;ŽVIRBLIUKAI;5754055310;Taip;0;0;6;6
1495;Drevinukas;ŽVIRBLIUKAI;3046196006;Taip;0;4;0;4
1496;Drevinukas;ŽVIRBLIUKAI;4260123123;Taip;11;0;0;11
1497;Drugelis;NYKŠTUKŲ;86452076401;Taip;3;0;0;3
1498;Drugelis;NYKŠTUKŲ;22204482690;Taip;3;0;0;3
1499;Drugelis;NYKŠTUKŲ;18603741278;Taip;0;1;0;1
1500;Drugelis;NYKŠTUKŲ;9263055716;Taip;3;0;2;5
1501;Drugelis;NYKŠTUKŲ;91204781931;Taip;0;2;1;3
1502;Drugelis;NYKŠTUKŲ;53978775822;Taip;0;2;2;4
1503;Drugelis;NYKŠTUKŲ;90197519022;Taip;0;1;0;1
1504;Drugelis;NYKŠTUKŲ;67195315804;Taip;0;2;0;2
1505;Drugelis;NYKŠTUKŲ;2593184133;Taip;4;2;0;6
1506;Drugelis;NYKŠTUKŲ;14998254512;Taip;2;1;0;3
1507;Drugelis;NYKŠTUKŲ;62834741685;Taip;4;1;0;5
1508;Drugelis;NYKŠTUKŲ;69762633803;Taip;0;1;0;1
1509;Drugelis;NYKŠTUKŲ;16524288155;Taip;6;3;0;9
1510;Drugelis;SMALSUČIŲ;3479833265;Taip;5;2;3;10
1511;Drugelis;SMALSUČIŲ;1217635751;Taip;3;0;2;5
1512;Drugelis;SMALSUČIŲ;3202149560;Taip;0;1;0;1
1513;Drugelis;SMALSUČIŲ;27569805506;Taip;0;3;0;3
1514;Drugelis;SMALSUČIŲ;1856912386;Ne;0;2;3;5
1515;Drugelis;SMALSUČIŲ;1576853049;Taip;12;0;1;13
1516;Drugelis;SMALSUČIŲ;1901608445;Taip;5;2;2;9
1517;Drugelis;SMALSUČIŲ;3096906506;Taip;0;9;0;9
1518;Drugelis;SMALSUČIŲ;7406396614;Taip;0;2;0;2
1519;Drugelis;SMALSUČIŲ;1255315664;Taip;7;0;0;7
1520;Drugelis;SMALSUČIŲ;1843605624;Taip;0;2;0;2
1521;Drugelis;SMALSUČIŲ;1506988472;Taip;0;1;0;1
1522;Drugelis;SMALSUČIŲ;1991420008;Taip;0;1;0;1
1523;Drugelis;SMALSUČIŲ;1421438458;Ne;0;3;0;3
1524;Drugelis;SMALSUČIŲ;53874036107;Taip;0;1;0;1
1525;Drugelis;SMALSUČIŲ;1961898730;Taip;3;1;0;4
1526;Drugelis;SMALSUČIŲ;4788423265;Taip;0;0;15;15
1527;Drugelis;SMALSUČIŲ;1541276266;Taip;0;1;0;1
1528;Drugelis;SMALSUČIŲ;5954059321;Taip;9;2;0;11
1529;Drugelis;SMALSUČIŲ;1888002607;Taip;0;2;2;4
1530;Drugelis;MUMINUKŲ;51963723965;Taip;0;2;0;2
1531;Drugelis;MUMINUKŲ;89109375373;Taip;0;2;0;2
1532;Drugelis;MUMINUKŲ;10841811704;Taip;2;9;0;11
1533;Drugelis;MUMINUKŲ;55662263930;Taip;2;9;0;11
1534;Drugelis;MUMINUKŲ;63076864410;Taip;0;1;0;1
1535;Drugelis;MUMINUKŲ;44627668646;Taip;0;22;0;22
1536;Drugelis;MUMINUKŲ;78311619943;Taip;0;1;0;1
1537;Drugelis;MUMINUKŲ;35386244403;Taip;0;8;0;8
1538;Drugelis;MUMINUKŲ;88073976875;Ne;0;9;0;9
1539;Drugelis;MUMINUKŲ;85362607749;Taip;0;3;0;3
1540;Drugelis;MUMINUKŲ;25002448923;Taip;0;2;0;2
1541;Drugelis;MUMINUKŲ;55339135155;Ne;0;10;0;10
1542;Drugelis;MUMINUKŲ;82465836364;Taip;0;2;0;2
1543;Drugelis;MUMINUKŲ;63173368598;Taip;0;2;0;2
1544;Drugelis;MUMINUKŲ;1761079726;Taip;9;2;0;11
1545;Drugelis;MUMINUKŲ;29713921940;Taip;0;5;1;6
1546;Drugelis;MUMINUKŲ;82441447907;Taip;15;0;0;15
1547;Drugelis;MUMINUKŲ;70288969200;Taip;0;1;0;1
1548;Drugelis;MUMINUKŲ;72147158912;Taip;7;2;0;9
1549;Drugelis;PŪKUOTUKAI;49035429728;Taip;0;2;2;4
1550;Drugelis;PŪKUOTUKAI;3156382280;Taip;0;2;2;4
1551;Drugelis;PŪKUOTUKAI;59819126556;Taip;12;0;1;13
1552;Drugelis;PŪKUOTUKAI;4989130624;Taip;14;0;0;14
1553;Drugelis;PŪKUOTUKAI;1657445173;Taip;7;10;0;17
1554;Drugelis;PŪKUOTUKAI;57217727711;Taip;0;10;0;10
1555;Drugelis;PŪKUOTUKAI;1240607928;Taip;0;4;0;4
1556;Drugelis;PŪKUOTUKAI;1162058481;Taip;0;1;0;1
1557;Drugelis;PŪKUOTUKAI;3161396176;Taip;0;7;0;7
1558;Drugelis;PŪKUOTUKAI;5649225445;Taip;0;7;0;7
1559;Drugelis;PŪKUOTUKAI;1060282804;Taip;0;7;0;7
1560;Drugelis;PŪKUOTUKAI;1667056936;Taip;1;0;4;5
1561;Drugelis;PŪKUOTUKAI;63777226415;Taip;7;1;0;8
1562;Drugelis;PŪKUOTUKAI;1651512363;Taip;0;1;0;1
1563;Drugelis;PŪKUOTUKAI;1546655542;Taip;0;3;0;3
1564;Drugelis;SPINDULIUKAI;6594452094;Taip;0;22;0;22
1565;Drugelis;SPINDULIUKAI;5122256823;Taip;4;0;0;4
1566;Drugelis;SPINDULIUKAI;7609530453;Taip;6;0;1;7
1567;Drugelis;SPINDULIUKAI;1142209285;Taip;5;2;0;7
1568;Drugelis;SPINDULIUKAI;4158475365;Ne;12;0;0;12
1569;Drugelis;SPINDULIUKAI;9510744779;Taip;0;2;2;4
1570;Drugelis;SPINDULIUKAI;8717445483;Taip;18;0;0;18
1571;Drugelis;SPINDULIUKAI;9836193857;Taip;5;1;0;6
1572;Drugelis;SPINDULIUKAI;7477547789;Taip;5;4;0;9
1573;Drugelis;SPINDULIUKAI;4825232236;Taip;0;0;4;4
1574;Drugelis;SPINDULIUKAI;5515894973;Taip;2;1;0;3
1575;Drugelis;SPINDULIUKAI;7447519502;Taip;1;0;0;1
1576;Drugelis;SPINDULIUKAI;7590759136;Taip;10;1;0;11
1577;Drugelis;SPINDULIUKAI;5692743298;Taip;1;0;0;1
1578;Drugelis;KIŠKUČIAI;9316073597;Taip;0;1;0;1
1579;Drugelis;KIŠKUČIAI;3061896520;Taip;0;2;0;2
1580;Drugelis;KIŠKUČIAI;8070030439;Taip;0;2;0;2
1581;Drugelis;KIŠKUČIAI;9612696781;Taip;7;0;0;7
1582;Drugelis;KIŠKUČIAI;5691833295;Taip;0;0;11;11
1583;Drugelis;KIŠKUČIAI;3037496936;Taip;0;0;11;11
1584;Drugelis;KIŠKUČIAI;4927896706;Ne;0;7;0;7
1585;Drugelis;KIŠKUČIAI;5902687211;Taip;4;0;2;6
1586;Drugelis;KIŠKUČIAI;1785724340;Taip;0;9;0;9
1587;Drugelis;KIŠKUČIAI;9345527734;Taip;12;0;0;12
1588;Drugelis;KIŠKUČIAI;6038184222;Taip;8;1;0;9
1589;Drugelis;KIŠKUČIAI;6321332888;Taip;10;7;0;17
1590;Drugelis;KIŠKUČIAI;6452921695;Taip;13;0;0;13
1591;Drugelis;KIŠKUČIAI;6632884258;Taip;0;7;2;9
1592;Drugelis;KIŠKUČIAI;8591548746;Taip;9;0;0;9
1593;"Du gaideliai";Uodelių;7084763712;Taip;5;0;1;6
1594;"Du gaideliai";Uodelių;1758546983;Taip;6;0;4;10
1595;"Du gaideliai";Uodelių;94639433266;Taip;2;0;0;2
1596;"Du gaideliai";Uodelių;1500684755;Taip;17;0;0;17
1597;"Du gaideliai";Uodelių;4387568448;Taip;5;0;3;8
1598;"Du gaideliai";Uodelių;6750787450;Taip;0;2;0;2
1599;"Du gaideliai";Uodelių;2601122166;Taip;20;2;0;22
1600;"Du gaideliai";Uodelių;5430986033;Taip;0;2;0;2
1601;"Du gaideliai";Uodelių;1876870081;Taip;0;13;0;13
1602;"Du gaideliai";Uodelių;1557413692;Taip;0;12;0;12
1603;"Du gaideliai";Uodelių;3560637865;Taip;6;11;0;17
1604;"Du gaideliai";Uodelių;7783203480;Taip;0;10;0;10
1605;"Du gaideliai";Uodelių;9324740716;Ne;7;0;1;8
1606;"Du gaideliai";Uodelių;1211005513;Taip;5;0;0;5
1607;"Du gaideliai";Uodelių;1549762923;Ne;5;8;0;13
1608;"Du gaideliai";Uodelių;2159833613;Taip;0;17;0;17
1609;"Du gaideliai";Uodelių;6203383711;Taip;8;0;0;8
1610;"Du gaideliai";OŽIUKŲ;25738622801;Taip;7;0;0;7
1611;"Du gaideliai";OŽIUKŲ;50087080642;Taip;7;0;0;7
1612;"Du gaideliai";OŽIUKŲ;91470338843;Taip;1;4;0;5
1613;"Du gaideliai";OŽIUKŲ;1479672134;Taip;8;0;0;8
1614;"Du gaideliai";OŽIUKŲ;88801178853;Taip;0;0;13;13
1615;"Du gaideliai";OŽIUKŲ;60934378499;Taip;0;1;0;1
1616;"Du gaideliai";OŽIUKŲ;1128234653;Taip;10;1;0;11
1617;"Du gaideliai";OŽIUKŲ;14681393632;Taip;0;4;0;4
1618;"Du gaideliai";OŽIUKŲ;13384312035;Taip;8;0;0;8
1619;"Du gaideliai";OŽIUKŲ;30562958921;Ne;0;0;2;2
1620;"Du gaideliai";OŽIUKŲ;1291620608;Taip;9;2;0;11
1621;"Du gaideliai";OŽIUKŲ;1628346439;Taip;17;2;0;19
1622;"Du gaideliai";OŽIUKŲ;1512578437;Ne;0;1;0;1
1623;"Du gaideliai";OŽIUKŲ;1261678548;Taip;0;11;0;11
1624;"Du gaideliai";OŽIUKŲ;1791530261;Taip;0;14;0;14
1625;"Du gaideliai";OŽIUKŲ;1906486044;Taip;4;2;0;6
1626;"Du gaideliai";OŽIUKŲ;41922349110;Taip;2;5;0;7
1627;"Du gaideliai";OŽIUKŲ;6161829923;Taip;0;17;0;17
1628;"Du gaideliai";OŽIUKŲ;85962801220;Taip;0;1;0;1
1629;"Du gaideliai";OŽIUKŲ;1923863232;Taip;0;6;0;6
1630;"Du gaideliai";Vištyčių;1888402861;Taip;0;6;0;6
1631;"Du gaideliai";Vištyčių;31139048776;Taip;0;12;0;12
1632;"Du gaideliai";Vištyčių;25898248315;Taip;0;8;0;8
1633;"Du gaideliai";Vištyčių;56826255179;Ne;0;4;0;4
1634;"Du gaideliai";Vištyčių;10516676378;Taip;0;2;0;2
1635;"Du gaideliai";Vištyčių;11621795110;Taip;0;5;0;5
1636;"Du gaideliai";Vištyčių;59558745879;Ne;14;0;0;14
1637;"Du gaideliai";Vištyčių;14599820571;Taip;6;1;0;7
1638;"Du gaideliai";Vištyčių;8087660692;Taip;20;0;0;20
1639;"Du gaideliai";Vištyčių;46193129936;Taip;9;1;0;10
1640;"Du gaideliai";Vištyčių;82205925738;Taip;5;0;0;5
1641;"Du gaideliai";Vištyčių;9173656753;Ne;0;13;0;13
1642;"Du gaideliai";Vištyčių;1850550387;Taip;0;2;0;2
1643;"Du gaideliai";Vištyčių;1258859998;Taip;0;1;0;1
1644;"Du gaideliai";Vištyčių;2157315097;Taip;0;10;0;10
1645;"Du gaideliai";Vištyčių;1823681047;Taip;0;10;0;10
1646;"Du gaideliai";GAIDŽIUKŲ;32735548453;Taip;0;0;1;1
1647;"Du gaideliai";GAIDŽIUKŲ;13544785168;Taip;10;0;0;10
1648;"Du gaideliai";GAIDŽIUKŲ;98790674632;Taip;0;4;0;4
1649;"Du gaideliai";GAIDŽIUKŲ;67678569738;Taip;0;0;13;13
1650;"Du gaideliai";GAIDŽIUKŲ;10671107948;Taip;0;3;0;3
1651;"Du gaideliai";GAIDŽIUKŲ;79968702371;Taip;0;0;1;1
1652;"Du gaideliai";GAIDŽIUKŲ;24753427184;Taip;0;6;0;6
1653;"Du gaideliai";GAIDŽIUKŲ;63476686143;Ne;0;0;3;3
1654;"Du gaideliai";GAIDŽIUKŲ;65144471076;Taip;0;9;0;9
1655;"Du gaideliai";GAIDŽIUKŲ;83990613379;Taip;2;1;0;3
1656;"Du gaideliai";GAIDŽIUKŲ;74161177222;Taip;2;1;0;3
1657;"Du gaideliai";GAIDŽIUKŲ;97364620242;Ne;7;9;0;16
1658;"Du gaideliai";GAIDŽIUKŲ;8471369515;Ne;0;3;0;3
1659;"Du gaideliai";GAIDŽIUKŲ;71411267197;Taip;0;0;3;3
1660;"Du gaideliai";GAIDŽIUKŲ;8643242715;Taip;0;8;0;8
1661;"Du gaideliai";GAIDŽIUKŲ;87984135142;Taip;7;2;0;9
1662;"Du gaideliai";GAIDŽIUKŲ;40776415914;Taip;0;1;0;1
1663;"Du gaideliai";Musyčių;4144269068;Taip;0;8;0;8
1664;"Du gaideliai";Musyčių;3370029981;Taip;0;3;0;3
1665;"Du gaideliai";Musyčių;5103483956;Taip;0;10;0;10
1666;"Du gaideliai";Musyčių;4378924981;Taip;0;1;0;1
1667;"Du gaideliai";Musyčių;7373413569;Taip;0;4;0;4
1668;"Du gaideliai";Musyčių;6783206132;Taip;13;0;0;13
1669;"Du gaideliai";Musyčių;3507387826;Taip;5;10;0;15
1670;"Du gaideliai";Musyčių;1785976627;Taip;1;1;3;5
1671;"Du gaideliai";Musyčių;5894974508;Taip;0;2;0;2
1672;"Du gaideliai";Musyčių;1135098595;Taip;7;7;0;14
1673;"Du gaideliai";Musyčių;5652662610;Taip;6;0;0;6
1674;"Du gaideliai";Musyčių;6348951959;Taip;5;0;1;6
1675;"Du gaideliai";Musyčių;3854355215;Taip;0;11;0;11
1676;"Du gaideliai";Musyčių;3849899284;Taip;4;2;1;7
1677;"Du gaideliai";Musyčių;2262425557;Taip;8;0;4;12
1678;"Du gaideliai";MALŪNO;6247706405;Taip;0;2;0;2
1679;"Du gaideliai";MALŪNO;6870356241;Taip;7;2;0;9
1680;"Du gaideliai";MALŪNO;7033276798;Taip;13;1;0;14
1681;"Du gaideliai";MALŪNO;6053941133;Taip;10;0;0;10
1682;"Du gaideliai";MALŪNO;1268479215;Taip;16;0;0;16
1683;"Du gaideliai";MALŪNO;5728374219;Taip;13;0;0;13
1684;"Du gaideliai";MALŪNO;6015360076;Taip;0;11;0;11
1685;"Du gaideliai";MALŪNO;7726490359;Taip;17;1;0;18
1686;"Du gaideliai";MALŪNO;5998344519;Taip;13;0;3;16
1687;"Du gaideliai";MALŪNO;8043896286;Taip;7;0;1;8
1688;"Du gaideliai";MALŪNO;2240947701;Taip;8;0;0;8
1689;"Du gaideliai";MALŪNO;6120647567;Taip;10;4;0;14
1690;"Du gaideliai";MALŪNO;6522707709;Taip;12;0;1;13
1691;"Du gaideliai";MALŪNO;4798503931;Taip;9;0;0;9
1692;"Du gaideliai";MALŪNO;3247101840;Taip;8;0;2;10
1693;Eglutė;RAMUNĖ;58949721375;Taip;0;2;0;2
1694;Eglutė;RAMUNĖ;90728032521;Taip;0;0;4;4
1695;Eglutė;RAMUNĖ;48107118284;Taip;0;4;3;7
1696;Eglutė;RAMUNĖ;18336619115;Taip;5;0;1;6
1697;Eglutė;RAMUNĖ;73455764001;Taip;0;1;0;1
1698;Eglutė;RAMUNĖ;99937268711;Taip;5;0;0;5
1699;Eglutė;RAMUNĖ;42898142937;Taip;0;7;0;7
1700;Eglutė;RAMUNĖ;9492889889;Taip;0;2;0;2
1701;Eglutė;RAMUNĖ;45851193886;Taip;0;3;0;3
1702;Eglutė;RAMUNĖ;87045022282;Taip;0;0;11;11
1703;Eglutė;RAMUNĖ;73442251672;Taip;0;2;4;6
1704;Eglutė;RAMUNĖ;26590185216;Ne;0;1;0;1
1705;Eglutė;RAMUNĖ;60500002903;Taip;0;3;1;4
1706;Eglutė;RAMUNĖ;59228063911;Taip;0;3;2;5
1707;Eglutė;RAMUNĖ;89786711506;Taip;0;0;1;1
1708;Eglutė;RAMUNĖ;49380660477;Ne;0;4;0;4
1709;Eglutė;RAMUNĖ;65706339440;Taip;0;1;0;1
1710;Eglutė;PELĖDŽIUKAI;72590410220;Ne;0;1;0;1
1711;Eglutė;PELĖDŽIUKAI;49145620813;Taip;0;0;1;1
1712;Eglutė;PELĖDŽIUKAI;1668758645;Taip;0;0;5;5
1713;Eglutė;PELĖDŽIUKAI;5625034056;Taip;0;0;5;5
1714;Eglutė;PELĖDŽIUKAI;85774102049;Taip;0;0;1;1
1715;Eglutė;PELĖDŽIUKAI;46538092543;Ne;0;0;2;2
1716;Eglutė;PELĖDŽIUKAI;1132082785;Taip;0;0;4;4
1717;Eglutė;PELĖDŽIUKAI;2092342476;Taip;10;3;0;13
1718;Eglutė;PELĖDŽIUKAI;70857129908;Taip;0;0;6;6
1719;Eglutė;PELĖDŽIUKAI;77689530230;Taip;0;9;0;9
1720;Eglutė;PELĖDŽIUKAI;584301494;Taip;8;0;0;8
1721;Eglutė;PELĖDŽIUKAI;14576118725;Ne;0;0;4;4
1722;Eglutė;PELĖDŽIUKAI;72428098332;Ne;0;0;6;6
1723;Eglutė;PELĖDŽIUKAI;66053397092;Taip;0;0;13;13
1724;Eglutė;PELĖDŽIUKAI;41303920332;Ne;0;0;4;4
1725;Eglutė;PELĖDŽIUKAI;4857192691;Ne;0;0;3;3
1726;Eglutė;PELĖDŽIUKAI;1909791840;Taip;0;0;6;6
1727;Eglutė;PELĖDŽIUKAI;2045454657;Taip;0;0;6;6
1728;Eglutė;PELĖDŽIUKAI;50552087321;Ne;0;7;3;10
1729;Eglutė;PELĖDŽIUKAI;87481211277;Taip;5;0;6;11
1730;Eglutė;PELĖDŽIUKAI;74449042391;Taip;0;7;1;8
1731;Eglutė;PELĖDŽIUKAI;1553160829;Taip;0;12;2;14
1732;Eglutė;PELĖDŽIUKAI;6248194593;Taip;0;3;0;3
1733;Eglutė;PELĖDŽIUKAI;90430489503;Taip;0;4;0;4
1734;Eglutė;KODĖLČIUKAI;85964105325;Taip;2;1;3;6
1735;Eglutė;KODĖLČIUKAI;6403410879;Taip;0;7;2;9
1736;Eglutė;KODĖLČIUKAI;1939447097;Ne;0;1;2;3
1737;Eglutė;KODĖLČIUKAI;1881111005;Ne;0;1;2;3
1738;Eglutė;KODĖLČIUKAI;1100326735;Ne;5;8;0;13
1739;Eglutė;KODĖLČIUKAI;1398611395;Taip;5;0;0;5
1740;Eglutė;KODĖLČIUKAI;2041825568;Taip;0;1;0;1
1741;Eglutė;KODĖLČIUKAI;1814357743;Taip;10;0;12;22
1742;Eglutė;KODĖLČIUKAI;1356175751;Taip;0;0;3;3
1743;Eglutė;KODĖLČIUKAI;2147042152;Taip;0;0;2;2
1744;Eglutė;KODĖLČIUKAI;78489473446;Taip;0;1;0;1
1745;Eglutė;KODĖLČIUKAI;63268716266;Taip;0;0;1;1
1746;Eglutė;KODĖLČIUKAI;2112417439;Ne;0;0;3;3
1747;Eglutė;KODĖLČIUKAI;64360778537;Taip;10;0;1;11
1748;Eglutė;KODĖLČIUKAI;1426211949;Ne;0;3;0;3
1749;Eglutė;KODĖLČIUKAI;1120848949;Taip;0;8;0;8
1750;Eglutė;KODĖLČIUKAI;1882915662;Ne;0;1;1;2
1751;Eglutė;KODĖLČIUKAI;1747424609;Taip;0;4;0;4
1752;Eglutė;KODĖLČIUKAI;1485521357;Taip;0;1;0;1
1753;Eglutė;KODĖLČIUKAI;1227167233;Taip;0;2;0;2
1754;Eglutė;KODĖLČIUKAI;90878878800;Taip;0;2;0;2
1755;Eglutė;KODĖLČIUKAI;7132999520;Taip;0;8;0;8
1756;Eglutė;OBUOLIUKAI;7354260503;Taip;0;2;0;2
1757;Eglutė;OBUOLIUKAI;5731355126;Taip;6;0;0;6
1758;Eglutė;OBUOLIUKAI;7629424045;Taip;0;0;1;1
1759;Eglutė;OBUOLIUKAI;9527732584;Taip;0;0;5;5
1760;Eglutė;OBUOLIUKAI;1122308715;Taip;0;0;1;1
1761;Eglutė;OBUOLIUKAI;9771473322;Ne;15;0;5;20
1762;Eglutė;OBUOLIUKAI;7307564177;Taip;0;0;4;4
1763;Eglutė;OBUOLIUKAI;3856651647;Taip;12;0;0;12
1764;Eglutė;OBUOLIUKAI;1265463853;Taip;0;0;14;14
1765;Eglutė;OBUOLIUKAI;8364693548;Taip;0;3;0;3
1766;Eglutė;OBUOLIUKAI;6891834971;Ne;0;10;0;10
1767;Eglutė;OBUOLIUKAI;1712276393;Ne;0;0;2;2
1768;Eglutė;OBUOLIUKAI;8523618773;Taip;0;0;6;6
1769;Eglutė;OBUOLIUKAI;9554672460;Ne;0;0;1;1
1770;Eglutė;OBUOLIUKAI;1321901982;Taip;0;12;0;12
1771;Eglutė;OBUOLIUKAI;8421062747;Taip;0;5;0;5
1772;Eglutė;OBUOLIUKAI;3775081619;Taip;0;7;0;7
1773;Eglutė;OBUOLIUKAI;9992438336;Taip;2;0;13;15
1774;Eglutė;KAŠTONAS;1565149756;Taip;6;0;0;6
1775;Eglutė;KAŠTONAS;7506194777;Taip;3;10;0;13
1776;Eglutė;KAŠTONAS;92489023262;Taip;0;0;2;2
1777;Eglutė;KAŠTONAS;55334393780;Taip;0;4;0;4
1778;Eglutė;KAŠTONAS;40880035310;Taip;0;2;0;2
1779;Eglutė;KAŠTONAS;5214574745;Taip;0;3;0;3
1780;Eglutė;KAŠTONAS;82988135134;Taip;1;2;1;4
1781;Eglutė;KAŠTONAS;93427464717;Taip;5;0;0;5
1782;Eglutė;KAŠTONAS;83194451903;Taip;0;2;0;2
1783;Eglutė;KAŠTONAS;96041043843;Taip;0;8;0;8
1784;Eglutė;KAŠTONAS;37576322876;Taip;0;2;0;2
1785;Eglutė;KAŠTONAS;95597529215;Taip;0;0;5;5
1786;Eglutė;KAŠTONAS;3997033;Ne;8;10;0;18
1787;Eglutė;KAŠTONAS;83912035659;Taip;0;5;0;5
1788;Eglutė;KAŠTONAS;44421461989;Taip;0;5;0;5
1789;Eglutė;KAŠTONAS;96140363702;Taip;0;2;0;2
1790;Eglutė;KAŠTONAS;40325923876;Taip;0;5;0;5
1791;Eglutė;KAŠTONAS;91896736509;Taip;0;1;0;1
1792;Eglutė;KAŠTONAS;50471207849;Taip;6;2;0;8
1793;Eglutė;KAŠTONAS;6542189095;Ne;0;7;0;7
1794;Eglutė;KAŠTONAS;75229333120;Ne;0;2;1;3
1795;Eglutė;KAŠTONAS;10122792768;Taip;5;1;0;6
1796;Eglutė;KAŠTONAS;1905376778;Taip;2;7;0;9
1797;Eglutė;KAŠTONAS;77296894224;Taip;0;0;3;3
1798;Eglutė;KAŠTONAS;2029176205;Taip;0;12;3;15
1799;Eglutė;KAŠTONAS;69979676570;Taip;0;2;0;2
1800;Eglutė;EŽIUKAI;2808806070;Taip;0;0;2;2
1801;Eglutė;EŽIUKAI;58699109274;Taip;0;0;1;1
1802;Eglutė;EŽIUKAI;15852252535;Taip;0;1;0;1
1803;Eglutė;EŽIUKAI;20502611523;Taip;5;0;2;7
1804;Eglutė;EŽIUKAI;27038409488;Taip;0;0;2;2
1805;Eglutė;EŽIUKAI;58521679969;Ne;0;12;0;12
1806;Eglutė;EŽIUKAI;16522997461;Ne;0;0;3;3
1807;Eglutė;EŽIUKAI;6066756372;Taip;0;0;1;1
1808;Eglutė;EŽIUKAI;9976231692;Taip;0;0;1;1
1809;Eglutė;EŽIUKAI;59146493060;Taip;4;0;0;4
1810;Eglutė;EŽIUKAI;83443573014;Ne;0;0;2;2
1811;Eglutė;EŽIUKAI;33254488808;Ne;0;5;0;5
1812;Eglutė;EŽIUKAI;93769554398;Taip;0;3;0;3
1813;Eglutė;EŽIUKAI;619528177;Ne;0;4;0;4
1814;Eglutė;EŽIUKAI;39537089288;Taip;0;0;2;2
1815;Eglutė;EŽIUKAI;84721839602;Taip;3;0;5;8
1816;Eglutė;EŽIUKAI;9318501404;Taip;0;3;0;3
1817;Eglutė;EŽIUKAI;8144571590;Taip;5;0;0;5
1818;Eglutė;EŽIUKAI;6570561861;Taip;0;0;1;1
1819;Eglutė;EŽIUKAI;8213137021;Taip;0;0;1;1
1820;Eglutė;EŽIUKAI;3642438432;Ne;0;0;9;9
1821;Eglutė;GILĖ;1308252968;Taip;5;0;0;5
1822;Eglutė;GILĖ;2053316445;Taip;4;0;9;13
1823;Eglutė;GILĖ;1954232966;Taip;5;0;0;5
1824;Eglutė;GILĖ;62257831469;Taip;0;1;1;2
1825;Eglutė;GILĖ;18202528233;Taip;11;5;0;16
1826;Eglutė;GILĖ;60257242941;Taip;0;5;0;5
1827;Eglutė;GILĖ;1125331552;Ne;0;0;4;4
1828;Eglutė;GILĖ;82910530417;Taip;0;16;0;16
1829;Eglutė;GILĖ;7035023835;Ne;0;0;7;7
1830;Eglutė;GILĖ;51884188642;Taip;0;0;2;2
1831;Eglutė;GILĖ;67038463806;Taip;0;9;0;9
1832;Eglutė;GILĖ;61256135116;Taip;5;2;0;7
1833;Eglutė;GILĖ;2138306323;Taip;0;0;4;4
1834;Eglutė;GILĖ;65593915933;Ne;0;10;0;10
1835;Eglutė;GILĖ;15019818974;Taip;0;5;0;5
1836;Eglutė;GILĖ;9169758481;Ne;0;0;1;1
1837;Eglutė;GILĖ;92526575353;Ne;5;0;1;6
1838;Eglutė;GILĖ;24785196945;Taip;9;0;0;9
1839;Eglutė;GILĖ;95274378693;Taip;0;0;2;2
1840;Eglutė;GILĖ;3725462135;Taip;0;3;0;3
1841;Eglutė;GILĖ;6323002362;Taip;0;0;2;2
1842;Eglutė;GILĖ;26716650724;Taip;6;2;0;8
1843;Eglutė;SAULUTĖ;9369442479;Taip;0;0;3;3
1844;Eglutė;SAULUTĖ;72153018644;Taip;0;6;0;6
1845;Eglutė;SAULUTĖ;2395506996;Ne;0;0;7;7
1846;Eglutė;SAULUTĖ;1864153865;Taip;0;0;2;2
1847;Eglutė;SAULUTĖ;49268076669;Taip;0;0;5;5
1848;Eglutė;SAULUTĖ;20582720349;Taip;0;0;1;1
1849;Eglutė;SAULUTĖ;7744905325;Taip;7;4;0;11
1850;Eglutė;SAULUTĖ;1347527598;Taip;0;0;1;1
1851;Eglutė;SAULUTĖ;1477651468;Taip;0;6;0;6
1852;Eglutė;SAULUTĖ;1533889475;Taip;0;0;1;1
1853;Eglutė;SAULUTĖ;2109443590;Taip;5;0;7;12
1854;Eglutė;SAULUTĖ;1272418234;Taip;0;0;2;2
1855;Eglutė;SAULUTĖ;1044133613;Taip;0;0;1;1
1856;Eglutė;SAULUTĖ;1206623876;Taip;4;6;0;10
1857;Eglutė;SAULUTĖ;1180482309;Taip;0;0;1;1
1858;Eglutė;SAULUTĖ;9506180285;Taip;0;2;1;3
1859;Eglutė;SAULUTĖ;4248739383;Taip;0;5;0;5
1860;Eglutė;SAULUTĖ;2087083722;Taip;9;0;1;10
1861;Eglutė;SAULUTĖ;1859052313;Taip;0;7;1;8
1862;Eglutė;ŠARKELĖ;2082716398;Taip;0;0;2;2
1863;Eglutė;ŠARKELĖ;1324622835;Taip;22;0;0;22
1864;Eglutė;ŠARKELĖ;9173875647;Taip;0;12;0;12
1865;Eglutė;ŠARKELĖ;6518497374;Ne;0;10;0;10
1866;Eglutė;ŠARKELĖ;3275796441;Taip;0;3;0;3
1867;Eglutė;ŠARKELĖ;1209962222;Taip;3;0;0;3
1868;Eglutė;ŠARKELĖ;3203786388;Taip;0;0;2;2
1869;Eglutė;ŠARKELĖ;3616979217;Taip;0;21;0;21
1870;Eglutė;ŠARKELĖ;7148210944;Ne;0;7;0;7
1871;Eglutė;ŠARKELĖ;9488150450;Taip;3;1;0;4
1872;Eglutė;ŠARKELĖ;3393414294;Taip;5;0;0;5
1873;Eglutė;ŠARKELĖ;7823828202;Taip;20;0;0;20
1874;Eglutė;ŠARKELĖ;2638807860;Taip;9;0;0;9
1875;Eglutė;ŠARKELĖ;6835296034;Taip;6;0;0;6
1876;Eglutė;ŠARKELĖ;9950953029;Taip;11;0;0;11
1877;Eglutė;NYKŠTUKAI;5943856319;Taip;0;0;2;2
1878;Eglutė;NYKŠTUKAI;9402686801;Taip;0;19;0;19
1879;Eglutė;NYKŠTUKAI;2783338563;Taip;0;7;0;7
1880;Eglutė;NYKŠTUKAI;2252971349;Taip;0;15;1;16
1881;Eglutė;NYKŠTUKAI;6544877723;Ne;0;13;0;13
1882;Eglutė;NYKŠTUKAI;1050313582;Ne;22;0;0;22
1883;Eglutė;NYKŠTUKAI;1534556744;Taip;6;0;0;6
1884;Eglutė;NYKŠTUKAI;6093932811;Taip;3;4;5;12
1885;Eglutė;NYKŠTUKAI;3473388722;Taip;0;0;1;1
1886;Eglutė;NYKŠTUKAI;4489150480;Taip;0;0;14;14
1887;Eglutė;NYKŠTUKAI;3006381069;Taip;0;0;2;2
1888;Eglutė;NYKŠTUKAI;2597978713;Taip;0;4;1;5
1889;Eglutė;NYKŠTUKAI;4230594049;Taip;0;13;0;13
1890;Eglutė;NYKŠTUKAI;5505398901;Taip;0;0;8;8
1891;Eglutė;NYKŠTUKAI;3985929379;Taip;1;0;0;1
1892;Eglutė;NYKŠTUKAI;3483007385;Ne;0;0;13;13
1893;Eglutė;ŽIRNIUKAI;3390360525;Taip;0;1;0;1
1894;Eglutė;ŽIRNIUKAI;1759383841;Taip;0;3;0;3
1895;Eglutė;ŽIRNIUKAI;4348313801;Taip;0;0;3;3
1896;Eglutė;ŽIRNIUKAI;9967488317;Taip;3;1;0;4
1897;Eglutė;ŽIRNIUKAI;7758643349;Taip;10;0;0;10
1898;Eglutė;ŽIRNIUKAI;5924994736;Taip;0;10;6;16
1899;Eglutė;ŽIRNIUKAI;3883122650;Taip;6;1;0;7
1900;Eglutė;ŽIRNIUKAI;1550045866;Taip;14;0;0;14
1901;Eglutė;ŽIRNIUKAI;3605053253;Taip;2;0;19;21
1902;Eglutė;ŽIRNIUKAI;7404631298;Taip;15;0;3;18
1903;Eglutė;ŽIRNIUKAI;7446423510;Taip;0;22;0;22
1904;Eglutė;ŽIRNIUKAI;6362265057;Taip;0;1;2;3
1905;Eglutė;ŽIRNIUKAI;1842517164;Taip;5;0;9;14
1906;Eglutė;ŽIRNIUKAI;2240154775;Taip;9;0;0;9
1907;Eglutė;ŽIRNIUKAI;7047262367;Taip;0;11;0;11
1908;Eglutė;ŽIRNIUKAI;4176597208;Taip;0;1;3;4
1909;Eglutė;ŽIRNIUKAI;3584247594;Taip;0;17;0;17
1910;Eglutė;ŽIRNIUKAI;8797889347;Taip;3;0;0;3
1911;Eglutė;ŽIRNIUKAI;1835565594;Taip;17;0;0;17
1912;Eglutė;ŽIRNIUKAI;9728550000;Taip;8;0;0;8
1913;Eglutė;BORUŽIUKAI;8943684351;Taip;10;0;0;10
1914;Eglutė;BORUŽIUKAI;6597261061;Taip;0;3;0;3
1915;Eglutė;BORUŽIUKAI;1932785408;Taip;0;0;1;1
1916;Eglutė;BORUŽIUKAI;4490295754;Taip;0;2;0;2
1917;Eglutė;BORUŽIUKAI;6328900251;Taip;0;1;0;1
1918;Eglutė;BORUŽIUKAI;7859815752;Taip;0;16;0;16
1919;Eglutė;BORUŽIUKAI;1422631723;Ne;7;13;0;20
1920;Eglutė;BORUŽIUKAI;1531942494;Taip;0;2;1;3
1921;Eglutė;BORUŽIUKAI;6483580751;Ne;0;1;1;2
1922;Eglutė;BORUŽIUKAI;9661883776;Taip;0;22;0;22
1923;Eglutė;BORUŽIUKAI;8165126017;Taip;0;0;2;2
1924;Eglutė;BORUŽIUKAI;4451772812;Taip;4;0;3;7
1925;Eglutė;BORUŽIUKAI;8933416279;Taip;0;0;2;2
1926;Eglutė;BORUŽIUKAI;9046652370;Taip;0;0;15;15
1927;Aušrinė;Varpeliai;40427909744;Taip;0;10;0;10
1928;Aušrinė;Varpeliai;73663919787;Taip;4;2;0;6
1929;Aušrinė;Varpeliai;1182643102;Taip;9;0;5;14
1930;Aušrinė;Varpeliai;2030227606;Taip;10;0;0;10
1931;Aušrinė;Varpeliai;51725342242;Ne;17;0;0;17
1932;Aušrinė;Varpeliai;1448250372;Taip;0;17;0;17
1933;Aušrinė;Varpeliai;68192824475;Taip;8;0;0;8
1934;Aušrinė;Varpeliai;69919525470;Taip;0;8;0;8
1935;Aušrinė;Varpeliai;11187944085;Taip;5;0;0;5
1936;Aušrinė;Varpeliai;1988534889;Taip;3;0;0;3
1937;Aušrinė;Varpeliai;1278319590;Taip;9;0;0;9
1938;Aušrinė;Varpeliai;3356127625;Taip;15;0;0;15
1939;Aušrinė;Varpeliai;1148796296;Taip;0;6;0;6
1940;Aušrinė;Varpeliai;1927141701;Taip;0;0;2;2
1941;Aušrinė;Varpeliai;1515536619;Taip;6;0;0;6
1942;Aušrinė;Varpeliai;1996032555;Taip;0;8;0;8
1943;Aušrinė;Varpeliai;9989277772;Taip;5;0;4;9
1944;Aušrinė;Varpeliai;1000417905;Taip;0;13;0;13
1945;Aušrinė;Bitutės;58768831540;Ne;0;4;0;4
1946;Aušrinė;Bitutės;97658375230;Ne;12;0;0;12
1947;Aušrinė;Bitutės;1303589037;Ne;10;0;0;10
1948;Aušrinė;Bitutės;10370673775;Taip;0;2;0;2
1949;Aušrinė;Bitutės;1601648171;Taip;7;2;0;9
1950;Aušrinė;Bitutės;4903762612;Taip;4;0;0;4
1951;Aušrinė;Bitutės;17061806895;Taip;5;0;0;5
1952;Aušrinė;Bitutės;6443602669;Taip;12;0;0;12
1953;Aušrinė;Bitutės;7796318812;Taip;2;0;0;2
1954;Aušrinė;Bitutės;83017543760;Ne;0;1;0;1
1955;Aušrinė;Bitutės;6318538591;Taip;1;1;0;2
1956;Aušrinė;Bitutės;3035781587;Taip;5;0;0;5
1957;Aušrinė;Bitutės;9605160359;Taip;14;0;1;15
1958;Aušrinė;Bitutės;1399518471;Taip;0;6;0;6
1959;Aušrinė;Bitutės;25590576293;Taip;0;14;0;14
1960;Aušrinė;Bitutės;7507448059;Taip;0;3;0;3
1961;Aušrinė;Bitutės;1291308838;Ne;0;3;0;3
1962;Aušrinė;Bitutės;63299644698;Taip;14;0;0;14
1963;Aušrinė;Bitutės;2526585854;Taip;13;0;0;13
1964;Aušrinė;Drugeliai;2043278242;Taip;0;0;1;1
1965;Aušrinė;Drugeliai;1343667707;Taip;0;3;0;3
1966;Aušrinė;Drugeliai;96010737590;Taip;0;17;0;17
1967;Aušrinė;Drugeliai;1133359254;Taip;17;2;0;19
1968;Aušrinė;Drugeliai;30244366906;Taip;5;0;0;5
1969;Aušrinė;Drugeliai;1974161463;Taip;12;4;0;16
1970;Aušrinė;Drugeliai;1184543607;Taip;14;0;0;14
1971;Aušrinė;Drugeliai;1573790467;Taip;0;0;22;22
1972;Aušrinė;Drugeliai;48118825872;Taip;0;0;3;3
1973;Aušrinė;Drugeliai;2069277030;Taip;5;0;2;7
1974;Aušrinė;Drugeliai;1206863546;Taip;7;0;6;13
1975;Aušrinė;Drugeliai;1501614270;Ne;7;0;0;7
1976;Aušrinė;Drugeliai;6265909152;Taip;7;0;6;13
1977;Aušrinė;Drugeliai;1532235421;Ne;0;8;0;8
1978;Aušrinė;Drugeliai;2212814026;Ne;22;0;0;22
1979;Aušrinė;Boružėlės;8364033602;Taip;8;0;1;9
1980;Aušrinė;Boružėlės;1151612627;Taip;0;0;4;4
1981;Aušrinė;Boružėlės;1009453682;Taip;0;5;0;5
1982;Aušrinė;Boružėlės;3544848804;Ne;0;0;1;1
1983;Aušrinė;Boružėlės;6136579994;Taip;0;10;0;10
1984;Aušrinė;Boružėlės;8463758715;Taip;0;1;0;1
1985;Aušrinė;Boružėlės;4579700769;Taip;0;1;0;1
1986;Aušrinė;Boružėlės;7268811782;Taip;0;14;0;14
1987;Aušrinė;Boružėlės;3042409414;Taip;0;0;1;1
1988;Aušrinė;Boružėlės;1831094707;Taip;0;5;0;5
1989;Aušrinė;Boružėlės;3593323270;Taip;0;3;1;4
1990;Aušrinė;Boružėlės;3795927209;Taip;9;0;0;9
1991;Aušrinė;Boružėlės;5283207520;Taip;0;0;11;11
1992;Aušrinė;Boružėlės;1116822936;Taip;0;0;2;2
1993;Aušrinė;Boružėlės;6226967695;Taip;22;0;0;22
1994;Aušrinė;Boružėlės;9226214856;Taip;5;0;1;6
1995;Aušrinė;Boružėlės;4562536818;Taip;4;0;0;4
1996;Aušrinė;Boružėlės;71379978884;Ne;0;10;0;10
1997;Aušrinė;Zuikučiai;5776170550;Taip;1;0;0;1
1998;Aušrinė;Zuikučiai;9641020899;Taip;10;0;0;10
1999;Aušrinė;Zuikučiai;5277217733;Taip;22;0;0;22
2000;Aušrinė;Zuikučiai;6375484280;Taip;9;0;0;9
2001;Aušrinė;Zuikučiai;1502013942;Taip;22;0;0;22
2002;Aušrinė;Zuikučiai;2190583964;Taip;6;0;2;8
2003;Aušrinė;Zuikučiai;3920229653;Taip;10;7;1;18
2004;Aušrinė;Zuikučiai;8756465854;Taip;0;5;0;5
2005;Aušrinė;Zuikučiai;6756184787;Ne;0;0;1;1
2006;Aušrinė;Zuikučiai;4288487063;Taip;15;0;0;15
2007;Aušrinė;Zuikučiai;5768470608;Taip;10;0;0;10
2008;Aušrinė;Zuikučiai;1440531672;Taip;0;10;0;10
2009;Aušrinė;Zuikučiai;7194803557;Ne;10;3;0;13
2010;Aušrinė;Zuikučiai;2309358870;Taip;8;14;0;22
2011;Aušrinė;Zuikučiai;2304972692;Taip;10;0;3;13
2012;Aušrinė;Meškiukai;5204445760;Taip;7;6;0;13
2013;Aušrinė;Meškiukai;3269357241;Taip;19;0;0;19
2014;Aušrinė;Meškiukai;2583331243;Taip;17;0;0;17
2015;Aušrinė;Meškiukai;2948716989;Taip;0;15;0;15
2016;Aušrinė;Meškiukai;2055282010;Taip;0;0;1;1
2017;Aušrinė;Meškiukai;3346154143;Taip;9;0;0;9
2018;Aušrinė;Meškiukai;3276075664;Taip;11;0;0;11
2019;Aušrinė;Meškiukai;2778931038;Taip;15;5;2;22
2020;Aušrinė;Meškiukai;8092890260;Taip;4;0;0;4
2021;Aušrinė;Meškiukai;8465864375;Taip;10;0;1;11
2022;Aušrinė;Meškiukai;7784329873;Taip;12;0;0;12
2023;Aušrinė;Meškiukai;6525761466;Taip;22;0;0;22
2024;Aušrinė;Meškiukai;5043122065;Taip;0;0;1;1
2025;Aušrinė;Meškiukai;7358925256;Taip;9;0;0;9
2026;Aušrinė;Meškiukai;5128863532;Ne;6;0;6;12
2027;"Geniukų kalvė";SAULUTĖS;97391898211;Ne;0;2;0;2
2028;"Geniukų kalvė";SAULUTĖS;50484102538;Taip;2;3;0;5
2029;"Geniukų kalvė";SAULUTĖS;71971614175;Ne;0;1;0;1
2030;"Geniukų kalvė";SAULUTĖS;19739642721;Taip;5;0;0;5
2031;"Geniukų kalvė";SAULUTĖS;87723170266;Ne;0;2;0;2
2032;"Geniukų kalvė";SAULUTĖS;22867530415;Ne;0;6;0;6
2033;"Geniukų kalvė";SAULUTĖS;80569810851;Taip;0;7;0;7
2034;"Geniukų kalvė";SAULUTĖS;68771652481;Taip;0;8;0;8
2035;"Geniukų kalvė";SAULUTĖS;88828238496;Taip;0;8;0;8
2036;"Geniukų kalvė";SAULUTĖS;50839305875;Ne;6;1;0;7
2037;"Geniukų kalvė";SAULUTĖS;66371314129;Taip;0;1;0;1
2038;"Geniukų kalvė";SAULUTĖS;54754447084;Taip;0;1;0;1
2039;"Geniukų kalvė";SAULUTĖS;35212920132;Taip;0;8;0;8
2040;"Geniukų kalvė";SAULUTĖS;94596443429;Taip;0;2;0;2
2041;"Geniukų kalvė";SAULUTĖS;95119267553;Taip;0;10;0;10
2042;"Geniukų kalvė";SAULUTĖS;75895159280;Taip;3;0;0;3
2043;"Geniukų kalvė";SAULUTĖS;89508036774;Taip;0;17;0;17
2044;"Geniukų kalvė";BITUTĖS;4967513360;Taip;2;1;0;3
2045;"Geniukų kalvė";BITUTĖS;5776314197;Taip;2;0;0;2
2046;"Geniukų kalvė";BITUTĖS;4105170344;Taip;0;9;1;10
2047;"Geniukų kalvė";BITUTĖS;8872900558;Taip;1;1;0;2
2048;"Geniukų kalvė";BITUTĖS;6511955882;Taip;3;1;0;4
2049;"Geniukų kalvė";BITUTĖS;6500641378;Taip;0;4;0;4
2050;"Geniukų kalvė";BITUTĖS;6498149304;Taip;0;1;0;1
2051;"Geniukų kalvė";BITUTĖS;3984265624;Taip;0;22;0;22
2052;"Geniukų kalvė";BITUTĖS;4813232640;Taip;10;0;0;10
2053;"Geniukų kalvė";BITUTĖS;1451190239;Taip;0;21;0;21
2054;"Geniukų kalvė";BITUTĖS;4647433927;Taip;0;1;6;7
2055;"Geniukų kalvė";BITUTĖS;5257713434;Taip;0;1;6;7
2056;"Geniukų kalvė";KIŠKUČIAI;1568133009;Ne;9;0;0;9
2057;"Geniukų kalvė";KIŠKUČIAI;7664689396;Taip;10;0;0;10
2058;"Geniukų kalvė";KIŠKUČIAI;4844734556;Taip;4;10;0;14
2059;"Geniukų kalvė";KIŠKUČIAI;4758435835;Taip;0;0;9;9
2060;"Geniukų kalvė";KIŠKUČIAI;2729442911;Ne;6;0;0;6
2061;"Geniukų kalvė";KIŠKUČIAI;4661051023;Taip;0;0;6;6
2062;"Geniukų kalvė";KIŠKUČIAI;23023070502;Taip;22;0;0;22
2063;"Geniukų kalvė";KIŠKUČIAI;8668696743;Ne;3;0;2;5
2064;"Geniukų kalvė";KIŠKUČIAI;43097490633;Taip;0;10;5;15
2065;"Geniukų kalvė";KIŠKUČIAI;23153198194;Taip;0;12;0;12
2066;"Geniukų kalvė";KIŠKUČIAI;2043786151;Taip;2;5;0;7
2067;"Geniukų kalvė";KIŠKUČIAI;1460456166;Taip;0;4;0;4
2068;"Geniukų kalvė";KIŠKUČIAI;8939171238;Taip;0;0;5;5
2069;"Geniukų kalvė";KIŠKUČIAI;7839383630;Taip;5;0;1;6
2070;"Geniukų kalvė";KIŠKUČIAI;2140334255;Taip;9;1;0;10
2071;"Geniukų kalvė";KIŠKUČIAI;2301758912;Taip;1;8;1;10
2072;"Geniukų kalvė";KIŠKUČIAI;8635708009;Taip;10;0;3;13
2073;"Geniukų kalvė";KIŠKUČIAI;9081596975;Ne;11;0;1;12
2074;"Geniukų kalvė";KIŠKUČIAI;30932565379;Taip;20;0;2;22
2075;"Geniukų kalvė";KIŠKUČIAI;2337226175;Ne;0;0;2;2
2076;"Geniukų kalvė";VYTURĖLIAI;91633670390;Taip;0;1;2;3
2077;"Geniukų kalvė";VYTURĖLIAI;27433933081;Taip;0;1;0;1
2078;"Geniukų kalvė";VYTURĖLIAI;43457570841;Ne;0;0;1;1
2079;"Geniukų kalvė";VYTURĖLIAI;83612705234;Taip;5;0;0;5
2080;"Geniukų kalvė";VYTURĖLIAI;91532192571;Taip;0;9;0;9
2081;"Geniukų kalvė";VYTURĖLIAI;71553800692;Ne;8;0;0;8
2082;"Geniukų kalvė";VYTURĖLIAI;24599003355;Ne;0;2;0;2
2083;"Geniukų kalvė";VYTURĖLIAI;32731577118;Taip;0;7;0;7
2084;"Geniukų kalvė";VYTURĖLIAI;2088336409;Taip;3;0;0;3
2085;"Geniukų kalvė";VYTURĖLIAI;28229850220;Taip;6;1;0;7
2086;"Geniukų kalvė";VYTURĖLIAI;89176368447;Ne;0;0;2;2
2087;"Geniukų kalvė";VYTURĖLIAI;92776604959;Taip;0;8;0;8
2088;"Geniukų kalvė";VYTURĖLIAI;53430469011;Taip;0;3;0;3
2089;"Geniukų kalvė";VYTURĖLIAI;1131917679;Ne;0;7;0;7
2090;"Geniukų kalvė";DRUGELIAI;46050191161;Taip;0;5;0;5
2091;"Geniukų kalvė";DRUGELIAI;11531299319;Taip;5;0;0;5
2092;"Geniukų kalvė";DRUGELIAI;37570191268;Taip;0;13;0;13
2093;"Geniukų kalvė";DRUGELIAI;80173832943;Ne;0;0;1;1
2094;"Geniukų kalvė";DRUGELIAI;50522707614;Taip;0;2;0;2
2095;"Geniukų kalvė";DRUGELIAI;21387794128;Taip;0;3;0;3
2096;"Geniukų kalvė";DRUGELIAI;72591209415;Taip;0;1;0;1
2097;"Geniukų kalvė";DRUGELIAI;56872543521;Taip;0;2;0;2
2098;"Geniukų kalvė";DRUGELIAI;90336374948;Ne;0;3;0;3
2099;"Geniukų kalvė";DRUGELIAI;23422495596;Taip;6;8;0;14
2100;"Geniukų kalvė";DRUGELIAI;20968739747;Taip;1;0;0;1
2101;"Geniukų kalvė";DRUGELIAI;59483867231;Taip;7;0;2;9
2102;"Geniukų kalvė";DRUGELIAI;1395993314;Taip;0;6;0;6
2103;"Geniukų kalvė";DRUGELIAI;1318135788;Taip;0;3;0;3
2104;"Geniukų kalvė";DRUGELIAI;9656415371;Taip;0;6;1;7
2105;"Geniukų kalvė";DRUGELIAI;6553877473;Taip;3;0;2;5
2106;"Geniukų kalvė";"SAULĖS ZUIKUČIAI";37079991701;Taip;0;0;1;1
2107;"Geniukų kalvė";"SAULĖS ZUIKUČIAI";49352255237;Taip;0;1;0;1
2108;"Geniukų kalvė";"SAULĖS ZUIKUČIAI";90227736128;Taip;0;8;0;8
2109;"Geniukų kalvė";"SAULĖS ZUIKUČIAI";54856843273;Taip;14;0;2;16
2110;"Geniukų kalvė";"SAULĖS ZUIKUČIAI";1806626063;Taip;0;6;0;6
2111;"Geniukų kalvė";"SAULĖS ZUIKUČIAI";88504194684;Taip;5;2;0;7
2112;"Geniukų kalvė";"SAULĖS ZUIKUČIAI";1776042329;Taip;0;0;6;6
2113;"Geniukų kalvė";"SAULĖS ZUIKUČIAI";1716204178;Taip;0;0;10;10
2114;"Geniukų kalvė";"SAULĖS ZUIKUČIAI";1774738349;Taip;1;0;0;1
2115;"Geniukų kalvė";"SAULĖS ZUIKUČIAI";2120890722;Taip;0;12;0;12
2116;"Geniukų kalvė";"SAULĖS ZUIKUČIAI";1415719190;Ne;0;0;2;2
2117;"Geniukų kalvė";"SAULĖS ZUIKUČIAI";83443339743;Taip;0;1;0;1
2118;"Geniukų kalvė";"SAULĖS ZUIKUČIAI";1084055203;Taip;0;5;0;5
2119;"Geniukų kalvė";"SAULĖS ZUIKUČIAI";75791398203;Taip;5;0;2;7
2120;"Geniukų kalvė";"SAULĖS ZUIKUČIAI";3553253934;Taip;18;0;0;18
2121;"Geniukų kalvė";"SAULĖS ZUIKUČIAI";2056340856;Ne;0;14;0;14
2122;"Geniukų kalvė";"SAULĖS ZUIKUČIAI";9669281441;Ne;2;0;3;5
2123;"Geniukų kalvė";SMALSUČIAI;44345867922;Taip;0;0;1;1
2124;"Geniukų kalvė";SMALSUČIAI;82277353185;Taip;0;0;3;3
2125;"Geniukų kalvė";SMALSUČIAI;19181427380;Taip;4;0;1;5
2126;"Geniukų kalvė";SMALSUČIAI;1684481833;Taip;12;0;0;12
2127;"Geniukų kalvė";SMALSUČIAI;14939415217;Taip;0;9;0;9
2128;"Geniukų kalvė";SMALSUČIAI;1990303616;Taip;0;3;0;3
2129;"Geniukų kalvė";SMALSUČIAI;62774512989;Taip;13;0;0;13
2130;"Geniukų kalvė";SMALSUČIAI;45542289762;Taip;0;0;3;3
2131;"Geniukų kalvė";SMALSUČIAI;23964009189;Taip;0;10;0;10
2132;"Geniukų kalvė";SMALSUČIAI;42328019754;Taip;0;6;0;6
2133;"Geniukų kalvė";SMALSUČIAI;90435684305;Taip;0;10;0;10
2134;"Geniukų kalvė";SMALSUČIAI;97616612192;Taip;0;2;0;2
2135;"Geniukų kalvė";SMALSUČIAI;67762121244;Ne;0;1;0;1
2136;"Geniukų kalvė";SMALSUČIAI;2003986836;Ne;0;0;2;2
2137;"Geniukų kalvė";SMALSUČIAI;1248190435;Taip;10;0;0;10
2138;"Geniukų kalvė";SMALSUČIAI;5792552722;Taip;0;0;3;3
2139;"Geniukų kalvė";SMALSUČIAI;6253940549;Taip;0;0;2;2
2140;"Geniukų kalvė";SMALSUČIAI;9416843495;Taip;0;0;1;1
2141;"Geniukų kalvė";RUDNOSIUKAI;2082749897;Taip;0;10;0;10
2142;"Geniukų kalvė";RUDNOSIUKAI;7352976665;Taip;0;0;2;2
2143;"Geniukų kalvė";RUDNOSIUKAI;12109348143;Taip;2;0;0;2
2144;"Geniukų kalvė";RUDNOSIUKAI;6728268857;Taip;2;2;0;4
2145;"Geniukų kalvė";RUDNOSIUKAI;87858628237;Taip;0;2;0;2
2146;"Geniukų kalvė";RUDNOSIUKAI;93360165202;Taip;2;0;0;2
2147;"Geniukų kalvė";RUDNOSIUKAI;36295276899;Taip;0;9;0;9
2148;"Geniukų kalvė";RUDNOSIUKAI;16810843163;Taip;5;1;3;9
2149;"Geniukų kalvė";RUDNOSIUKAI;75926614045;Taip;0;1;0;1
2150;"Geniukų kalvė";RUDNOSIUKAI;51320722945;Ne;5;0;1;6
2151;"Geniukų kalvė";RUDNOSIUKAI;96448080708;Taip;3;7;0;10
2152;"Geniukų kalvė";RUDNOSIUKAI;1727967870;Taip;3;1;0;4
2153;"Geniukų kalvė";RUDNOSIUKAI;29353737550;Taip;5;2;6;13
2154;"Geniukų kalvė";RUDNOSIUKAI;6928979691;Ne;0;1;3;4
2155;"Geniukų kalvė";RUDNOSIUKAI;22074236863;Taip;0;5;1;6
2156;"Geniukų kalvė";RUDNOSIUKAI;7269049874;Taip;0;5;1;6
2157;"Geniukų kalvė";PELĖDŽIUKAI;1829858221;Taip;5;5;0;10
2158;"Geniukų kalvė";PELĖDŽIUKAI;1624933726;Taip;18;0;0;18
2159;"Geniukų kalvė";PELĖDŽIUKAI;3599151643;Taip;0;0;3;3
2160;"Geniukų kalvė";PELĖDŽIUKAI;37670000746;Taip;0;1;1;2
2161;"Geniukų kalvė";PELĖDŽIUKAI;14839311346;Taip;0;5;0;5
2162;"Geniukų kalvė";PELĖDŽIUKAI;31140342871;Taip;2;0;0;2
2163;"Geniukų kalvė";PELĖDŽIUKAI;70097449722;Taip;0;10;0;10
2164;"Geniukų kalvė";PELĖDŽIUKAI;53385228310;Ne;0;6;0;6
2165;"Geniukų kalvė";PELĖDŽIUKAI;68752448767;Taip;0;1;4;5
2166;"Geniukų kalvė";PELĖDŽIUKAI;57595197116;Taip;0;1;0;1
2167;"Geniukų kalvė";PELĖDŽIUKAI;61225085978;Taip;0;11;0;11
2168;"Geniukų kalvė";PELĖDŽIUKAI;83623361401;Ne;0;6;0;6
2169;"Geniukų kalvė";PELĖDŽIUKAI;67649373235;Taip;3;0;0;3
2170;"Geniukų kalvė";PELĖDŽIUKAI;87751274075;Ne;0;0;5;5
2171;"Geniukų kalvė";PELĖDŽIUKAI;71884588832;Ne;3;0;4;7
2172;"Geniukų kalvė";PELĖDŽIUKAI;1239061261;Taip;10;0;0;10
2173;"Geniukų kalvė";PELĖDŽIUKAI;91734868433;Ne;0;0;1;1
2174;"Geniukų kalvė";BORUŽĖLĖS;51353124475;Ne;0;10;0;10
2175;"Geniukų kalvė";BORUŽĖLĖS;1246234700;Ne;0;5;0;5
2176;"Geniukų kalvė";BORUŽĖLĖS;52431368754;Ne;0;0;10;10
2177;"Geniukų kalvė";BORUŽĖLĖS;30865528880;Taip;1;1;1;3
2178;"Geniukų kalvė";BORUŽĖLĖS;66632618838;Taip;5;1;0;6
2179;"Geniukų kalvė";BORUŽĖLĖS;88543141650;Taip;7;0;1;8
2180;"Geniukų kalvė";BORUŽĖLĖS;96954076142;Taip;0;1;0;1
2181;"Geniukų kalvė";BORUŽĖLĖS;27479616927;Taip;1;0;0;1
2182;"Geniukų kalvė";BORUŽĖLĖS;38949678625;Taip;0;2;0;2
2183;"Geniukų kalvė";BORUŽĖLĖS;99051569551;Taip;5;4;0;9
2184;"Geniukų kalvė";BORUŽĖLĖS;50218457812;Ne;1;1;0;2
2185;"Geniukų kalvė";BORUŽĖLĖS;8916930503;Taip;5;0;0;5
2186;"Geniukų kalvė";BORUŽĖLĖS;2038860438;Taip;13;0;2;15
2187;"Geniukų kalvė";BORUŽĖLĖS;74161080879;Taip;0;0;5;5
2188;"Geniukų kalvė";BORUŽĖLĖS;93542861144;Taip;0;0;9;9
2189;"Geniukų kalvė";BORUŽĖLĖS;1923449545;Taip;3;0;2;5
2190;"Geniukų kalvė";BORUŽĖLĖS;1073117547;Taip;0;0;2;2
2191;"Geniukų kalvė";PAGRANDUKAI;2938446054;Taip;0;1;0;1
2192;"Geniukų kalvė";PAGRANDUKAI;6737863183;Taip;4;0;0;4
2193;"Geniukų kalvė";PAGRANDUKAI;9990243525;Taip;5;0;0;5
2194;"Geniukų kalvė";PAGRANDUKAI;6174114461;Taip;10;0;0;10
2195;"Geniukų kalvė";PAGRANDUKAI;3826265557;Taip;0;0;1;1
2196;"Geniukų kalvė";PAGRANDUKAI;1051563985;Taip;0;2;1;3
2197;"Geniukų kalvė";PAGRANDUKAI;6070945557;Taip;0;2;0;2
2198;"Geniukų kalvė";PAGRANDUKAI;2659298240;Taip;0;2;0;2
2199;"Geniukų kalvė";PAGRANDUKAI;2217221922;Taip;1;0;0;1
2200;"Geniukų kalvė";PAGRANDUKAI;8271041553;Taip;0;6;0;6
2201;"Geniukų kalvė";PAGRANDUKAI;9976423099;Taip;11;0;0;11
2202;"Geniukų kalvė";PAGRANDUKAI;3762178533;Taip;13;0;0;13
2203;"Geniukų kalvė";NYKŠTUKAI;4958738745;Taip;0;0;3;3
2204;"Geniukų kalvė";NYKŠTUKAI;4271763719;Taip;2;1;10;13
2205;"Geniukų kalvė";NYKŠTUKAI;9069256760;Taip;15;0;1;16
2206;"Geniukų kalvė";NYKŠTUKAI;3493492581;Taip;0;6;0;6
2207;"Geniukų kalvė";NYKŠTUKAI;3180116136;Taip;3;7;0;10
2208;"Geniukų kalvė";NYKŠTUKAI;2904091819;Ne;3;0;0;3
2209;"Geniukų kalvė";NYKŠTUKAI;5245434552;Taip;0;3;0;3
2210;"Geniukų kalvė";NYKŠTUKAI;6794151223;Taip;1;0;0;1
2211;"Geniukų kalvė";NYKŠTUKAI;5161535756;Taip;0;0;2;2
2212;"Geniukų kalvė";NYKŠTUKAI;1499735818;Taip;0;15;0;15
2213;Gelvonėlis;ĄŽUOLIUKAI;48593832088;Taip;0;0;3;3
2214;Gelvonėlis;ĄŽUOLIUKAI;71199691102;Taip;0;10;0;10
2215;Gelvonėlis;ĄŽUOLIUKAI;2218767947;Taip;0;5;4;9
2216;Gelvonėlis;ĄŽUOLIUKAI;5393404051;Taip;17;0;0;17
2217;Gelvonėlis;ĄŽUOLIUKAI;7277516341;Taip;5;0;1;6
2218;Gelvonėlis;ĄŽUOLIUKAI;98009116912;Taip;0;0;1;1
2219;Gelvonėlis;ĄŽUOLIUKAI;91507293029;Taip;0;19;0;19
2220;Gelvonėlis;ĄŽUOLIUKAI;79847096929;Taip;0;0;11;11
2221;Gelvonėlis;ĄŽUOLIUKAI;70550528579;Taip;12;2;0;14
2222;Gelvonėlis;ĄŽUOLIUKAI;51375531815;Taip;0;6;1;7
2223;Gelvonėlis;ĄŽUOLIUKAI;17021411833;Taip;0;8;0;8
2224;Gelvonėlis;ĄŽUOLIUKAI;9970883470;Taip;0;6;0;6
2225;Gelvonėlis;ĄŽUOLIUKAI;1902998389;Taip;0;5;0;5
2226;Gelvonėlis;ĄŽUOLIUKAI;7822842578;Taip;5;2;1;8
2227;Gelvonėlis;ĄŽUOLIUKAI;71076083278;Taip;17;0;1;18
2228;Gelvonėlis;ĄŽUOLIUKAI;89916945860;Ne;0;0;2;2
2229;Gelvonėlis;ĄŽUOLIUKAI;1776015014;Taip;12;1;0;13
2230;Gelvonėlis;ĄŽUOLIUKAI;43250059460;Taip;0;9;0;9
2231;Gelvonėlis;ĄŽUOLIUKAI;22201650331;Taip;0;9;0;9
2232;Gelvonėlis;ŽVIRBLIUKAI;1772713183;Taip;0;10;1;11
2233;Gelvonėlis;ŽVIRBLIUKAI;1801724527;Ne;0;2;0;2
2234;Gelvonėlis;ŽVIRBLIUKAI;83360239551;Taip;0;0;22;22
2235;Gelvonėlis;ŽVIRBLIUKAI;21250325232;Taip;0;1;1;2
2236;Gelvonėlis;ŽVIRBLIUKAI;23181505838;Taip;0;12;0;12
2237;Gelvonėlis;ŽVIRBLIUKAI;2997738880;Taip;0;2;1;3
2238;Gelvonėlis;ŽVIRBLIUKAI;1373771258;Taip;0;7;0;7
2239;Gelvonėlis;ŽVIRBLIUKAI;92420286100;Taip;9;6;0;15
2240;Gelvonėlis;ŽVIRBLIUKAI;41610307448;Taip;10;0;3;13
2241;Gelvonėlis;ŽVIRBLIUKAI;87746258537;Taip;0;6;0;6
2242;Gelvonėlis;ŽVIRBLIUKAI;6635285387;Taip;0;0;3;3
2243;Gelvonėlis;ŽVIRBLIUKAI;1938913528;Taip;5;10;0;15
2244;Gelvonėlis;ŽVIRBLIUKAI;2096702999;Taip;0;3;1;4
2245;Gelvonėlis;ŽVIRBLIUKAI;17044138057;Taip;0;0;2;2
2246;Gelvonėlis;ŽVIRBLIUKAI;84863800926;Taip;10;5;0;15
2247;Gelvonėlis;ŽVIRBLIUKAI;1355742622;Taip;5;7;0;12
2248;Gelvonėlis;ŽVIRBLIUKAI;90961913967;Taip;0;1;0;1
2249;Gelvonėlis;ŽVIRBLIUKAI;1827511187;Taip;0;10;1;11
2250;Gelvonėlis;ŽVIRBLIUKAI;1835508505;Taip;0;2;2;4
2251;Gelvonėlis;ŽVIRBLIUKAI;9784762153;Taip;13;2;0;15
2252;Gelvonėlis;ŽVIRBLIUKAI;9919860358;Taip;1;2;0;3
2253;Gelvonėlis;RASELĖS;27296649662;Taip;0;0;1;1
2254;Gelvonėlis;RASELĖS;11994848859;Taip;7;0;0;7
2255;Gelvonėlis;RASELĖS;32532059858;Taip;9;0;1;10
2256;Gelvonėlis;RASELĖS;40035134521;Taip;0;2;0;2
2257;Gelvonėlis;RASELĖS;57163457394;Taip;0;1;0;1
2258;Gelvonėlis;RASELĖS;23568664214;Taip;0;0;2;2
2259;Gelvonėlis;RASELĖS;41750260566;Taip;0;0;1;1
2260;Gelvonėlis;RASELĖS;3461354329;Taip;10;6;0;16
2261;Gelvonėlis;RASELĖS;95413117888;Taip;7;9;0;16
2262;Gelvonėlis;RASELĖS;3325116198;Taip;7;0;1;8
2263;Gelvonėlis;RASELĖS;2153676615;Ne;6;11;0;17
2264;Gelvonėlis;RASELĖS;87254295179;Taip;0;5;0;5
2265;Gelvonėlis;RASELĖS;47302438188;Taip;10;0;2;12
2266;Gelvonėlis;RASELĖS;66162315180;Taip;6;1;0;7
2267;Gelvonėlis;RASELĖS;32893563601;Taip;10;1;0;11
2268;Gelvonėlis;RASELĖS;18324768783;Taip;1;0;0;1
2269;Gelvonėlis;RASELĖS;11697172905;Taip;6;2;0;8
2270;Gelvonėlis;RASELĖS;1221420212;Taip;5;5;0;10
2271;Gelvonėlis;RASELĖS;1396698456;Taip;8;0;2;10
2272;Gelvonėlis;RASELĖS;43145774484;Ne;6;0;0;6
2273;Gelvonėlis;RASELĖS;18237108866;Taip;10;2;0;12
2274;Gelvonėlis;RASELĖS;3271118581;Taip;18;0;0;18
2275;Gelvonėlis;RASELĖS;79607769503;Ne;4;0;0;4
2276;Gelvonėlis;RASELĖS;96792124844;Ne;4;0;0;4
2277;Gelvonėlis;SAULUTĖ;57821074297;Taip;0;1;0;1
2278;Gelvonėlis;SAULUTĖ;35428558838;Taip;0;6;0;6
2279;Gelvonėlis;SAULUTĖ;57792200616;Taip;0;8;0;8
2280;Gelvonėlis;SAULUTĖ;84202281636;Taip;0;6;0;6
2281;Gelvonėlis;SAULUTĖ;38629832653;Taip;0;7;0;7
2282;Gelvonėlis;SAULUTĖ;473144281;Taip;3;0;0;3
2283;Gelvonėlis;SAULUTĖ;81833782531;Taip;0;3;0;3
2284;Gelvonėlis;SAULUTĖ;72048682220;Taip;9;0;0;9
2285;Gelvonėlis;SAULUTĖ;33845988568;Taip;3;1;0;4
2286;Gelvonėlis;SAULUTĖ;45588179697;Taip;0;3;0;3
2287;Gelvonėlis;SAULUTĖ;4316492518;Taip;12;1;0;13
2288;Gelvonėlis;SAULUTĖ;17005717219;Ne;0;7;0;7
2289;Gelvonėlis;SAULUTĖ;34373469291;Taip;7;0;0;7
2290;Gelvonėlis;SAULUTĖ;35992063196;Taip;2;4;0;6
2291;Gelvonėlis;SAULUTĖ;11807134557;Taip;0;1;0;1
2292;Gelvonėlis;SAULUTĖ;80973545044;Ne;0;0;22;22
2293;Gelvonėlis;PELĖDŽIUKAI;72281404967;Taip;0;0;7;7
2294;Gelvonėlis;PELĖDŽIUKAI;59868339873;Taip;0;3;0;3
2295;Gelvonėlis;PELĖDŽIUKAI;91191192491;Taip;0;4;0;4
2296;Gelvonėlis;PELĖDŽIUKAI;2044305781;Taip;0;4;0;4
2297;Gelvonėlis;PELĖDŽIUKAI;54577279896;Taip;0;0;4;4
2298;Gelvonėlis;PELĖDŽIUKAI;45653629924;Taip;0;0;4;4
2299;Gelvonėlis;PELĖDŽIUKAI;16588607945;Taip;0;7;0;7
2300;Gelvonėlis;PELĖDŽIUKAI;10505090360;Taip;0;5;0;5
2301;Gelvonėlis;PELĖDŽIUKAI;9898346862;Taip;5;2;2;9
2302;Gelvonėlis;PELĖDŽIUKAI;15109448940;Taip;0;0;1;1
2303;Gelvonėlis;PELĖDŽIUKAI;75070203296;Taip;0;0;7;7
2304;Gelvonėlis;PELĖDŽIUKAI;24391920760;Taip;0;3;0;3
2305;Gelvonėlis;PELĖDŽIUKAI;67940634367;Taip;0;0;2;2
2306;Gelvonėlis;PELĖDŽIUKAI;83653321747;Taip;0;6;0;6
2307;Gelvonėlis;DRUGELIAI;5098282548;Taip;6;0;0;6
2308;Gelvonėlis;DRUGELIAI;50383394228;Ne;11;0;0;11
2309;Gelvonėlis;DRUGELIAI;68841073274;Taip;0;8;0;8
2310;Gelvonėlis;DRUGELIAI;1775227032;Taip;0;4;0;4
2311;Gelvonėlis;DRUGELIAI;67365224459;Taip;0;1;0;1
2312;Gelvonėlis;DRUGELIAI;1042715433;Ne;0;12;0;12
2313;Gelvonėlis;DRUGELIAI;59592904001;Taip;10;1;0;11
2314;Gelvonėlis;DRUGELIAI;6405741006;Taip;0;3;0;3
2315;Gelvonėlis;DRUGELIAI;1750552925;Taip;0;9;0;9
2316;Gelvonėlis;DRUGELIAI;19782508652;Ne;0;1;0;1
2317;Gelvonėlis;DRUGELIAI;3859776410;Taip;22;0;0;22
2318;Gelvonėlis;DRUGELIAI;19955601762;Taip;2;0;0;2
2319;Gelvonėlis;DRUGELIAI;71806077882;Taip;22;0;0;22
2320;Gelvonėlis;DRUGELIAI;8475204684;Taip;0;1;0;1
2321;Gelvonėlis;DRUGELIAI;4830374546;Taip;12;5;0;17
2322;Gelvonėlis;DRUGELIAI;2622967319;Taip;5;7;0;12
2323;Gelvonėlis;VARPELIAI;3059903126;Taip;5;0;1;6
2324;Gelvonėlis;VARPELIAI;9149117970;Taip;0;2;0;2
2325;Gelvonėlis;VARPELIAI;3483144401;Taip;0;0;5;5
2326;Gelvonėlis;VARPELIAI;1512245903;Taip;7;0;0;7
2327;Gelvonėlis;VARPELIAI;6451557430;Taip;12;7;0;19
2328;Gelvonėlis;VARPELIAI;6225854165;Taip;12;0;0;12
2329;Gelvonėlis;VARPELIAI;2638430817;Ne;0;0;10;10
2330;Gelvonėlis;VARPELIAI;9396676137;Taip;12;0;0;12
2331;Gelvonėlis;VARPELIAI;9353066785;Taip;12;0;0;12
2332;Gelvonėlis;VARPELIAI;9059244134;Taip;0;3;0;3
2333;Gelvonėlis;VARPELIAI;1987204544;Taip;7;12;0;19
2334;Gelvonėlis;VARPELIAI;8515746171;Taip;9;3;0;12
2335;Gelvonėlis;VARPELIAI;9600526942;Taip;0;0;1;1
2336;Gelvonėlis;VARPELIAI;1387948936;Taip;8;11;0;19
2337;Gelvonėlis;VARPELIAI;9650922918;Taip;5;1;0;6
2338;Gelvonėlis;VARPELIAI;3121251271;Taip;5;0;2;7
2339;Gelvonėlis;VARPELIAI;1462716950;Taip;12;0;0;12
2340;Gelvonėlis;VARPELIAI;6949090250;Taip;22;0;0;22
2341;Gelvonėlis;BORUŽĖLĖS;1030246127;Taip;5;1;4;10
2342;Gelvonėlis;BORUŽĖLĖS;22575527531;Taip;6;1;0;7
2343;Gelvonėlis;BORUŽĖLĖS;1163833201;Taip;22;0;0;22
2344;Gelvonėlis;BORUŽĖLĖS;1236944078;Taip;0;3;0;3
2345;Gelvonėlis;BORUŽĖLĖS;3379601736;Taip;0;14;0;14
2346;Gelvonėlis;BORUŽĖLĖS;1597669426;Taip;6;2;0;8
2347;Gelvonėlis;BORUŽĖLĖS;31744699590;Taip;7;1;1;9
2348;Gelvonėlis;BORUŽĖLĖS;4917453676;Ne;9;0;1;10
2349;Gelvonėlis;BORUŽĖLĖS;9108760720;Taip;0;3;0;3
2350;Gelvonėlis;BORUŽĖLĖS;9777094764;Taip;13;0;0;13
2351;Gelvonėlis;BORUŽĖLĖS;3936144045;Ne;0;2;0;2
2352;Gelvonėlis;BORUŽĖLĖS;12715604772;Taip;13;1;0;14
2353;Gelvonėlis;BORUŽĖLĖS;8050788182;Taip;0;16;0;16
2354;Gelvonėlis;BORUŽĖLĖS;91441127098;Taip;7;0;0;7
2355;Gelvonėlis;BORUŽĖLĖS;1183745610;Taip;0;12;0;12
2356;Gelvonėlis;BORUŽĖLĖS;1836155450;Taip;0;10;0;10
2357;Gelvonėlis;BORUŽĖLĖS;1400871061;Taip;4;0;0;4
2358;Gelvonėlis;BORUŽĖLĖS;87693970225;Taip;2;2;0;4
2359;Gelvonėlis;BORUŽĖLĖS;69221565557;Taip;10;0;0;10
2360;Gelvonėlis;BORUŽĖLĖS;79899652046;Taip;13;0;0;13
2361;Gelvonėlis;BORUŽĖLĖS;7903272826;Taip;22;0;0;22
2362;Gelvonėlis;NYKŠTUKAI;6604992169;Taip;11;4;0;15
2363;Gelvonėlis;NYKŠTUKAI;6556472766;Taip;17;0;2;19
2364;Gelvonėlis;NYKŠTUKAI;7182180008;Taip;0;7;0;7
2365;Gelvonėlis;NYKŠTUKAI;6598178467;Taip;10;3;2;15
2366;Gelvonėlis;NYKŠTUKAI;8885088900;Taip;0;1;2;3
2367;Gelvonėlis;NYKŠTUKAI;8622621570;Taip;15;0;2;17
2368;Gelvonėlis;NYKŠTUKAI;2400289466;Taip;5;5;0;10
2369;Gelvonėlis;NYKŠTUKAI;5129492284;Taip;5;0;0;5
2370;Gelvonėlis;NYKŠTUKAI;9493536517;Taip;7;0;0;7
2371;Gelvonėlis;NYKŠTUKAI;2288951845;Taip;6;0;0;6
2372;Gelvonėlis;NYKŠTUKAI;2515471132;Taip;0;0;2;2
2373;Gelvonėlis;NYKŠTUKAI;6319058542;Taip;10;0;0;10
2374;Gelvonėlis;NYKŠTUKAI;9538571448;Taip;0;3;0;3
2375;Gelvonėlis;NYKŠTUKAI;7919814808;Ne;11;1;0;12
2376;Gelvonėlis;NYKŠTUKAI;7620280474;Taip;6;0;0;6
2377;Gelvonėlis;BITUTĖS;7759317220;Ne;0;6;0;6
2378;Gelvonėlis;BITUTĖS;6196065515;Taip;0;1;0;1
2379;Gelvonėlis;BITUTĖS;2504468098;Taip;0;11;0;11
2380;Gelvonėlis;BITUTĖS;7983982378;Taip;12;5;0;17
2381;Gelvonėlis;BITUTĖS;5721858659;Taip;5;1;0;6
2382;Gelvonėlis;BITUTĖS;9667024635;Taip;0;5;0;5
2383;Gelvonėlis;BITUTĖS;2108690954;Taip;0;5;0;5
2384;Gelvonėlis;BITUTĖS;9323579468;Taip;1;0;1;2
2385;Gelvonėlis;BITUTĖS;4855800131;Taip;0;0;2;2
2386;Gelvonėlis;BITUTĖS;1753617545;Taip;7;1;0;8
2387;Gelvonėlis;BITUTĖS;6189110767;Taip;8;0;0;8
2388;Gelvonėlis;BITUTĖS;3843881329;Taip;0;2;0;2
2389;Gelvonėlis;BITUTĖS;6317822775;Taip;0;1;0;1
2390;Gelvonėlis;BITUTĖS;9184192787;Taip;0;2;0;2
2391;Gelvonėlis;BITUTĖS;9369121356;Taip;3;1;0;4
2392;Gelvonėlis;BITUTĖS;2119550116;Taip;12;0;0;12
2393;Gelvonėlis;BITUTĖS;7826522180;Taip;0;1;0;1
2394;Gelvonėlis;BITUTĖS;9286500887;Taip;0;0;7;7
2395;Gelvonėlis;BITUTĖS;5095782784;Taip;6;1;0;7
2396;Gelvonėlis;BITUTĖS;1516164123;Taip;10;3;0;13
2397;Gelvonėlis;BITUTĖS;3788522708;Taip;3;0;0;3
2398;Gelvonėlis;RAMUNĖLĖS;5047022305;Ne;0;0;7;7
2399;Gelvonėlis;RAMUNĖLĖS;2742000725;Taip;0;0;1;1
2400;Gelvonėlis;RAMUNĖLĖS;1085845218;Taip;21;0;0;21
2401;Gelvonėlis;RAMUNĖLĖS;5511174729;Taip;0;0;8;8
2402;Gelvonėlis;RAMUNĖLĖS;1284359362;Taip;9;0;0;9
2403;Gelvonėlis;RAMUNĖLĖS;69073786634;Taip;0;10;0;10
2404;Gelvonėlis;RAMUNĖLĖS;8775661719;Taip;0;3;0;3
2405;Gelvonėlis;RAMUNĖLĖS;6255253658;Taip;0;1;2;3
2406;Gelvonėlis;RAMUNĖLĖS;29928181395;Taip;5;10;0;15
2407;Gelvonėlis;RAMUNĖLĖS;21684706944;Taip;5;1;0;6
2408;Gelvonėlis;RAMUNĖLĖS;75676389361;Taip;1;3;0;4
2409;Gelvonėlis;RAMUNĖLĖS;9387523651;Taip;0;6;0;6
2410;Gelvonėlis;RAMUNĖLĖS;2140799517;Taip;0;7;0;7
2411;Gelvonėlis;RAMUNĖLĖS;3830940009;Taip;0;9;0;9
2412;Gelvonėlis;RAMUNĖLĖS;3089755141;Taip;0;2;0;2
2413;Gelvonėlis;RAMUNĖLĖS;2077783219;Taip;0;1;1;2
2414;Gelvonėlis;RAMUNĖLĖS;1408313697;Taip;0;0;5;5
2415;Gelvonėlis;RAMUNĖLĖS;3670612781;Taip;0;8;0;8
2416;Gelvonėlis;RAMUNĖLĖS;1624125024;Taip;1;2;0;3
2417;Gelvonėlis;RAMUNĖLĖS;3147489259;Taip;0;6;0;6
2418;Gelvonėlis;RAMUNĖLĖS;9798684265;Taip;0;0;1;1
2419;Gervelė;ŽIRNIUKAI;3525060645;Taip;12;8;0;20
2420;Gervelė;ŽIRNIUKAI;94487630173;Taip;3;0;3;6
2421;Gervelė;ŽIRNIUKAI;2551280794;Taip;6;5;0;11
2422;Gervelė;ŽIRNIUKAI;7302238728;Ne;0;1;0;1
2423;Gervelė;ŽIRNIUKAI;5989713844;Taip;0;3;0;3
2424;Gervelė;ŽIRNIUKAI;4560752068;Taip;0;15;0;15
2425;Gervelė;ŽIRNIUKAI;87619285504;Taip;0;0;4;4
2426;Gervelė;ŽIRNIUKAI;1991238577;Taip;0;5;0;5
2427;Gervelė;ŽIRNIUKAI;9515308666;Taip;0;3;0;3
2428;Gervelė;ŽIRNIUKAI;1616949023;Taip;13;0;2;15
2429;Gervelė;ŽIRNIUKAI;4943974662;Taip;5;6;0;11
2430;Gervelė;ŽIRNIUKAI;8152446576;Taip;15;2;0;17
2431;Gervelė;ŽIRNIUKAI;6967078836;Taip;11;0;1;12
2432;Gervelė;ŽIRNIUKAI;1704033440;Taip;15;2;0;17
2433;Gervelė;ŽIRNIUKAI;4705514590;Ne;0;5;0;5
2434;Gervelė;ŽIRNIUKAI;89076506192;Taip;9;0;1;10
2435;Gervelė;ŽIRNIUKAI;2167744244;Taip;1;2;0;3
2436;Gervelė;ŽIRNIUKAI;3427400844;Taip;2;5;0;7
2437;Gervelė;ŽIRNIUKAI;7697761552;Taip;0;10;0;10
2438;Gervelė;LAŠIUKAI;52142182972;Taip;0;2;0;2
2439;Gervelė;LAŠIUKAI;73803372762;Taip;0;0;2;2
2440;Gervelė;LAŠIUKAI;1697536098;Taip;13;3;0;16
2441;Gervelė;LAŠIUKAI;1617055167;Taip;0;6;0;6
2442;Gervelė;LAŠIUKAI;3278950938;Taip;0;0;1;1
2443;Gervelė;LAŠIUKAI;1492459180;Taip;5;0;0;5
2444;Gervelė;LAŠIUKAI;49013139623;Taip;10;0;0;10
2445;Gervelė;LAŠIUKAI;2019214634;Taip;22;0;0;22
2446;Gervelė;LAŠIUKAI;1860333208;Taip;0;5;0;5
2447;Gervelė;LAŠIUKAI;8454703111;Taip;0;0;1;1
2448;Gervelė;LAŠIUKAI;1921567602;Taip;0;1;0;1
2449;Gervelė;LAŠIUKAI;88273293270;Taip;8;0;1;9
2450;Gervelė;LAŠIUKAI;8035942210;Taip;0;9;1;10
2451;Gervelė;LAŠIUKAI;2191126539;Taip;0;0;4;4
2452;Gervelė;LAŠIUKAI;2632272974;Taip;0;9;0;9
2453;Gervelė;LAŠIUKAI;62782512806;Taip;0;7;0;7
2454;Gervelė;LAŠIUKAI;85689668690;Taip;0;10;0;10
2455;Gervelė;PABIRUČIAI;81112128210;Taip;0;5;0;5
2456;Gervelė;PABIRUČIAI;48497142461;Ne;0;5;0;5
2457;Gervelė;PABIRUČIAI;24724452164;Taip;0;0;1;1
2458;Gervelė;PABIRUČIAI;30126718224;Taip;0;5;0;5
2459;Gervelė;PABIRUČIAI;65086547895;Taip;0;9;0;9
2460;Gervelė;PABIRUČIAI;32101040739;Ne;0;0;19;19
2461;Gervelė;PABIRUČIAI;97418410809;Ne;4;0;0;4
2462;Gervelė;PABIRUČIAI;4265845947;Taip;0;1;0;1
2463;Gervelė;PABIRUČIAI;65751519550;Ne;3;0;0;3
2464;Gervelė;PABIRUČIAI;1303396562;Ne;0;0;4;4
2465;Gervelė;PABIRUČIAI;2017094793;Taip;0;0;1;1
2466;Gervelė;PABIRUČIAI;76731434799;Ne;13;0;0;13
2467;Gervelė;PABIRUČIAI;8302493906;Ne;0;6;0;6
2468;Gervelė;PABIRUČIAI;1371549808;Taip;0;5;0;5
2469;Gervelė;PABIRUČIAI;27435616549;Taip;0;1;0;1
2470;Gervelė;PABIRUČIAI;1413157604;Taip;0;0;3;3
2471;Gervelė;BITUTĖS;98970443751;Taip;0;0;3;3
2472;Gervelė;BITUTĖS;47945657061;Taip;0;5;0;5
2473;Gervelė;BITUTĖS;64688647985;Taip;0;0;10;10
2474;Gervelė;BITUTĖS;1545499809;Taip;0;4;0;4
2475;Gervelė;BITUTĖS;73134084618;Taip;0;6;0;6
2476;Gervelė;BITUTĖS;29756975817;Taip;0;2;0;2
2477;Gervelė;BITUTĖS;33044536438;Ne;0;1;0;1
2478;Gervelė;BITUTĖS;1897895689;Taip;0;11;0;11
2479;Gervelė;BITUTĖS;87075838181;Taip;2;0;0;2
2480;Gervelė;BITUTĖS;84331024451;Taip;1;0;0;1
2481;Gervelė;BITUTĖS;85855349922;Taip;0;8;0;8
2482;Gervelė;BITUTĖS;75507305203;Taip;0;5;0;5
2483;Gervelė;BITUTĖS;4092917137;Ne;6;0;0;6
2484;Gervelė;BURATINO;54142931109;Taip;0;10;0;10
2485;Gervelė;BURATINO;1772051140;Taip;0;4;0;4
2486;Gervelė;BURATINO;29832889771;Ne;10;2;0;12
2487;Gervelė;BURATINO;1815418720;Taip;0;11;0;11
2488;Gervelė;BURATINO;6168558862;Taip;0;9;0;9
2489;Gervelė;BURATINO;92859033264;Taip;0;7;0;7
2490;Gervelė;BURATINO;3784549444;Taip;0;9;0;9
2491;Gervelė;BURATINO;3946391650;Taip;0;1;0;1
2492;Gervelė;BURATINO;7620764911;Taip;4;3;0;7
2493;Gervelė;BURATINO;5440557094;Taip;15;1;0;16
2494;Gervelė;BURATINO;8195558041;Taip;22;0;0;22
2495;Gervelė;BURATINO;9909794030;Taip;0;6;0;6
2496;Gervelė;BURATINO;3022690832;Taip;6;0;0;6
2497;Gervelė;BURATINO;3825101647;Ne;22;0;0;22
2498;Gervelė;BURATINO;9692128960;Ne;0;7;0;7
2499;Gervelė;VIŠČIUKŲ;4394752176;Taip;5;1;0;6
2500;Gervelė;VIŠČIUKŲ;7020599764;Taip;0;0;1;1
2501;Gervelė;VIŠČIUKŲ;5953552777;Taip;0;4;0;4
2502;Gervelė;VIŠČIUKŲ;6951455424;Taip;0;0;4;4
2503;Gervelė;VIŠČIUKŲ;8016341646;Taip;1;0;0;1
2504;Gervelė;VIŠČIUKŲ;9970293084;Ne;0;12;0;12
2505;Gervelė;VIŠČIUKŲ;5267617723;Taip;5;1;0;6
2506;Gervelė;VIŠČIUKŲ;1400044294;Taip;0;3;0;3
2507;Gervelė;VIŠČIUKŲ;7935059565;Taip;5;0;0;5
2508;Gervelė;VIŠČIUKŲ;8012122042;Taip;11;0;3;14
2509;Gervelė;VIŠČIUKŲ;5767158743;Taip;7;0;0;7
2510;Gervelė;VIŠČIUKŲ;7050837754;Taip;7;0;2;9
2511;Gervelė;VIŠČIUKŲ;6228025635;Taip;0;0;1;1
2512;Gervelė;VIŠČIUKŲ;8840658383;Taip;3;0;2;5
2513;Gervelė;VIŠČIUKŲ;5685222621;Taip;0;0;2;2
2514;Gilužis;Skruzdėliukų;35511006307;Taip;7;2;1;10
2515;Gilužis;Skruzdėliukų;44807904472;Taip;4;2;0;6
2516;Gilužis;Skruzdėliukų;1671692484;Taip;0;1;0;1
2517;Gilužis;Skruzdėliukų;1615293331;Taip;0;10;0;10
2518;Gilužis;Skruzdėliukų;9474400084;Taip;0;2;0;2
2519;Gilužis;Skruzdėliukų;5161095299;Taip;2;1;0;3
2520;Gilužis;Skruzdėliukų;70959404439;Taip;2;2;0;4
2521;Gilužis;Skruzdėliukų;8120898865;Taip;2;0;0;2
2522;Gilužis;Skruzdėliukų;4611735601;Taip;10;2;0;12
2523;Gilužis;Skruzdėliukų;8595541498;Taip;0;1;0;1
2524;Gilužis;Skruzdėliukų;5365582271;Taip;15;7;0;22
2525;Gilužis;Skruzdėliukų;7364297673;Taip;17;0;0;17
2526;Gilužis;Skruzdėliukų;4362244070;Ne;0;1;0;1
2527;Gilužis;Skruzdėliukų;2093487071;Taip;9;0;2;11
2528;Gilužis;Skruzdėliukų;2042514241;Taip;0;1;0;1
2529;Gilužis;Skruzdėliukų;2218793969;Taip;18;0;0;18
2530;Gilužis;Skruzdėliukų;3216004438;Taip;0;6;0;6
2531;Gilužis;Skruzdėliukų;7766747590;Taip;0;0;1;1
2532;Gilužis;Nykštukų;94828544657;Taip;10;0;1;11
2533;Gilužis;Nykštukų;65865096435;Ne;0;3;0;3
2534;Gilužis;Nykštukų;61579959201;Taip;0;9;0;9
2535;Gilužis;Nykštukų;41863620605;Taip;0;2;0;2
2536;Gilužis;Nykštukų;10456837723;Taip;0;0;1;1
2537;Gilužis;Nykštukų;30714242097;Taip;0;0;1;1
2538;Gilužis;Nykštukų;72071736122;Taip;0;1;3;4
2539;Gilužis;Nykštukų;25086526218;Taip;8;0;0;8
2540;Gilužis;Nykštukų;37179053472;Taip;0;5;0;5
2541;Gilužis;Nykštukų;64182110384;Taip;10;12;0;22
2542;Gilužis;Nykštukų;51989833076;Taip;0;2;0;2
2543;Gilužis;Nykštukų;42894227994;Taip;0;3;0;3
2544;Gilužis;Nykštukų;36855170422;Taip;1;0;4;5
2545;Gilužis;Nykštukų;21430317293;Ne;5;0;1;6
2546;Gilužis;Nykštukų;93696234277;Taip;0;0;1;1
2547;Gilužis;Nykštukų;36105195245;Taip;0;0;8;8
2548;Gilužis;Nykštukų;2330374550;Taip;0;3;0;3
2549;Gilužis;Nykštukų;38286886127;Taip;0;0;3;3
2550;Gilužis;Nykštukų;51801100240;Taip;3;0;8;11
2551;Gilužis;Bitučių;7667792304;Taip;0;2;0;2
2552;Gilužis;Bitučių;33601993265;Taip;0;2;0;2
2553;Gilužis;Bitučių;36591400178;Taip;0;6;0;6
2554;Gilužis;Bitučių;16762351251;Taip;0;7;0;7
2555;Gilužis;Bitučių;79835099585;Taip;0;5;0;5
2556;Gilužis;Bitučių;86856314276;Taip;0;8;0;8
2557;Gilužis;Bitučių;6761901941;Taip;5;2;0;7
2558;Gilužis;Bitučių;86204525039;Taip;0;1;0;1
2559;Gilužis;Bitučių;31841898314;Taip;0;1;0;1
2560;Gilužis;Bitučių;58788039263;Taip;0;5;0;5
2561;Gilužis;Bitučių;35872947177;Taip;0;1;0;1
2562;Gilužis;Bitučių;67925251330;Taip;0;5;0;5
2563;Gilužis;Bitučių;75877736009;Taip;0;1;0;1
2564;Gilužis;Bitučių;77265792587;Taip;0;1;0;1
2565;Gilužis;Bitučių;98929035480;Taip;0;2;0;2
2566;Gilužis;Bitučių;60029145569;Taip;0;3;0;3
2567;Gilužis;Bitučių;6748923923;Taip;10;0;0;10
2568;Gilužis;Bitučių;84012597609;Ne;0;1;0;1
2569;Gilužis;Bitučių;44591290522;Taip;0;2;0;2
2570;Gilužis;Kačiukų;64044950817;Taip;2;12;0;14
2571;Gilužis;Kačiukų;97044945526;Taip;10;0;0;10
2572;Gilužis;Kačiukų;2452430134;Taip;0;2;0;2
2573;Gilužis;Kačiukų;97366385111;Taip;0;3;0;3
2574;Gilužis;Kačiukų;90653192774;Taip;6;0;0;6
2575;Gilužis;Kačiukų;43427840545;Taip;14;0;0;14
2576;Gilužis;Kačiukų;69179380194;Taip;2;0;0;2
2577;Gilužis;Kačiukų;27145205823;Taip;0;0;1;1
2578;Gilužis;Kačiukų;11999596704;Taip;0;1;0;1
2579;Gilužis;Kačiukų;40327951625;Ne;0;9;0;9
2580;Gilužis;Kačiukų;32385951346;Taip;22;0;0;22
2581;Gilužis;Kačiukų;48813257365;Ne;0;2;0;2
2582;Gilužis;Kačiukų;37836645040;Taip;0;1;0;1
2583;Gilužis;Kačiukų;90150093965;Taip;0;2;0;2
2584;Gilužis;Kačiukų;88997906780;Taip;6;0;0;6
2585;Gilužis;Kačiukų;1483999429;Taip;7;2;0;9
2586;Gilužis;Kačiukų;8442202778;Taip;5;0;0;5
2587;Gilužis;Kačiukų;1642252063;Taip;0;2;0;2
2588;Gilužis;Pelėdžiukų;28030501676;Taip;0;7;0;7
2589;Gilužis;Pelėdžiukų;5726426223;Taip;0;5;0;5
2590;Gilužis;Pelėdžiukų;16234698170;Taip;5;1;0;6
2591;Gilužis;Pelėdžiukų;67700612490;Taip;0;0;2;2
2592;Gilužis;Pelėdžiukų;61132410107;Taip;0;7;0;7
2593;Gilužis;Pelėdžiukų;62062383570;Taip;8;5;0;13
2594;Gilužis;Pelėdžiukų;79192054914;Taip;8;1;0;9
2595;Gilužis;Pelėdžiukų;53479123084;Taip;10;0;0;10
2596;Gilužis;Pelėdžiukų;22977705605;Taip;0;4;0;4
2597;Gilužis;Pelėdžiukų;23013185518;Taip;0;0;1;1
2598;Gilužis;Pelėdžiukų;50090534112;Taip;0;0;2;2
2599;Gilužis;Pelėdžiukų;48885794712;Taip;0;1;4;5
2600;Gilužis;Pelėdžiukų;65593927737;Taip;1;0;0;1
2601;Gilužis;Pelėdžiukų;55062344648;Taip;6;0;0;6
2602;Gilužis;Pelėdžiukų;4037228503;Taip;0;0;1;1
2603;Gilužis;Drugelių;78348593667;Taip;0;7;0;7
2604;Gilužis;Drugelių;73688524319;Taip;0;0;1;1
2605;Gilužis;Drugelių;9184268838;Taip;0;1;0;1
2606;Gilužis;Drugelių;48661024580;Taip;5;1;1;7
2607;Gilužis;Drugelių;23066248600;Taip;7;0;1;8
2608;Gilužis;Drugelių;1437220475;Taip;0;1;0;1
2609;Gilužis;Drugelių;32201401076;Taip;10;0;0;10
2610;Gilužis;Drugelių;49548271216;Taip;0;4;0;4
2611;Gilužis;Drugelių;70078053276;Taip;0;0;3;3
2612;Gilužis;Drugelių;34173898307;Taip;0;3;0;3
2613;Gilužis;Drugelių;67880087360;Taip;10;1;1;12
2614;Gilužis;Drugelių;28352939067;Taip;0;0;1;1
2615;Gilužis;Drugelių;73290159635;Taip;0;0;4;4
2616;Gilužis;Drugelių;36023384252;Taip;0;0;1;1
2617;Gilužis;Drugelių;86110181512;Taip;0;0;1;1
2618;Gilužis;Drugelių;44522730563;Taip;0;0;2;2
2619;Gilužis;Drugelių;1951561868;Taip;4;2;0;6
2620;Gilužis;Drugelių;1515789192;Taip;10;0;2;12
2621;Gilužis;Drugelių;3866604956;Taip;0;0;7;7
2622;Gilužis;Saulučių;17896774143;Taip;0;1;9;10
2623;Gilužis;Saulučių;9918995545;Taip;0;1;0;1
2624;Gilužis;Saulučių;4209000927;Taip;10;0;1;11
2625;Gilužis;Saulučių;4575619425;Ne;0;2;4;6
2626;Gilužis;Saulučių;8224691148;Taip;9;5;0;14
2627;Gilužis;Saulučių;4473810097;Taip;7;0;0;7
2628;Gilužis;Saulučių;1649256496;Taip;5;0;0;5
2629;Gilužis;Saulučių;96550272401;Taip;18;0;0;18
2630;Gilužis;Saulučių;69504888193;Taip;0;0;1;1
2631;Gilužis;Saulučių;2391630554;Taip;5;1;0;6
2632;Gilužis;Saulučių;18997894859;Taip;0;3;0;3
2633;Gilužis;Saulučių;7744997250;Ne;0;0;5;5
2634;Gilužis;Saulučių;32730847948;Taip;5;0;0;5
2635;Gilužis;Saulučių;3181765606;Taip;0;6;1;7
2636;Gilužis;Saulučių;5905237803;Taip;3;0;0;3
2637;Gilužis;Saulučių;79805583046;Taip;1;0;2;3
2638;Gilužis;Saulučių;2872439079;Taip;0;0;1;1
2639;Gilužis;Saulučių;28447690974;Taip;2;0;1;3
2640;Gilužis;Saulučių;35650138667;Taip;0;2;0;2
2641;Gilužis;Saulučių;9367673896;Taip;0;0;6;6
2642;Gilužis;Paukštelių;1911733577;Ne;11;1;1;13
2643;Gilužis;Paukštelių;1124568431;Ne;14;0;0;14
2644;Gilužis;Paukštelių;1120628451;Taip;0;4;0;4
2645;Gilužis;Paukštelių;1772207635;Taip;0;10;0;10
2646;Gilužis;Paukštelių;9252084783;Taip;0;1;0;1
2647;Gilužis;Paukštelių;4265465127;Taip;5;0;0;5
2648;Gilužis;Paukštelių;1797199356;Taip;0;6;0;6
2649;Gilužis;Paukštelių;93844800610;Taip;5;0;1;6
2650;Gilužis;Paukštelių;92163197528;Taip;0;8;0;8
2651;Gilužis;Paukštelių;1962922981;Taip;9;0;0;9
2652;Gilužis;Paukštelių;2769830772;Taip;0;0;1;1
2653;Gilužis;Paukštelių;1259168003;Taip;0;1;0;1
2654;Gilužis;Paukštelių;91148708775;Taip;0;0;1;1
2655;Gilužis;Paukštelių;1067512693;Taip;11;0;2;13
2656;Gilužis;Paukštelių;1413931545;Taip;5;7;0;12
2657;Gilužis;Paukštelių;4754994261;Ne;1;9;0;10
2658;Gilužis;Obuoliukų;27834192987;Taip;0;1;0;1
2659;Gilužis;Obuoliukų;5513758257;Taip;2;0;0;2
2660;Gilužis;Obuoliukų;72582220264;Taip;0;3;0;3
2661;Gilužis;Obuoliukų;1840213846;Taip;10;0;0;10
2662;Gilužis;Obuoliukų;1637726675;Taip;0;5;0;5
2663;Gilužis;Obuoliukų;1404236599;Taip;0;22;0;22
2664;Gilužis;Obuoliukų;1847232194;Taip;0;8;0;8
2665;Gilužis;Obuoliukų;93652771548;Taip;1;0;0;1
2666;Gilužis;Obuoliukų;8015495924;Taip;2;0;1;3
2667;Gilužis;Obuoliukų;96799037695;Taip;2;0;1;3
2668;Gilužis;Obuoliukų;2138402546;Taip;1;0;0;1
2669;Gilužis;Obuoliukų;1236164928;Taip;0;3;0;3
2670;Gilužis;Obuoliukų;84834458261;Taip;0;4;0;4
2671;Gilužis;Obuoliukų;5121769570;Taip;0;4;0;4
2672;Gilužis;Obuoliukų;1428994411;Taip;5;0;0;5
2673;Gilužis;Obuoliukų;5899163275;Taip;2;8;0;10
2674;Gilužis;Obuoliukų;2126527730;Taip;0;5;0;5
2675;Gilužis;Obuoliukų;53388692764;Taip;0;2;3;5
2676;Gilužis;KIŠKUČIŲ;2118119414;Taip;0;0;3;3
2677;Gilužis;KIŠKUČIŲ;1017937594;Taip;3;0;0;3
2678;Gilužis;KIŠKUČIŲ;98584480044;Taip;0;1;0;1
2679;Gilužis;KIŠKUČIŲ;1191967409;Taip;16;0;0;16
2680;Gilužis;KIŠKUČIŲ;1025400197;Taip;0;0;3;3
2681;Gilužis;KIŠKUČIŲ;1841556598;Taip;0;0;1;1
2682;Gilužis;KIŠKUČIŲ;24558082285;Taip;22;0;0;22
2683;Gilužis;KIŠKUČIŲ;31157032738;Taip;0;1;0;1
2684;Gilužis;KIŠKUČIŲ;69205729963;Taip;0;0;1;1
2685;Gilužis;KIŠKUČIŲ;1464348972;Taip;11;5;0;16
2686;Gilužis;KIŠKUČIŲ;7740703388;Taip;0;0;6;6
2687;Gilužis;KIŠKUČIŲ;1589884646;Taip;0;2;0;2
2688;Gilužis;KIŠKUČIŲ;1453976300;Taip;0;3;0;3
2689;Gilužis;KIŠKUČIŲ;57074114440;Taip;0;14;0;14
2690;Gilužis;KIŠKUČIŲ;1307302669;Taip;0;0;8;8
2691;Gilužis;KIŠKUČIŲ;1569805585;Taip;0;0;2;2
2692;Gilužis;KIŠKUČIŲ;1211233315;Taip;0;0;2;2
2693;Gilužis;Meškučių;9104396905;Taip;0;10;1;11
2694;Gilužis;Meškučių;15672746324;Taip;2;0;0;2
2695;Gilužis;Meškučių;5988529284;Ne;8;0;3;11
2696;Gilužis;Meškučių;2144919007;Taip;0;1;0;1
2697;Gilužis;Meškučių;6840555273;Taip;0;6;0;6
2698;Gilužis;Meškučių;1664140841;Taip;0;2;0;2
2699;Gilužis;Meškučių;1201973661;Taip;0;8;0;8
2700;Gilužis;Meškučių;99889836604;Taip;7;0;0;7
2701;Gilužis;Meškučių;93541096118;Taip;0;5;0;5
2702;Gilužis;Meškučių;41791785706;Ne;0;22;0;22
2703;Gilužis;Meškučių;3104707033;Ne;8;0;0;8
2704;Gilužis;Meškučių;3884351522;Ne;3;0;0;3
2705;Gilužis;Meškučių;1003733551;Taip;0;0;2;2
2706;Gilužis;Meškučių;41887832166;Taip;3;0;0;3
2707;Gilužis;Meškučių;57285847418;Taip;0;3;0;3
2708;Gilužis;Meškučių;37771334557;Taip;0;11;0;11
2709;Gilužis;Meškučių;3451034791;Ne;0;22;0;22
2710;Gilužis;Pagrandukai;7937643339;Taip;0;1;0;1
2711;Gilužis;Pagrandukai;3132445117;Taip;10;1;0;11
2712;Gilužis;Pagrandukai;8899557365;Taip;19;0;0;19
2713;Gilužis;Pagrandukai;2661894041;Taip;22;0;0;22
2714;Gilužis;Pagrandukai;5109935385;Taip;13;2;0;15
2715;Gilužis;Pagrandukai;3335512812;Taip;6;0;0;6
2716;Gilužis;Pagrandukai;6093514885;Taip;10;7;0;17
2717;Gilužis;Pagrandukai;4156613717;Taip;4;0;0;4
2718;Gilužis;Pagrandukai;5713786735;Ne;12;0;0;12
2719;Gilužis;Pagrandukai;2784416935;Taip;0;16;0;16
2720;Gilužis;Pagrandukai;6315155554;Taip;4;2;0;6
2721;Gilužis;Pagrandukai;1146713023;Taip;0;3;0;3
2722;Gilužis;Pagrandukai;9362581908;Taip;18;0;0;18
2723;Gilužis;Pagrandukai;3473889426;Taip;18;0;0;18
2724;Gilužis;Pagrandukai;7228498662;Taip;13;0;0;13
2725;Gilužis;Pagrandukai;1459273692;Taip;0;1;0;1
2726;Gilužis;Boružėlių;9421351780;Taip;6;0;1;7
2727;Gilužis;Boružėlių;9332056404;Taip;9;5;1;15
2728;Gilužis;Boružėlių;7810223775;Taip;0;22;0;22
2729;Gilužis;Boružėlių;3258640163;Taip;0;22;0;22
2730;Gilužis;Boružėlių;7742783427;Taip;20;0;0;20
2731;Gilužis;Boružėlių;7998695149;Taip;20;0;0;20
2732;Gilužis;Boružėlių;9833451628;Taip;0;3;0;3
2733;Gilužis;Boružėlių;6404411477;Taip;10;1;0;11
2734;Gilužis;Boružėlių;1222370750;Taip;0;1;0;1
2735;Gilužis;Boružėlių;5217748032;Ne;4;2;0;6
2736;Gilužis;Boružėlių;7358572344;Taip;5;1;0;6
2737;Gilužis;Boružėlių;4617259961;Taip;3;0;0;3
2738;Gilužis;Boružėlių;9186274541;Taip;11;0;0;11
2739;Gilužis;Boružėlių;6121625070;Taip;0;22;0;22
2740;Gilužis;Boružėlių;3419281756;Taip;5;0;0;5
2741;Gilužis;Boružėlių;4403218878;Taip;6;1;0;7
2742;Gilužis;Boružėlių;5989314494;Taip;5;0;1;6
2743;Gilužis;Boružėlių;6270071724;Taip;13;0;0;13
2744;Gintarėlis;PAPŪGĖLĖS;32751650045;Taip;0;1;0;1
2745;Gintarėlis;PAPŪGĖLĖS;3100442808;Taip;0;14;0;14
2746;Gintarėlis;PAPŪGĖLĖS;41950550071;Taip;0;2;0;2
2747;Gintarėlis;PAPŪGĖLĖS;36019373990;Ne;0;1;0;1
2748;Gintarėlis;PAPŪGĖLĖS;47480197789;Taip;10;9;0;19
2749;Gintarėlis;PAPŪGĖLĖS;96134869997;Taip;10;0;0;10
2750;Gintarėlis;PAPŪGĖLĖS;62371949439;Taip;0;6;0;6
2751;Gintarėlis;PAPŪGĖLĖS;25360163411;Taip;0;18;0;18
2752;Gintarėlis;PAPŪGĖLĖS;74116167225;Taip;0;0;2;2
2753;Gintarėlis;PAPŪGĖLĖS;45279808861;Taip;0;7;0;7
2754;Gintarėlis;PAPŪGĖLĖS;7610677403;Ne;3;2;1;6
2755;Gintarėlis;PAPŪGĖLĖS;43183534908;Taip;0;0;2;2
2756;Gintarėlis;PAPŪGĖLĖS;2529363136;Taip;0;0;1;1
2757;Gintarėlis;PAPŪGĖLĖS;1943647795;Taip;0;12;0;12
2758;Gintarėlis;PAPŪGĖLĖS;6541323688;Taip;0;1;0;1
2759;Gintarėlis;SPINDULIUKAI;96694096944;Taip;0;13;0;13
2760;Gintarėlis;SPINDULIUKAI;58118782421;Taip;3;0;0;3
2761;Gintarėlis;SPINDULIUKAI;33863655816;Taip;2;2;0;4
2762;Gintarėlis;SPINDULIUKAI;11384063236;Taip;0;9;0;9
2763;Gintarėlis;SPINDULIUKAI;99077732058;Taip;0;16;0;16
2764;Gintarėlis;SPINDULIUKAI;27532374357;Taip;0;5;0;5
2765;Gintarėlis;SPINDULIUKAI;8112379741;Ne;0;8;4;12
2766;Gintarėlis;SPINDULIUKAI;37848651606;Taip;0;9;1;10
2767;Gintarėlis;SPINDULIUKAI;56701557907;Ne;5;2;1;8
2768;Gintarėlis;SPINDULIUKAI;77140073438;Taip;0;1;0;1
2769;Gintarėlis;SPINDULIUKAI;484847222;Taip;0;1;0;1
2770;Gintarėlis;SPINDULIUKAI;18570638516;Taip;0;6;0;6
2771;Gintarėlis;SPINDULIUKAI;29392171144;Taip;0;12;0;12
2772;Gintarėlis;SPINDULIUKAI;92436759875;Taip;0;8;0;8
2773;Gintarėlis;SPINDULIUKAI;1360843628;Taip;0;9;1;10
2774;Gintarėlis;SPINDULIUKAI;6452806962;Taip;3;6;0;9
2775;Gintarėlis;SPINDULIUKAI;63037561278;Taip;0;8;0;8
2776;Gintarėlis;SPINDULIUKAI;77591601744;Taip;0;0;3;3
2777;Gintarėlis;SPINDULIUKAI;19506557567;Ne;4;0;0;4
2778;Gintarėlis;SPINDULIUKAI;24915581271;Taip;0;6;1;7
2779;Gintarėlis;SPINDULIUKAI;1076400051;Taip;0;8;0;8
2780;Gintarėlis;LAŠIUKAI;6893183889;Taip;0;1;0;1
2781;Gintarėlis;LAŠIUKAI;5880091191;Taip;0;1;0;1
2782;Gintarėlis;LAŠIUKAI;9584956349;Taip;0;5;9;14
2783;Gintarėlis;LAŠIUKAI;94354056029;Taip;2;3;0;5
2784;Gintarėlis;LAŠIUKAI;78359050717;Taip;0;1;0;1
2785;Gintarėlis;LAŠIUKAI;6457288028;Taip;0;1;0;1
2786;Gintarėlis;LAŠIUKAI;1002155392;Taip;10;5;0;15
2787;Gintarėlis;LAŠIUKAI;96416364735;Taip;2;1;0;3
2788;Gintarėlis;LAŠIUKAI;3504738389;Taip;0;2;0;2
2789;Gintarėlis;LAŠIUKAI;9130659549;Taip;10;5;0;15
2790;Gintarėlis;LAŠIUKAI;1809511815;Taip;0;2;10;12
2791;Gintarėlis;LAŠIUKAI;4660854883;Taip;0;1;0;1
2792;Gintarėlis;LAŠIUKAI;3799412062;Ne;0;1;0;1
2793;Gintarėlis;LAŠIUKAI;25210675029;Taip;10;1;0;11
2794;Gintarėlis;LAŠIUKAI;7192722296;Taip;0;8;0;8
2795;Gintarėlis;LAŠIUKAI;9040480798;Taip;0;5;0;5
2796;Gintarėlis;LAŠIUKAI;8055928882;Taip;0;22;0;22
2797;Gintarėlis;LAŠIUKAI;7644607132;Taip;8;3;1;12
2798;Gintarėlis;LAŠIUKAI;2088008759;Taip;0;6;8;14
2799;Gintarėlis;GAIDŽIUKAI;61360761151;Taip;0;3;0;3
2800;Gintarėlis;GAIDŽIUKAI;12332079305;Taip;5;6;0;11
2801;Gintarėlis;GAIDŽIUKAI;29645999843;Taip;0;2;0;2
2802;Gintarėlis;GAIDŽIUKAI;2099549218;Taip;0;9;0;9
2803;Gintarėlis;GAIDŽIUKAI;28514742083;Taip;0;4;0;4
2804;Gintarėlis;GAIDŽIUKAI;86948612054;Taip;0;2;0;2
2805;Gintarėlis;GAIDŽIUKAI;45480802894;Taip;0;9;1;10
2806;Gintarėlis;GAIDŽIUKAI;1539226211;Taip;0;17;0;17
2807;Gintarėlis;GAIDŽIUKAI;2043878016;Taip;0;9;0;9
2808;Gintarėlis;GAIDŽIUKAI;90891401453;Ne;0;10;0;10
2809;Gintarėlis;GAIDŽIUKAI;1770479969;Taip;0;3;0;3
2810;Gintarėlis;GAIDŽIUKAI;29331294396;Taip;0;11;0;11
2811;Gintarėlis;GAIDŽIUKAI;1799002086;Taip;0;4;0;4
2812;Gintarėlis;GAIDŽIUKAI;33714823189;Taip;0;4;0;4
2813;Gintarėlis;GAIDŽIUKAI;33786299764;Taip;0;3;0;3
2814;Gintarėlis;GAIDŽIUKAI;1441282039;Taip;0;1;0;1
2815;Gintarėlis;GAIDŽIUKAI;5835437020;Ne;4;8;0;12
2816;Gintarėlis;MEŠKUČIAI;46036221870;Taip;3;0;0;3
2817;Gintarėlis;MEŠKUČIAI;72954464555;Taip;0;3;0;3
2818;Gintarėlis;MEŠKUČIAI;74741949593;Taip;0;5;0;5
2819;Gintarėlis;MEŠKUČIAI;1684735692;Taip;0;8;0;8
2820;Gintarėlis;MEŠKUČIAI;5988536057;Ne;0;2;0;2
2821;Gintarėlis;MEŠKUČIAI;92253181137;Taip;0;3;0;3
2822;Gintarėlis;MEŠKUČIAI;37758004138;Taip;0;2;0;2
2823;Gintarėlis;MEŠKUČIAI;89600903751;Taip;0;6;0;6
2824;Gintarėlis;MEŠKUČIAI;26403359331;Ne;0;2;1;3
2825;Gintarėlis;MEŠKUČIAI;33678587696;Taip;0;6;0;6
2826;Gintarėlis;MEŠKUČIAI;77834528801;Taip;0;4;0;4
2827;Gintarėlis;MEŠKUČIAI;47309634627;Taip;0;2;0;2
2828;Gintarėlis;MEŠKUČIAI;49921116417;Taip;0;10;0;10
2829;Gintarėlis;MEŠKUČIAI;85312459968;Taip;0;16;0;16
2830;Gintarėlis;MEŠKUČIAI;49473761753;Taip;0;1;0;1
2831;Gintarėlis;MEŠKUČIAI;89450049559;Taip;0;18;0;18
2832;Gintarėlis;MEŠKUČIAI;6242733673;Ne;4;1;0;5
2833;Gintarėlis;MEŠKUČIAI;48793702146;Taip;0;3;0;3
2834;Gintarėlis;MEŠKUČIAI;49079274803;Ne;6;3;0;9
2835;Gintarėlis;MEŠKUČIAI;16507384915;Taip;0;2;0;2
2836;Gintarėlis;MEŠKUČIAI;58918505824;Taip;0;3;0;3
2837;Gintarėlis;MEŠKUČIAI;40605918843;Ne;0;1;0;1
2838;Gintarėlis;DRUGELIAI;14840692502;Ne;0;2;0;2
2839;Gintarėlis;DRUGELIAI;1462949250;Taip;0;9;3;12
2840;Gintarėlis;DRUGELIAI;9737200226;Taip;0;4;0;4
2841;Gintarėlis;DRUGELIAI;6655809299;Taip;5;6;0;11
2842;Gintarėlis;DRUGELIAI;2614258442;Taip;0;9;0;9
2843;Gintarėlis;DRUGELIAI;1452402931;Taip;0;7;0;7
2844;Gintarėlis;DRUGELIAI;4217329880;Ne;0;7;0;7
2845;Gintarėlis;DRUGELIAI;7571352126;Taip;7;3;0;10
2846;Gintarėlis;DRUGELIAI;50896429585;Taip;0;3;0;3
2847;Gintarėlis;DRUGELIAI;1042222561;Taip;5;1;0;6
2848;Gintarėlis;DRUGELIAI;1331684725;Ne;0;2;0;2
2849;Gintarėlis;DRUGELIAI;9687974376;Taip;15;7;0;22
2850;Gintarėlis;DRUGELIAI;8704248985;Taip;0;16;0;16
2851;Gintarėlis;DRUGELIAI;8419453060;Taip;0;4;1;5
2852;Gintarėlis;DRUGELIAI;6655645997;Taip;10;7;0;17
2853;Gintarėlis;DRUGELIAI;6080108998;Taip;10;7;0;17
2854;Gintarėlis;DRUGELIAI;7449437199;Taip;0;1;0;1
2855;Gintarėlis;DRUGELIAI;4076421692;Ne;5;3;0;8
2856;Gintarėlis;DRUGELIAI;2016067859;Taip;0;3;1;4
2857;Gintarėlis;DRUGELIAI;5355691986;Taip;0;7;0;7
2858;Gintarėlis;KAČIUKAI;9903314418;Taip;0;2;0;2
2859;Gintarėlis;KAČIUKAI;37612987791;Taip;0;1;0;1
2860;Gintarėlis;KAČIUKAI;26259581924;Taip;0;8;0;8
2861;Gintarėlis;KAČIUKAI;70787488885;Ne;4;1;0;5
2862;Gintarėlis;KAČIUKAI;50715082496;Taip;0;4;0;4
2863;Gintarėlis;KAČIUKAI;1159773367;Taip;0;8;0;8
2864;Gintarėlis;KAČIUKAI;1124481108;Ne;0;1;0;1
2865;Gintarėlis;KAČIUKAI;2050020230;Taip;0;5;0;5
2866;Gintarėlis;KAČIUKAI;54145290842;Taip;0;22;0;22
2867;Gintarėlis;KAČIUKAI;19813827223;Taip;0;2;0;2
2868;Gintarėlis;KAČIUKAI;98684742007;Ne;0;22;0;22
2869;Gintarėlis;KAČIUKAI;2000986290;Taip;0;8;0;8
2870;Gintarėlis;KAČIUKAI;6421537455;Taip;0;22;0;22
2871;Gintarėlis;KAČIUKAI;1595816431;Taip;10;3;0;13
2872;Gintarėlis;KAČIUKAI;30446888177;Taip;0;4;0;4
2873;Gintarėlis;KAČIUKAI;63221497564;Taip;0;1;0;1
2874;Gintarėlis;KAČIUKAI;58701768194;Taip;0;8;0;8
2875;Gintarėlis;KAČIUKAI;29480359781;Ne;0;8;3;11
2876;Gintarėlis;KIŠKUČIAI;8665467175;Taip;0;2;0;2
2877;Gintarėlis;KIŠKUČIAI;83754732536;Taip;0;5;0;5
2878;Gintarėlis;KIŠKUČIAI;89051269756;Ne;0;11;0;11
2879;Gintarėlis;KIŠKUČIAI;1642627920;Taip;0;10;0;10
2880;Gintarėlis;KIŠKUČIAI;1593455162;Taip;0;4;0;4
2881;Gintarėlis;KIŠKUČIAI;2043405414;Taip;0;5;0;5
2882;Gintarėlis;KIŠKUČIAI;3828845515;Taip;0;3;0;3
2883;Gintarėlis;KIŠKUČIAI;19402011412;Taip;0;1;0;1
2884;Gintarėlis;KIŠKUČIAI;96211766919;Taip;0;1;0;1
2885;Gintarėlis;KIŠKUČIAI;78697777550;Taip;13;0;0;13
2886;Gintarėlis;KIŠKUČIAI;2970527490;Ne;3;2;0;5
2887;Gintarėlis;KIŠKUČIAI;4279681763;Taip;0;1;0;1
2888;Gintarėlis;KIŠKUČIAI;1868431609;Ne;0;11;3;14
2889;Gintarėlis;KIŠKUČIAI;2032900352;Taip;2;0;0;2
2890;Gintarėlis;KIŠKUČIAI;1543013649;Taip;7;12;0;19
2891;Gintarėlis;KIŠKUČIAI;24774460882;Taip;0;1;0;1
2892;Gintarėlis;KIŠKUČIAI;1028456578;Taip;10;1;0;11
2893;Gintarėlis;VYTURIUKAI;1553747935;Taip;1;19;0;20
2894;Gintarėlis;VYTURIUKAI;56124970238;Taip;0;6;0;6
2895;Gintarėlis;VYTURIUKAI;34606130829;Taip;0;10;0;10
2896;Gintarėlis;VYTURIUKAI;21658913551;Taip;0;2;2;4
2897;Gintarėlis;VYTURIUKAI;18715625324;Ne;0;2;1;3
2898;Gintarėlis;VYTURIUKAI;9740239182;Taip;0;16;0;16
2899;Gintarėlis;VYTURIUKAI;2036488789;Taip;7;0;0;7
2900;Gintarėlis;VYTURIUKAI;2721386855;Taip;0;1;0;1
2901;Gintarėlis;BORUŽĖLĖS;4971574875;Taip;0;6;0;6
2902;Gintarėlis;BORUŽĖLĖS;6277010268;Taip;10;0;0;10
2903;Gintarėlis;BORUŽĖLĖS;1771868868;Ne;0;8;0;8
2904;Gintarėlis;BORUŽĖLĖS;39372328122;Taip;0;1;0;1
2905;Gintarėlis;BORUŽĖLĖS;25451522701;Taip;17;1;0;18
2906;Gintarėlis;BORUŽĖLĖS;90216120878;Taip;0;19;0;19
2907;Gintarėlis;BORUŽĖLĖS;1929900615;Taip;5;1;0;6
2908;Gintarėlis;BORUŽĖLĖS;82344200095;Taip;0;7;0;7
2909;Gintarėlis;BORUŽĖLĖS;1168158494;Taip;5;1;0;6
2910;Gintarėlis;BORUŽĖLĖS;9255623049;Taip;0;11;0;11
2911;Gintarėlis;BORUŽĖLĖS;88451515187;Taip;0;3;0;3
2912;Gintarėlis;BORUŽĖLĖS;7703150488;Taip;0;6;0;6
2913;Gintarėlis;BORUŽĖLĖS;2145479870;Taip;0;1;0;1
2914;Gintarėlis;BORUŽĖLĖS;49506158711;Ne;0;1;0;1
2915;Gintarėlis;BORUŽĖLĖS;30066476338;Taip;0;3;0;3
2916;Gintarėlis;BORUŽĖLĖS;10001742134;Taip;0;2;0;2
2917;Gintarėlis;BORUŽĖLĖS;63146841406;Taip;0;22;0;22
2918;Gintarėlis;BORUŽĖLĖS;30334064319;Taip;0;1;0;1
2919;Gintarėlis;BORUŽĖLĖS;6426075546;Taip;0;3;0;3
2920;Gintarėlis;BORUŽĖLĖS;91798408335;Taip;0;17;0;17
2921;Gintarėlis;BORUŽĖLĖS;25684002087;Taip;0;2;0;2
2922;Gintarėlis;BORUŽĖLĖS;10826255781;Taip;0;4;0;4
2923;Gintarėlis;BORUŽĖLĖS;1505703905;Taip;0;2;0;2
2924;Gintarėlis;EŽIUKAI;1793785936;Ne;0;6;2;8
2925;Gintarėlis;EŽIUKAI;5464804183;Taip;0;1;2;3
2926;Gintarėlis;EŽIUKAI;1856031326;Taip;0;5;0;5
2927;Gintarėlis;EŽIUKAI;96812991513;Taip;6;7;0;13
2928;Gintarėlis;EŽIUKAI;27890184523;Taip;0;10;0;10
2929;Gintarėlis;EŽIUKAI;1841482183;Taip;0;2;1;3
2930;Gintarėlis;EŽIUKAI;8074941282;Taip;2;1;0;3
2931;Gintarėlis;EŽIUKAI;2040989572;Taip;0;7;1;8
2932;Gintarėlis;EŽIUKAI;18008015227;Taip;0;3;0;3
2933;Gintarėlis;EŽIUKAI;1312688961;Taip;6;0;5;11
2934;Gintarėlis;EŽIUKAI;1672037617;Taip;0;1;0;1
2935;Gintarėlis;EŽIUKAI;51418692259;Taip;3;1;0;4
2936;Gintarėlis;EŽIUKAI;74295947670;Taip;0;1;0;1
2937;Gintarėlis;EŽIUKAI;52644122529;Taip;0;8;0;8
2938;Gintarėlis;EŽIUKAI;2732338838;Taip;0;2;1;3
2939;Gintarėlis;EŽIUKAI;7731823367;Taip;0;6;0;6
2940;Gintarėlis;EŽIUKAI;7053099543;Taip;0;8;0;8
2941;Gintarėlis;EŽIUKAI;56834651967;Taip;0;22;0;22
2942;Gintarėlis;EŽIUKAI;9705808868;Taip;0;1;0;1
2943;Gintarėlis;EŽIUKAI;13416505188;Taip;10;7;1;18
2944;Gintarėlis;EŽIUKAI;36350623756;Taip;5;0;0;5
2945;Gintarėlis;EŽIUKAI;96404879029;Taip;0;17;0;17
2946;Gintarėlis;EŽIUKAI;1725007540;Ne;6;0;0;6
2947;Gintarėlis;VIŠČIUKAI;7494884360;Taip;0;10;0;10
2948;Gintarėlis;VIŠČIUKAI;8064521864;Taip;0;8;1;9
2949;Gintarėlis;VIŠČIUKAI;8913652291;Taip;0;0;2;2
2950;Gintarėlis;VIŠČIUKAI;1033624080;Ne;0;13;1;14
2951;Gintarėlis;VIŠČIUKAI;2919700367;Taip;0;9;13;22
2952;Gintarėlis;VIŠČIUKAI;1768789948;Taip;5;0;0;5
2953;Gintarėlis;VIŠČIUKAI;2235045173;Taip;0;7;0;7
2954;Gintarėlis;VIŠČIUKAI;9494521554;Taip;0;10;0;10
2955;Gintarėlis;VIŠČIUKAI;7147842224;Taip;0;1;3;4
2956;Gintarėlis;VIŠČIUKAI;7674351459;Taip;1;6;0;7
2957;Gintarėlis;VIŠČIUKAI;2485750596;Taip;0;9;0;9
2958;Gintarėlis;VIŠČIUKAI;2595566032;Taip;0;1;0;1
2959;Gintarėlis;VIŠČIUKAI;9141438560;Taip;0;1;0;1
2960;Gintarėlis;VIŠČIUKAI;9648982613;Taip;3;3;0;6
2961;Gintarėlis;VIŠČIUKAI;6292664833;Taip;0;2;0;2
2962;Gintarėlis;"SAULĖS ZUIKUČIAI";8287685690;Taip;0;12;0;12
2963;Gintarėlis;"SAULĖS ZUIKUČIAI";6914904213;Taip;0;8;0;8
2964;Gintarėlis;"SAULĖS ZUIKUČIAI";1696337909;Taip;0;8;0;8
2965;Gintarėlis;"SAULĖS ZUIKUČIAI";1778573935;Taip;0;3;0;3
2966;Gintarėlis;"SAULĖS ZUIKUČIAI";5796729245;Taip;0;12;0;12
2967;Gintarėlis;"SAULĖS ZUIKUČIAI";9915887420;Taip;0;12;0;12
2968;Gintarėlis;"SAULĖS ZUIKUČIAI";3398936974;Ne;6;7;0;13
2969;Gintarėlis;"SAULĖS ZUIKUČIAI";5153948767;Taip;7;1;0;8
2970;Gintarėlis;"SAULĖS ZUIKUČIAI";9675201979;Taip;8;9;0;17
2971;Gintarėlis;"SAULĖS ZUIKUČIAI";7971810025;Ne;5;10;0;15
2972;Gintarėlis;"SAULĖS ZUIKUČIAI";2814569415;Taip;0;7;3;10
2973;Gintarėlis;"SAULĖS ZUIKUČIAI";6862629244;Ne;10;8;0;18
2974;Gintarėlis;"SAULĖS ZUIKUČIAI";9279399214;Ne;0;5;0;5
2975;Gintarėlis;"SAULĖS ZUIKUČIAI";8000297636;Taip;0;7;4;11
2976;Gintarėlis;"SAULĖS ZUIKUČIAI";6142819210;Taip;0;2;5;7
2977;Gintarėlis;"SAULĖS ZUIKUČIAI";3359584322;Taip;4;6;1;11
2978;Gintarėlis;"SAULĖS ZUIKUČIAI";7815317644;Taip;0;5;0;5
2979;Giraitė;Aviliukas;67009533810;Ne;0;6;0;6
2980;Giraitė;Aviliukas;68804588518;Taip;0;11;0;11
2981;Giraitė;Aviliukas;809734624;Taip;0;5;0;5
2982;Giraitė;Aviliukas;44396075745;Taip;0;6;0;6
2983;Giraitė;Aviliukas;42330865487;Taip;4;0;0;4
2984;Giraitė;Aviliukas;67108509429;Taip;0;8;0;8
2985;Giraitė;Aviliukas;86412433313;Taip;3;0;0;3
2986;Giraitė;Aviliukas;10778161174;Taip;0;2;0;2
2987;Giraitė;Aviliukas;6449275481;Taip;6;0;0;6
2988;Giraitė;Aviliukas;37348466498;Taip;0;2;0;2
2989;Giraitė;Aviliukas;12568042778;Taip;13;0;0;13
2990;Giraitė;Aviliukas;32804353567;Taip;4;0;0;4
2991;Giraitė;Aviliukas;24903085449;Taip;0;11;0;11
2992;Giraitė;Aviliukas;7868564343;Taip;0;7;0;7
2993;Giraitė;Aviliukas;6084454238;Taip;0;5;0;5
2994;Giraitė;LapiukaI;42953220489;Taip;9;1;0;10
2995;Giraitė;LapiukaI;1285310492;Taip;7;0;0;7
2996;Giraitė;LapiukaI;17883856522;Taip;0;1;0;1
2997;Giraitė;LapiukaI;79459838218;Taip;0;2;0;2
2998;Giraitė;LapiukaI;1690407683;Taip;5;9;0;14
2999;Giraitė;LapiukaI;94357968497;Taip;5;1;0;6
3000;Giraitė;LapiukaI;1146337878;Ne;11;0;1;12
3001;Giraitė;LapiukaI;1424661991;Taip;9;0;0;9
3002;Giraitė;LapiukaI;9710265790;Taip;0;2;0;2
3003;Giraitė;LapiukaI;26202357668;Taip;2;2;0;4
3004;Giraitė;LapiukaI;260305509;Taip;3;0;0;3
3005;Giraitė;LapiukaI;84373081236;Taip;1;0;0;1
3006;Giraitė;LapiukaI;9493194946;Taip;0;1;0;1
3007;Giraitė;LapiukaI;89948210310;Taip;0;2;0;2
3008;Giraitė;LapiukaI;22783526738;Taip;0;0;4;4
3009;Giraitė;Voveriukai;83995022535;Taip;5;0;1;6
3010;Giraitė;Voveriukai;19151459055;Taip;0;1;2;3
3011;Giraitė;Voveriukai;37416923466;Taip;0;0;1;1
3012;Giraitė;Voveriukai;70629522964;Taip;22;0;0;22
3013;Giraitė;Voveriukai;10070775660;Taip;3;0;1;4
3014;Giraitė;Voveriukai;68502311448;Taip;0;1;0;1
3015;Giraitė;Voveriukai;34413917793;Ne;0;0;6;6
3016;Giraitė;Voveriukai;1458304464;Taip;0;3;0;3
3017;Giraitė;Voveriukai;48623826572;Taip;0;0;1;1
3018;Giraitė;Voveriukai;482311593;Taip;22;0;0;22
3019;Giraitė;Voveriukai;10108398683;Taip;0;1;3;4
3020;Giraitė;Voveriukai;19218675078;Ne;0;0;2;2
3021;Giraitė;Voveriukai;61477798910;Taip;4;2;0;6
3022;Giraitė;Voveriukai;20082610200;Ne;5;5;0;10
3023;Giraitė;Voveriukai;2107606245;Taip;7;0;0;7
3024;Giraitė;Voveriukai;2816941652;Taip;0;5;0;5
3025;Giraitė;Voveriukai;1313395982;Ne;10;6;0;16
3026;Giraitė;Voveriukai;5824936903;Taip;0;2;0;2
3027;Giraitė;Voveriukai;1965752607;Ne;0;8;0;8
3028;Giraitė;Grybukai;82326314822;Ne;0;0;1;1
3029;Giraitė;Grybukai;65817530256;Ne;0;1;0;1
3030;Giraitė;Grybukai;64804371570;Taip;3;0;0;3
3031;Giraitė;Grybukai;44781582045;Taip;0;2;0;2
3032;Giraitė;Grybukai;2088558056;Taip;0;5;1;6
3033;Giraitė;Grybukai;47716066947;Ne;0;0;1;1
3034;Giraitė;Grybukai;70833551710;Taip;0;0;4;4
3035;Giraitė;Grybukai;40223017870;Taip;0;2;0;2
3036;Giraitė;Grybukai;98893791966;Taip;0;3;0;3
3037;Giraitė;Grybukai;38156994332;Taip;0;7;0;7
3038;Giraitė;Grybukai;1791880914;Taip;0;0;6;6
3039;Giraitė;Grybukai;47131903191;Taip;0;6;0;6
3040;Giraitė;Grybukai;16962877902;Taip;0;5;0;5
3041;Giraitė;Grybukai;1354740688;Ne;1;0;0;1
3042;Giraitė;Riešutėliai;3683700626;Taip;5;0;0;5
3043;Giraitė;Riešutėliai;5167002022;Taip;0;22;0;22
3044;Giraitė;Riešutėliai;2425354598;Taip;0;0;1;1
3045;Giraitė;Riešutėliai;9495968363;Taip;11;0;0;11
3046;Giraitė;Riešutėliai;1253151830;Taip;11;0;0;11
3047;Giraitė;Riešutėliai;5892950503;Taip;0;1;0;1
3048;Giraitė;Riešutėliai;4336519836;Taip;8;0;0;8
3049;Giraitė;Riešutėliai;9026736929;Taip;2;1;0;3
3050;Giraitė;Riešutėliai;9882372025;Taip;7;0;3;10
3051;Giraitė;Riešutėliai;5721669627;Taip;5;0;0;5
3052;Giraitė;Riešutėliai;3091067158;Taip;4;0;0;4
3053;Giraitė;Riešutėliai;23319979302;Taip;0;10;0;10
3054;Giraitė;Riešutėliai;4785524898;Taip;5;3;0;8
3055;Giraitė;Riešutėliai;8869728241;Taip;2;0;0;2
3056;Giraitė;Riešutėliai;4839351300;Taip;5;5;6;16
3057;Giraitė;Riešutėliai;1817075429;Taip;7;0;5;12
3058;Giraitė;Riešutėliai;9224845723;Taip;6;0;0;6
3059;Giraitė;Riešutėliai;4687228561;Ne;10;0;0;10
3060;Giraitė;Riešutėliai;9652807467;Taip;15;0;1;16
3061;Giraitė;Meškiukai;27501094616;Taip;4;3;0;7
3062;Giraitė;Meškiukai;2513312448;Taip;5;1;0;6
3063;Giraitė;Meškiukai;5367392810;Taip;0;3;0;3
3064;Giraitė;Meškiukai;1608876140;Taip;4;0;0;4
3065;Giraitė;Meškiukai;5461837332;Taip;0;5;0;5
3066;Giraitė;Meškiukai;1355594003;Taip;0;4;0;4
3067;Giraitė;Meškiukai;1050699551;Taip;22;0;0;22
3068;Giraitė;Meškiukai;1876815077;Taip;0;5;0;5
3069;Giraitė;Meškiukai;1063628206;Taip;0;6;0;6
3070;Giraitė;Meškiukai;1318214394;Taip;4;0;6;10
3071;Giraitė;Meškiukai;1846118720;Taip;0;1;0;1
3072;Giraitė;Meškiukai;9195735923;Taip;2;0;1;3
3073;Giraitė;Meškiukai;65251975467;Taip;3;0;0;3
3074;Giraitė;Meškiukai;1704154980;Taip;4;0;0;4
3075;Giraitė;Meškiukai;1819657811;Taip;2;1;0;3
3076;Giraitė;Meškiukai;1512384599;Taip;2;0;0;2
3077;Giraitė;Meškiukai;2571892050;Taip;0;0;3;3
3078;Giraitė;Meškiukai;5544613599;Taip;2;12;0;14
3079;Giraitė;Meškiukai;6156715234;Taip;1;0;1;2
3080;Giraitė;Meškiukai;1594965200;Taip;0;0;1;1
3081;Giraitė;Meškiukai;9723242940;Taip;10;0;0;10
3082;Giraitė;Meškiukai;5726182600;Taip;8;0;0;8
3083;Giraitė;Meškiukai;1772790396;Taip;11;0;0;11
3084;Giraitė;Uogelės;3031181239;Taip;0;0;1;1
3085;Giraitė;Uogelės;99494458394;Taip;0;3;0;3
3086;Giraitė;Uogelės;1103462199;Taip;1;1;0;2
3087;Giraitė;Uogelės;1447893912;Taip;0;1;0;1
3088;Giraitė;Uogelės;49193108666;Ne;5;5;0;10
3089;Giraitė;Uogelės;1312761239;Taip;0;1;0;1
3090;Giraitė;Uogelės;43475840493;Taip;3;1;0;4
3091;Giraitė;Uogelės;30804922053;Taip;1;5;0;6
3092;Giraitė;Uogelės;2083472940;Taip;10;0;0;10
3093;Giraitė;Uogelės;5378240128;Taip;0;13;0;13
3094;Giraitė;Uogelės;40696452801;Taip;0;2;0;2
3095;Giraitė;Uogelės;74256775397;Ne;12;5;0;17
3096;Giraitė;Uogelės;65392345188;Taip;0;5;0;5
3097;Giraitė;Uogelės;7779733510;Taip;3;0;0;3
3098;Giraitė;Uogelės;1110792632;Taip;4;0;0;4
3099;Giraitė;Šaltinėlis;83173577451;Taip;7;3;0;10
3100;Giraitė;Šaltinėlis;89112366792;Taip;0;2;2;4
3101;Giraitė;Šaltinėlis;29823126743;Ne;0;4;0;4
3102;Giraitė;Šaltinėlis;85943562009;Taip;0;3;0;3
3103;Giraitė;Šaltinėlis;8636782322;Taip;0;2;0;2
3104;Giraitė;Šaltinėlis;29419658963;Taip;2;0;0;2
3105;Giraitė;Šaltinėlis;23443952589;Taip;2;0;3;5
3106;Giraitė;Šaltinėlis;13537474624;Taip;0;4;0;4
3107;Giraitė;Šaltinėlis;74821326426;Taip;3;1;0;4
3108;Giraitė;Šaltinėlis;78338863066;Taip;5;1;0;6
3109;Giraitė;Šaltinėlis;5106092595;Taip;0;2;2;4
3110;Giraitė;Šaltinėlis;18070708999;Taip;1;1;0;2
3111;Giraitė;Šaltinėlis;83199904684;Taip;0;1;0;1
3112;Giraitė;Šaltinėlis;72098612565;Taip;0;5;0;5
3113;Giraitė;Šaltinėlis;94197982724;Taip;0;4;0;4
3114;Giraitė;Šaltinėlis;25319015890;Ne;0;1;4;5
3115;Giraitė;Boružėlės;5438716880;Taip;0;19;0;19
3116;Giraitė;Boružėlės;4055450300;Taip;8;7;0;15
3117;Giraitė;Boružėlės;4387282125;Taip;9;0;0;9
3118;Giraitė;Boružėlės;2074303013;Taip;0;0;2;2
3119;Giraitė;Boružėlės;7354834895;Taip;2;0;0;2
3120;Giraitė;Boružėlės;4822168634;Taip;0;0;1;1
3121;Giraitė;Boružėlės;6963656869;Ne;0;1;0;1
3122;Giraitė;Boružėlės;3875214088;Taip;7;5;0;12
3123;Giraitė;Boružėlės;7481895278;Taip;14;0;0;14
3124;Giraitė;Boružėlės;3607198556;Taip;0;5;0;5
3125;Giraitė;Boružėlės;1945918102;Ne;15;1;0;16
3126;Giraitė;Boružėlės;2699984170;Taip;10;4;0;14
3127;Giraitė;Boružėlės;6265908751;Taip;0;0;1;1
3128;Giraitė;Gandriukai;69883334049;Taip;11;0;0;11
3129;Giraitė;Gandriukai;1025627643;Taip;0;0;3;3
3130;Giraitė;Gandriukai;26032013284;Taip;0;1;0;1
3131;Giraitė;Gandriukai;82915040164;Taip;0;1;0;1
3132;Giraitė;Gandriukai;18968645937;Taip;0;0;5;5
3133;Giraitė;Gandriukai;64357457379;Taip;0;11;0;11
3134;Giraitė;Gandriukai;1238299747;Ne;16;0;0;16
3135;Giraitė;Gandriukai;1054132082;Taip;0;0;4;4
3136;Giraitė;Gandriukai;5081903157;Ne;6;3;0;9
3137;Giraitė;Gandriukai;5759367884;Taip;4;0;1;5
3138;Giraitė;Gandriukai;1111614295;Taip;13;3;0;16
3139;Giraitė;Gandriukai;1434737480;Taip;5;0;0;5
3140;Giraitė;ŽVIRBLIUKAI;4444292550;Taip;3;0;1;4
3141;Giraitė;ŽVIRBLIUKAI;1958553421;Taip;0;0;2;2
3142;Giraitė;ŽVIRBLIUKAI;77765768952;Taip;0;5;0;5
3143;Giraitė;ŽVIRBLIUKAI;56380808064;Taip;0;8;1;9
3144;Giraitė;ŽVIRBLIUKAI;1730588815;Taip;5;0;0;5
3145;Giraitė;ŽVIRBLIUKAI;1641872824;Taip;6;0;0;6
3146;Giraitė;ŽVIRBLIUKAI;1234136698;Taip;14;0;2;16
3147;Giraitė;ŽVIRBLIUKAI;2065944230;Taip;5;4;0;9
3148;Giraitė;ŽVIRBLIUKAI;2951520056;Taip;0;0;1;1
3149;Giraitė;ŽVIRBLIUKAI;1464444782;Taip;8;0;1;9
3150;Giraitė;ŽVIRBLIUKAI;1435017557;Taip;0;22;0;22
3151;Giraitė;ŽVIRBLIUKAI;48291239027;Taip;10;0;1;11
3152;Giraitė;ŽVIRBLIUKAI;3628448974;Taip;0;7;0;7
3153;Giraitė;ŽVIRBLIUKAI;8020051188;Taip;0;0;4;4
3154;Giraitė;Kiškeliai;4076402180;Taip;0;3;0;3
3155;Giraitė;Kiškeliai;5902161665;Taip;6;0;2;8
3156;Giraitė;Kiškeliai;5532639133;Taip;0;2;2;4
3157;Giraitė;Kiškeliai;4296449093;Taip;5;10;0;15
3158;Giraitė;Kiškeliai;4009092043;Taip;0;10;0;10
3159;Giraitė;Kiškeliai;7919088987;Taip;22;0;0;22
3160;Giraitė;Kiškeliai;8376809208;Taip;5;0;1;6
3161;Giraitė;Kiškeliai;5616242311;Taip;10;0;0;10
3162;Giraitė;Kiškeliai;9728453316;Taip;2;0;0;2
3163;Giraitė;Kiškeliai;4272999339;Ne;6;0;0;6
3164;Giraitė;Kiškeliai;9392127689;Taip;1;0;3;4
3165;Giraitė;Kiškeliai;4955786826;Taip;0;3;0;3
3166;Gudrutis;Gandriukų;38591847769;Taip;0;2;0;2
3167;Gudrutis;Gandriukų;33123804925;Taip;5;0;0;5
3168;Gudrutis;Gandriukų;21999129886;Taip;0;7;0;7
3169;Gudrutis;Gandriukų;69437346100;Ne;0;8;0;8
3170;Gudrutis;Gandriukų;71306450171;Taip;0;0;14;14
3171;Gudrutis;Gandriukų;74606626459;Taip;7;0;0;7
3172;Gudrutis;Gandriukų;1261390117;Ne;5;0;0;5
3173;Gudrutis;Gandriukų;15665148606;Taip;5;1;0;6
3174;Gudrutis;Gandriukų;1013150817;Taip;0;2;1;3
3175;Gudrutis;Gandriukų;13755502342;Taip;0;1;0;1
3176;Gudrutis;Gandriukų;35401545938;Taip;7;0;0;7
3177;Gudrutis;Gandriukų;3363640861;Taip;0;1;0;1
3178;Gudrutis;Gandriukų;62735575539;Taip;0;12;0;12
3179;Gudrutis;Gandriukų;6824283429;Taip;15;0;0;15
3180;Gudrutis;"Saulės zuikučių";2453989647;Taip;0;7;0;7
3181;Gudrutis;"Saulės zuikučių";1434565790;Taip;8;7;0;15
3182;Gudrutis;"Saulės zuikučių";1238607523;Taip;0;6;0;6
3183;Gudrutis;"Saulės zuikučių";1204945185;Taip;0;2;0;2
3184;Gudrutis;"Saulės zuikučių";1389133303;Taip;0;2;0;2
3185;Gudrutis;"Saulės zuikučių";77776725399;Taip;0;1;0;1
3186;Gudrutis;"Saulės zuikučių";21494647270;Taip;0;8;0;8
3187;Gudrutis;"Saulės zuikučių";87981934125;Taip;9;0;2;11
3188;Gudrutis;"Saulės zuikučių";1998630017;Taip;0;0;6;6
3189;Gudrutis;"Saulės zuikučių";1823786522;Taip;0;1;0;1
3190;Gudrutis;"Saulės zuikučių";1618442704;Taip;0;0;1;1
3191;Gudrutis;"Saulės zuikučių";1592255250;Taip;0;0;2;2
3192;Gudrutis;"Saulės zuikučių";8085295588;Taip;0;0;1;1
3193;Gudrutis;"Saulės zuikučių";74605225026;Taip;1;0;2;3
3194;Gudrutis;"Saulės zuikučių";11383212272;Taip;0;13;0;13
3195;Gudrutis;"Saulės zuikučių";1156575830;Taip;0;0;1;1
3196;Gudrutis;"Saulės zuikučių";1490739175;Taip;5;10;0;15
3197;Gudrutis;"Saulės zuikučių";8128313792;Taip;0;5;7;12
3198;Gudrutis;"Saulės zuikučių";8768627605;Taip;3;0;6;9
3199;Gudrutis;"Saulės zuikučių";18320321051;Taip;12;0;1;13
3200;Gudrutis;Pelėdžiukų;2012092629;Ne;10;0;6;16
3201;Gudrutis;Pelėdžiukų;28075147728;Taip;0;0;4;4
3202;Gudrutis;Pelėdžiukų;21178331458;Taip;4;0;1;5
3203;Gudrutis;Pelėdžiukų;18813895572;Taip;0;1;0;1
3204;Gudrutis;Pelėdžiukų;14779917423;Taip;4;0;1;5
3205;Gudrutis;Pelėdžiukų;2579697941;Taip;0;0;4;4
3206;Gudrutis;Pelėdžiukų;54019097027;Taip;6;1;1;8
3207;Gudrutis;Pelėdžiukų;79189562476;Ne;0;0;6;6
3208;Gudrutis;Pelėdžiukų;3970404528;Taip;0;1;5;6
3209;Gudrutis;Pelėdžiukų;98473509715;Taip;0;0;1;1
3210;Gudrutis;Pelėdžiukų;1049398501;Taip;0;17;0;17
3211;Gudrutis;Pelėdžiukų;16404432728;Taip;0;2;0;2
3212;Gudrutis;Pelėdžiukų;1027391188;Taip;0;0;10;10
3213;Gudrutis;Pelėdžiukų;81252457503;Taip;0;0;3;3
3214;Gudrutis;Pelėdžiukų;1340947103;Taip;0;9;13;22
3215;Gudrutis;Pelėdžiukų;7632549677;Taip;0;0;11;11
3216;Gudrutis;Pelėdžiukų;1464768624;Taip;4;0;2;6
3217;Gudrutis;BITUČIŲ;4125420913;Taip;0;0;1;1
3218;Gudrutis;BITUČIŲ;13495334557;Taip;5;1;3;9
3219;Gudrutis;BITUČIŲ;29816980468;Taip;0;2;0;2
3220;Gudrutis;BITUČIŲ;59378091248;Ne;0;1;0;1
3221;Gudrutis;BITUČIŲ;26020212688;Ne;0;0;1;1
3222;Gudrutis;BITUČIŲ;84586752341;Taip;0;1;0;1
3223;Gudrutis;BITUČIŲ;47141496535;Taip;0;0;5;5
3224;Gudrutis;BITUČIŲ;7838753258;Taip;0;0;9;9
3225;Gudrutis;BITUČIŲ;83200430763;Taip;1;2;1;4
3226;Gudrutis;BITUČIŲ;1042589663;Taip;0;7;0;7
3227;Gudrutis;BITUČIŲ;41945603137;Taip;0;9;0;9
3228;Gudrutis;BITUČIŲ;58999949883;Taip;0;1;0;1
3229;Gudrutis;BITUČIŲ;65712774270;Ne;0;0;2;2
3230;Gudrutis;BITUČIŲ;61452187923;Taip;5;0;0;5
3231;Gudrutis;BITUČIŲ;36492561410;Taip;0;0;1;1
3232;Gudrutis;Boružėlių;1190408818;Ne;0;0;10;10
3233;Gudrutis;Boružėlių;2431077357;Taip;0;3;0;3
3234;Gudrutis;Boružėlių;4193661251;Taip;3;0;1;4
3235;Gudrutis;Boružėlių;7116979528;Taip;5;2;2;9
3236;Gudrutis;Boružėlių;1991658503;Taip;2;0;1;3
3237;Gudrutis;Boružėlių;1936327172;Taip;0;0;2;2
3238;Gudrutis;Boružėlių;3359028602;Taip;0;6;0;6
3239;Gudrutis;Boružėlių;1693306014;Taip;0;5;0;5
3240;Gudrutis;Boružėlių;6443631536;Taip;8;0;0;8
3241;Gudrutis;Boružėlių;9042793284;Taip;0;0;3;3
3242;Gudrutis;Boružėlių;4945755164;Taip;0;6;3;9
3243;Gudrutis;Boružėlių;2074151024;Taip;11;0;0;11
3244;Gudrutis;Boružėlių;9841172472;Taip;12;0;0;12
3245;Gudrutis;Drugeliai;2487363252;Ne;0;0;3;3
3246;Gudrutis;Drugeliai;4612995336;Taip;7;0;0;7
3247;Gudrutis;Drugeliai;2197278086;Taip;10;6;0;16
3248;Gudrutis;Drugeliai;6731806925;Taip;6;0;0;6
3249;Gudrutis;Drugeliai;9701111916;Taip;0;0;2;2
3250;Gudrutis;Drugeliai;1228190677;Taip;0;0;2;2
3251;Gudrutis;Drugeliai;6198012431;Taip;3;0;4;7
3252;Gudrutis;Drugeliai;3646335609;Taip;0;0;4;4
3253;Gudrutis;Drugeliai;3625838131;Taip;2;7;0;9
3254;Gudrutis;Drugeliai;5097101097;Taip;0;0;1;1
3255;Gudrutis;Drugeliai;2337493193;Taip;0;8;0;8
3256;Gudrutis;Drugeliai;2764843216;Taip;0;7;0;7
3257;Gudrutis;Drugeliai;7955353991;Taip;3;6;0;9
3258;Jurginėlis;Ąžuoliukai;8217773164;Taip;0;21;0;21
3259;Jurginėlis;Ąžuoliukai;29155768493;Ne;2;3;0;5
3260;Jurginėlis;Ąžuoliukai;1591501789;Taip;0;6;0;6
3261;Jurginėlis;Ąžuoliukai;75192831969;Taip;0;3;0;3
3262;Jurginėlis;Ąžuoliukai;67578476769;Taip;0;17;0;17
3263;Jurginėlis;Ąžuoliukai;10095155757;Taip;0;9;0;9
3264;Jurginėlis;Ąžuoliukai;64641268493;Taip;0;2;0;2
3265;Jurginėlis;Ąžuoliukai;7798931951;Taip;0;19;0;19
3266;Jurginėlis;Ąžuoliukai;92559573466;Taip;0;7;0;7
3267;Jurginėlis;Ąžuoliukai;29601247012;Taip;0;4;0;4
3268;Jurginėlis;Ąžuoliukai;56382554421;Taip;0;15;0;15
3269;Jurginėlis;Ąžuoliukai;75958769515;Taip;0;7;0;7
3270;Jurginėlis;Ąžuoliukai;59618430487;Taip;0;2;0;2
3271;Jurginėlis;Ąžuoliukai;51856181602;Taip;0;4;0;4
3272;Jurginėlis;Ąžuoliukai;64852957209;Taip;0;1;0;1
3273;Jurginėlis;Ąžuoliukai;23049094719;Taip;0;2;0;2
3274;Jurginėlis;Ąžuoliukai;1742217696;Taip;10;0;3;13
3275;Jurginėlis;Ąžuoliukai;8423424896;Taip;0;12;0;12
3276;Jurginėlis;Ąžuoliukai;52105378503;Taip;0;2;0;2
3277;Jurginėlis;Žiogeliai;64524305038;Taip;0;7;0;7
3278;Jurginėlis;Žiogeliai;60988201430;Taip;0;1;0;1
3279;Jurginėlis;Žiogeliai;55253928424;Taip;0;2;0;2
3280;Jurginėlis;Žiogeliai;50470137888;Taip;6;0;0;6
3281;Jurginėlis;Žiogeliai;85888481045;Taip;9;0;0;9
3282;Jurginėlis;Žiogeliai;96017651718;Taip;6;1;0;7
3283;Jurginėlis;Žiogeliai;92688596347;Taip;0;14;0;14
3284;Jurginėlis;Žiogeliai;84691244839;Taip;0;9;0;9
3285;Jurginėlis;Žiogeliai;87566883270;Ne;0;7;0;7
3286;Jurginėlis;Žiogeliai;1175198086;Taip;0;5;0;5
3287;Jurginėlis;Žiogeliai;8149405217;Taip;0;2;0;2
3288;Jurginėlis;Žiogeliai;1058274970;Taip;0;0;22;22
3289;Jurginėlis;Žiogeliai;93055778306;Taip;0;4;0;4
3290;Jurginėlis;Žiogeliai;24615714793;Taip;0;13;0;13
3291;Jurginėlis;Žiogeliai;90786336005;Taip;2;0;0;2
3292;Jurginėlis;Žiogeliai;1041294212;Taip;0;3;0;3
3293;Jurginėlis;Pelėdžiukų;35653034443;Taip;5;1;0;6
3294;Jurginėlis;Pelėdžiukų;59935106302;Taip;0;0;1;1
3295;Jurginėlis;Pelėdžiukų;91317327949;Taip;0;0;2;2
3296;Jurginėlis;Pelėdžiukų;52877525045;Taip;8;3;0;11
3297;Jurginėlis;Pelėdžiukų;36829106143;Taip;0;0;1;1
3298;Jurginėlis;Pelėdžiukų;45200409204;Taip;7;8;0;15
3299;Jurginėlis;Pelėdžiukų;2544904907;Taip;20;0;0;20
3300;Jurginėlis;Pelėdžiukų;7449558199;Taip;0;0;6;6
3301;Jurginėlis;Pelėdžiukų;54494144846;Taip;0;4;1;5
3302;Jurginėlis;Pelėdžiukų;6072633581;Taip;0;12;0;12
3303;Jurginėlis;Pelėdžiukų;57340494605;Taip;0;0;1;1
3304;Jurginėlis;Pelėdžiukų;18273043496;Taip;0;1;0;1
3305;Jurginėlis;Pelėdžiukų;91909797332;Taip;0;1;0;1
3306;Jurginėlis;Pelėdžiukų;7278855565;Taip;0;0;2;2
3307;Jurginėlis;Pelėdžiukų;1295024976;Taip;0;0;4;4
3308;Jurginėlis;Boružėlių;74357497654;Taip;0;1;0;1
3309;Jurginėlis;Boružėlių;63355660135;Taip;0;6;0;6
3310;Jurginėlis;Boružėlių;64840404890;Ne;7;4;0;11
3311;Jurginėlis;Boružėlių;82216478040;Ne;0;13;0;13
3312;Jurginėlis;Boružėlių;86967421380;Taip;0;5;0;5
3313;Jurginėlis;Boružėlių;10360871447;Taip;0;6;0;6
3314;Jurginėlis;Boružėlių;81519067874;Taip;0;2;0;2
3315;Jurginėlis;Boružėlių;2588167364;Ne;0;2;0;2
3316;Jurginėlis;Boružėlių;88889021693;Taip;0;13;0;13
3317;Jurginėlis;Boružėlių;74738988946;Taip;0;8;0;8
3318;Jurginėlis;Boružėlių;26247261025;Taip;0;6;0;6
3319;Jurginėlis;Boružėlių;31459663030;Ne;0;7;0;7
3320;Jurginėlis;Boružėlių;12869519580;Taip;0;6;0;6
3321;Jurginėlis;Boružėlių;32999311928;Ne;0;11;0;11
3322;Jurginėlis;Boružėlių;38238082314;Taip;3;5;0;8
3323;Jurginėlis;Boružėlių;19813742281;Taip;0;6;0;6
3324;Jurginėlis;Boružėlių;96095068634;Taip;0;1;0;1
3325;Jurginėlis;Bitučių;41492483889;Taip;0;2;0;2
3326;Jurginėlis;Bitučių;47471788525;Ne;0;0;2;2
3327;Jurginėlis;Bitučių;9063688205;Taip;0;2;0;2
3328;Jurginėlis;Bitučių;3788255853;Ne;9;9;0;18
3329;Jurginėlis;Bitučių;82962903099;Taip;0;2;0;2
3330;Jurginėlis;Bitučių;90707023246;Taip;0;1;0;1
3331;Jurginėlis;Bitučių;32667255865;Ne;0;1;0;1
3332;Jurginėlis;Bitučių;25564914064;Taip;0;2;0;2
3333;Jurginėlis;Bitučių;20339209794;Taip;0;4;0;4
3334;Jurginėlis;Bitučių;84958379689;Taip;0;3;0;3
3335;Jurginėlis;Bitučių;86820360373;Taip;0;1;0;1
3336;Jurginėlis;Bitučių;2123535778;Taip;0;0;1;1
3337;Jurginėlis;Bitučių;50656028856;Taip;0;5;0;5
3338;Jurginėlis;Bitučių;45937957629;Taip;0;1;0;1
3339;Jurginėlis;Bitučių;10179464570;Taip;0;0;4;4
3340;Jurginėlis;Bitučių;87615798332;Taip;0;0;3;3
3341;Jurginėlis;Bitučių;36215389575;Taip;0;0;1;1
3342;Jurginėlis;Bitučių;14158658573;Taip;0;1;0;1
3343;Jurginėlis;Bitučių;57002585818;Taip;0;9;1;10
3344;Jurginėlis;Bitučių;1196957598;Taip;0;3;0;3
3345;Jurginėlis;Skruzdeliukų;1710682615;Taip;0;3;0;3
3346;Jurginėlis;Skruzdeliukų;1485725580;Taip;13;2;0;15
3347;Jurginėlis;Skruzdeliukų;51685299187;Ne;13;3;0;16
3348;Jurginėlis;Skruzdeliukų;1881790340;Taip;0;10;0;10
3349;Jurginėlis;Skruzdeliukų;31143311410;Ne;10;0;0;10
3350;Jurginėlis;Skruzdeliukų;94107758268;Taip;0;10;0;10
3351;Jurginėlis;Skruzdeliukų;1868080361;Taip;0;4;0;4
3352;Jurginėlis;Skruzdeliukų;38755774035;Taip;15;0;0;15
3353;Jurginėlis;Skruzdeliukų;68109772993;Ne;10;2;4;16
3354;Jurginėlis;Skruzdeliukų;1329203545;Taip;0;5;0;5
3355;Jurginėlis;Skruzdeliukų;86427848578;Taip;0;4;0;4
3356;Jurginėlis;Skruzdeliukų;12659496203;Taip;0;0;1;1
3357;Jurginėlis;Skruzdeliukų;1828295769;Taip;0;4;0;4
3358;Jurginėlis;Skruzdeliukų;17286700686;Ne;0;7;2;9
3359;Jurginėlis;Drugelių;1758862051;Taip;0;1;0;1
3360;Jurginėlis;Drugelių;9589394406;Taip;8;0;0;8
3361;Jurginėlis;Drugelių;47243459592;Taip;9;3;0;12
3362;Jurginėlis;Drugelių;8972814655;Taip;6;1;4;11
3363;Jurginėlis;Drugelių;8784076886;Taip;22;3;0;25
3364;Jurginėlis;Drugelių;7753784918;Taip;0;3;12;15
3365;Jurginėlis;Drugelių;8338173095;Taip;0;0;1;1
3366;Jurginėlis;Drugelių;3068120316;Taip;0;0;6;6
3367;Jurginėlis;Drugelių;1361108271;Taip;0;0;4;4
3368;Jurginėlis;Drugelių;4852619394;Taip;0;3;22;25
3369;Jurginėlis;Drugelių;1701720412;Taip;16;0;0;16
3370;Jurginėlis;Drugelių;8920304044;Taip;0;1;1;2
3371;Jurginėlis;Drugelių;1954364886;Taip;0;2;0;2
3372;Jurginėlis;Drugelių;1974388885;Taip;10;0;3;13
3373;Jurginėlis;Drugelių;3027573572;Taip;0;1;0;1
3374;Jurginėlis;Drugelių;4851923549;Ne;0;0;4;4
3375;Jurginėlis;Žibučių;4806248290;Taip;0;1;0;1
3376;Jurginėlis;Žibučių;2624313807;Taip;14;2;0;16
3377;Jurginėlis;Žibučių;2710889915;Taip;0;3;0;3
3378;Jurginėlis;Žibučių;1983924909;Taip;0;2;0;2
3379;Jurginėlis;Žibučių;1547101731;Taip;5;0;0;5
3380;Jurginėlis;Žibučių;2639125463;Ne;4;1;0;5
3381;Jurginėlis;Žibučių;2535601005;Taip;9;0;0;9
3382;Jurginėlis;Žibučių;5242359650;Taip;0;11;0;11
3383;Jurginėlis;Žibučių;1175441410;Ne;3;4;0;7
3384;Jurginėlis;Žibučių;1586599624;Taip;0;8;0;8
3385;Jurginėlis;Žibučių;1343532870;Taip;0;2;0;2
3386;Jurginėlis;Žibučių;1102466152;Taip;0;5;0;5
3387;Jurginėlis;Žibučių;5892180334;Taip;0;1;0;1
3388;Jurginėlis;Žibučių;1759218238;Taip;0;5;0;5
3389;Jurginėlis;Žibučių;3708774681;Taip;3;13;0;16
3390;Jurginėlis;Žibučių;9646318532;Taip;0;6;0;6
3391;Jurginėlis;Žibučių;1082593212;Taip;0;6;0;6
3392;Jurginėlis;Žibučių;8144038013;Taip;22;0;0;22
3393;Jurginėlis;Žibučių;6413324051;Taip;0;6;0;6
3394;Jurginėlis;Zuikučių;6217229672;Ne;0;7;0;7
3395;Jurginėlis;Zuikučių;1762685527;Ne;0;9;0;9
3396;Jurginėlis;Zuikučių;1649208522;Ne;0;0;3;3
3397;Jurginėlis;Zuikučių;8084970770;Taip;0;1;0;1
3398;Jurginėlis;Zuikučių;87991288027;Ne;4;0;0;4
3399;Jurginėlis;Zuikučių;1400142372;Taip;9;1;0;10
3400;Jurginėlis;Zuikučių;1416995981;Taip;0;0;1;1
3401;Jurginėlis;Zuikučių;1656300401;Taip;0;8;0;8
3402;Jurginėlis;Zuikučių;1759031589;Taip;0;1;0;1
3403;Jurginėlis;Zuikučių;1945098580;Taip;3;0;3;6
3404;Jurginėlis;Zuikučių;1409480187;Ne;0;12;1;13
3405;Jurginėlis;Zuikučių;1780106633;Taip;9;1;0;10
3406;Jurginėlis;Zuikučių;2106937059;Ne;0;3;0;3
3407;Jurginėlis;Zuikučių;1535907893;Ne;0;9;0;9
3408;Jurginėlis;Zuikučių;8793129805;Taip;13;2;0;15
3409;Jurginėlis;Zuikučių;74303787465;Taip;0;3;0;3
3410;Jurginėlis;Zuikučių;60128913543;Taip;0;3;0;3
3411;Jurginėlis;Zuikučių;9320841905;Taip;0;18;4;22
3412;Jurginėlis;Zuikučių;7293372539;Ne;4;1;0;5
3413;Jurginėlis;Viščiukų;1656335765;Ne;13;0;0;13
3414;Jurginėlis;Viščiukų;6579565337;Taip;5;0;0;5
3415;Jurginėlis;Viščiukų;6729212950;Taip;5;10;0;15
3416;Jurginėlis;Viščiukų;4827340942;Ne;17;0;0;17
3417;Jurginėlis;Viščiukų;6806704355;Taip;19;0;0;19
3418;Jurginėlis;Viščiukų;7990015623;Taip;20;1;0;21
3419;Jurginėlis;Viščiukų;3699180485;Taip;0;9;0;9
3420;Jurginėlis;Viščiukų;9882919290;Taip;0;3;0;3
3421;Jurginėlis;Viščiukų;2548920722;Taip;13;0;1;14
3422;Jurginėlis;Viščiukų;4536086996;Taip;5;0;0;5
3423;Jurginėlis;Viščiukų;3284464951;Taip;14;1;0;15
3424;Jurginėlis;Viščiukų;5921714669;Taip;5;5;0;10
3425;Jurginėlis;Viščiukų;4158502752;Taip;10;0;1;11
3426;Jurginėlis;Viščiukų;4463258777;Taip;12;0;0;12
3427;Jurginėlis;Meškiukų;8443412187;Taip;20;0;0;20
3428;Jurginėlis;Meškiukų;7809274980;Taip;8;0;0;8
3429;Jurginėlis;Meškiukų;2221708420;Taip;8;0;0;8
3430;Jurginėlis;Meškiukų;5984893389;Taip;0;11;0;11
3431;Jurginėlis;Meškiukų;3079495897;Taip;0;0;1;1
3432;Jurginėlis;Meškiukų;1455749921;Taip;19;3;0;22
3433;Jurginėlis;Meškiukų;9946892497;Taip;22;0;0;22
3434;Jurginėlis;Meškiukų;2417314519;Ne;3;0;2;5
3435;Jurginėlis;Meškiukų;6968528293;Taip;0;3;0;3
3436;Jurginėlis;Meškiukų;9507571301;Ne;0;0;4;4
3437;Jurginėlis;Meškiukų;8779807396;Ne;16;0;2;18
3438;Jurginėlis;Meškiukų;8161347781;Taip;0;9;0;9
3439;Jurginėlis;Meškiukų;4967548277;Taip;0;14;6;20
3440;Jurginėlis;Meškiukų;2925253653;Taip;7;0;1;8
3441;Jurginėlis;Meškiukų;1340689348;Ne;0;18;0;18
3442;Jurginėlis;Meškiukų;6181547354;Taip;0;14;8;22
3443;Jurginėlis;Gandriukų;7419836868;Taip;13;0;1;14
3444;Jurginėlis;Gandriukų;51603579121;Ne;14;4;0;18
3445;Jurginėlis;Gandriukų;87444065733;Taip;5;11;0;16
3446;Jurginėlis;Gandriukų;2179884441;Taip;0;14;0;14
3447;Jurginėlis;Gandriukų;2264351097;Taip;8;0;2;10
3448;Jurginėlis;Gandriukų;78496894090;Taip;8;0;1;9
3449;Jurginėlis;Gandriukų;99523320519;Taip;0;0;5;5
3450;Jurginėlis;Gandriukų;1498351759;Ne;0;0;2;2
3451;Jurginėlis;Gandriukų;1159550277;Taip;0;1;0;1
3452;Jurginėlis;Gandriukų;75383941896;Taip;4;1;0;5
3453;Jurginėlis;Gandriukų;1773100970;Taip;5;1;4;10
3454;Jurginėlis;Gandriukų;1500087367;Taip;5;1;4;10
3455;Jurginėlis;Gandriukų;43368987046;Taip;10;0;1;11
3456;Jurginėlis;Gandriukų;6707289955;Taip;6;0;1;7
3457;Jurginėlis;Gandriukų;1927843089;Taip;1;0;1;2
3458;Jurginėlis;Gandriukų;8178112926;Taip;14;1;2;17
3459;Jurginėlis;Gandriukų;6475508583;Taip;22;0;0;22
3460;Jurginėlis;Gandriukų;91517951071;Taip;10;0;0;10
3461;Jurginėlis;Gandriukų;9714764714;Ne;5;0;13;18
3462;Jurginėlis;Gandriukų;5756997642;Taip;10;1;2;13
3463;Karusėlė;PAGRANDUKAS;3660843696;Taip;0;6;0;6
3464;Karusėlė;PAGRANDUKAS;9805481603;Taip;5;0;0;5
3465;Karusėlė;PAGRANDUKAS;1412890120;Taip;0;10;0;10
3466;Karusėlė;PAGRANDUKAS;8967704928;Taip;22;0;0;22
3467;Karusėlė;PAGRANDUKAS;5132581245;Taip;4;0;1;5
3468;Karusėlė;PAGRANDUKAS;2160071272;Taip;0;0;1;1
3469;Karusėlė;PAGRANDUKAS;9462242426;Taip;13;0;2;15
3470;Karusėlė;PAGRANDUKAS;2412418335;Taip;12;0;1;13
3471;Karusėlė;PAGRANDUKAS;8678437720;Taip;0;0;5;5
3472;Karusėlė;PAGRANDUKAS;6826455161;Taip;4;0;0;4
3473;Karusėlė;PAGRANDUKAS;5695697634;Taip;10;0;0;10
3474;Karusėlė;PAGRANDUKAS;8127218866;Taip;12;0;1;13
3475;Karusėlė;PAGRANDUKAS;6062361348;Taip;17;0;0;17
3476;Karusėlė;PAGRANDUKAS;3620722907;Taip;22;0;0;22
3477;Karusėlė;PAGRANDUKAS;7013765804;Taip;15;0;0;15
3478;Karusėlė;NYKŠTUKAS;1560316431;Taip;4;0;0;4
3479;Karusėlė;NYKŠTUKAS;82963400142;Taip;17;0;0;17
3480;Karusėlė;NYKŠTUKAS;1567290218;Taip;0;3;0;3
3481;Karusėlė;NYKŠTUKAS;77290004668;Ne;0;0;1;1
3482;Karusėlė;NYKŠTUKAS;64652121316;Taip;13;0;0;13
3483;Karusėlė;NYKŠTUKAS;1250530261;Taip;0;7;0;7
3484;Karusėlė;NYKŠTUKAS;1397009220;Taip;0;17;0;17
3485;Karusėlė;NYKŠTUKAS;62938709605;Taip;10;0;0;10
3486;Karusėlė;NYKŠTUKAS;96150256487;Taip;8;0;0;8
3487;Karusėlė;NYKŠTUKAS;1680275369;Taip;2;0;0;2
3488;Karusėlė;NYKŠTUKAS;17728195505;Taip;4;0;1;5
3489;Karusėlė;NYKŠTUKAS;1534689679;Taip;0;0;4;4
3490;Karusėlė;NYKŠTUKAS;1226371512;Taip;0;0;7;7
3491;Karusėlė;NYKŠTUKAS;45634061915;Taip;0;7;0;7
3492;Karusėlė;NYKŠTUKAS;1311631554;Ne;15;7;0;22
3493;Karusėlė;NYKŠTUKAS;5481354767;Taip;2;0;1;3
3494;Karusėlė;NYKŠTUKAS;1798723081;Ne;6;4;1;11
3495;Karusėlė;NYKŠTUKAS;8419242504;Taip;5;0;1;6
3496;Karusėlė;BITUTĖ;34233236889;Taip;0;11;0;11
3497;Karusėlė;BITUTĖ;59360129103;Taip;0;6;0;6
3498;Karusėlė;BITUTĖ;73632076815;Taip;1;1;0;2
3499;Karusėlė;BITUTĖ;13709181657;Ne;1;1;0;2
3500;Karusėlė;BITUTĖ;79818913523;Taip;0;5;0;5
3501;Karusėlė;BITUTĖ;70640710377;Taip;2;0;0;2
3502;Karusėlė;BITUTĖ;49030870029;Taip;2;1;0;3
3503;Karusėlė;BITUTĖ;3136722375;Taip;9;2;0;11
3504;Karusėlė;BITUTĖ;61949196545;Ne;0;4;0;4
3505;Karusėlė;BITUTĖ;92696158075;Taip;1;1;0;2
3506;Karusėlė;BITUTĖ;53518197256;Taip;0;6;0;6
3507;Karusėlė;BITUTĖ;32652681132;Taip;2;1;0;3
3508;Karusėlė;BITUTĖ;12592642929;Ne;5;0;0;5
3509;Karusėlė;BITUTĖ;93257316270;Taip;4;1;0;5
3510;Karusėlė;BITUTĖ;5205096259;Taip;5;4;0;9
3511;Karusėlė;BITUTĖ;75225376723;Taip;4;3;0;7
3512;Karusėlė;BITUTĖ;57323585520;Taip;0;2;0;2
3513;Karusėlė;BITUTĖ;14967055322;Ne;0;9;0;9
3514;Karusėlė;BITUTĖ;2582494071;Taip;0;13;0;13
3515;Karusėlė;BITUTĖ;28039124654;Ne;0;1;0;1
3516;Karusėlė;BITUTĖ;13158075075;Taip;2;1;0;3
3517;Karusėlė;BITUTĖ;92236920191;Taip;5;3;0;8
3518;Karusėlė;BITUTĖ;8302185030;Taip;1;1;0;2
3519;Karusėlė;BITUTĖ;58784706592;Taip;0;5;0;5
3520;Karusėlė;BITUTĖ;8079425267;Ne;0;12;0;12
3521;Karusėlė;BITUTĖ;1688616471;Taip;0;1;0;1
3522;Karusėlė;BORUŽĖLĖ;1705790474;Taip;0;2;0;2
3523;Karusėlė;BORUŽĖLĖ;4890393582;Taip;8;2;0;10
3524;Karusėlė;BORUŽĖLĖ;1311907441;Taip;0;6;0;6
3525;Karusėlė;BORUŽĖLĖ;1593728369;Taip;1;17;0;18
3526;Karusėlė;BORUŽĖLĖ;6313010762;Taip;0;1;0;1
3527;Karusėlė;BORUŽĖLĖ;5859827168;Taip;15;0;0;15
3528;Karusėlė;BORUŽĖLĖ;37349219339;Taip;11;2;0;13
3529;Karusėlė;BORUŽĖLĖ;49110267692;Taip;3;0;1;4
3530;Karusėlė;BORUŽĖLĖ;1809033214;Taip;6;0;0;6
3531;Karusėlė;BORUŽĖLĖ;9065247151;Taip;0;0;12;12
3532;Karusėlė;BORUŽĖLĖ;6811862463;Taip;3;9;0;12
3533;Karusėlė;BORUŽĖLĖ;5471989295;Ne;13;0;0;13
3534;Karusėlė;BORUŽĖLĖ;9753876554;Taip;12;1;0;13
3535;Karusėlė;BORUŽĖLĖ;1204919995;Taip;22;0;0;22
3536;Karusėlė;BORUŽĖLĖ;8717484092;Taip;10;10;0;20
3537;Karusėlė;BORUŽĖLĖ;5351690991;Taip;0;1;5;6
3538;Karusėlė;BORUŽĖLĖ;1994682683;Taip;4;3;5;12
3539;Karusėlė;BORUŽĖLĖ;1350744949;Taip;22;0;0;22
3540;Karusėlė;UOGELĖ;3053539045;Taip;0;1;0;1
3541;Karusėlė;UOGELĖ;9992989896;Taip;0;1;0;1
3542;Karusėlė;UOGELĖ;2084276906;Taip;15;1;0;16
3543;Karusėlė;UOGELĖ;1098106063;Taip;6;2;1;9
3544;Karusėlė;UOGELĖ;8665314366;Taip;0;3;0;3
3545;Karusėlė;UOGELĖ;8316147204;Taip;22;0;0;22
3546;Karusėlė;UOGELĖ;5504719953;Ne;0;9;0;9
3547;Karusėlė;UOGELĖ;5919009583;Taip;0;14;0;14
3548;Karusėlė;UOGELĖ;4199597984;Taip;0;1;0;1
3549;Karusėlė;UOGELĖ;2383023280;Taip;5;4;0;9
3550;Karusėlė;UOGELĖ;1575408822;Taip;22;0;0;22
3551;Karusėlė;UOGELĖ;3917113787;Taip;0;3;0;3
3552;Karusėlė;UOGELĖ;4068106379;Taip;5;1;0;6
3553;Karusėlė;UOGELĖ;1428516421;Taip;0;2;8;10
3554;Karusėlė;UOGELĖ;4638918427;Taip;2;2;0;4
3555;Karusėlė;UOGELĖ;3615957761;Taip;5;14;0;19
3556;Karusėlė;UOGELĖ;3514026443;Taip;0;7;0;7
3557;Karusėlė;GINTARĖLIS;75574841532;Taip;0;1;0;1
3558;Karusėlė;GINTARĖLIS;1058129883;Taip;0;1;0;1
3559;Karusėlė;GINTARĖLIS;1625704473;Taip;10;1;0;11
3560;Karusėlė;GINTARĖLIS;5267055924;Ne;4;3;0;7
3561;Karusėlė;GINTARĖLIS;17254955427;Taip;0;1;1;2
3562;Karusėlė;GINTARĖLIS;1467237683;Taip;5;0;0;5
3563;Karusėlė;GINTARĖLIS;33935704865;Taip;0;6;0;6
3564;Karusėlė;GINTARĖLIS;92286460424;Taip;8;11;0;19
3565;Karusėlė;GINTARĖLIS;80377577910;Taip;0;9;0;9
3566;Karusėlė;GINTARĖLIS;7794899167;Taip;0;1;0;1
3567;Karusėlė;GINTARĖLIS;1302846796;Taip;0;10;0;10
3568;Karusėlė;GINTARĖLIS;6181109173;Ne;0;2;0;2
3569;Karusėlė;GINTARĖLIS;65387251381;Taip;3;1;0;4
3570;Karusėlė;GINTARĖLIS;90635580825;Taip;2;0;1;3
3571;Karusėlė;GINTARĖLIS;93635113154;Taip;3;1;0;4
3572;Karusėlė;GINTARĖLIS;2386140324;Taip;0;5;0;5
3573;Karusėlė;GINTARĖLIS;90731574209;Ne;0;10;0;10
3574;Karusėlė;GINTARĖLIS;1248828581;Taip;9;7;0;16
3575;Karusėlė;GINTARĖLIS;6596029324;Taip;6;0;0;6
3576;Karusėlė;SAULUTĖ;1705251019;Taip;2;1;0;3
3577;Karusėlė;SAULUTĖ;64855471225;Taip;0;2;0;2
3578;Karusėlė;SAULUTĖ;45701480267;Taip;3;1;0;4
3579;Karusėlė;SAULUTĖ;35910852843;Taip;19;0;0;19
3580;Karusėlė;SAULUTĖ;1198992954;Taip;0;3;0;3
3581;Karusėlė;SAULUTĖ;1223992311;Taip;0;2;0;2
3582;Karusėlė;SAULUTĖ;6702329224;Taip;22;0;0;22
3583;Karusėlė;SAULUTĖ;1239411995;Ne;0;1;0;1
3584;Karusėlė;SAULUTĖ;4806666157;Taip;3;2;1;6
3585;Karusėlė;SAULUTĖ;10539595272;Taip;0;1;0;1
3586;Karusėlė;SAULUTĖ;52452661421;Taip;0;6;0;6
3587;Karusėlė;SAULUTĖ;54723578928;Taip;4;0;0;4
3588;Karusėlė;SAULUTĖ;2606829789;Ne;0;2;0;2
3589;Karusėlė;SAULUTĖ;91676265927;Taip;0;6;0;6
3590;Karusėlė;SAULUTĖ;39088931809;Taip;0;2;2;4
3591;Karusėlė;SAULUTĖ;63044693440;Taip;0;1;0;1
3592;Karusėlė;SAULUTĖ;23662916408;Taip;0;13;0;13
3593;Karusėlė;SAULUTĖ;99462674291;Taip;5;2;1;8
3594;Karusėlė;SAULUTĖ;59790578013;Taip;0;2;0;2
3595;Karusėlė;SAULUTĖ;2025180617;Taip;0;3;0;3
3596;Karusėlė;SAULUTĖ;7977835762;Taip;22;0;0;22
3597;Karusėlė;SAULUTĖ;1273810363;Taip;6;0;0;6
3598;Karusėlė;SAULUTĖ;25328680614;Taip;14;1;0;15
3599;Karusėlė;SAULUTĖ;2038274137;Taip;3;0;0;3
3600;Karusėlė;TIGRIUKAS;1277422207;Taip;6;6;0;12
3601;Karusėlė;TIGRIUKAS;1799128848;Taip;0;1;0;1
3602;Karusėlė;TIGRIUKAS;95430039864;Taip;2;0;0;2
3603;Karusėlė;TIGRIUKAS;68279619421;Ne;0;4;0;4
3604;Karusėlė;TIGRIUKAS;86870088150;Taip;0;7;0;7
3605;Karusėlė;TIGRIUKAS;25581881402;Taip;0;9;0;9
3606;Karusėlė;TIGRIUKAS;60785707116;Taip;0;9;0;9
3607;Karusėlė;TIGRIUKAS;18831943978;Taip;6;0;0;6
3608;Karusėlė;TIGRIUKAS;1817869518;Taip;0;1;0;1
3609;Karusėlė;TIGRIUKAS;1193711193;Taip;0;10;0;10
3610;Karusėlė;TIGRIUKAS;3752570475;Ne;10;4;0;14
3611;Karusėlė;TIGRIUKAS;1305485683;Taip;8;0;0;8
3612;Karusėlė;TIGRIUKAS;8881750322;Taip;5;0;0;5
3613;Karusėlė;TIGRIUKAS;8946147763;Taip;6;0;0;6
3614;Karusėlė;TIGRIUKAS;4426462711;Taip;0;4;0;4
3615;Karusėlė;TIGRIUKAS;3960354989;Taip;5;3;0;8
3616;Karusėlė;TIGRIUKAS;2036366726;Taip;0;1;0;1
3617;Karusėlė;VAIVORYKŠTĖ;1653601923;Ne;10;0;0;10
3618;Karusėlė;VAIVORYKŠTĖ;27840592998;Taip;0;6;0;6
3619;Karusėlė;VAIVORYKŠTĖ;1979913722;Taip;0;8;0;8
3620;Karusėlė;VAIVORYKŠTĖ;89727334417;Taip;15;5;0;20
3621;Karusėlė;VAIVORYKŠTĖ;88371238657;Taip;10;0;1;11
3622;Karusėlė;VAIVORYKŠTĖ;21474974272;Taip;3;4;0;7
3623;Karusėlė;VAIVORYKŠTĖ;1629901230;Taip;0;5;0;5
3624;Karusėlė;VAIVORYKŠTĖ;2092642601;Taip;0;7;0;7
3625;Karusėlė;VAIVORYKŠTĖ;2083974132;Taip;10;2;0;12
3626;Karusėlė;VAIVORYKŠTĖ;1945164524;Taip;0;8;0;8
3627;Karusėlė;VAIVORYKŠTĖ;1886562437;Taip;0;6;0;6
3628;Karusėlė;VAIVORYKŠTĖ;1915396083;Taip;0;2;0;2
3629;Karusėlė;VAIVORYKŠTĖ;1094853107;Taip;0;15;0;15
3630;Karusėlė;VAIVORYKŠTĖ;40499469616;Taip;0;11;0;11
3631;Karusėlė;VAIVORYKŠTĖ;26373120499;Taip;0;2;0;2
3632;Karusėlė;VAIVORYKŠTĖ;78971949838;Taip;0;1;0;1
3633;Karusėlė;VAIVORYKŠTĖ;25859211954;Taip;4;0;0;4
3634;Karusėlė;VAIVORYKŠTĖ;47751458940;Taip;2;4;0;6
3635;Karusėlė;VAIVORYKŠTĖ;68537797465;Taip;0;18;0;18
3636;Karusėlė;VAIVORYKŠTĖ;11336671763;Ne;1;10;0;11
3637;Karusėlė;VAIVORYKŠTĖ;9482894921;Taip;0;6;0;6
3638;Karusėlė;"AUKSINĖ ŽUVELĖ";77212719456;Taip;0;3;0;3
3639;Karusėlė;"AUKSINĖ ŽUVELĖ";1414085818;Taip;0;1;0;1
3640;Karusėlė;"AUKSINĖ ŽUVELĖ";4888730297;Taip;0;7;0;7
3641;Karusėlė;"AUKSINĖ ŽUVELĖ";26710882757;Taip;0;7;0;7
3642;Karusėlė;"AUKSINĖ ŽUVELĖ";47542882134;Taip;0;2;0;2
3643;Karusėlė;"AUKSINĖ ŽUVELĖ";6580115367;Taip;0;7;0;7
3644;Karusėlė;"AUKSINĖ ŽUVELĖ";27958836709;Taip;8;0;0;8
3645;Karusėlė;"AUKSINĖ ŽUVELĖ";76108591835;Taip;0;2;0;2
3646;Karusėlė;"AUKSINĖ ŽUVELĖ";23369021638;Ne;5;5;0;10
3647;Karusėlė;"AUKSINĖ ŽUVELĖ";2216383015;Ne;9;2;0;11
3648;Karusėlė;"AUKSINĖ ŽUVELĖ";58031363722;Taip;6;0;0;6
3649;Karusėlė;"AUKSINĖ ŽUVELĖ";41390857064;Taip;0;2;0;2
3650;Karusėlė;"AUKSINĖ ŽUVELĖ";44475356094;Taip;0;1;0;1
3651;Karusėlė;"AUKSINĖ ŽUVELĖ";1462103488;Ne;0;8;0;8
3652;Karusėlė;"AUKSINĖ ŽUVELĖ";1948979039;Taip;0;4;0;4
3653;Karusėlė;"AUKSINĖ ŽUVELĖ";1982350605;Taip;8;1;0;9
3654;Karusėlė;"AUKSINĖ ŽUVELĖ";4878805177;Taip;3;2;0;5
3655;Karusėlė;RAMUNĖ;5951045233;Taip;2;1;0;3
3656;Karusėlė;RAMUNĖ;9868386182;Taip;2;1;0;3
3657;Karusėlė;RAMUNĖ;2381566229;Taip;22;0;0;22
3658;Karusėlė;RAMUNĖ;9344514262;Taip;21;0;0;21
3659;Karusėlė;RAMUNĖ;2215367063;Ne;7;8;0;15
3660;Karusėlė;RAMUNĖ;6495631086;Taip;0;1;0;1
3661;Karusėlė;RAMUNĖ;1698478530;Taip;12;0;0;12
3662;Karusėlė;RAMUNĖ;8331985564;Ne;7;0;0;7
3663;Karusėlė;RAMUNĖ;5803808409;Taip;0;7;0;7
3664;Karusėlė;RAMUNĖ;5855430678;Taip;0;1;2;3
3665;Karusėlė;RAMUNĖ;9400171357;Taip;0;16;0;16
3666;Karusėlė;RAMUNĖ;5766390337;Taip;11;3;0;14
3667;Karusėlė;RAMUNĖ;6413701823;Taip;10;0;0;10
3668;Karusėlė;RAMUNĖ;2007411601;Taip;15;7;0;22
3669;Kaštonas;NYKŠTUKAI;41926955433;Taip;4;2;0;6
3670;Kaštonas;NYKŠTUKAI;81834426663;Taip;0;1;0;1
3671;Kaštonas;NYKŠTUKAI;1626798162;Taip;10;6;0;16
3672;Kaštonas;NYKŠTUKAI;46191613797;Ne;0;6;0;6
3673;Kaštonas;NYKŠTUKAI;76576870173;Taip;0;1;0;1
3674;Kaštonas;NYKŠTUKAI;1152555202;Taip;0;1;0;1
3675;Kaštonas;NYKŠTUKAI;1023364928;Taip;15;0;0;15
3676;Kaštonas;NYKŠTUKAI;1186956315;Taip;6;1;0;7
3677;Kaštonas;NYKŠTUKAI;1931800904;Taip;0;3;0;3
3678;Kaštonas;NYKŠTUKAI;1781481896;Taip;0;2;0;2
3679;Kaštonas;NYKŠTUKAI;6701145026;Taip;4;0;0;4
3680;Kaštonas;NYKŠTUKAI;9287426151;Taip;0;1;0;1
3681;Kaštonas;NYKŠTUKAI;55052021468;Taip;0;1;0;1
3682;Kaštonas;NYKŠTUKAI;6560054869;Taip;0;14;0;14
3683;Kaštonas;NYKŠTUKAI;9168456496;Taip;0;1;0;1
3684;Kaštonas;NYKŠTUKAI;3059036526;Taip;0;1;0;1
3685;Kaštonas;NYKŠTUKAI;8990194475;Taip;0;11;0;11
3686;Kaštonas;NYKŠTUKAI;9702914628;Taip;11;3;0;14
3687;Kaštonas;NYKŠTUKAI;41221846403;Taip;0;8;0;8
3688;Kaštonas;NYKŠTUKAI;3773227028;Taip;0;7;0;7
3689;Kaštonas;DRUGELIAI;1547554662;Taip;0;3;0;3
3690;Kaštonas;DRUGELIAI;10295996551;Taip;0;1;0;1
3691;Kaštonas;DRUGELIAI;91745369760;Ne;0;2;0;2
3692;Kaštonas;DRUGELIAI;78786250725;Taip;0;4;0;4
3693;Kaštonas;DRUGELIAI;7641793210;Taip;0;3;0;3
3694;Kaštonas;DRUGELIAI;46419017842;Taip;0;7;0;7
3695;Kaštonas;DRUGELIAI;59413506728;Ne;0;2;0;2
3696;Kaštonas;DRUGELIAI;29029841983;Taip;0;2;0;2
3697;Kaštonas;DRUGELIAI;1641976468;Taip;0;15;0;15
3698;Kaštonas;DRUGELIAI;2825343274;Taip;0;3;0;3
3699;Kaštonas;DRUGELIAI;54580238237;Taip;0;6;0;6
3700;Kaštonas;DRUGELIAI;8748600333;Taip;0;1;0;1
3701;Kaštonas;DRUGELIAI;87941682538;Taip;0;7;0;7
3702;Kaštonas;DRUGELIAI;17123843027;Taip;0;1;0;1
3703;Kaštonas;DRUGELIAI;1364683665;Taip;0;2;0;2
3704;Kaštonas;DRUGELIAI;75540345287;Taip;0;12;0;12
3705;Kaštonas;DRUGELIAI;23319023639;Taip;0;1;0;1
3706;Kaštonas;DRUGELIAI;16395082273;Taip;0;2;0;2
3707;Kaštonas;DRUGELIAI;2120469277;Taip;0;5;0;5
3708;Kaštonas;KIŠKUČIAI;1859126564;Ne;0;12;0;12
3709;Kaštonas;KIŠKUČIAI;4449017708;Ne;0;10;0;10
3710;Kaštonas;KIŠKUČIAI;2539596633;Taip;0;1;0;1
3711;Kaštonas;KIŠKUČIAI;3638565578;Ne;0;16;0;16
3712;Kaštonas;KIŠKUČIAI;5153948802;Taip;0;13;0;13
3713;Kaštonas;KIŠKUČIAI;4956177048;Taip;0;22;0;22
3714;Kaštonas;KIŠKUČIAI;2165890763;Taip;6;13;0;19
3715;Kaštonas;KIŠKUČIAI;5610113641;Taip;0;16;0;16
3716;Kaštonas;KIŠKUČIAI;2417951642;Taip;0;1;0;1
3717;Kaštonas;KIŠKUČIAI;2797443202;Taip;0;7;0;7
3718;Kaštonas;KIŠKUČIAI;7776071299;Taip;9;0;0;9
3719;Kaštonas;KIŠKUČIAI;3039980710;Taip;0;1;0;1
3720;Kaštonas;KIŠKUČIAI;3507672150;Taip;0;2;0;2
3721;Kaštonas;KIŠKUČIAI;3131712783;Taip;0;8;0;8
3722;Kaštonas;KIŠKUČIAI;1747580231;Ne;5;8;0;13
3723;Kaštonas;KIŠKUČIAI;1826015013;Taip;0;3;0;3
3724;Kaštonas;KIŠKUČIAI;7553024183;Taip;5;5;0;10
3725;Kaštonas;KIŠKUČIAI;5630659056;Taip;10;2;0;12
3726;Kaštonas;KIŠKUČIAI;8151333699;Taip;21;0;0;21
3727;Kaštonas;KIŠKUČIAI;2007064959;Taip;0;19;0;19
3728;Kaštonas;KIŠKUČIAI;7841179083;Taip;0;22;0;22
3729;Kaštonas;KIŠKUČIAI;3649329598;Taip;12;5;0;17
3730;Kaštonas;KIŠKUČIAI;8906976150;Taip;10;1;0;11
3731;Kaštonas;KIŠKUČIAI;7508357392;Taip;1;0;0;1
3732;Kaštonas;BITUTĖS;51558463647;Taip;7;4;0;11
3733;Kaštonas;BITUTĖS;2062489205;Taip;5;5;0;10
3734;Kaštonas;BITUTĖS;78535860714;Taip;0;5;0;5
3735;Kaštonas;BITUTĖS;2146285017;Taip;0;20;0;20
3736;Kaštonas;BITUTĖS;98526928421;Taip;0;16;0;16
3737;Kaštonas;BITUTĖS;1292350264;Taip;0;5;0;5
3738;Kaštonas;BITUTĖS;3967999408;Taip;0;1;0;1
3739;Kaštonas;BITUTĖS;39974835155;Taip;10;0;0;10
3740;Kaštonas;BITUTĖS;1380861719;Taip;0;2;0;2
3741;Kaštonas;BITUTĖS;18542160352;Taip;0;9;0;9
3742;Kaštonas;BITUTĖS;1162926887;Taip;0;12;0;12
3743;Kaštonas;BITUTĖS;1459614385;Taip;0;14;0;14
3744;Kaštonas;BITUTĖS;4250816034;Taip;0;10;0;10
3745;Kaštonas;BITUTĖS;9967553882;Taip;0;4;0;4
3746;Kaštonas;BITUTĖS;27082059521;Taip;13;0;0;13
3747;Kaštonas;BITUTĖS;1465714333;Ne;0;10;0;10
3748;Kaštonas;BITUTĖS;1252815477;Taip;0;8;0;8
3749;Kaštonas;BITUTĖS;7557437205;Taip;0;2;0;2
3750;Kaštonas;BITUTĖS;92533370070;Taip;12;3;0;15
3751;Kaštonas;BITUTĖS;9215070593;Taip;5;6;0;11
3752;Kaštonas;BITUTĖS;2149717496;Ne;0;6;0;6
3753;Kaštonas;BITUTĖS;6511223066;Taip;0;4;0;4
3754;Kaštonas;MEŠKIUKAI;13105582649;Taip;5;12;0;17
3755;Kaštonas;MEŠKIUKAI;1420929477;Taip;0;14;0;14
3756;Kaštonas;MEŠKIUKAI;12354635231;Taip;5;1;0;6
3757;Kaštonas;MEŠKIUKAI;94748215851;Taip;22;0;0;22
3758;Kaštonas;MEŠKIUKAI;66717201099;Taip;10;5;0;15
3759;Kaštonas;MEŠKIUKAI;12358360731;Taip;11;0;0;11
3760;Kaštonas;MEŠKIUKAI;97106889191;Taip;0;16;0;16
3761;Kaštonas;MEŠKIUKAI;8042807487;Taip;9;3;0;12
3762;Kaštonas;MEŠKIUKAI;2711819539;Taip;0;11;0;11
3763;Kaštonas;MEŠKIUKAI;1294879767;Taip;0;11;0;11
3764;Kaštonas;MEŠKIUKAI;1367704050;Taip;10;3;0;13
3765;Kaštonas;MEŠKIUKAI;5722934228;Taip;0;7;0;7
3766;Kaštonas;MEŠKIUKAI;89221382880;Taip;0;15;0;15
3767;Kaštonas;MEŠKIUKAI;65960895249;Taip;10;0;0;10
3768;Kaštonas;MEŠKIUKAI;69883785412;Taip;0;4;0;4
3769;Kaštonas;MEŠKIUKAI;1049699735;Taip;2;11;0;13
3770;Kaštonas;MEŠKIUKAI;1385352925;Taip;0;3;0;3
3771;Kaštonas;MEŠKIUKAI;3863015751;Ne;2;0;0;2
3772;Kaštonas;MEŠKIUKAI;2760501432;Ne;8;3;0;11
3773;Kaštonas;MEŠKIUKAI;70838449788;Ne;7;2;0;9
3774;Kaštonas;MEŠKIUKAI;1249299633;Taip;7;0;0;7
3775;Kaštonas;MEŠKIUKAI;1196590128;Taip;0;3;0;3
3776;Kaštonas;BORUŽĖLĖS;5099098185;Taip;6;0;0;6
3777;Kaštonas;BORUŽĖLĖS;6967725663;Taip;0;17;0;17
3778;Kaštonas;BORUŽĖLĖS;5478395437;Taip;5;0;0;5
3779;Kaštonas;BORUŽĖLĖS;6606094891;Taip;22;0;0;22
3780;Kaštonas;BORUŽĖLĖS;1364391105;Taip;21;0;0;21
3781;Kaštonas;BORUŽĖLĖS;2125410714;Ne;6;0;0;6
3782;Kaštonas;BORUŽĖLĖS;7956422880;Taip;0;22;0;22
3783;Kaštonas;BORUŽĖLĖS;8564586014;Taip;12;7;0;19
3784;Kaštonas;BORUŽĖLĖS;5328263421;Taip;11;0;0;11
3785;Kaštonas;BORUŽĖLĖS;4033866425;Taip;9;1;0;10
3786;Kaštonas;BORUŽĖLĖS;3961661158;Taip;22;0;0;22
3787;Kaštonas;BORUŽĖLĖS;6251564828;Taip;13;3;0;16
3788;Kaštonas;BORUŽĖLĖS;7291448857;Taip;5;0;0;5
3789;Kaštonas;BORUŽĖLĖS;3105500733;Taip;15;0;0;15
3790;Kaštonas;BORUŽĖLĖS;6175014441;Taip;15;0;0;15
3791;Kaštonas;BORUŽĖLĖS;4450146424;Taip;8;0;0;8
3792;Kaštonas;BORUŽĖLĖS;5548875714;Taip;6;0;0;6
3793;Kaštonas;BORUŽĖLĖS;3333990952;Taip;6;0;0;6
3794;Kaštonas;BORUŽĖLĖS;8166925991;Taip;0;8;0;8
3795;Krivūlė;SPINDULIUKAI;59978148537;Taip;0;0;5;5
3796;Krivūlė;SPINDULIUKAI;55356606791;Taip;5;0;0;5
3797;Krivūlė;SPINDULIUKAI;88714209343;Taip;0;0;4;4
3798;Krivūlė;SPINDULIUKAI;50715118246;Taip;0;1;0;1
3799;Krivūlė;SPINDULIUKAI;43180342657;Taip;0;0;1;1
3800;Krivūlė;SPINDULIUKAI;78895964424;Taip;0;0;1;1
3801;Krivūlė;SPINDULIUKAI;58431942;Taip;0;0;2;2
3802;Krivūlė;SPINDULIUKAI;48514609257;Taip;5;0;1;6
3803;Krivūlė;SPINDULIUKAI;49698343392;Taip;0;5;0;5
3804;Krivūlė;SPINDULIUKAI;1361647836;Taip;0;0;7;7
3805;Krivūlė;SPINDULIUKAI;3157698386;Taip;5;0;2;7
3806;Krivūlė;SPINDULIUKAI;91823213506;Taip;9;0;6;15
3807;Krivūlė;SPINDULIUKAI;26046598666;Taip;0;0;2;2
3808;Krivūlė;SPINDULIUKAI;52632731467;Taip;0;0;9;9
3809;Krivūlė;SPINDULIUKAI;1443815293;Taip;1;0;3;4
3810;Krivūlė;SPINDULIUKAI;1980001276;Taip;12;1;0;13
3811;Krivūlė;SPINDULIUKAI;14824959974;Taip;0;1;1;2
3812;Krivūlė;BORUŽĖLĖS;4969782237;Taip;3;0;2;5
3813;Krivūlė;BORUŽĖLĖS;3605506478;Taip;5;0;5;10
3814;Krivūlė;BORUŽĖLĖS;4896656209;Taip;5;0;5;10
3815;Krivūlė;BORUŽĖLĖS;4845515196;Taip;9;0;3;12
3816;Krivūlė;BORUŽĖLĖS;5676562063;Taip;10;0;5;15
3817;Krivūlė;BORUŽĖLĖS;6935969502;Taip;9;0;0;9
3818;Krivūlė;BORUŽĖLĖS;4972360440;Taip;17;0;0;17
3819;Krivūlė;BORUŽĖLĖS;7318064702;Taip;0;6;0;6
3820;Krivūlė;BORUŽĖLĖS;3912620138;Taip;10;0;0;10
3821;Krivūlė;BORUŽĖLĖS;3246787504;Taip;0;0;2;2
3822;Krivūlė;BORUŽĖLĖS;5531566792;Taip;7;0;3;10
3823;Krivūlė;BORUŽĖLĖS;2386053480;Taip;0;0;9;9
3824;Krivūlė;BORUŽĖLĖS;8586287004;Taip;12;0;0;12
3825;Krivūlė;BORUŽĖLĖS;4540069843;Taip;10;0;5;15
3826;Krivūlė;BORUŽĖLĖS;4297876008;Taip;0;12;0;12
3827;Krivūlė;BORUŽĖLĖS;2138125571;Taip;15;0;1;16
3828;Krivūlė;BORUŽĖLĖS;4257468922;Taip;0;1;0;1
3829;Krivūlė;BORUŽĖLĖS;4177660973;Taip;0;3;0;3
3830;Krivūlė;BORUŽĖLĖS;2517785727;Taip;19;0;0;19
3831;Krivūlė;BORUŽĖLĖS;2711010212;Taip;14;0;0;14
3832;Krivūlė;BORUŽĖLĖS;4025821636;Taip;17;0;0;17
3833;Krivūlė;DRUGELIŲ;23648162135;Taip;0;0;1;1
3834;Krivūlė;DRUGELIŲ;1061891147;Taip;0;0;1;1
3835;Krivūlė;DRUGELIŲ;3203271448;Taip;0;0;4;4
3836;Krivūlė;DRUGELIŲ;56163922565;Taip;9;5;0;14
3837;Krivūlė;DRUGELIŲ;13434120023;Taip;6;0;5;11
3838;Krivūlė;DRUGELIŲ;60140618216;Taip;0;0;2;2
3839;Krivūlė;DRUGELIŲ;54700834388;Taip;0;0;1;1
3840;Krivūlė;DRUGELIŲ;1465116151;Taip;0;0;8;8
3841;Krivūlė;DRUGELIŲ;1091759903;Taip;0;0;3;3
3842;Krivūlė;DRUGELIŲ;3594180341;Ne;0;0;1;1
3843;Krivūlė;DRUGELIŲ;7042541581;Ne;0;0;2;2
3844;Krivūlė;"BITUTĖS (VALDOFRO)";4205061357;Taip;2;0;0;2
3845;Krivūlė;"BITUTĖS (VALDOFRO)";73736799724;Taip;3;0;2;5
3846;Krivūlė;"BITUTĖS (VALDOFRO)";60958909807;Taip;10;0;0;10
3847;Krivūlė;"BITUTĖS (VALDOFRO)";66552145067;Taip;0;3;1;4
3848;Krivūlė;"BITUTĖS (VALDOFRO)";66555601736;Taip;0;0;2;2
3849;Krivūlė;"BITUTĖS (VALDOFRO)";99074500749;Taip;0;0;2;2
3850;Krivūlė;"BITUTĖS (VALDOFRO)";46337826378;Taip;4;7;0;11
3851;Krivūlė;"BITUTĖS (VALDOFRO)";98620856056;Taip;0;8;0;8
3852;Krivūlė;"BITUTĖS (VALDOFRO)";1588621536;Taip;0;0;1;1
3853;Krivūlė;"BITUTĖS (VALDOFRO)";97075230746;Taip;0;0;1;1
3854;Krivūlė;"BITUTĖS (VALDOFRO)";91939517475;Taip;0;0;1;1
3855;Krivūlė;"BITUTĖS (VALDOFRO)";97859012083;Taip;3;3;3;9
3856;Krivūlė;"BITUTĖS (VALDOFRO)";37704437957;Taip;0;6;6;12
3857;Krivūlė;"BITUTĖS (VALDOFRO)";2425023811;Taip;13;0;0;13
3858;Krivūlė;"BITUTĖS (VALDOFRO)";4838666934;Taip;4;0;0;4
3859;Krivūlė;"BITUTĖS (VALDOFRO)";3994278221;Taip;4;0;0;4
3860;Krivūlė;"BITUTĖS (VALDOFRO)";3868507751;Taip;5;0;0;5
3861;Krivūlė;"BITUTĖS (VALDOFRO)";18486357195;Taip;10;0;3;13
3862;Krivūlė;"BITUTĖS (VALDOFRO)";1851097789;Taip;8;0;0;8
3863;Krivūlė;"BITUTĖS (VALDOFRO)";2030169515;Taip;12;0;0;12
3864;Krivūlė;"BITUTĖS (VALDOFRO)";7789248863;Taip;0;0;1;1
3865;Krivūlė;"BITUTĖS (VALDOFRO)";4823819882;Taip;17;0;0;17
3866;Krivūlė;"BITUTĖS (VALDOFRO)";5113297248;Taip;0;0;5;5
3867;Krivūlė;EŽIUKAI;44741515819;Taip;2;0;0;2
3868;Krivūlė;EŽIUKAI;2099607493;Taip;16;0;1;17
3869;Krivūlė;EŽIUKAI;1290759541;Taip;5;0;4;9
3870;Krivūlė;EŽIUKAI;28308524979;Taip;14;0;0;14
3871;Krivūlė;EŽIUKAI;1699961817;Taip;0;0;18;18
3872;Krivūlė;EŽIUKAI;96319752378;Ne;2;0;2;4
3873;Krivūlė;EŽIUKAI;66981981114;Taip;0;7;0;7
3874;Krivūlė;EŽIUKAI;1265788772;Taip;2;0;1;3
3875;Krivūlė;EŽIUKAI;1113101710;Taip;0;0;2;2
3876;Krivūlė;EŽIUKAI;8463621294;Taip;0;0;5;5
3877;Krivūlė;EŽIUKAI;86659723162;Taip;7;0;2;9
3878;Krivūlė;EŽIUKAI;2125078552;Ne;15;0;0;15
3879;Krivūlė;EŽIUKAI;2903062788;Ne;5;0;0;5
3880;Krivūlė;EŽIUKAI;81401012140;Ne;0;8;0;8
3881;Krivūlė;NYKŠTUKAI;37502093836;Taip;5;0;4;9
3882;Krivūlė;NYKŠTUKAI;83840444975;Taip;5;0;4;9
3883;Krivūlė;NYKŠTUKAI;701438210;Taip;15;0;0;15
3884;Krivūlė;NYKŠTUKAI;1657452686;Taip;5;0;2;7
3885;Krivūlė;NYKŠTUKAI;73760357378;Taip;0;0;1;1
3886;Krivūlė;NYKŠTUKAI;3015266398;Taip;4;8;0;12
3887;Krivūlė;NYKŠTUKAI;7873123757;Taip;4;2;1;7
3888;Krivūlė;NYKŠTUKAI;97398901468;Taip;4;0;0;4
3889;Krivūlė;NYKŠTUKAI;1515185307;Taip;0;2;0;2
3890;Krivūlė;NYKŠTUKAI;1217856292;Taip;8;7;2;17
3891;Krivūlė;NYKŠTUKAI;3064591570;Taip;5;5;0;10
3892;Krivūlė;NYKŠTUKAI;7922515745;Taip;8;0;0;8
3893;Krivūlė;NYKŠTUKAI;9311270695;Taip;0;0;14;14
3894;Krivūlė;NYKŠTUKAI;6861483854;Ne;8;0;2;10
3895;Krivūlė;NYKŠTUKAI;1283858948;Taip;18;0;0;18
3896;Krivūlė;NYKŠTUKAI;7052198958;Taip;9;0;0;9
3897;Krivūlė;NYKŠTUKAI;5818988913;Taip;0;0;3;3
3898;Kodėlčiukas;Saulutės;42540143229;Taip;2;0;0;2
3899;Kodėlčiukas;Saulutės;79090323340;Taip;0;6;0;6
3900;Kodėlčiukas;Saulutės;5922075420;Taip;0;5;0;5
3901;Kodėlčiukas;Saulutės;1905426469;Taip;10;0;0;10
3902;Kodėlčiukas;Saulutės;79742559803;Taip;0;0;1;1
3903;Kodėlčiukas;Saulutės;62309098505;Taip;0;1;0;1
3904;Kodėlčiukas;Saulutės;14611425618;Taip;0;5;0;5
3905;Kodėlčiukas;Saulutės;49784617790;Taip;0;6;0;6
3906;Kodėlčiukas;Saulutės;43335982030;Taip;14;0;0;14
3907;Kodėlčiukas;Saulutės;49731697380;Taip;0;1;0;1
3908;Kodėlčiukas;Saulutės;23065888472;Taip;0;5;0;5
3909;Kodėlčiukas;Saulutės;1730913401;Taip;2;0;6;8
3910;Kodėlčiukas;Saulutės;66109277013;Taip;0;5;0;5
3911;Kodėlčiukas;Saulutės;45910018746;Taip;0;3;0;3
3912;Kodėlčiukas;Saulutės;1608321100;Taip;0;1;2;3
3913;Kodėlčiukas;Saulutės;24024963204;Ne;0;0;2;2
3914;Kodėlčiukas;Saulutės;1290630625;Taip;16;0;0;16
3915;Kodėlčiukas;Saulutės;9323563664;Taip;0;4;0;4
3916;Kodėlčiukas;Nežiniukai;49317624340;Taip;11;0;1;12
3917;Kodėlčiukas;Nežiniukai;41477530966;Taip;0;2;1;3
3918;Kodėlčiukas;Nežiniukai;69860272843;Taip;0;1;0;1
3919;Kodėlčiukas;Nežiniukai;52040715568;Taip;0;10;0;10
3920;Kodėlčiukas;Nežiniukai;37852137155;Taip;5;0;0;5
3921;Kodėlčiukas;Nežiniukai;86134523927;Taip;6;0;2;8
3922;Kodėlčiukas;Nežiniukai;47677246360;Taip;7;2;0;9
3923;Kodėlčiukas;Nežiniukai;46307870009;Taip;4;10;4;18
3924;Kodėlčiukas;Nežiniukai;35337024913;Taip;6;2;1;9
3925;Kodėlčiukas;Nežiniukai;82927457803;Taip;0;0;1;1
3926;Kodėlčiukas;Nežiniukai;33432780322;Taip;5;7;0;12
3927;Kodėlčiukas;Nežiniukai;96270550335;Taip;0;2;1;3
3928;Kodėlčiukas;Nežiniukai;98476858512;Taip;6;0;0;6
3929;Kodėlčiukas;Nežiniukai;50234358109;Taip;10;7;0;17
3930;Kodėlčiukas;Nežiniukai;53066448447;Taip;0;10;0;10
3931;Kodėlčiukas;Nežiniukai;30874603769;Ne;0;0;14;14
3932;Kodėlčiukas;Nežiniukai;50411894014;Ne;0;0;5;5
3933;Kodėlčiukas;Nežiniukai;93698504377;Taip;5;0;3;8
3934;Kodėlčiukas;Nežiniukai;1518135854;Ne;0;0;4;4
3935;Kodėlčiukas;Nežiniukai;41664027247;Taip;0;0;4;4
3936;Kodėlčiukas;Nežiniukai;35779814505;Taip;0;4;0;4
3937;Kodėlčiukas;Nežiniukai;1614088526;Taip;0;0;9;9
3938;Kodėlčiukas;Nežiniukai;1347742983;Taip;0;0;2;2
3939;Kodėlčiukas;Nežiniukai;1951603132;Taip;0;0;3;3
3940;Kodėlčiukas;Nežiniukai;15211280060;Taip;0;0;2;2
3941;Kodėlčiukas;Gintarėliai;58406224468;Taip;5;0;3;8
3942;Kodėlčiukas;Gintarėliai;1485012710;Taip;0;8;0;8
3943;Kodėlčiukas;Gintarėliai;5520128823;Taip;0;5;0;5
3944;Kodėlčiukas;Gintarėliai;2062878300;Taip;5;7;0;12
3945;Kodėlčiukas;Gintarėliai;1950934087;Taip;6;0;0;6
3946;Kodėlčiukas;Gintarėliai;4884104023;Taip;5;5;1;11
3947;Kodėlčiukas;Gintarėliai;1632458573;Taip;0;2;0;2
3948;Kodėlčiukas;Gintarėliai;9332136116;Taip;8;0;0;8
3949;Kodėlčiukas;Gintarėliai;4944791330;Taip;7;0;0;7
3950;Kodėlčiukas;Gintarėliai;8219424737;Taip;6;0;0;6
3951;Kodėlčiukas;Gintarėliai;3758606327;Taip;0;0;3;3
3952;Kodėlčiukas;Gintarėliai;8647609373;Taip;10;0;12;22
3953;Kodėlčiukas;Gintarėliai;5093139270;Taip;4;0;2;6
3954;Kodėlčiukas;Gintarėliai;4738357524;Taip;0;0;3;3
3955;Kodėlčiukas;Gintarėliai;8075591032;Taip;5;0;2;7
3956;Kodėlčiukas;Gintarėliai;8873629130;Ne;10;0;0;10
3957;Kodėlčiukas;Gintarėliai;2765869141;Taip;7;0;3;10
3958;Kodėlčiukas;Šnekučiai;1844016431;Taip;0;0;3;3
3959;Kodėlčiukas;Šnekučiai;1550915654;Taip;0;7;0;7
3960;Kodėlčiukas;Šnekučiai;1935757837;Taip;5;2;0;7
3961;Kodėlčiukas;Šnekučiai;41123326737;Taip;0;1;0;1
3962;Kodėlčiukas;Šnekučiai;8114859362;Taip;10;0;3;13
3963;Kodėlčiukas;Šnekučiai;1666743304;Taip;7;0;0;7
3964;Kodėlčiukas;Šnekučiai;1432342305;Taip;0;0;1;1
3965;Kodėlčiukas;Šnekučiai;1584936719;Ne;0;0;3;3
3966;Kodėlčiukas;Šnekučiai;9178209049;Taip;0;0;10;10
3967;Kodėlčiukas;Šnekučiai;5988863934;Taip;5;11;0;16
3968;Kodėlčiukas;Šnekučiai;2742365461;Taip;0;5;0;5
3969;Kodėlčiukas;Šnekučiai;76164689333;Ne;0;1;1;2
3970;Kodėlčiukas;Šnekučiai;5386820408;Taip;0;5;0;5
3971;Kodėlčiukas;Šnekučiai;6194726931;Taip;0;12;0;12
3972;Kodėlčiukas;Šnekučiai;6327741830;Taip;18;0;0;18
3973;Kodėlčiukas;Šnekučiai;5782600824;Taip;5;0;0;5
3974;Kodėlčiukas;Šnekučiai;7074381835;Ne;15;0;1;16
3975;Kodėlčiukas;Šnekučiai;7757494295;Taip;2;0;3;5
3976;Kodėlčiukas;Šnekučiai;5827455834;Taip;4;0;2;6
3977;Kodėlčiukas;Šnekučiai;2988674717;Taip;14;0;1;15
3978;Kodėlčiukas;Pabiručiai;2108297221;Taip;5;0;1;6
3979;Kodėlčiukas;Pabiručiai;39617728687;Taip;0;0;3;3
3980;Kodėlčiukas;Pabiručiai;81633973264;Taip;0;7;3;10
3981;Kodėlčiukas;Pabiručiai;51185323645;Ne;0;5;0;5
3982;Kodėlčiukas;Pabiručiai;48423906431;Taip;0;11;1;12
3983;Kodėlčiukas;Pabiručiai;87708953660;Taip;7;0;0;7
3984;Kodėlčiukas;Pabiručiai;53418429595;Taip;0;1;0;1
3985;Kodėlčiukas;Pabiručiai;98729047811;Taip;0;0;1;1
3986;Kodėlčiukas;Pabiručiai;88106769076;Taip;0;0;10;10
3987;Kodėlčiukas;Pabiručiai;88962123607;Taip;0;0;1;1
3988;Kodėlčiukas;Pabiručiai;62762045244;Taip;0;10;0;10
3989;Kodėlčiukas;Pabiručiai;5333383758;Taip;0;0;1;1
3990;Kodėlčiukas;Pabiručiai;21552812103;Taip;9;0;0;9
3991;Kodėlčiukas;Pabiručiai;63558518927;Taip;4;0;0;4
3992;Kodėlčiukas;Pabiručiai;6878848127;Taip;5;0;0;5
3993;Kodėlčiukas;Pabiručiai;87517377176;Taip;0;0;2;2
3994;Kodėlčiukas;Pabiručiai;94058317569;Taip;4;0;1;5
3995;Kodėlčiukas;Pabiručiai;77935011738;Taip;0;0;3;3
3996;Kodėlčiukas;Pabiručiai;2315513519;Taip;0;0;2;2
3997;Kodėlčiukas;Pabiručiai;1833960742;Taip;0;10;0;10
3998;Kodėlčiukas;Pabiručiai;5421835194;Taip;15;0;0;15
3999;Kodėlčiukas;Pabiručiai;60728060670;Taip;0;2;0;2
4000;Kodėlčiukas;Smalsučiai;83992508203;Taip;10;0;0;10
4001;Kodėlčiukas;Smalsučiai;20612460521;Taip;0;1;3;4
4002;Kodėlčiukas;Smalsučiai;36383021317;Ne;10;7;0;17
4003;Kodėlčiukas;Smalsučiai;14856898838;Taip;0;0;5;5
4004;Kodėlčiukas;Smalsučiai;96798716829;Taip;4;3;0;7
4005;Kodėlčiukas;Smalsučiai;30131221448;Taip;0;0;5;5
4006;Kodėlčiukas;Smalsučiai;84863948327;Taip;0;0;1;1
4007;Kodėlčiukas;Smalsučiai;85578471272;Taip;0;0;4;4
4008;Kodėlčiukas;Smalsučiai;74068673680;Taip;0;0;1;1
4009;Kodėlčiukas;Smalsučiai;70047045302;Ne;0;3;0;3
4010;Kodėlčiukas;Smalsučiai;83002620619;Taip;0;1;0;1
4011;Kodėlčiukas;Smalsučiai;39818301789;Taip;0;16;0;16
4012;Kodėlčiukas;Smalsučiai;32715685481;Taip;0;0;5;5
4013;Kodėlčiukas;Smalsučiai;90639838215;Taip;0;0;6;6
4014;Kodėlčiukas;Smalsučiai;76998539095;Taip;0;8;7;15
4015;Kodėlčiukas;Smalsučiai;10616561892;Taip;0;0;4;4
4016;Kodėlčiukas;Smalsučiai;59447524564;Taip;6;0;0;6
4017;Kodėlčiukas;Giliukai;26010333641;Taip;0;0;1;1
4018;Kodėlčiukas;Giliukai;1782784297;Taip;5;3;0;8
4019;Kodėlčiukas;Giliukai;97902789189;Taip;10;0;0;10
4020;Kodėlčiukas;Giliukai;93684599166;Taip;0;1;3;4
4021;Kodėlčiukas;Giliukai;80767435810;Taip;5;5;6;16
4022;Kodėlčiukas;Giliukai;62063291384;Taip;0;2;3;5
4023;Kodėlčiukas;Giliukai;1825630143;Taip;0;3;18;21
4024;Kodėlčiukas;Giliukai;11130172902;Taip;5;0;2;7
4025;Kodėlčiukas;Giliukai;29830674331;Taip;0;0;1;1
4026;Kodėlčiukas;Giliukai;24138056567;Taip;0;0;1;1
4027;Kodėlčiukas;Giliukai;84905680496;Taip;0;7;0;7
4028;Kodėlčiukas;Giliukai;58893099621;Taip;0;0;5;5
4029;Kodėlčiukas;Giliukai;2637712514;Taip;0;0;8;8
4030;Kodėlčiukas;Giliukai;1354133871;Taip;0;0;9;9
4031;Kodėlčiukas;Giliukai;45393129631;Taip;7;0;3;10
4032;Kodėlčiukas;Giliukai;47667750562;Taip;0;6;7;13
4033;Kodėlčiukas;Giliukai;8204069897;Taip;5;0;0;5
4034;Kodėlčiukas;Giliukai;1938753417;Taip;0;0;3;3
4035;Kodėlčiukas;Giliukai;29319461634;Taip;0;2;0;2
4036;Kodėlčiukas;Gudručiai;20467065338;Taip;6;0;0;6
4037;Kodėlčiukas;Gudručiai;15580950604;Taip;0;0;1;1
4038;Kodėlčiukas;Gudručiai;44431255380;Taip;0;0;7;7
4039;Kodėlčiukas;Gudručiai;32318234528;Ne;10;0;1;11
4040;Kodėlčiukas;Gudručiai;9315712284;Taip;0;0;2;2
4041;Kodėlčiukas;Gudručiai;93275059990;Taip;10;1;0;11
4042;Kodėlčiukas;Gudručiai;18557158044;Taip;0;0;1;1
4043;Kodėlčiukas;Gudručiai;3542081571;Ne;20;0;0;20
4044;Kodėlčiukas;Gudručiai;1234971388;Taip;0;0;2;2
4045;Kodėlčiukas;Gudručiai;1048653620;Ne;0;7;0;7
4046;Kodėlčiukas;Gudručiai;1202105251;Taip;4;0;2;6
4047;Kodėlčiukas;Gudručiai;1978279511;Taip;0;0;1;1
4048;Kodėlčiukas;Gudručiai;1251970125;Taip;0;0;2;2
4049;Kodėlčiukas;Gudručiai;6186365121;Taip;0;0;1;1
4050;Kodėlčiukas;Gudručiai;70940790491;Taip;0;0;1;1
4051;Kodėlčiukas;Gudručiai;6168432879;Taip;0;0;1;1
4052;Kodėlčiukas;Gudručiai;1106092960;Taip;0;0;4;4
4053;Kodėlčiukas;Gudručiai;8393750817;Taip;0;0;4;4
4054;Kodėlčiukas;Gudručiai;2061169442;Taip;0;0;5;5
4055;Kodėlčiukas;Gudručiai;1115828736;Taip;0;0;1;1
4056;Kodėlčiukas;Gudručiai;1723716524;Taip;17;0;0;17
4057;Kodėlčiukas;Gudručiai;87784905691;Taip;0;0;2;2
4058;Kodėlčiukas;Žirniukai;1645680526;Taip;0;0;3;3
4059;Kodėlčiukas;Žirniukai;7327247516;Taip;7;0;0;7
4060;Kodėlčiukas;Žirniukai;1725624698;Taip;6;1;0;7
4061;Kodėlčiukas;Žirniukai;6988515253;Taip;22;0;0;22
4062;Kodėlčiukas;Žirniukai;3385551650;Taip;12;0;0;12
4063;Kodėlčiukas;Žirniukai;7080578299;Taip;14;0;0;14
4064;Kodėlčiukas;Žirniukai;9865803714;Taip;14;0;6;20
4065;Kodėlčiukas;Žirniukai;7430239198;Taip;12;0;0;12
4066;Kodėlčiukas;Žirniukai;2464972409;Taip;10;0;7;17
4067;Kodėlčiukas;Žirniukai;7116594055;Taip;0;9;2;11
4068;Kodėlčiukas;Žirniukai;8393893311;Taip;0;0;1;1
4069;Kodėlčiukas;Žirniukai;7509476161;Taip;7;0;0;7
4070;Kodėlčiukas;Žirniukai;4687333060;Taip;5;0;0;5
4071;Kodėlčiukas;Žirniukai;1491160730;Taip;3;0;0;3
4072;Kodėlčiukas;Žirniukai;2216791610;Taip;14;0;2;16
4073;Kodėlčiukas;Katinėliai;6248137523;Taip;0;0;1;1
4074;Kodėlčiukas;Katinėliai;1233880820;Taip;0;0;9;9
4075;Kodėlčiukas;Katinėliai;5443377251;Taip;2;6;3;11
4076;Kodėlčiukas;Katinėliai;7971932716;Taip;3;0;0;3
4077;Kodėlčiukas;Katinėliai;6045564826;Taip;19;0;0;19
4078;Kodėlčiukas;Katinėliai;7282579315;Taip;2;0;4;6
4079;Kodėlčiukas;Katinėliai;6905424567;Taip;0;0;3;3
4080;Kodėlčiukas;Katinėliai;7626940433;Taip;0;7;0;7
4081;Kodėlčiukas;Katinėliai;9803206596;Taip;17;0;0;17
4082;Kodėlčiukas;Katinėliai;4917910801;Taip;0;6;0;6
4083;Kodėlčiukas;Katinėliai;1699358514;Taip;2;0;5;7
4084;Kodėlčiukas;Katinėliai;4038168647;Taip;0;0;1;1
4085;Kodėlčiukas;Katinėliai;8378295683;Taip;21;1;0;22
4086;Kodėlčiukas;Katinėliai;6000831611;Taip;0;0;9;9
4087;Kodėlčiukas;Nykštukai;7246243975;Ne;0;2;0;2
4088;Kodėlčiukas;Nykštukai;1906128091;Taip;11;0;0;11
4089;Kodėlčiukas;Nykštukai;8140940288;Taip;11;0;1;12
4090;Kodėlčiukas;Nykštukai;2929946390;Taip;0;11;0;11
4091;Kodėlčiukas;Nykštukai;9528997865;Taip;22;0;0;22
4092;Kodėlčiukas;Nykštukai;3782714343;Taip;17;0;0;17
4093;Kodėlčiukas;Nykštukai;1600501494;Taip;3;0;1;4
4094;Kodėlčiukas;Nykštukai;9460792167;Taip;1;0;2;3
4095;Kodėlčiukas;Nykštukai;1256650715;Taip;2;0;0;2
4096;Kodėlčiukas;Nykštukai;4818678923;Taip;17;0;0;17
4097;Kodėlčiukas;Nykštukai;8302606312;Taip;0;0;3;3
4098;Kodėlčiukas;Nykštukai;1919722425;Taip;0;0;2;2
4099;Kodėlčiukas;Nykštukai;1218904283;Taip;0;0;1;1
4100;Kodėlčiukas;Nykštukai;3880019350;Taip;13;0;1;14
4101;Kodėlčiukas;Nykštukai;7630180473;Taip;0;0;8;8
4102;Kodėlčiukas;Nykštukai;9589692031;Taip;18;0;2;20
4103;Kodėlčiukas;Nykštukai;2593524511;Taip;5;0;0;5
4104;Kodėlčiukas;Nykštukai;9794875862;Taip;2;0;1;3
4105;Kodėlčiukas;Nykštukai;1052656432;Taip;0;3;2;5
4106;Klevelis;Gėlytės;61178149504;Taip;0;7;0;7
4107;Klevelis;Gėlytės;1907412546;Taip;9;0;0;9
4108;Klevelis;Gėlytės;36864673412;Ne;0;4;0;4
4109;Klevelis;Gėlytės;65540816272;Taip;0;7;0;7
4110;Klevelis;Gėlytės;8756257605;Taip;4;0;0;4
4111;Klevelis;Gėlytės;15615294726;Taip;6;0;2;8
4112;Klevelis;Gėlytės;3101947555;Taip;0;7;0;7
4113;Klevelis;Gėlytės;7829685182;Taip;6;0;4;10
4114;Klevelis;Gėlytės;32438253753;Taip;3;0;0;3
4115;Klevelis;Gėlytės;68457250471;Ne;7;0;0;7
4116;Klevelis;Gėlytės;1024982577;Ne;0;9;0;9
4117;Klevelis;Gėlytės;7309676894;Taip;0;10;0;10
4118;Klevelis;Gėlytės;1942666372;Taip;0;20;0;20
4119;Klevelis;Gėlytės;50441219517;Taip;1;1;0;2
4120;Klevelis;Gėlytės;8154620920;Ne;0;10;0;10
4121;Klevelis;Paukšteliai;1606294984;Taip;0;3;0;3
4122;Klevelis;Paukšteliai;1953918266;Taip;0;7;0;7
4123;Klevelis;Paukšteliai;1685710938;Taip;0;3;0;3
4124;Klevelis;Paukšteliai;4400576631;Taip;10;0;0;10
4125;Klevelis;Paukšteliai;7506522045;Taip;4;0;1;5
4126;Klevelis;Paukšteliai;8155136607;Ne;0;13;0;13
4127;Klevelis;Paukšteliai;2043650571;Ne;0;10;0;10
4128;Klevelis;Paukšteliai;6172016747;Taip;0;2;0;2
4129;Klevelis;Paukšteliai;23520576240;Taip;0;3;0;3
4130;Klevelis;Paukšteliai;4930308435;Taip;0;2;0;2
4131;Klevelis;Paukšteliai;3408705916;Taip;0;22;0;22
4132;Klevelis;Paukšteliai;2555810841;Taip;12;0;0;12
4133;Klevelis;Paukšteliai;5024289280;Taip;0;0;4;4
4134;Klevelis;Paukšteliai;3437712794;Taip;1;1;0;2
4135;Klevelis;Paukšteliai;2744433344;Taip;18;0;1;19
4136;Klevelis;Paukšteliai;5354831337;Ne;0;17;0;17
4137;Klevelis;Paukšteliai;1851385706;Taip;0;3;0;3
4138;Klevelis;Spindulėliai;8957321461;Taip;0;14;0;14
4139;Klevelis;Spindulėliai;72505352951;Ne;0;4;0;4
4140;Klevelis;Spindulėliai;36733972781;Ne;0;4;0;4
4141;Klevelis;Spindulėliai;1929138590;Taip;1;4;0;5
4142;Klevelis;Spindulėliai;71637673796;Taip;0;7;0;7
4143;Klevelis;Spindulėliai;49983865253;Taip;0;17;0;17
4144;Klevelis;Spindulėliai;85910214189;Taip;0;4;0;4
4145;Klevelis;Spindulėliai;27776527268;Ne;0;2;0;2
4146;Klevelis;Spindulėliai;1299222411;Taip;0;5;0;5
4147;Klevelis;Spindulėliai;2041814549;Taip;2;4;0;6
4148;Klevelis;Spindulėliai;30473769754;Taip;0;0;1;1
4149;Klevelis;Spindulėliai;1608781752;Taip;0;5;0;5
4150;Klevelis;Spindulėliai;32063805512;Taip;0;10;0;10
4151;Klevelis;Spindulėliai;5786557195;Taip;6;0;0;6
4152;Klevelis;Spindulėliai;1980755137;Taip;0;1;0;1
4153;Klevelis;Spindulėliai;8246422485;Taip;0;2;0;2
4154;Klevelis;Spindulėliai;58302265771;Ne;0;4;0;4
4155;Klevelis;Spindulėliai;4733970252;Taip;0;7;0;7
4156;Klevelis;Spindulėliai;1141466643;Taip;0;4;0;4
4157;Klevelis;Spindulėliai;9125827523;Taip;0;2;0;2
4158;Klevelis;Spindulėliai;3397741232;Taip;6;7;0;13
4159;Klevelis;Spindulėliai;1520846063;Taip;0;2;0;2
4160;Klevelis;Spindulėliai;3201144750;Taip;0;4;0;4
4161;Klevelis;BORUŽĖLĖS;8195584468;Taip;5;2;0;7
4162;Klevelis;BORUŽĖLĖS;8357021249;Taip;1;0;2;3
4163;Klevelis;BORUŽĖLĖS;4558350854;Ne;0;0;1;1
4164;Klevelis;BORUŽĖLĖS;3873345138;Ne;9;0;7;16
4165;Klevelis;BORUŽĖLĖS;1020095914;Taip;14;0;0;14
4166;Klevelis;BORUŽĖLĖS;1749117711;Taip;4;0;5;9
4167;Klevelis;BORUŽĖLĖS;5402403433;Taip;9;0;2;11
4168;Klevelis;BORUŽĖLĖS;4424095457;Taip;8;0;0;8
4169;Klevelis;BORUŽĖLĖS;2207041148;Taip;16;0;0;16
4170;Klevelis;BORUŽĖLĖS;9291855374;Taip;11;0;0;11
4171;Klevelis;BORUŽĖLĖS;7855598075;Taip;12;1;0;13
4172;Klevelis;BORUŽĖLĖS;2031118410;Taip;6;1;0;7
4173;Klevelis;BORUŽĖLĖS;5705915729;Taip;1;0;2;3
4174;Klevelis;BORUŽĖLĖS;6488139414;Taip;12;0;1;13
4175;Klevelis;BORUŽĖLĖS;7115198351;Taip;16;0;0;16
4176;Klevelis;BORUŽĖLĖS;7559183263;Taip;0;2;0;2
4177;Kurpaitė;Viščiukų;8669676262;Taip;3;1;0;4
4178;Kurpaitė;Viščiukų;2827617670;Taip;18;0;0;18
4179;Kurpaitė;Viščiukų;4168882748;Taip;0;8;0;8
4180;Kurpaitė;Viščiukų;9062514113;Taip;0;6;0;6
4181;Kurpaitė;Viščiukų;9200404698;Ne;6;2;0;8
4182;Kurpaitė;Viščiukų;7546409044;Taip;0;20;0;20
4183;Kurpaitė;Viščiukų;8831080716;Taip;0;4;0;4
4184;Kurpaitė;Viščiukų;4592795281;Taip;0;16;0;16
4185;Kurpaitė;Viščiukų;9655585527;Taip;11;0;0;11
4186;Kurpaitė;Viščiukų;4684525618;Taip;0;19;0;19
4187;Kurpaitė;Viščiukų;9915241987;Taip;8;1;0;9
4188;Kurpaitė;Viščiukų;9529949992;Taip;10;0;0;10
4189;Kurpaitė;Viščiukų;4602268315;Taip;20;0;0;20
4190;Kurpaitė;Gėlyčių;9435979008;Taip;10;0;0;10
4191;Kurpaitė;Gėlyčių;7431793716;Taip;0;22;0;22
4192;Kurpaitė;Gėlyčių;72710210157;Taip;0;11;0;11
4193;Kurpaitė;Gėlyčių;24410351286;Ne;0;16;0;16
4194;Kurpaitė;Gėlyčių;2359555461;Taip;0;7;0;7
4195;Kurpaitė;Gėlyčių;1505783589;Taip;0;11;0;11
4196;Kurpaitė;Gėlyčių;7249931704;Taip;10;0;0;10
4197;Kurpaitė;Gėlyčių;3102257512;Taip;0;13;0;13
4198;Kurpaitė;Gėlyčių;58127430940;Taip;6;3;0;9
4199;Kurpaitė;Gėlyčių;1606617694;Taip;0;15;0;15
4200;Kurpaitė;Gėlyčių;1660650556;Taip;3;9;0;12
4201;Kurpaitė;Gėlyčių;1151128660;Taip;4;0;0;4
4202;Kurpaitė;Gėlyčių;1457318954;Taip;14;1;0;15
4203;Kurpaitė;Gėlyčių;2116580903;Taip;0;12;0;12
4204;Kurpaitė;Gėlyčių;65434834152;Taip;0;11;0;11
4205;Kurpaitė;Gėlyčių;3660687688;Taip;0;6;0;6
4206;Kurpaitė;Gėlyčių;9063294667;Ne;0;2;0;2
4207;Kurpaitė;Drugelių;49970457589;Taip;0;16;0;16
4208;Kurpaitė;Drugelių;62959992605;Taip;0;15;0;15
4209;Kurpaitė;Drugelių;38605683298;Taip;0;2;0;2
4210;Kurpaitė;Drugelių;5394176979;Taip;13;0;0;13
4211;Kurpaitė;Drugelių;5442955475;Taip;0;1;0;1
4212;Kurpaitė;Drugelių;31201788860;Taip;0;6;0;6
4213;Kurpaitė;Drugelių;66920939967;Taip;0;14;0;14
4214;Kurpaitė;Drugelių;1730735673;Taip;0;1;0;1
4215;Kurpaitė;Drugelių;52852801754;Taip;0;5;0;5
4216;Kurpaitė;Drugelių;43247754405;Taip;7;13;0;20
4217;Kurpaitė;Drugelių;54840686231;Taip;0;7;0;7
4218;Kurpaitė;Drugelių;48526842780;Taip;0;8;0;8
4219;Kurpaitė;Drugelių;61993267223;Taip;0;8;0;8
4220;Kurpaitė;Drugelių;1641562196;Taip;0;5;0;5
4221;Kurpaitė;Drugelių;71716344368;Taip;0;9;0;9
4222;Kurpaitė;Drugelių;48538300542;Taip;6;9;0;15
4223;Kurpaitė;Drugelių;51115562424;Taip;2;0;0;2
4224;Kurpaitė;Pelyčių;9919068986;Taip;0;12;0;12
4225;Kurpaitė;Pelyčių;54413485607;Taip;0;13;0;13
4226;Kurpaitė;Pelyčių;41686757437;Taip;0;13;0;13
4227;Kurpaitė;Pelyčių;32817744462;Ne;13;0;0;13
4228;Kurpaitė;Pelyčių;1993159901;Taip;0;12;0;12
4229;Kurpaitė;Pelyčių;32746331924;Taip;10;0;0;10
4230;Kurpaitė;Pelyčių;31034408890;Taip;0;1;0;1
4231;Kurpaitė;Pelyčių;42531654257;Taip;0;2;0;2
4232;Kurpaitė;Pelyčių;42230129130;Taip;0;9;0;9
4233;Kurpaitė;Pelyčių;28569380108;Taip;0;12;0;12
4234;Kurpaitė;Pelyčių;86497821794;Taip;9;1;0;10
4235;Kurpaitė;Pelyčių;34995551069;Taip;8;0;0;8
4236;Kurpaitė;Pelyčių;1136113867;Taip;0;18;0;18
4237;Kurpaitė;Pelyčių;1936055251;Taip;12;2;0;14
4238;Kurpaitė;Pelyčių;3697560973;Taip;15;0;0;15
4239;Kurpaitė;Pelyčių;5902371603;Taip;0;11;0;11
4240;Kūlverstukas;Saulutės;1816105412;Taip;0;6;0;6
4241;Kūlverstukas;Saulutės;1471794813;Taip;0;3;3;6
4242;Kūlverstukas;Saulutės;4028937969;Taip;5;8;9;22
4243;Kūlverstukas;Saulutės;1109035765;Taip;5;0;4;9
4244;Kūlverstukas;Saulutės;1570383265;Taip;5;8;0;13
4245;Kūlverstukas;Saulutės;46862868133;Taip;0;0;22;22
4246;Kūlverstukas;Saulutės;3737085009;Taip;5;0;0;5
4247;Kūlverstukas;Saulutės;49788909084;Taip;10;1;9;20
4248;Kūlverstukas;Saulutės;8362459952;Taip;0;0;1;1
4249;Kūlverstukas;Saulutės;74829986958;Taip;0;3;2;5
4250;Kūlverstukas;Saulutės;47399326083;Ne;1;0;0;1
4251;Kūlverstukas;Saulutės;21138396996;Taip;3;6;2;11
4252;Kūlverstukas;Saulutės;2072009099;Taip;9;0;0;9
4253;Kūlverstukas;Saulutės;1000393691;Taip;0;0;1;1
4254;Kūlverstukas;Saulutės;2135571148;Taip;0;5;5;10
4255;Kūlverstukas;Saulutės;1987591278;Taip;12;0;10;22
4256;Kūlverstukas;Saulutės;1396533792;Taip;4;0;12;16
4257;Kūlverstukas;Peledžiukai;52190958426;Taip;0;2;0;2
4258;Kūlverstukas;Peledžiukai;1399479148;Taip;1;0;0;1
4259;Kūlverstukas;Peledžiukai;85330859485;Taip;0;0;1;1
4260;Kūlverstukas;Peledžiukai;89965851223;Ne;0;5;0;5
4261;Kūlverstukas;Peledžiukai;46254945540;Taip;0;0;1;1
4262;Kūlverstukas;Peledžiukai;80342796585;Taip;3;4;0;7
4263;Kūlverstukas;Peledžiukai;1260193245;Taip;22;0;0;22
4264;Kūlverstukas;Peledžiukai;10716234461;Taip;0;3;0;3
4265;Kūlverstukas;Peledžiukai;9856560184;Taip;4;0;0;4
4266;Kūlverstukas;Peledžiukai;89179106633;Ne;0;8;0;8
4267;Kūlverstukas;Gelytės;1226883894;Taip;7;0;5;12
4268;Kūlverstukas;Gelytės;37991935289;Taip;1;3;0;4
4269;Kūlverstukas;Gelytės;7440474403;Taip;9;0;0;9
4270;Kūlverstukas;Gelytės;8891671739;Taip;12;0;10;22
4271;Kūlverstukas;Gelytės;3991821717;Taip;19;0;0;19
4272;Kūlverstukas;Gelytės;5488011852;Taip;10;0;2;12
4273;Kūlverstukas;Gelytės;3937419139;Taip;6;0;0;6
4274;Kūlverstukas;Gelytės;8092104136;Taip;0;5;3;8
4275;Kūlverstukas;Gelytės;7480593611;Ne;0;0;5;5
4276;Kūlverstukas;Gelytės;1699783763;Taip;0;5;0;5
4277;Kūlverstukas;Gelytės;1240006602;Taip;9;0;0;9
4278;Kūlverstukas;Gelytės;3162189859;Taip;5;13;3;21
4279;Kūlverstukas;Gelytės;5372936730;Taip;5;0;1;6
4280;Kūlverstukas;Gelytės;8243342948;Taip;3;1;0;4
4281;Kūlverstukas;Gelytės;1452422691;Taip;0;3;1;4
4282;Kūlverstukas;Bitutės;3270176280;Taip;15;0;0;15
4283;Kūlverstukas;Bitutės;1932066021;Ne;6;0;1;7
4284;Kūlverstukas;Bitutės;4073233921;Taip;0;0;5;5
4285;Kūlverstukas;Bitutės;9427388681;Taip;0;8;0;8
4286;Kūlverstukas;Bitutės;5345423038;Taip;0;0;1;1
4287;Kūlverstukas;Bitutės;8853848991;Taip;11;0;0;11
4288;Kūlverstukas;Bitutės;4285624305;Taip;11;0;11;22
4289;Kūlverstukas;Bitutės;5103259175;Taip;0;0;6;6
4290;Kūlverstukas;Bitutės;9167460438;Taip;7;0;2;9
4291;Kūlverstukas;Bitutės;2087570702;Taip;0;0;6;6
4292;Kūlverstukas;Bitutės;5488852698;Taip;10;0;0;10
4293;Kūlverstukas;Bitutės;2419847093;Taip;0;0;1;1
4294;Kūlverstukas;Bitutės;1898905623;Taip;22;0;0;22
4295;Kūlverstukas;Bitutės;3069047204;Taip;5;13;3;21
4296;Kūlverstukas;Bitutės;2169480822;Taip;0;2;2;4
4297;Lakštingala;Saulutės;33332213331;Taip;0;1;5;6
4298;Lakštingala;Saulutės;35681729219;Ne;0;2;0;2
4299;Lakštingala;Saulutės;1416434491;Taip;0;0;3;3
4300;Lakštingala;Saulutės;66011447350;Taip;0;0;1;1
4301;Lakštingala;Saulutės;17738218138;Taip;6;0;0;6
4302;Lakštingala;Saulutės;23753553201;Taip;6;0;1;7
4303;Lakštingala;Saulutės;31706572403;Ne;0;2;1;3
4304;Lakštingala;Saulutės;53652623242;Taip;0;2;3;5
4305;Lakštingala;Saulutės;51200162218;Taip;0;0;2;2
4306;Lakštingala;Saulutės;22211300772;Taip;3;0;3;6
4307;Lakštingala;Saulutės;18470272487;Taip;5;0;0;5
4308;Lakštingala;Saulutės;25804940619;Taip;2;2;0;4
4309;Lakštingala;Saulutės;35357852412;Taip;0;0;7;7
4310;Lakštingala;Saulutės;42865585801;Taip;0;1;0;1
4311;Lakštingala;Saulutės;30224525177;Taip;0;4;1;5
4312;Lakštingala;Saulutės;1914662837;Taip;0;9;0;9
4313;Lakštingala;Saulutės;18798639428;Taip;0;4;0;4
4314;Lakštingala;Saulutės;87760794641;Taip;0;6;0;6
4315;Lakštingala;Saulutės;87223860105;Ne;0;13;0;13
4316;Lakštingala;Saulutės;1451425863;Taip;5;0;0;5
4317;Lakštingala;Saulutės;75435214041;Taip;0;1;1;2
4318;Lakštingala;Saulutės;78156519200;Taip;0;0;1;1
4319;Lakštingala;Saulutės;98174553118;Taip;0;7;1;8
4320;Lakštingala;Nykštukai;45850246980;Taip;1;1;2;4
4321;Lakštingala;Nykštukai;74001349345;Taip;0;0;1;1
4322;Lakštingala;Nykštukai;51586922715;Taip;0;11;0;11
4323;Lakštingala;Nykštukai;31221126819;Taip;0;0;1;1
4324;Lakštingala;Nykštukai;95489864230;Taip;0;0;6;6
4325;Lakštingala;Nykštukai;10653315095;Ne;10;1;0;11
4326;Lakštingala;Nykštukai;96792864646;Taip;0;1;0;1
4327;Lakštingala;Nykštukai;43151626858;Taip;0;6;0;6
4328;Lakštingala;Nykštukai;79652151224;Ne;0;1;0;1
4329;Lakštingala;Nykštukai;5692087454;Taip;0;0;6;6
4330;Lakštingala;Nykštukai;93222430249;Taip;1;0;0;1
4331;Lakštingala;Nykštukai;89747320378;Taip;0;2;0;2
4332;Lakštingala;Nykštukai;79583726414;Taip;0;13;5;18
4333;Lakštingala;Nykštukai;2430795418;Taip;0;0;8;8
4334;Lakštingala;Nykštukai;62866040506;Taip;0;0;1;1
4335;Lakštingala;Nykštukai;98717827320;Taip;0;1;0;1
4336;Lakštingala;Nykštukai;57836156450;Taip;0;2;0;2
4337;Lakštingala;Nykštukai;50868279016;Taip;0;0;4;4
4338;Lakštingala;Nykštukai;3426133948;Taip;10;4;0;14
4339;Lakštingala;Nykštukai;37722153251;Taip;16;0;0;16
4340;Lakštingala;Bitutės;81628046226;Taip;0;1;0;1
4341;Lakštingala;Bitutės;63360792078;Taip;0;2;0;2
4342;Lakštingala;Bitutės;84925543738;Taip;0;2;0;2
4343;Lakštingala;Bitutės;1150148262;Ne;1;2;0;3
4344;Lakštingala;Bitutės;88634927621;Taip;0;7;0;7
4345;Lakštingala;Bitutės;58670695979;Ne;0;4;0;4
4346;Lakštingala;Bitutės;1208496587;Taip;0;5;0;5
4347;Lakštingala;Bitutės;1478103633;Taip;2;10;0;12
4348;Lakštingala;Bitutės;5460505229;Taip;0;2;2;4
4349;Lakštingala;Bitutės;43764846549;Taip;0;3;0;3
4350;Lakštingala;Bitutės;59776948588;Taip;4;0;3;7
4351;Lakštingala;Bitutės;7179277612;Taip;0;6;0;6
4352;Lakštingala;Bitutės;85722261846;Taip;0;4;0;4
4353;Lakštingala;Bitutės;1484725137;Ne;0;4;1;5
4354;Lakštingala;Bitutės;90557374701;Taip;5;0;1;6
4355;Lakštingala;Bitutės;70253545165;Taip;0;6;0;6
4356;Lakštingala;Bitutės;49381287243;Taip;0;2;1;3
4357;Lakštingala;Bitutės;96502788115;Taip;8;1;0;9
4358;Lakštingala;Bitutės;20671216208;Taip;0;0;1;1
4359;Lakštingala;Bitutės;3544861594;Taip;0;6;0;6
4360;Lakštingala;Bitutės;75081412082;Ne;0;0;1;1
4361;Lakštingala;Pūkeliai;91158318909;Taip;0;6;0;6
4362;Lakštingala;Pūkeliai;9610324086;Taip;0;0;1;1
4363;Lakštingala;Pūkeliai;95149875628;Taip;0;13;0;13
4364;Lakštingala;Pūkeliai;44713607631;Taip;4;2;0;6
4365;Lakštingala;Pūkeliai;46426227002;Taip;0;12;0;12
4366;Lakštingala;Pūkeliai;1646500057;Taip;9;0;0;9
4367;Lakštingala;Pūkeliai;82319560992;Taip;7;6;0;13
4368;Lakštingala;Pūkeliai;14826956710;Taip;10;0;1;11
4369;Lakštingala;Pūkeliai;92129853333;Taip;7;0;1;8
4370;Lakštingala;Pūkeliai;19356167631;Taip;5;1;0;6
4371;Lakštingala;Pūkeliai;33431377093;Taip;3;0;0;3
4372;Lakštingala;Pūkeliai;63698553352;Taip;2;0;0;2
4373;Lakštingala;Pūkeliai;16039738423;Taip;0;4;1;5
4374;Lakštingala;Pūkeliai;2106666739;Taip;14;0;0;14
4375;Lakštingala;Aitvariukai;36990696663;Taip;0;2;0;2
4376;Lakštingala;Aitvariukai;99780001413;Taip;0;7;15;22
4377;Lakštingala;Aitvariukai;20201679407;Taip;6;0;0;6
4378;Lakštingala;Aitvariukai;7857821609;Taip;0;4;0;4
4379;Lakštingala;Aitvariukai;68405766745;Taip;0;0;1;1
4380;Lakštingala;Aitvariukai;8946285512;Ne;0;2;0;2
4381;Lakštingala;Aitvariukai;33957315145;Taip;0;4;0;4
4382;Lakštingala;Aitvariukai;19833280319;Taip;5;0;0;5
4383;Lakštingala;Aitvariukai;2088394089;Ne;0;1;0;1
4384;Lakštingala;Aitvariukai;15819827141;Taip;0;2;0;2
4385;Lakštingala;Aitvariukai;84766974984;Taip;0;5;0;5
4386;Lakštingala;Aitvariukai;26675933922;Taip;0;1;0;1
4387;Lakštingala;Aitvariukai;69176146563;Taip;0;2;0;2
4388;Lakštingala;Aitvariukai;53444347656;Taip;0;16;0;16
4389;Lakštingala;Aitvariukai;8781225219;Taip;3;1;0;4
4390;Lakštingala;Aitvariukai;78648398334;Taip;0;20;0;20
4391;Lakštingala;Boružiukai;9795993812;Taip;2;0;1;3
4392;Lakštingala;Boružiukai;3280380015;Taip;3;0;0;3
4393;Lakštingala;Boružiukai;43313173294;Taip;15;0;0;15
4394;Lakštingala;Boružiukai;9004336424;Ne;0;0;3;3
4395;Lakštingala;Boružiukai;87470014156;Taip;7;0;0;7
4396;Lakštingala;Boružiukai;2072883878;Taip;0;1;0;1
4397;Lakštingala;Boružiukai;8873445262;Taip;20;0;0;20
4398;Lakštingala;Boružiukai;1898853302;Ne;3;0;4;7
4399;Lakštingala;Boružiukai;7443563000;Taip;4;0;0;4
4400;Lakštingala;Boružiukai;2792618575;Taip;0;16;0;16
4401;Lakštingala;Boružiukai;55720630870;Taip;11;0;0;11
4402;Lakštingala;Boružiukai;4818524423;Taip;0;5;0;5
4403;Lakštingala;Boružiukai;1444534032;Ne;0;0;1;1
4404;Lakštingala;Boružiukai;6150013105;Taip;7;1;0;8
4405;Lakštingala;Boružiukai;2130767942;Taip;0;0;19;19
4406;Lakštingala;Boružiukai;9724531753;Ne;0;8;1;9
4407;Lakštingala;Boružiukai;3758930567;Ne;0;0;2;2
4408;Lakštingala;"KIŠKUČIAI (SAV.)";64992551832;Taip;0;4;0;4
4409;Lakštingala;"KIŠKUČIAI (SAV.)";1169891428;Taip;10;0;0;10
4410;Lakštingala;"KIŠKUČIAI (SAV.)";63039806752;Taip;0;1;0;1
4411;Lakštingala;"KIŠKUČIAI (SAV.)";1409132656;Taip;0;8;0;8
4412;Lakštingala;"KIŠKUČIAI (SAV.)";1236087612;Taip;0;8;0;8
4413;Lakštingala;"KIŠKUČIAI (SAV.)";80762133625;Taip;0;2;0;2
4414;Lakštingala;"KIŠKUČIAI (SAV.)";1128658722;Taip;2;11;0;13
4415;Lakštingala;"KIŠKUČIAI (SAV.)";2083229761;Taip;0;2;0;2
4416;Lakštingala;"KIŠKUČIAI (SAV.)";1538315501;Taip;5;5;0;10
4417;Lakštingala;"KIŠKUČIAI (SAV.)";40853872375;Taip;0;2;0;2
4418;Lakštingala;"KIŠKUČIAI (SAV.)";1663637599;Ne;17;2;0;19
4419;Lakštingala;"KIŠKUČIAI (SAV.)";1716046309;Taip;5;1;0;6
4420;Lakštingala;"KIŠKUČIAI (SAV.)";3660645944;Ne;0;16;0;16
4421;Lakštingala;"KIŠKUČIAI (SAV.)";7038977283;Ne;0;11;0;11
4422;Lakštingala;"KIŠKUČIAI (SAV.)";80142440362;Taip;0;2;0;2
4423;Lakštingala;"KIŠKUČIAI (SAV.)";7623300327;Taip;13;0;0;13
4424;Lakštingala;"KIŠKUČIAI (SAV.)";2241000661;Taip;13;0;0;13
4425;Lakštingala;Žiogeliai;2104150466;Taip;1;0;0;1
4426;Lakštingala;Žiogeliai;9395512638;Taip;5;0;0;5
4427;Lakštingala;Žiogeliai;8705627810;Taip;0;2;2;4
4428;Lakštingala;Žiogeliai;1832608585;Taip;0;1;0;1
4429;Lakštingala;Žiogeliai;9958821769;Taip;0;1;0;1
4430;Lakštingala;Žiogeliai;7953724873;Taip;0;4;0;4
4431;Lakštingala;Žiogeliai;1411121466;Taip;5;1;0;6
4432;Lakštingala;Žiogeliai;8944088082;Taip;0;2;0;2
4433;Lakštingala;Žiogeliai;9897713625;Taip;3;3;0;6
4434;Lakštingala;Žiogeliai;70798601578;Taip;10;3;0;13
4435;Lakštingala;Žiogeliai;2039579203;Taip;2;0;0;2
4436;Lakštingala;Žiogeliai;6576202365;Taip;0;5;1;6
4437;Lakštingala;Žiogeliai;89044575245;Taip;5;1;0;6
4438;Lakštingala;Žiogeliai;7900597697;Taip;0;0;4;4
4439;Lakštingala;Žiogeliai;9497327995;Taip;7;0;0;7
4440;Lakštingala;Žiogeliai;8016552114;Taip;0;22;0;22
4441;Lakštingala;Žiogeliai;8470575927;Taip;5;4;0;9
4442;Lakštingala;SPINDULIUKAI;19003276281;Taip;5;2;0;7
4443;Lakštingala;SPINDULIUKAI;31911078405;Taip;5;2;0;7
4444;Lakštingala;SPINDULIUKAI;59343571746;Taip;8;0;0;8
4445;Lakštingala;SPINDULIUKAI;601001178;Taip;0;16;0;16
4446;Lakštingala;SPINDULIUKAI;42012300013;Taip;0;1;4;5
4447;Lakštingala;SPINDULIUKAI;58847206918;Taip;1;0;0;1
4448;Lakštingala;SPINDULIUKAI;5033145687;Taip;0;3;2;5
4449;Lakštingala;SPINDULIUKAI;26288159700;Taip;0;1;1;2
4450;Lakštingala;SPINDULIUKAI;11399672681;Taip;13;0;0;13
4451;Lakštingala;SPINDULIUKAI;95832669291;Taip;4;16;0;20
4452;Lakštingala;SPINDULIUKAI;4183492894;Taip;0;0;5;5
4453;Lakštingala;SPINDULIUKAI;48160996499;Ne;0;3;0;3
4454;Lakštingala;SPINDULIUKAI;70748679017;Taip;0;5;0;5
4455;Lakštingala;SPINDULIUKAI;37897965773;Taip;0;0;16;16
4456;Lakštingala;SPINDULIUKAI;4770775472;Taip;0;2;1;3
4457;Lakštingala;SPINDULIUKAI;8838078447;Ne;3;1;0;4
4458;Lakštingala;SPINDULIUKAI;7448175606;Taip;1;6;0;7
4459;Lakštingala;Pėledžiukai;98609129644;Taip;0;9;0;9
4460;Lakštingala;Pėledžiukai;2635399411;Taip;0;2;0;2
4461;Lakštingala;Pėledžiukai;1271455798;Taip;0;5;0;5
4462;Lakštingala;Pėledžiukai;1868573076;Taip;0;1;11;12
4463;Lakštingala;Pėledžiukai;14410791110;Taip;0;2;0;2
4464;Lakštingala;Pėledžiukai;1676655778;Taip;13;1;0;14
4465;Lakštingala;Pėledžiukai;15430318196;Taip;0;0;20;20
4466;Lakštingala;Pėledžiukai;9381815353;Taip;0;2;0;2
4467;Lakštingala;Pėledžiukai;25449089230;Taip;0;5;0;5
4468;Lakštingala;Pėledžiukai;36367286465;Taip;0;2;0;2
4469;Lakštingala;Pėledžiukai;91671174585;Taip;0;3;0;3
4470;Lakštingala;Pėledžiukai;1347480198;Ne;0;2;0;2
4471;Lakštingala;Pėledžiukai;88947243829;Taip;0;3;0;3
4472;Lakštingala;Pėledžiukai;6329787217;Taip;3;2;7;12
4473;Lakštingala;Pėledžiukai;58056130761;Taip;0;22;0;22
4474;Lakštingala;Pėledžiukai;1310400524;Taip;0;10;0;10
4475;Lakštingala;Pėledžiukai;2013216779;Taip;0;3;2;5
4476;Lakštingala;Pėledžiukai;8890852891;Taip;0;2;0;2
4477;Lakštingala;Pėledžiukai;9998322501;Taip;0;0;18;18
4478;Lakštingala;Katinėliai;9774836470;Taip;5;1;0;6
4479;Lakštingala;Katinėliai;7929034243;Taip;5;16;0;21
4480;Lakštingala;Katinėliai;8171357606;Taip;4;9;0;13
4481;Lakštingala;Katinėliai;6780591792;Taip;3;0;0;3
4482;Lakštingala;Katinėliai;9431217584;Taip;7;0;0;7
4483;Lakštingala;Katinėliai;2962846236;Taip;0;0;10;10
4484;Lakštingala;Katinėliai;3811230983;Taip;0;1;5;6
4485;Lakštingala;Katinėliai;6908873466;Taip;2;2;0;4
4486;Lakštingala;Katinėliai;5854794141;Taip;0;1;0;1
4487;Lakštingala;Katinėliai;8422745100;Taip;5;11;0;16
4488;Lakštingala;Katinėliai;5598711072;Taip;16;0;0;16
4489;Lakštingala;Katinėliai;1958696382;Taip;0;0;13;13
4490;Lakštingala;Katinėliai;2022621678;Taip;0;0;10;10
4491;Lakštingala;Katinėliai;4542992319;Taip;0;0;14;14
4492;Lakštingala;Katinėliai;8529259340;Taip;0;0;14;14
4493;Lakštingala;Deimantėliai;4032030375;Taip;8;7;0;15
4494;Lakštingala;Deimantėliai;1655202909;Taip;17;0;0;17
4495;Lakštingala;Deimantėliai;8284565948;Taip;5;0;5;10
4496;Lakštingala;Deimantėliai;1648466517;Taip;0;2;0;2
4497;Lakštingala;Deimantėliai;3993759015;Taip;16;0;0;16
4498;Lakštingala;Deimantėliai;3568151046;Taip;4;5;0;9
4499;Lakštingala;Deimantėliai;9725851433;Taip;14;0;0;14
4500;Lakštingala;Deimantėliai;4700135106;Taip;4;1;2;7
4501;Lakštingala;Deimantėliai;1863034132;Taip;22;0;0;22
4502;Lakštingala;Deimantėliai;9879064676;Ne;2;0;0;2
4503;Lakštingala;Deimantėliai;3369263112;Taip;6;3;0;9
4504;Lakštingala;Deimantėliai;9489982241;Taip;5;2;0;7
4505;Lakštingala;Deimantėliai;3724324861;Ne;22;0;0;22
4506;Lakštingala;Deimantėliai;2652305131;Taip;3;7;0;10
4507;Lakštingala;Deimantėliai;6332498461;Taip;1;5;2;8
4508;Lakštingala;Deimantėliai;9375002191;Taip;7;0;1;8
4509;Lakštingala;Deimantėliai;2941128360;Taip;0;0;1;1
4510;Lakštingala;Deimantėliai;9912622093;Taip;7;1;0;8
4511;Lašelis;VIŠČIUKAI;86191407652;Taip;8;0;0;8
4512;Lašelis;VIŠČIUKAI;8873895533;Taip;0;0;3;3
4513;Lašelis;VIŠČIUKAI;58391864442;Taip;0;2;0;2
4514;Lašelis;VIŠČIUKAI;10694830733;Ne;0;10;0;10
4515;Lašelis;VIŠČIUKAI;4320017329;Taip;0;0;1;1
4516;Lašelis;VIŠČIUKAI;14934740494;Ne;0;8;0;8
4517;Lašelis;VIŠČIUKAI;8332516807;Taip;4;0;0;4
4518;Lašelis;VIŠČIUKAI;1282991939;Taip;4;0;0;4
4519;Lašelis;VIŠČIUKAI;60394164372;Taip;11;0;0;11
4520;Lašelis;VIŠČIUKAI;713862923;Taip;0;0;5;5
4521;Lašelis;VIŠČIUKAI;82073061357;Taip;7;0;0;7
4522;Lašelis;VIŠČIUKAI;4277113412;Ne;12;6;0;18
4523;Lašelis;VIŠČIUKAI;7349722463;Taip;0;4;0;4
4524;Lašelis;VIŠČIUKAI;2429224297;Taip;0;9;0;9
4525;Lašelis;VIŠČIUKAI;1383759549;Taip;16;0;0;16
4526;Lašelis;VIŠČIUKAI;2118500745;Taip;0;0;2;2
4527;Lašelis;VIŠČIUKAI;5437008837;Taip;10;0;3;13
4528;Lašelis;VIŠČIUKAI;1171647193;Taip;13;0;0;13
4529;Lašelis;ŠYPSENA;9391594216;Taip;2;13;0;15
4530;Lašelis;ŠYPSENA;65174922062;Ne;5;8;0;13
4531;Lašelis;ŠYPSENA;6977000987;Taip;2;0;0;2
4532;Lašelis;ŠYPSENA;4599789649;Ne;0;16;0;16
4533;Lašelis;ŠYPSENA;6136792125;Ne;5;0;0;5
4534;Lašelis;ŠYPSENA;6090290046;Taip;7;0;0;7
4535;Lašelis;ŠYPSENA;1417989409;Taip;7;0;1;8
4536;Lašelis;ŠYPSENA;1193336600;Taip;0;11;0;11
4537;Lašelis;ŠYPSENA;1268330178;Taip;19;1;0;20
4538;Lašelis;ŠYPSENA;1739797553;Taip;0;3;0;3
4539;Lašelis;ŠYPSENA;1578956182;Taip;5;1;0;6
4540;Lašelis;ŠYPSENA;2113295854;Ne;0;0;2;2
4541;Lašelis;ŠYPSENA;2500332755;Ne;0;1;0;1
4542;Lašelis;ŠYPSENA;1953392509;Taip;0;0;1;1
4543;Lašelis;ŠYPSENA;1343084840;Taip;21;0;0;21
4544;Lašelis;ŠYPSENA;7471332824;Taip;18;0;0;18
4545;Lašelis;ŠYPSENA;6492909546;Ne;0;6;0;6
4546;Lašelis;ŠYPSENA;8324581018;Ne;16;0;1;17
4547;Lašelis;ŠYPSENA;5046619730;Taip;5;0;0;5
4548;Lašelis;ŠYPSENA;3741905080;Taip;0;0;1;1
4549;Lašelis;NYKŠTUKAI;1614647892;Taip;0;0;2;2
4550;Lašelis;NYKŠTUKAI;8181369424;Taip;4;0;1;5
4551;Lašelis;NYKŠTUKAI;1534313851;Ne;0;13;0;13
4552;Lašelis;NYKŠTUKAI;40927906931;Taip;0;12;0;12
4553;Lašelis;NYKŠTUKAI;1099685342;Taip;0;12;0;12
4554;Lašelis;NYKŠTUKAI;38601962350;Taip;0;4;0;4
4555;Lašelis;NYKŠTUKAI;1917927039;Taip;0;16;0;16
4556;Lašelis;NYKŠTUKAI;3447120578;Ne;0;0;4;4
4557;Lašelis;NYKŠTUKAI;1635550414;Taip;0;16;0;16
4558;Lašelis;NYKŠTUKAI;7047619741;Taip;2;0;1;3
4559;Lašelis;NYKŠTUKAI;85641710509;Taip;0;0;11;11
4560;Lašelis;NYKŠTUKAI;1742951527;Taip;0;0;1;1
4561;Lašelis;NYKŠTUKAI;28071639285;Taip;0;2;0;2
4562;Lašelis;NYKŠTUKAI;87745170593;Taip;6;2;0;8
4563;Lašelis;NYKŠTUKAI;37726695989;Taip;0;9;0;9
4564;Lašelis;NYKŠTUKAI;75224154074;Taip;0;6;0;6
4565;Lašelis;NYKŠTUKAI;29417065142;Taip;0;10;0;10
4566;Lašelis;NYKŠTUKAI;1711262987;Taip;10;0;3;13
4567;Lašelis;NYKŠTUKAI;73391370015;Taip;0;6;0;6
4568;Lašelis;SAULUTĖ;71550135640;Ne;3;9;0;12
4569;Lašelis;SAULUTĖ;17105970545;Taip;8;0;0;8
4570;Lašelis;SAULUTĖ;18905952587;Ne;0;1;0;1
4571;Lašelis;SAULUTĖ;39887519960;Ne;14;1;0;15
4572;Lašelis;SAULUTĖ;52081356883;Taip;5;2;0;7
4573;Lašelis;SAULUTĖ;3071193513;Taip;5;3;0;8
4574;Lašelis;SAULUTĖ;19712015840;Taip;0;11;0;11
4575;Lašelis;SAULUTĖ;72661430712;Taip;0;10;0;10
4576;Lašelis;SAULUTĖ;94756490716;Taip;6;4;0;10
4577;Lašelis;SAULUTĖ;34947111596;Taip;0;1;0;1
4578;Lašelis;SAULUTĖ;29635578653;Taip;11;0;0;11
4579;Lašelis;SAULUTĖ;36907557289;Ne;5;4;0;9
4580;Lašelis;SAULUTĖ;92897887533;Ne;0;6;0;6
4581;Lašelis;SAULUTĖ;85978955807;Taip;11;2;0;13
4582;Lašelis;SAULUTĖ;20798875600;Ne;0;6;0;6
4583;Lašelis;SAULUTĖ;3505668718;Taip;0;5;0;5
4584;Lašelis;SAULUTĖ;72124622387;Taip;15;4;0;19
4585;Lašelis;BORUŽĖLĖS;7351939034;Taip;0;13;0;13
4586;Lašelis;BORUŽĖLĖS;1085400709;Taip;0;5;0;5
4587;Lašelis;BORUŽĖLĖS;7998812497;Taip;20;0;0;20
4588;Lašelis;BORUŽĖLĖS;2912232814;Taip;17;1;0;18
4589;Lašelis;BORUŽĖLĖS;6127747445;Taip;17;2;0;19
4590;Lašelis;BORUŽĖLĖS;1777442316;Ne;2;0;0;2
4591;Lašelis;BORUŽĖLĖS;6553762186;Taip;11;8;0;19
4592;Lašelis;BORUŽĖLĖS;3867799187;Taip;5;0;0;5
4593;Lašelis;BORUŽĖLĖS;3982877012;Taip;8;0;6;14
4594;Lašelis;BORUŽĖLĖS;6669130831;Taip;5;4;0;9
4595;Lašelis;BORUŽĖLĖS;5556821953;Taip;19;0;0;19
4596;Lašelis;BORUŽĖLĖS;1646912457;Taip;2;4;0;6
4597;Lašelis;BORUŽĖLĖS;1886540733;Taip;9;3;0;12
4598;Lašelis;BORUŽĖLĖS;4151582358;Taip;10;4;0;14
4599;Lašelis;BORUŽĖLĖS;7802622810;Taip;10;2;0;12
4600;Lašelis;SKRUZDELIUKAI;8318512396;Taip;14;0;0;14
4601;Lašelis;SKRUZDELIUKAI;1244168190;Taip;0;1;0;1
4602;Lašelis;SKRUZDELIUKAI;2034007263;Taip;9;0;0;9
4603;Lašelis;SKRUZDELIUKAI;7367305924;Taip;0;0;4;4
4604;Lašelis;SKRUZDELIUKAI;7657786815;Taip;7;2;0;9
4605;Lašelis;SKRUZDELIUKAI;3843163586;Taip;7;0;0;7
4606;Lašelis;SKRUZDELIUKAI;6304391719;Taip;2;0;0;2
4607;Lašelis;SKRUZDELIUKAI;1085950130;Taip;5;0;0;5
4608;Linelis;Giliukai;85241351404;Ne;9;0;0;9
4609;Linelis;Giliukai;18406137746;Taip;0;2;3;5
4610;Linelis;Giliukai;29074930927;Taip;6;3;0;9
4611;Linelis;Giliukai;1539102468;Taip;0;0;1;1
4612;Linelis;Giliukai;79543604124;Taip;2;6;0;8
4613;Linelis;Giliukai;5903547677;Taip;0;0;1;1
4614;Linelis;Giliukai;3300710386;Taip;0;0;4;4
4615;Linelis;Giliukai;1505058152;Ne;8;0;1;9
4616;Linelis;Giliukai;92658776822;Taip;0;8;0;8
4617;Linelis;Giliukai;4644771654;Taip;0;11;0;11
4618;Linelis;Giliukai;11026646292;Taip;0;0;3;3
4619;Linelis;Giliukai;94514045159;Taip;9;0;0;9
4620;Linelis;Giliukai;18847368957;Taip;0;2;4;6
4621;Linelis;Giliukai;1646521870;Taip;0;0;4;4
4622;Linelis;Giliukai;1270931913;Taip;0;0;2;2
4623;Linelis;Giliukai;53442382594;Taip;0;5;0;5
4624;Linelis;Giliukai;1159267747;Taip;0;9;0;9
4625;Linelis;Saulutė;39379678474;Taip;0;1;0;1
4626;Linelis;Saulutė;67550509307;Taip;0;0;4;4
4627;Linelis;Saulutė;50135757374;Ne;0;0;1;1
4628;Linelis;Saulutė;88082442940;Taip;0;1;0;1
4629;Linelis;Saulutė;3721941885;Taip;0;0;3;3
4630;Linelis;Saulutė;78794214074;Taip;0;4;0;4
4631;Linelis;Saulutė;39302486335;Taip;0;2;0;2
4632;Linelis;Saulutė;77154624822;Taip;0;1;0;1
4633;Linelis;Saulutė;54594020356;Ne;12;0;6;18
4634;Linelis;Saulutė;4425214681;Taip;0;0;2;2
4635;Linelis;Saulutė;68038417200;Taip;0;0;2;2
4636;Linelis;Saulutė;23823598531;Ne;0;0;4;4
4637;Linelis;Saulutė;26545201411;Taip;0;0;1;1
4638;Linelis;Saulutė;91181408578;Taip;0;0;2;2
4639;Linelis;Saulutė;44313943197;Ne;6;2;1;9
4640;Linelis;Saulutė;30874840026;Taip;0;0;1;1
4641;Linelis;Saulutė;13906245933;Taip;0;7;0;7
4642;Linelis;Saulutė;62954795489;Taip;12;0;0;12
4643;Linelis;Saulutė;1478318177;Ne;0;15;0;15
4644;Linelis;Saulutė;13522521866;Taip;0;0;1;1
4645;Linelis;Nykštukai;58467930454;Taip;0;9;0;9
4646;Linelis;Nykštukai;38426234048;Taip;6;0;2;8
4647;Linelis;Nykštukai;1526473615;Taip;0;6;1;7
4648;Linelis;Nykštukai;1891722948;Taip;0;0;4;4
4649;Linelis;Nykštukai;1148540808;Taip;0;0;2;2
4650;Linelis;Nykštukai;4443285231;Taip;0;1;1;2
4651;Linelis;Nykštukai;37069004807;Taip;0;0;1;1
4652;Linelis;Nykštukai;8339073780;Taip;0;0;3;3
4653;Linelis;Nykštukai;71647031404;Ne;5;2;0;7
4654;Linelis;Nykštukai;1194624252;Taip;6;0;1;7
4655;Linelis;Nykštukai;46788785414;Taip;0;2;1;3
4656;Linelis;Nykštukai;3483401448;Ne;0;3;0;3
4657;Linelis;Daigiukai;6385439136;Taip;0;2;3;5
4658;Linelis;Daigiukai;1552829080;Taip;0;1;1;2
4659;Linelis;Daigiukai;4253571334;Taip;0;0;1;1
4660;Linelis;Daigiukai;4126444564;Taip;5;1;0;6
4661;Linelis;Daigiukai;8837847094;Taip;6;5;4;15
4662;Linelis;Daigiukai;3189188757;Taip;6;0;2;8
4663;Linelis;Daigiukai;1351957198;Taip;10;0;10;20
4664;Linelis;Daigiukai;2857645329;Taip;5;0;3;8
4665;Linelis;Daigiukai;6130634131;Taip;0;2;0;2
4666;Linelis;Daigiukai;8654487151;Taip;0;0;1;1
4667;Linelis;Daigiukai;6160295507;Taip;0;0;5;5
4668;Linelis;Daigiukai;6374352500;Taip;1;0;0;1
4669;Markučiai;Žirniukų;13358445982;Taip;0;0;1;1
4670;Markučiai;Žirniukų;4934200922;Taip;5;8;0;13
4671;Markučiai;Žirniukų;89393452327;Taip;0;3;7;10
4672;Markučiai;Žirniukų;9506953554;Taip;0;15;0;15
4673;Markučiai;Žirniukų;61354140820;Taip;0;1;1;2
4674;Markučiai;Žirniukų;86073430849;Taip;0;3;2;5
4675;Markučiai;Žirniukų;23712199138;Taip;2;0;0;2
4676;Markučiai;Žirniukų;68178936347;Taip;16;3;0;19
4677;Markučiai;Žirniukų;62276512687;Taip;0;0;2;2
4678;Markučiai;Žirniukų;95776655287;Taip;11;0;0;11
4679;Markučiai;Žirniukų;47122307518;Taip;0;2;2;4
4680;Markučiai;Žirniukų;9326053563;Taip;14;0;0;14
4681;Markučiai;Žirniukų;3498150320;Taip;6;0;0;6
4682;Markučiai;Žirniukų;1813116125;Ne;0;8;0;8
4683;Markučiai;Žirniukų;1150675918;Taip;3;3;2;8
4684;Markučiai;Žirniukų;95347461846;Taip;1;3;0;4
4685;Markučiai;Žirniukų;1962169822;Taip;15;0;0;15
4686;Markučiai;Žirniukų;4511936094;Taip;8;9;0;17
4687;Markučiai;Nykštukų;46647877230;Taip;5;3;0;8
4688;Markučiai;Nykštukų;37101160556;Taip;4;6;1;11
4689;Markučiai;Nykštukų;1473258832;Taip;9;1;0;10
4690;Markučiai;Nykštukų;92394309416;Taip;0;0;5;5
4691;Markučiai;Nykštukų;5026941590;Taip;3;0;0;3
4692;Markučiai;Nykštukų;81140027425;Taip;5;0;0;5
4693;Markučiai;Nykštukų;6915912992;Taip;0;0;5;5
4694;Markučiai;Nykštukų;52920975294;Taip;0;0;1;1
4695;Markučiai;Nykštukų;88304161598;Taip;0;4;0;4
4696;Markučiai;Nykštukų;1828510990;Taip;0;0;1;1
4697;Markučiai;Nykštukų;7578995182;Taip;10;5;0;15
4698;Markučiai;Nykštukų;1464123752;Taip;0;0;1;1
4699;Markučiai;Nykštukų;6639579832;Taip;0;1;11;12
4700;Markučiai;Nykštukų;9985442003;Taip;9;6;0;15
4701;Markučiai;Nykštukų;1507368475;Taip;9;0;0;9
4702;Markučiai;Nykštukų;1817367317;Taip;7;0;0;7
4703;Markučiai;Nykštukų;5954207590;Taip;10;0;2;12
4704;Markučiai;Pelėdžiukų;1586644788;Taip;1;0;3;4
4705;Markučiai;Pelėdžiukų;2539130198;Taip;0;5;0;5
4706;Markučiai;Pelėdžiukų;99878848764;Taip;0;10;1;11
4707;Markučiai;Pelėdžiukų;6430378111;Taip;2;0;0;2
4708;Markučiai;Pelėdžiukų;40039975519;Taip;0;0;2;2
4709;Markučiai;Pelėdžiukų;47402355544;Taip;0;10;0;10
4710;Markučiai;Pelėdžiukų;62012358431;Ne;14;0;0;14
4711;Markučiai;Pelėdžiukų;35937680002;Taip;2;0;0;2
4712;Markučiai;Pelėdžiukų;80867943870;Taip;5;0;0;5
4713;Markučiai;Pelėdžiukų;86596936099;Taip;0;3;0;3
4714;Markučiai;Pelėdžiukų;29403750068;Taip;6;0;0;6
4715;Markučiai;Pelėdžiukų;37310130818;Taip;0;10;0;10
4716;Markučiai;Pelėdžiukų;52599782800;Taip;0;12;0;12
4717;Markučiai;Pelėdžiukų;1482031262;Taip;5;0;3;8
4718;Markučiai;Pelėdžiukų;95026191001;Taip;6;0;0;6
4719;Markučiai;Pelėdžiukų;28059558537;Taip;0;0;1;1
4720;Markučiai;Pelėdžiukų;4938918595;Taip;10;0;0;10
4721;Markučiai;Pelėdžiukų;54616789785;Taip;7;0;0;7
4722;Markučiai;Pelėdžiukų;1155718131;Taip;4;11;0;15
4723;Markučiai;Pelėdžiukų;18563720509;Taip;14;0;2;16
4724;Markučiai;Boružėlių;9059302464;Taip;20;0;0;20
4725;Markučiai;Boružėlių;9220749889;Taip;0;0;1;1
4726;Markučiai;Boružėlių;2962530721;Taip;3;1;0;4
4727;Markučiai;Boružėlių;6574037877;Taip;0;0;3;3
4728;Markučiai;Boružėlių;5752762229;Ne;0;2;1;3
4729;Markučiai;Boružėlių;4383421917;Taip;0;1;0;1
4730;Markučiai;Boružėlių;9789274040;Taip;10;0;1;11
4731;Markučiai;Boružėlių;1146968021;Taip;6;0;0;6
4732;Markučiai;Boružėlių;1171899107;Taip;0;0;1;1
4733;Markučiai;Boružėlių;8092642447;Taip;0;2;0;2
4734;Markučiai;Boružėlių;8078777204;Taip;10;0;0;10
4735;Markučiai;Boružėlių;8605357678;Taip;0;1;2;3
4736;Markučiai;Boružėlių;3755794133;Taip;15;0;2;17
4737;Markučiai;Boružėlių;8244065962;Ne;0;1;0;1
4738;Markučiai;Boružėlių;5902165968;Taip;2;0;1;3
4739;Markučiai;Bitučių;4653663237;Ne;13;0;2;15
4740;Markučiai;Bitučių;1720541082;Ne;0;0;1;1
4741;Markučiai;Bitučių;8792524832;Taip;3;0;0;3
4742;Markučiai;Bitučių;1717624510;Taip;10;0;0;10
4743;Markučiai;Bitučių;9518247571;Taip;10;0;0;10
4744;Markučiai;Bitučių;4836298058;Taip;6;0;0;6
4745;Markučiai;Bitučių;9027071539;Taip;10;1;0;11
4746;Markučiai;Bitučių;8748794886;Taip;11;0;2;13
4747;Markučiai;Bitučių;5727655114;Taip;4;5;0;9
4748;Markučiai;Bitučių;6740434675;Taip;5;0;0;5
4749;Markučiai;Bitučių;6707310242;Taip;10;0;0;10
4750;Markučiai;Bitučių;2256262371;Taip;22;0;0;22
4751;Markučiai;Bitučių;7387460586;Taip;0;0;1;1
4752;Markučiai;Bitučių;8950442843;Taip;5;0;0;5
4753;Markučiai;Bitučių;6260010822;Taip;11;0;1;12
4754;Markučiai;Drugelių;2851424931;Taip;0;0;1;1
4755;Markučiai;Drugelių;1719927769;Taip;0;0;8;8
4756;Markučiai;Drugelių;1411292558;Taip;7;0;0;7
4757;Markučiai;Drugelių;2608111078;Taip;0;0;5;5
4758;Markučiai;Drugelių;9428254633;Taip;8;0;0;8
4759;Markučiai;Drugelių;61666612833;Taip;0;1;0;1
4760;Markučiai;Drugelių;20261053601;Taip;0;1;0;1
4761;Markučiai;Drugelių;24315961901;Taip;6;0;5;11
4762;Markučiai;Drugelių;45698891062;Taip;0;0;1;1
4763;Markučiai;Drugelių;22197471483;Taip;1;0;0;1
4764;Markučiai;Drugelių;9028932081;Taip;0;15;0;15
4765;Markučiai;Drugelių;9019827941;Taip;1;0;0;1
4766;Markučiai;Drugelių;11203825718;Taip;0;0;3;3
4767;Markučiai;Drugelių;7538681006;Taip;0;14;6;20
4768;Markučiai;Drugelių;7194049189;Taip;0;1;3;4
4769;Markučiai;Drugelių;1964223995;Taip;7;0;0;7
4770;Markučiai;Drugelių;23081602011;Ne;0;0;1;1
4771;Markučiai;Skruzdėliukų;1471334430;Taip;0;0;6;6
4772;Markučiai;Skruzdėliukų;9825799013;Ne;15;3;0;18
4773;Markučiai;Skruzdėliukų;8803226424;Taip;4;0;0;4
4774;Markučiai;Skruzdėliukų;20702694553;Taip;0;3;0;3
4775;Markučiai;Skruzdėliukų;55093673733;Taip;7;1;0;8
4776;Markučiai;Skruzdėliukų;39971140989;Taip;5;0;0;5
4777;Markučiai;Skruzdėliukų;54732351634;Taip;0;0;5;5
4778;Markučiai;Skruzdėliukų;1631270056;Ne;0;2;0;2
4779;Markučiai;Skruzdėliukų;1419433247;Taip;1;11;0;12
4780;Markučiai;Skruzdėliukų;1089500743;Taip;0;7;0;7
4781;Markučiai;Skruzdėliukų;2939795063;Taip;10;0;2;12
4782;Markučiai;Skruzdėliukų;9285037135;Taip;15;0;0;15
4783;Markučiai;Skruzdėliukų;1699369138;Taip;0;0;18;18
4784;Markučiai;Skruzdėliukų;1881218133;Taip;0;2;1;3
4785;Markučiai;Skruzdėliukų;1200278823;Taip;7;5;1;13
4786;Markučiai;Skruzdėliukų;8863238710;Taip;5;6;11;22
4787;Markučiai;Skruzdėliukų;68193563408;Taip;10;8;0;18
4788;Markučiai;Skruzdėliukų;92854605649;Taip;22;0;0;22
4789;Markučiai;Skruzdėliukų;1529531638;Taip;10;0;0;10
4790;Markučiai;ZUIKUČIŲ;82320812575;Taip;0;0;2;2
4791;Markučiai;ZUIKUČIŲ;4861535057;Taip;10;0;0;10
4792;Markučiai;ZUIKUČIŲ;1482203905;Taip;0;0;2;2
4793;Markučiai;ZUIKUČIŲ;11751635395;Taip;0;2;0;2
4794;Markučiai;ZUIKUČIŲ;1184908076;Taip;3;9;0;12
4795;Markučiai;ZUIKUČIŲ;7729045227;Taip;11;0;0;11
4796;Markučiai;ZUIKUČIŲ;8061880631;Taip;8;0;0;8
4797;Markučiai;ZUIKUČIŲ;1392582514;Taip;4;1;0;5
4798;Markučiai;ZUIKUČIŲ;7691410556;Taip;7;0;0;7
4799;Markučiai;ZUIKUČIŲ;7969520467;Taip;7;0;0;7
4800;Markučiai;ZUIKUČIŲ;6808291628;Taip;15;3;0;18
4801;Markučiai;ZUIKUČIŲ;5387571295;Taip;8;0;0;8
4802;Markučiai;ZUIKUČIŲ;3794643964;Taip;2;2;0;4
4803;Markučiai;ZUIKUČIŲ;91228262895;Taip;0;17;0;17
4804;Markučiai;ZUIKUČIŲ;7481923902;Taip;0;0;1;1
4805;Markučiai;ZUIKUČIŲ;1025406111;Taip;0;16;1;17
4806;Markučiai;ZUIKUČIŲ;5749873170;Taip;0;0;3;3
4807;Markučiai;ZUIKUČIŲ;9581578352;Taip;15;0;0;15
4808;Markučiai;ŽIOGELIŲ;5099997904;Taip;6;1;0;7
4809;Markučiai;ŽIOGELIŲ;3163226803;Taip;10;0;0;10
4810;Markučiai;ŽIOGELIŲ;1244026489;Taip;21;3;0;24
4811;Markučiai;ŽIOGELIŲ;76025616287;Taip;0;1;0;1
4812;Markučiai;ŽIOGELIŲ;1323922187;Taip;8;3;0;11
4813;Markučiai;ŽIOGELIŲ;54892037118;Taip;4;6;0;10
4814;Markučiai;ŽIOGELIŲ;1549653580;Taip;7;3;2;12
4815;Markučiai;ŽIOGELIŲ;1054802708;Taip;7;7;0;14
4816;Markučiai;ŽIOGELIŲ;67074776419;Taip;0;3;0;3
4817;Markučiai;ŽIOGELIŲ;1007919702;Taip;0;7;0;7
4818;Markučiai;ŽIOGELIŲ;7850311496;Taip;22;3;0;25
4819;Markučiai;ŽIOGELIŲ;2169583290;Taip;0;9;0;9
4820;Markučiai;ŽIOGELIŲ;3340385503;Taip;0;1;1;2
4821;Markučiai;ŽIOGELIŲ;4152184290;Taip;0;3;1;4
4822;Markučiai;ŽIOGELIŲ;1742944578;Taip;0;2;2;4
4823;Markučiai;ŽIOGELIŲ;23267867195;Taip;6;0;1;7
4824;Markučiai;Ežiukių;1827829954;Taip;8;1;0;9
4825;Markučiai;Ežiukių;4925856706;Taip;0;15;0;15
4826;Markučiai;Ežiukių;6570638672;Taip;0;7;0;7
4827;Markučiai;Ežiukių;3771563320;Taip;7;1;1;9
4828;Markučiai;Ežiukių;1648283497;Taip;2;10;0;12
4829;Markučiai;Ežiukių;4186684938;Taip;16;0;0;16
4830;Markučiai;Ežiukių;5975331223;Taip;8;5;1;14
4831;Markučiai;Ežiukių;2687320408;Taip;17;1;0;18
4832;Markučiai;Ežiukių;1309122110;Taip;12;1;2;15
4833;Markučiai;Ežiukių;9295954145;Taip;16;0;2;18
4834;Markučiai;Ežiukių;8990923872;Taip;4;0;3;7
4835;Markučiai;Ežiukių;2738553283;Taip;21;1;0;22
4836;Markučiai;Ežiukių;3386071459;Taip;22;0;0;22
4837;Markučiai;Ežiukių;7255617408;Taip;22;0;0;22
4838;Markučiai;Ežiukių;5246980173;Ne;8;0;0;8
4839;Markučiai;Ežiukių;1599633295;Taip;17;2;0;19
4840;Markučiai;Ežiukių;6308368050;Ne;11;0;0;11
4841;Markučiai;Ežiukių;4249158803;Taip;6;0;2;8
4842;Markučiai;Ežiukių;5958705106;Taip;10;0;1;11
4843;Markučiai;Ežiukių;3282845685;Taip;0;0;14;14
4844;Mažylis;"2 DARŽELIO GR.";5063094678;Taip;4;0;2;6
4845;Mažylis;"2 DARŽELIO GR.";3860760654;Taip;10;0;1;11
4846;Mažylis;"2 DARŽELIO GR.";9608529135;Taip;0;0;3;3
4847;Mažylis;"2 DARŽELIO GR.";8899463988;Taip;0;0;2;2
4848;Mažylis;"2 DARŽELIO GR.";9411559447;Taip;3;0;1;4
4849;Mažylis;"2 DARŽELIO GR.";45148418456;Taip;0;0;2;2
4850;Mažylis;"2 DARŽELIO GR.";4252408251;Ne;0;0;7;7
4851;Mažylis;"2 DARŽELIO GR.";38277640135;Taip;0;0;6;6
4852;Mažylis;"2 DARŽELIO GR.";1514640197;Taip;0;0;2;2
4853;Mažylis;"2 DARŽELIO GR.";6851169340;Taip;0;0;1;1
4854;Mažylis;"2 DARŽELIO GR.";4486742281;Ne;18;0;0;18
4855;Mažylis;"2 DARŽELIO GR.";79181926145;Taip;9;5;1;15
4856;Mažylis;"2 DARŽELIO GR.";6920129837;Ne;8;0;0;8
4857;Mažylis;"2 DARŽELIO GR.";1663347167;Ne;18;0;0;18
4858;Mažylis;"2 DARŽELIO GR.";1460572347;Taip;0;0;2;2
4859;Mažylis;"2 DARŽELIO GR.";7416381505;Taip;14;0;1;15
4860;Mažylis;"2 DARŽELIO GR.";6134051712;Taip;0;0;1;1
4861;Mažylis;"2 DARŽELIO GR.";8352202912;Taip;0;0;2;2
4862;Mažylis;"4 PRIEŠMOKYKLINĖ GR.";6302092043;Ne;0;0;3;3
4863;Mažylis;"4 PRIEŠMOKYKLINĖ GR.";66861078627;Ne;0;0;13;13
4864;Mažylis;"4 PRIEŠMOKYKLINĖ GR.";28914540415;Taip;0;0;6;6
4865;Mažylis;"4 PRIEŠMOKYKLINĖ GR.";8684267495;Taip;0;2;0;2
4866;Mažylis;"4 PRIEŠMOKYKLINĖ GR.";57677251463;Taip;0;0;11;11
4867;Mažylis;"4 PRIEŠMOKYKLINĖ GR.";5439091390;Taip;13;0;0;13
4868;Mažylis;"4 PRIEŠMOKYKLINĖ GR.";36779005815;Taip;0;0;1;1
4869;Mažylis;"4 PRIEŠMOKYKLINĖ GR.";87616420119;Taip;0;0;1;1
4870;Mažylis;"4 PRIEŠMOKYKLINĖ GR.";33743124122;Taip;0;0;4;4
4871;Mažylis;"4 PRIEŠMOKYKLINĖ GR.";11033123284;Taip;0;2;0;2
4872;Mažylis;"4 PRIEŠMOKYKLINĖ GR.";40329007615;Ne;0;0;1;1
4873;Mažylis;"4 PRIEŠMOKYKLINĖ GR.";1102106521;Taip;0;0;3;3
4874;Mažylis;"4 PRIEŠMOKYKLINĖ GR.";54844605291;Taip;0;6;0;6
4875;Mažylis;"4 PRIEŠMOKYKLINĖ GR.";26981897418;Ne;0;0;16;16
4876;Mažylis;"4 PRIEŠMOKYKLINĖ GR.";52616512471;Taip;0;0;8;8
4877;Mažylis;"4 PRIEŠMOKYKLINĖ GR.";5984612355;Taip;1;0;1;2
4878;Mažylis;"5 DARŽ.GR.";7774469604;Taip;0;0;7;7
4879;Mažylis;"5 DARŽ.GR.";1692808423;Taip;0;0;2;2
4880;Mažylis;"5 DARŽ.GR.";76814348181;Taip;0;4;1;5
4881;Mažylis;"5 DARŽ.GR.";37676161966;Taip;0;0;5;5
4882;Mažylis;"5 DARŽ.GR.";91436869919;Taip;0;0;8;8
4883;Mažylis;"5 DARŽ.GR.";74056314359;Ne;0;4;2;6
4884;Mažylis;"5 DARŽ.GR.";36307201422;Taip;0;0;2;2
4885;Mažylis;"5 DARŽ.GR.";37179412928;Taip;7;0;1;8
4886;Mažylis;"5 DARŽ.GR.";9958976870;Taip;0;0;1;1
4887;Mažylis;"5 DARŽ.GR.";56438009944;Ne;0;0;22;22
4888;Mažylis;"5 DARŽ.GR.";11471986928;Taip;4;0;0;4
4889;Mažylis;"5 DARŽ.GR.";8439933210;Taip;0;0;5;5
4890;Mažylis;"5 DARŽ.GR.";8318476578;Taip;17;0;0;17
4891;Mažylis;"3 DARŽELIO GR.";24303144913;Taip;0;0;1;1
4892;Mažylis;"3 DARŽELIO GR.";50868656860;Taip;11;0;0;11
4893;Mažylis;"3 DARŽELIO GR.";1370723211;Taip;0;0;11;11
4894;Mažylis;"3 DARŽELIO GR.";2070067356;Ne;0;0;4;4
4895;Mažylis;"3 DARŽELIO GR.";81907805809;Taip;0;0;6;6
4896;Mažylis;"3 DARŽELIO GR.";1999937720;Taip;0;0;2;2
4897;Mažylis;"3 DARŽELIO GR.";98251642256;Taip;10;2;1;13
4898;Mažylis;"3 DARŽELIO GR.";90336289067;Ne;0;0;2;2
4899;Mažylis;"3 DARŽELIO GR.";1021183555;Taip;5;0;0;5
4900;Mažylis;"3 DARŽELIO GR.";1910064549;Taip;0;10;2;12
4901;Mažylis;"3 DARŽELIO GR.";86823456557;Taip;5;0;2;7
4902;Mažylis;"3 DARŽELIO GR.";2520667095;Taip;0;0;1;1
4903;Mažylis;"3 DARŽELIO GR.";5479496104;Taip;0;1;0;1
4904;Mažylis;"3 DARŽELIO GR.";1520251270;Taip;0;0;2;2
4905;Mažylis;"3 DARŽELIO GR.";5271395545;Taip;0;0;2;2
4906;Mažylis;"6 DARŽELIO GR.";1023886258;Taip;0;0;7;7
4907;Mažylis;"6 DARŽELIO GR.";2249845212;Taip;20;0;0;20
4908;Mažylis;"6 DARŽELIO GR.";38333694019;Taip;0;0;2;2
4909;Mažylis;"6 DARŽELIO GR.";37552673590;Taip;0;0;1;1
4910;Mažylis;"6 DARŽELIO GR.";44917962136;Taip;0;0;1;1
4911;Mažylis;"6 DARŽELIO GR.";34677678888;Ne;0;11;0;11
4912;Mažylis;"6 DARŽELIO GR.";72018918082;Taip;0;0;2;2
4913;Mažylis;"6 DARŽELIO GR.";99612915803;Taip;0;0;4;4
4914;Mažylis;"6 DARŽELIO GR.";1217081615;Taip;0;0;4;4
4915;Mažylis;"6 DARŽELIO GR.";1418120714;Taip;6;0;0;6
4916;Mažylis;"6 DARŽELIO GR.";1381948803;Taip;18;0;0;18
4917;Mažylis;"6 DARŽELIO GR.";94128544096;Taip;5;0;0;5
4918;Mažylis;"6 DARŽELIO GR.";33428832459;Taip;0;0;5;5
4919;Mažylis;"1 NAUJA (LOPŠELIS)";6854350717;Taip;0;0;2;2
4920;Mažylis;"1 NAUJA (LOPŠELIS)";2979849055;Ne;5;0;3;8
4921;Mažylis;"1 NAUJA (LOPŠELIS)";4503734408;Taip;3;0;1;4
4922;Mažylis;"1 NAUJA (LOPŠELIS)";6162880220;Taip;2;0;0;2
4923;Mažylis;"1 NAUJA (LOPŠELIS)";9362249595;Taip;18;0;0;18
4924;Mažylis;"1 NAUJA (LOPŠELIS)";1077493584;Taip;0;1;0;1
4925;Mažylis;"1 NAUJA (LOPŠELIS)";2704741847;Taip;0;10;2;12
4926;Mažylis;"1 NAUJA (LOPŠELIS)";4798415786;Taip;0;1;0;1
4927;Mažylis;"1 NAUJA (LOPŠELIS)";3327673298;Ne;3;0;0;3
4928;Mažylis;"1 NAUJA (LOPŠELIS)";9447747294;Taip;0;0;10;10
4929;Mažylis;"1 NAUJA (LOPŠELIS)";2126108232;Taip;0;0;2;2
4930;Medynėlis;BITUTĖS;1721728772;Ne;0;3;0;3
4931;Medynėlis;BITUTĖS;51942577095;Taip;0;2;0;2
4932;Medynėlis;BITUTĖS;57858019710;Taip;0;0;4;4
4933;Medynėlis;BITUTĖS;78341557395;Taip;0;8;1;9
4934;Medynėlis;BITUTĖS;70950123240;Taip;0;0;1;1
4935;Medynėlis;BITUTĖS;38838111813;Taip;0;1;0;1
4936;Medynėlis;BITUTĖS;1641742927;Ne;0;4;0;4
4937;Medynėlis;BITUTĖS;5202479867;Taip;0;0;3;3
4938;Medynėlis;BITUTĖS;72334464245;Taip;0;11;0;11
4939;Medynėlis;BITUTĖS;39476010274;Taip;22;0;0;22
4940;Medynėlis;BITUTĖS;7522506857;Taip;0;5;0;5
4941;Medynėlis;BITUTĖS;2055140361;Taip;0;11;11;22
4942;Medynėlis;BITUTĖS;1663988144;Taip;0;4;0;4
4943;Medynėlis;BITUTĖS;3684709853;Taip;0;1;2;3
4944;Medynėlis;BITUTĖS;65852278020;Taip;7;1;0;8
4945;Medynėlis;DRUGELIAI;29673282359;Taip;1;1;0;2
4946;Medynėlis;DRUGELIAI;119345675;Ne;0;2;0;2
4947;Medynėlis;DRUGELIAI;56207399170;Taip;0;5;0;5
4948;Medynėlis;DRUGELIAI;77267420461;Taip;20;0;0;20
4949;Medynėlis;DRUGELIAI;82368415455;Ne;1;0;0;1
4950;Medynėlis;DRUGELIAI;22422832248;Taip;0;2;0;2
4951;Medynėlis;DRUGELIAI;96133788423;Taip;5;0;0;5
4952;Medynėlis;DRUGELIAI;1673034349;Ne;0;2;0;2
4953;Medynėlis;DRUGELIAI;98839852579;Taip;0;2;0;2
4954;Medynėlis;DRUGELIAI;64603154583;Taip;6;1;0;7
4955;Medynėlis;DRUGELIAI;4567518841;Taip;0;4;0;4
4956;Medynėlis;DRUGELIAI;75083011184;Taip;10;12;0;22
4957;Medynėlis;DRUGELIAI;5748498291;Ne;7;0;0;7
4958;Medynėlis;DRUGELIAI;55276812676;Taip;3;0;0;3
4959;Medynėlis;DRUGELIAI;76282032727;Taip;0;7;0;7
4960;Medynėlis;DRUGELIAI;1828684971;Taip;7;2;0;9
4961;Medynėlis;DRUGELIAI;30399789674;Taip;5;1;0;6
4962;Medynėlis;SKRUZDĖLIUKAI;4024866819;Taip;10;0;0;10
4963;Medynėlis;SKRUZDĖLIUKAI;2418225089;Taip;0;4;0;4
4964;Medynėlis;SKRUZDĖLIUKAI;9413309043;Taip;4;0;2;6
4965;Medynėlis;SKRUZDĖLIUKAI;6594928740;Taip;17;5;0;22
4966;Medynėlis;SKRUZDĖLIUKAI;4581683292;Taip;0;7;0;7
4967;Medynėlis;SKRUZDĖLIUKAI;4137297035;Taip;5;0;4;9
4968;Medynėlis;SKRUZDĖLIUKAI;9009316740;Taip;0;0;1;1
4969;Medynėlis;SKRUZDĖLIUKAI;1795479738;Taip;0;20;0;20
4970;Medynėlis;SKRUZDĖLIUKAI;5530782065;Taip;0;0;2;2
4971;Medynėlis;SKRUZDĖLIUKAI;5269927048;Taip;0;5;3;8
4972;Medynėlis;SKRUZDĖLIUKAI;2427349194;Taip;11;0;0;11
4973;Medynėlis;SKRUZDĖLIUKAI;8948133343;Taip;3;0;0;3
4974;Medynėlis;SKRUZDĖLIUKAI;7633674694;Taip;0;1;0;1
4975;Medynėlis;SKRUZDĖLIUKAI;7244497661;Taip;14;8;0;22
4976;Medynėlis;SKRUZDĖLIUKAI;5995034919;Taip;0;0;5;5
4977;Medynėlis;SKRUZDĖLIUKAI;8775219704;Taip;0;11;0;11
4978;Medynėlis;SKRUZDĖLIUKAI;1658457155;Taip;4;1;0;5
4979;Medynėlis;SKRUZDĖLIUKAI;33981260502;Taip;0;0;11;11
4980;Medynėlis;SKRUZDĖLIUKAI;3773215372;Taip;3;2;0;5
4981;Medynėlis;VOVERIUKAI;2834559432;Taip;10;0;0;10
4982;Medynėlis;VOVERIUKAI;2310200034;Ne;0;3;0;3
4983;Medynėlis;VOVERIUKAI;6999562417;Taip;14;6;0;20
4984;Medynėlis;VOVERIUKAI;5586407412;Taip;10;0;1;11
4985;Medynėlis;VOVERIUKAI;7108619017;Taip;0;10;0;10
4986;Medynėlis;VOVERIUKAI;1820113382;Taip;0;5;0;5
4987;Medynėlis;VOVERIUKAI;9304002459;Taip;0;0;1;1
4988;Medynėlis;VOVERIUKAI;5982453884;Taip;5;6;0;11
4989;Medynėlis;VOVERIUKAI;1173510831;Taip;1;6;0;7
4990;Medynėlis;VOVERIUKAI;6406459222;Taip;7;1;0;8
4991;Medynėlis;VOVERIUKAI;2335108073;Ne;5;0;2;7
4992;Medynėlis;VOVERIUKAI;4985243068;Taip;9;0;0;9
4993;Medynėlis;VOVERIUKAI;2057309788;Taip;7;3;2;12
4994;Medynėlis;VOVERIUKAI;9073514151;Taip;0;5;0;5
4995;Medynėlis;VOVERIUKAI;4238860287;Ne;0;0;2;2
4996;Medynėlis;VOVERIUKAI;1750775033;Taip;5;0;2;7
4997;Medynėlis;VOVERIUKAI;9800678364;Taip;0;15;4;19
4998;Medynėlis;VOVERIUKAI;1237589979;Taip;17;0;0;17
4999;Medynėlis;MEŠKIUKAI;1434648803;Taip;0;0;1;1
5000;Medynėlis;MEŠKIUKAI;1975763240;Ne;0;1;1;2
5001;Medynėlis;MEŠKIUKAI;5347745655;Taip;10;0;0;10
5002;Medynėlis;MEŠKIUKAI;1781906016;Taip;0;13;0;13
5003;Medynėlis;MEŠKIUKAI;91658912153;Taip;0;10;0;10
5004;Medynėlis;MEŠKIUKAI;1269734734;Taip;10;3;0;13
5005;Medynėlis;MEŠKIUKAI;46445461622;Taip;10;2;0;12
5006;Medynėlis;MEŠKIUKAI;7226012217;Taip;12;2;0;14
5007;Medynėlis;MEŠKIUKAI;5007624930;Ne;10;1;1;12
5008;Medynėlis;MEŠKIUKAI;9476336240;Taip;0;1;0;1
5009;Medynėlis;MEŠKIUKAI;8629622922;Taip;10;1;1;12
5010;Medynėlis;MEŠKIUKAI;1479759021;Taip;4;0;0;4
5011;Medynėlis;MEŠKIUKAI;2389345601;Taip;4;0;9;13
5012;Medynėlis;MEŠKIUKAI;1635649525;Ne;0;2;1;3
5013;Medynėlis;MEŠKIUKAI;12812096047;Taip;4;10;0;14
5014;Medynėlis;MEŠKIUKAI;2326848026;Taip;0;4;0;4
5015;Medynėlis;MEŠKIUKAI;8143370943;Taip;0;0;3;3
5016;Medynėlis;MEŠKIUKAI;99799126572;Ne;3;0;0;3
5017;Medynėlis;PELĖDŽIUKAI;1379827887;Taip;22;0;0;22
5018;Medynėlis;PELĖDŽIUKAI;1829338208;Taip;4;8;0;12
5019;Medynėlis;PELĖDŽIUKAI;88240380945;Taip;0;0;4;4
5020;Medynėlis;PELĖDŽIUKAI;1129265551;Taip;10;7;1;18
5021;Medynėlis;PELĖDŽIUKAI;76668029492;Taip;0;0;1;1
5022;Medynėlis;PELĖDŽIUKAI;1080058205;Taip;0;3;0;3
5023;Medynėlis;PELĖDŽIUKAI;38759466139;Taip;0;0;1;1
5024;Medynėlis;PELĖDŽIUKAI;1968892466;Taip;0;2;0;2
5025;Medynėlis;PELĖDŽIUKAI;1194247621;Taip;12;0;0;12
5026;Medynėlis;PELĖDŽIUKAI;1755767517;Taip;0;11;0;11
5027;Medynėlis;PELĖDŽIUKAI;37435525923;Taip;0;7;0;7
5028;Medynėlis;PELĖDŽIUKAI;1415208530;Taip;15;0;3;18
5029;Medynėlis;PELĖDŽIUKAI;7804751416;Taip;12;10;0;22
5030;Medynėlis;PELĖDŽIUKAI;6182500688;Taip;10;9;0;19
5031;Medynėlis;PELĖDŽIUKAI;2831484614;Taip;8;0;0;8
5032;Medynėlis;PELĖDŽIUKAI;8122944228;Taip;7;0;3;10
5033;Medynėlis;PELĖDŽIUKAI;15047814683;Taip;0;0;1;1
5034;Medynėlis;PELĖDŽIUKAI;1937403950;Ne;9;0;0;9
5035;Medynėlis;PELĖDŽIUKAI;53914093216;Taip;21;0;0;21
5036;Medynėlis;BORUŽIUKAI;52437462417;Taip;6;0;0;6
5037;Medynėlis;BORUŽIUKAI;1657676226;Taip;3;4;0;7
5038;Medynėlis;BORUŽIUKAI;51192496113;Taip;3;0;0;3
5039;Medynėlis;BORUŽIUKAI;1314163134;Taip;0;4;0;4
5040;Medynėlis;BORUŽIUKAI;1010025777;Taip;0;3;0;3
5041;Medynėlis;BORUŽIUKAI;96544597673;Taip;6;1;0;7
5042;Medynėlis;BORUŽIUKAI;79786316561;Taip;0;5;0;5
5043;Medynėlis;BORUŽIUKAI;88550635466;Taip;0;6;0;6
5044;Medynėlis;BORUŽIUKAI;1693185124;Taip;0;1;0;1
5045;Medynėlis;BORUŽIUKAI;1563329598;Taip;0;2;0;2
5046;Medynėlis;BORUŽIUKAI;1611512841;Taip;0;3;0;3
5047;Medynėlis;BORUŽIUKAI;55848491611;Taip;11;2;0;13
5048;Medynėlis;BORUŽIUKAI;7061506238;Taip;2;0;0;2
5049;Medynėlis;BORUŽIUKAI;1192592678;Ne;13;2;0;15
5050;Medynėlis;BORUŽIUKAI;12150004702;Ne;10;2;0;12
5051;Medynėlis;BORUŽIUKAI;7628899696;Taip;10;2;0;12
5052;Medynėlis;BORUŽIUKAI;48636516521;Taip;5;1;0;6
5053;Medynėlis;EŽIUKAI;3398294520;Taip;5;2;0;7
5054;Medynėlis;EŽIUKAI;2026582294;Taip;0;1;0;1
5055;Medynėlis;EŽIUKAI;1437000615;Taip;0;7;0;7
5056;Medynėlis;EŽIUKAI;1995078812;Taip;0;2;1;3
5057;Medynėlis;EŽIUKAI;1208227740;Taip;0;2;0;2
5058;Medynėlis;EŽIUKAI;1569413876;Taip;14;2;0;16
5059;Medynėlis;EŽIUKAI;31443674861;Taip;0;7;0;7
5060;Medynėlis;EŽIUKAI;3165639252;Taip;9;0;1;10
5061;Medynėlis;EŽIUKAI;1882919126;Taip;0;5;0;5
5062;Medynėlis;EŽIUKAI;61158254770;Taip;0;15;0;15
5063;Medynėlis;EŽIUKAI;1216195798;Taip;0;2;0;2
5064;Medynėlis;EŽIUKAI;2406561273;Taip;0;1;0;1
5065;Medynėlis;EŽIUKAI;3225662051;Taip;0;2;0;2
5066;Medynėlis;EŽIUKAI;1915791061;Taip;0;0;1;1
5067;Medynėlis;ZUIKUČIAI;5785463517;Taip;5;1;0;6
5068;Medynėlis;ZUIKUČIAI;9184868565;Taip;9;0;0;9
5069;Medynėlis;ZUIKUČIAI;1621499650;Taip;0;5;0;5
5070;Medynėlis;ZUIKUČIAI;4222917765;Taip;0;5;0;5
5071;Medynėlis;ZUIKUČIAI;4323515017;Taip;5;2;0;7
5072;Medynėlis;ZUIKUČIAI;9866431097;Taip;17;1;0;18
5073;Medynėlis;ZUIKUČIAI;5571641847;Taip;5;5;0;10
5074;Medynėlis;ZUIKUČIAI;6681155625;Taip;22;0;0;22
5075;Medynėlis;ZUIKUČIAI;6073797962;Taip;0;1;1;2
5076;Medynėlis;KAČIUKAI;7740591575;Taip;0;1;0;1
5077;Medynėlis;KAČIUKAI;4100792567;Taip;15;0;0;15
5078;Medynėlis;KAČIUKAI;4217263449;Taip;0;0;2;2
5079;Medynėlis;KAČIUKAI;1587899391;Taip;22;0;0;22
5080;Medynėlis;KAČIUKAI;1056744101;Taip;6;0;7;13
5081;Medynėlis;KAČIUKAI;7455041214;Taip;6;0;1;7
5082;Medynėlis;KAČIUKAI;7272017225;Taip;10;0;0;10
5083;Medynėlis;KAČIUKAI;4092824377;Taip;12;1;0;13
5084;Medynėlis;KAČIUKAI;6826790492;Taip;0;0;1;1
5085;Medynėlis;KAČIUKAI;4488439037;Taip;0;0;22;22
5086;Medynėlis;KAČIUKAI;6485314750;Taip;9;0;0;9
5087;Medynėlis;KAČIUKAI;6101613567;Ne;0;0;3;3
5088;Medynėlis;KAČIUKAI;2234994999;Taip;0;5;0;5
5089;Medynėlis;PELIUKAI;9314893329;Taip;1;2;0;3
5090;Medynėlis;PELIUKAI;3787172254;Taip;10;8;0;18
5091;Medynėlis;PELIUKAI;5051773825;Taip;16;0;0;16
5092;Medynėlis;PELIUKAI;1344240019;Taip;0;4;0;4
5093;Medynėlis;PELIUKAI;6218943275;Taip;7;2;0;9
5094;Medynėlis;PELIUKAI;1406029765;Taip;7;2;0;9
5095;Medynėlis;PELIUKAI;1162859552;Taip;0;5;0;5
5096;Medynėlis;PELIUKAI;6032067904;Ne;3;0;0;3
5097;Medynėlis;PELIUKAI;7232396755;Taip;13;5;0;18
5098;Medynėlis;PELIUKAI;9919108302;Taip;0;15;0;15
5099;Medynėlis;PELIUKAI;1463263793;Taip;0;8;0;8
5100;Medynėlis;PELIUKAI;1333848517;Taip;5;0;11;16
5101;Medynėlis;PELIUKAI;3270413614;Taip;14;2;0;16
5102;Medynėlis;PELIUKAI;5532880670;Taip;0;5;7;12
5103;Medynėlis;PELIUKAI;7651663404;Taip;3;0;2;5
5104;Medynėlis;PELIUKAI;5446430319;Taip;0;0;7;7
5105;Medynėlis;PELIUKAI;4315717555;Taip;0;1;6;7
5106;Molinukas;NYKŠTUKAI;70883949824;Taip;0;0;2;2
5107;Molinukas;NYKŠTUKAI;78219816965;Taip;3;0;5;8
5108;Molinukas;NYKŠTUKAI;25562159395;Taip;0;11;0;11
5109;Molinukas;NYKŠTUKAI;60898158225;Taip;4;0;0;4
5110;Molinukas;NYKŠTUKAI;51421193001;Taip;0;7;0;7
5111;Molinukas;NYKŠTUKAI;65954418475;Taip;0;0;22;22
5112;Molinukas;NYKŠTUKAI;25761685637;Taip;0;3;0;3
5113;Molinukas;NYKŠTUKAI;25402100091;Taip;0;0;1;1
5114;Molinukas;NYKŠTUKAI;19007912410;Taip;0;1;1;2
5115;Molinukas;NYKŠTUKAI;62719013867;Taip;7;2;0;9
5116;Molinukas;NYKŠTUKAI;41890709428;Taip;0;0;3;3
5117;Molinukas;NYKŠTUKAI;74040038141;Taip;5;0;2;7
5118;Molinukas;NYKŠTUKAI;73542178867;Taip;0;0;3;3
5119;Molinukas;NYKŠTUKAI;81968957100;Taip;4;0;0;4
5120;Molinukas;NYKŠTUKAI;96140904528;Taip;10;8;0;18
5121;Molinukas;NYKŠTUKAI;24664585525;Taip;0;1;0;1
5122;Molinukas;NYKŠTUKAI;96366441416;Taip;0;0;2;2
5123;Molinukas;NYKŠTUKAI;94725766823;Taip;11;1;0;12
5124;Molinukas;NYKŠTUKAI;48613608109;Taip;0;1;0;1
5125;Molinukas;NYKŠTUKAI;52577977910;Ne;0;9;0;9
5126;Molinukas;NYKŠTUKAI;46887752521;Taip;0;0;12;12
5127;Molinukas;NYKŠTUKAI;81952213381;Taip;0;0;1;1
5128;Molinukas;NYKŠTUKAI;60386582602;Taip;11;0;0;11
5129;Molinukas;NYKŠTUKAI;1388074160;Taip;3;0;0;3
5130;Molinukas;NYKŠTUKAI;78355703743;Ne;1;0;1;2
5131;Molinukas;NYKŠTUKAI;21462500359;Ne;0;0;8;8
5132;Molinukas;NYKŠTUKAI;10647191823;Taip;4;0;2;6
5133;Molinukas;NYKŠTUKAI;95409535650;Taip;0;1;3;4
5134;Molinukas;NYKŠTUKAI;11787953136;Taip;0;5;0;5
5135;Molinukas;NYKŠTUKAI;81983716075;Taip;0;6;3;9
5136;Molinukas;ZUIKUČIŲ;5387818175;Ne;4;0;1;5
5137;Molinukas;ZUIKUČIŲ;6326031969;Taip;6;0;0;6
5138;Molinukas;ZUIKUČIŲ;7398075402;Taip;5;0;0;5
5139;Molinukas;ZUIKUČIŲ;7377137582;Taip;0;10;4;14
5140;Molinukas;ZUIKUČIŲ;4534279257;Ne;14;0;0;14
5141;Molinukas;ZUIKUČIŲ;8688180482;Taip;9;5;7;21
5142;Molinukas;ZUIKUČIŲ;1686122652;Taip;12;0;0;12
5143;Molinukas;ZUIKUČIŲ;2324578741;Taip;0;0;3;3
5144;Molinukas;ZUIKUČIŲ;4918181437;Taip;10;0;6;16
5145;Molinukas;ZUIKUČIŲ;3497266382;Taip;5;0;1;6
5146;Molinukas;ZUIKUČIŲ;8604288346;Taip;0;5;2;7
5147;Molinukas;ZUIKUČIŲ;8297662673;Taip;22;0;0;22
5148;Molinukas;ZUIKUČIŲ;1856269656;Taip;12;0;2;14
5149;Molinukas;ZUIKUČIŲ;6636118069;Taip;0;10;0;10
5150;Molinukas;ZUIKUČIŲ;8525796051;Taip;7;0;0;7
5151;Molinukas;ZUIKUČIŲ;2774371800;Ne;0;0;1;1
5152;Molinukas;ZUIKUČIŲ;8913137310;Ne;0;2;0;2
5153;Molinukas;ZUIKUČIŲ;8416644024;Taip;7;0;3;10
5154;Molinukas;SRAIGIUKŲ;5116921885;Taip;10;0;1;11
5155;Molinukas;SRAIGIUKŲ;97437953544;Taip;10;3;0;13
5156;Molinukas;SRAIGIUKŲ;91328196871;Taip;6;2;0;8
5157;Molinukas;SRAIGIUKŲ;66414602983;Taip;5;0;2;7
5158;Molinukas;SRAIGIUKŲ;26935664306;Taip;0;2;2;4
5159;Molinukas;SRAIGIUKŲ;9379961926;Taip;0;0;13;13
5160;Molinukas;SRAIGIUKŲ;43690886471;Taip;0;7;0;7
5161;Molinukas;SRAIGIUKŲ;62433691448;Taip;0;0;2;2
5162;Molinukas;SRAIGIUKŲ;94522698417;Ne;0;0;6;6
5163;Molinukas;SRAIGIUKŲ;36167191615;Taip;0;0;6;6
5164;Molinukas;SRAIGIUKŲ;93991392425;Taip;4;0;4;8
5165;Molinukas;SRAIGIUKŲ;8013554298;Taip;0;0;1;1
5166;Molinukas;SRAIGIUKŲ;71842515853;Taip;7;0;1;8
5167;Molinukas;SRAIGIUKŲ;9854008152;Taip;0;0;3;3
5168;Molinukas;SRAIGIUKŲ;42123897177;Taip;9;0;1;10
5169;Molinukas;SRAIGIUKŲ;4659400698;Taip;0;11;0;11
5170;Molinukas;SRAIGIUKŲ;21801124679;Ne;0;0;3;3
5171;Molinukas;SRAIGIUKŲ;5258874882;Taip;3;8;0;11
5172;Molinukas;SRAIGIUKŲ;3000090536;Taip;0;0;2;2
5173;Molinukas;VOVERIUKAI;99537506556;Taip;0;0;1;1
5174;Molinukas;VOVERIUKAI;49733379099;Taip;0;4;0;4
5175;Molinukas;VOVERIUKAI;1293862946;Taip;0;0;1;1
5176;Molinukas;VOVERIUKAI;8674220663;Taip;0;8;0;8
5177;Molinukas;VOVERIUKAI;1151672597;Taip;6;0;0;6
5178;Molinukas;VOVERIUKAI;13856993048;Taip;5;0;3;8
5179;Molinukas;VOVERIUKAI;41153045448;Taip;0;0;2;2
5180;Molinukas;VOVERIUKAI;43651915331;Taip;0;7;15;22
5181;Molinukas;VOVERIUKAI;12208955611;Taip;0;1;0;1
5182;Molinukas;VOVERIUKAI;91913856999;Taip;2;0;1;3
5183;Molinukas;VOVERIUKAI;1241069188;Taip;1;1;0;2
5184;Molinukas;VOVERIUKAI;44399175317;Taip;5;6;0;11
5185;Molinukas;VOVERIUKAI;10482714545;Taip;0;13;0;13
5186;Molinukas;VOVERIUKAI;1880434477;Taip;0;0;2;2
5187;Molinukas;VOVERIUKAI;45801826827;Taip;9;0;1;10
5188;Molinukas;VOVERIUKAI;1018558040;Taip;11;0;2;13
5189;Molinukas;VOVERIUKAI;93528667925;Taip;0;0;1;1
5190;Molinukas;VOVERIUKAI;1538778372;Taip;0;0;3;3
5191;Molinukas;VOVERIUKAI;1167405137;Taip;4;0;0;4
5192;Molinukas;VOVERIUKAI;2048642721;Taip;0;4;0;4
5193;Molinukas;VOVERIUKAI;2041132581;Taip;0;0;3;3
5194;Molinukas;VOVERIUKAI;7987658567;Ne;0;2;0;2
5195;Molinukas;ŽVIRBLIUKŲ;6353165459;Taip;0;0;2;2
5196;Molinukas;ŽVIRBLIUKŲ;5876669121;Taip;4;0;0;4
5197;Molinukas;ŽVIRBLIUKŲ;3030169626;Taip;0;0;5;5
5198;Molinukas;ŽVIRBLIUKŲ;6087698882;Taip;11;0;1;12
5199;Molinukas;ŽVIRBLIUKŲ;6832647220;Taip;16;0;0;16
5200;Molinukas;ŽVIRBLIUKŲ;2211909678;Taip;13;0;0;13
5201;Molinukas;ŽVIRBLIUKŲ;4950808381;Taip;3;3;2;8
5202;Molinukas;ŽVIRBLIUKŲ;7623051674;Ne;7;0;3;10
5203;Molinukas;ŽVIRBLIUKŲ;6795839380;Taip;0;0;22;22
5204;Molinukas;ŽVIRBLIUKŲ;8053608348;Taip;7;4;0;11
5205;Molinukas;ŽVIRBLIUKŲ;8446233414;Taip;22;0;0;22
5206;Molinukas;ŽVIRBLIUKŲ;6014990150;Taip;4;0;0;4
5207;Molinukas;KAČIUKŲ;5685582215;Taip;0;7;0;7
5208;Molinukas;KAČIUKŲ;9448910819;Taip;0;0;1;1
5209;Molinukas;KAČIUKŲ;3469196411;Taip;5;0;2;7
5210;Molinukas;KAČIUKŲ;1849018608;Taip;0;1;0;1
5211;Molinukas;KAČIUKŲ;4171978721;Taip;0;5;4;9
5212;Molinukas;KAČIUKŲ;5580968328;Ne;5;0;1;6
5213;Molinukas;KAČIUKŲ;9413396859;Taip;0;1;0;1
5214;Molinukas;KAČIUKŲ;4896935150;Taip;19;0;0;19
5215;Molinukas;KAČIUKŲ;2286586693;Taip;5;1;0;6
5216;Molinukas;KAČIUKŲ;8536615996;Ne;6;0;4;10
5217;Molinukas;KAČIUKŲ;6898958282;Taip;3;0;2;5
5218;Naminukas;Drugeliai;46165828687;Taip;7;9;0;16
5219;Naminukas;Drugeliai;2126348084;Taip;0;12;0;12
5220;Naminukas;Drugeliai;1462439902;Taip;6;0;0;6
5221;Naminukas;Drugeliai;85754834119;Taip;0;2;0;2
5222;Naminukas;Drugeliai;91504585368;Taip;0;0;3;3
5223;Naminukas;Drugeliai;1315517694;Taip;7;0;0;7
5224;Naminukas;Drugeliai;10134368426;Taip;0;7;0;7
5225;Naminukas;Drugeliai;2126839560;Taip;5;0;0;5
5226;Naminukas;Drugeliai;1355495217;Taip;15;0;1;16
5227;Naminukas;Drugeliai;7291023483;Taip;0;1;0;1
5228;Naminukas;Drugeliai;27189261329;Taip;0;0;1;1
5229;Naminukas;Drugeliai;50807508081;Taip;0;9;0;9
5230;Naminukas;Drugeliai;34296400556;Taip;0;4;0;4
5231;Naminukas;Drugeliai;19432091931;Taip;6;11;0;17
5232;Naminukas;Drugeliai;90672353258;Taip;0;9;0;9
5233;Naminukas;Drugeliai;15608850480;Taip;0;0;1;1
5234;Naminukas;Drugeliai;8716638124;Taip;0;1;0;1
5235;Naminukas;Drugeliai;2967647412;Ne;0;11;0;11
5236;Naminukas;Drugeliai;5817578784;Taip;0;0;1;1
5237;Naminukas;Drugeliai;5822184150;Taip;0;0;3;3
5238;Naminukas;Drugeliai;7440490894;Taip;0;2;0;2
5239;Naminukas;Bitutės;53746114607;Taip;10;3;0;13
5240;Naminukas;Bitutės;9541388086;Taip;0;0;10;10
5241;Naminukas;Bitutės;4419568254;Taip;0;0;5;5
5242;Naminukas;Bitutės;1956749138;Taip;5;13;0;18
5243;Naminukas;Bitutės;6503569633;Taip;3;10;2;15
5244;Naminukas;Bitutės;3192885665;Taip;0;0;5;5
5245;Naminukas;Bitutės;9530232649;Taip;12;0;10;22
5246;Naminukas;Bitutės;8131328042;Taip;7;6;0;13
5247;Naminukas;Bitutės;2769848640;Taip;5;0;7;12
5248;Naminukas;Bitutės;7176287699;Taip;0;0;2;2
5249;Naminukas;Bitutės;7888950723;Taip;0;0;3;3
5250;Naminukas;Bitutės;1710002948;Taip;5;3;0;8
5251;Naminukas;Bitutės;5610993611;Taip;5;0;0;5
5252;Naminukas;Bitutės;3994190066;Taip;0;3;0;3
5253;Naminukas;Bitutės;6526207235;Taip;0;4;0;4
5254;Naminukas;Bitutės;9600303816;Taip;4;3;0;7
5255;Naminukas;Bitutės;5244682030;Taip;4;3;0;7
5256;Naminukas;Bitutės;5195078101;Taip;0;2;0;2
5257;Naminukas;Bitutės;9501202207;Taip;0;11;4;15
5258;Naminukas;Paukšteliai;92882855386;Taip;8;2;0;10
5259;Naminukas;Paukšteliai;37525846039;Taip;3;1;1;5
5260;Naminukas;Paukšteliai;2126182508;Taip;13;3;0;16
5261;Naminukas;Paukšteliai;3603079488;Ne;0;0;1;1
5262;Naminukas;Paukšteliai;59473696226;Taip;0;0;5;5
5263;Naminukas;Paukšteliai;39747242234;Taip;4;0;0;4
5264;Naminukas;Paukšteliai;1946057668;Taip;10;0;1;11
5265;Naminukas;Paukšteliai;1647625489;Taip;0;1;1;2
5266;Naminukas;Paukšteliai;1893485577;Taip;10;0;3;13
5267;Naminukas;Paukšteliai;1863885754;Taip;0;7;2;9
5268;Naminukas;Paukšteliai;2100371376;Taip;0;4;0;4
5269;Naminukas;Paukšteliai;1439033627;Ne;17;1;1;19
5270;Naminukas;Paukšteliai;15748906161;Ne;9;0;1;10
5271;Naminukas;Paukšteliai;70836957729;Taip;10;0;0;10
5272;Naminukas;Paukšteliai;7386776624;Taip;0;1;1;2
5273;Naminukas;Paukšteliai;9039313646;Taip;0;1;0;1
5274;Naminukas;"NYKŠTUKAI ";1509433995;Ne;0;0;1;1
5275;Naminukas;"NYKŠTUKAI ";59020433000;Taip;0;1;0;1
5276;Naminukas;"NYKŠTUKAI ";2544422668;Taip;0;0;3;3
5277;Naminukas;"NYKŠTUKAI ";3029310084;Taip;11;0;0;11
5278;Naminukas;"NYKŠTUKAI ";16946991001;Taip;7;1;0;8
5279;Naminukas;"NYKŠTUKAI ";7632725551;Ne;0;9;0;9
5280;Naminukas;"NYKŠTUKAI ";46665774314;Taip;10;5;0;15
5281;Naminukas;"NYKŠTUKAI ";1490712871;Taip;17;0;0;17
5282;Naminukas;"NYKŠTUKAI ";1252481328;Ne;22;0;0;22
5283;Naminukas;"NYKŠTUKAI ";5918430817;Taip;13;0;0;13
5284;Naminukas;"NYKŠTUKAI ";1499464511;Ne;0;2;3;5
5285;Naminukas;"NYKŠTUKAI ";9321656855;Taip;9;0;0;9
5286;Naminukas;"NYKŠTUKAI ";4515242836;Taip;0;0;6;6
5287;Naminukas;"NYKŠTUKAI ";3826149605;Ne;12;0;0;12
5288;Naminukas;"NYKŠTUKAI ";6501046678;Taip;2;0;1;3
5289;Naminukas;"NYKŠTUKAI ";6029194403;Ne;14;1;0;15
5290;Naminukas;"NYKŠTUKAI ";70281612245;Taip;11;0;1;12
5291;Naminukas;"NYKŠTUKAI ";10563508139;Taip;4;2;0;6
5292;Naminukas;"NYKŠTUKAI ";90045007984;Taip;0;2;0;2
5293;Naminukas;"NYKŠTUKAI ";74291965804;Taip;22;0;0;22
5294;Neries;DEBESĖLIŲ;28267779362;Taip;1;0;0;1
5295;Neries;DEBESĖLIŲ;8573169074;Taip;0;12;0;12
5296;Neries;DEBESĖLIŲ;2085901811;Taip;0;2;0;2
5297;Neries;DEBESĖLIŲ;70177841044;Taip;0;4;0;4
5298;Neries;DEBESĖLIŲ;66348813404;Ne;0;2;0;2
5299;Neries;DEBESĖLIŲ;97670123581;Taip;0;2;0;2
5300;Neries;DEBESĖLIŲ;78475531620;Taip;3;3;0;6
5301;Neries;DEBESĖLIŲ;58447815495;Taip;0;4;0;4
5302;Neries;DEBESĖLIŲ;1908377973;Taip;0;3;1;4
5303;Neries;DEBESĖLIŲ;1139288486;Taip;7;3;0;10
5304;Neries;DEBESĖLIŲ;6449369298;Taip;0;6;0;6
5305;Neries;DEBESĖLIŲ;6378297641;Taip;0;1;0;1
5306;Neries;DEBESĖLIŲ;2531690903;Taip;0;25;0;25
5307;Neries;DEBESĖLIŲ;20226478524;Taip;3;0;0;3
5308;Neries;DEBESĖLIŲ;25015347703;Taip;0;20;0;20
5309;Neries;DEBESĖLIŲ;6994378824;Taip;3;0;1;4
5310;Neries;PUMPURĖLIŲ;4058545269;Ne;0;7;0;7
5311;Neries;PUMPURĖLIŲ;40762091796;Taip;0;9;0;9
5312;Neries;PUMPURĖLIŲ;5189351158;Taip;0;4;0;4
5313;Neries;PUMPURĖLIŲ;42514000113;Ne;0;3;0;3
5314;Neries;PUMPURĖLIŲ;4112888398;Taip;0;3;0;3
5315;Neries;PUMPURĖLIŲ;1300411811;Taip;0;14;0;14
5316;Neries;PUMPURĖLIŲ;1355661922;Taip;11;0;0;11
5317;Neries;PUMPURĖLIŲ;1414837177;Taip;0;10;0;10
5318;Neries;PUMPURĖLIŲ;2003536788;Taip;0;10;0;10
5319;Neries;PUMPURĖLIŲ;14071513289;Taip;0;1;0;1
5320;Neries;PUMPURĖLIŲ;7332285452;Taip;0;7;0;7
5321;Neries;PUMPURĖLIŲ;2823401633;Taip;0;1;0;1
5322;Neries;PUMPURĖLIŲ;3914400553;Taip;0;7;0;7
5323;Neries;PUMPURĖLIŲ;5283566263;Ne;7;0;0;7
5324;Nykštukas;SMAGURIAI;46457925178;Taip;0;2;0;2
5325;Nykštukas;SMAGURIAI;67215878528;Taip;0;2;0;2
5326;Nykštukas;SMAGURIAI;279882740;Taip;0;3;0;3
5327;Nykštukas;SMAGURIAI;22907267392;Taip;0;1;0;1
5328;Nykštukas;SMAGURIAI;25467677674;Ne;0;1;0;1
5329;Nykštukas;SMAGURIAI;65431970524;Taip;7;1;0;8
5330;Nykštukas;SMAGURIAI;73015157334;Taip;0;1;1;2
5331;Nykštukas;SMAGURIAI;94379087811;Taip;4;1;0;5
5332;Nykštukas;SMAGURIAI;57158850838;Taip;0;7;0;7
5333;Nykštukas;SMAGURIAI;61896011340;Taip;0;8;0;8
5334;Nykštukas;SMAGURIAI;74269403579;Taip;5;0;0;5
5335;Nykštukas;SMAGURIAI;5270008748;Taip;0;5;0;5
5336;Nykštukas;SMAGURIAI;40765421180;Ne;7;7;0;14
5337;Nykštukas;SMAGURIAI;44921552171;Taip;4;9;0;13
5338;Nykštukas;SMAGURIAI;21793281327;Taip;0;1;0;1
5339;Nykštukas;SMAGURIAI;42662848704;Taip;0;2;0;2
5340;Nykštukas;SMAGURIAI;51839683425;Taip;0;7;0;7
5341;Nykštukas;SMAGURIAI;18018106215;Taip;2;3;0;5
5342;Nykštukas;SMALSIUKAI;59343371023;Taip;0;1;0;1
5343;Nykštukas;SMALSIUKAI;43810892974;Taip;0;0;5;5
5344;Nykštukas;SMALSIUKAI;62768852397;Taip;10;0;0;10
5345;Nykštukas;SMALSIUKAI;47375659986;Taip;7;1;0;8
5346;Nykštukas;SMALSIUKAI;38098661273;Taip;0;1;0;1
5347;Nykštukas;SMALSIUKAI;87609458114;Taip;0;0;1;1
5348;Nykštukas;SMALSIUKAI;26952411744;Ne;5;0;5;10
5349;Nykštukas;SMALSIUKAI;28276934404;Taip;0;1;0;1
5350;Nykštukas;SMALSIUKAI;79340379786;Taip;0;8;0;8
5351;Nykštukas;SMALSIUKAI;74234678869;Taip;0;8;0;8
5352;Nykštukas;SMALSIUKAI;51448568141;Taip;0;0;10;10
5353;Nykštukas;SMALSIUKAI;1213461702;Taip;0;4;0;4
5354;Nykštukas;SMALSIUKAI;50160103840;Taip;0;0;1;1
5355;Nykštukas;SMALSIUKAI;57664247691;Taip;7;0;0;7
5356;Nykštukas;SMALSIUKAI;7598045357;Taip;0;1;0;1
5357;Nykštukas;SMALSIUKAI;2018631335;Taip;0;0;3;3
5358;Nykštukas;AITVARIUKAI;1144228064;Ne;0;11;0;11
5359;Nykštukas;AITVARIUKAI;6787279403;Taip;0;9;0;9
5360;Nykštukas;AITVARIUKAI;3808695428;Taip;5;0;0;5
5361;Nykštukas;AITVARIUKAI;2002197530;Taip;15;0;1;16
5362;Nykštukas;AITVARIUKAI;2113361929;Taip;22;0;0;22
5363;Nykštukas;AITVARIUKAI;1555891900;Taip;0;3;0;3
5364;Nykštukas;AITVARIUKAI;4256675710;Taip;0;8;0;8
5365;Nykštukas;AITVARIUKAI;1209871301;Taip;16;1;0;17
5366;Nykštukas;AITVARIUKAI;93527297465;Taip;0;4;0;4
5367;Nykštukas;AITVARIUKAI;1642172676;Taip;0;3;0;3
5368;Nykštukas;AITVARIUKAI;1603960759;Taip;12;2;0;14
5369;Nykštukas;AITVARIUKAI;4487291454;Taip;0;1;2;3
5370;Nykštukas;AITVARIUKAI;5356005675;Taip;13;7;0;20
5371;Nykštukas;AITVARIUKAI;5772758127;Taip;5;0;0;5
5372;Nykštukas;AITVARIUKAI;9229795383;Ne;0;6;0;6
5373;Nykštukas;AITVARIUKAI;3479582264;Taip;0;2;0;2
5374;Nykštukas;AITVARIUKAI;1643843455;Taip;17;0;0;17
5375;Nykštukas;AITVARIUKAI;1965559069;Taip;0;10;0;10
5376;Nykštukas;DAINORĖLIAI;1505896987;Ne;8;0;1;9
5377;Nykštukas;DAINORĖLIAI;1070086244;Taip;2;1;0;3
5378;Nykštukas;DAINORĖLIAI;6105521992;Taip;0;1;0;1
5379;Nykštukas;DAINORĖLIAI;23638266708;Taip;0;5;0;5
5380;Nykštukas;DAINORĖLIAI;8027860617;Taip;0;0;5;5
5381;Nykštukas;DAINORĖLIAI;7498721887;Taip;13;0;0;13
5382;Nykštukas;DAINORĖLIAI;7660848578;Taip;0;1;0;1
5383;Nykštukas;DAINORĖLIAI;2284266953;Taip;0;0;1;1
5384;Nykštukas;DAINORĖLIAI;4720226790;Taip;10;7;0;17
5385;Nykštukas;DAINORĖLIAI;7546263542;Taip;0;0;2;2
5386;Nykštukas;DAINORĖLIAI;9778271272;Taip;0;10;0;10
5387;Nykštukas;DAINORĖLIAI;7150793310;Taip;16;0;0;16
5388;Nykštukas;DAINORĖLIAI;7584220414;Taip;0;6;0;6
5389;Nykštukas;DAINORĖLIAI;8323439041;Taip;14;1;0;15
5390;Nykštukas;DAINORĖLIAI;7615678714;Taip;0;2;0;2
5391;Nykštukas;DAINORĖLIAI;9567571526;Taip;0;0;7;7
5392;Nykštukas;DAINORĖLIAI;3970413055;Taip;9;0;4;13
5393;Nykštukas;DAINORĖLIAI;2657373608;Taip;0;6;0;6
5394;Nykštukas;DAINORĖLIAI;1755944368;Taip;22;0;0;22
5395;Nykštukas;DAINORĖLIAI;3904901392;Taip;9;7;0;16
5396;Nykštukas;POKŠTUKAI;3600328638;Taip;0;4;0;4
5397;Nykštukas;POKŠTUKAI;55774090623;Taip;0;1;0;1
5398;Nykštukas;POKŠTUKAI;76331610722;Taip;0;1;0;1
5399;Nykštukas;POKŠTUKAI;93975876383;Taip;0;1;0;1
5400;Nykštukas;POKŠTUKAI;38015323588;Taip;0;1;0;1
5401;Nykštukas;POKŠTUKAI;61522787793;Taip;0;2;0;2
5402;Nykštukas;POKŠTUKAI;57257040004;Taip;3;2;0;5
5403;Nykštukas;POKŠTUKAI;71341878371;Taip;0;1;0;1
5404;Nykštukas;POKŠTUKAI;26881921240;Ne;3;1;0;4
5405;Nykštukas;POKŠTUKAI;76160042626;Taip;0;5;0;5
5406;Nykštukas;POKŠTUKAI;47502587491;Ne;0;5;0;5
5407;Nykštukas;POKŠTUKAI;89192783223;Taip;0;5;0;5
5408;Nykštukas;POKŠTUKAI;35147793572;Taip;0;1;0;1
5409;Nykštukas;POKŠTUKAI;47936707754;Taip;7;1;0;8
5410;Nykštukas;POKŠTUKAI;26063170580;Taip;0;4;0;4
5411;Nykštukas;POKŠTUKAI;23972457568;Ne;0;22;0;22
5412;Nykštukas;POKŠTUKAI;85166768951;Taip;0;1;0;1
5413;Nykštukas;KODĖLČIUKAI;26966643974;Taip;0;3;0;3
5414;Nykštukas;KODĖLČIUKAI;16477177174;Taip;0;3;0;3
5415;Nykštukas;KODĖLČIUKAI;55476689493;Taip;0;6;0;6
5416;Nykštukas;KODĖLČIUKAI;32089764813;Taip;0;0;1;1
5417;Nykštukas;KODĖLČIUKAI;86515707900;Taip;0;11;0;11
5418;Nykštukas;KODĖLČIUKAI;44948458322;Taip;0;1;0;1
5419;Nykštukas;KODĖLČIUKAI;16511008060;Taip;0;7;2;9
5420;Nykštukas;KODĖLČIUKAI;3027861392;Taip;1;2;0;3
5421;Nykštukas;KODĖLČIUKAI;189969762;Taip;6;0;0;6
5422;Nykštukas;KODĖLČIUKAI;46532492743;Ne;2;2;0;4
5423;Nykštukas;KODĖLČIUKAI;36547972390;Taip;0;2;0;2
5424;Nykštukas;KODĖLČIUKAI;61302078210;Taip;0;22;0;22
5425;Nykštukas;KODĖLČIUKAI;98067007304;Taip;0;0;3;3
5426;Nykštukas;KODĖLČIUKAI;4168838641;Taip;0;0;4;4
5427;Nykštukas;PASAKORIAI;29477668697;Taip;5;3;0;8
5428;Nykštukas;PASAKORIAI;27650304509;Taip;0;6;0;6
5429;Nykštukas;PASAKORIAI;1754697121;Taip;10;0;0;10
5430;Nykštukas;PASAKORIAI;86393328886;Taip;2;6;0;8
5431;Nykštukas;PASAKORIAI;67433137766;Taip;10;0;0;10
5432;Nykštukas;PASAKORIAI;12777395170;Taip;0;10;0;10
5433;Nykštukas;PASAKORIAI;59971592045;Taip;7;0;0;7
5434;Nykštukas;PASAKORIAI;1412282356;Taip;0;9;0;9
5435;Nykštukas;PASAKORIAI;1312775821;Taip;9;0;0;9
5436;Nykštukas;PASAKORIAI;67209958343;Taip;0;13;0;13
5437;Nykštukas;PASAKORIAI;40012664626;Taip;0;3;0;3
5438;Nykštukas;PASAKORIAI;2106464061;Ne;9;3;0;12
5439;Nykštukas;PASAKORIAI;368045639;Ne;0;6;0;6
5440;Nykštukas;PASAKORIAI;53994799769;Taip;0;7;0;7
5441;Nykštukas;PASAKORIAI;1967445943;Taip;0;1;0;1
5442;Nykštukas;PASAKORIAI;88757197161;Taip;10;2;0;12
5443;Nykštukas;PASAKORIAI;301318033;Taip;0;4;0;4
5444;Nykštukas;PASAKORIAI;25431679881;Taip;22;0;0;22
5445;Nykštukas;PASAKORIAI;6154158870;Taip;10;7;0;17
5446;Nykštukas;PASAKORIAI;9728270999;Ne;0;4;0;4
5447;Nykštukas;PASAKORIAI;45917705129;Taip;0;3;0;3
5448;Nykštukas;PASAKORIAI;5185856324;Taip;1;0;3;4
5449;Nykštukas;GUDRUČIAI;90969634936;Taip;0;4;0;4
5450;Nykštukas;GUDRUČIAI;1572666795;Taip;0;9;0;9
5451;Nykštukas;GUDRUČIAI;66071060125;Taip;15;0;0;15
5452;Nykštukas;GUDRUČIAI;53603222817;Taip;0;0;1;1
5453;Nykštukas;GUDRUČIAI;23684742279;Taip;4;5;0;9
5454;Nykštukas;GUDRUČIAI;84800943947;Taip;0;1;0;1
5455;Nykštukas;GUDRUČIAI;30508998297;Taip;0;5;0;5
5456;Nykštukas;GUDRUČIAI;25097193002;Taip;2;0;0;2
5457;Nykštukas;GUDRUČIAI;1448977214;Taip;0;0;5;5
5458;Nykštukas;GUDRUČIAI;2109799405;Ne;0;13;0;13
5459;Nykštukas;GUDRUČIAI;83322635443;Taip;0;6;0;6
5460;Nykštukas;GUDRUČIAI;9041364129;Ne;0;22;0;22
5461;Nykštukas;GUDRUČIAI;7098812765;Taip;4;5;0;9
5462;Nykštukas;GUDRUČIAI;48718365302;Taip;11;1;0;12
5463;Nykštukas;GUDRUČIAI;2121319324;Taip;0;1;0;1
5464;Nykštukas;GUDRUČIAI;40386182073;Taip;0;2;0;2
5465;Nykštukas;GUDRUČIAI;54607001703;Taip;0;1;0;1
5466;Nykštukas;GUDRUČIAI;7356168681;Taip;7;0;4;11
5467;Nykštukas;GUDRUČIAI;27701482167;Taip;0;1;0;1
5468;Nykštukas;GUDRUČIAI;56267408803;Taip;5;1;0;6
5469;Nykštukas;GUDRUČIAI;26154640888;Taip;18;0;0;18
5470;Nykštukas;GUDRUČIAI;92898851752;Taip;0;13;0;13
5471;Nykštukas;GUDRUČIAI;85663477778;Taip;0;1;0;1
5472;Nykštukas;GUDRUČIAI;52614843907;Taip;5;0;0;5
5473;Nykštukas;GUDRUČIAI;94426618018;Taip;0;4;0;4
5474;Nykštukas;GUDRUČIAI;7325852578;Taip;5;0;0;5
5475;Nykštukas;GUDRUČIAI;1055246536;Taip;1;5;0;6
5476;Nykštukas;NAMINUKAI;99161787513;Taip;16;0;0;16
5477;Nykštukas;NAMINUKAI;69041011010;Taip;16;0;0;16
5478;Nykštukas;NAMINUKAI;1856534241;Ne;0;11;0;11
5479;Nykštukas;NAMINUKAI;34930388032;Ne;9;0;0;9
5480;Nykštukas;NAMINUKAI;1178437485;Taip;0;4;0;4
5481;Nykštukas;NAMINUKAI;1608057875;Taip;0;2;0;2
5482;Nykštukas;NAMINUKAI;1285120987;Taip;0;6;0;6
5483;Nykštukas;NAMINUKAI;1994080785;Taip;0;11;0;11
5484;Nykštukas;NAMINUKAI;37253009284;Taip;0;2;0;2
5485;Nykštukas;NAMINUKAI;1630706629;Ne;0;0;1;1
5486;Nykštukas;NAMINUKAI;1350373348;Taip;0;11;0;11
5487;Nykštukas;NAMINUKAI;27896604498;Taip;0;8;0;8
5488;Nykštukas;NAMINUKAI;7322548781;Taip;4;0;0;4
5489;Nykštukas;NAMINUKAI;9422129964;Taip;0;0;1;1
5490;Nykštukas;NAMINUKAI;7836485289;Taip;2;0;0;2
5491;Nykštukas;NAMINUKAI;1186114115;Taip;7;0;0;7
5492;Nykštukas;NAMINUKAI;30762220262;Taip;5;0;1;6
5493;Nykštukas;NAMINUKAI;30020977675;Ne;0;4;0;4
5494;Nykštukas;NAMINUKAI;61615049677;Taip;0;8;0;8
5495;Nykštukas;NAMINUKAI;86582838748;Taip;6;0;2;8
5496;Nykštukas;NAMINUKAI;49056338161;Taip;0;2;0;2
5497;Nykštukas;KŪLVERSTUKAI;4331906712;Taip;2;0;0;2
5498;Nykštukas;KŪLVERSTUKAI;6112448299;Taip;0;1;0;1
5499;Nykštukas;KŪLVERSTUKAI;2696384135;Taip;10;0;0;10
5500;Nykštukas;KŪLVERSTUKAI;4040123876;Taip;9;5;0;14
5501;Nykštukas;KŪLVERSTUKAI;1930357859;Taip;10;0;0;10
5502;Nykštukas;KŪLVERSTUKAI;2205400512;Taip;2;1;0;3
5503;Nykštukas;KŪLVERSTUKAI;9779645295;Taip;0;5;0;5
5504;Nykštukas;KŪLVERSTUKAI;6106373554;Taip;7;0;0;7
5505;Nykštukas;KŪLVERSTUKAI;4612171029;Taip;12;0;0;12
5506;Nykštukas;KŪLVERSTUKAI;3120577264;Taip;6;0;0;6
5507;Nykštukas;KŪLVERSTUKAI;6958596223;Taip;6;5;0;11
5508;Nykštukas;KŪLVERSTUKAI;3273579005;Taip;0;2;0;2
5509;Nykštukas;KŪLVERSTUKAI;3852057722;Taip;0;1;0;1
5510;Nykštukas;KŪLVERSTUKAI;5121027981;Taip;15;0;0;15
5511;Nykštukas;KŪLVERSTUKAI;3985610575;Taip;0;4;0;4
5512;Nykštukas;TREPSIUKAI;5190754451;Taip;5;0;0;5
5513;Nykštukas;TREPSIUKAI;8120626738;Taip;4;0;0;4
5514;Nykštukas;TREPSIUKAI;4795301170;Taip;16;0;0;16
5515;Nykštukas;TREPSIUKAI;4949895196;Taip;3;0;0;3
5516;Nykštukas;TREPSIUKAI;9713859038;Taip;8;0;1;9
5517;Nykštukas;TREPSIUKAI;2988856911;Taip;18;1;0;19
5518;Nykštukas;TREPSIUKAI;4830484167;Taip;7;0;1;8
5519;Nykštukas;TREPSIUKAI;2661110617;Taip;10;0;0;10
5520;Nykštukas;TREPSIUKAI;1707956308;Taip;0;3;0;3
5521;Nykštukas;TREPSIUKAI;8310484267;Taip;0;0;1;1
5522;Nykštukas;TREPSIUKAI;9326131725;Taip;0;1;0;1
5523;Nykštukas;TREPSIUKAI;9842748132;Taip;20;0;0;20
5524;Nykštukas;TREPSIUKAI;4771072061;Taip;17;0;0;17
5525;Nykštukas;TREPSIUKAI;1902253981;Taip;9;4;0;13
5526;Nykštukas;TREPSIUKAI;2826079911;Taip;0;0;1;1
5527;Nykštukas;TREPSIUKAI;2000207070;Taip;10;0;0;10
5528;Nykštukas;TREPSIUKAI;5421090978;Taip;18;3;0;21
5529;Nykštukas;TREPSIUKAI;7954996421;Taip;0;10;0;10
5530;Ozas;Smalsučiai;9227939420;Taip;5;0;0;5
5531;Ozas;Smalsučiai;7917100888;Taip;5;1;0;6
5532;Ozas;Smalsučiai;87218067796;Taip;17;0;0;17
5533;Ozas;Smalsučiai;4397034031;Taip;4;1;0;5
5534;Ozas;Smalsučiai;1974320330;Taip;0;6;0;6
5535;Ozas;Smalsučiai;1173284700;Taip;1;0;3;4
5536;Ozas;Smalsučiai;67987032400;Taip;0;2;0;2
5537;Ozas;Smalsučiai;57069047630;Taip;0;1;0;1
5538;Ozas;Smalsučiai;9595277597;Taip;0;5;0;5
5539;Ozas;Smalsučiai;1893257809;Taip;7;3;0;10
5540;Ozas;Smalsučiai;6540803077;Taip;0;1;0;1
5541;Ozas;Smalsučiai;8072802467;Taip;4;0;0;4
5542;Ozas;Smalsučiai;1248092034;Ne;2;0;0;2
5543;Ozas;Smalsučiai;43381497677;Taip;2;0;0;2
5544;Ozas;Smalsučiai;7351651916;Taip;0;3;0;3
5545;Ozas;Smalsučiai;3286170280;Taip;0;0;1;1
5546;Ozas;Smalsučiai;9521048381;Taip;18;0;0;18
5547;Ozas;Smalsučiai;2053832360;Taip;0;0;1;1
5548;Ozas;Drugeliai;1655808777;Taip;0;4;0;4
5549;Ozas;Drugeliai;8176840834;Taip;0;15;0;15
5550;Ozas;Drugeliai;6668470892;Taip;0;6;0;6
5551;Ozas;Drugeliai;8088330187;Taip;22;0;0;22
5552;Ozas;Drugeliai;9073973849;Taip;0;0;1;1
5553;Ozas;Drugeliai;9322806566;Taip;19;0;0;19
5554;Ozas;Drugeliai;2676747542;Taip;4;0;8;12
5555;Ozas;Drugeliai;8289643065;Taip;0;0;1;1
5556;Ozas;Drugeliai;4726019355;Taip;0;5;0;5
5557;Ozas;Drugeliai;9987863302;Ne;7;0;3;10
5558;Ozas;Drugeliai;5503766544;Taip;0;8;0;8
5559;Ozas;Drugeliai;2980799420;Taip;22;0;0;22
5560;Ozas;Drugeliai;4935698806;Taip;0;4;0;4
5561;Ozas;Drugeliai;1793692289;Taip;0;3;0;3
5562;Ozas;Drugeliai;8318380547;Taip;0;14;0;14
5563;Ozas;Drugeliai;2825614921;Taip;19;0;0;19
5564;Ozas;Drugeliai;43660054250;Taip;0;19;0;19
5565;Ozas;Boružėlės;1348960421;Taip;10;0;0;10
5566;Ozas;Boružėlės;1375643969;Ne;13;0;2;15
5567;Ozas;Boružėlės;63852147122;Taip;7;1;0;8
5568;Ozas;Boružėlės;8190314087;Taip;5;4;0;9
5569;Ozas;Boružėlės;3803998816;Taip;4;0;0;4
5570;Ozas;Boružėlės;1212358423;Taip;9;1;1;11
5571;Ozas;Boružėlės;7615907271;Taip;0;1;0;1
5572;Ozas;Boružėlės;1560342499;Taip;0;9;0;9
5573;Ozas;Boružėlės;8529654920;Taip;5;0;0;5
5574;Ozas;Boružėlės;60194872867;Ne;8;1;1;10
5575;Ozas;Boružėlės;2527574646;Taip;0;5;0;5
5576;Ozas;Boružėlės;9773251894;Taip;0;10;1;11
5577;Ozas;Boružėlės;36523514229;Taip;0;7;0;7
5578;Ozas;Boružėlės;1367050160;Taip;15;0;0;15
5579;Ozas;Boružėlės;68364031736;Taip;0;4;0;4
5580;Ozas;Boružėlės;2678629892;Taip;3;0;5;8
5581;Ozas;Boružėlės;1109113859;Ne;5;0;1;6
5582;Ozas;Boružėlės;1826499734;Taip;5;3;0;8
5583;Ozas;Boružėlės;6432357144;Taip;22;0;0;22
5584;Ozas;Boružėlės;1498656201;Taip;12;10;0;22
5585;Ozas;Boružėlės;8979747150;Taip;20;0;0;20
5586;Ozas;Boružėlės;1217496635;Taip;12;0;0;12
5587;Ozas;Boružėlės;1682529482;Taip;9;0;1;10
5588;Ozas;Žiogeliai;89211493110;Taip;0;6;0;6
5589;Ozas;Žiogeliai;47957527704;Taip;2;7;0;9
5590;Ozas;Žiogeliai;52850058303;Taip;0;6;0;6
5591;Ozas;Žiogeliai;71334912565;Taip;0;5;0;5
5592;Ozas;Žiogeliai;58157410967;Taip;0;5;0;5
5593;Ozas;Žiogeliai;54246199303;Taip;9;0;0;9
5594;Ozas;Žiogeliai;34439403991;Taip;5;0;0;5
5595;Ozas;Žiogeliai;12235746678;Taip;0;10;0;10
5596;Ozas;Žiogeliai;89415254787;Taip;0;1;0;1
5597;Ozas;Žiogeliai;1763449085;Taip;0;0;1;1
5598;Ozas;Žiogeliai;79201129646;Taip;8;0;1;9
5599;Ozas;Žiogeliai;33802611373;Taip;0;3;0;3
5600;Ozas;Žiogeliai;26147218825;Taip;0;12;0;12
5601;Ozas;Žiogeliai;4396409015;Taip;5;5;0;10
5602;Ozas;Žiogeliai;16202534864;Ne;0;3;0;3
5603;Ozas;Žiogeliai;47247380242;Ne;0;5;0;5
5604;Ozas;Žiogeliai;49875201400;Taip;0;3;0;3
5605;Ozas;Žiogeliai;96534241110;Taip;0;1;0;1
5606;Ozas;Žiogeliai;44852155196;Taip;0;0;3;3
5607;Ozas;Žiogeliai;82797241773;Taip;3;0;0;3
5608;Ozas;Žiogeliai;15053930619;Taip;5;5;0;10
5609;Ozas;Žiogeliai;42846343820;Taip;1;0;0;1
5610;Ozas;Bitutės;26114981770;Ne;0;0;3;3
5611;Ozas;Bitutės;49220695182;Taip;0;6;0;6
5612;Ozas;Bitutės;97985936709;Taip;0;2;2;4
5613;Ozas;Bitutės;96089833744;Taip;0;0;1;1
5614;Ozas;Bitutės;91462990629;Taip;4;1;2;7
5615;Ozas;Bitutės;25241271456;Taip;5;0;3;8
5616;Ozas;Bitutės;21436609394;Ne;0;1;2;3
5617;Ozas;Bitutės;1806690419;Taip;0;0;4;4
5618;Ozas;Bitutės;20806414515;Taip;0;0;5;5
5619;Ozas;Bitutės;73127608271;Taip;0;4;1;5
5620;Ozas;Bitutės;11842802958;Taip;0;6;0;6
5621;Ozas;Bitutės;14182351781;Ne;0;0;1;1
5622;Ozas;Bitutės;89886182151;Taip;0;0;5;5
5623;Ozas;Bitutės;55341521797;Taip;17;0;0;17
5624;Ozas;Bitutės;1352632856;Taip;7;0;0;7
5625;Ozas;Bitutės;11088024064;Taip;5;4;0;9
5626;Ozas;Bitutės;37636521897;Taip;0;0;3;3
5627;Ozas;Bitutės;2110892014;Taip;0;7;5;12
5628;Ozas;Bitutės;39931003216;Taip;0;0;1;1
5629;Ozas;Aitvarėliai;1653285671;Taip;6;4;0;10
5630;Ozas;Aitvarėliai;65979490151;Taip;0;0;2;2
5631;Ozas;Aitvarėliai;36897118363;Taip;0;6;0;6
5632;Ozas;Aitvarėliai;25660709486;Taip;8;12;0;20
5633;Ozas;Aitvarėliai;87500216376;Taip;0;6;0;6
5634;Ozas;Aitvarėliai;62542133064;Taip;0;12;2;14
5635;Ozas;Aitvarėliai;77935174855;Taip;7;0;5;12
5636;Ozas;Aitvarėliai;74709964983;Taip;0;3;0;3
5637;Ozas;Aitvarėliai;28736160618;Taip;0;3;0;3
5638;Ozas;Aitvarėliai;31810796132;Taip;6;1;0;7
5639;Ozas;Aitvarėliai;49556201469;Taip;0;3;0;3
5640;Ozas;Aitvarėliai;3222282556;Taip;0;2;0;2
5641;Ozas;Aitvarėliai;46679332069;Taip;12;0;0;12
5642;Ozas;Aitvarėliai;1556404162;Taip;2;0;0;2
5643;Ozas;Aitvarėliai;20944134865;Taip;0;7;0;7
5644;Ozas;Aitvarėliai;2087307495;Taip;0;10;0;10
5645;Ozas;Aitvarėliai;99211100553;Taip;0;0;1;1
5646;Ozas;Aitvarėliai;56927777775;Taip;0;9;0;9
5647;Ozas;Aitvarėliai;84378491220;Taip;7;0;2;9
5648;Ozas;Aitvarėliai;53609618421;Taip;0;1;0;1
5649;Ozas;Aitvarėliai;1182573257;Taip;15;0;0;15
5650;Ozas;Aitvarėliai;85075096111;Taip;0;7;0;7
5651;Ozas;Voveraitės;89115682092;Taip;5;4;3;12
5652;Ozas;Voveraitės;97875471586;Taip;0;0;5;5
5653;Ozas;Voveraitės;42030629149;Taip;0;0;8;8
5654;Ozas;Voveraitės;8817179462;Taip;0;2;0;2
5655;Ozas;Voveraitės;87683044622;Taip;0;0;19;19
5656;Ozas;Voveraitės;88443183082;Taip;9;1;1;11
5657;Ozas;Voveraitės;94576453630;Taip;9;7;0;16
5658;Ozas;Voveraitės;26834809068;Taip;0;10;0;10
5659;Ozas;Voveraitės;88508505247;Taip;0;9;0;9
5660;Ozas;Voveraitės;47574756201;Taip;12;2;1;15
5661;Ozas;Voveraitės;24088059514;Taip;0;1;0;1
5662;Ozas;Voveraitės;27655773887;Taip;0;1;0;1
5663;Ozas;Voveraitės;88837027397;Taip;0;1;0;1
5664;Ozas;Voveraitės;46431348128;Taip;0;1;0;1
5665;Ozas;Voveraitės;66463185196;Taip;16;0;0;16
5666;Ozas;Voveraitės;93882562685;Taip;0;7;0;7
5667;Ozas;Voveraitės;90020306864;Taip;6;2;0;8
5668;Ozas;Voveraitės;34723844399;Taip;0;0;1;1
5669;Ozas;Voveraitės;16101439010;Taip;0;5;2;7
5670;Ozas;Voveraitės;5637273299;Taip;0;0;17;17
5671;Ozas;Voveraitės;1637437696;Taip;8;0;1;9
5672;Ozas;Kodelčiukai;2808066733;Taip;8;13;0;21
5673;Ozas;Kodelčiukai;71351371644;Taip;0;1;0;1
5674;Ozas;Kodelčiukai;13077342836;Taip;0;8;0;8
5675;Ozas;Kodelčiukai;1746778441;Taip;0;2;0;2
5676;Ozas;Kodelčiukai;1110232715;Taip;0;5;0;5
5677;Ozas;Kodelčiukai;28273919775;Taip;15;0;0;15
5678;Ozas;Kodelčiukai;88618151766;Taip;4;0;0;4
5679;Ozas;Kodelčiukai;3637786952;Taip;5;7;0;12
5680;Ozas;Kodelčiukai;39003781970;Taip;5;7;0;12
5681;Ozas;Kodelčiukai;1243205832;Taip;8;0;0;8
5682;Ozas;Kodelčiukai;1235925750;Taip;22;0;0;22
5683;Ozas;Kodelčiukai;69756875821;Taip;10;4;0;14
5684;Ozas;Kodelčiukai;19065860134;Taip;10;4;0;14
5685;Ozas;Kodelčiukai;91774614891;Taip;5;2;0;7
5686;Ozas;Kodelčiukai;19284606277;Taip;5;1;0;6
5687;Ozas;Kodelčiukai;1230455881;Taip;12;0;0;12
5688;Ozas;Kodelčiukai;9664748034;Taip;0;2;0;2
5689;Ozas;Kodelčiukai;1684454071;Taip;0;3;0;3
5690;Ozas;Kodelčiukai;1008366446;Ne;0;1;1;2
5691;Ozas;Kodelčiukai;1995302672;Taip;0;2;0;2
5692;Ozas;Kodelčiukai;1288477637;Taip;12;1;0;13
5693;Ozas;Kodelčiukai;82373453244;Taip;0;4;0;4
5694;Ozas;Kodelčiukai;94673981368;Taip;0;8;0;8
5695;Ozas;Pelėdžiukai;1462541264;Taip;0;4;0;4
5696;Ozas;Pelėdžiukai;3439351594;Taip;0;14;0;14
5697;Ozas;Pelėdžiukai;41795363180;Taip;0;11;0;11
5698;Ozas;Pelėdžiukai;60743195418;Ne;0;8;0;8
5699;Ozas;Pelėdžiukai;64778552590;Taip;5;0;1;6
5700;Ozas;Pelėdžiukai;1755283948;Taip;0;0;5;5
5701;Ozas;Pelėdžiukai;13375413701;Taip;0;1;0;1
5702;Ozas;Pelėdžiukai;16523707810;Taip;7;0;1;8
5703;Ozas;Pelėdžiukai;47291376629;Taip;0;0;2;2
5704;Ozas;Pelėdžiukai;34330362446;Taip;12;1;0;13
5705;Ozas;Pelėdžiukai;1450257399;Taip;6;0;0;6
5706;Ozas;Pelėdžiukai;88159158596;Taip;2;0;0;2
5707;Ozas;Pelėdžiukai;56346624523;Taip;0;0;1;1
5708;Ozas;Pelėdžiukai;1814400303;Taip;5;5;0;10
5709;Ozas;Pelėdžiukai;1889249743;Taip;0;2;1;3
5710;Ozas;Pelėdžiukai;1099026003;Taip;7;0;0;7
5711;Ozas;Pelėdžiukai;15885510365;Taip;7;0;0;7
5712;Ozas;Pelėdžiukai;2058548464;Taip;3;0;0;3
5713;Ozas;Pelėdžiukai;4590847831;Taip;0;0;1;1
5714;Ozas;Pelėdžiukai;1910114048;Taip;0;1;0;1
5715;Ozas;"Kačiukai ";75077443996;Taip;6;0;1;7
5716;Ozas;"Kačiukai ";95179927759;Taip;0;2;0;2
5717;Ozas;"Kačiukai ";6618249243;Taip;5;9;3;17
5718;Ozas;"Kačiukai ";2114612776;Taip;0;15;2;17
5719;Ozas;"Kačiukai ";60155732637;Taip;0;2;0;2
5720;Ozas;"Kačiukai ";37159754070;Taip;0;0;1;1
5721;Ozas;"Kačiukai ";61398533877;Taip;0;0;2;2
5722;Ozas;"Kačiukai ";1580501935;Ne;0;0;8;8
5723;Ozas;"Kačiukai ";1848619053;Taip;0;0;17;17
5724;Ozas;"Kačiukai ";1316758924;Taip;10;7;2;19
5725;Ozas;"Kačiukai ";2018398634;Taip;0;0;9;9
5726;Ozas;"Kačiukai ";84277015523;Taip;0;0;3;3
5727;Ozas;"Kačiukai ";1822377180;Taip;16;0;2;18
5728;Ozas;"Kačiukai ";1551028882;Taip;5;0;0;5
5729;Ozas;"Kačiukai ";14760258125;Taip;5;0;1;6
5730;Ozas;"Kačiukai ";4400619617;Taip;0;0;4;4
5731;Ozas;"Kačiukai ";9345447142;Taip;15;0;1;16
5732;Ozas;"Kačiukai ";1681367373;Taip;0;12;0;12
5733;Ozas;"Kačiukai ";8248732706;Taip;14;1;1;16
5734;Ozas;Ančiukų;9392526836;Taip;0;9;0;9
5735;Ozas;Ančiukų;3255382007;Taip;7;2;1;10
5736;Ozas;Ančiukų;1837947633;Taip;0;2;0;2
5737;Ozas;Ančiukų;5850824864;Taip;10;0;0;10
5738;Ozas;Ančiukų;4966355020;Taip;0;0;3;3
5739;Ozas;Ančiukų;1562277866;Taip;0;0;1;1
5740;Ozas;Ančiukų;6088757991;Taip;22;0;0;22
5741;Ozas;Ančiukų;2991511872;Taip;6;0;0;6
5742;Ozas;Ančiukų;6257625501;Taip;22;0;0;22
5743;Ozas;Ančiukų;7402290524;Taip;9;8;0;17
5744;Ozas;Ančiukų;4571583671;Taip;9;1;0;10
5745;Ozas;Ančiukų;5682027094;Taip;15;2;5;22
5746;Ozas;Ančiukų;6053885086;Taip;11;3;0;14
5747;Ozas;Ančiukų;2511477658;Taip;0;1;0;1
5748;Ozas;Ančiukų;6950802941;Taip;18;0;0;18
5749;Ozas;Ančiukų;6499549095;Taip;7;2;1;10
5750;Ozas;Ančiukų;9324647606;Taip;13;0;1;14
5751;Ozas;Nykškukų;3329391600;Taip;0;2;1;3
5752;Ozas;Nykškukų;2352118061;Taip;12;0;0;12
5753;Ozas;Nykškukų;7499756171;Taip;7;13;0;20
5754;Ozas;Nykškukų;7018190169;Taip;6;0;0;6
5755;Ozas;Nykškukų;4254601638;Taip;10;0;0;10
5756;Ozas;Nykškukų;2705294874;Taip;0;5;0;5
5757;Ozas;Nykškukų;4227555342;Taip;9;5;0;14
5758;Ozas;Nykškukų;4220780257;Taip;10;2;0;12
5759;Ozas;Nykškukų;2773182934;Taip;5;5;0;10
5760;Ozas;Nykškukų;5102704846;Taip;0;0;2;2
5761;Ozas;Nykškukų;5642468671;Taip;5;0;0;5
5762;Ozas;Nykškukų;7494307084;Ne;22;0;0;22
5763;Ozas;Nykškukų;1475005204;Taip;4;0;0;4
5764;Ozas;Nykškukų;4583818638;Taip;9;0;0;9
5765;Ozas;Nykškukų;2369544599;Taip;0;2;1;3
5766;Ozas;Nykškukų;4207160323;Taip;5;2;0;7
5767;Ozas;Nykškukų;8416839037;Taip;6;1;0;7
5768;Ozas;Nykškukų;4699369567;Taip;7;0;0;7
5769;Ozas;Nykškukų;1161776624;Taip;7;1;0;8
5770;Pabiručiai;Voveriukų;82866592801;Taip;0;11;0;11
5771;Pabiručiai;Voveriukų;36884058806;Taip;0;2;0;2
5772;Pabiručiai;Voveriukų;1798480819;Taip;0;1;0;1
5773;Pabiručiai;Voveriukų;57797244989;Taip;0;11;0;11
5774;Pabiručiai;Voveriukų;48017416657;Taip;0;0;4;4
5775;Pabiručiai;Voveriukų;95846629190;Taip;3;9;0;12
5776;Pabiručiai;Voveriukų;5059523668;Ne;0;3;0;3
5777;Pabiručiai;Voveriukų;53593230261;Taip;0;1;0;1
5778;Pabiručiai;Voveriukų;92007951082;Taip;0;1;0;1
5779;Pabiručiai;Voveriukų;55956922916;Taip;0;11;0;11
5780;Pabiručiai;Voveriukų;81393745800;Ne;0;6;0;6
5781;Pabiručiai;Voveriukų;9492402983;Taip;4;2;1;7
5782;Pabiručiai;Voveriukų;44352248446;Ne;0;3;0;3
5783;Pabiručiai;Voveriukų;6160308400;Taip;0;8;0;8
5784;Pabiručiai;Boružiukų;1303589700;Taip;0;4;0;4
5785;Pabiručiai;Boružiukų;22866929836;Taip;0;7;0;7
5786;Pabiručiai;Boružiukų;47314536610;Taip;0;9;0;9
5787;Pabiručiai;Boružiukų;39499870735;Taip;0;3;0;3
5788;Pabiručiai;Boružiukų;32325675784;Taip;0;3;0;3
5789;Pabiručiai;Boružiukų;93509618214;Taip;0;2;1;3
5790;Pabiručiai;Boružiukų;57792326027;Taip;0;1;0;1
5791;Pabiručiai;Boružiukų;91293202710;Ne;0;7;0;7
5792;Pabiručiai;Boružiukų;27052463521;Taip;0;10;0;10
5793;Pabiručiai;Boružiukų;59616111036;Taip;0;2;4;6
5794;Pabiručiai;Boružiukų;2284041402;Taip;10;0;0;10
5795;Pabiručiai;Boružiukų;67295377190;Taip;0;1;0;1
5796;Pabiručiai;Boružiukų;61547104192;Taip;0;1;0;1
5797;Pabiručiai;Boružiukų;97165250663;Taip;0;2;0;2
5798;Pabiručiai;Boružiukų;38492844225;Taip;0;2;0;2
5799;Pabiručiai;Boružiukų;3959937657;Taip;10;0;0;10
5800;Pabiručiai;Boružiukų;51516019654;Taip;0;2;0;2
5801;Pabiručiai;Boružiukų;74823092402;Ne;0;2;0;2
5802;Pabiručiai;Boružiukų;32339177392;Taip;5;0;0;5
5803;Pabiručiai;Katinėlių;1670938208;Taip;13;0;1;14
5804;Pabiručiai;Katinėlių;1224986101;Taip;4;6;6;16
5805;Pabiručiai;Katinėlių;6283372742;Taip;4;0;0;4
5806;Pabiručiai;Katinėlių;1749155319;Ne;9;1;1;11
5807;Pabiručiai;Katinėlių;34883375155;Taip;0;15;0;15
5808;Pabiručiai;Katinėlių;58112415466;Taip;0;14;0;14
5809;Pabiručiai;Katinėlių;42877891797;Taip;0;5;0;5
5810;Pabiručiai;Katinėlių;6285940478;Taip;0;2;0;2
5811;Pabiručiai;Katinėlių;8284711578;Taip;0;2;0;2
5812;Pabiručiai;Katinėlių;8710389714;Taip;0;2;0;2
5813;Pabiručiai;Katinėlių;4501176225;Taip;0;5;0;5
5814;Pabiručiai;Katinėlių;8503177793;Taip;4;0;0;4
5815;Pabiručiai;Katinėlių;95695057362;Taip;0;1;0;1
5816;Pabiručiai;Katinėlių;4339607826;Taip;0;11;0;11
5817;Pabiručiai;Katinėlių;8306688649;Taip;1;0;2;3
5818;Pabiručiai;Katinėlių;2572570925;Taip;12;0;0;12
5819;Pabiručiai;Katinėlių;6994301415;Taip;0;0;17;17
5820;Pabiručiai;Katinėlių;4205107384;Taip;2;0;0;2
5821;Pabiručiai;Žiogelių;5522447437;Taip;13;0;0;13
5822;Pabiručiai;Žiogelių;7974345478;Taip;0;6;0;6
5823;Pabiručiai;Žiogelių;8367889753;Taip;0;4;0;4
5824;Pabiručiai;Žiogelių;3028063887;Taip;0;2;0;2
5825;Pabiručiai;Žiogelių;1642658060;Taip;0;10;0;10
5826;Pabiručiai;Žiogelių;3206962828;Taip;5;0;1;6
5827;Pabiručiai;Žiogelių;3355875364;Taip;0;1;0;1
5828;Pabiručiai;Žiogelių;7085036701;Taip;0;1;0;1
5829;Pabiručiai;Žiogelių;8736658575;Taip;0;1;2;3
5830;Pabiručiai;Žiogelių;1311650644;Taip;0;8;0;8
5831;Pabiručiai;Žiogelių;5480714322;Taip;0;2;0;2
5832;Pabiručiai;Žiogelių;3585198013;Taip;0;5;0;5
5833;Pabiručiai;Žiogelių;2356833740;Taip;0;0;4;4
5834;Pabiručiai;Žiogelių;5311762824;Taip;0;8;0;8
5835;Pabiručiai;Žiogelių;1587905929;Taip;22;0;0;22
5836;Pabiručiai;Žiogelių;5761888906;Taip;10;8;0;18
5837;Pabiručiai;Žiogelių;4667769378;Taip;0;10;0;10
5838;Pabiručiai;Smalsiukai;77665506359;Taip;0;3;0;3
5839;Pabiručiai;Smalsiukai;33576823599;Taip;0;7;0;7
5840;Pabiručiai;Smalsiukai;99245902550;Ne;0;2;0;2
5841;Pabiručiai;Smalsiukai;72030186300;Taip;9;3;0;12
5842;Pabiručiai;Smalsiukai;1461544209;Taip;0;0;2;2
5843;Pabiručiai;Smalsiukai;1749795353;Taip;11;5;0;16
5844;Pabiručiai;Smalsiukai;83758151778;Ne;0;1;0;1
5845;Pabiručiai;Smalsiukai;46891762701;Taip;0;4;0;4
5846;Pabiručiai;Smalsiukai;88469372129;Taip;0;1;0;1
5847;Pabiručiai;Smalsiukai;1052844376;Taip;0;8;0;8
5848;Pabiručiai;Smalsiukai;55812858767;Taip;0;8;1;9
5849;Pabiručiai;Smalsiukai;97516241743;Taip;0;0;5;5
5850;Pabiručiai;Smalsiukai;37299891873;Taip;10;0;0;10
5851;Pabiručiai;Smalsiukai;99612002248;Taip;5;1;0;6
5852;Pabiručiai;Smalsiukai;67029008630;Taip;0;5;0;5
5853;Pabiručiai;Smalsiukai;84458450123;Taip;0;2;0;2
5854;Pabiručiai;Smalsiukai;8690290547;Taip;0;15;0;15
5855;Pabiručiai;Smalsiukai;1961336031;Ne;0;12;0;12
5856;Pabiručiai;Kiškučiai;23334247840;Ne;13;0;0;13
5857;Pabiručiai;Kiškučiai;78055744911;Taip;0;1;0;1
5858;Pabiručiai;Kiškučiai;9756328087;Ne;0;10;0;10
5859;Pabiručiai;Kiškučiai;16153916925;Taip;0;11;0;11
5860;Pabiručiai;Kiškučiai;62817645726;Taip;0;6;0;6
5861;Pabiručiai;Kiškučiai;2117594123;Taip;21;0;0;21
5862;Pabiručiai;Kiškučiai;25986912111;Taip;0;5;0;5
5863;Pabiručiai;Kiškučiai;99405892035;Taip;0;12;0;12
5864;Pabiručiai;Kiškučiai;31043795418;Taip;0;17;0;17
5865;Pabiručiai;Kiškučiai;1189209435;Taip;0;4;0;4
5866;Pabiručiai;Kiškučiai;58410416452;Taip;21;0;0;21
5867;Pabiručiai;Kiškučiai;1457799587;Taip;2;0;0;2
5868;Pabiručiai;Kiškučiai;93595653770;Taip;0;8;0;8
5869;Pabiručiai;Kiškučiai;72090235276;Taip;0;10;0;10
5870;Pabiručiai;Kiškučiai;4463663862;Taip;6;12;0;18
5871;Pabiručiai;Kiškučiai;1780827082;Taip;0;3;0;3
5872;Pabiručiai;Kiškučiai;3767061583;Taip;12;1;0;13
5873;Pabiručiai;Kiškučiai;37991862437;Taip;0;2;0;2
5874;Pabiručiai;Kiškučiai;5327687404;Taip;5;1;0;6
5875;Pabiručiai;"Pėledžiukai ";7457099536;Taip;17;2;0;19
5876;Pabiručiai;"Pėledžiukai ";77273870334;Taip;0;1;0;1
5877;Pabiručiai;"Pėledžiukai ";80756439543;Taip;9;0;0;9
5878;Pabiručiai;"Pėledžiukai ";6112244077;Taip;7;3;0;10
5879;Pabiručiai;"Pėledžiukai ";18356992277;Taip;0;8;0;8
5880;Pabiručiai;"Pėledžiukai ";55197056543;Taip;0;1;0;1
5881;Pabiručiai;"Pėledžiukai ";42627202407;Taip;0;7;0;7
5882;Pabiručiai;"Pėledžiukai ";28121667845;Taip;0;6;0;6
5883;Pabiručiai;"Pėledžiukai ";1474411801;Taip;0;2;0;2
5884;Pabiručiai;"Pėledžiukai ";1591342751;Taip;0;2;0;2
5885;Pabiručiai;"Pėledžiukai ";1078387167;Taip;12;0;0;12
5886;Pabiručiai;"Pėledžiukai ";3733576400;Taip;0;12;0;12
5887;Pabiručiai;"Pėledžiukai ";4568554097;Taip;4;5;0;9
5888;Pabiručiai;"Pėledžiukai ";34215100257;Taip;0;12;0;12
5889;Pabiručiai;"Pėledžiukai ";26940925728;Taip;0;9;0;9
5890;Pabiručiai;"Pėledžiukai ";2944433375;Taip;0;5;0;5
5891;Pabiručiai;"Kodelčiūkai ";1819457592;Ne;0;9;0;9
5892;Pabiručiai;"Kodelčiūkai ";38142737487;Taip;0;9;0;9
5893;Pabiručiai;"Kodelčiūkai ";62923769489;Taip;0;11;0;11
5894;Pabiručiai;"Kodelčiūkai ";65267728282;Taip;0;1;0;1
5895;Pabiručiai;"Kodelčiūkai ";81307674221;Taip;0;0;1;1
5896;Pabiručiai;"Kodelčiūkai ";15948930587;Taip;20;2;0;22
5897;Pabiručiai;"Kodelčiūkai ";6696186733;Taip;17;0;0;17
5898;Pabiručiai;"Kodelčiūkai ";78798062773;Taip;0;6;0;6
5899;Pabiručiai;"Kodelčiūkai ";66085180057;Ne;0;11;0;11
5900;Pabiručiai;"Kodelčiūkai ";7468072633;Ne;0;6;0;6
5901;Pabiručiai;"Kodelčiūkai ";1901455947;Taip;5;0;1;6
5902;Pabiručiai;"Kodelčiūkai ";1718014001;Taip;0;8;0;8
5903;Pabiručiai;"Kodelčiūkai ";2143676810;Taip;0;8;0;8
5904;Pabiručiai;"Kodelčiūkai ";46251218463;Taip;0;0;3;3
5905;Pabiručiai;"Kodelčiūkai ";1236499374;Taip;0;19;0;19
5906;Pabiručiai;"Kodelčiūkai ";8344476830;Taip;0;8;0;8
5907;Pabiručiai;"Peliukų ";4301904533;Taip;14;0;0;14
5908;Pabiručiai;"Peliukų ";3096466200;Taip;0;8;0;8
5909;Pabiručiai;"Peliukų ";5708597471;Taip;8;2;0;10
5910;Pabiručiai;"Peliukų ";8106446562;Taip;0;7;0;7
5911;Pabiručiai;"Peliukų ";7046122545;Taip;0;0;4;4
5912;Pabiručiai;"Peliukų ";6401188653;Taip;0;2;0;2
5913;Pabiručiai;"Peliukų ";5686769648;Taip;0;6;0;6
5914;Pabiručiai;"Peliukų ";7073230645;Taip;22;0;0;22
5915;Pabiručiai;"Peliukų ";1344711015;Ne;0;2;0;2
5916;Pabiručiai;"Viščiukų ";2349337471;Taip;0;1;0;1
5917;Pabiručiai;"Viščiukų ";9468698553;Taip;5;0;0;5
5918;Pabiručiai;"Viščiukų ";4040533883;Taip;0;0;5;5
5919;Pabiručiai;"Viščiukų ";8236964683;Taip;0;1;0;1
5920;Pabiručiai;"Viščiukų ";7066037017;Taip;0;5;0;5
5921;Pabiručiai;"Viščiukų ";7090116276;Taip;1;1;10;12
5922;Pabiručiai;"Viščiukų ";2514312233;Taip;4;5;0;9
5923;Pabiručiai;"Viščiukų ";7606274875;Taip;4;5;0;9
5924;Pabiručiai;"Viščiukų ";8897462614;Taip;0;0;2;2
5925;Pabiručiai;"Viščiukų ";7278334800;Ne;6;0;1;7
5926;Pabiručiai;"Drugelių ";6251432968;Taip;5;0;0;5
5927;Pabiručiai;"Drugelių ";1671027282;Taip;7;0;0;7
5928;Pabiručiai;"Drugelių ";3151360288;Taip;0;1;0;1
5929;Pabiručiai;"Drugelių ";1028312285;Taip;5;0;1;6
5930;Pabiručiai;"Drugelių ";2446697763;Taip;2;0;3;5
5931;Pabiručiai;"Drugelių ";1498738549;Taip;13;3;0;16
5932;Pabiručiai;"Drugelių ";4312364951;Taip;4;1;2;7
5933;Pabiručiai;"Drugelių ";4462744848;Taip;0;11;0;11
5934;Pabiručiai;"Drugelių ";1240057541;Taip;0;10;0;10
5935;Pabiručiai;"Drugelių ";9589005897;Taip;22;0;0;22
5936;Pabiručiai;"Drugelių ";3759350345;Taip;0;5;0;5
5937;Pabiručiai;"Drugelių ";1582754284;Taip;0;8;0;8
5938;Pabiručiai;"Drugelių ";4813206044;Taip;17;1;0;18
5939;Pabiručiai;"Drugelių ";5497318373;Taip;8;0;0;8
5940;Pabiručiai;"Drugelių ";7572077461;Taip;18;1;0;19
5941;Pagrandukas;Saulytės;56985738094;Taip;10;1;0;11
5942;Pagrandukas;Saulytės;73747309137;Taip;5;10;0;15
5943;Pagrandukas;Saulytės;90141915028;Taip;0;15;0;15
5944;Pagrandukas;Saulytės;73094500140;Taip;0;1;0;1
5945;Pagrandukas;Saulytės;25042144265;Taip;0;1;0;1
5946;Pagrandukas;Saulytės;92496791690;Taip;0;9;0;9
5947;Pagrandukas;Saulytės;8490035231;Taip;0;16;0;16
5948;Pagrandukas;Saulytės;17860708643;Taip;5;0;0;5
5949;Pagrandukas;Saulytės;10275994267;Taip;0;12;0;12
5950;Pagrandukas;Saulytės;53442283517;Ne;0;9;0;9
5951;Pagrandukas;Saulytės;1735088719;Taip;0;6;0;6
5952;Pagrandukas;Saulytės;2240690677;Taip;0;6;0;6
5953;Pagrandukas;Saulytės;23836053268;Taip;0;11;0;11
5954;Pagrandukas;Saulytės;82076379343;Taip;0;10;0;10
5955;Pagrandukas;Saulytės;90244057040;Taip;0;16;0;16
5956;Pagrandukas;Saulytės;5179694773;Taip;5;5;0;10
5957;Pagrandukas;Saulytės;4550081974;Taip;0;5;0;5
5958;Pagrandukas;Zuikučiai;27121246153;Taip;0;0;2;2
5959;Pagrandukas;Zuikučiai;61698205530;Taip;0;0;2;2
5960;Pagrandukas;Zuikučiai;65443026043;Taip;0;1;0;1
5961;Pagrandukas;Zuikučiai;45339513408;Taip;5;6;0;11
5962;Pagrandukas;Zuikučiai;52079380668;Taip;0;3;0;3
5963;Pagrandukas;Zuikučiai;37941723547;Taip;0;1;0;1
5964;Pagrandukas;Zuikučiai;58398098970;Ne;0;6;0;6
5965;Pagrandukas;Zuikučiai;68051228918;Ne;0;6;0;6
5966;Pagrandukas;Zuikučiai;641267897;Taip;0;3;0;3
5967;Pagrandukas;Zuikučiai;99150983585;Taip;0;11;0;11
5968;Pagrandukas;Zuikučiai;43720624711;Taip;0;3;0;3
5969;Pagrandukas;Zuikučiai;1350949224;Taip;0;1;0;1
5970;Pagrandukas;Zuikučiai;49574848652;Taip;0;3;0;3
5971;Pagrandukas;Zuikučiai;18049426774;Taip;1;0;1;2
5972;Pagrandukas;Boružėlių;3888408459;Taip;3;0;0;3
5973;Pagrandukas;Boružėlių;3398225200;Taip;3;3;0;6
5974;Pagrandukas;Boružėlių;5752454925;Taip;0;0;9;9
5975;Pagrandukas;Boružėlių;3587941684;Ne;16;0;0;16
5976;Pagrandukas;Boružėlių;5946007985;Taip;7;1;5;13
5977;Pagrandukas;Boružėlių;7770852445;Taip;4;0;0;4
5978;Pagrandukas;Boružėlių;3953844737;Taip;7;2;0;9
5979;Pagrandukas;Boružėlių;7271589727;Taip;6;0;0;6
5980;Pagrandukas;Boružėlių;7064391685;Taip;10;0;1;11
5981;Pagrandukas;Boružėlių;5640182548;Taip;10;2;0;12
5982;Pagrandukas;Boružėlių;1403569615;Taip;5;10;0;15
5983;Pagrandukas;Boružėlių;1998073387;Taip;7;0;0;7
5984;Pagrandukas;Boružėlių;5511396314;Taip;2;13;0;15
5985;Pagrandukas;Bitutės;95949044544;Taip;0;0;4;4
5986;Pagrandukas;Bitutės;22146063631;Taip;0;8;0;8
5987;Pagrandukas;Bitutės;1844631218;Taip;0;0;6;6
5988;Pagrandukas;Bitutės;1479570204;Taip;0;0;5;5
5989;Pagrandukas;Bitutės;1505620688;Taip;0;0;5;5
5990;Pagrandukas;Bitutės;44029972943;Taip;0;1;1;2
5991;Pagrandukas;Bitutės;1707429884;Taip;7;1;0;8
5992;Pagrandukas;Bitutės;91591094393;Taip;0;0;5;5
5993;Pagrandukas;Bitutės;8891887553;Taip;0;0;3;3
5994;Pagrandukas;Bitutės;1503479321;Taip;0;0;3;3
5995;Pagrandukas;Bitutės;9313380552;Taip;0;0;5;5
5996;Pagrandukas;Bitutės;51982253355;Taip;0;7;0;7
5997;Pagrandukas;Bitutės;6044667668;Taip;7;0;0;7
5998;Pagrandukas;Bitutės;3227066520;Taip;0;0;3;3
5999;Pagrandukas;Pelėdžiukai;1590309916;Taip;0;1;0;1
6000;Pagrandukas;Pelėdžiukai;1964310988;Taip;0;3;0;3
6001;Pagrandukas;Pelėdžiukai;44044284874;Taip;5;3;0;8
6002;Pagrandukas;Pelėdžiukai;33750135077;Taip;0;7;2;9
6003;Pagrandukas;Pelėdžiukai;2066377478;Taip;0;0;1;1
6004;Pagrandukas;Pelėdžiukai;1189453012;Taip;0;2;0;2
6005;Pagrandukas;Pelėdžiukai;43539883053;Taip;5;1;0;6
6006;Pagrandukas;Pelėdžiukai;7751376696;Taip;0;1;0;1
6007;Pagrandukas;Pelėdžiukai;5818020587;Taip;0;2;0;2
6008;Pagrandukas;Pelėdžiukai;93036151205;Ne;0;2;1;3
6009;Pagrandukas;Pelėdžiukai;1232460221;Taip;2;1;9;12
6010;Pagrandukas;Pelėdžiukai;57471531440;Taip;0;18;0;18
6011;Pagrandukas;Žvaigždutė;9329518124;Taip;4;2;0;6
6012;Pagrandukas;Žvaigždutė;75080308291;Taip;0;5;0;5
6013;Pagrandukas;Žvaigždutė;7876029445;Taip;0;1;0;1
6014;Pagrandukas;Žvaigždutė;1313716840;Taip;0;1;0;1
6015;Pagrandukas;Žvaigždutė;14043704729;Taip;0;9;0;9
6016;Pagrandukas;Žvaigždutė;51692261484;Ne;5;7;0;12
6017;Pagrandukas;Žvaigždutė;35830862363;Ne;7;1;0;8
6018;Pagrandukas;Žvaigždutė;2079943643;Taip;0;1;0;1
6019;Pagrandukas;Žvaigždutė;2923517578;Taip;5;1;0;6
6020;Pagrandukas;Žvaigždutė;4724383814;Taip;0;0;5;5
6021;Pagrandukas;Žvaigždutė;7782678159;Taip;5;1;0;6
6022;Pagrandukas;Žvaigždutė;8879549409;Taip;0;2;0;2
6023;Pagrandukas;Žvaigždutė;6299298199;Taip;0;4;0;4
6024;Pagrandukas;Žvaigždutė;7543795007;Taip;0;7;0;7
6025;Pagrandukas;Žvaigždutė;3860781857;Taip;0;5;0;5
6026;Pagrandukas;Žvaigždutė;24287759126;Taip;5;2;0;7
6027;Pagrandukas;Žvaigždutė;9522269582;Taip;0;6;0;6
6028;Pakalnutė;Pagrandukai;22735454739;Taip;0;0;2;2
6029;Pakalnutė;Pagrandukai;1621947670;Ne;0;1;4;5
6030;Pakalnutė;Pagrandukai;2930341121;Taip;0;0;4;4
6031;Pakalnutė;Pagrandukai;70476217309;Ne;2;1;0;3
6032;Pakalnutė;Pagrandukai;39181323005;Taip;9;0;0;9
6033;Pakalnutė;Pagrandukai;83425301719;Taip;0;1;2;3
6034;Pakalnutė;Pagrandukai;46144634381;Taip;0;1;0;1
6035;Pakalnutė;Pagrandukai;6551713953;Taip;0;1;7;8
6036;Pakalnutė;Pagrandukai;57463392902;Taip;5;3;0;8
6037;Pakalnutė;Pagrandukai;97346486902;Taip;9;0;0;9
6038;Pakalnutė;Pagrandukai;24840895951;Taip;9;1;0;10
6039;Pakalnutė;Pagrandukai;58670351468;Taip;0;0;1;1
6040;Pakalnutė;Pagrandukai;7535589010;Taip;2;0;0;2
6041;Pakalnutė;Pagrandukai;1210432627;Taip;3;9;0;12
6042;Pakalnutė;Pagrandukai;3987920952;Ne;4;0;0;4
6043;Pakalnutė;Pagrandukai;34357752735;Ne;5;0;0;5
6044;Pakalnutė;Pagrandukai;28398386463;Taip;10;0;0;10
6045;Pakalnutė;"Pelėdžiukų ";1167939323;Taip;4;0;0;4
6046;Pakalnutė;"Pelėdžiukų ";88746368414;Taip;0;0;1;1
6047;Pakalnutė;"Pelėdžiukų ";77988376736;Taip;0;10;0;10
6048;Pakalnutė;"Pelėdžiukų ";26491667009;Taip;0;1;0;1
6049;Pakalnutė;"Pelėdžiukų ";77242242918;Taip;0;0;1;1
6050;Pakalnutė;"Pelėdžiukų ";22415995120;Taip;5;0;0;5
6051;Pakalnutė;"Pelėdžiukų ";1970792910;Taip;0;6;1;7
6052;Pakalnutė;"Pelėdžiukų ";1101880932;Taip;0;6;0;6
6053;Pakalnutė;"Pelėdžiukų ";2304898969;Taip;1;0;0;1
6054;Pakalnutė;"Pelėdžiukų ";12785798739;Taip;7;9;0;16
6055;Pakalnutė;"Pelėdžiukų ";9626872763;Ne;0;4;1;5
6056;Pakalnutė;"Pelėdžiukų ";65265804867;Taip;0;0;1;1
6057;Pakalnutė;"Pelėdžiukų ";24118925398;Taip;0;7;0;7
6058;Pakalnutė;Ežiukai;72729647117;Taip;0;8;0;8
6059;Pakalnutė;Ežiukai;64242664158;Taip;0;1;0;1
6060;Pakalnutė;Ežiukai;56277347819;Taip;6;4;0;10
6061;Pakalnutė;Ežiukai;48593837984;Taip;4;0;0;4
6062;Pakalnutė;Ežiukai;26038172396;Taip;0;0;1;1
6063;Pakalnutė;Ežiukai;82408964876;Taip;8;1;0;9
6064;Pakalnutė;Ežiukai;68936094010;Ne;2;0;0;2
6065;Pakalnutė;Ežiukai;49066311903;Taip;0;2;0;2
6066;Pakalnutė;Ežiukai;78371539346;Ne;6;5;0;11
6067;Pakalnutė;Ežiukai;89871858343;Taip;0;10;0;10
6068;Pakalnutė;Ežiukai;71254042639;Taip;0;2;0;2
6069;Pakalnutė;Ežiukai;91448223847;Taip;15;0;0;15
6070;Pakalnutė;Ežiukai;7696792543;Taip;4;0;0;4
6071;Pakalnutė;Ežiukai;1936371007;Taip;1;0;0;1
6072;Pakalnutė;Skruzdėliukų;58775427990;Taip;0;2;0;2
6073;Pakalnutė;Skruzdėliukų;35416453763;Taip;0;1;0;1
6074;Pakalnutė;Skruzdėliukų;89875639056;Ne;0;4;0;4
6075;Pakalnutė;Skruzdėliukų;1855158585;Ne;13;0;0;13
6076;Pakalnutė;Skruzdėliukų;7171281063;Ne;0;1;0;1
6077;Pakalnutė;Skruzdėliukų;79722445374;Taip;0;1;0;1
6078;Pakalnutė;Skruzdėliukų;58650103614;Taip;0;10;0;10
6079;Pakalnutė;Skruzdėliukų;1785760365;Taip;6;0;0;6
6080;Pakalnutė;Skruzdėliukų;42536262678;Taip;5;0;0;5
6081;Pakalnutė;Skruzdėliukų;16888957248;Taip;0;8;0;8
6082;Pakalnutė;Skruzdėliukų;1693445653;Ne;4;0;0;4
6083;Pakalnutė;Bitučių;2993145079;Taip;0;5;0;5
6084;Pakalnutė;Bitučių;2367683002;Taip;0;0;1;1
6085;Pakalnutė;Bitučių;2765220889;Taip;0;0;1;1
6086;Pakalnutė;Bitučių;9445909071;Ne;0;3;0;3
6087;Pakalnutė;Bitučių;5532458706;Taip;0;10;0;10
6088;Pakalnutė;Bitučių;5355198213;Taip;0;7;0;7
6089;Pakalnutė;Bitučių;5941955322;Taip;3;0;0;3
6090;Pakalnutė;Bitučių;3306334576;Taip;5;0;0;5
6091;Pakalnutė;Bitučių;2095540372;Taip;6;2;2;10
6092;Pakalnutė;Bitučių;5342592825;Taip;0;7;0;7
6093;Pakalnutė;Bitučių;2932205226;Taip;0;0;2;2
6094;Pakalnutė;Bitučių;1238121406;Taip;2;5;0;7
6095;Pakalnutė;Bitučių;6117542654;Taip;16;0;1;17
6096;Pakalnutė;Bitučių;5464143742;Taip;16;0;0;16
6097;Pakalnutė;Bitučių;6351193702;Ne;0;9;0;9
6098;Pakalnutė;Boružiukų;5120176374;Taip;2;4;0;6
6099;Pakalnutė;Boružiukų;9256219647;Taip;2;0;0;2
6100;Pakalnutė;Boružiukų;6798939288;Taip;10;0;0;10
6101;Pakalnutė;Boružiukų;7357431226;Taip;12;2;0;14
6102;Pakalnutė;Boružiukų;5039000154;Taip;5;12;0;17
6103;Pakalnutė;Boružiukų;7853479591;Ne;0;6;0;6
6104;Pakalnutė;Boružiukų;6575909478;Taip;0;15;0;15
6105;Pakalnutė;Boružiukų;3583094831;Taip;8;2;0;10
6106;Pakalnutė;Boružiukų;4033813807;Taip;9;4;0;13
6107;Pakalnutė;Boružiukų;2040992265;Taip;6;8;0;14
6108;Pakalnutė;Boružiukų;7503936754;Taip;4;1;3;8
6109;Pakalnutė;Boružiukų;2835611316;Taip;11;0;0;11
6110;Pakalnutė;Boružiukų;5134342817;Taip;7;0;1;8
6111;Pakalnutė;Boružiukų;7672252382;Ne;4;3;0;7
6112;Pakalnutė;Meškiukų;1602013811;Taip;0;8;0;8
6113;Pakalnutė;Meškiukų;41008813511;Ne;12;0;0;12
6114;Pakalnutė;Meškiukų;83174865018;Taip;0;1;0;1
6115;Pakalnutė;Meškiukų;1655551042;Taip;0;7;0;7
6116;Pakalnutė;Meškiukų;40117721972;Taip;8;5;0;13
6117;Pakalnutė;Meškiukų;64706392096;Ne;7;8;0;15
6118;Pakalnutė;Meškiukų;2202341545;Taip;14;0;0;14
6119;Pakalnutė;Meškiukų;7487278074;Taip;5;0;0;5
6120;Pakalnutė;Meškiukų;9355380341;Taip;0;22;0;22
6121;Pakalnutė;Meškiukų;7324846434;Taip;7;0;0;7
6122;Pakalnutė;Meškiukų;9001185744;Taip;5;0;0;5
6123;Pakalnutė;Nykštukai;6769352325;Taip;0;7;0;7
6124;Pakalnutė;Nykštukai;1202301707;Taip;10;0;0;10
6125;Pakalnutė;Nykštukai;11183301096;Taip;15;1;0;16
6126;Pakalnutė;Nykštukai;19773872429;Taip;2;0;0;2
6127;Pakalnutė;Nykštukai;85900847069;Taip;5;0;0;5
6128;Pakalnutė;Nykštukai;7452656662;Taip;0;4;1;5
6129;Pakalnutė;Nykštukai;7389600659;Taip;0;3;0;3
6130;Pakalnutė;Nykštukai;5309195407;Taip;0;4;0;4
6131;Pakalnutė;Nykštukai;1849396954;Taip;0;0;1;1
6132;Pakalnutė;Nykštukai;76382908561;Taip;0;0;2;2
6133;Pakalnutė;Nykštukai;99344331316;Taip;16;0;0;16
6134;Pakalnutė;Nykštukai;33667858388;Taip;0;9;0;9
6135;Pakalnutė;Nykštukai;2815093249;Taip;0;2;0;2
6136;Pakalnutė;Nykštukai;1372722843;Taip;0;9;0;9
6137;Pakalnutė;Nykštukai;2051737273;Taip;0;0;3;3
6138;Pakalnutė;Nykštukai;61712002384;Taip;4;4;0;8
6139;Pakalnutė;"Zuikučių ";1198230323;Taip;0;1;0;1
6140;Pakalnutė;"Zuikučių ";6016791282;Taip;0;10;0;10
6141;Pakalnutė;"Zuikučių ";3609982613;Taip;2;1;0;3
6142;Pakalnutė;"Zuikučių ";5958653847;Taip;6;0;0;6
6143;Pakalnutė;"Zuikučių ";2159430356;Taip;0;6;0;6
6144;Pakalnutė;"Zuikučių ";1147843795;Ne;0;8;1;9
6145;Pakalnutė;"Zuikučių ";6879558965;Taip;6;1;0;7
6146;Pakalnutė;"Zuikučių ";3555822605;Taip;12;0;2;14
6147;Pakalnutė;"Zuikučių ";1583462733;Taip;3;0;0;3
6148;Pakalnutė;"Zuikučių ";6377564215;Taip;3;0;0;3
6149;Pakalnutė;"Zuikučių ";3306670221;Taip;0;8;3;11
6150;Pakalnutė;"Zuikučių ";1159312512;Taip;13;1;0;14
6151;Pakalnutė;"Zuikučių ";6549217377;Taip;1;0;0;1
6152;Pakalnutė;"Zuikučių ";1610847242;Taip;0;2;0;2
6153;Pakalnutė;"Zuikučių ";8813262660;Ne;5;4;0;9
6154;Pakalnutė;"Zuikučių ";5102345686;Taip;0;1;0;1
6155;Pakalnutė;"Zuikučių ";7949588551;Ne;3;0;0;3
6156;Pakalnutė;"Zuikučių ";81578522887;Ne;2;1;0;3
6157;Pakalnutė;"Drugelių ";4046820545;Taip;5;12;0;17
6158;Pakalnutė;"Drugelių ";5973972464;Taip;5;1;0;6
6159;Pakalnutė;"Drugelių ";3035056391;Taip;9;12;0;21
6160;Pakalnutė;"Drugelių ";4742424647;Taip;0;2;0;2
6161;Pakalnutė;"Drugelių ";2075865543;Taip;0;1;0;1
6162;Pakalnutė;"Drugelių ";5435336235;Taip;0;10;4;14
6163;Pakalnutė;"Drugelių ";4514642887;Taip;10;4;0;14
6164;Pakalnutė;"Drugelių ";9274456755;Taip;0;6;0;6
6165;Pakalnutė;"Drugelių ";2721810040;Taip;0;0;10;10
6166;Pakalnutė;"Drugelių ";80818670065;Taip;7;5;0;12
6167;Pakalnutė;"Drugelių ";2049079012;Taip;0;3;0;3
6168;Pakalnutė;"Drugelių ";4681267749;Taip;0;5;0;5
6169;Pakalnutė;"Drugelių ";85356812538;Taip;0;6;0;6
6170;Pakalnutė;"Drugelių ";6771510589;Taip;11;0;0;11
6171;Pakalnutė;"Drugelių ";18503890312;Taip;0;13;0;13
6172;Pakalnutė;"Drugelių ";4264260466;Taip;9;1;0;10
6173;Panerių;Rūtelė;81949147104;Taip;0;0;3;3
6174;Panerių;Rūtelė;21661667266;Taip;0;0;6;6
6175;Panerių;Rūtelė;1429591387;Ne;0;0;3;3
6176;Panerių;Rūtelė;14092687895;Taip;0;0;4;4
6177;Panerių;Rūtelė;8498616733;Ne;0;16;4;20
6178;Panerių;Rūtelė;7324873912;Taip;0;0;2;2
6179;Panerių;Rūtelė;8388744329;Taip;0;0;2;2
6180;Panerių;Rūtelė;2348627375;Taip;10;0;2;12
6181;Panerių;Rūtelė;3349776899;Taip;0;14;4;18
6182;Panerių;Rūtelė;68313730462;Taip;4;0;5;9
6183;Panerių;Rūtelė;84672957234;Taip;13;0;0;13
6184;Panerių;Rūtelė;60738239005;Taip;20;0;0;20
6185;Panerių;Rūtelė;10051044012;Taip;0;9;0;9
6186;Panerių;Rūtelė;1017100748;Taip;0;3;0;3
6187;Panerių;Rūtelė;68231938043;Ne;0;0;1;1
6188;Panerių;Rūtelė;78838685571;Taip;0;22;0;22
6189;Panerių;Rūtelė;53384267657;Taip;0;0;1;1
6190;Panerių;Rūtelė;1558843252;Taip;0;0;4;4
6191;Panerių;Rūtelė;8666159951;Taip;0;0;9;9
6192;Panerių;Rūtelė;39185053006;Taip;0;5;0;5
6193;Panerių;Gėlytės;1894521927;Taip;3;0;0;3
6194;Panerių;Gėlytės;1303873524;Taip;3;0;1;4
6195;Panerių;Gėlytės;75034220223;Ne;9;2;0;11
6196;Panerių;Gėlytės;1386277428;Taip;0;1;0;1
6197;Panerių;Gėlytės;2069150261;Taip;13;0;0;13
6198;Panerių;Gėlytės;5109850366;Taip;0;5;0;5
6199;Panerių;Gėlytės;9268558715;Taip;11;0;2;13
6200;Panerių;Gėlytės;9004468035;Taip;10;0;0;10
6201;Panerių;Gėlytės;18963190527;Taip;13;0;0;13
6202;Panerių;Gėlytės;1423148023;Taip;0;0;1;1
6203;Panerių;Gėlytės;6227583229;Taip;0;0;6;6
6204;Panerių;Gėlytės;3843500717;Taip;0;0;5;5
6205;Panerių;Gėlytės;9639587601;Taip;0;3;0;3
6206;Panerių;Gėlytės;2786775879;Taip;0;17;0;17
6207;Panerių;Gėlytės;4103412131;Taip;22;0;0;22
6208;Panerių;Gėlytės;3631150576;Ne;0;7;0;7
6209;Panerių;Gėlytės;5001921323;Taip;0;0;2;2
6210;Panerių;Gėlytės;2608386063;Ne;9;0;2;11
6211;Panerių;Gėlytės;2195332401;Taip;0;0;11;11
6212;Panerių;Boružė;7805429137;Taip;10;0;1;11
6213;Panerių;Boružė;8299189235;Taip;22;0;0;22
6214;Panerių;Boružė;9268618414;Taip;0;0;1;1
6215;Panerių;Boružė;6908487075;Taip;5;1;16;22
6216;Panerių;Boružė;2571561865;Taip;0;13;0;13
6217;Panerių;Boružė;6411372006;Taip;5;0;2;7
6218;Panerių;Boružė;9506008651;Taip;11;0;0;11
6219;Panerių;Boružė;1419817211;Taip;10;0;3;13
6220;Panerių;Boružė;9188471756;Taip;2;0;0;2
6221;Panerių;Boružė;4023257875;Taip;0;8;0;8
6222;Panerių;Boružė;4689913361;Taip;5;0;0;5
6223;Panerių;Boružė;8693113275;Taip;18;0;0;18
6224;Panerių;Boružė;8771264170;Ne;3;0;3;6
6225;Panerių;Boružė;6182126113;Ne;5;0;0;5
6226;Papartis;ZUIKUČIAI;1065234123;Taip;7;0;2;9
6227;Papartis;ZUIKUČIAI;27900855758;Taip;4;0;3;7
6228;Papartis;ZUIKUČIAI;1219140467;Taip;0;1;6;7
6229;Papartis;ZUIKUČIAI;1260151691;Taip;4;0;0;4
6230;Papartis;ZUIKUČIAI;2412700197;Taip;5;4;0;9
6231;Papartis;ZUIKUČIAI;1554777403;Taip;0;3;0;3
6232;Papartis;ZUIKUČIAI;7703070601;Taip;0;5;0;5
6233;Papartis;ZUIKUČIAI;7902130389;Taip;5;6;0;11
6234;Papartis;ZUIKUČIAI;4992305227;Taip;14;0;0;14
6235;Papartis;ZUIKUČIAI;4346817695;Taip;0;0;2;2
6236;Papartis;ZUIKUČIAI;2447926422;Taip;5;9;0;14
6237;Papartis;ZUIKUČIAI;3182457453;Taip;17;0;2;19
6238;Papartis;ZUIKUČIAI;3275123842;Taip;0;5;0;5
6239;Papartis;ZUIKUČIAI;8190458132;Taip;5;1;2;8
6240;Papartis;ZUIKUČIAI;8952917454;Taip;0;0;3;3
6241;Papartis;ZUIKUČIAI;5410369044;Taip;0;0;6;6
6242;Papartis;ZUIKUČIAI;6126912448;Taip;0;0;3;3
6243;Papartis;ZUIKUČIAI;5675537250;Ne;3;0;0;3
6244;Papartis;ZUIKUČIAI;3221250267;Taip;4;0;1;5
6245;Papartis;ZUIKUČIAI;5846324441;Ne;7;1;6;14
6246;Papartis;ZUIKUČIAI;1065128993;Ne;15;1;2;18
6247;Papartis;ZUIKUČIAI;3895487270;Taip;6;6;0;12
6248;Papartis;DRUGELIAI;4508053349;Taip;3;2;2;7
6249;Papartis;DRUGELIAI;7387281720;Taip;0;8;0;8
6250;Papartis;DRUGELIAI;3243869451;Taip;0;0;1;1
6251;Papartis;DRUGELIAI;2778629398;Taip;18;0;0;18
6252;Papartis;DRUGELIAI;3475745012;Taip;12;0;8;20
6253;Papartis;DRUGELIAI;2535412635;Taip;8;0;7;15
6254;Papartis;DRUGELIAI;6797687614;Taip;5;0;2;7
6255;Papartis;DRUGELIAI;8148483438;Taip;0;0;2;2
6256;Papartis;DRUGELIAI;5265293240;Taip;0;15;7;22
6257;Papartis;DRUGELIAI;9134335737;Taip;0;15;7;22
6258;Papartis;DRUGELIAI;1836914270;Taip;9;0;2;11
6259;Papartis;DRUGELIAI;4935694347;Taip;3;0;5;8
6260;Papartis;DRUGELIAI;1672028156;Taip;0;0;3;3
6261;Papartis;DRUGELIAI;3107106078;Taip;0;0;14;14
6262;Papartis;DRUGELIAI;1205854439;Ne;0;0;6;6
6263;Papartis;DRUGELIAI;7067369268;Taip;0;0;14;14
6264;Papartis;DRUGELIAI;6746279237;Taip;18;0;3;21
6265;Papartis;ŽVIRBLIUKAI;50932429867;Taip;0;5;0;5
6266;Papartis;ŽVIRBLIUKAI;76557621397;Taip;0;0;5;5
6267;Papartis;ŽVIRBLIUKAI;25395258852;Taip;0;7;0;7
6268;Papartis;ŽVIRBLIUKAI;43479692818;Taip;0;0;1;1
6269;Papartis;ŽVIRBLIUKAI;38687595335;Taip;0;5;2;7
6270;Papartis;ŽVIRBLIUKAI;2572865390;Taip;5;0;7;12
6271;Papartis;ŽVIRBLIUKAI;36753788655;Taip;0;5;0;5
6272;Papartis;ŽVIRBLIUKAI;75872164784;Taip;0;0;2;2
6273;Papartis;ŽVIRBLIUKAI;97003005429;Ne;12;0;0;12
6274;Papartis;ŽVIRBLIUKAI;2328716782;Taip;5;2;1;8
6275;Papartis;ŽVIRBLIUKAI;44727915152;Taip;3;3;0;6
6276;Papartis;ŽVIRBLIUKAI;60618694149;Taip;0;5;0;5
6277;Papartis;ŽVIRBLIUKAI;60803503066;Taip;0;0;3;3
6278;Papartis;ŽVIRBLIUKAI;66084413148;Taip;5;0;11;16
6279;Papartis;ŽVIRBLIUKAI;54923526939;Taip;0;0;1;1
6280;Papartis;ŽVIRBLIUKAI;65887563163;Ne;0;5;0;5
6281;Papartis;ŽVIRBLIUKAI;95325725936;Taip;3;2;0;5
6282;Papartis;ŽVIRBLIUKAI;6896883671;Taip;0;0;2;2
6283;Papartis;ŽVIRBLIUKAI;1712122097;Taip;0;6;0;6
6284;Papartis;SAULUTĖS;42803013754;Taip;0;3;0;3
6285;Papartis;SAULUTĖS;2022533158;Taip;1;0;1;2
6286;Papartis;SAULUTĖS;1237889393;Taip;0;1;0;1
6287;Papartis;SAULUTĖS;1246604915;Taip;0;2;0;2
6288;Papartis;SAULUTĖS;48182233276;Taip;0;1;0;1
6289;Papartis;SAULUTĖS;23218268605;Ne;2;0;0;2
6290;Papartis;SAULUTĖS;18124337938;Taip;5;0;2;7
6291;Papartis;SAULUTĖS;22443998204;Taip;0;2;0;2
6292;Papartis;SAULUTĖS;30982681803;Taip;0;6;0;6
6293;Papartis;SAULUTĖS;95139517078;Taip;0;6;0;6
6294;Papartis;SAULUTĖS;14978429821;Taip;0;1;0;1
6295;Papartis;SAULUTĖS;50090482473;Taip;0;1;1;2
6296;Papartis;SAULUTĖS;10078570352;Taip;5;1;2;8
6297;Papartis;SAULUTĖS;88700503601;Taip;0;1;1;2
6298;Papartis;SAULUTĖS;21963930874;Taip;0;7;0;7
6299;Papartis;SAULUTĖS;15207322802;Taip;0;1;0;1
6300;Papartis;SAULUTĖS;2115718328;Ne;0;0;1;1
6301;Papartis;SAULUTĖS;3933829088;Taip;0;0;11;11
6302;Papartis;SAULUTĖS;67966766974;Taip;0;1;0;1
6303;Papartis;GANDRIUKAI;46076659264;Ne;0;2;1;3
6304;Papartis;GANDRIUKAI;1727771667;Taip;0;0;2;2
6305;Papartis;GANDRIUKAI;37759125130;Taip;0;22;0;22
6306;Papartis;GANDRIUKAI;20862839950;Taip;0;2;0;2
6307;Papartis;GANDRIUKAI;20907751423;Taip;0;0;1;1
6308;Papartis;GANDRIUKAI;8564913801;Taip;7;0;0;7
6309;Papartis;GANDRIUKAI;47876153590;Taip;0;7;0;7
6310;Papartis;GANDRIUKAI;84260015363;Taip;0;6;0;6
6311;Papartis;GANDRIUKAI;67226404925;Taip;22;0;0;22
6312;Papartis;GANDRIUKAI;41330436046;Taip;5;1;0;6
6313;Papartis;GANDRIUKAI;83927324420;Taip;0;3;0;3
6314;Papartis;GANDRIUKAI;21840378271;Taip;2;0;0;2
6315;Papartis;GANDRIUKAI;93141801552;Taip;0;1;0;1
6316;Papartis;GANDRIUKAI;80455285324;Taip;0;2;0;2
6317;Papartis;GANDRIUKAI;81006952163;Taip;3;0;0;3
6318;Papartis;GANDRIUKAI;285754903;Taip;6;2;0;8
6319;Papartis;GANDRIUKAI;51857496843;Taip;0;1;0;1
6320;Papartis;GANDRIUKAI;18164175829;Taip;0;0;3;3
6321;Papartis;GANDRIUKAI;10026323228;Taip;0;0;22;22
6322;Papartis;GANDRIUKAI;1045629158;Taip;0;1;0;1
6323;Papartis;GANDRIUKAI;8593823543;Taip;5;4;0;9
6324;Papartis;SMALSUČIAI;2889259605;Taip;5;0;0;5
6325;Papartis;SMALSUČIAI;3287617252;Taip;0;1;2;3
6326;Papartis;SMALSUČIAI;4823666725;Taip;0;7;0;7
6327;Papartis;SMALSUČIAI;1406820323;Taip;0;15;0;15
6328;Papartis;SMALSUČIAI;2092191603;Taip;0;2;0;2
6329;Papartis;SMALSUČIAI;2067304804;Taip;5;0;0;5
6330;Papartis;SMALSUČIAI;51899025231;Ne;8;0;0;8
6331;Papartis;SMALSUČIAI;74972133115;Taip;0;0;2;2
6332;Papartis;SMALSUČIAI;4216398263;Taip;0;8;0;8
6333;Papartis;SMALSUČIAI;89525856173;Taip;0;4;1;5
6334;Papartis;SMALSUČIAI;82454730189;Taip;5;0;0;5
6335;Papartis;SMALSUČIAI;74734443304;Taip;5;1;0;6
6336;Papartis;SMALSUČIAI;2398385967;Taip;0;2;0;2
6337;Papartis;SMALSUČIAI;63087155760;Taip;0;0;4;4
6338;Papartis;SMALSUČIAI;26193472997;Taip;7;1;0;8
6339;Papartis;SMALSUČIAI;68478260102;Ne;0;6;0;6
6340;Papartis;"ŽIRNIUKAI ";44833872631;Taip;14;0;0;14
6341;Papartis;"ŽIRNIUKAI ";1944730492;Taip;0;0;4;4
6342;Papartis;"ŽIRNIUKAI ";12406782910;Taip;0;2;0;2
6343;Papartis;"ŽIRNIUKAI ";1271303103;Taip;10;0;8;18
6344;Papartis;"ŽIRNIUKAI ";7845277151;Taip;0;7;0;7
6345;Papartis;"ŽIRNIUKAI ";30041894006;Taip;5;0;0;5
6346;Papartis;"ŽIRNIUKAI ";3630377970;Taip;11;0;1;12
6347;Papartis;"ŽIRNIUKAI ";38896771062;Taip;0;0;8;8
6348;Papartis;"ŽIRNIUKAI ";86735273559;Taip;4;0;0;4
6349;Papartis;"ŽIRNIUKAI ";29789530287;Taip;0;0;2;2
6350;Papartis;"ŽIRNIUKAI ";22570313128;Taip;8;0;0;8
6351;Papartis;"ŽIRNIUKAI ";51588027659;Taip;0;8;0;8
6352;Papartis;"ŽIRNIUKAI ";1703232380;Taip;0;12;0;12
6353;Papartis;"ŽIRNIUKAI ";64345875780;Ne;9;4;0;13
6354;Papartis;"ŽIRNIUKAI ";2598688561;Taip;7;0;1;8
6355;Papartis;"ŽIRNIUKAI ";53040207725;Taip;0;5;1;6
6356;Papartis;"ŽIRNIUKAI ";3991709974;Taip;0;6;0;6
6357;Papartis;"ŽIRNIUKAI ";3367009621;Taip;6;0;0;6
6358;Papartis;"ŽIRNIUKAI ";3408756311;Taip;0;2;0;2
6359;Papartis;BORUŽĖLĖS;3320524073;Taip;8;0;0;8
6360;Papartis;BORUŽĖLĖS;9384670351;Taip;1;9;0;10
6361;Papartis;BORUŽĖLĖS;1974159967;Taip;9;0;0;9
6362;Papartis;BORUŽĖLĖS;5732853976;Taip;7;0;1;8
6363;Papartis;BORUŽĖLĖS;4279580382;Taip;2;5;1;8
6364;Papartis;BORUŽĖLĖS;8891856856;Taip;0;1;0;1
6365;Papartis;BORUŽĖLĖS;8532558577;Taip;8;0;0;8
6366;Papartis;BORUŽĖLĖS;9968072478;Ne;0;0;1;1
6367;Papartis;BORUŽĖLĖS;1916222143;Taip;20;0;0;20
6368;Papartis;BORUŽĖLĖS;2215846642;Taip;0;0;3;3
6369;Papartis;BORUŽĖLĖS;9704930584;Taip;0;7;0;7
6370;Papartis;BORUŽĖLĖS;7859096984;Taip;0;1;0;1
6371;Papartis;BORUŽĖLĖS;7252265838;Taip;11;0;0;11
6372;Papartis;BORUŽĖLĖS;9072635586;Taip;11;0;2;13
6373;Papartis;BORUŽĖLĖS;9804863902;Taip;4;0;1;5
6374;Papartis;VARPELIAI;9502229005;Taip;12;0;0;12
6375;Papartis;VARPELIAI;4203241118;Taip;0;0;6;6
6376;Papartis;VARPELIAI;4570512336;Taip;0;0;7;7
6377;Papartis;VARPELIAI;3324647852;Taip;0;0;2;2
6378;Papartis;VARPELIAI;5652560002;Taip;0;12;0;12
6379;Papartis;VARPELIAI;6949120693;Taip;0;7;0;7
6380;Papartis;VARPELIAI;6794076631;Taip;17;0;0;17
6381;Papartis;VARPELIAI;1596721999;Taip;0;0;22;22
6382;Papartis;VARPELIAI;5957889361;Taip;0;0;1;1
6383;Papartis;VARPELIAI;9939850340;Taip;0;2;0;2
6384;Papartis;VARPELIAI;8932290803;Taip;0;3;3;6
6385;Papartis;VARPELIAI;7803854703;Taip;0;1;0;1
6386;Papartis;VARPELIAI;5218101579;Ne;10;0;0;10
6387;Papartis;VARPELIAI;5608868738;Ne;0;7;0;7
6388;Papartis;VARPELIAI;6423401656;Taip;0;0;1;1
6389;Pasagėlė;SMALSUČIŲ;63657801249;Ne;0;0;2;2
6390;Pasagėlė;SMALSUČIŲ;2096927238;Ne;0;2;0;2
6391;Pasagėlė;SMALSUČIŲ;27151485531;Taip;11;0;0;11
6392;Pasagėlė;SMALSUČIŲ;1616662586;Taip;0;5;4;9
6393;Pasagėlė;SMALSUČIŲ;1180183091;Taip;10;6;0;16
6394;Pasagėlė;SMALSUČIŲ;8285580095;Taip;0;15;0;15
6395;Pasagėlė;SMALSUČIŲ;8218872969;Ne;0;0;6;6
6396;Pasagėlė;SMALSUČIŲ;8301904575;Taip;6;0;2;8
6397;Pasagėlė;SMALSUČIŲ;1587218379;Taip;0;0;3;3
6398;Pasagėlė;SMALSUČIŲ;76285364171;Taip;0;0;2;2
6399;Pasagėlė;SMALSUČIŲ;49106308532;Taip;0;2;0;2
6400;Pasagėlė;SMALSUČIŲ;1974755599;Taip;0;3;0;3
6401;Pasagėlė;SMALSUČIŲ;6543038595;Ne;0;9;0;9
6402;Pasagėlė;GUDRUČIŲ;75037090183;Taip;0;0;3;3
6403;Pasagėlė;GUDRUČIŲ;84330734709;Taip;0;0;1;1
6404;Pasagėlė;GUDRUČIŲ;80908835303;Taip;2;0;0;2
6405;Pasagėlė;GUDRUČIŲ;7050705086;Taip;0;0;2;2
6406;Pasagėlė;GUDRUČIŲ;2137489054;Taip;0;5;1;6
6407;Pasagėlė;GUDRUČIŲ;1040850911;Taip;0;0;4;4
6408;Pasagėlė;GUDRUČIŲ;1215400980;Ne;0;2;1;3
6409;Pasagėlė;GUDRUČIŲ;1054424694;Taip;0;1;0;1
6410;Pasagėlė;GUDRUČIŲ;6011034443;Taip;0;0;5;5
6411;Pasagėlė;GUDRUČIŲ;1511098546;Taip;5;6;0;11
6412;Pasagėlė;GUDRUČIŲ;54694832614;Taip;0;0;2;2
6413;Pasagėlė;GUDRUČIŲ;2023002624;Taip;0;0;4;4
6414;Pasagėlė;GUDRUČIŲ;8428101374;Taip;0;0;4;4
6415;Pasagėlė;GUDRUČIŲ;60492768809;Taip;0;0;1;1
6416;Pasagėlė;GUDRUČIŲ;64636489181;Taip;0;3;1;4
6417;Pasagėlė;GUDRUČIŲ;69892632522;Taip;4;0;0;4
6418;Pasagėlė;PABIRUČIŲ;1113026818;Taip;1;0;0;1
6419;Pasagėlė;PABIRUČIŲ;8301938009;Ne;2;0;0;2
6420;Pasagėlė;PABIRUČIŲ;16591459661;Ne;2;0;0;2
6421;Pasagėlė;PABIRUČIŲ;20999997254;Taip;0;18;0;18
6422;Pasagėlė;PABIRUČIŲ;4668155071;Taip;0;0;1;1
6423;Pasagėlė;PABIRUČIŲ;9388057389;Taip;0;0;4;4
6424;Pasagėlė;PABIRUČIŲ;20743334216;Ne;6;0;0;6
6425;Pasagėlė;PABIRUČIŲ;1371753067;Ne;2;0;1;3
6426;Pasagėlė;PABIRUČIŲ;9801268758;Ne;3;0;1;4
6427;Pasagėlė;PABIRUČIŲ;3583848327;Taip;8;5;0;13
6428;Pasagėlė;PABIRUČIŲ;5040657332;Taip;0;3;0;3
6429;Pasagėlė;PABIRUČIŲ;3924127476;Taip;2;0;0;2
6430;Pasagėlė;PABIRUČIŲ;2769668641;Ne;11;0;0;11
6431;Pasagėlė;PABIRUČIŲ;4261133734;Taip;2;0;0;2
6432;Pasagėlė;PABIRUČIŲ;3576157355;Taip;14;0;0;14
6433;Pasagėlė;PABIRUČIŲ;6429160371;Taip;8;0;0;8
6434;Pasagėlė;PABIRUČIŲ;2717225575;Taip;6;0;0;6
6435;Pasaka;Drugelių;94297031036;Taip;15;0;0;15
6436;Pasaka;Drugelių;13636850029;Taip;7;1;4;12
6437;Pasaka;Drugelių;6029722606;Taip;0;1;1;2
6438;Pasaka;Drugelių;28436567147;Taip;0;1;6;7
6439;Pasaka;Drugelių;23870813014;Taip;0;0;1;1
6440;Pasaka;Drugelių;12737037014;Taip;0;0;3;3
6441;Pasaka;Drugelių;65838651894;Taip;0;0;3;3
6442;Pasaka;Drugelių;93787399452;Taip;0;1;0;1
6443;Pasaka;Drugelių;35974582480;Taip;0;1;0;1
6444;Pasaka;Drugelių;27093500070;Taip;0;5;0;5
6445;Pasaka;Drugelių;33026273567;Taip;3;1;2;6
6446;Pasaka;Drugelių;28874215183;Taip;0;1;1;2
6447;Pasaka;Drugelių;70534119238;Taip;8;0;0;8
6448;Pasaka;Drugelių;63580854012;Taip;12;0;0;12
6449;Pasaka;Nykštukų;71026394541;Taip;3;0;0;3
6450;Pasaka;Nykštukų;93130495054;Taip;0;0;2;2
6451;Pasaka;Nykštukų;57075224058;Taip;0;2;1;3
6452;Pasaka;Nykštukų;2063660647;Taip;0;2;3;5
6453;Pasaka;Nykštukų;18135410695;Taip;0;2;2;4
6454;Pasaka;Nykštukų;37149227316;Taip;0;2;0;2
6455;Pasaka;Nykštukų;1386420328;Taip;0;0;6;6
6456;Pasaka;Nykštukų;27770796692;Taip;0;1;0;1
6457;Pasaka;Nykštukų;5459272292;Taip;13;2;0;15
6458;Pasaka;Nykštukų;5665758011;Ne;5;6;0;11
6459;Pasaka;Nykštukų;1237568934;Taip;0;2;0;2
6460;Pasaka;Nykštukų;91546084785;Taip;0;2;3;5
6461;Pasaka;Nykštukų;7040953491;Taip;10;0;0;10
6462;Pasaka;Nykštukų;1333499160;Taip;0;6;0;6
6463;Pasaka;Nykštukų;3088081091;Taip;4;2;0;6
6464;Pasaka;Montesori;4130774501;Taip;0;0;1;1
6465;Pasaka;Montesori;67492634520;Taip;10;11;0;21
6466;Pasaka;Montesori;56974315820;Taip;0;0;1;1
6467;Pasaka;Montesori;50242777961;Taip;0;0;3;3
6468;Pasaka;Montesori;88392698583;Taip;6;0;0;6
6469;Pasaka;Montesori;49914586879;Taip;5;0;0;5
6470;Pasaka;Montesori;17561742498;Taip;5;0;0;5
6471;Pasaka;Montesori;47000824102;Taip;5;2;0;7
6472;Pasaka;Montesori;1450566193;Taip;5;0;0;5
6473;Pasaka;Montesori;31880975983;Taip;0;0;4;4
6474;Pasaka;Montesori;90472847444;Taip;5;0;0;5
6475;Pasaka;Montesori;17311912868;Taip;3;0;0;3
6476;Pasaka;Montesori;69250064506;Taip;0;0;1;1
6477;Pasaka;Montesori;81598865451;Taip;10;0;0;10
6478;Pasaka;Montesori;1564467627;Taip;0;0;5;5
6479;Pasaka;Montesori;7016077429;Taip;5;0;0;5
6480;Pasaka;Montesori;39319539842;Taip;10;11;0;21
6481;Pasaka;Montesori;16974081144;Taip;0;0;2;2
6482;Pasaka;Montesori;1514381003;Taip;8;0;0;8
6483;Pasaka;Montesori;93994995081;Taip;0;0;7;7
6484;Pasaka;Montesori;5812041166;Taip;0;8;0;8
6485;Pasaka;Montesori;4305485747;Taip;5;0;3;8
6486;Pasaka;Žirniukų;17931259433;Ne;0;0;1;1
6487;Pasaka;Žirniukų;9722435751;Taip;2;2;0;4
6488;Pasaka;Žirniukų;7648503006;Taip;8;0;4;12
6489;Pasaka;Žirniukų;73703706115;Taip;22;0;0;22
6490;Pasaka;Žirniukų;2018620389;Taip;5;2;0;7
6491;Pasaka;Žirniukų;6441884677;Taip;0;2;0;2
6492;Pasaka;Žirniukų;5651452381;Taip;0;2;0;2
6493;Pasaka;Žirniukų;1720511696;Taip;3;0;0;3
6494;Pasaka;Žirniukų;1826743229;Taip;5;1;1;7
6495;Pasaka;Žirniukų;9560190761;Taip;5;1;1;7
6496;Pasaka;Žirniukų;7286419663;Taip;5;0;0;5
6497;Pasaka;Žirniukų;2788679885;Taip;9;3;0;12
6498;Pasaka;Žirniukų;6378803142;Taip;12;0;0;12
6499;Pasaka;Žirniukų;7441310161;Taip;12;0;0;12
6500;Pasaka;Žirniukų;1565873178;Ne;11;0;1;12
6501;Pasaka;Žirniukų;2400455036;Taip;6;1;0;7
6502;Pasaka;Žirniukų;79170702319;Taip;18;0;1;19
6503;Pasaka;"Voveriukų ";15051078156;Taip;0;1;0;1
6504;Pasaka;"Voveriukų ";50319234551;Taip;6;0;2;8
6505;Pasaka;"Voveriukų ";15500820772;Taip;12;0;0;12
6506;Pasaka;"Voveriukų ";12951124853;Taip;6;0;0;6
6507;Pasaka;"Voveriukų ";53523660848;Taip;0;2;1;3
6508;Pasaka;"Voveriukų ";89376142045;Taip;6;1;2;9
6509;Pasaka;"Voveriukų ";52135673503;Taip;0;0;4;4
6510;Pasaka;"Voveriukų ";59491538033;Taip;12;0;0;12
6511;Pasaka;"Voveriukų ";20358771509;Taip;0;4;0;4
6512;Pasaka;"Voveriukų ";94514447596;Taip;12;0;0;12
6513;Pasaka;"Voveriukų ";71316589358;Taip;0;1;0;1
6514;Pasaka;"Voveriukų ";61091610394;Taip;10;0;1;11
6515;Pasaka;"Voveriukų ";8122815158;Taip;0;0;9;9
6516;Pasaka;"Voveriukų ";1719236931;Taip;7;0;0;7
6517;Pasaka;"Voveriukų ";1268530885;Taip;0;1;3;4
6518;Pasaka;"VALDOFRO 12";7865658875;Taip;5;1;0;6
6519;Pasaka;"VALDOFRO 12";2141354232;Taip;0;2;3;5
6520;Pasaka;"VALDOFRO 12";4271029223;Taip;0;3;1;4
6521;Pasaka;"VALDOFRO 12";49627576872;Taip;4;0;0;4
6522;Pasaka;"VALDOFRO 12";75591036061;Taip;0;0;2;2
6523;Pasaka;"VALDOFRO 12";8042135600;Taip;0;4;0;4
6524;Pasaka;"VALDOFRO 12";20521208273;Taip;0;0;1;1
6525;Pasaka;"VALDOFRO 12";73057603223;Taip;3;2;1;6
6526;Pasaka;"VALDOFRO 12";95288167171;Taip;5;0;0;5
6527;Pasaka;"VALDOFRO 12";72287065055;Ne;0;17;0;17
6528;Pasaka;"VALDOFRO 12";77282670444;Taip;0;6;2;8
6529;Pasaka;"VALDOFRO 12";22557231904;Taip;0;2;0;2
6530;Pasaka;"VALDOFRO 12";3367120837;Taip;0;0;4;4
6531;Pasaka;"VALDOFRO 12";7010681103;Taip;0;7;0;7
6532;Pasaka;"VALDOFRO 12";1155273197;Taip;0;10;0;10
6533;Pasaka;"VALDOFRO 12";56766427323;Taip;2;0;0;2
6534;Pasaka;"VALDOFRO 12";5141156728;Taip;0;6;1;7
6535;Pasaka;"VALDORFO 2";34612155918;Taip;0;0;2;2
6536;Pasaka;"VALDORFO 2";48295303497;Taip;0;0;4;4
6537;Pasaka;"VALDORFO 2";1397972532;Ne;0;0;3;3
6538;Pasaka;"VALDORFO 2";27035873367;Ne;0;0;3;3
6539;Pasaka;"VALDORFO 2";27496232796;Ne;0;0;5;5
6540;Pasaka;"VALDORFO 2";95494862542;Taip;0;0;2;2
6541;Pasaka;"VALDORFO 2";25283698668;Taip;0;4;1;5
6542;Pasaka;"VALDORFO 2";42294285713;Taip;0;0;1;1
6543;Pasaka;"VALDORFO 2";50030735612;Taip;0;0;4;4
6544;Pasaka;"VALDORFO 2";80814715752;Taip;0;1;1;2
6545;Pasaka;"VALDORFO 2";61077353229;Taip;0;3;2;5
6546;Pasaka;"VALDORFO 2";2077818693;Taip;0;0;2;2
6547;Pasaka;"VALDORFO 2";71365777764;Taip;4;0;0;4
6548;Pasaka;"VALDORFO 2";1741935840;Taip;6;0;3;9
6549;Pasaka;"VALDORFO 2";77904202630;Taip;4;0;0;4
6550;Pasaka;"VALDORFO 2";7432241898;Taip;0;0;4;4
6551;Pasaka;"VALDORFO 2";8590385693;Taip;0;0;4;4
6552;Pasaka;Gudručiai;39815814046;Taip;0;9;0;9
6553;Pasaka;Gudručiai;92877021972;Taip;0;1;0;1
6554;Pasaka;Gudručiai;81610725511;Taip;5;0;0;5
6555;Pasaka;Gudručiai;48750144608;Taip;6;0;0;6
6556;Pasaka;Gudručiai;30111718221;Taip;0;0;10;10
6557;Pasaka;Gudručiai;49342277188;Ne;5;1;0;6
6558;Pasaka;Gudručiai;36316289275;Taip;5;0;0;5
6559;Pasaka;Gudručiai;55650091777;Taip;0;2;1;3
6560;Pasaka;Gudručiai;74752546806;Taip;0;0;5;5
6561;Pasaka;Gudručiai;21863319299;Taip;12;0;0;12
6562;Pasaka;Gudručiai;15867940757;Taip;0;5;0;5
6563;Pasaka;Gudručiai;91855873214;Taip;0;2;3;5
6564;Pasaka;Gudručiai;35413730712;Ne;0;6;0;6
6565;Pasaka;Gudručiai;19883430399;Taip;0;0;3;3
6566;Pasaka;Gudručiai;1117608861;Taip;0;0;4;4
6567;Pasaka;Bitelių;8821776109;Taip;5;0;2;7
6568;Pasaka;Bitelių;45184972933;Taip;0;1;0;1
6569;Pasaka;Bitelių;29836649248;Taip;6;0;0;6
6570;Pasaka;Bitelių;76560015870;Ne;0;0;1;1
6571;Pasaka;Bitelių;78517147252;Taip;5;5;1;11
6572;Pasaka;Bitelių;45850914548;Ne;1;1;0;2
6573;Pasaka;Bitelių;55254934245;Taip;0;0;1;1
6574;Pasaka;Bitelių;4895994309;Taip;0;3;0;3
6575;Pasaka;Bitelių;64143651711;Ne;0;12;0;12
6576;Pasaka;Bitelių;62051806386;Taip;0;2;1;3
6577;Pasaka;Bitelių;80567536745;Ne;2;5;0;7
6578;Pasaka;Bitelių;53151161817;Taip;0;1;0;1
6579;Pasaka;Bitelių;97012371435;Ne;1;1;0;2
6580;Pasaka;Bitelių;40182594961;Taip;0;0;1;1
6581;Pasaka;Bitelių;14080980324;Taip;5;10;0;15
6582;Pasaka;Bitelių;17537343699;Taip;8;2;2;12
6583;Pasaka;Bitelių;72878659455;Taip;0;7;0;7
6584;Pasaka;Bitelių;91499940063;Taip;0;1;0;1
6585;Pasaka;"Pabiručių ";6868519179;Taip;12;0;1;13
6586;Pasaka;"Pabiručių ";6759415053;Taip;7;0;1;8
6587;Pasaka;"Pabiručių ";5351364328;Taip;12;0;0;12
6588;Pasaka;"Pabiručių ";4635912654;Taip;12;0;0;12
6589;Pasaka;"Pabiručių ";8132829016;Taip;8;0;1;9
6590;Pasaka;"Pabiručių ";8651165520;Taip;8;0;1;9
6591;Pasaka;"Pabiručių ";5371046207;Taip;0;0;4;4
6592;Pasaka;"Pabiručių ";4137222204;Taip;17;0;0;17
6593;Pasaka;"Pabiručių ";3047931231;Taip;7;0;5;12
6594;Pasaka;"Pabiručių ";7103485358;Taip;8;0;0;8
6595;Pasaka;"Pabiručių ";7248640367;Taip;4;0;1;5
6596;Pasaka;"Pabiručių ";8277245475;Taip;5;0;1;6
6597;Pasaka;"Pabiručių ";5723970763;Taip;22;0;0;22
6598;Pasaka;"Pabiručių ";9136521759;Taip;0;0;1;1
6599;Pasaka;"Pabiručių ";8119086492;Taip;4;0;2;6
6600;Pasaka;Šnekučių;31896116591;Taip;2;5;0;7
6601;Pasaka;Šnekučių;49626651411;Taip;12;0;2;14
6602;Pasaka;Šnekučių;9549799936;Taip;0;10;2;12
6603;Pasaka;Šnekučių;34897359060;Taip;7;0;1;8
6604;Pasaka;Šnekučių;52912333520;Taip;0;6;1;7
6605;Pasaka;Šnekučių;9973758979;Taip;0;0;1;1
6606;Pasaka;Šnekučių;1693530160;Taip;0;0;1;1
6607;Pasaka;Šnekučių;62303770229;Taip;3;0;1;4
6608;Pasaka;Šnekučių;23132755276;Taip;0;0;1;1
6609;Pasaka;Šnekučių;7082166681;Taip;0;4;0;4
6610;Pasaka;Šnekučių;8615661704;Ne;0;3;0;3
6611;Pasaka;Šnekučių;4178679491;Ne;0;3;0;3
6612;Pasaka;Šnekučių;56983167265;Taip;0;0;7;7
6613;Pasaka;Šnekučių;50456063454;Taip;0;0;2;2
6614;Pasaka;Šnekučių;10055061537;Taip;0;4;7;11
6615;Pasaka;Šnekučių;51500606207;Taip;2;1;0;3
6616;Paslaptis;Priešmokyklinė;62476103195;Taip;0;13;0;13
6617;Paslaptis;Priešmokyklinė;8052295537;Taip;0;1;5;6
6618;Paslaptis;Priešmokyklinė;9611990012;Taip;0;1;0;1
6619;Paslaptis;Priešmokyklinė;50274794824;Taip;8;0;3;11
6620;Paslaptis;Priešmokyklinė;26977991466;Taip;0;1;1;2
6621;Paslaptis;Priešmokyklinė;61247199871;Taip;0;10;2;12
6622;Paslaptis;Priešmokyklinė;16224875313;Taip;14;0;1;15
6623;Paslaptis;Priešmokyklinė;68726419200;Taip;0;1;7;8
6624;Paslaptis;Priešmokyklinė;60268283772;Taip;0;1;3;4
6625;Paslaptis;Priešmokyklinė;1828914082;Ne;0;5;7;12
6626;Paslaptis;Priešmokyklinė;1259942408;Taip;0;5;3;8
6627;Paslaptis;Priešmokyklinė;1667818122;Taip;0;12;0;12
6628;Paslaptis;Priešmokyklinė;1128775055;Taip;14;0;4;18
6629;Paslaptis;Priešmokyklinė;36229769543;Taip;0;1;1;2
6630;Paslaptis;Priešmokyklinė;87862241593;Taip;22;0;0;22
6631;Paslaptis;Priešmokyklinė;1677007836;Taip;0;1;2;3
6632;Paslaptis;Priešmokyklinė;1982955007;Ne;0;1;0;1
6633;Paslaptis;Priešmokyklinė;99228588629;Taip;0;1;1;2
6634;Paslaptis;Priešmokyklinė;57773958059;Taip;0;0;7;7
6635;Paslaptis;Priešmokyklinė;73547132372;Ne;0;1;2;3
6636;Paslaptis;Priešmokyklinė;69704103686;Taip;10;0;2;12
6637;Paslaptis;Priešmokyklinė;18629473292;Taip;1;0;6;7
6638;Paslaptis;Priešmokyklinė;1445974659;Taip;0;1;0;1
6639;Paslaptis;Priešmokyklinė;2578713065;Ne;0;10;3;13
6640;Paslaptis;"Darželio mišraus amžiaus grupė";1094068061;Taip;0;1;0;1
6641;Paslaptis;"Darželio mišraus amžiaus grupė";8522925854;Taip;0;12;0;12
6642;Paslaptis;"Darželio mišraus amžiaus grupė";1868248793;Taip;0;10;0;10
6643;Paslaptis;"Darželio mišraus amžiaus grupė";1950287365;Taip;12;0;2;14
6644;Paslaptis;"Darželio mišraus amžiaus grupė";1530380043;Taip;0;1;0;1
6645;Paslaptis;"Darželio mišraus amžiaus grupė";1938288335;Taip;8;1;0;9
6646;Paslaptis;"Darželio mišraus amžiaus grupė";1127602652;Taip;0;1;0;1
6647;Paslaptis;"Darželio mišraus amžiaus grupė";40283689721;Taip;0;13;0;13
6648;Paslaptis;"Darželio mišraus amžiaus grupė";4731417201;Taip;10;1;1;12
6649;Paslaptis;"Darželio mišraus amžiaus grupė";3461773781;Taip;0;7;0;7
6650;Paslaptis;"Darželio mišraus amžiaus grupė";5790420711;Taip;0;3;0;3
6651;Paslaptis;"Darželio mišraus amžiaus grupė";1195616749;Taip;12;1;0;13
6652;Paslaptis;"Darželio mišraus amžiaus grupė";4674623065;Taip;0;1;0;1
6653;Paslaptis;"Darželio mišraus amžiaus grupė";6375966771;Taip;0;12;0;12
6654;Paslaptis;"Darželio mišraus amžiaus grupė";2474900044;Taip;4;0;0;4
6655;Paslaptis;"Darželio mišraus amžiaus grupė";3170216428;Taip;0;1;0;1
6656;Paslaptis;"Darželio mišraus amžiaus grupė";9559318660;Taip;10;1;0;11
6657;Paslaptis;"Darželio mišraus amžiaus grupė";8280740387;Taip;10;0;3;13
6658;Paslaptis;"Darželio mišraus amžiaus grupė";2891547963;Taip;5;0;0;5
6659;Paslaptis;"Darželio mišraus amžiaus grupė";3415869190;Taip;1;1;2;4
6660;Paslaptis;"Darželio mišraus amžiaus grupė";1983773762;Taip;10;1;0;11
6661;Paslaptis;"Darželio mišraus amžiaus grupė";5557019619;Taip;10;0;0;10
6662;Paslaptis;"Darželio mišraus amžiaus grupė";1782398974;Taip;0;1;0;1
6663;Paslaptis;"Darželio mišraus amžiaus grupė";4109288950;Taip;8;0;0;8
6664;Paslaptis;"Darželio mišraus amžiaus grupė";8083478190;Taip;0;0;1;1
6665;Paslaptis;"Darželio mišraus amžiaus grupė";2089780119;Taip;0;13;0;13
6666;Paslaptis;"NAUJA (LOPŠELIS)";2879752620;Taip;4;1;1;6
6667;Paslaptis;"NAUJA (LOPŠELIS)";2693910134;Taip;0;1;0;1
6668;Paslaptis;"NAUJA (LOPŠELIS)";8239855620;Taip;7;0;0;7
6669;Paslaptis;"NAUJA (LOPŠELIS)";1033910097;Taip;0;0;1;1
6670;Paslaptis;"NAUJA (LOPŠELIS)";5206529350;Taip;3;3;0;6
6671;Paslaptis;"NAUJA (LOPŠELIS)";5456011928;Taip;0;5;0;5
6672;Paslaptis;"NAUJA (LOPŠELIS)";8895770223;Ne;6;0;0;6
6673;Paslaptis;"NAUJA (LOPŠELIS)";5756338103;Taip;6;0;0;6
6674;Paslaptis;"NAUJA (LOPŠELIS)";6131831325;Taip;15;1;1;17
6675;Paslaptis;"NAUJA (LOPŠELIS)";5886364670;Taip;4;0;1;5
6676;Paslaptis;"NAUJA (LOPŠELIS)";7579781779;Taip;15;0;0;15
6677;Paslaptis;"NAUJA (LOPŠELIS)";3844066232;Taip;0;6;0;6
6678;Paslaptis;"NAUJA (LOPŠELIS)";3104525540;Taip;14;0;0;14
6679;Paslaptis;"NAUJA (LOPŠELIS)";8146824196;Taip;5;0;1;6
6680;Paslaptis;"NAUJA (LOPŠELIS)";3398729758;Taip;12;0;0;12
6681;Paslaptis;"NAUJA (LOPŠELIS)";2675089401;Taip;8;0;0;8
6682;Pasakaitė;Vieversėlių;70802215290;Taip;0;16;0;16
6683;Pasakaitė;Vieversėlių;82272856075;Taip;0;1;0;1
6684;Pasakaitė;Vieversėlių;23103636206;Taip;0;6;0;6
6685;Pasakaitė;Vieversėlių;48421643700;Taip;0;4;0;4
6686;Pasakaitė;Vieversėlių;94906317709;Taip;5;0;0;5
6687;Pasakaitė;Vieversėlių;725988513;Taip;9;0;0;9
6688;Pasakaitė;Vieversėlių;62372417041;Taip;4;5;0;9
6689;Pasakaitė;Vieversėlių;91751201397;Taip;0;0;3;3
6690;Pasakaitė;Vieversėlių;1631919806;Ne;1;0;5;6
6691;Pasakaitė;Vieversėlių;1696228992;Ne;1;0;5;6
6692;Pasakaitė;Vieversėlių;47661428412;Taip;0;12;0;12
6693;Pasakaitė;Vieversėlių;18419655194;Taip;0;2;0;2
6694;Pasakaitė;Vieversėlių;91109909258;Taip;0;13;0;13
6695;Pasakaitė;Vieversėlių;1917342472;Ne;4;0;0;4
6696;Pasakaitė;Vieversėlių;39926553926;Taip;11;9;0;20
6697;Pasakaitė;Vieversėlių;1139554564;Taip;0;18;0;18
6698;Pasakaitė;Spindulėlių;72232008007;Taip;0;0;2;2
6699;Pasakaitė;Spindulėlių;20667371334;Taip;0;21;0;21
6700;Pasakaitė;Spindulėlių;21284070194;Taip;0;1;0;1
6701;Pasakaitė;Spindulėlių;13787417933;Taip;7;0;0;7
6702;Pasakaitė;Spindulėlių;88951595986;Ne;0;0;1;1
6703;Pasakaitė;Spindulėlių;45451715428;Taip;0;2;0;2
6704;Pasakaitė;Spindulėlių;1381307997;Taip;0;13;0;13
6705;Pasakaitė;Spindulėlių;8638071584;Ne;4;10;0;14
6706;Pasakaitė;Spindulėlių;75361056418;Taip;0;5;0;5
6707;Pasakaitė;Spindulėlių;4680949976;Taip;14;1;0;15
6708;Pasakaitė;Spindulėlių;3734935229;Taip;6;13;0;19
6709;Pasakaitė;Spindulėlių;2523842161;Taip;2;0;2;4
6710;Pasakaitė;Spindulėlių;4267488049;Taip;0;12;0;12
6711;Pasakaitė;Spindulėlių;1523034176;Taip;0;2;0;2
6712;Pasakaitė;Spindulėlių;7152349570;Taip;0;14;0;14
6713;Pasakaitė;Pasagėlių;3165658822;Taip;0;18;0;18
6714;Pasakaitė;Pasagėlių;61230317080;Ne;0;3;0;3
6715;Pasakaitė;Pasagėlių;1740419218;Taip;0;18;0;18
6716;Pasakaitė;Pasagėlių;5378855541;Taip;2;6;0;8
6717;Pasakaitė;Pasagėlių;9680682204;Taip;6;0;0;6
6718;Pasakaitė;Pasagėlių;4703375416;Taip;0;5;0;5
6719;Pasakaitė;Pasagėlių;1019010454;Taip;15;1;0;16
6720;Pasakaitė;Pasagėlių;4959175420;Taip;0;3;0;3
6721;Pasakaitė;Pasagėlių;1144813356;Taip;1;0;0;1
6722;Pasakaitė;Pasagėlių;83018133588;Taip;0;0;1;1
6723;Pasakaitė;Pasagėlių;4013900094;Taip;10;0;0;10
6724;Pasakaitė;Pasagėlių;5467179333;Taip;10;7;0;17
6725;Pasakaitė;Švyturėlių;26826144324;Taip;0;0;5;5
6726;Pasakaitė;Švyturėlių;26485770641;Taip;0;0;5;5
6727;Pasakaitė;Švyturėlių;30460033968;Taip;6;2;0;8
6728;Pasakaitė;Švyturėlių;39762990812;Taip;0;5;1;6
6729;Pasakaitė;Švyturėlių;24235494284;Taip;0;0;2;2
6730;Pasakaitė;Švyturėlių;74338375162;Taip;0;0;1;1
6731;Pasakaitė;Švyturėlių;56474981516;Taip;0;0;5;5
6732;Pasakaitė;Švyturėlių;24096031951;Taip;8;0;0;8
6733;Pasakaitė;Švyturėlių;11001677712;Taip;0;0;14;14
6734;Pasakaitė;Švyturėlių;9914689534;Taip;4;0;2;6
6735;Pasakaitė;Švyturėlių;75785125455;Taip;8;0;0;8
6736;Pasakaitė;Švyturėlių;88077831193;Taip;11;0;0;11
6737;Pasakaitė;Švyturėlių;8225188274;Taip;0;6;0;6
6738;Pasakaitė;Švyturėlių;73957497029;Taip;0;5;0;5
6739;Pasakaitė;Švyturėlių;1070409611;Taip;15;0;6;21
6740;Pasakaitė;Švyturėlių;1159523006;Taip;12;0;2;14
6741;Pasakaitė;Švyturėlių;5436985035;Taip;0;9;0;9
6742;Pasakaitė;Švyturėlių;1627102470;Taip;0;0;4;4
6743;Pasakaitė;Švyturėlių;4008826950;Taip;12;8;1;21
6744;Pasakaitė;Švyturėlių;32235101944;Taip;0;0;5;5
6745;Pasakaitė;Kodėlčiukų;82138492327;Taip;5;0;0;5
6746;Pasakaitė;Kodėlčiukų;94317654094;Taip;0;0;1;1
6747;Pasakaitė;Kodėlčiukų;11006810461;Taip;12;5;0;17
6748;Pasakaitė;Kodėlčiukų;1553678838;Taip;10;0;2;12
6749;Pasakaitė;Kodėlčiukų;92762645558;Taip;0;0;2;2
6750;Pasakaitė;Kodėlčiukų;22071058323;Taip;12;10;0;22
6751;Pasakaitė;Kodėlčiukų;93907096625;Taip;10;0;1;11
6752;Pasakaitė;Kodėlčiukų;9746401498;Ne;2;0;6;8
6753;Pasakaitė;Kodėlčiukų;6839399035;Ne;7;0;1;8
6754;Pasakaitė;Kodėlčiukų;99352468512;Taip;6;0;0;6
6755;Pasakaitė;Kodėlčiukų;1809383469;Taip;6;0;0;6
6756;Pasakaitė;Kodėlčiukų;2742595829;Taip;5;0;7;12
6757;Pasakaitė;Kodėlčiukų;6983619733;Taip;3;0;0;3
6758;Pasakaitė;Kodėlčiukų;5313360864;Taip;10;0;0;10
6759;Pasakaitė;Kodėlčiukų;9506178305;Taip;10;0;1;11
6760;Pasakaitė;Gudručių;85389647155;Taip;0;5;0;5
6761;Pasakaitė;Gudručių;89807086522;Taip;0;1;2;3
6762;Pasakaitė;Gudručių;25228014112;Taip;0;0;9;9
6763;Pasakaitė;Gudručių;61088864114;Taip;5;0;2;7
6764;Pasakaitė;Gudručių;31076632547;Taip;2;6;0;8
6765;Pasakaitė;Gudručių;29112724120;Taip;0;0;2;2
6766;Pasakaitė;Gudručių;1175881877;Taip;5;5;2;12
6767;Pasakaitė;Gudručių;96876687235;Taip;0;0;8;8
6768;Pasakaitė;Gudručių;76810884215;Taip;0;0;2;2
6769;Pasakaitė;Gudručių;44876121501;Taip;10;0;2;12
6770;Pasakaitė;Gudručių;28194608955;Taip;0;2;0;2
6771;Pasakaitė;Gudručių;68762624079;Ne;0;0;5;5
6772;Pasakaitė;Gudručių;62505201993;Taip;0;0;2;2
6773;Pasakaitė;Gudručių;64811535115;Taip;5;0;4;9
6774;Pasakaitė;Gudručių;13548717757;Taip;0;0;1;1
6775;Pasakaitė;Gudručių;80929303402;Ne;0;3;0;3
6776;Pasakaitė;Gudručių;31971771240;Taip;0;4;0;4
6777;Pasakaitė;Gudručių;81509638417;Ne;0;0;7;7
6778;Pasakaitė;Gudručių;2031899743;Taip;0;0;4;4
6779;Pasakaitė;Čiulbonėlių;18107086294;Taip;0;12;0;12
6780;Pasakaitė;Čiulbonėlių;5414310905;Taip;0;0;2;2
6781;Pasakaitė;Čiulbonėlių;52612577074;Taip;12;6;4;22
6782;Pasakaitė;Čiulbonėlių;55594674308;Taip;0;0;1;1
6783;Pasakaitė;Čiulbonėlių;4889157048;Taip;0;0;4;4
6784;Pasakaitė;Čiulbonėlių;6035279095;Taip;0;0;3;3
6785;Pasakaitė;Čiulbonėlių;1304294521;Taip;0;3;0;3
6786;Pasakaitė;Čiulbonėlių;1827896757;Taip;0;0;3;3
6787;Pasakaitė;Čiulbonėlių;61297377425;Ne;0;22;0;22
6788;Pasakaitė;Čiulbonėlių;20868624857;Taip;3;11;0;14
6789;Pasakaitė;Čiulbonėlių;90096913388;Taip;0;16;0;16
6790;Pasakaitė;Čiulbonėlių;26218072375;Taip;0;4;0;4
6791;Pasakaitė;Čiulbonėlių;98801528286;Taip;7;0;0;7
6792;Pasakaitė;Čiulbonėlių;1135448504;Taip;0;0;14;14
6793;Pasakaitė;"Verpstelių ";12092268542;Taip;0;5;0;5
6794;Pasakaitė;"Verpstelių ";600641021;Taip;5;8;0;13
6795;Pasakaitė;"Verpstelių ";1407277414;Taip;0;0;1;1
6796;Pasakaitė;"Verpstelių ";17218793370;Taip;15;4;0;19
6797;Pasakaitė;"Verpstelių ";46873849992;Taip;0;4;0;4
6798;Pasakaitė;"Verpstelių ";96648719544;Taip;0;6;0;6
6799;Pasakaitė;"Verpstelių ";82475369612;Taip;0;4;0;4
6800;Pasakaitė;"Verpstelių ";88885227604;Taip;0;9;0;9
6801;Pasakaitė;"Verpstelių ";1270179754;Taip;2;0;0;2
6802;Pasakaitė;"Verpstelių ";2210519019;Taip;0;0;4;4
6803;Pasakaitė;"Verpstelių ";18105216772;Taip;0;2;0;2
6804;Pasakaitė;"Verpstelių ";50537059387;Taip;0;0;1;1
6805;Pasakaitė;"Verpstelių ";29699532850;Taip;6;8;6;20
6806;Pasakaitė;"Verpstelių ";46074425530;Taip;4;0;0;4
6807;Pasakaitė;"Verpstelių ";45157801238;Taip;0;1;0;1
6808;Pasakaitė;Smalsučiai;7685647972;Taip;0;5;0;5
6809;Pasakaitė;Smalsučiai;7020773169;Taip;13;0;8;21
6810;Pasakaitė;Smalsučiai;5948958906;Taip;0;5;0;5
6811;Pasakaitė;Smalsučiai;3231283338;Taip;0;1;2;3
6812;Pasakaitė;Smalsučiai;5455278072;Taip;11;2;0;13
6813;Pasakaitė;Smalsučiai;9543991684;Taip;9;3;0;12
6814;Pasakaitė;Smalsučiai;3778906698;Taip;0;2;0;2
6815;Pasakaitė;Smalsučiai;3541877287;Taip;13;0;8;21
6816;Pasakaitė;Smalsučiai;4882856664;Taip;0;4;1;5
6817;Pasakaitė;Smalsučiai;3579498202;Taip;5;1;0;6
6818;Pasakaitė;Smalsučiai;1060914693;Taip;5;0;0;5
6819;Pasakaitė;"Čiauškučiai ";3606601644;Taip;9;0;0;9
6820;Pasakaitė;"Čiauškučiai ";6714500298;Taip;0;7;0;7
6821;Pasakaitė;"Čiauškučiai ";8578521969;Taip;10;0;0;10
6822;Pasakaitė;"Čiauškučiai ";7526264241;Taip;0;0;1;1
6823;Pasakaitė;"Čiauškučiai ";8390366303;Ne;0;0;2;2
6824;Pasakaitė;"Čiauškučiai ";2751828639;Taip;6;0;0;6
6825;Pasakaitė;"Čiauškučiai ";8463220257;Taip;5;0;3;8
6826;Pasakaitė;"Čiauškučiai ";7761162338;Taip;4;2;0;6
6827;Pasakaitė;"Čiauškučiai ";8223662339;Taip;9;0;1;10
6828;Pasakaitė;"Čiauškučiai ";9018830962;Taip;15;0;0;15
6829;Pasakaitė;"Čiauškučiai ";7790937149;Taip;5;0;0;5
6830;Pasakaitė;"Čiauškučiai ";3400305768;Taip;5;0;0;5
6831;Pasakaitė;"Čiauškučiai ";8469043564;Taip;10;0;0;10
6832;Pasakaitė;Pabiručiai;1827070201;Taip;4;0;4;8
6833;Pasakaitė;Pabiručiai;1879865535;Taip;7;0;3;10
6834;Pasakaitė;Pabiručiai;9175612991;Taip;7;0;1;8
6835;Pasakaitė;Pabiručiai;26714845001;Taip;10;0;6;16
6836;Pasakaitė;Pabiručiai;46891856500;Taip;6;2;0;8
6837;Pasakaitė;Pabiručiai;3397132786;Ne;0;7;0;7
6838;Pasakaitė;Pabiručiai;1769070351;Taip;0;5;0;5
6839;Pasakaitė;Pabiručiai;49117693773;Taip;9;0;0;9
6840;Pasakaitė;Pabiručiai;1320898756;Taip;5;0;17;22
6841;Pasakaitė;Pabiručiai;1027136050;Taip;0;0;1;1
6842;Pasakaitė;Pabiručiai;1198248619;Taip;0;6;0;6
6843;Pasakaitė;Pabiručiai;1595057434;Taip;5;7;1;13
6844;Pasakaitė;Pabiručiai;1032113089;Ne;0;9;0;9
6845;Pasakaitė;Pabiručiai;21252086256;Taip;0;5;4;9
6846;Pasakaitė;Pabiručiai;6134483994;Taip;0;8;0;8
6847;Pasakaitė;Pabiručiai;1673576868;Taip;0;13;0;13
6848;Pasakaitė;Pabiručiai;2017275984;Taip;0;0;1;1
6849;Pasakaitė;Pabiručiai;27702516199;Taip;0;0;4;4
6850;Pasakaitė;Pabiručiai;6346678827;Ne;0;0;6;6
6851;Pelenė;Varpelis;69242277342;Taip;0;1;0;1
6852;Pelenė;Varpelis;59921559091;Taip;5;0;0;5
6853;Pelenė;Varpelis;62426432001;Taip;0;0;7;7
6854;Pelenė;Varpelis;2029929226;Taip;0;1;0;1
6855;Pelenė;Varpelis;8311474428;Taip;0;7;0;7
6856;Pelenė;Varpelis;8189960936;Taip;2;0;2;4
6857;Pelenė;Varpelis;37922275946;Taip;0;11;0;11
6858;Pelenė;Varpelis;62172213063;Taip;0;7;0;7
6859;Pelenė;Varpelis;93009343319;Taip;7;0;1;8
6860;Pelenė;Varpelis;72752022712;Taip;0;5;0;5
6861;Pelenė;Varpelis;22762248459;Taip;8;0;0;8
6862;Pelenė;Varpelis;70438374608;Taip;0;4;0;4
6863;Pelenė;Varpelis;17746532458;Taip;4;0;0;4
6864;Pelenė;Varpelis;6533433685;Taip;6;9;0;15
6865;Pelenė;Varpelis;59795549508;Taip;0;13;0;13
6866;Pelenė;Varpelis;1072148409;Taip;5;0;4;9
6867;Pelenė;Varpelis;83359560510;Taip;0;8;0;8
6868;Pelenė;Saulutės;99521206531;Ne;0;5;0;5
6869;Pelenė;Saulutės;59732999282;Ne;5;0;3;8
6870;Pelenė;Saulutės;99849461351;Taip;0;8;0;8
6871;Pelenė;Saulutės;4233272418;Taip;0;5;0;5
6872;Pelenė;Saulutės;55808304356;Taip;0;0;2;2
6873;Pelenė;Saulutės;12170216844;Taip;0;6;1;7
6874;Pelenė;Saulutės;1321060587;Taip;0;0;3;3
6875;Pelenė;Saulutės;11671895181;Taip;0;2;0;2
6876;Pelenė;Saulutės;24547508796;Ne;6;0;0;6
6877;Pelenė;Saulutės;91433727359;Taip;0;6;0;6
6878;Pelenė;Saulutės;55937499558;Taip;3;0;0;3
6879;Pelenė;Saulutės;96121315210;Taip;10;0;0;10
6880;Pelenė;Saulutės;78085706850;Taip;2;0;0;2
6881;Pelenė;Saulutės;11924441656;Taip;0;11;0;11
6882;Pelenė;Saulutės;15949989455;Ne;5;7;0;12
6883;Pelenė;Saulutės;98221995571;Taip;0;0;1;1
6884;Pelenė;Saulutės;2115021063;Taip;0;0;8;8
6885;Pelenė;Raktelis;85051053863;Taip;16;0;2;18
6886;Pelenė;Raktelis;1356029457;Taip;0;20;0;20
6887;Pelenė;Raktelis;32577488307;Taip;4;0;3;7
6888;Pelenė;Raktelis;32716320977;Taip;0;15;0;15
6889;Pelenė;Raktelis;40968963343;Taip;0;3;0;3
6890;Pelenė;Raktelis;29587640966;Taip;0;12;0;12
6891;Pelenė;Raktelis;55350714718;Taip;0;4;5;9
6892;Pelenė;Raktelis;30625065081;Taip;0;1;0;1
6893;Pelenė;Raktelis;62615483649;Taip;2;10;1;13
6894;Pelenė;Raktelis;87207607315;Taip;0;0;3;3
6895;Pelenė;Raktelis;70335326964;Taip;0;2;0;2
6896;Pelenė;Raktelis;1045206373;Taip;0;0;1;1
6897;Pelenė;Raktelis;120966603;Taip;0;3;0;3
6898;Pelenė;Žvaigždutės;33028103211;Ne;0;0;2;2
6899;Pelenė;Žvaigždutės;3189769456;Taip;0;6;0;6
6900;Pelenė;Žvaigždutės;45687410331;Taip;12;0;4;16
6901;Pelenė;Žvaigždutės;8483195434;Taip;0;4;0;4
6902;Pelenė;Žvaigždutės;66474157416;Taip;0;0;1;1
6903;Pelenė;Žvaigždutės;1793514226;Taip;5;13;0;18
6904;Pelenė;Žvaigždutės;55747365118;Taip;10;0;0;10
6905;Pelenė;Žvaigždutės;12400151337;Taip;6;0;2;8
6906;Pelenė;Žvaigždutės;77504082241;Taip;0;12;0;12
6907;Pelenė;Žvaigždutės;93234992958;Taip;0;5;0;5
6908;Pelenė;Žvaigždutės;2393068606;Taip;0;2;0;2
6909;Pelenė;Žvaigždutės;62544766703;Taip;0;6;0;6
6910;Pelenė;Žvaigždutės;14791621417;Taip;7;0;2;9
6911;Pelenė;Žvaigždutės;43686344645;Ne;0;8;0;8
6912;Pelenė;Žvaigždutės;39850314417;Taip;6;0;1;7
6913;Pelenė;Žvaigždutės;71274664713;Taip;0;7;0;7
6914;Pelenė;Žvaigždutės;1542958753;Taip;10;0;2;12
6915;Pelenė;Žvaigždutės;1846536895;Taip;0;21;0;21
6916;Pelenė;Žvaigždutės;1516249890;Taip;0;4;0;4
6917;Pelenė;Žvaigždutės;1908166570;Taip;0;0;1;1
6918;Pelenė;Žvaigždutės;1599336930;Taip;8;0;1;9
6919;Pelenė;Žvaigždutės;1283843474;Taip;8;0;0;8
6920;Pelenė;Nykštukas;35657264407;Ne;0;7;0;7
6921;Pelenė;Nykštukas;3299454566;Taip;0;0;1;1
6922;Pelenė;Nykštukas;1931857547;Taip;7;0;0;7
6923;Pelenė;Nykštukas;4386060612;Ne;0;0;6;6
6924;Pelenė;Nykštukas;1568123491;Taip;0;1;0;1
6925;Pelenė;Nykštukas;1418000665;Taip;0;0;5;5
6926;Pelenė;Nykštukas;1038583766;Taip;5;0;0;5
6927;Pelenė;Nykštukas;1127657620;Taip;0;6;0;6
6928;Pelenė;Nykštukas;17572291941;Taip;0;3;0;3
6929;Pelenė;Nykštukas;1183026351;Taip;0;2;0;2
6930;Pelenė;Nykštukas;28622286194;Taip;6;4;0;10
6931;Pelenė;Nykštukas;1050272821;Taip;0;7;0;7
6932;Pelenė;Nykštukas;45589326259;Ne;8;0;0;8
6933;Pelenė;Nykštukas;26010775076;Taip;4;1;0;5
6934;Pelenė;Nykštukas;14200374671;Taip;2;0;1;3
6935;Pelenė;Nykštukas;89920419797;Taip;5;3;0;8
6936;Pelenė;Žirniukai;59244146880;Taip;10;0;0;10
6937;Pelenė;Žirniukai;96840961754;Taip;0;0;2;2
6938;Pelenė;Žirniukai;52690820;Taip;0;0;1;1
6939;Pelenė;Žirniukai;43987538343;Taip;6;0;0;6
6940;Pelenė;Žirniukai;1710249888;Taip;10;1;0;11
6941;Pelenė;Žirniukai;78648474464;Ne;0;0;5;5
6942;Pelenė;Žirniukai;86063417321;Taip;1;0;0;1
6943;Pelenė;Žirniukai;61012202440;Taip;8;2;0;10
6944;Pelenė;Žirniukai;4178071578;Taip;0;7;0;7
6945;Pelenė;Žirniukai;45410683361;Taip;5;0;3;8
6946;Pelenė;Žirniukai;8813044848;Taip;0;0;2;2
6947;Pelenė;Žirniukai;1807037374;Taip;20;0;2;22
6948;Pelenė;Žirniukai;6559830470;Taip;8;0;3;11
6949;Pelenė;Žirniukai;62484999314;Taip;2;0;4;6
6950;Pelenė;Žirniukai;1289416312;Taip;12;0;0;12
6951;Pelenė;Žirniukai;1774912517;Taip;9;0;0;9
6952;Pelenė;Žirniukai;6937587856;Taip;0;1;0;1
6953;Pelenė;Lašeliai;1483843416;Taip;3;18;0;21
6954;Pelenė;Lašeliai;2677995903;Ne;9;0;1;10
6955;Pelenė;Lašeliai;6579504852;Taip;7;0;5;12
6956;Pelenė;Lašeliai;6181604926;Ne;0;0;3;3
6957;Pelenė;Lašeliai;2092775878;Taip;1;3;0;4
6958;Pelenė;Lašeliai;10457480694;Taip;7;0;3;10
6959;Pelenė;Lašeliai;7589978427;Taip;0;3;0;3
6960;Pelenė;Lašeliai;8721423900;Taip;0;8;0;8
6961;Pelenė;Lašeliai;3189305906;Taip;0;5;0;5
6962;Pelenė;Lašeliai;8607110629;Taip;0;7;0;7
6963;Pelenė;Lašeliai;7144616734;Ne;4;0;1;5
6964;Pelenė;Lašeliai;8770771520;Taip;0;0;1;1
6965;Pelenė;Lašeliai;1750366978;Taip;0;10;0;10
6966;Pelenė;Lašeliai;8675348688;Taip;11;0;0;11
6967;Pelenė;Lašeliai;1217505164;Taip;5;0;0;5
6968;Pelenė;Lašeliai;7836778389;Taip;0;0;5;5
6969;Pelenė;Lašeliai;1978481168;Taip;0;0;1;1
6970;Pelenė;Lašeliai;3596386480;Taip;6;3;0;9
6971;Pelenė;Lašeliai;6021833025;Taip;0;8;0;8
6972;Pelenė;Lašeliai;7469266085;Taip;0;18;0;18
6973;Pelenė;Lašeliai;3296147024;Taip;0;7;0;7
6974;Pelenė;Grūdelis;88349051367;Taip;0;10;0;10
6975;Pelenė;Grūdelis;38804968295;Taip;3;0;0;3
6976;Pelenė;Grūdelis;83979485459;Taip;0;1;0;1
6977;Pelenė;Grūdelis;86862048784;Ne;0;0;1;1
6978;Pelenė;Grūdelis;8945972016;Taip;0;8;0;8
6979;Pelenė;Grūdelis;52681956071;Taip;5;0;0;5
6980;Pelenė;Grūdelis;96734246902;Taip;3;0;0;3
6981;Pelenė;Grūdelis;45985345611;Taip;4;0;1;5
6982;Pelenė;Grūdelis;23859597260;Taip;12;0;0;12
6983;Pelenė;Grūdelis;21224601178;Taip;12;0;0;12
6984;Pelenė;Grūdelis;67249286878;Ne;0;10;0;10
6985;Pelenė;Grūdelis;82762950191;Taip;0;0;1;1
6986;Pelenė;Grūdelis;12965686122;Taip;0;4;0;4
6987;Pelenė;Braškytė;5325176433;Taip;0;13;0;13
6988;Pelenė;Braškytė;9009271610;Taip;0;10;0;10
6989;Pelenė;Braškytė;8916634408;Taip;7;0;1;8
6990;Pelenė;Braškytė;4546285993;Taip;0;20;0;20
6991;Pelenė;Braškytė;3238807604;Taip;0;1;2;3
6992;Pelenė;Braškytė;5780697554;Taip;0;4;0;4
6993;Pelenė;Braškytė;6707167720;Taip;0;0;5;5
6994;Pelenė;Braškytė;8466974910;Taip;4;0;0;4
6995;Pelenė;Braškytė;7880284433;Taip;2;0;3;5
6996;Pelenė;Braškytė;9621197758;Taip;0;3;0;3
6997;Pelenė;Braškytė;9195113444;Taip;5;5;0;10
6998;Pelenė;Braškytė;6375060159;Taip;5;5;0;10
6999;Pelenė;Braškytė;9218868317;Taip;0;5;0;5
7000;Pelenė;Boružėlės;4624325473;Taip;0;1;0;1
7001;Pelenė;Boružėlės;1336431888;Taip;0;2;0;2
7002;Pelenė;Boružėlės;1533938659;Ne;0;0;6;6
7003;Pelenė;Boružėlės;1114786936;Taip;0;5;3;8
7004;Pelenė;Boružėlės;8404317146;Taip;4;0;0;4
7005;Pelenė;Boružėlės;1140030742;Taip;16;0;0;16
7006;Pelenė;Boružėlės;3497915398;Taip;14;0;0;14
7007;Pelenė;Boružėlės;2154553741;Taip;14;0;0;14
7008;Pelenė;Boružėlės;8598498275;Taip;0;22;0;22
7009;Pelenė;Boružėlės;39705461573;Ne;10;0;0;10
7010;Pelenė;Boružėlės;5356756237;Ne;5;0;1;6
7011;Pelenė;Boružėlės;3131930907;Taip;9;0;1;10
7012;Pelenė;Boružėlės;1067737206;Taip;0;9;0;9
7013;Pelenė;Boružėlės;1775717256;Ne;9;0;0;9
7014;Pelenė;Boružėlės;6459145539;Taip;4;0;2;6
7015;Pelenė;Boružėlės;3419051414;Taip;7;0;0;7
7016;Pelenė;Boružėlės;6632188229;Taip;12;10;0;22
7017;Pelenė;Boružėlės;8716395810;Taip;0;6;0;6
7018;Pelenė;Boružėlės;6191899254;Taip;6;5;0;11
7019;Pelenė;Saldainiukai;2737277656;Taip;12;0;0;12
7020;Pelenė;Saldainiukai;2647876561;Taip;10;0;1;11
7021;Pelenė;Saldainiukai;8194354176;Taip;0;5;0;5
7022;Pelenė;Saldainiukai;2322908067;Taip;22;0;0;22
7023;Pelenė;Saldainiukai;8239650471;Taip;4;0;2;6
7024;Pelenė;Saldainiukai;5228983908;Taip;9;0;0;9
7025;Pelenė;Saldainiukai;3174009848;Taip;15;0;0;15
7026;Pelenė;Saldainiukai;6524101295;Taip;15;0;0;15
7027;Pelenė;Saldainiukai;4376033711;Taip;4;0;0;4
7028;Pelenė;Saldainiukai;6894978459;Taip;9;2;0;11
7029;Pelenė;Saldainiukai;2103177773;Taip;11;0;0;11
7030;Pelenė;Saldainiukai;4321705575;Taip;0;3;0;3
7031;Pelenė;Saldainiukai;6481466282;Taip;9;0;0;9
7032;Pipiras;EŽIUKAI;12489971559;Taip;0;3;0;3
7033;Pipiras;EŽIUKAI;56241147614;Taip;7;1;0;8
7034;Pipiras;EŽIUKAI;1112327896;Taip;7;2;0;9
7035;Pipiras;EŽIUKAI;24106575180;Taip;11;2;0;13
7036;Pipiras;EŽIUKAI;52968399382;Taip;0;5;0;5
7037;Pipiras;EŽIUKAI;38894447952;Taip;0;1;0;1
7038;Pipiras;EŽIUKAI;76685499613;Taip;0;2;3;5
7039;Pipiras;EŽIUKAI;24414917430;Taip;0;7;0;7
7040;Pipiras;EŽIUKAI;71881026465;Taip;0;1;0;1
7041;Pipiras;EŽIUKAI;95904922548;Taip;0;11;0;11
7042;Pipiras;EŽIUKAI;93498963556;Taip;0;2;6;8
7043;Pipiras;EŽIUKAI;9858798452;Taip;10;5;0;15
7044;Pipiras;EŽIUKAI;22190236403;Taip;0;1;0;1
7045;Pipiras;EŽIUKAI;1213972436;Taip;0;1;0;1
7046;Pipiras;EŽIUKAI;4564046164;Ne;0;1;0;1
7047;Pipiras;EŽIUKAI;35225328018;Taip;0;1;0;1
7048;Pipiras;EŽIUKAI;1129409620;Taip;0;1;0;1
7049;Pipiras;BITUTĖS;20034839935;Taip;0;5;0;5
7050;Pipiras;BITUTĖS;35376853030;Taip;9;5;0;14
7051;Pipiras;BITUTĖS;96219330294;Taip;0;6;0;6
7052;Pipiras;BITUTĖS;77699420684;Taip;0;5;0;5
7053;Pipiras;BITUTĖS;17828188095;Taip;2;0;0;2
7054;Pipiras;BITUTĖS;61581422755;Taip;17;0;0;17
7055;Pipiras;BITUTĖS;75297843018;Taip;0;10;0;10
7056;Pipiras;BITUTĖS;81094360294;Taip;0;2;0;2
7057;Pipiras;BITUTĖS;35448366688;Ne;10;0;0;10
7058;Pipiras;BITUTĖS;7501158031;Taip;0;9;0;9
7059;Pipiras;BITUTĖS;35777468660;Taip;0;2;0;2
7060;Pipiras;BITUTĖS;8797825745;Taip;6;2;0;8
7061;Pipiras;BITUTĖS;74448139833;Taip;5;0;0;5
7062;Pipiras;BITUTĖS;7724903510;Taip;0;9;0;9
7063;Pipiras;NYKŠTUKAI;60655521743;Taip;9;0;0;9
7064;Pipiras;NYKŠTUKAI;45471590000;Taip;0;9;0;9
7065;Pipiras;NYKŠTUKAI;5849366642;Taip;0;3;0;3
7066;Pipiras;NYKŠTUKAI;15927602783;Taip;0;3;0;3
7067;Pipiras;NYKŠTUKAI;56791669968;Taip;0;6;0;6
7068;Pipiras;NYKŠTUKAI;31751980968;Taip;21;0;0;21
7069;Pipiras;NYKŠTUKAI;41412423426;Taip;0;1;0;1
7070;Pipiras;NYKŠTUKAI;32061333461;Taip;5;0;0;5
7071;Pipiras;NYKŠTUKAI;63803090607;Taip;0;5;0;5
7072;Pipiras;NYKŠTUKAI;72634292284;Taip;0;1;0;1
7073;Pipiras;NYKŠTUKAI;86812470693;Taip;0;1;0;1
7074;Pipiras;NYKŠTUKAI;66182015590;Ne;0;9;0;9
7075;Pipiras;NYKŠTUKAI;1017413300;Taip;0;6;0;6
7076;Pipiras;NYKŠTUKAI;1626782165;Taip;0;7;0;7
7077;Pipiras;NYKŠTUKAI;1813200223;Ne;3;1;0;4
7078;Pipiras;PELĖDŽIUKAI;6694920607;Taip;0;3;0;3
7079;Pipiras;PELĖDŽIUKAI;3325511140;Taip;9;1;0;10
7080;Pipiras;PELĖDŽIUKAI;3341850450;Taip;6;0;0;6
7081;Pipiras;PELĖDŽIUKAI;7870521230;Taip;0;1;0;1
7082;Pipiras;PELĖDŽIUKAI;5778300856;Taip;0;1;0;1
7083;Pipiras;PELĖDŽIUKAI;3888552150;Taip;0;1;0;1
7084;Pipiras;PELĖDŽIUKAI;7026118693;Taip;0;1;0;1
7085;Pipiras;PELĖDŽIUKAI;1391682850;Taip;0;6;0;6
7086;Pipiras;PELĖDŽIUKAI;87924002679;Ne;12;0;0;12
7087;Pipiras;PELĖDŽIUKAI;6805620664;Taip;7;0;0;7
7088;Pipiras;PELĖDŽIUKAI;7912217889;Ne;5;2;0;7
7089;Pipiras;PELĖDŽIUKAI;5502001191;Taip;0;3;0;3
7090;Pipiras;PELĖDŽIUKAI;9275905384;Taip;0;10;0;10
7091;Pipiras;PELĖDŽIUKAI;4496076326;Taip;5;5;0;10
7092;Pipiras;PELĖDŽIUKAI;3141822820;Taip;0;8;0;8
7093;Pipiras;PELĖDŽIUKAI;4456861303;Taip;0;12;0;12
7094;Pipiras;PELĖDŽIUKAI;2044498561;Taip;0;1;0;1
7095;Pipiras;PELĖDŽIUKAI;3357866319;Ne;0;4;1;5
7096;Pipiras;DRUGELIAI;41585818819;Taip;0;13;0;13
7097;Pipiras;DRUGELIAI;5577759167;Taip;10;0;0;10
7098;Pipiras;DRUGELIAI;7799786844;Taip;4;0;0;4
7099;Pipiras;DRUGELIAI;2345034928;Taip;22;0;0;22
7100;Pipiras;DRUGELIAI;5014457985;Ne;4;1;0;5
7101;Pipiras;DRUGELIAI;4927845000;Ne;0;3;0;3
7102;Pipiras;DRUGELIAI;1904376366;Taip;0;8;0;8
7103;Pipiras;DRUGELIAI;1128674099;Taip;0;2;0;2
7104;Pipiras;DRUGELIAI;3422170541;Taip;0;2;0;2
7105;Pipiras;DRUGELIAI;1391958633;Taip;0;4;0;4
7106;Pipiras;DRUGELIAI;3622164823;Taip;0;5;0;5
7107;Pipiras;DRUGELIAI;3008358842;Taip;0;1;0;1
7108;Pipiras;DRUGELIAI;2024777430;Taip;0;6;0;6
7109;Pipiras;DRUGELIAI;4959823035;Taip;0;5;0;5
7110;Pipiras;DRUGELIAI;6339186940;Taip;0;1;0;1
7111;Pipiras;DRUGELIAI;3314276870;Taip;3;0;0;3
7112;Pipiras;DRUGELIAI;5637557921;Taip;22;0;0;22
7113;Pipiras;DRUGELIAI;1050430252;Ne;5;1;0;6
7114;Pipiras;GĖLYTĖS;56325056631;Taip;0;3;0;3
7115;Pipiras;GĖLYTĖS;48059975861;Taip;5;0;0;5
7116;Pipiras;GĖLYTĖS;23377947863;Taip;7;5;0;12
7117;Pipiras;GĖLYTĖS;87831792882;Taip;5;3;0;8
7118;Pipiras;GĖLYTĖS;1417855241;Taip;0;3;0;3
7119;Pipiras;GĖLYTĖS;1791226869;Taip;5;3;0;8
7120;Pipiras;GĖLYTĖS;1077104941;Taip;0;9;0;9
7121;Pipiras;GĖLYTĖS;60652954862;Taip;0;3;0;3
7122;Pipiras;GĖLYTĖS;27808576289;Taip;0;7;0;7
7123;Pipiras;GĖLYTĖS;5114553619;Taip;0;8;0;8
7124;Pipiras;GĖLYTĖS;18211174874;Taip;4;1;0;5
7125;Pipiras;GĖLYTĖS;4246712256;Taip;0;6;0;6
7126;Pipiras;GĖLYTĖS;25000181631;Taip;0;10;0;10
7127;Pipiras;GĖLYTĖS;2473644942;Taip;0;6;0;6
7128;Pipiras;GĖLYTĖS;1650661825;Taip;0;2;0;2
7129;Pipiras;GĖLYTĖS;56822466210;Taip;0;2;0;2
7130;Pipiras;GĖLYTĖS;23663823688;Taip;8;4;0;12
7131;Pipiras;GĖLYTĖS;6481320053;Ne;8;1;0;9
7132;Pipiras;BORUŽĖLĖS;54633757340;Taip;0;2;0;2
7133;Pipiras;BORUŽĖLĖS;68636458010;Taip;0;7;0;7
7134;Pipiras;BORUŽĖLĖS;31533878253;Taip;0;5;0;5
7135;Pipiras;BORUŽĖLĖS;20456702162;Taip;15;0;0;15
7136;Pipiras;BORUŽĖLĖS;57459408180;Taip;0;14;0;14
7137;Pipiras;BORUŽĖLĖS;7354253729;Ne;0;5;0;5
7138;Pipiras;BORUŽĖLĖS;99551392640;Taip;0;5;0;5
7139;Pipiras;BORUŽĖLĖS;9423015002;Taip;0;14;0;14
7140;Pipiras;BORUŽĖLĖS;68235713574;Taip;0;2;0;2
7141;Pipiras;BORUŽĖLĖS;23794561369;Taip;0;7;0;7
7142;Pipiras;BORUŽĖLĖS;46165404909;Taip;0;12;0;12
7143;Pipiras;BORUŽĖLĖS;6804964469;Taip;2;1;0;3
7144;Pipiras;BORUŽĖLĖS;81817710888;Taip;8;1;0;9
7145;Pipiras;BORUŽĖLĖS;7448924569;Taip;0;2;0;2
7146;Pipiras;BORUŽĖLĖS;1676986127;Taip;0;4;0;4
7147;Pipiras;BORUŽĖLĖS;1334584865;Taip;5;10;0;15
7148;Pipiras;BORUŽĖLĖS;1657721144;Taip;0;2;0;2
7149;Pipiras;BORUŽĖLĖS;6766596656;Taip;0;4;0;4
7150;Pipiras;SKRUZDĖLIUKAI;76840668343;Taip;22;0;0;22
7151;Pipiras;SKRUZDĖLIUKAI;1975780209;Taip;3;1;2;6
7152;Pipiras;SKRUZDĖLIUKAI;75153377410;Taip;0;10;0;10
7153;Pipiras;SKRUZDĖLIUKAI;7196519583;Taip;0;20;0;20
7154;Pipiras;SKRUZDĖLIUKAI;53180156021;Taip;0;0;3;3
7155;Pipiras;SKRUZDĖLIUKAI;96711811784;Taip;0;10;0;10
7156;Pipiras;SKRUZDĖLIUKAI;85339674885;Taip;0;10;0;10
7157;Pipiras;SKRUZDĖLIUKAI;61166497338;Taip;7;0;0;7
7158;Pipiras;SKRUZDĖLIUKAI;90202583208;Taip;0;5;0;5
7159;Pipiras;SKRUZDĖLIUKAI;84791674090;Ne;0;4;0;4
7160;Pipiras;SKRUZDĖLIUKAI;49361002482;Taip;0;2;0;2
7161;Pipiras;SKRUZDĖLIUKAI;53377928276;Taip;0;1;0;1
7162;Pipiras;SKRUZDĖLIUKAI;57731282074;Taip;12;0;0;12
7163;Pipiras;SKRUZDĖLIUKAI;1450882528;Taip;5;0;7;12
7164;Pipiras;SKRUZDĖLIUKAI;1469877916;Taip;0;1;0;1
7165;Pipiras;SKRUZDĖLIUKAI;71790101454;Taip;0;6;0;6
7166;Pipiras;SKRUZDĖLIUKAI;73564428514;Ne;0;16;0;16
7167;Pipiras;ŽVIRBLIUKŲ;80046621658;Taip;22;0;0;22
7168;Pipiras;ŽVIRBLIUKŲ;1232620336;Taip;0;12;0;12
7169;Pipiras;ŽVIRBLIUKŲ;1549121029;Taip;5;0;0;5
7170;Pipiras;ŽVIRBLIUKŲ;37087220885;Taip;0;5;0;5
7171;Pipiras;ŽVIRBLIUKŲ;1700856741;Taip;0;4;0;4
7172;Pipiras;ŽVIRBLIUKŲ;1319863476;Ne;0;2;0;2
7173;Pipiras;ŽVIRBLIUKŲ;1757192919;Taip;0;6;0;6
7174;Pipiras;ŽVIRBLIUKŲ;1417086043;Taip;0;18;0;18
7175;Pipiras;ŽVIRBLIUKŲ;1441590033;Taip;0;2;0;2
7176;Pipiras;ŽVIRBLIUKŲ;3370047940;Taip;0;10;0;10
7177;Pipiras;ŽVIRBLIUKŲ;1008228932;Taip;5;6;0;11
7178;Pipiras;ŽVIRBLIUKŲ;2030665851;Taip;0;9;0;9
7179;Pipiras;ŽVIRBLIUKŲ;1182415963;Taip;0;6;0;6
7180;Pipiras;ŽVIRBLIUKŲ;8657924258;Taip;0;8;0;8
7181;Pipiras;ŽVIRBLIUKŲ;10750695428;Taip;0;22;0;22
7182;Pipiras;ŽVIRBLIUKŲ;66816368717;Ne;0;5;0;5
7183;Pipiras;ŽVIRBLIUKŲ;1799335356;Ne;0;9;0;9
7184;Pipiras;ŽVIRBLIUKŲ;3247709788;Taip;0;10;0;10
7185;Pipiras;ZUIKUČIŲ;7161727352;Taip;0;11;0;11
7186;Pipiras;ZUIKUČIŲ;5225533488;Taip;0;6;0;6
7187;Pipiras;ZUIKUČIŲ;5622119207;Taip;5;8;0;13
7188;Pipiras;ZUIKUČIŲ;9157870634;Taip;0;2;0;2
7189;Pipiras;ZUIKUČIŲ;4017042461;Taip;0;11;0;11
7190;Pipiras;ZUIKUČIŲ;4177166475;Taip;0;1;0;1
7191;Pipiras;ZUIKUČIŲ;6792777396;Taip;0;1;0;1
7192;Pipiras;ZUIKUČIŲ;5845498558;Taip;5;6;0;11
7193;Pipiras;ZUIKUČIŲ;1784839485;Taip;0;1;0;1
7194;Pipiras;ZUIKUČIŲ;5141447649;Taip;22;0;0;22
7195;Pipiras;ZUIKUČIŲ;3775916247;Taip;6;0;0;6
7196;Pipiras;ZUIKUČIŲ;5908707752;Taip;0;20;0;20
7197;Pipiras;ZUIKUČIŲ;8422419380;Taip;0;5;0;5
7198;Pipiras;ZUIKUČIŲ;3882437376;Taip;3;11;0;14
7199;Pipiras;VARLIUKŲ;6363349541;Taip;0;4;0;4
7200;Pipiras;VARLIUKŲ;4266424785;Taip;0;6;0;6
7201;Pipiras;VARLIUKŲ;2315614501;Taip;5;0;0;5
7202;Pipiras;VARLIUKŲ;5422547144;Taip;0;10;0;10
7203;Pipiras;VARLIUKŲ;3421769229;Taip;1;9;0;10
7204;Pipiras;VARLIUKŲ;5445858240;Taip;0;6;0;6
7205;Pipiras;VARLIUKŲ;1242260242;Taip;0;10;0;10
7206;Pipiras;VARLIUKŲ;6685567970;Ne;2;1;0;3
7207;Pipiras;VARLIUKŲ;8520454289;Taip;0;3;0;3
7208;Pipiras;VARLIUKŲ;7969837759;Taip;0;15;0;15
7209;Pipiras;VARLIUKŲ;4426479971;Taip;0;1;0;1
7210;Pipiras;VARLIUKŲ;2267192782;Taip;0;12;0;12
7211;Pipiras;ŽIOGELIŲ;2096009051;Taip;0;13;0;13
7212;Pipiras;ŽIOGELIŲ;71283505646;Ne;0;5;0;5
7213;Pipiras;ŽIOGELIŲ;1485565125;Taip;3;0;0;3
7214;Pipiras;ŽIOGELIŲ;2061168407;Taip;8;2;0;10
7215;Pipiras;ŽIOGELIŲ;2030170020;Ne;0;8;0;8
7216;Pipiras;ŽIOGELIŲ;2637950013;Taip;22;0;0;22
7217;Pipiras;ŽIOGELIŲ;3652741639;Taip;22;0;0;22
7218;Pipiras;ŽIOGELIŲ;1415741097;Taip;6;6;0;12
7219;Pipiras;ŽIOGELIŲ;1658491279;Taip;2;0;0;2
7220;Pipiras;ŽIOGELIŲ;1082396096;Taip;6;4;0;10
7221;Pipiras;ŽIOGELIŲ;1324680675;Taip;5;1;0;6
7222;Pipiras;ŽIOGELIŲ;6794437566;Taip;22;0;0;22
7223;Pipiras;ŽIOGELIŲ;1371141047;Taip;8;0;0;8
7224;Pipiras;ŽIOGELIŲ;1293250996;Taip;0;3;0;3
7225;Pipiras;ŽIOGELIŲ;1751427121;Taip;5;0;0;5
7226;Pipiras;ŽIOGELIŲ;1114377378;Taip;0;4;0;4
7227;Pipiras;ŽIOGELIŲ;8088285579;Ne;0;9;0;9
7228;Pipiras;ŽIOGELIŲ;1949087858;Ne;0;12;0;12
7229;"Prie pasakų parko";"ZUIKUČIŲ (SPEC.)";1783727978;Taip;7;0;2;9
7230;"Prie pasakų parko";"ZUIKUČIŲ (SPEC.)";2058795331;Taip;7;0;0;7
7231;"Prie pasakų parko";"ZUIKUČIŲ (SPEC.)";1057427744;Ne;0;0;2;2
7232;"Prie pasakų parko";"ZUIKUČIŲ (SPEC.)";4574965127;Ne;4;0;2;6
7233;"Prie pasakų parko";"ZUIKUČIŲ (SPEC.)";3397410463;Ne;0;0;3;3
7234;"Prie pasakų parko";PAUKŠČIUKŲ;5982019255;Ne;0;0;5;5
7235;"Prie pasakų parko";PAUKŠČIUKŲ;2160440145;Taip;5;3;0;8
7236;"Prie pasakų parko";PAUKŠČIUKŲ;6992830082;Taip;2;2;0;4
7237;"Prie pasakų parko";PAUKŠČIUKŲ;2216634402;Taip;8;0;2;10
7238;"Prie pasakų parko";PAUKŠČIUKŲ;1278065349;Taip;20;0;0;20
7239;"Prie pasakų parko";PAUKŠČIUKŲ;3356307067;Taip;0;0;2;2
7240;"Prie pasakų parko";PAUKŠČIUKŲ;8215830508;Ne;4;12;0;16
7241;"Prie pasakų parko";PAUKŠČIUKŲ;8318567916;Taip;7;0;0;7
7242;"Prie pasakų parko";PAUKŠČIUKŲ;8189217660;Taip;8;6;1;15
7243;"Prie pasakų parko";PAUKŠČIUKŲ;2741301903;Taip;22;0;0;22
7244;"Prie pasakų parko";PAUKŠČIUKŲ;4181676762;Taip;0;10;0;10
7245;"Prie pasakų parko";PAUKŠČIUKŲ;1482803930;Taip;17;0;0;17
7246;"Prie pasakų parko";PAUKŠČIUKŲ;9926991259;Taip;9;3;0;12
7247;"Prie pasakų parko";PAUKŠČIUKŲ;8574432191;Taip;15;0;0;15
7248;"Prie pasakų parko";PAUKŠČIUKŲ;1588062393;Taip;2;0;7;9
7249;"Prie pasakų parko";PAUKŠČIUKŲ;2217627240;Taip;1;0;0;1
7250;"Prie pasakų parko";PAUKŠČIUKŲ;7548653053;Taip;16;1;0;17
7251;"Prie pasakų parko";"LINKSMOJI ŠEIMYNĖLĖ (SPEC)";70678189213;Taip;1;0;0;1
7252;"Prie pasakų parko";"LINKSMOJI ŠEIMYNĖLĖ (SPEC)";3023913956;Ne;0;1;0;1
7253;"Prie pasakų parko";"LINKSMOJI ŠEIMYNĖLĖ (SPEC)";29561378525;Taip;4;0;9;13
7254;"Prie pasakų parko";"LINKSMOJI ŠEIMYNĖLĖ (SPEC)";7186554262;Taip;0;0;1;1
7255;"Prie pasakų parko";"LINKSMOJI ŠEIMYNĖLĖ (SPEC)";6339321027;Taip;0;0;2;2
7256;"Prie pasakų parko";"LINKSMOJI ŠEIMYNĖLĖ (SPEC)";50713289266;Ne;2;0;4;6
7257;"Prie pasakų parko";"LINKSMOJI ŠEIMYNĖLĖ (SPEC)";1327847558;Taip;0;8;0;8
7258;"Prie pasakų parko";NYKŠTUKŲ;18733824395;Taip;0;0;1;1
7259;"Prie pasakų parko";NYKŠTUKŲ;79438946697;Taip;2;8;0;10
7260;"Prie pasakų parko";NYKŠTUKŲ;21605684303;Taip;4;0;2;6
7261;"Prie pasakų parko";NYKŠTUKŲ;72936036464;Taip;0;0;3;3
7262;"Prie pasakų parko";NYKŠTUKŲ;1410161486;Taip;8;0;1;9
7263;"Prie pasakų parko";NYKŠTUKŲ;9384410578;Taip;13;0;3;16
7264;"Prie pasakų parko";NYKŠTUKŲ;9511739352;Taip;7;0;2;9
7265;"Prie pasakų parko";NYKŠTUKŲ;7235277422;Taip;0;0;3;3
7266;"Prie pasakų parko";NYKŠTUKŲ;6577763037;Taip;1;1;0;2
7267;"Prie pasakų parko";NYKŠTUKŲ;6027613840;Taip;7;0;0;7
7268;"Prie pasakų parko";NYKŠTUKŲ;4657371068;Taip;0;0;1;1
7269;"Prie pasakų parko";NYKŠTUKŲ;1634442815;Taip;0;2;0;2
7270;"Prie pasakų parko";LAŠELIŲ;1168637823;Taip;0;0;2;2
7271;"Prie pasakų parko";LAŠELIŲ;2106160177;Taip;2;14;0;16
7272;"Prie pasakų parko";LAŠELIŲ;15531434904;Taip;0;1;0;1
7273;"Prie pasakų parko";LAŠELIŲ;62268017779;Ne;4;0;0;4
7274;"Prie pasakų parko";LAŠELIŲ;37693490595;Taip;3;0;0;3
7275;"Prie pasakų parko";LAŠELIŲ;98216786643;Taip;4;0;1;5
7276;"Prie pasakų parko";LAŠELIŲ;488285764;Taip;1;0;0;1
7277;"Prie pasakų parko";LAŠELIŲ;41495895397;Taip;0;14;0;14
7278;"Prie pasakų parko";LAŠELIŲ;80772711351;Taip;0;10;0;10
7279;"Prie pasakų parko";LAŠELIŲ;17947580061;Taip;0;0;1;1
7280;"Prie pasakų parko";"KAČIUKAI (SPEC)";5049934191;Ne;10;0;4;14
7281;"Prie pasakų parko";"KAČIUKAI (SPEC)";67103811533;Ne;3;0;2;5
7282;"Prie pasakų parko";"KAČIUKAI (SPEC)";4241426494;Ne;4;0;1;5
7283;"Prie pasakų parko";"KAČIUKAI (SPEC)";42696300043;Taip;0;11;0;11
7284;"Prie pasakų parko";"ŽVAIGŽDUTĖS  (SPEC)";2224744461;Taip;10;0;0;10
7285;"Prie pasakų parko";"ŽVAIGŽDUTĖS  (SPEC)";39511689145;Taip;0;0;3;3
7286;"Prie pasakų parko";"ŽVAIGŽDUTĖS  (SPEC)";11759638207;Taip;0;0;1;1
7287;"Prie pasakų parko";"ŽVAIGŽDUTĖS  (SPEC)";3045247119;Ne;0;0;3;3
7288;"Prie pasakų parko";"ŽVAIGŽDUTĖS  (SPEC)";7341054382;Ne;20;0;0;20
7289;"Prie pasakų parko";"ŽVAIGŽDUTĖS  (SPEC)";1118596267;Taip;6;0;2;8
7290;"Prie pasakų parko";"ŽVAIGŽDUTĖS  (SPEC)";66048881669;Ne;0;0;1;1
7291;"Prie pasakų parko";"ŽVAIGŽDUTĖS  (SPEC)";89327404290;Taip;5;0;1;6
7292;"Prie pasakų parko";"ANČIUKAI (SPEC)";47396396133;Taip;0;0;5;5
7293;"Prie pasakų parko";"ANČIUKAI (SPEC)";4908579339;Taip;15;0;2;17
7294;"Prie pasakų parko";"ANČIUKAI (SPEC)";2241142980;Taip;10;0;1;11
7295;"Prie pasakų parko";"ANČIUKAI (SPEC)";1730134670;Ne;0;0;3;3
7296;"Prie pasakų parko";"ANČIUKAI (SPEC)";78012776060;Taip;8;0;0;8
7297;"Prie pasakų parko";"ANČIUKAI (SPEC)";1658448860;Taip;0;0;8;8
7298;"Prie pasakų parko";"ANČIUKAI (SPEC)";78634860827;Taip;0;0;3;3
7299;"Prie pasakų parko";"ANČIUKAI (SPEC)";1182188784;Taip;7;0;9;16
7300;"Prie pasakų parko";"ANČIUKAI (SPEC)";1508800551;Taip;0;0;5;5
7301;"Prie pasakų parko";"ANČIUKAI (SPEC)";7710346116;Ne;3;0;2;5
7302;"Prie pasakų parko";TIGRIUKAI;1425859956;Taip;0;2;0;2
7303;"Prie pasakų parko";TIGRIUKAI;4427448272;Taip;12;0;0;12
7304;"Prie pasakų parko";TIGRIUKAI;2601881804;Taip;0;2;0;2
7305;"Prie pasakų parko";TIGRIUKAI;34800098950;Taip;4;0;0;4
7306;"Prie pasakų parko";TIGRIUKAI;1275460051;Taip;6;0;5;11
7307;"Prie pasakų parko";TIGRIUKAI;1400892707;Taip;0;0;11;11
7308;"Prie pasakų parko";TIGRIUKAI;4365489653;Taip;0;1;0;1
7309;"Prie pasakų parko";TIGRIUKAI;6273733995;Taip;0;11;0;11
7310;"Prie pasakų parko";TIGRIUKAI;1204812495;Taip;0;9;0;9
7311;"Prie pasakų parko";TIGRIUKAI;5699852944;Taip;6;0;2;8
7312;"Prie pasakų parko";TIGRIUKAI;5001661462;Taip;0;0;3;3
7313;"Prie pasakų parko";TIGRIUKAI;65825430797;Taip;0;12;0;12
7314;"Prie pasakų parko";TIGRIUKAI;4900757614;Taip;0;0;3;3
7315;"Prie pasakų parko";TIGRIUKAI;8205731591;Taip;13;0;2;15
7316;"Prie pasakų parko";TIGRIUKAI;1357074461;Taip;0;0;22;22
7317;"Prie pasakų parko";TIGRIUKAI;8474308320;Taip;22;0;0;22
7318;"Prie pasakų parko";TIGRIUKAI;4332682721;Ne;0;0;7;7
7319;"Prie pasakų parko";"EŽIUKŲ (SPEC)";2820889357;Ne;3;0;0;3
7320;"Prie pasakų parko";"EŽIUKŲ (SPEC)";1549137154;Taip;2;0;2;4
7321;"Prie pasakų parko";"EŽIUKŲ (SPEC)";7545372781;Ne;5;0;0;5
7322;"Prie pasakų parko";"EŽIUKŲ (SPEC)";29445903073;Taip;12;2;0;14
7323;"Prie pasakų parko";"EŽIUKŲ (SPEC)";2133790263;Ne;0;5;0;5
7324;"Prie pasakų parko";"EŽIUKŲ (SPEC)";8849417734;Taip;0;0;1;1
7325;"Prie pasakų parko";"EŽIUKŲ (SPEC)";9190379838;Taip;0;0;2;2
7326;"Prie pasakų parko";"EŽIUKŲ (SPEC)";7327208141;Ne;12;0;1;13
7327;"Prie pasakų parko";"EŽIUKŲ (SPEC)";76969210386;Taip;0;0;4;4
7328;"Prie pasakų parko";"BORUŽIUKŲ (SPEC)";2080597774;Taip;0;0;2;2
7329;"Prie pasakų parko";"BORUŽIUKŲ (SPEC)";28574450739;Taip;0;1;0;1
7330;"Prie pasakų parko";"BORUŽIUKŲ (SPEC)";8817950372;Taip;0;14;0;14
7331;"Prie pasakų parko";"BORUŽIUKŲ (SPEC)";4203385836;Ne;0;3;0;3
7332;"Prie pasakų parko";"BORUŽIUKŲ (SPEC)";92307951922;Taip;0;0;3;3
7333;"Prie pasakų parko";"BORUŽIUKŲ (SPEC)";6215345468;Ne;0;0;1;1
7334;"Prie pasakų parko";SAULYTĖS;1543331408;Taip;1;0;0;1
7335;"Prie pasakų parko";SAULYTĖS;1369637618;Taip;0;17;0;17
7336;"Prie pasakų parko";SAULYTĖS;4501408366;Taip;0;10;0;10
7337;"Prie pasakų parko";SAULYTĖS;8182873487;Taip;0;2;0;2
7338;"Prie pasakų parko";SAULYTĖS;1610362831;Ne;0;9;0;9
7339;"Prie pasakų parko";SAULYTĖS;2548712970;Taip;5;0;3;8
7340;"Prie pasakų parko";SAULYTĖS;78516912418;Taip;9;4;0;13
7341;"Prie pasakų parko";SAULYTĖS;5593546668;Taip;0;2;0;2
7342;"Prie pasakų parko";SAULYTĖS;6361878877;Taip;10;0;0;10
7343;"Prie pasakų parko";SAULYTĖS;4443834766;Taip;6;0;1;7
7344;"Prie pasakų parko";SAULYTĖS;3453119286;Taip;5;0;0;5
7345;"Prie pasakų parko";SAULYTĖS;5169736542;Taip;0;13;0;13
7346;"Prie pasakų parko";SAULYTĖS;5494350183;Taip;2;7;0;9
7347;"Prie pasakų parko";SAULYTĖS;6250397070;Taip;0;22;0;22
7348;Pumpurėlis;RAMUNĖLIŲ;61297074638;Taip;5;2;0;7
7349;Pumpurėlis;RAMUNĖLIŲ;87813594933;Taip;10;7;0;17
7350;Pumpurėlis;RAMUNĖLIŲ;7015779224;Taip;0;17;0;17
7351;Pumpurėlis;RAMUNĖLIŲ;24681852477;Taip;0;3;0;3
7352;Pumpurėlis;RAMUNĖLIŲ;27361939846;Taip;0;11;0;11
7353;Pumpurėlis;RAMUNĖLIŲ;72455192748;Taip;7;2;0;9
7354;Pumpurėlis;RAMUNĖLIŲ;20093100251;Taip;0;6;0;6
7355;Pumpurėlis;RAMUNĖLIŲ;66672997420;Taip;0;4;0;4
7356;Pumpurėlis;RAMUNĖLIŲ;15096075268;Taip;9;0;0;9
7357;Pumpurėlis;RAMUNĖLIŲ;1685401053;Taip;0;1;0;1
7358;Pumpurėlis;RAMUNĖLIŲ;2671657094;Taip;0;0;1;1
7359;Pumpurėlis;RAMUNĖLIŲ;91612536967;Taip;0;1;0;1
7360;Pumpurėlis;RAMUNĖLIŲ;45279361421;Taip;6;0;4;10
7361;Pumpurėlis;RAMUNĖLIŲ;16656067942;Taip;0;11;0;11
7362;Pumpurėlis;RAMUNĖLIŲ;9041599264;Taip;0;2;0;2
7363;Pumpurėlis;RAMUNĖLIŲ;1021043951;Taip;0;0;3;3
7364;Pumpurėlis;RAMUNĖLIŲ;1524688901;Ne;4;0;8;12
7365;Pumpurėlis;RAMUNĖLIŲ;1366801299;Ne;4;0;8;12
7366;Pumpurėlis;RAMUNĖLIŲ;1631951556;Taip;0;0;3;3
7367;Pumpurėlis;RAMUNĖLIŲ;1085633311;Taip;0;1;0;1
7368;Pumpurėlis;RAMUNĖLIŲ;6215273976;Taip;0;3;0;3
7369;Pumpurėlis;VARPELIŲ;97145389284;Taip;11;1;0;12
7370;Pumpurėlis;VARPELIŲ;70522541316;Taip;7;1;0;8
7371;Pumpurėlis;VARPELIŲ;465606233;Taip;0;2;1;3
7372;Pumpurėlis;VARPELIŲ;93964052608;Taip;22;0;0;22
7373;Pumpurėlis;VARPELIŲ;11052382671;Taip;0;12;0;12
7374;Pumpurėlis;VARPELIŲ;28759758744;Taip;0;2;7;9
7375;Pumpurėlis;VARPELIŲ;77110003421;Taip;9;2;1;12
7376;Pumpurėlis;VARPELIŲ;47596248180;Taip;0;8;0;8
7377;Pumpurėlis;VARPELIŲ;46386981131;Taip;2;7;0;9
7378;Pumpurėlis;VARPELIŲ;49176440282;Ne;0;9;0;9
7379;Pumpurėlis;VARPELIŲ;36645787745;Taip;0;2;0;2
7380;Pumpurėlis;VARPELIŲ;5901659879;Taip;6;2;1;9
7381;Pumpurėlis;VARPELIŲ;56351492623;Taip;0;2;3;5
7382;Pumpurėlis;VARPELIŲ;1754102092;Taip;0;1;0;1
7383;Pumpurėlis;VARPELIŲ;57426850391;Taip;0;6;1;7
7384;Pumpurėlis;VARPELIŲ;15256433275;Taip;10;4;0;14
7385;Pumpurėlis;VARPELIŲ;89695456583;Taip;7;0;0;7
7386;Pumpurėlis;VARPELIŲ;1544903261;Ne;0;15;0;15
7387;Pumpurėlis;VARPELIŲ;1945407792;Taip;14;0;0;14
7388;Pumpurėlis;VARPELIŲ;1645287832;Taip;0;2;8;10
7389;Pumpurėlis;VARPELIŲ;6025998706;Taip;5;2;0;7
7390;Pumpurėlis;DRUGELIŲ;1230058211;Taip;0;1;0;1
7391;Pumpurėlis;DRUGELIŲ;1053338730;Taip;16;0;0;16
7392;Pumpurėlis;DRUGELIŲ;1397924008;Taip;0;0;3;3
7393;Pumpurėlis;DRUGELIŲ;6230500803;Taip;0;9;0;9
7394;Pumpurėlis;DRUGELIŲ;2129779614;Taip;0;7;2;9
7395;Pumpurėlis;DRUGELIŲ;2102427499;Taip;0;1;2;3
7396;Pumpurėlis;DRUGELIŲ;9724549899;Taip;13;0;0;13
7397;Pumpurėlis;DRUGELIŲ;9317495169;Taip;0;7;0;7
7398;Pumpurėlis;DRUGELIŲ;8262886949;Ne;0;4;0;4
7399;Pumpurėlis;DRUGELIŲ;6535398274;Taip;0;11;0;11
7400;Pumpurėlis;DRUGELIŲ;9078991043;Taip;10;0;1;11
7401;Pumpurėlis;DRUGELIŲ;9733380187;Ne;0;8;0;8
7402;Pumpurėlis;DRUGELIŲ;83388662869;Ne;0;7;0;7
7403;Pumpurėlis;DRUGELIŲ;7123915287;Taip;4;0;0;4
7404;Pumpurėlis;DRUGELIŲ;1690424790;Taip;6;2;0;8
7405;Pumpurėlis;DRUGELIŲ;4192641015;Taip;0;3;0;3
7406;Pumpurėlis;DRUGELIŲ;7519369167;Taip;0;0;3;3
7407;Pumpurėlis;DRUGELIŲ;1248017244;Ne;0;1;7;8
7408;Pumpurėlis;DRUGELIŲ;6395230524;Taip;11;0;1;12
7409;Pumpurėlis;KODĖLČIUKŲ;5984878126;Taip;15;0;0;15
7410;Pumpurėlis;KODĖLČIUKŲ;18928851032;Taip;0;2;1;3
7411;Pumpurėlis;KODĖLČIUKŲ;9224879966;Taip;5;8;0;13
7412;Pumpurėlis;KODĖLČIUKŲ;1188314397;Taip;4;0;0;4
7413;Pumpurėlis;KODĖLČIUKŲ;2468796972;Taip;0;6;0;6
7414;Pumpurėlis;KODĖLČIUKŲ;8830261792;Taip;1;1;0;2
7415;Pumpurėlis;KODĖLČIUKŲ;9583257172;Taip;6;3;0;9
7416;Pumpurėlis;KODĖLČIUKŲ;9138883172;Taip;5;0;0;5
7417;Pumpurėlis;KODĖLČIUKŲ;7533555059;Taip;10;12;0;22
7418;Pumpurėlis;KODĖLČIUKŲ;6669327226;Taip;0;10;0;10
7419;Pumpurėlis;KODĖLČIUKŲ;13952236905;Taip;5;0;0;5
7420;Pumpurėlis;KODĖLČIUKŲ;87061817106;Taip;6;1;0;7
7421;Pumpurėlis;KODĖLČIUKŲ;30267173981;Taip;2;0;0;2
7422;Pumpurėlis;KODĖLČIUKŲ;1835168438;Taip;6;1;0;7
7423;Pumpurėlis;KODĖLČIUKŲ;5615260965;Taip;1;0;0;1
7424;Pumpurėlis;KODĖLČIUKŲ;4344595328;Taip;0;3;0;3
7425;Pumpurėlis;KODĖLČIUKŲ;3298821054;Taip;9;0;1;10
7426;Pumpurėlis;KODĖLČIUKŲ;8806961007;Taip;10;0;0;10
7427;Pumpurėlis;KODĖLČIUKŲ;9439363363;Taip;5;0;0;5
7428;Pumpurėlis;KODĖLČIUKŲ;5964953923;Taip;0;0;6;6
7429;Pumpurėlis;KODĖLČIUKŲ;1492810528;Ne;10;0;4;14
7430;Pumpurėlis;KODĖLČIUKŲ;7566451857;Taip;14;0;0;14
7431;Pumpurėlis;LINELIS;1320618070;Taip;5;0;0;5
7432;Pumpurėlis;LINELIS;42874947682;Taip;3;0;0;3
7433;Pumpurėlis;LINELIS;90214423899;Taip;0;2;0;2
7434;Pumpurėlis;LINELIS;79993170267;Taip;0;1;0;1
7435;Pumpurėlis;LINELIS;79842160701;Ne;5;0;0;5
7436;Pumpurėlis;LINELIS;98941059894;Ne;0;2;0;2
7437;Pumpurėlis;LINELIS;22232669189;Taip;0;4;0;4
7438;Pumpurėlis;LINELIS;65556407758;Taip;11;5;0;16
7439;Pumpurėlis;LINELIS;50662453283;Taip;5;2;0;7
7440;Pumpurėlis;LINELIS;5626656132;Taip;5;5;0;10
7441;Pumpurėlis;LINELIS;39148007125;Taip;0;1;0;1
7442;Pumpurėlis;LINELIS;8916669921;Taip;0;8;0;8
7443;Pumpurėlis;LINELIS;79813871981;Ne;6;2;0;8
7444;Pumpurėlis;LINELIS;24135602993;Taip;3;1;0;4
7445;Pumpurėlis;LINELIS;99841176399;Taip;7;2;0;9
7446;Pumpurėlis;LINELIS;1890693598;Taip;0;2;0;2
7447;Pumpurėlis;LINELIS;57455327823;Ne;0;12;0;12
7448;Pumpurėlis;LINELIS;5956784613;Taip;6;12;0;18
7449;Pumpurėlis;SAULUTĖS;73683690800;Taip;0;7;0;7
7450;Pumpurėlis;SAULUTĖS;45898175544;Taip;0;13;0;13
7451;Pumpurėlis;SAULUTĖS;49696660115;Taip;0;5;0;5
7452;Pumpurėlis;SAULUTĖS;24927191443;Taip;0;9;0;9
7453;Pumpurėlis;SAULUTĖS;57225404439;Taip;0;1;0;1
7454;Pumpurėlis;SAULUTĖS;76081690528;Taip;0;2;0;2
7455;Pumpurėlis;SAULUTĖS;76467622234;Taip;0;10;0;10
7456;Pumpurėlis;SAULUTĖS;89004303712;Taip;0;4;0;4
7457;Pumpurėlis;SAULUTĖS;32946314312;Taip;0;0;4;4
7458;Pumpurėlis;SAULUTĖS;50292067501;Taip;0;6;0;6
7459;Pumpurėlis;SAULUTĖS;91231481674;Taip;0;10;0;10
7460;Pumpurėlis;SAULUTĖS;77106733982;Taip;0;1;4;5
7461;Pumpurėlis;SAULUTĖS;25796704653;Taip;0;1;0;1
7462;Pumpurėlis;SAULUTĖS;73862556514;Ne;0;3;0;3
7463;Pumpurėlis;SAULUTĖS;96528992638;Taip;5;1;0;6
7464;Pumpurėlis;SAULUTĖS;86392525702;Taip;0;1;1;2
7465;Pumpurėlis;BITUTĖS;2028515310;Taip;4;2;0;6
7466;Pumpurėlis;BITUTĖS;44982629856;Taip;0;1;2;3
7467;Pumpurėlis;BITUTĖS;1333429949;Taip;8;0;0;8
7468;Pumpurėlis;BITUTĖS;8747439652;Taip;7;0;0;7
7469;Pumpurėlis;BITUTĖS;92238719397;Taip;5;1;0;6
7470;Pumpurėlis;BITUTĖS;1400057487;Taip;0;0;6;6
7471;Pumpurėlis;BITUTĖS;1274293175;Taip;5;1;2;8
7472;Pumpurėlis;BITUTĖS;93809482039;Taip;3;0;0;3
7473;Pumpurėlis;BITUTĖS;7786926187;Taip;2;1;0;3
7474;Pumpurėlis;BITUTĖS;74144468541;Taip;0;1;0;1
7475;Pumpurėlis;BITUTĖS;1640573725;Taip;15;1;0;16
7476;Pumpurėlis;BITUTĖS;1473237607;Taip;0;0;6;6
7477;Pumpurėlis;BITUTĖS;71979455611;Taip;0;7;0;7
7478;Pumpurėlis;BITUTĖS;1001114367;Taip;0;1;1;2
7479;Pumpurėlis;BITUTĖS;26859673794;Taip;10;6;0;16
7480;Pumpurėlis;BITUTĖS;72719147901;Taip;6;3;0;9
7481;Pumpurėlis;BITUTĖS;1527144198;Taip;5;2;0;7
7482;Pumpurėlis;BITUTĖS;57949968899;Taip;5;1;0;6
7483;Pumpurėlis;BITUTĖS;1298302188;Taip;3;0;0;3
7484;Pumpurėlis;BITUTĖS;1255753542;Ne;15;0;0;15
7485;Pumpurėlis;DOBILIUKAI;1273831078;Taip;0;10;0;10
7486;Pumpurėlis;DOBILIUKAI;1264017142;Taip;0;0;9;9
7487;Pumpurėlis;DOBILIUKAI;1439043505;Taip;0;2;0;2
7488;Pumpurėlis;DOBILIUKAI;1287902351;Taip;0;3;0;3
7489;Pumpurėlis;DOBILIUKAI;13358453137;Taip;4;1;0;5
7490;Pumpurėlis;DOBILIUKAI;1867989314;Taip;0;1;0;1
7491;Pumpurėlis;DOBILIUKAI;1209654095;Taip;5;0;1;6
7492;Pumpurėlis;DOBILIUKAI;40267078306;Taip;14;0;0;14
7493;Pumpurėlis;DOBILIUKAI;51793437519;Taip;0;1;0;1
7494;Pumpurėlis;DOBILIUKAI;1319664504;Taip;10;0;2;12
7495;Pumpurėlis;DOBILIUKAI;1055683170;Taip;0;4;0;4
7496;Pumpurėlis;DOBILIUKAI;1620037477;Taip;0;10;0;10
7497;Pumpurėlis;DOBILIUKAI;1307929787;Taip;0;2;0;2
7498;Pumpurėlis;DOBILIUKAI;1511761574;Taip;0;8;0;8
7499;Pumpurėlis;DOBILIUKAI;1346602122;Taip;1;7;0;8
7500;Pumpurėlis;DOBILIUKAI;1469189392;Taip;15;0;7;22
7501;Pumpurėlis;DOBILIUKAI;94636926281;Taip;5;0;3;8
7502;Pumpurėlis;DOBILIUKAI;1027125361;Taip;0;2;1;3
7503;Pumpurėlis;PUPYČIŲ;3733509497;Taip;6;0;0;6
7504;Pumpurėlis;PUPYČIŲ;9612924972;Taip;5;0;1;6
7505;Pumpurėlis;PUPYČIŲ;9884099545;Taip;11;0;0;11
7506;Pumpurėlis;PUPYČIŲ;8258560345;Taip;0;0;15;15
7507;Pumpurėlis;PUPYČIŲ;1687770779;Ne;14;0;0;14
7508;Pumpurėlis;PUPYČIŲ;5196733185;Taip;3;3;0;6
7509;Pumpurėlis;PUPYČIŲ;2668855786;Taip;11;8;0;19
7510;Pumpurėlis;PUPYČIŲ;4928495108;Taip;0;5;0;5
7511;Pumpurėlis;PUPYČIŲ;8886730333;Taip;10;7;0;17
7512;Pumpurėlis;PUPYČIŲ;5438584331;Taip;8;1;0;9
7513;Pumpurėlis;PUPYČIŲ;7160091629;Taip;13;0;0;13
7514;Pumpurėlis;PUPYČIŲ;3893768713;Taip;0;4;0;4
7515;Pumpurėlis;PUPYČIŲ;3101133244;Taip;11;1;0;12
7516;Pumpurėlis;PUPYČIŲ;4508966729;Taip;5;4;0;9
7517;Pumpurėlis;PUPYČIŲ;4451898302;Taip;12;0;6;18
7518;Pumpurėlis;PUPYČIŲ;5023658988;Ne;0;12;0;12
7519;Pumpurėlis;PUPYČIŲ;9552913910;Taip;0;0;7;7
7520;Pumpurėlis;ŽIRNIUKŲ;4985045047;Taip;2;0;0;2
7521;Pumpurėlis;ŽIRNIUKŲ;7610949816;Taip;8;0;0;8
7522;Pumpurėlis;ŽIRNIUKŲ;3405169131;Taip;5;0;10;15
7523;Pumpurėlis;ŽIRNIUKŲ;6977710645;Taip;17;0;0;17
7524;Pumpurėlis;ŽIRNIUKŲ;9431295796;Taip;16;0;0;16
7525;Pumpurėlis;ŽIRNIUKŲ;1395380236;Taip;10;0;0;10
7526;Pumpurėlis;ŽIRNIUKŲ;9424449290;Ne;0;0;11;11
7527;Pumpurėlis;ŽIRNIUKŲ;6955168163;Taip;12;0;0;12
7528;Pumpurėlis;ŽIRNIUKŲ;7229289985;Taip;0;7;0;7
7529;Pumpurėlis;ŽIRNIUKŲ;1674341906;Ne;2;0;0;2
7530;Pumpurėlis;ŽIRNIUKŲ;5663147778;Taip;12;0;0;12
7531;Pumpurėlis;ŽIRNIUKŲ;8373105196;Taip;9;2;0;11
7532;Pumpurėlis;ŽIRNIUKŲ;6165833101;Taip;2;9;0;11
7533;Pumpurėlis;ŽIRNIUKŲ;9726028397;Taip;0;3;0;3
7534;Pumpurėlis;ŽIRNIUKŲ;5171198109;Taip;0;8;0;8
7535;Pumpurėlis;ŽIRNIUKŲ;2969734731;Taip;5;0;0;5
7536;Pumpurėlis;BORUŽĖLIŲ;42611228425;Taip;0;9;1;10
7537;Pumpurėlis;BORUŽĖLIŲ;68035717481;Taip;0;12;0;12
7538;Pumpurėlis;BORUŽĖLIŲ;1594436797;Taip;0;0;1;1
7539;Pumpurėlis;BORUŽĖLIŲ;1568701327;Ne;7;0;2;9
7540;Pumpurėlis;BORUŽĖLIŲ;1842097360;Ne;0;0;5;5
7541;Pumpurėlis;BORUŽĖLIŲ;82659096039;Taip;0;1;0;1
7542;Pumpurėlis;BORUŽĖLIŲ;1098875585;Taip;4;1;0;5
7543;Pumpurėlis;BORUŽĖLIŲ;1617303626;Taip;7;0;0;7
7544;Pumpurėlis;BORUŽĖLIŲ;1306102772;Taip;9;0;0;9
7545;Pumpurėlis;BORUŽĖLIŲ;1075914140;Taip;0;0;1;1
7546;Pumpurėlis;BORUŽĖLIŲ;2345116167;Taip;0;4;0;4
7547;Pumpurėlis;BORUŽĖLIŲ;63610860077;Taip;0;8;0;8
7548;Pumpurėlis;BORUŽĖLIŲ;1257222112;Ne;10;0;2;12
7549;Pumpurėlis;BORUŽĖLIŲ;1508245418;Ne;0;3;0;3
7550;Pumpurėlis;BORUŽĖLIŲ;81595634697;Taip;5;0;0;5
7551;Pumpurėlis;BORUŽĖLIŲ;1061975374;Taip;0;1;0;1
7552;Pumpurėlis;BORUŽĖLIŲ;9579497944;Taip;0;0;1;1
7553;Puriena;Ančiukų;73312316742;Taip;0;0;1;1
7554;Puriena;Ančiukų;90765300922;Taip;5;7;1;13
7555;Puriena;Ančiukų;54803470430;Taip;0;2;0;2
7556;Puriena;Ančiukų;27321768851;Taip;0;2;1;3
7557;Puriena;Ančiukų;17378740941;Taip;0;0;3;3
7558;Puriena;Ančiukų;58363113692;Taip;0;0;1;1
7559;Puriena;Ančiukų;78566741895;Taip;0;3;0;3
7560;Puriena;Ančiukų;69902514699;Taip;0;3;0;3
7561;Puriena;Ančiukų;54723251890;Taip;5;2;0;7
7562;Puriena;Ančiukų;54181308247;Taip;0;11;0;11
7563;Puriena;Ančiukų;86174474927;Taip;0;2;0;2
7564;Puriena;Ančiukų;85013789582;Ne;0;13;0;13
7565;Puriena;Ančiukų;93516016900;Ne;2;2;1;5
7566;Puriena;Ančiukų;61259599767;Taip;0;2;0;2
7567;Puriena;Ančiukų;84757305442;Taip;0;0;7;7
7568;Puriena;Ančiukų;50171510736;Taip;0;0;5;5
7569;Puriena;Ančiukų;48507270084;Taip;0;0;7;7
7570;Puriena;Ančiukų;88268169404;Taip;0;2;0;2
7571;Puriena;Ančiukų;9440991851;Taip;0;0;1;1
7572;Puriena;Ančiukų;1394510964;Taip;0;3;0;3
7573;Puriena;Ančiukų;73970752510;Taip;2;2;2;6
7574;Puriena;Drugeliai;7337038503;Taip;6;2;0;8
7575;Puriena;Drugeliai;47316276655;Taip;13;0;0;13
7576;Puriena;Drugeliai;20286870431;Taip;5;3;0;8
7577;Puriena;Drugeliai;63196502622;Taip;7;0;2;9
7578;Puriena;Drugeliai;11497629767;Taip;14;2;0;16
7579;Puriena;Drugeliai;2146036332;Taip;8;0;0;8
7580;Puriena;Drugeliai;1142929858;Taip;3;0;6;9
7581;Puriena;Drugeliai;1443945321;Taip;0;0;1;1
7582;Puriena;Drugeliai;1703078658;Taip;0;0;1;1
7583;Puriena;Drugeliai;2083071198;Taip;5;9;0;14
7584;Puriena;Drugeliai;8213725698;Taip;5;0;0;5
7585;Puriena;Drugeliai;2378865002;Taip;5;2;3;10
7586;Puriena;Drugeliai;5891404983;Ne;0;2;4;6
7587;Puriena;Drugeliai;9239618299;Taip;0;15;2;17
7588;Puriena;Drugeliai;2089174669;Taip;0;2;0;2
7589;Puriena;Drugeliai;2131343339;Taip;0;2;0;2
7590;Puriena;Drugeliai;1748337587;Taip;3;3;0;6
7591;Puriena;Drugeliai;1030958414;Taip;8;0;0;8
7592;Puriena;Drugeliai;8618298134;Taip;1;0;12;13
7593;Puriena;Drugeliai;8707076857;Taip;2;0;0;2
7594;Puriena;Drugeliai;1820719083;Taip;10;0;2;12
7595;Puriena;Drugeliai;4394023057;Taip;0;9;0;9
7596;Puriena;Pelėdžiukai;11431481909;Taip;8;0;0;8
7597;Puriena;Pelėdžiukai;53451774513;Taip;0;16;0;16
7598;Puriena;Pelėdžiukai;12499791115;Taip;0;2;0;2
7599;Puriena;Pelėdžiukai;54048579160;Taip;0;11;0;11
7600;Puriena;Pelėdžiukai;43490363874;Taip;0;10;0;10
7601;Puriena;Pelėdžiukai;34689084311;Taip;10;0;0;10
7602;Puriena;Pelėdžiukai;21611180390;Taip;0;3;0;3
7603;Puriena;Pelėdžiukai;15016729899;Taip;0;3;0;3
7604;Puriena;Pelėdžiukai;11677252767;Taip;0;5;0;5
7605;Puriena;Pelėdžiukai;16437608299;Taip;0;12;0;12
7606;Puriena;Pelėdžiukai;69494886505;Taip;0;6;0;6
7607;Puriena;Pelėdžiukai;95972862152;Taip;10;0;0;10
7608;Puriena;Pelėdžiukai;51874022935;Taip;0;3;0;3
7609;Puriena;Pelėdžiukai;58791977007;Taip;0;1;0;1
7610;Puriena;Pelėdžiukai;53286108187;Taip;0;2;0;2
7611;Puriena;Pelėdžiukai;81806945761;Taip;0;6;0;6
7612;Puriena;Pelėdžiukai;26040866189;Taip;0;1;0;1
7613;Puriena;Pelėdžiukai;90508354565;Taip;4;0;0;4
7614;Puriena;Pelėdžiukai;95822432988;Taip;4;0;0;4
7615;Puriena;Pelėdžiukai;45627148409;Taip;4;4;0;8
7616;Puriena;Voveriukai;23746358787;Taip;5;1;0;6
7617;Puriena;Voveriukai;6285846517;Taip;0;1;0;1
7618;Puriena;Voveriukai;5501308683;Ne;7;2;0;9
7619;Puriena;Voveriukai;1263637124;Taip;13;2;0;15
7620;Puriena;Voveriukai;1290933817;Taip;0;2;1;3
7621;Puriena;Voveriukai;7429832136;Taip;5;2;1;8
7622;Puriena;Voveriukai;4966293604;Taip;0;1;0;1
7623;Puriena;Voveriukai;2203259310;Taip;0;0;5;5
7624;Puriena;Voveriukai;40573980976;Taip;0;7;0;7
7625;Puriena;Voveriukai;1381379515;Taip;10;0;0;10
7626;Puriena;Voveriukai;6057477307;Taip;0;4;0;4
7627;Puriena;Voveriukai;1290962809;Taip;19;1;0;20
7628;Puriena;Voveriukai;11242620566;Ne;0;2;0;2
7629;Puriena;Voveriukai;9139110598;Taip;10;1;0;11
7630;Puriena;Voveriukai;9106525954;Taip;3;2;0;5
7631;Puriena;Voveriukai;5999564879;Ne;5;0;0;5
7632;Puriena;Voveriukai;6053657231;Taip;0;6;0;6
7633;Puriena;Voveriukai;9146447088;Taip;0;0;1;1
7634;Puriena;Voveriukai;8478901457;Taip;0;0;3;3
7635;Puriena;Bitučių;77708842205;Taip;0;2;0;2
7636;Puriena;Bitučių;67031288256;Taip;0;7;0;7
7637;Puriena;Bitučių;11169417266;Ne;0;5;0;5
7638;Puriena;Bitučių;45287018563;Taip;0;2;2;4
7639;Puriena;Bitučių;3538587188;Taip;0;1;0;1
7640;Puriena;Bitučių;17841197680;Taip;0;2;0;2
7641;Puriena;Bitučių;25813179990;Ne;6;0;9;15
7642;Puriena;Bitučių;59762352185;Taip;0;2;0;2
7643;Puriena;Bitučių;87462824319;Taip;0;5;0;5
7644;Puriena;Bitučių;6794972162;Taip;0;2;0;2
7645;Puriena;Bitučių;33307762315;Taip;0;0;1;1
7646;Puriena;Bitučių;65319170607;Taip;0;2;0;2
7647;Puriena;Bitučių;55441324338;Taip;0;3;0;3
7648;Puriena;Bitučių;10701053444;Taip;0;2;1;3
7649;Puriena;Bitučių;10530139834;Taip;13;1;0;14
7650;Puriena;Bitučių;85386780648;Taip;5;0;0;5
7651;Puriena;Bitučių;38994996491;Taip;0;1;0;1
7652;Puriena;Bitučių;65910898731;Taip;0;0;3;3
7653;Puriena;Bitučių;3883844676;Taip;0;6;0;6
7654;Puriena;Zylutės;29931607789;Ne;0;2;0;2
7655;Puriena;Zylutės;5920910288;Taip;0;2;0;2
7656;Puriena;Zylutės;14052847763;Taip;4;7;0;11
7657;Puriena;Zylutės;46510003255;Taip;0;5;0;5
7658;Puriena;Zylutės;64733952400;Taip;0;4;0;4
7659;Puriena;Zylutės;1993142891;Taip;7;3;0;10
7660;Puriena;Zylutės;6539425730;Taip;13;5;0;18
7661;Puriena;Zylutės;61706928693;Taip;0;13;0;13
7662;Puriena;Zylutės;45128021817;Taip;13;0;0;13
7663;Puriena;Zylutės;7285127722;Ne;0;1;0;1
7664;Puriena;Zylutės;63953968050;Ne;0;3;0;3
7665;Puriena;Zylutės;87711542948;Taip;0;2;0;2
7666;Puriena;Zylutės;50199557129;Taip;15;0;0;15
7667;Puriena;Zylutės;88595039240;Ne;5;5;0;10
7668;Puriena;Zylutės;65137815385;Taip;0;1;0;1
7669;Puriena;Zylutės;54604607448;Taip;7;3;0;10
7670;Puriena;Zylutės;1994224209;Taip;0;4;0;4
7671;Puriena;Zylutės;27546501673;Taip;0;2;0;2
7672;Puriena;Meškučių;1758690169;Taip;22;0;0;22
7673;Puriena;Meškučių;1240190350;Taip;0;2;2;4
7674;Puriena;Meškučių;19157486407;Taip;0;2;1;3
7675;Puriena;Meškučių;1557814435;Taip;0;2;1;3
7676;Puriena;Meškučių;87523460146;Taip;3;0;0;3
7677;Puriena;Meškučių;61241768982;Taip;19;0;0;19
7678;Puriena;Meškučių;26980342372;Taip;9;0;0;9
7679;Puriena;Meškučių;4260334053;Taip;0;10;0;10
7680;Puriena;Meškučių;83821680276;Taip;10;0;4;14
7681;Puriena;Meškučių;71778035373;Taip;0;12;0;12
7682;Puriena;Meškučių;1184946421;Taip;0;2;0;2
7683;Puriena;Meškučių;61117212576;Taip;0;0;3;3
7684;Puriena;Meškučių;59193676476;Taip;0;7;0;7
7685;Puriena;Meškučių;91069175088;Taip;8;0;0;8
7686;Puriena;Meškučių;16572830524;Taip;0;1;0;1
7687;Puriena;Meškučių;18592085188;Taip;10;0;0;10
7688;Puriena;Meškučių;3327714361;Taip;6;0;1;7
7689;Puriena;Meškučių;1418776789;Ne;3;0;0;3
7690;Puriena;Nykštukų;71773966341;Taip;0;0;5;5
7691;Puriena;Nykštukų;85334594528;Taip;0;1;0;1
7692;Puriena;Nykštukų;1945542034;Taip;0;2;0;2
7693;Puriena;Nykštukų;79194353091;Taip;10;2;0;12
7694;Puriena;Nykštukų;1629458651;Taip;7;1;0;8
7695;Puriena;Nykštukų;91735621242;Taip;10;1;0;11
7696;Puriena;Nykštukų;5284316470;Taip;2;1;0;3
7697;Puriena;Nykštukų;1116529845;Taip;0;1;0;1
7698;Puriena;Nykštukų;8719239663;Taip;2;1;0;3
7699;Puriena;Nykštukų;1206969296;Taip;0;0;8;8
7700;Puriena;Nykštukų;84527348236;Ne;7;0;0;7
7701;Puriena;Nykštukų;24572685191;Taip;0;0;5;5
7702;Puriena;Nykštukų;95153406240;Taip;0;2;0;2
7703;Puriena;Nykštukų;1125102675;Taip;5;1;0;6
7704;Puriena;Nykštukų;29217326976;Taip;10;5;0;15
7705;Puriena;Nykštukų;1507059980;Taip;0;5;0;5
7706;Puriena;Nykštukų;1376708741;Taip;0;1;0;1
7707;Puriena;Ežiukai;1900570261;Taip;0;2;3;5
7708;Puriena;Ežiukai;1704296685;Taip;9;2;0;11
7709;Puriena;Ežiukai;1174355613;Taip;6;0;4;10
7710;Puriena;Ežiukai;2255508780;Taip;3;3;0;6
7711;Puriena;Ežiukai;35226601932;Taip;4;3;1;8
7712;Puriena;Ežiukai;2072874096;Taip;0;2;1;3
7713;Puriena;Ežiukai;11011727269;Taip;0;5;0;5
7714;Puriena;Ežiukai;87416314075;Taip;0;7;5;12
7715;Puriena;Ežiukai;1175577834;Taip;0;0;15;15
7716;Puriena;Ežiukai;1134539790;Taip;0;0;1;1
7717;Puriena;Ežiukai;8852985927;Taip;0;3;0;3
7718;Puriena;Ežiukai;9471669903;Taip;1;2;1;4
7719;Puriena;Ežiukai;1707413291;Taip;5;9;0;14
7720;Puriena;Ežiukai;1773431155;Taip;1;4;0;5
7721;Puriena;Ežiukai;1379084331;Taip;0;0;3;3
7722;Puriena;Ežiukai;21180207545;Taip;0;0;6;6
7723;Puriena;Ežiukai;1762395617;Taip;0;9;0;9
7724;Puriena;Ežiukai;2560477213;Taip;0;5;0;5
7725;Puriena;Ežiukai;1786569222;Taip;0;7;3;10
7726;Puriena;Ežiukai;41863686552;Taip;0;2;0;2
7727;Puriena;"Boružiukų ";3033562627;Taip;0;2;0;2
7728;Puriena;"Boružiukų ";5777076971;Taip;0;2;1;3
7729;Puriena;"Boružiukų ";3557013127;Taip;0;1;0;1
7730;Puriena;"Boružiukų ";7769252165;Taip;0;2;0;2
7731;Puriena;"Boružiukų ";2170025682;Taip;5;0;0;5
7732;Puriena;"Boružiukų ";1428098802;Taip;0;4;0;4
7733;Puriena;"Boružiukų ";3772941726;Taip;0;4;0;4
7734;Puriena;"Boružiukų ";4460575818;Taip;7;9;0;16
7735;Puriena;"Boružiukų ";4605662701;Taip;5;9;0;14
7736;Puriena;"Boružiukų ";8120597514;Taip;0;9;0;9
7737;Puriena;"Boružiukų ";4776745276;Taip;0;0;22;22
7738;Puriena;"Boružiukų ";6158842119;Taip;13;4;0;17
7739;Puriena;"Boružiukų ";3681811493;Taip;15;0;0;15
7740;Puriena;"Boružiukų ";4060087185;Taip;0;11;0;11
7741;Puriena;"Boružiukų ";8310231540;Taip;0;7;0;7
7742;Puriena;"Boružiukų ";1819876614;Taip;12;2;3;17
7743;Puriena;"Zuikučių ";6883573289;Taip;7;0;1;8
7744;Puriena;"Zuikučių ";1339162214;Taip;20;1;0;21
7745;Puriena;"Zuikučių ";4283608124;Taip;6;0;6;12
7746;Puriena;"Zuikučių ";8130975863;Taip;5;0;0;5
7747;Puriena;"Zuikučių ";2813562677;Taip;0;7;0;7
7748;Puriena;"Zuikučių ";3542374463;Taip;7;2;0;9
7749;Puriena;"Zuikučių ";7573536525;Taip;0;2;2;4
7750;Puriena;"Zuikučių ";8022809059;Taip;12;0;0;12
7751;Puriena;"Zuikučių ";4498919764;Taip;5;0;2;7
7752;Puriena;"Zuikučių ";5395382717;Taip;9;3;0;12
7753;Puriena;"Zuikučių ";4444523140;Taip;13;0;0;13
7754;Puriena;"Zuikučių ";1933733714;Taip;8;12;2;22
7755;Puriena;"Zuikučių ";7622407056;Taip;0;8;0;8
7756;Puriena;"Zuikučių ";6150437624;Taip;5;5;0;10
7757;Puriena;"Zuikučių ";6813480086;Taip;9;0;0;9
7758;Puriena;"Zuikučių ";9854244405;Taip;15;0;1;16
7759;Pušaitė;Kodėlčiukai;62054870153;Taip;0;1;0;1
7760;Pušaitė;Kodėlčiukai;1972872969;Taip;0;22;0;22
7761;Pušaitė;Kodėlčiukai;1434600898;Ne;0;2;1;3
7762;Pušaitė;Kodėlčiukai;10978479164;Ne;0;5;2;7
7763;Pušaitė;Kodėlčiukai;92087943993;Ne;0;1;2;3
7764;Pušaitė;Kodėlčiukai;10391045958;Taip;0;4;0;4
7765;Pušaitė;Kodėlčiukai;51875651426;Taip;0;8;2;10
7766;Pušaitė;Kodėlčiukai;35587797387;Taip;0;5;0;5
7767;Pušaitė;Kodėlčiukai;36990708512;Taip;12;0;0;12
7768;Pušaitė;Kodėlčiukai;12300222260;Ne;0;1;1;2
7769;Pušaitė;Kodėlčiukai;37480908997;Taip;0;1;0;1
7770;Pušaitė;Kodėlčiukai;81773729142;Taip;0;0;4;4
7771;Pušaitė;Kodėlčiukai;2856902024;Taip;0;22;0;22
7772;Pušaitė;Kodėlčiukai;15593642938;Taip;0;4;2;6
7773;Pušaitė;Kodėlčiukai;10955132610;Taip;0;0;3;3
7774;Pušaitė;Kodėlčiukai;7680945149;Taip;0;2;0;2
7775;Pušaitė;Kodėlčiukai;1611231114;Taip;0;0;10;10
7776;Pušaitė;Kodėlčiukai;89687717250;Taip;0;1;3;4
7777;Pušaitė;Kodėlčiukai;36677285052;Taip;0;1;0;1
7778;Pušaitė;Kodėlčiukai;3554790718;Taip;0;0;2;2
7779;Pušaitė;Kodėlčiukai;1912176781;Taip;0;8;0;8
7780;Pušaitė;Kodėlčiukai;20960105409;Taip;7;2;0;9
7781;Pušaitė;Kodėlčiukai;1444313482;Taip;0;1;0;1
7782;Pušaitė;Saulutės;1918948738;Taip;0;5;0;5
7783;Pušaitė;Saulutės;29899199427;Taip;0;5;0;5
7784;Pušaitė;Saulutės;36646217833;Taip;7;2;1;10
7785;Pušaitė;Saulutės;40449072854;Taip;5;1;0;6
7786;Pušaitė;Saulutės;46097491628;Taip;0;1;0;1
7787;Pušaitė;Saulutės;34210048269;Taip;0;8;0;8
7788;Pušaitė;Saulutės;2066639203;Taip;0;4;0;4
7789;Pušaitė;Saulutės;99740435577;Ne;0;1;0;1
7790;Pušaitė;Saulutės;88286687854;Taip;0;4;0;4
7791;Pušaitė;Saulutės;1302087452;Taip;0;2;2;4
7792;Pušaitė;Saulutės;12326544543;Taip;0;1;0;1
7793;Pušaitė;Saulutės;61624123734;Taip;4;6;0;10
7794;Pušaitė;Saulutės;10115195053;Taip;5;0;0;5
7795;Pušaitė;Saulutės;22491605433;Taip;0;2;0;2
7796;Pušaitė;Saulutės;81155033460;Taip;0;2;0;2
7797;Pušaitė;Saulutės;1389123203;Taip;0;0;1;1
7798;Pušaitė;Zuikučiai;2115591523;Taip;0;8;5;13
7799;Pušaitė;Zuikučiai;8738827821;Taip;0;0;7;7
7800;Pušaitė;Zuikučiai;2181510181;Taip;0;7;2;9
7801;Pušaitė;Zuikučiai;7477429922;Taip;0;5;0;5
7802;Pušaitė;Zuikučiai;6306133416;Taip;0;7;1;8
7803;Pušaitė;Zuikučiai;6355379926;Taip;10;0;10;20
7804;Pušaitė;Zuikučiai;9389544351;Taip;0;22;0;22
7805;Pušaitė;Zuikučiai;80743691769;Taip;6;0;0;6
7806;Pušaitė;Zuikučiai;1296700534;Taip;8;0;1;9
7807;Pušaitė;Zuikučiai;51500717235;Taip;10;0;0;10
7808;Pušaitė;Zuikučiai;2125574493;Ne;4;0;3;7
7809;Pušaitė;Zuikučiai;5398532705;Taip;0;11;0;11
7810;Pušaitė;Zuikučiai;8309000712;Taip;0;14;1;15
7811;Pušaitė;Zuikučiai;4881689337;Taip;5;0;1;6
7812;Pušaitė;Zuikučiai;3718196299;Taip;0;0;6;6
7813;Pušaitė;Zuikučiai;1295203136;Taip;7;0;0;7
7814;Pušaitė;Zuikučiai;3813761666;Ne;0;0;22;22
7815;Pušaitė;Zuikučiai;4762094720;Taip;0;1;0;1
7816;Pušaitė;Zuikučiai;6600314608;Taip;21;0;0;21
7817;Pušaitė;Vėžliukai;82156965570;Taip;0;4;0;4
7818;Pušaitė;Vėžliukai;23761715185;Taip;0;1;0;1
7819;Pušaitė;Vėžliukai;64592128211;Ne;0;6;0;6
7820;Pušaitė;Vėžliukai;1556107106;Taip;5;0;12;17
7821;Pušaitė;Vėžliukai;82231263639;Ne;6;0;0;6
7822;Pušaitė;Vėžliukai;2841816118;Taip;0;0;2;2
7823;Pušaitė;Vėžliukai;42099662246;Ne;0;2;0;2
7824;Pušaitė;Vėžliukai;18643269807;Taip;0;1;0;1
7825;Pušaitė;Vėžliukai;15673961087;Taip;0;2;0;2
7826;Pušaitė;Vėžliukai;57942390119;Ne;0;5;1;6
7827;Pušaitė;Vėžliukai;54773904854;Taip;0;2;1;3
7828;Pušaitė;Vėžliukai;24065238572;Ne;1;4;1;6
7829;Pušaitė;Vėžliukai;94185131317;Ne;0;0;5;5
7830;Pušaitė;Vėžliukai;49430231849;Taip;0;9;0;9
7831;Pušaitė;Vėžliukai;87253675662;Taip;0;1;0;1
7832;Pušaitė;Vėžliukai;2452682364;Taip;0;4;0;4
7833;Pušaitė;Vėžliukai;7097481136;Taip;4;0;2;6
7834;Pušaitė;"Linksmieji nykštukai";78786009806;Taip;0;7;0;7
7835;Pušaitė;"Linksmieji nykštukai";8716642556;Taip;6;0;0;6
7836;Pušaitė;"Linksmieji nykštukai";1195830679;Ne;0;2;3;5
7837;Pušaitė;"Linksmieji nykštukai";31633196136;Taip;0;4;0;4
7838;Pušaitė;"Linksmieji nykštukai";43153897720;Taip;4;1;0;5
7839;Pušaitė;"Linksmieji nykštukai";35461910180;Taip;0;4;0;4
7840;Pušaitė;"Linksmieji nykštukai";3093517968;Ne;0;11;0;11
7841;Pušaitė;"Linksmieji nykštukai";2060782612;Taip;0;10;0;10
7842;Pušaitė;"Linksmieji nykštukai";1877125294;Taip;0;0;2;2
7843;Pušaitė;"Linksmieji nykštukai";7827620759;Taip;0;2;0;2
7844;Pušaitė;"Linksmieji nykštukai";2725492842;Taip;6;0;1;7
7845;Pušaitė;"Kačiukų trobelė";1822282723;Taip;5;0;1;6
7846;Pušaitė;"Kačiukų trobelė";78247116817;Taip;0;0;2;2
7847;Pušaitė;"Kačiukų trobelė";16304995570;Taip;0;0;5;5
7848;Pušaitė;"Kačiukų trobelė";4007278281;Taip;0;1;1;2
7849;Pušaitė;"Kačiukų trobelė";48012145823;Taip;0;2;0;2
7850;Pušaitė;"Kačiukų trobelė";94141517569;Taip;7;2;0;9
7851;Pušaitė;"Kačiukų trobelė";50194950518;Ne;0;2;1;3
7852;Pušaitė;"Kačiukų trobelė";39697900885;Taip;0;0;2;2
7853;Pušaitė;"Kačiukų trobelė";48452579219;Taip;0;0;3;3
7854;Pušaitė;"Kačiukų trobelė";37954589328;Taip;5;0;1;6
7855;Pušaitė;"Kačiukų trobelė";75933088658;Ne;5;2;0;7
7856;Pušaitė;"Kačiukų trobelė";96861089842;Taip;0;5;0;5
7857;Pušaitė;"Kačiukų trobelė";1478137437;Ne;0;2;0;2
7858;Pušaitė;"Kačiukų trobelė";9124124056;Taip;0;0;7;7
7859;Pušaitė;"Kačiukų trobelė";7216538264;Taip;3;1;0;4
7860;Pušaitė;"Kačiukų trobelė";5534494766;Taip;0;5;0;5
7861;Pušaitė;"Kačiukų trobelė";5354874010;Taip;0;5;0;5
7862;Pušaitė;Ežiukai;3577616212;Taip;2;1;0;3
7863;Pušaitė;Ežiukai;2090143259;Taip;15;0;0;15
7864;Pušaitė;Ežiukai;9524002395;Taip;0;1;1;2
7865;Pušaitė;Ežiukai;7305350540;Taip;20;2;0;22
7866;Pušaitė;Ežiukai;1111143593;Taip;0;0;1;1
7867;Pušaitė;Ežiukai;15270671089;Taip;0;1;0;1
7868;Pušaitė;Ežiukai;1143122778;Taip;5;1;6;12
7869;Pušaitė;Ežiukai;9461292576;Taip;0;14;1;15
7870;Pušaitė;Ežiukai;4671293211;Taip;0;4;3;7
7871;Pušaitė;Ežiukai;8958364766;Taip;0;1;0;1
7872;Pušaitė;Ežiukai;7575143890;Taip;5;0;0;5
7873;Pušaitė;Ežiukai;7808186865;Taip;3;0;0;3
7874;Pušaitė;Ežiukai;5436168234;Taip;6;0;0;6
7875;Pušaitė;Ežiukai;8021494509;Taip;0;22;0;22
7876;Pušaitė;Ežiukai;2172342063;Taip;7;3;0;10
7877;Pušaitė;"Gudručių šalis";6470721291;Taip;0;2;0;2
7878;Pušaitė;"Gudručių šalis";15550007793;Taip;0;4;0;4
7879;Pušaitė;"Gudručių šalis";4386242143;Taip;4;2;2;8
7880;Pušaitė;"Gudručių šalis";9997642887;Taip;5;2;0;7
7881;Pušaitė;"Gudručių šalis";15546035138;Taip;2;2;0;4
7882;Pušaitė;"Gudručių šalis";79097991060;Taip;0;2;0;2
7883;Pušaitė;"Gudručių šalis";1275885492;Taip;0;2;0;2
7884;Pušaitė;"Gudručių šalis";40886746431;Taip;6;0;0;6
7885;Pušaitė;"Gudručių šalis";66025911973;Taip;0;12;0;12
7886;Pušaitė;"Gudručių šalis";90178990466;Taip;0;0;2;2
7887;Pušaitė;"Gudručių šalis";89985930634;Taip;13;1;0;14
7888;Pušaitė;"Gudručių šalis";4266368627;Ne;4;3;0;7
7889;Pušaitė;"Gudručių šalis";49973513385;Taip;0;3;0;3
7890;Pušaitė;"Gudručių šalis";66238819356;Taip;0;0;6;6
7891;Pušaitė;"Gudručių šalis";89212112638;Taip;0;2;4;6
7892;Pušaitė;"Gudručių šalis";11297426946;Taip;0;0;3;3
7893;Pušaitė;"Gudručių šalis";67365323950;Taip;0;1;0;1
7894;Pušaitė;"Gudručių šalis";35947321028;Taip;0;22;0;22
7895;Pušaitė;"Gudručių šalis";1459628106;Taip;3;2;2;7
7896;Pušaitė;"Gudručių šalis";87504481892;Ne;6;2;0;8
7897;Pušaitė;"Gudručių šalis";6915619931;Ne;6;2;0;8
7898;Pušaitė;"Lapučių mokyklėlė";1102988768;Taip;0;1;6;7
7899;Pušaitė;"Lapučių mokyklėlė";40417586835;Taip;0;10;2;12
7900;Pušaitė;"Lapučių mokyklėlė";91960884985;Taip;0;0;6;6
7901;Pušaitė;"Lapučių mokyklėlė";60394388920;Taip;0;1;3;4
7902;Pušaitė;"Lapučių mokyklėlė";85343380637;Taip;0;1;2;3
7903;Pušaitė;"Lapučių mokyklėlė";2044213583;Taip;0;22;0;22
7904;Pušaitė;"Lapučių mokyklėlė";1394847204;Taip;2;0;0;2
7905;Pušaitė;"Lapučių mokyklėlė";97778827111;Taip;0;2;5;7
7906;Pušaitė;"Lapučių mokyklėlė";13127077816;Taip;0;1;0;1
7907;Pušaitė;"Lapučių mokyklėlė";6667124375;Taip;3;0;0;3
7908;Pušaitė;"Lapučių mokyklėlė";71218084687;Taip;3;1;0;4
7909;Pušaitė;"Lapučių mokyklėlė";41026183089;Taip;5;0;0;5
7910;Pušaitė;"Lapučių mokyklėlė";53766202712;Taip;0;5;0;5
7911;Pušaitė;"Lapučių mokyklėlė";3231637165;Taip;7;0;0;7
7912;Pušaitė;"Lapučių mokyklėlė";6542917863;Taip;0;0;7;7
7913;Pušaitė;"VOVERIUKAI ";8438652029;Taip;0;0;1;1
7914;Pušaitė;"VOVERIUKAI ";4662871524;Taip;0;4;1;5
7915;Pušaitė;"VOVERIUKAI ";6323180798;Taip;2;0;1;3
7916;Pušaitė;"VOVERIUKAI ";5191894075;Taip;15;0;0;15
7917;Pušaitė;"VOVERIUKAI ";6180888008;Taip;0;1;6;7
7918;Pušaitė;"VOVERIUKAI ";9127444013;Taip;0;5;4;9
7919;Pušaitė;"VOVERIUKAI ";6578483902;Taip;13;3;0;16
7920;Pušaitė;"VOVERIUKAI ";3350461304;Ne;1;1;0;2
7921;Pušaitė;"VOVERIUKAI ";9313564235;Taip;8;0;0;8
7922;Pušaitė;"VOVERIUKAI ";1781601521;Taip;3;0;0;3
7923;Pušaitė;"VOVERIUKAI ";1024996364;Taip;0;0;4;4
7924;Pušaitė;"VOVERIUKAI ";1161519408;Taip;0;22;0;22
7925;Pušaitė;"VOVERIUKAI ";8822285103;Ne;2;0;1;3
7926;Pušaitė;MEŠKUČIAI;3695016765;Taip;9;7;0;16
7927;Pušaitė;MEŠKUČIAI;3195191374;Taip;2;1;1;4
7928;Pušaitė;MEŠKUČIAI;5104111840;Taip;7;0;0;7
7929;Pušaitė;MEŠKUČIAI;8702361596;Taip;3;0;0;3
7930;Pušaitė;MEŠKUČIAI;1122112207;Taip;0;9;2;11
7931;Pušaitė;MEŠKUČIAI;1624587173;Taip;0;0;3;3
7932;Pušaitė;MEŠKUČIAI;5415680731;Taip;0;22;0;22
7933;Pušaitė;MEŠKUČIAI;3014180020;Taip;5;0;0;5
7934;Pušaitė;MEŠKUČIAI;9327636862;Ne;0;4;1;5
7935;Pušaitė;MEŠKUČIAI;4175909754;Taip;0;1;1;2
7936;Pušaitė;MEŠKUČIAI;1635528919;Taip;5;0;2;7
7937;Pušaitė;MEŠKUČIAI;3788392895;Taip;4;0;1;5
7938;Pušaitė;MEŠKUČIAI;2837439334;Taip;0;22;0;22
7939;Pušaitė;MEŠKUČIAI;7014914682;Taip;12;0;0;12
7940;Pušaitė;PELIUKAI;9265357004;Taip;0;4;0;4
7941;Pušaitė;PELIUKAI;8793102437;Ne;4;5;0;9
7942;Pušaitė;PELIUKAI;3150144924;Taip;4;2;0;6
7943;Pušaitė;PELIUKAI;9390342572;Taip;13;1;0;14
7944;Pušaitė;PELIUKAI;9056933586;Taip;13;1;0;14
7945;Pušaitė;PELIUKAI;4517181474;Ne;5;2;0;7
7946;Pušaitė;PELIUKAI;9033615485;Taip;9;0;0;9
7947;Pušaitė;PELIUKAI;4605161267;Taip;17;1;0;18
7948;Pušaitė;PELIUKAI;4374232593;Taip;0;0;1;1
7949;Pušaitė;PELIUKAI;6160825713;Taip;12;0;2;14
7950;Pušaitė;PELIUKAI;7898355721;Taip;0;0;2;2
7951;Pušaitė;PELIUKAI;3698808100;Ne;11;1;0;12
7952;Pušynėlis;PUMPURĖLIAI;2048377076;Taip;9;0;1;10
7953;Pušynėlis;PUMPURĖLIAI;9665845150;Taip;0;4;0;4
7954;Pušynėlis;PUMPURĖLIAI;1817179601;Taip;9;7;0;16
7955;Pušynėlis;PUMPURĖLIAI;4030500100;Taip;5;0;0;5
7956;Pušynėlis;PUMPURĖLIAI;8172450090;Taip;5;0;0;5
7957;Pušynėlis;PUMPURĖLIAI;9466109315;Taip;0;0;2;2
7958;Pušynėlis;PUMPURĖLIAI;1573574250;Taip;0;1;0;1
7959;Pušynėlis;PUMPURĖLIAI;1284674882;Taip;0;9;0;9
7960;Pušynėlis;PUMPURĖLIAI;9039274775;Taip;10;0;3;13
7961;Pušynėlis;PUMPURĖLIAI;2012089695;Taip;4;5;0;9
7962;Pušynėlis;PUMPURĖLIAI;6077698697;Taip;0;0;4;4
7963;Pušynėlis;PUMPURĖLIAI;25261143142;Taip;0;2;0;2
7964;Pušynėlis;PUMPURĖLIAI;35538053975;Taip;1;1;0;2
7965;Pušynėlis;PUMPURĖLIAI;3510202379;Taip;6;0;9;15
7966;Pušynėlis;PUMPURĖLIAI;9154108688;Taip;14;0;1;15
7967;Pušynėlis;PUMPURĖLIAI;7046421581;Taip;3;0;2;5
7968;Pušynėlis;PUMPURĖLIAI;3037031809;Taip;0;0;2;2
7969;Pušynėlis;PUMPURĖLIAI;6716726918;Taip;0;16;0;16
7970;Pušynėlis;SAULUTĖS;1415916851;Taip;2;0;0;2
7971;Pušynėlis;SAULUTĖS;93484950406;Taip;6;0;10;16
7972;Pušynėlis;SAULUTĖS;91759717760;Taip;10;5;0;15
7973;Pušynėlis;SAULUTĖS;15555681471;Taip;0;0;4;4
7974;Pušynėlis;SAULUTĖS;2431940444;Taip;6;0;0;6
7975;Pušynėlis;SAULUTĖS;58252435610;Taip;0;0;4;4
7976;Pušynėlis;SAULUTĖS;75716791245;Taip;3;5;0;8
7977;Pušynėlis;SAULUTĖS;40478713455;Taip;0;9;0;9
7978;Pušynėlis;SAULUTĖS;39796631884;Taip;0;0;9;9
7979;Pušynėlis;SAULUTĖS;48050606382;Taip;0;1;0;1
7980;Pušynėlis;SAULUTĖS;79386112020;Taip;0;0;4;4
7981;Pušynėlis;SAULUTĖS;2042833795;Taip;6;1;0;7
7982;Pušynėlis;SAULUTĖS;74952593070;Taip;0;9;0;9
7983;Pušynėlis;SAULUTĖS;1610449906;Taip;4;0;0;4
7984;Pušynėlis;SAULUTĖS;51835639636;Taip;0;5;0;5
7985;Pušynėlis;SAULUTĖS;1863758087;Taip;0;1;0;1
7986;Pušynėlis;PRIEŠMOKYKLINĖ;45205911818;Ne;3;2;0;5
7987;Pušynėlis;PRIEŠMOKYKLINĖ;62127095103;Taip;0;2;0;2
7988;Pušynėlis;PRIEŠMOKYKLINĖ;72180767422;Taip;0;1;0;1
7989;Pušynėlis;PRIEŠMOKYKLINĖ;80673105992;Ne;0;6;0;6
7990;Pušynėlis;PRIEŠMOKYKLINĖ;1148988140;Taip;12;0;0;12
7991;Pušynėlis;PRIEŠMOKYKLINĖ;34354697329;Ne;0;4;0;4
7992;Pušynėlis;PRIEŠMOKYKLINĖ;6823339260;Taip;0;1;0;1
7993;Pušynėlis;PRIEŠMOKYKLINĖ;45123764353;Taip;0;6;0;6
7994;Pušynėlis;PRIEŠMOKYKLINĖ;23088088585;Taip;0;5;0;5
7995;Pušynėlis;PRIEŠMOKYKLINĖ;81276442183;Taip;0;0;4;4
7996;Pušynėlis;PRIEŠMOKYKLINĖ;53367560890;Taip;0;0;2;2
7997;Pušynėlis;PRIEŠMOKYKLINĖ;6577939120;Taip;0;0;1;1
7998;Pušynėlis;PRIEŠMOKYKLINĖ;21260292631;Taip;0;0;3;3
7999;Pušynėlis;PRIEŠMOKYKLINĖ;75612576422;Taip;1;4;0;5
8000;Pušynėlis;PRIEŠMOKYKLINĖ;24035278105;Taip;0;0;5;5
8001;Pušynėlis;PRIEŠMOKYKLINĖ;68201469907;Taip;0;0;3;3
8002;Pušynėlis;PRIEŠMOKYKLINĖ;61363661998;Ne;5;0;0;5
8003;Pušynėlis;PRIEŠMOKYKLINĖ;21082691040;Taip;0;1;0;1
8004;Pušynėlis;PRIEŠMOKYKLINĖ;1224747660;Taip;0;5;3;8
8005;Pušynėlis;PRIEŠMOKYKLINĖ;1071102465;Taip;10;0;0;10
8006;Pušynėlis;LOPŠELIS;2141785580;Taip;0;4;0;4
8007;Pušynėlis;LOPŠELIS;2793982816;Ne;6;2;2;10
8008;Pušynėlis;LOPŠELIS;1034336110;Taip;4;0;0;4
8009;Pušynėlis;LOPŠELIS;1610132076;Taip;0;0;1;1
8010;Pušynėlis;LOPŠELIS;3192818461;Taip;0;1;0;1
8011;Pušynėlis;LOPŠELIS;1164201286;Taip;0;2;0;2
8012;Pušynėlis;LOPŠELIS;4920818548;Taip;0;22;0;22
8013;Pušynėlis;LOPŠELIS;5236219294;Taip;4;0;0;4
8014;Pušynėlis;LOPŠELIS;6709692748;Taip;12;1;0;13
8015;Pušynėlis;LOPŠELIS;8799095053;Taip;0;1;0;1
8016;Pušynėlis;LOPŠELIS;5318223378;Taip;14;0;0;14
8017;Pušynėlis;LOPŠELIS;4052132379;Taip;8;0;0;8
8018;Pušynėlis;LOPŠELIS;8451160808;Ne;15;0;0;15
8019;Pušynėlis;LOPŠELIS;5897839636;Taip;0;4;0;4
8020;Raktelis;LAŠIUKAI;91578547534;Taip;2;0;0;2
8021;Raktelis;LAŠIUKAI;84902670203;Taip;0;1;0;1
8022;Raktelis;LAŠIUKAI;54911112924;Taip;0;2;1;3
8023;Raktelis;LAŠIUKAI;58035524929;Taip;0;4;0;4
8024;Raktelis;LAŠIUKAI;44697037907;Ne;2;2;8;12
8025;Raktelis;LAŠIUKAI;44404187711;Taip;0;2;0;2
8026;Raktelis;LAŠIUKAI;2586639003;Ne;0;2;1;3
8027;Raktelis;LAŠIUKAI;11398845304;Taip;0;2;0;2
8028;Raktelis;LAŠIUKAI;83327989096;Taip;2;2;0;4
8029;Raktelis;LAŠIUKAI;74848273145;Taip;0;5;0;5
8030;Raktelis;LAŠIUKAI;61588160544;Taip;0;2;1;3
8031;Raktelis;LAŠIUKAI;10029133549;Ne;0;2;1;3
8032;Raktelis;LAŠIUKAI;59965096201;Taip;0;1;5;6
8033;Raktelis;LAŠIUKAI;81622959801;Taip;0;6;0;6
8034;Raktelis;LAŠIUKAI;7486620978;Taip;0;9;0;9
8035;Raktelis;LAŠIUKAI;1090555980;Taip;0;3;0;3
8036;Raktelis;LAŠIUKAI;6358826871;Taip;1;3;0;4
8037;Raktelis;LAŠIUKAI;88714718433;Taip;0;4;1;5
8038;Raktelis;LAŠIUKAI;8495930552;Taip;12;1;0;13
8039;Raktelis;LAŠIUKAI;1508479097;Taip;2;1;0;3
8040;Raktelis;LAŠIUKAI;13722490194;Taip;0;4;0;4
8041;Raktelis;BITUTĖS;61636842808;Taip;0;0;1;1
8042;Raktelis;BITUTĖS;49216690763;Taip;6;0;4;10
8043;Raktelis;BITUTĖS;68578915107;Taip;0;4;1;5
8044;Raktelis;BITUTĖS;38068336379;Taip;0;0;1;1
8045;Raktelis;BITUTĖS;67716590566;Taip;0;2;0;2
8046;Raktelis;BITUTĖS;77068762851;Taip;0;0;2;2
8047;Raktelis;BITUTĖS;83366206408;Taip;0;2;0;2
8048;Raktelis;BITUTĖS;86120193313;Taip;0;0;3;3
8049;Raktelis;BITUTĖS;1224477393;Ne;0;5;0;5
8050;Raktelis;BITUTĖS;69445577844;Ne;0;1;0;1
8051;Raktelis;BITUTĖS;93797285418;Taip;0;2;0;2
8052;Raktelis;BITUTĖS;71909273139;Taip;0;0;1;1
8053;Raktelis;BITUTĖS;37587869107;Taip;0;3;0;3
8054;Raktelis;BITUTĖS;1544882634;Taip;0;2;0;2
8055;Raktelis;BITUTĖS;63051817818;Taip;0;2;1;3
8056;Raktelis;BITUTĖS;78841101231;Taip;3;0;1;4
8057;Raktelis;BITUTĖS;76758476679;Taip;0;0;2;2
8058;Raktelis;BITUTĖS;5663304735;Ne;0;2;0;2
8059;Raktelis;BITUTĖS;17270742947;Taip;0;7;0;7
8060;Raktelis;BITUTĖS;5392514118;Taip;7;2;5;14
8061;Raktelis;BITUTĖS;7048022562;Taip;0;1;0;1
8062;Raktelis;BITUTĖS;9774706725;Taip;1;0;0;1
8063;Raktelis;BORUŽĖLĖS;8117871963;Taip;0;0;11;11
8064;Raktelis;BORUŽĖLĖS;5031703240;Taip;0;2;0;2
8065;Raktelis;BORUŽĖLĖS;6049420030;Ne;0;6;1;7
8066;Raktelis;BORUŽĖLĖS;9313156299;Taip;5;2;0;7
8067;Raktelis;BORUŽĖLĖS;54221331553;Taip;3;2;0;5
8068;Raktelis;BORUŽĖLĖS;2070196225;Taip;0;12;0;12
8069;Raktelis;BORUŽĖLĖS;1192775994;Taip;6;5;0;11
8070;Raktelis;BORUŽĖLĖS;3609939325;Taip;0;0;2;2
8071;Raktelis;BORUŽĖLĖS;3345708690;Taip;5;1;0;6
8072;Raktelis;BORUŽĖLĖS;8245310502;Taip;22;0;0;22
8073;Raktelis;BORUŽĖLĖS;7487507324;Taip;0;1;0;1
8074;Raktelis;BORUŽĖLĖS;93271260871;Taip;6;7;0;13
8075;Raktelis;BORUŽĖLĖS;6779413882;Taip;22;0;0;22
8076;Raktelis;BORUŽĖLĖS;9584164290;Taip;0;10;0;10
8077;Raktelis;BORUŽĖLĖS;6854111162;Ne;0;5;0;5
8078;Raktelis;BORUŽĖLĖS;9348898875;Taip;0;1;0;1
8079;Raktelis;BORUŽĖLĖS;9053427316;Taip;0;1;1;2
8080;Raktelis;BORUŽĖLĖS;3762141936;Taip;3;2;0;5
8081;Raktelis;BORUŽĖLĖS;3713386556;Taip;5;7;0;12
8082;Raktelis;KAČIUKAI;8579864696;Ne;0;1;0;1
8083;Raktelis;KAČIUKAI;1393351147;Taip;0;3;1;4
8084;Raktelis;KAČIUKAI;27084497916;Taip;2;0;0;2
8085;Raktelis;KAČIUKAI;1063413424;Ne;0;8;0;8
8086;Raktelis;KAČIUKAI;4449411816;Taip;5;2;1;8
8087;Raktelis;KAČIUKAI;89139880068;Taip;0;3;0;3
8088;Raktelis;KAČIUKAI;1623046697;Taip;0;0;2;2
8089;Raktelis;KAČIUKAI;1468915955;Taip;0;1;0;1
8090;Raktelis;KAČIUKAI;21063882404;Ne;4;1;0;5
8091;Raktelis;KAČIUKAI;78145437124;Taip;1;0;0;1
8092;Raktelis;KAČIUKAI;2143998936;Taip;0;3;0;3
8093;Raktelis;KAČIUKAI;1957572199;Taip;0;0;1;1
8094;Raktelis;KAČIUKAI;4906678347;Taip;0;4;0;4
8095;Raktelis;KAČIUKAI;1567546511;Taip;2;15;0;17
8096;Raktelis;KAČIUKAI;9380332489;Taip;10;0;0;10
8097;Raktelis;KAČIUKAI;26727657814;Taip;0;2;1;3
8098;Raktelis;KAČIUKAI;30092089456;Taip;0;7;0;7
8099;Raktelis;KAČIUKAI;50372098009;Taip;0;5;0;5
8100;Raktelis;KAČIUKAI;1378192491;Taip;0;2;0;2
8101;Raktelis;KAČIUKAI;3180109604;Taip;17;0;0;17
8102;Raktelis;KAČIUKAI;1046075234;Taip;0;2;0;2
8103;Raktelis;KAČIUKAI;1457880868;Taip;22;0;0;22
8104;Raktelis;KAČIUKAI;4071338645;Taip;0;8;0;8
8105;Raktelis;KIŠKUČIAI;7170546710;Taip;5;15;0;20
8106;Raktelis;KIŠKUČIAI;1983808547;Taip;17;0;0;17
8107;Raktelis;KIŠKUČIAI;4905982507;Taip;22;0;0;22
8108;Raktelis;KIŠKUČIAI;6367875352;Taip;0;2;0;2
8109;Raktelis;KIŠKUČIAI;4317705126;Taip;5;4;0;9
8110;Raktelis;KIŠKUČIAI;1975411457;Ne;16;0;0;16
8111;Raktelis;KIŠKUČIAI;6199212999;Taip;0;7;0;7
8112;Raktelis;KIŠKUČIAI;2499890317;Taip;22;0;0;22
8113;Raktelis;KIŠKUČIAI;1843086151;Taip;0;2;0;2
8114;Raktelis;KIŠKUČIAI;1622504968;Taip;5;0;0;5
8115;Raktelis;KIŠKUČIAI;5405322552;Taip;7;0;2;9
8116;Raktelis;KIŠKUČIAI;6550851582;Taip;5;1;0;6
8117;Raktelis;KIŠKUČIAI;7334310944;Taip;8;2;0;10
8118;Raktelis;KIŠKUČIAI;5492437864;Taip;22;0;0;22
8119;Raktelis;KIŠKUČIAI;9779789133;Taip;5;3;1;9
8120;Raktelis;KIŠKUČIAI;6102196040;Taip;5;3;1;9
8121;Raktelis;NYKŠTUKAI;5627179884;Taip;0;0;1;1
8122;Raktelis;NYKŠTUKAI;6608224825;Taip;0;10;0;10
8123;Raktelis;NYKŠTUKAI;8873203690;Taip;0;2;0;2
8124;Raktelis;NYKŠTUKAI;2219712757;Ne;6;1;0;7
8125;Raktelis;NYKŠTUKAI;8456082594;Taip;0;1;0;1
8126;Raktelis;NYKŠTUKAI;2807100092;Taip;2;4;0;6
8127;Raktelis;NYKŠTUKAI;2753402906;Taip;0;2;0;2
8128;Raktelis;NYKŠTUKAI;9591285702;Taip;5;0;0;5
8129;Raktelis;NYKŠTUKAI;5925441742;Taip;5;0;0;5
8130;Raktelis;NYKŠTUKAI;6929358401;Taip;0;2;0;2
8131;Raktelis;NYKŠTUKAI;9593639791;Taip;0;9;0;9
8132;Raktelis;NYKŠTUKAI;9357757604;Taip;1;11;0;12
8133;Raktelis;NYKŠTUKAI;7973137015;Taip;7;9;0;16
8134;Raktelis;NYKŠTUKAI;7265543701;Taip;0;3;0;3
8135;Raktelis;NYKŠTUKAI;1392036584;Taip;0;1;0;1
8136;Raktelis;NYKŠTUKAI;8459980712;Taip;5;5;0;10
8137;Raktelis;PELIUKAI;4610536784;Taip;0;3;0;3
8138;Raktelis;PELIUKAI;1109105359;Ne;0;1;0;1
8139;Raktelis;PELIUKAI;8320696048;Taip;3;0;0;3
8140;Raktelis;PELIUKAI;1453677708;Taip;0;2;0;2
8141;Raktelis;PELIUKAI;3880578523;Taip;0;2;0;2
8142;Raktelis;PELIUKAI;4583377785;Taip;9;7;0;16
8143;Raktelis;PELIUKAI;9072312203;Taip;2;11;0;13
8144;Raktelis;PELIUKAI;6385127914;Taip;0;1;0;1
8145;Raktelis;PELIUKAI;1322912585;Taip;0;1;0;1
8146;Raktelis;PELIUKAI;4228614834;Taip;0;2;0;2
8147;Raktelis;PELIUKAI;4755892641;Taip;0;2;0;2
8148;Raktelis;PELIUKAI;8353427144;Taip;22;0;0;22
8149;Raktelis;PELIUKAI;5082785025;Taip;18;0;0;18
8150;Raktelis;PELIUKAI;7869495911;Taip;0;0;1;1
8151;Raktelis;PELIUKAI;9130613710;Taip;0;11;0;11
8152;Raktelis;PELIUKAI;8869030487;Taip;9;0;0;9
8153;Raktelis;AGUONOS;1453259901;Taip;14;0;1;15
8154;Raktelis;AGUONOS;66327590524;Taip;0;10;0;10
8155;Raktelis;AGUONOS;6935703343;Taip;0;2;0;2
8156;Raktelis;AGUONOS;54361317676;Taip;0;10;0;10
8157;Raktelis;AGUONOS;5430563880;Taip;0;2;2;4
8158;Raktelis;AGUONOS;25504804011;Ne;0;4;3;7
8159;Raktelis;AGUONOS;12333424396;Taip;0;1;0;1
8160;Raktelis;AGUONOS;30483797110;Taip;0;2;3;5
8161;Raktelis;AGUONOS;61367764807;Taip;4;0;2;6
8162;Raktelis;AGUONOS;24160611392;Taip;0;14;0;14
8163;Raktelis;AGUONOS;55504358470;Ne;0;12;0;12
8164;Raktelis;AGUONOS;34960672068;Taip;0;2;0;2
8165;Raktelis;AGUONOS;82549894936;Taip;0;6;0;6
8166;Raktelis;AGUONOS;874585350;Taip;0;2;4;6
8167;Raktelis;AGUONOS;79301972646;Taip;0;2;0;2
8168;Raktelis;AGUONOS;8796557675;Taip;18;0;0;18
8169;Raktelis;AGUONOS;1820583792;Taip;22;0;0;22
8170;Raktelis;AGUONOS;5711863758;Ne;6;0;1;7
8171;Raktelis;AGUONOS;1747834520;Taip;0;16;0;16
8172;Raktelis;AGUONOS;5000264125;Taip;4;4;0;8
8173;Raktelis;AGUONOS;53034039807;Taip;8;3;0;11
8174;Raktelis;AGUONOS;5802689482;Taip;10;4;0;14
8175;Raktelis;AGUONOS;6014726741;Taip;0;6;0;6
8176;Raktelis;LAPIUKŲ;8996622650;Taip;0;7;0;7
8177;Raktelis;LAPIUKŲ;51237034253;Ne;0;8;0;8
8178;Raktelis;LAPIUKŲ;1326855282;Taip;0;5;0;5
8179;Raktelis;LAPIUKŲ;92373834478;Ne;0;6;0;6
8180;Raktelis;LAPIUKŲ;77512682081;Taip;6;0;0;6
8181;Raktelis;LAPIUKŲ;68570148753;Taip;6;12;0;18
8182;Raktelis;LAPIUKŲ;27403835292;Taip;0;1;0;1
8183;Raktelis;LAPIUKŲ;10188975432;Taip;3;1;0;4
8184;Raktelis;LAPIUKŲ;14234831040;Taip;0;2;0;2
8185;Raktelis;LAPIUKŲ;15159708127;Taip;2;0;0;2
8186;Raktelis;LAPIUKŲ;43500434912;Taip;0;4;0;4
8187;Raktelis;LAPIUKŲ;9501202273;Taip;0;2;0;2
8188;Raktelis;LAPIUKŲ;67972824332;Taip;5;0;0;5
8189;Raktelis;LAPIUKŲ;54341630847;Taip;5;1;0;6
8190;Raktelis;LAPIUKŲ;1197826066;Taip;5;1;0;6
8191;Raktelis;LAPIUKŲ;5943583254;Taip;0;6;0;6
8192;Raktelis;LAPIUKŲ;4569798381;Taip;12;2;0;14
8193;Raktelis;LAPIUKŲ;1819514057;Ne;0;1;0;1
8194;Raktelis;LAPIUKŲ;67304194087;Taip;5;2;0;7
8195;Raktelis;LAPIUKŲ;15583558585;Taip;0;14;0;14
8196;Raktelis;PELĖDŽIUKAI;2985254060;Taip;2;0;1;3
8197;Raktelis;PELĖDŽIUKAI;59913848400;Ne;0;10;0;10
8198;Raktelis;PELĖDŽIUKAI;23688235312;Taip;0;6;0;6
8199;Raktelis;PELĖDŽIUKAI;68390568000;Taip;13;1;0;14
8200;Raktelis;PELĖDŽIUKAI;61890775725;Taip;0;2;2;4
8201;Raktelis;PELĖDŽIUKAI;26764160130;Taip;0;0;15;15
8202;Raktelis;PELĖDŽIUKAI;58513885211;Taip;0;6;0;6
8203;Raktelis;PELĖDŽIUKAI;75507005694;Taip;3;3;0;6
8204;Raktelis;PELĖDŽIUKAI;79109699217;Taip;2;2;0;4
8205;Raktelis;PELĖDŽIUKAI;11937575740;Taip;0;1;0;1
8206;Raktelis;PELĖDŽIUKAI;34216516886;Taip;2;0;0;2
8207;Raktelis;PELĖDŽIUKAI;15685936471;Taip;0;1;3;4
8208;Raktelis;PELĖDŽIUKAI;24221829774;Taip;5;2;2;9
8209;Raktelis;PELĖDŽIUKAI;57958699478;Taip;0;6;0;6
8210;Raktelis;PELĖDŽIUKAI;46587243900;Taip;0;2;0;2
8211;Raktelis;PELĖDŽIUKAI;18646642032;Taip;2;2;0;4
8212;Raktelis;PELĖDŽIUKAI;5914986262;Taip;0;5;0;5
8213;Raktelis;PELĖDŽIUKAI;48454225305;Taip;0;5;0;5
8214;Raktelis;PELĖDŽIUKAI;32913698258;Taip;0;0;5;5
8215;Raktelis;PELĖDŽIUKAI;67378900057;Ne;0;0;1;1
8216;Raktelis;PELĖDŽIUKAI;40006848965;Taip;4;0;1;5
8217;Raktelis;PELĖDŽIUKAI;38001876942;Taip;0;6;0;6
8218;Raktelis;PELĖDŽIUKAI;67756822733;Taip;1;2;0;3
8219;Raktelis;PELĖDŽIUKAI;82492627;Taip;0;2;1;3
8220;Rasa;Nykštukai;1846631921;Taip;0;12;0;12
8221;Rasa;Nykštukai;72152762554;Taip;1;4;0;5
8222;Rasa;Nykštukai;59695217278;Taip;0;4;0;4
8223;Rasa;Nykštukai;32724807082;Taip;0;2;0;2
8224;Rasa;Nykštukai;36336738780;Taip;0;6;0;6
8225;Rasa;Nykštukai;69640669835;Taip;0;4;0;4
8226;Rasa;Nykštukai;68980971096;Ne;2;0;0;2
8227;Rasa;Nykštukai;36874827315;Taip;0;4;0;4
8228;Rasa;Nykštukai;87310376118;Taip;7;0;0;7
8229;Rasa;Nykštukai;1067614202;Ne;0;11;0;11
8230;Rasa;Nykštukai;99521832856;Taip;5;3;0;8
8231;Rasa;Nykštukai;59127440556;Taip;0;2;0;2
8232;Rasa;Nykštukai;29141190550;Taip;0;1;0;1
8233;Rasa;Nykštukai;1549153022;Taip;0;10;0;10
8234;Rasa;Nykštukai;96518910021;Taip;7;0;0;7
8235;Rasa;Nykštukai;3001023535;Ne;1;0;0;1
8236;Rasa;Nykštukai;5108279813;Ne;0;3;0;3
8237;Rasa;"Širdelė mergaičių estetinio lavinimo grupė";2133989183;Taip;0;1;0;1
8238;Rasa;"Širdelė mergaičių estetinio lavinimo grupė";91941960564;Taip;0;6;1;7
8239;Rasa;"Širdelė mergaičių estetinio lavinimo grupė";1883458628;Taip;0;12;0;12
8240;Rasa;"Širdelė mergaičių estetinio lavinimo grupė";1339376048;Taip;4;3;3;10
8241;Rasa;"Širdelė mergaičių estetinio lavinimo grupė";33479419656;Taip;9;5;0;14
8242;Rasa;"Širdelė mergaičių estetinio lavinimo grupė";3281315532;Taip;0;1;0;1
8243;Rasa;"Širdelė mergaičių estetinio lavinimo grupė";58858081077;Taip;0;7;0;7
8244;Rasa;"Širdelė mergaičių estetinio lavinimo grupė";56168039878;Taip;5;6;0;11
8245;Rasa;"Širdelė mergaičių estetinio lavinimo grupė";4601657045;Taip;0;4;0;4
8246;Rasa;"Širdelė mergaičių estetinio lavinimo grupė";2626361958;Taip;10;3;1;14
8247;Rasa;"Širdelė mergaičių estetinio lavinimo grupė";6976298054;Taip;0;5;0;5
8248;Rasa;"Širdelė mergaičių estetinio lavinimo grupė";2840872613;Ne;0;7;1;8
8249;Rasa;"Širdelė mergaičių estetinio lavinimo grupė";8866896989;Taip;0;17;0;17
8250;Rasa;"Širdelė mergaičių estetinio lavinimo grupė";13135367451;Taip;0;3;8;11
8251;Rasa;"Širdelė mergaičių estetinio lavinimo grupė";9648034081;Taip;4;6;0;10
8252;Rasa;"Širdelė mergaičių estetinio lavinimo grupė";5599182715;Taip;0;4;0;4
8253;Rasa;"Širdelė mergaičių estetinio lavinimo grupė";9938280570;Taip;0;4;0;4
8254;Rasa;"Širdelė mergaičių estetinio lavinimo grupė";91931863004;Taip;12;5;0;17
8255;Rasa;"Širdelė mergaičių estetinio lavinimo grupė";2132535297;Taip;2;15;0;17
8256;Rasa;"Širdelė mergaičių estetinio lavinimo grupė";23600769349;Taip;0;7;0;7
8257;Rasa;Meškiukai;8278928396;Taip;12;3;2;17
8258;Rasa;Meškiukai;8052120247;Taip;6;1;0;7
8259;Rasa;Meškiukai;1013865195;Taip;0;11;0;11
8260;Rasa;Meškiukai;2110008545;Ne;0;0;2;2
8261;Rasa;Meškiukai;72772661373;Taip;10;0;0;10
8262;Rasa;Meškiukai;63673920646;Taip;0;2;2;4
8263;Rasa;Meškiukai;4485715299;Taip;0;9;0;9
8264;Rasa;Meškiukai;52913880917;Taip;4;1;0;5
8265;Rasa;Meškiukai;6734478649;Taip;10;0;0;10
8266;Rasa;Meškiukai;5932187584;Taip;15;3;0;18
8267;Rasa;Meškiukai;5145978804;Ne;10;13;0;23
8268;Rasa;Meškiukai;6356448094;Taip;0;3;22;25
8269;Rasa;Meškiukai;2683897055;Taip;18;5;0;23
8270;Rasa;Meškiukai;4790859112;Taip;0;1;5;6
8271;Rasa;Meškiukai;7534548604;Ne;9;0;1;10
8272;Rasa;Meškiukai;5606722133;Taip;0;3;2;5
8273;Rasa;Meškiukai;7565880116;Taip;7;3;5;15
8274;Rasa;Meškiukai;7544963724;Taip;6;6;0;12
8275;Rasa;Meškiukai;3567565920;Ne;0;0;8;8
8276;Rasa;Sauliukai;68458114162;Ne;0;3;0;3
8277;Rasa;Sauliukai;42792180843;Taip;0;4;3;7
8278;Rasa;Sauliukai;12635625072;Taip;0;3;0;3
8279;Rasa;Sauliukai;18715553061;Taip;0;7;0;7
8280;Rasa;Sauliukai;30725310352;Taip;0;5;0;5
8281;Rasa;Sauliukai;2095297719;Taip;0;0;2;2
8282;Rasa;Sauliukai;84260038900;Taip;0;4;2;6
8283;Rasa;Sauliukai;8781212539;Taip;0;4;10;14
8284;Rasa;Sauliukai;92593352340;Taip;0;6;0;6
8285;Rasa;Sauliukai;41438771469;Taip;1;1;0;2
8286;Rasa;Sauliukai;79283195492;Ne;0;1;0;1
8287;Rasa;Sauliukai;51362685893;Taip;0;1;0;1
8288;Rasa;Sauliukai;9148315088;Taip;0;10;0;10
8289;Rasa;Sauliukai;89783044220;Taip;0;4;1;5
8290;Rasa;Sauliukai;69984722099;Taip;0;5;0;5
8291;Rasa;Sauliukai;1717387929;Taip;0;5;0;5
8292;Rasa;Sauliukai;35226191822;Taip;12;7;0;19
8293;Rasa;Smalsučiai;38570340276;Ne;0;7;0;7
8294;Rasa;Smalsučiai;1614333465;Ne;0;5;1;6
8295;Rasa;Smalsučiai;62152088598;Taip;0;10;0;10
8296;Rasa;Smalsučiai;47160008402;Taip;0;2;2;4
8297;Rasa;Smalsučiai;61191043836;Taip;0;1;0;1
8298;Rasa;Smalsučiai;67603435279;Taip;0;2;6;8
8299;Rasa;Smalsučiai;7873461118;Ne;0;5;1;6
8300;Rasa;Smalsučiai;2123727085;Taip;0;14;2;16
8301;Rasa;Smalsučiai;1011880741;Taip;0;3;2;5
8302;Rasa;Smalsučiai;1908234170;Taip;11;2;1;14
8303;Rasa;Smalsučiai;38285343302;Taip;0;2;1;3
8304;Rasa;Smalsučiai;35934308248;Taip;0;2;5;7
8305;Rasa;Smalsučiai;2100861702;Taip;5;11;0;16
8306;Rasa;Smalsučiai;33210203210;Ne;0;6;0;6
8307;Rasa;Smalsučiai;79908276669;Ne;0;5;0;5
8308;Rasa;Smalsučiai;2639024477;Taip;0;0;1;1
8309;Rasa;Smalsučiai;27981379045;Ne;0;3;0;3
8310;Rasa;"Pelėdžiukai ";77589878141;Taip;0;0;7;7
8311;Rasa;"Pelėdžiukai ";1658948426;Taip;6;0;0;6
8312;Rasa;"Pelėdžiukai ";1803769089;Taip;0;0;3;3
8313;Rasa;"Pelėdžiukai ";1311346161;Taip;0;3;0;3
8314;Rasa;"Pelėdžiukai ";20587484061;Taip;0;0;2;2
8315;Rasa;"Pelėdžiukai ";1176606744;Taip;4;0;0;4
8316;Rasa;"Pelėdžiukai ";2121070882;Taip;0;0;6;6
8317;Rasa;"Pelėdžiukai ";1457384318;Taip;11;0;5;16
8318;Rasa;"Pelėdžiukai ";3884105235;Taip;0;0;5;5
8319;Rasa;"Pelėdžiukai ";1726266997;Ne;4;0;0;4
8320;Rasa;"Pelėdžiukai ";6704162447;Taip;0;10;0;10
8321;Rasa;"Pelėdžiukai ";7558966891;Taip;2;0;1;3
8322;Rasa;"Pelėdžiukai ";3063226692;Ne;0;7;0;7
8323;Rasa;"Pelėdžiukai ";6773004268;Taip;22;0;0;22
8324;Rasa;"Pelėdžiukai ";3023088027;Taip;0;19;0;19
8325;Rasa;"Pelėdžiukai ";8953448462;Ne;4;0;0;4
8326;Rasa;"Pelėdžiukai ";5325275053;Taip;0;13;0;13
8327;Rasa;Katinėliai;69686196470;Taip;0;6;0;6
8328;Rasa;Katinėliai;52215260039;Taip;2;9;0;11
8329;Rasa;Katinėliai;3312448238;Taip;0;8;0;8
8330;Rasa;Katinėliai;6462106753;Taip;10;4;0;14
8331;Rasa;Katinėliai;97125416712;Ne;0;2;0;2
8332;Rasa;Katinėliai;19313431652;Taip;5;7;0;12
8333;Rasa;Katinėliai;67334304285;Ne;0;8;0;8
8334;Rasa;Katinėliai;1018965809;Taip;0;5;0;5
8335;Rasa;Katinėliai;1226974819;Ne;7;9;0;16
8336;Rasa;Katinėliai;7404447244;Taip;0;3;0;3
8337;Rasa;Katinėliai;74206773356;Taip;0;0;2;2
8338;Rasa;Katinėliai;6781449151;Taip;0;4;0;4
8339;Rasa;Katinėliai;88319654798;Taip;3;4;3;10
8340;Rasa;Katinėliai;95692605702;Taip;3;5;0;8
8341;Rasa;Katinėliai;33757319655;Ne;0;1;0;1
8342;Rasa;Katinėliai;45229725317;Taip;0;1;0;1
8343;Rasa;Katinėliai;1516629281;Taip;0;5;0;5
8344;Rasa;Ančiukai;7520665472;Taip;0;12;0;12
8345;Rasa;Ančiukai;7185331699;Taip;11;4;0;15
8346;Rasa;Ančiukai;1060810039;Taip;11;4;0;15
8347;Rasa;Ančiukai;2977737634;Taip;4;7;0;11
8348;Rasa;Ančiukai;8310400946;Taip;12;3;0;15
8349;Rasa;Ančiukai;9599510902;Taip;14;1;0;15
8350;Rasa;Ančiukai;7037958994;Taip;7;17;0;24
8351;Rasa;Ančiukai;9668538340;Taip;2;13;0;15
8352;Rasa;Ančiukai;4795339259;Taip;6;14;0;20
8353;Rasa;Ančiukai;3668598028;Taip;0;25;0;25
8354;Rasa;Ančiukai;6019853365;Taip;19;3;0;22
8355;Rasa;Ančiukai;6208444770;Taip;6;0;0;6
8356;Rasa;Ančiukai;3664125930;Ne;17;5;0;22
8357;Rasa;Ančiukai;7028605422;Taip;9;7;0;16
8358;Rasa;"Vyturiukai ";1210203141;Taip;0;10;1;11
8359;Rasa;"Vyturiukai ";7575833127;Taip;0;3;5;8
8360;Rasa;"Vyturiukai ";27131705540;Taip;0;4;0;4
8361;Rasa;"Vyturiukai ";1823276800;Taip;0;11;0;11
8362;Rasa;"Vyturiukai ";1651905746;Taip;0;2;0;2
8363;Rasa;"Vyturiukai ";66103644564;Taip;2;13;0;15
8364;Rasa;"Vyturiukai ";73115061371;Taip;0;12;0;12
8365;Rasa;"Vyturiukai ";1049242346;Taip;6;3;6;15
8366;Rasa;"Vyturiukai ";1179402963;Taip;0;10;0;10
8367;Rasa;"Vyturiukai ";1210340955;Taip;10;14;0;24
8368;Rasa;"Vyturiukai ";84161884493;Taip;0;0;7;7
8369;Rasa;"Vyturiukai ";1214055260;Taip;0;6;0;6
8370;Rasa;"Vyturiukai ";50186813736;Taip;22;3;0;25
8371;Rasa;"Vyturiukai ";2041098301;Taip;8;0;0;8
8372;Rasa;"Vyturiukai ";71420694152;Ne;0;3;13;16
8373;Rasa;"Vyturiukai ";1477555365;Taip;0;16;0;16
8374;Rasa;"Vyturiukai ";6344169010;Taip;0;5;0;5
8375;Rasa;Voveriukai;99911904705;Taip;10;0;0;10
8376;Rasa;Voveriukai;1558712079;Taip;0;10;0;10
8377;Rasa;Voveriukai;25918582395;Ne;13;4;0;17
8378;Rasa;Voveriukai;9890493148;Taip;12;4;0;16
8379;Rasa;Voveriukai;79439306932;Taip;0;9;0;9
8380;Rasa;Voveriukai;1728275988;Taip;16;3;0;19
8381;Rasa;Voveriukai;74744565967;Taip;0;6;0;6
8382;Rasa;Voveriukai;1452467682;Taip;0;5;0;5
8383;Rasa;Voveriukai;1093723298;Ne;0;1;0;1
8384;Rasa;Voveriukai;2879767810;Taip;0;12;0;12
8385;Rasa;Voveriukai;2158444381;Taip;0;1;0;1
8386;Rasa;Voveriukai;5589971159;Taip;0;4;0;4
8387;Rasa;"DRUGELIAI ";4847544355;Taip;0;6;1;7
8388;Rasa;"DRUGELIAI ";9847597133;Taip;0;0;3;3
8389;Rasa;"DRUGELIAI ";1386880644;Taip;7;2;0;9
8390;Rasa;"DRUGELIAI ";1223962374;Taip;0;2;0;2
8391;Rasa;"DRUGELIAI ";1336291828;Taip;6;7;0;13
8392;Rasa;"DRUGELIAI ";3200377629;Taip;12;3;0;15
8393;Rasa;"DRUGELIAI ";3979273111;Taip;0;4;0;4
8394;Rasa;"DRUGELIAI ";5176175108;Taip;15;1;0;16
8395;Rasa;"DRUGELIAI ";5363748728;Taip;2;13;0;15
8396;Rasa;"DRUGELIAI ";7004232909;Taip;22;2;0;24
8397;Rasa;"DRUGELIAI ";9723040721;Taip;6;10;0;16
8398;Rasa;"DRUGELIAI ";7228037580;Taip;7;0;0;7
8399;Rasa;"DRUGELIAI ";2540124793;Taip;11;3;0;14
8400;Rasa;"DRUGELIAI ";2093263887;Taip;9;14;0;23
8401;Rasa;Zuikučiai;1916783052;Ne;4;4;0;8
8402;Rasa;Zuikučiai;4554377449;Taip;0;2;0;2
8403;Rasa;Zuikučiai;2137321989;Taip;5;10;0;15
8404;Rasa;Zuikučiai;1432856662;Taip;2;3;0;5
8405;Rasa;Zuikučiai;1993471951;Taip;7;0;0;7
8406;Rasa;Zuikučiai;1860462451;Taip;3;10;0;13
8407;Rasa;Zuikučiai;42609897431;Taip;0;2;0;2
8408;Rasa;Zuikučiai;55374082940;Taip;0;12;0;12
8409;Rasa;Zuikučiai;2114613635;Taip;0;0;6;6
8410;Rasa;Zuikučiai;56016538926;Taip;5;0;0;5
8411;Rasa;Zuikučiai;7397794681;Taip;0;2;0;2
8412;Rasa;Zuikučiai;7657119471;Taip;0;6;0;6
8413;Rasa;Zuikučiai;13297122928;Taip;0;10;0;10
8414;Rasa;Zuikučiai;6795591746;Taip;0;19;0;19
8415;Rasa;Zuikučiai;6108187043;Taip;0;8;0;8
8416;Rasa;Zuikučiai;1560278351;Taip;7;2;0;9
8417;Rasa;Zuikučiai;1004116597;Taip;0;5;0;5
8418;Rasa;Zuikučiai;26384431360;Taip;0;1;0;1
8419;Rasa;Zuikučiai;1131418692;Taip;0;5;0;5
8420;Riešutėlis;Viščiukų;1782544949;Ne;0;10;0;10
8421;Riešutėlis;Viščiukų;91799192513;Taip;5;4;0;9
8422;Riešutėlis;Viščiukų;50427986973;Taip;0;11;0;11
8423;Riešutėlis;Viščiukų;28855582790;Taip;8;1;0;9
8424;Riešutėlis;Viščiukų;2131349938;Taip;0;7;0;7
8425;Riešutėlis;Viščiukų;41275727334;Taip;17;0;0;17
8426;Riešutėlis;Viščiukų;98456292572;Taip;0;1;0;1
8427;Riešutėlis;Viščiukų;63919369801;Taip;4;1;0;5
8428;Riešutėlis;Viščiukų;85564700996;Taip;0;3;0;3
8429;Riešutėlis;Viščiukų;2146831972;Taip;5;1;0;6
8430;Riešutėlis;Viščiukų;61571638960;Taip;7;1;0;8
8431;Riešutėlis;Viščiukų;8857939937;Taip;3;2;0;5
8432;Riešutėlis;Viščiukų;1957794151;Taip;0;9;0;9
8433;Riešutėlis;Viščiukų;5520818573;Taip;5;0;0;5
8434;Riešutėlis;Viščiukų;1743324657;Taip;14;1;0;15
8435;Riešutėlis;Viščiukų;1792212841;Taip;7;6;0;13
8436;Riešutėlis;Viščiukų;1930481567;Taip;3;0;0;3
8437;Riešutėlis;Viščiukų;86455801201;Taip;5;0;0;5
8438;Riešutėlis;Viščiukų;93958381534;Taip;0;4;0;4
8439;Riešutėlis;Viščiukų;1532275496;Taip;4;0;0;4
8440;Riešutėlis;Viščiukų;4311016578;Ne;2;0;0;2
8441;Riešutėlis;Viščiukų;2201158918;Taip;0;4;1;5
8442;Riešutėlis;Viščiukų;4229384438;Ne;0;3;0;3
8443;Riešutėlis;"Riešutėliai ";8077135868;Taip;5;0;0;5
8444;Riešutėlis;"Riešutėliai ";1077680441;Ne;0;1;1;2
8445;Riešutėlis;"Riešutėliai ";1430255154;Taip;9;7;0;16
8446;Riešutėlis;"Riešutėliai ";90082848356;Taip;7;1;0;8
8447;Riešutėlis;"Riešutėliai ";55620350407;Taip;5;2;1;8
8448;Riešutėlis;"Riešutėliai ";57437627642;Ne;0;1;0;1
8449;Riešutėlis;"Riešutėliai ";2035669978;Taip;0;7;2;9
8450;Riešutėlis;"Riešutėliai ";1105598415;Taip;0;0;3;3
8451;Riešutėlis;"Riešutėliai ";11913461630;Taip;0;0;5;5
8452;Riešutėlis;"Riešutėliai ";1674871670;Taip;15;1;0;16
8453;Riešutėlis;"Riešutėliai ";1853283967;Taip;8;0;0;8
8454;Riešutėlis;"Riešutėliai ";49061075792;Taip;6;7;0;13
8455;Riešutėlis;"Riešutėliai ";1532633795;Taip;8;0;0;8
8456;Riešutėlis;"Riešutėliai ";3806836220;Taip;0;1;7;8
8457;Riešutėlis;"Riešutėliai ";16308059025;Taip;0;0;1;1
8458;Riešutėlis;"Riešutėliai ";9023304543;Taip;3;1;0;4
8459;Riešutėlis;"Riešutėliai ";1941869661;Taip;0;2;0;2
8460;Riešutėlis;Ežiukai;68367330775;Taip;0;0;2;2
8461;Riešutėlis;Ežiukai;8407612029;Taip;0;2;0;2
8462;Riešutėlis;Ežiukai;83564208896;Taip;9;0;0;9
8463;Riešutėlis;Ežiukai;45372107189;Ne;0;13;0;13
8464;Riešutėlis;Ežiukai;1659653711;Taip;5;2;0;7
8465;Riešutėlis;Ežiukai;20330297586;Taip;3;0;0;3
8466;Riešutėlis;Ežiukai;52227650850;Taip;0;1;0;1
8467;Riešutėlis;Ežiukai;96819764408;Taip;0;2;0;2
8468;Riešutėlis;Ežiukai;66558189779;Taip;0;9;0;9
8469;Riešutėlis;Ežiukai;62003857623;Taip;0;6;0;6
8470;Riešutėlis;Ežiukai;23972193661;Taip;0;3;0;3
8471;Riešutėlis;Ežiukai;54820388507;Taip;0;11;0;11
8472;Riešutėlis;Ežiukai;32134152672;Taip;0;3;0;3
8473;Riešutėlis;Ežiukai;1579325190;Taip;7;0;2;9
8474;Riešutėlis;Ežiukai;57828137061;Ne;0;16;0;16
8475;Riešutėlis;Ežiukai;48055109138;Taip;0;6;0;6
8476;Riešutėlis;Ežiukai;69587584156;Taip;0;1;0;1
8477;Riešutėlis;Ežiukai;9485880468;Taip;0;1;0;1
8478;Riešutėlis;Ežiukai;3626122579;Taip;6;0;3;9
8479;Riešutėlis;Ežiukai;2378768167;Taip;5;2;6;13
8480;Riešutėlis;Ežiukai;1320515966;Taip;10;0;0;10
8481;Riešutėlis;Pelėdžiukai;6303767779;Taip;0;0;3;3
8482;Riešutėlis;Pelėdžiukai;1457008581;Taip;0;0;1;1
8483;Riešutėlis;Pelėdžiukai;8012201566;Taip;0;5;0;5
8484;Riešutėlis;Pelėdžiukai;8751571852;Taip;0;7;6;13
8485;Riešutėlis;Pelėdžiukai;5479780116;Taip;0;1;0;1
8486;Riešutėlis;Pelėdžiukai;7225365172;Taip;9;0;1;10
8487;Riešutėlis;Pelėdžiukai;9839084885;Taip;9;0;0;9
8488;Riešutėlis;Pelėdžiukai;6928558714;Taip;9;6;0;15
8489;Riešutėlis;Pelėdžiukai;9040123535;Ne;0;1;1;2
8490;Riešutėlis;Pelėdžiukai;2430518637;Taip;16;1;0;17
8491;Riešutėlis;Pelėdžiukai;3970874098;Taip;8;0;0;8
8492;Riešutėlis;Pelėdžiukai;4451419273;Taip;14;6;2;22
8493;Riešutėlis;Pelėdžiukai;1638021880;Taip;5;0;1;6
8494;Riešutėlis;Pelėdžiukai;5282039544;Ne;10;0;0;10
8495;Riešutėlis;Meškiukai;1485215618;Ne;5;1;0;6
8496;Riešutėlis;Meškiukai;54091928168;Taip;0;1;0;1
8497;Riešutėlis;Meškiukai;35918917950;Taip;10;7;0;17
8498;Riešutėlis;Meškiukai;74152896785;Ne;0;1;0;1
8499;Riešutėlis;Meškiukai;14272401750;Taip;10;0;1;11
8500;Riešutėlis;Meškiukai;37951030398;Taip;7;7;0;14
8501;Riešutėlis;Meškiukai;61160276176;Taip;3;0;1;4
8502;Riešutėlis;Meškiukai;75116205075;Taip;0;1;0;1
8503;Riešutėlis;Meškiukai;50016291414;Taip;3;0;0;3
8504;Riešutėlis;Meškiukai;76883335437;Taip;2;0;1;3
8505;Riešutėlis;Meškiukai;82203033052;Taip;7;0;2;9
8506;Riešutėlis;Meškiukai;30351563466;Taip;0;2;0;2
8507;Riešutėlis;Meškiukai;86230171561;Taip;0;1;0;1
8508;Riešutėlis;Meškiukai;7435155136;Taip;4;0;0;4
8509;Riešutėlis;Meškiukai;12005650217;Taip;0;1;0;1
8510;Riešutėlis;Meškiukai;14480798602;Ne;0;1;0;1
8511;Riešutėlis;Meškiukai;17419936511;Taip;0;1;1;2
8512;Riešutėlis;Meškiukai;6201042890;Taip;2;1;1;4
8513;Riešutėlis;Meškiukai;2815239542;Taip;11;0;0;11
8514;Riešutėlis;Meškiukai;8927730307;Ne;0;0;4;4
8515;Riešutėlis;Meškiukai;3722925159;Taip;5;0;5;10
8516;Riešutėlis;Kiškučiai;90088217854;Ne;9;1;0;10
8517;Riešutėlis;Kiškučiai;49061132665;Taip;0;1;0;1
8518;Riešutėlis;Kiškučiai;60941759790;Taip;0;1;0;1
8519;Riešutėlis;Kiškučiai;92159110899;Taip;0;10;2;12
8520;Riešutėlis;Kiškučiai;1623455993;Taip;0;3;0;3
8521;Riešutėlis;Kiškučiai;4464545735;Taip;0;2;0;2
8522;Riešutėlis;Kiškučiai;96066602684;Taip;0;1;2;3
8523;Riešutėlis;Kiškučiai;55715445788;Taip;0;1;0;1
8524;Riešutėlis;Kiškučiai;1747328573;Taip;0;3;0;3
8525;Riešutėlis;Kiškučiai;1250209796;Taip;16;1;2;19
8526;Riešutėlis;Kiškučiai;50338275044;Taip;0;6;0;6
8527;Riešutėlis;Kiškučiai;18310744085;Taip;0;6;0;6
8528;Riešutėlis;Kiškučiai;1748738558;Taip;0;7;0;7
8529;Riešutėlis;Kiškučiai;93192056557;Taip;4;0;0;4
8530;Riešutėlis;Kiškučiai;2973908247;Taip;0;6;0;6
8531;Riešutėlis;Kiškučiai;9205961122;Taip;0;0;6;6
8532;Riešutėlis;Kiškučiai;2163433983;Taip;0;1;0;1
8533;Riešutėlis;Kiškučiai;4916885450;Taip;5;8;9;22
8534;Riešutėlis;Kiškučiai;8864100655;Taip;0;2;0;2
8535;Riešutėlis;Kiškučiai;6149891188;Taip;0;1;0;1
8536;Riešutėlis;Voveriukų;6500567162;Taip;0;14;0;14
8537;Riešutėlis;Voveriukų;9081486438;Taip;5;1;1;7
8538;Riešutėlis;Voveriukų;1212829190;Taip;22;0;0;22
8539;Riešutėlis;Voveriukų;59279444190;Taip;0;1;0;1
8540;Riešutėlis;Voveriukų;31417468379;Ne;5;4;0;9
8541;Riešutėlis;Voveriukų;1065105725;Taip;0;5;0;5
8542;Riešutėlis;Voveriukų;36176126840;Taip;0;2;0;2
8543;Riešutėlis;Voveriukų;26053212952;Taip;2;0;0;2
8544;Riešutėlis;Voveriukų;51840071269;Taip;2;0;0;2
8545;Riešutėlis;Voveriukų;70549617521;Taip;0;2;0;2
8546;Riešutėlis;Voveriukų;36161702165;Ne;0;2;0;2
8547;Riešutėlis;Voveriukų;46444683383;Taip;2;2;0;4
8548;Riešutėlis;Voveriukų;92166220283;Taip;0;0;1;1
8549;Riešutėlis;Voveriukų;2163248156;Taip;0;2;0;2
8550;Riešutėlis;Voveriukų;56426084480;Taip;5;1;0;6
8551;Riešutėlis;Voveriukų;65629075580;Taip;0;8;0;8
8552;Riešutėlis;Voveriukų;89384403521;Taip;0;3;0;3
8553;Riešutėlis;Voveriukų;64736615832;Ne;0;1;0;1
8554;Riešutėlis;Voveriukų;29751938918;Taip;7;0;12;19
8555;Riešutėlis;Saulutės;9198963882;Taip;19;0;0;19
8556;Riešutėlis;Saulutės;2111280879;Ne;0;1;0;1
8557;Riešutėlis;Saulutės;1160573638;Taip;5;1;0;6
8558;Riešutėlis;Saulutės;1056034480;Taip;3;2;3;8
8559;Riešutėlis;Saulutės;1136025173;Taip;0;0;22;22
8560;Riešutėlis;Saulutės;2097580659;Taip;0;5;0;5
8561;Riešutėlis;Saulutės;2112179980;Ne;5;2;0;7
8562;Riešutėlis;Saulutės;2851186469;Taip;0;0;2;2
8563;Riešutėlis;Saulutės;7207507008;Taip;0;2;1;3
8564;Riešutėlis;Saulutės;8749505821;Taip;0;6;0;6
8565;Riešutėlis;Saulutės;1169051233;Taip;5;2;0;7
8566;Riešutėlis;Saulutės;1091941952;Taip;0;5;0;5
8567;Riešutėlis;Saulutės;24776322315;Taip;0;2;0;2
8568;Riešutėlis;Saulutės;7912773569;Taip;0;1;0;1
8569;Riešutėlis;Saulutės;2655848313;Taip;0;2;2;4
8570;Riešutėlis;Saulutės;4898775561;Taip;0;1;0;1
8571;Riešutėlis;Saulutės;5717194707;Taip;0;2;0;2
8572;Riešutėlis;Saulutės;5537309549;Taip;0;2;2;4
8573;Riešutėlis;"Boruželės ";16561622902;Taip;5;0;0;5
8574;Riešutėlis;"Boruželės ";56117509354;Taip;0;13;0;13
8575;Riešutėlis;"Boruželės ";1936519033;Taip;7;2;0;9
8576;Riešutėlis;"Boruželės ";2611705234;Taip;7;2;0;9
8577;Riešutėlis;"Boruželės ";1455509576;Taip;0;2;1;3
8578;Riešutėlis;"Boruželės ";4701887030;Taip;0;2;3;5
8579;Riešutėlis;"Boruželės ";3577669231;Taip;1;0;0;1
8580;Riešutėlis;"Boruželės ";9670912357;Taip;6;2;0;8
8581;Riešutėlis;"Boruželės ";26781529460;Taip;8;0;2;10
8582;Riešutėlis;"Boruželės ";4344185375;Taip;4;0;0;4
8583;Riešutėlis;"Boruželės ";8936419431;Taip;1;5;0;6
8584;Riešutėlis;"Boruželės ";4041498684;Taip;5;0;0;5
8585;Riešutėlis;"Boruželės ";8087180983;Taip;0;22;0;22
8586;Riešutėlis;"Boruželės ";4276034784;Taip;0;0;6;6
8587;Riešutėlis;"Boruželės ";2566084613;Taip;0;10;0;10
8588;Riešutėlis;"Boruželės ";1640383686;Taip;8;0;0;8
8589;Riešutėlis;"Boruželės ";3851000866;Taip;0;1;0;1
8590;Riešutėlis;"Bitutės ";3149710709;Taip;2;0;0;2
8591;Riešutėlis;"Bitutės ";1918857028;Taip;3;0;0;3
8592;Riešutėlis;"Bitutės ";1686215195;Taip;9;0;0;9
8593;Riešutėlis;"Bitutės ";54011982803;Taip;0;1;0;1
8594;Riešutėlis;"Bitutės ";2395648260;Taip;0;17;0;17
8595;Riešutėlis;"Bitutės ";4480906648;Taip;18;0;0;18
8596;Riešutėlis;"Bitutės ";86647499063;Ne;10;0;0;10
8597;Riešutėlis;"Bitutės ";4188823834;Taip;15;0;0;15
8598;Riešutėlis;"Bitutės ";59796628656;Taip;5;5;2;12
8599;Riešutėlis;"Bitutės ";6852846350;Taip;6;7;1;14
8600;Riešutėlis;"Bitutės ";13815744901;Taip;5;8;0;13
8601;Riešutėlis;"Bitutės ";91430094368;Taip;0;2;0;2
8602;Riešutėlis;"Bitutės ";4897379979;Taip;4;0;1;5
8603;Riešutėlis;"Bitutės ";65873300738;Taip;0;4;0;4
8604;Riešutėlis;"Bitutės ";8313605541;Taip;0;1;0;1
8605;Riešutėlis;"Bitutės ";1921241349;Ne;0;0;2;2
8606;Riešutėlis;Drugelių;5753609922;Taip;17;0;0;17
8607;Riešutėlis;Drugelių;8578903763;Taip;5;6;0;11
8608;Riešutėlis;Drugelių;3975091711;Taip;3;8;0;11
8609;Riešutėlis;Drugelių;6194259707;Taip;0;8;0;8
8610;Riešutėlis;Drugelių;5811657782;Taip;8;0;0;8
8611;Riešutėlis;Drugelių;1075842434;Taip;0;0;1;1
8612;Riešutėlis;Drugelių;8016820352;Taip;6;2;0;8
8613;Riešutėlis;Drugelių;4994368504;Taip;0;4;0;4
8614;Riešutėlis;Drugelių;1942944625;Taip;5;3;0;8
8615;Riešutėlis;Drugelių;8845709386;Taip;0;4;0;4
8616;Riešutėlis;Drugelių;8128352818;Taip;0;0;1;1
8617;Riešutėlis;Drugelių;8352146446;Taip;8;0;0;8
8618;Riešutėlis;Drugelių;1528972517;Taip;5;10;0;15
8619;Riešutėlis;Drugelių;8180618419;Ne;1;1;1;3
8620;Riešutėlis;Drugelių;3920525584;Taip;8;2;0;10
8621;Riešutėlis;Drugelių;5412882446;Taip;6;0;3;9
8622;Riešutėlis;Drugelių;8020533200;Taip;11;1;0;12
8623;Ramunėlė;SAULUTĖS;19664665864;Ne;0;8;0;8
8624;Ramunėlė;SAULUTĖS;80319760551;Taip;0;1;0;1
8625;Ramunėlė;SAULUTĖS;72681762872;Taip;0;7;0;7
8626;Ramunėlė;SAULUTĖS;7736649569;Taip;0;2;0;2
8627;Ramunėlė;SAULUTĖS;43737882488;Taip;0;2;1;3
8628;Ramunėlė;SAULUTĖS;16577268434;Taip;0;5;0;5
8629;Ramunėlė;SAULUTĖS;44016905818;Taip;2;2;1;5
8630;Ramunėlė;SAULUTĖS;19784681244;Taip;0;11;0;11
8631;Ramunėlė;SAULUTĖS;99807372989;Taip;0;5;0;5
8632;Ramunėlė;SAULUTĖS;3599929268;Taip;0;2;0;2
8633;Ramunėlė;SAULUTĖS;9266024764;Taip;0;5;0;5
8634;Ramunėlė;SAULUTĖS;94707638226;Taip;0;2;0;2
8635;Ramunėlė;SAULUTĖS;69367849602;Taip;0;10;0;10
8636;Ramunėlė;SAULUTĖS;97944093065;Taip;0;1;0;1
8637;Ramunėlė;SAULUTĖS;27163734018;Taip;8;3;1;12
8638;Ramunėlė;SAULUTĖS;2089805114;Taip;5;0;2;7
8639;Ramunėlė;SAULUTĖS;1079295964;Taip;12;2;0;14
8640;Ramunėlė;SAULUTĖS;26568396284;Taip;7;2;3;12
8641;Ramunėlė;SAULUTĖS;1982905923;Taip;0;2;15;17
8642;Ramunėlė;SAULUTĖS;9918328799;Taip;0;4;0;4
8643;Ramunėlė;ŽIBUTĖ;8943746426;Taip;0;5;0;5
8644;Ramunėlė;ŽIBUTĖ;57697488265;Taip;0;8;0;8
8645;Ramunėlė;ŽIBUTĖ;4103951942;Taip;0;7;0;7
8646;Ramunėlė;ŽIBUTĖ;37227575121;Taip;0;12;0;12
8647;Ramunėlė;ŽIBUTĖ;21178777924;Taip;6;2;0;8
8648;Ramunėlė;ŽIBUTĖ;9615607625;Taip;0;5;0;5
8649;Ramunėlė;ŽIBUTĖ;24395304267;Ne;3;2;0;5
8650;Ramunėlė;ŽIBUTĖ;41210974793;Taip;7;0;0;7
8651;Ramunėlė;ŽIBUTĖ;71451001033;Taip;0;5;0;5
8652;Ramunėlė;ŽIBUTĖ;6126971384;Taip;5;1;0;6
8653;Ramunėlė;ŽIBUTĖ;78632810141;Taip;22;0;0;22
8654;Ramunėlė;ŽIBUTĖ;8826277893;Taip;0;2;0;2
8655;Ramunėlė;ŽIBUTĖ;573414969;Taip;0;9;0;9
8656;Ramunėlė;ŽIBUTĖ;2069380818;Taip;7;0;2;9
8657;Ramunėlė;ŽIBUTĖ;1686559920;Taip;0;20;0;20
8658;Ramunėlė;ŽIBUTĖ;2127262855;Taip;0;6;0;6
8659;Ramunėlė;ŽIBUTĖ;1383896021;Taip;10;2;5;17
8660;Ramunėlė;ŽIBUTĖ;1898089064;Ne;19;0;0;19
8661;Ramunėlė;ŽIBUTĖ;1575204445;Ne;0;2;5;7
8662;Ramunėlė;ŽIBUTĖ;1511271386;Ne;0;7;0;7
8663;Ramunėlė;ŽIBUTĖ;1845973626;Taip;0;4;0;4
8664;Ramunėlė;ŽIRNIUKAI;99821576722;Ne;0;2;0;2
8665;Ramunėlė;ŽIRNIUKAI;50481250500;Taip;0;0;4;4
8666;Ramunėlė;ŽIRNIUKAI;94856703262;Taip;0;10;0;10
8667;Ramunėlė;ŽIRNIUKAI;65453540817;Taip;0;2;0;2
8668;Ramunėlė;ŽIRNIUKAI;42260677623;Taip;0;3;0;3
8669;Ramunėlė;ŽIRNIUKAI;6024704965;Taip;0;3;0;3
8670;Ramunėlė;ŽIRNIUKAI;26794018418;Taip;0;5;0;5
8671;Ramunėlė;ŽIRNIUKAI;91420704570;Taip;0;1;0;1
8672;Ramunėlė;ŽIRNIUKAI;88310187748;Taip;0;2;0;2
8673;Ramunėlė;ŽIRNIUKAI;26023476423;Taip;0;1;0;1
8674;Ramunėlė;ŽIRNIUKAI;31363181264;Taip;1;2;2;5
8675;Ramunėlė;ŽIRNIUKAI;74094856940;Ne;7;2;0;9
8676;Ramunėlė;ŽIRNIUKAI;46655439401;Taip;0;2;0;2
8677;Ramunėlė;ŽIRNIUKAI;49072154718;Taip;0;4;2;6
8678;Ramunėlė;ŽIRNIUKAI;81555246386;Taip;0;7;0;7
8679;Ramunėlė;ŽIRNIUKAI;64011542531;Taip;9;0;0;9
8680;Ramunėlė;ŽIRNIUKAI;74958543608;Ne;0;0;1;1
8681;Ramunėlė;ŽIRNIUKAI;19570213314;Taip;0;7;0;7
8682;Ramunėlė;BITUTĖS;23095478847;Taip;6;3;0;9
8683;Ramunėlė;BITUTĖS;9961229084;Taip;0;8;0;8
8684;Ramunėlė;BITUTĖS;7921336790;Taip;0;2;0;2
8685;Ramunėlė;BITUTĖS;86378277613;Taip;0;3;0;3
8686;Ramunėlė;BITUTĖS;1866642357;Ne;0;3;0;3
8687;Ramunėlė;BITUTĖS;32249506035;Taip;4;1;0;5
8688;Ramunėlė;BITUTĖS;42582811243;Taip;0;1;0;1
8689;Ramunėlė;BITUTĖS;1485483496;Taip;0;3;0;3
8690;Ramunėlė;BITUTĖS;3683430430;Taip;0;8;0;8
8691;Ramunėlė;BITUTĖS;4101387438;Taip;0;0;3;3
8692;Ramunėlė;BITUTĖS;16357824257;Taip;0;5;0;5
8693;Ramunėlė;BITUTĖS;9715654332;Taip;0;6;0;6
8694;Ramunėlė;BITUTĖS;1012658900;Taip;0;9;0;9
8695;Ramunėlė;BITUTĖS;9017349382;Taip;0;2;0;2
8696;Ramunėlė;DRUGELIAI;52584057093;Taip;0;2;0;2
8697;Ramunėlė;DRUGELIAI;22249196276;Taip;10;2;1;13
8698;Ramunėlė;DRUGELIAI;81774258556;Taip;4;0;4;8
8699;Ramunėlė;DRUGELIAI;22097349678;Taip;5;4;0;9
8700;Ramunėlė;DRUGELIAI;62716754080;Taip;0;9;0;9
8701;Ramunėlė;DRUGELIAI;14581393355;Taip;0;2;1;3
8702;Ramunėlė;DRUGELIAI;35823437202;Taip;0;1;0;1
8703;Ramunėlė;DRUGELIAI;15363368541;Taip;0;0;4;4
8704;Ramunėlė;DRUGELIAI;76947701645;Taip;3;0;1;4
8705;Ramunėlė;DRUGELIAI;15310034187;Taip;0;3;0;3
8706;Ramunėlė;DRUGELIAI;22306706669;Taip;0;2;1;3
8707;Ramunėlė;DRUGELIAI;25346770513;Ne;0;10;2;12
8708;Ramunėlė;DRUGELIAI;72620475723;Taip;0;1;0;1
8709;Ramunėlė;DRUGELIAI;92929314036;Taip;0;2;0;2
8710;Ramunėlė;DRUGELIAI;28838673166;Ne;5;1;0;6
8711;Ramunėlė;DRUGELIAI;1253351354;Taip;0;0;1;1
8712;Ramunėlė;DRUGELIAI;13195968349;Taip;0;2;0;2
8713;Ramunėlė;DRUGELIAI;21608020858;Taip;5;2;1;8
8714;Ramunėlė;DRUGELIAI;1478538572;Taip;0;7;0;7
8715;Ramunėlė;DRUGELIAI;26152001976;Ne;0;8;0;8
8716;Ramunėlė;DRUGELIAI;1175561112;Taip;0;6;0;6
8717;Ramunėlė;NEUŽMIRŠTUOLĖS;19420482998;Ne;0;9;0;9
8718;Ramunėlė;NEUŽMIRŠTUOLĖS;4990982790;Taip;0;5;1;6
8719;Ramunėlė;NEUŽMIRŠTUOLĖS;9130637883;Taip;19;0;0;19
8720;Ramunėlė;NEUŽMIRŠTUOLĖS;3271832822;Taip;10;2;0;12
8721;Ramunėlė;NEUŽMIRŠTUOLĖS;3554787356;Taip;3;0;4;7
8722;Ramunėlė;NEUŽMIRŠTUOLĖS;8098492540;Taip;0;7;0;7
8723;Ramunėlė;NEUŽMIRŠTUOLĖS;6217540064;Taip;3;2;0;5
8724;Ramunėlė;NEUŽMIRŠTUOLĖS;3065727741;Taip;6;0;0;6
8725;Ramunėlė;NEUŽMIRŠTUOLĖS;8016643568;Taip;5;0;0;5
8726;Ramunėlė;NEUŽMIRŠTUOLĖS;4511376806;Taip;0;8;0;8
8727;Ramunėlė;NEUŽMIRŠTUOLĖS;9171690612;Taip;7;2;3;12
8728;Ramunėlė;NEUŽMIRŠTUOLĖS;8357049686;Taip;0;9;0;9
8729;Ramunėlė;NEUŽMIRŠTUOLĖS;1078618047;Taip;22;0;0;22
8730;Ramunėlė;NEUŽMIRŠTUOLĖS;6329943991;Taip;0;0;3;3
8731;Ramunėlė;NEUŽMIRŠTUOLĖS;8940763540;Taip;0;0;18;18
8732;Ramunėlė;NEUŽMIRŠTUOLĖS;8086994543;Taip;6;0;0;6
8733;Ramunėlė;NEUŽMIRŠTUOLĖS;5822045625;Taip;0;0;1;1
8734;Ramunėlė;NEUŽMIRŠTUOLĖS;2225787182;Taip;0;17;0;17
8735;Ramunėlė;OBUOLIUKAI;1376538015;Ne;0;7;0;7
8736;Ramunėlė;OBUOLIUKAI;1783572058;Taip;0;1;0;1
8737;Ramunėlė;OBUOLIUKAI;30907738272;Ne;0;2;0;2
8738;Ramunėlė;OBUOLIUKAI;1891454355;Ne;8;4;0;12
8739;Ramunėlė;OBUOLIUKAI;1814199950;Taip;0;2;0;2
8740;Ramunėlė;OBUOLIUKAI;1199690327;Taip;0;0;1;1
8741;Ramunėlė;OBUOLIUKAI;52168460247;Taip;6;2;0;8
8742;Ramunėlė;OBUOLIUKAI;67836032797;Taip;0;3;0;3
8743;Ramunėlė;OBUOLIUKAI;66630134164;Taip;4;0;0;4
8744;Ramunėlė;OBUOLIUKAI;1988109236;Taip;0;16;0;16
8745;Ramunėlė;OBUOLIUKAI;1083479451;Taip;0;1;0;1
8746;Ramunėlė;OBUOLIUKAI;7228065409;Taip;0;9;0;9
8747;Ramunėlė;OBUOLIUKAI;2567264851;Taip;0;0;1;1
8748;Ramunėlė;OBUOLIUKAI;9584620339;Taip;0;1;0;1
8749;Ramunėlė;OBUOLIUKAI;8402889872;Taip;12;2;0;14
8750;Ramunėlė;OBUOLIUKAI;1745170057;Taip;0;2;1;3
8751;Ramunėlė;OBUOLIUKAI;8768539595;Taip;0;9;0;9
8752;Ramunėlė;OBUOLIUKAI;2055332353;Taip;0;7;0;7
8753;Ramunėlė;OBUOLIUKAI;58573425792;Taip;0;0;5;5
8754;Ramunėlė;SAULĖGRĄŽA;3973083939;Taip;0;1;0;1
8755;Ramunėlė;SAULĖGRĄŽA;53748116108;Taip;0;2;1;3
8756;Ramunėlė;SAULĖGRĄŽA;1028730863;Taip;0;1;0;1
8757;Ramunėlė;SAULĖGRĄŽA;1085668968;Taip;0;1;0;1
8758;Ramunėlė;SAULĖGRĄŽA;1500685962;Ne;0;10;0;10
8759;Ramunėlė;SAULĖGRĄŽA;57963557951;Taip;5;1;0;6
8760;Ramunėlė;SAULĖGRĄŽA;9924675250;Taip;0;1;0;1
8761;Ramunėlė;SAULĖGRĄŽA;1386186515;Taip;0;0;1;1
8762;Ramunėlė;SAULĖGRĄŽA;1171170929;Taip;0;0;2;2
8763;Ramunėlė;SAULĖGRĄŽA;10677635919;Taip;0;8;0;8
8764;Ramunėlė;SAULĖGRĄŽA;11512621396;Taip;2;0;0;2
8765;Ramunėlė;SAULĖGRĄŽA;17292085814;Taip;0;14;0;14
8766;Ramunėlė;SAULĖGRĄŽA;4814208279;Ne;0;4;0;4
8767;Ramunėlė;SAULĖGRĄŽA;8254302108;Taip;0;2;0;2
8768;Ramunėlė;SAULĖGRĄŽA;1364997950;Taip;0;1;0;1
8769;Ramunėlė;SAULĖGRĄŽA;1397784717;Taip;0;0;2;2
8770;Ramunėlė;BORUŽĖLĖS;82024687579;Taip;0;8;0;8
8771;Ramunėlė;BORUŽĖLĖS;1563618796;Taip;0;2;0;2
8772;Ramunėlė;BORUŽĖLĖS;76195144469;Taip;0;0;10;10
8773;Ramunėlė;BORUŽĖLĖS;1033548164;Taip;0;2;1;3
8774;Ramunėlė;BORUŽĖLĖS;1946639898;Taip;12;2;0;14
8775;Ramunėlė;BORUŽĖLĖS;1058243928;Taip;0;4;0;4
8776;Ramunėlė;BORUŽĖLĖS;63470398650;Taip;0;1;0;1
8777;Ramunėlė;BORUŽĖLĖS;1439962940;Taip;0;1;0;1
8778;Ramunėlė;BORUŽĖLĖS;93125217886;Taip;3;0;0;3
8779;Ramunėlė;BORUŽĖLĖS;1690224857;Taip;0;0;6;6
8780;Ramunėlė;BORUŽĖLĖS;1827657363;Taip;0;4;0;4
8781;Ramunėlė;BORUŽĖLĖS;1176835101;Taip;0;2;1;3
8782;Ramunėlė;BORUŽĖLĖS;1341351994;Taip;0;6;0;6
8783;Ramunėlė;BORUŽĖLĖS;2859202237;Taip;0;5;0;5
8784;Ramunėlė;BORUŽĖLĖS;17273267465;Taip;6;2;2;10
8785;Ramunėlė;BORUŽĖLĖS;1709795078;Taip;0;14;0;14
8786;Ramunėlė;BORUŽĖLĖS;1077068878;Taip;0;2;5;7
8787;Ramunėlė;BORUŽĖLĖS;1207455851;Taip;5;0;2;7
8788;Ramunėlė;NYKŠTUKAS;2995509132;Taip;0;2;0;2
8789;Ramunėlė;NYKŠTUKAS;3301219357;Taip;0;1;0;1
8790;Ramunėlė;NYKŠTUKAS;6348171102;Taip;8;0;0;8
8791;Ramunėlė;NYKŠTUKAS;1800967823;Taip;0;0;4;4
8792;Ramunėlė;NYKŠTUKAS;8205893352;Taip;0;2;0;2
8793;Ramunėlė;NYKŠTUKAS;4392309015;Taip;3;0;2;5
8794;Ramunėlė;NYKŠTUKAS;8656417794;Ne;5;1;0;6
8795;Ramunėlė;NYKŠTUKAS;7902931560;Taip;9;2;0;11
8796;Ramunėlė;NYKŠTUKAS;3883411539;Taip;0;0;4;4
8797;Ramunėlė;NYKŠTUKAS;5049415445;Taip;12;0;0;12
8798;Ramunėlė;NYKŠTUKAS;5465647281;Taip;0;11;0;11
8799;Ramunėlė;NYKŠTUKAS;6809164145;Taip;0;0;7;7
8800;Ramunėlė;NYKŠTUKAS;6184872126;Taip;7;0;0;7
8801;Ramunėlė;UOGELĖ;6134554678;Taip;8;4;2;14
8802;Ramunėlė;UOGELĖ;8726443989;Taip;5;3;0;8
8803;Ramunėlė;UOGELĖ;7219400182;Taip;9;0;0;9
8804;Ramunėlė;UOGELĖ;4715809064;Taip;0;1;0;1
8805;Ramunėlė;UOGELĖ;5315953299;Taip;3;2;0;5
8806;Ramunėlė;UOGELĖ;3852734401;Taip;5;0;0;5
8807;Ramunėlė;UOGELĖ;1192743154;Taip;0;5;0;5
8808;Ramunėlė;UOGELĖ;5562960498;Taip;0;15;0;15
8809;Ramunėlė;UOGELĖ;1599595174;Ne;2;10;0;12
8810;Ramunėlė;UOGELĖ;1483391590;Taip;4;2;0;6
8811;Ramunėlė;UOGELĖ;5605444408;Taip;3;2;0;5
8812;Ramunėlė;UOGELĖ;8323020864;Taip;9;0;0;9
8813;Ramunėlė;UOGELĖ;8912978935;Taip;0;2;0;2
8814;Ramunėlė;UOGELĖ;9320573498;Taip;0;4;0;4
8815;Ramunėlė;UOGELĖ;5420360864;Taip;12;10;0;22
8816;Ramunėlė;UOGELĖ;3779769727;Taip;0;8;0;8
8817;Ramunėlė;UOGELĖ;8929122197;Taip;5;0;0;5
8818;Ramunėlė;UOGELĖ;4575123456;Taip;6;0;1;7
8819;Ramunėlė;UOGELĖ;3574886801;Taip;22;0;0;22
8820;Ramunėlė;VARPELIAI;2499280049;Taip;4;2;0;6
8821;Ramunėlė;VARPELIAI;6310921755;Taip;0;2;0;2
8822;Ramunėlė;VARPELIAI;3685786758;Taip;0;2;0;2
8823;Ramunėlė;VARPELIAI;7750405604;Taip;5;1;0;6
8824;Ramunėlė;VARPELIAI;58028743912;Taip;13;0;0;13
8825;Ramunėlė;VARPELIAI;4349250416;Taip;0;4;1;5
8826;Ramunėlė;VARPELIAI;3055294324;Taip;19;1;0;20
8827;Ramunėlė;VARPELIAI;6612728883;Taip;0;4;2;6
8828;Ramunėlė;VARPELIAI;1534723406;Taip;6;0;0;6
8829;Ramunėlė;VARPELIAI;7295041630;Taip;0;1;0;1
8830;Ramunėlė;VARPELIAI;1216101539;Taip;0;19;0;19
8831;Ramunėlė;VARPELIAI;4677819736;Taip;0;0;2;2
8832;Ramunėlė;VARPELIAI;6837072361;Taip;1;8;0;9
8833;Ramunėlė;VARPELIAI;1303053333;Taip;0;2;0;2
8834;Ramunėlė;VARPELIAI;6695672297;Taip;5;0;0;5
8835;Ramunėlė;VARPELIAI;7638038269;Taip;0;7;0;7
8836;Ramunėlė;VARPELIAI;7825538259;Taip;2;1;0;3
8837;Rūta;SMALSUČIAI;14391882157;Taip;0;0;1;1
8838;Rūta;SMALSUČIAI;18117978189;Taip;0;0;9;9
8839;Rūta;SMALSUČIAI;184041928;Taip;5;0;3;8
8840;Rūta;SMALSUČIAI;77285178781;Taip;0;4;5;9
8841;Rūta;SMALSUČIAI;45391890869;Ne;10;0;1;11
8842;Rūta;SMALSUČIAI;78953568121;Ne;10;12;0;22
8843;Rūta;SMALSUČIAI;26152518052;Taip;22;0;0;22
8844;Rūta;SMALSUČIAI;68107516536;Ne;0;1;0;1
8845;Rūta;SMALSUČIAI;87692898919;Taip;0;0;11;11
8846;Rūta;SMALSUČIAI;3874247966;Taip;7;0;1;8
8847;Rūta;SMALSUČIAI;38837808144;Taip;7;0;2;9
8848;Rūta;SMALSUČIAI;50814418724;Taip;0;4;0;4
8849;Rūta;SMALSUČIAI;1364470800;Taip;0;0;1;1
8850;Rūta;SMALSUČIAI;1996690514;Taip;0;3;0;3
8851;Rūta;SMALSUČIAI;59694891781;Taip;12;0;0;12
8852;Rūta;SMALSUČIAI;1945068716;Taip;4;0;1;5
8853;Rūta;SMALSUČIAI;83473072263;Taip;0;0;4;4
8854;Rūta;KŪLVERSTUKAI;1080628212;Taip;0;7;0;7
8855;Rūta;KŪLVERSTUKAI;1800198849;Taip;0;3;0;3
8856;Rūta;KŪLVERSTUKAI;1150292834;Taip;0;1;0;1
8857;Rūta;KŪLVERSTUKAI;56171468735;Taip;0;7;0;7
8858;Rūta;KŪLVERSTUKAI;88159609117;Taip;0;2;0;2
8859;Rūta;KŪLVERSTUKAI;2084379688;Taip;4;2;0;6
8860;Rūta;KŪLVERSTUKAI;1807332522;Taip;4;3;0;7
8861;Rūta;KŪLVERSTUKAI;1674584707;Taip;0;10;0;10
8862;Rūta;KŪLVERSTUKAI;2079429418;Taip;0;3;0;3
8863;Rūta;KŪLVERSTUKAI;1972150300;Taip;0;1;0;1
8864;Rūta;KŪLVERSTUKAI;50658624766;Taip;7;0;0;7
8865;Rūta;KŪLVERSTUKAI;1971925569;Taip;3;1;0;4
8866;Rūta;KŪLVERSTUKAI;56470874552;Taip;5;1;0;6
8867;Rūta;KŪLVERSTUKAI;1363296753;Taip;0;8;0;8
8868;Rūta;KŪLVERSTUKAI;17349566042;Taip;7;6;0;13
8869;Rūta;KŪLVERSTUKAI;1043614414;Taip;0;13;0;13
8870;Rūta;KŪLVERSTUKAI;1703148668;Taip;0;0;3;3
8871;Rūta;KODĖLČIUKAI;6136733410;Taip;14;0;1;15
8872;Rūta;KODĖLČIUKAI;8607455403;Taip;0;4;0;4
8873;Rūta;KODĖLČIUKAI;4168356825;Taip;6;0;0;6
8874;Rūta;KODĖLČIUKAI;1186493111;Taip;0;9;0;9
8875;Rūta;KODĖLČIUKAI;1390207547;Taip;0;1;0;1
8876;Rūta;KODĖLČIUKAI;9569447586;Taip;0;9;0;9
8877;Rūta;KODĖLČIUKAI;32004750783;Taip;0;0;3;3
8878;Rūta;KODĖLČIUKAI;6982618655;Taip;0;4;0;4
8879;Rūta;KODĖLČIUKAI;1433704180;Taip;5;0;0;5
8880;Rūta;KODĖLČIUKAI;1671913833;Taip;0;2;0;2
8881;Rūta;KODĖLČIUKAI;4282074540;Taip;5;0;0;5
8882;Rūta;KODĖLČIUKAI;2677062861;Taip;7;0;0;7
8883;Rūta;KODĖLČIUKAI;1415664888;Taip;0;8;4;12
8884;Rūta;KODĖLČIUKAI;4426456302;Taip;3;0;0;3
8885;Rūta;KODĖLČIUKAI;9675482322;Ne;10;7;0;17
8886;Rūta;KODĖLČIUKAI;2912054049;Taip;5;0;0;5
8887;Rūta;BORUŽĖLĖS;1346367896;Taip;0;5;0;5
8888;Rūta;BORUŽĖLĖS;1565896222;Taip;10;0;7;17
8889;Rūta;BORUŽĖLĖS;8673942478;Taip;0;0;7;7
8890;Rūta;BORUŽĖLĖS;1092908255;Taip;0;1;1;2
8891;Rūta;BORUŽĖLĖS;1521231573;Ne;11;0;2;13
8892;Rūta;BORUŽĖLĖS;1967141665;Taip;0;0;1;1
8893;Rūta;BORUŽĖLĖS;6006094035;Taip;6;0;5;11
8894;Rūta;BORUŽĖLĖS;8889388348;Taip;9;0;3;12
8895;Rūta;BORUŽĖLĖS;8704594038;Taip;0;0;1;1
8896;Rūta;BORUŽĖLĖS;3478456813;Taip;5;1;1;7
8897;Rūta;BORUŽĖLĖS;1180144866;Taip;2;0;0;2
8898;Rūta;BORUŽĖLĖS;4078957924;Taip;6;0;1;7
8899;Rūta;BORUŽĖLĖS;4363571135;Taip;5;8;0;13
8900;Rūta;BORUŽĖLĖS;4754142240;Taip;0;0;1;1
8901;Rūta;BORUŽĖLĖS;2116581815;Taip;5;0;2;7
8902;Rūta;BORUŽĖLĖS;8851591109;Taip;5;0;5;10
8903;Rūta;BORUŽĖLĖS;7552644990;Taip;8;0;0;8
8904;Rūta;BORUŽĖLĖS;1336973131;Taip;1;6;0;7
8905;Rūta;BORUŽĖLĖS;3873876608;Taip;5;1;0;6
8906;Rūta;BORUŽĖLĖS;7631229177;Taip;15;0;0;15
8907;Rūta;VYTURĖLIAI;1938200654;Ne;3;0;0;3
8908;Rūta;VYTURĖLIAI;31821660367;Taip;0;2;0;2
8909;Rūta;VYTURĖLIAI;14552031490;Taip;0;1;0;1
8910;Rūta;VYTURĖLIAI;58334018927;Taip;0;0;1;1
8911;Rūta;VYTURĖLIAI;24807873951;Taip;0;1;0;1
8912;Rūta;VYTURĖLIAI;86163505598;Taip;4;0;3;7
8913;Rūta;VYTURĖLIAI;89650991326;Taip;0;1;0;1
8914;Rūta;VYTURĖLIAI;86514347752;Taip;11;3;0;14
8915;Rūta;VYTURĖLIAI;8941291651;Taip;0;2;0;2
8916;Rūta;VYTURĖLIAI;92007397776;Taip;0;1;0;1
8917;Rūta;VYTURĖLIAI;92554408021;Taip;8;0;1;9
8918;Rūta;VYTURĖLIAI;27023480832;Taip;5;0;0;5
8919;Rūta;VYTURĖLIAI;87233420613;Taip;0;2;0;2
8920;Rūta;VYTURĖLIAI;90699177243;Taip;0;0;1;1
8921;Rūta;VYTURĖLIAI;70038163995;Taip;0;0;2;2
8922;Rūta;VYTURĖLIAI;56355568788;Taip;6;0;4;10
8923;Rūta;VYTURĖLIAI;21286497837;Taip;2;0;0;2
8924;Rūta;VYTURĖLIAI;74717101386;Taip;5;2;0;7
8925;Rūta;VYTURĖLIAI;67822551240;Taip;5;0;0;5
8926;Rūta;VYTURĖLIAI;8213932715;Taip;6;5;0;11
8927;Rūta;"PABIRUČIAI (LOGOPEDINĖ)";70608720189;Taip;1;0;0;1
8928;Rūta;"PABIRUČIAI (LOGOPEDINĖ)";97812491022;Taip;0;0;1;1
8929;Rūta;"PABIRUČIAI (LOGOPEDINĖ)";1489564914;Taip;0;11;0;11
8930;Rūta;"PABIRUČIAI (LOGOPEDINĖ)";45484303685;Taip;0;0;1;1
8931;Rūta;GUDRUČIAI;69788516459;Taip;0;8;0;8
8932;Rūta;GUDRUČIAI;78925728976;Ne;6;0;0;6
8933;Rūta;GUDRUČIAI;44365150696;Taip;0;7;0;7
8934;Rūta;GUDRUČIAI;10957816153;Taip;0;6;0;6
8935;Rūta;GUDRUČIAI;13023764979;Taip;0;1;0;1
8936;Rūta;GUDRUČIAI;4409524323;Taip;9;1;0;10
8937;Rūta;GUDRUČIAI;2033577529;Taip;0;8;0;8
8938;Rūta;GUDRUČIAI;79762491266;Taip;5;1;0;6
8939;Rūta;GUDRUČIAI;24211514845;Taip;0;0;2;2
8940;Rūta;GUDRUČIAI;48213220767;Ne;4;3;0;7
8941;Rūta;GUDRUČIAI;50266063379;Ne;6;3;2;11
8942;Rūta;GUDRUČIAI;28676981495;Taip;5;2;0;7
8943;Rūta;GUDRUČIAI;81049938466;Taip;0;4;0;4
8944;Rūta;GUDRUČIAI;67740925555;Taip;0;2;0;2
8945;Rūta;GUDRUČIAI;34935546673;Taip;5;1;0;6
8946;Rūta;GUDRUČIAI;47869128534;Taip;5;1;0;6
8947;Rūta;GUDRUČIAI;28332403249;Taip;0;3;1;4
8948;Rūta;GUDRUČIAI;91072621203;Taip;0;10;0;10
8949;Rūta;GUDRUČIAI;28158130932;Taip;15;1;0;16
8950;Rūta;SEKLYTĖLĖ;73486569144;Taip;0;1;0;1
8951;Rūta;SEKLYTĖLĖ;63130007113;Taip;5;0;0;5
8952;Rūta;SEKLYTĖLĖ;36767660286;Taip;0;3;0;3
8953;Rūta;SEKLYTĖLĖ;44422869429;Taip;0;4;0;4
8954;Rūta;SEKLYTĖLĖ;74600889000;Taip;0;12;0;12
8955;Rūta;SEKLYTĖLĖ;61614584274;Taip;1;0;3;4
8956;Rūta;SEKLYTĖLĖ;91160282230;Taip;5;0;0;5
8957;Rūta;SEKLYTĖLĖ;7273166365;Ne;5;0;0;5
8958;Rūta;SEKLYTĖLĖ;28539513133;Taip;5;0;3;8
8959;Rūta;SEKLYTĖLĖ;11116950913;Taip;5;0;5;10
8960;Rūta;SEKLYTĖLĖ;32768658491;Taip;5;2;0;7
8961;Rūta;SEKLYTĖLĖ;39447933171;Ne;2;0;0;2
8962;Rūta;SEKLYTĖLĖ;52426424863;Taip;1;2;1;4
8963;Rūta;SEKLYTĖLĖ;94077980408;Taip;0;6;0;6
8964;Rūta;SEKLYTĖLĖ;9037549271;Taip;10;2;0;12
8965;Rūta;SEKLYTĖLĖ;1789959175;Taip;0;7;0;7
8966;Rūta;SEKLYTĖLĖ;5905750207;Taip;0;0;2;2
8967;Rūta;SEKLYTĖLĖ;2080471128;Taip;5;0;6;11
8968;Rūta;SEKLYTĖLĖ;1168419924;Taip;0;6;0;6
8969;Rūta;"VARPELIAI (LOGOPEDINĖ)";13743264567;Taip;5;2;0;7
8970;Rūta;"VARPELIAI (LOGOPEDINĖ)";23413166816;Taip;0;10;0;10
8971;Rūta;"VARPELIAI (LOGOPEDINĖ)";97163853698;Taip;0;0;5;5
8972;Rūta;"VARPELIAI (LOGOPEDINĖ)";1617760535;Taip;0;0;1;1
8973;Rūta;KIŠKUČIŲ;4297300799;Taip;0;10;0;10
8974;Rūta;KIŠKUČIŲ;6207902435;Taip;0;4;0;4
8975;Rūta;KIŠKUČIŲ;9791861646;Taip;4;0;1;5
8976;Rūta;KIŠKUČIŲ;8182243701;Taip;5;1;9;15
8977;Rūta;KIŠKUČIŲ;3454881685;Taip;0;6;0;6
8978;Rūta;KIŠKUČIŲ;3043164521;Taip;8;0;3;11
8979;Rūta;KIŠKUČIŲ;4293920701;Taip;0;0;1;1
8980;Rūta;KIŠKUČIŲ;1510268514;Taip;5;1;0;6
8981;Rūta;KIŠKUČIŲ;4728904136;Taip;0;11;0;11
8982;Rūta;KIŠKUČIŲ;9419809946;Taip;0;0;2;2
8983;Rūta;KIŠKUČIŲ;1811055786;Taip;0;0;2;2
8984;Rūta;KIŠKUČIŲ;2928803089;Taip;10;8;0;18
8985;Rūta;KIŠKUČIŲ;3875136625;Taip;0;0;1;1
8986;Rūta;KIŠKUČIŲ;2702537976;Taip;5;1;0;6
8987;Rūta;ŽVIRBLIUKAI;3499727608;Taip;0;7;0;7
8988;Rūta;ŽVIRBLIUKAI;9765301038;Taip;0;7;0;7
8989;Rūta;ŽVIRBLIUKAI;8277677952;Taip;0;0;5;5
8990;Rūta;ŽVIRBLIUKAI;9638495757;Taip;5;0;2;7
8991;Rūta;ŽVIRBLIUKAI;3956912957;Ne;19;0;0;19
8992;Rūta;ŽVIRBLIUKAI;3055345528;Taip;0;4;0;4
8993;Rūta;ŽVIRBLIUKAI;4423305209;Ne;8;9;0;17
8994;Rūta;ŽVIRBLIUKAI;2890569107;Taip;0;0;10;10
8995;Rūta;ŽVIRBLIUKAI;3964922552;Taip;0;0;5;5
8996;Rūta;ŽVIRBLIUKAI;1216786487;Taip;0;11;0;11
8997;Rūta;ŽVIRBLIUKAI;9736567509;Taip;0;0;1;1
8998;Rūta;ŽVIRBLIUKAI;2474991135;Taip;0;0;2;2
8999;Rūta;ŽVIRBLIUKAI;7519931138;Taip;0;0;10;10
9000;Rūta;ŽVIRBLIUKAI;9400586178;Taip;0;0;4;4
9001;Rūta;SAULUTĖS;54140704807;Ne;0;0;8;8
9002;Rūta;SAULUTĖS;26830853793;Taip;0;1;0;1
9003;Rūta;SAULUTĖS;75322385068;Taip;0;1;0;1
9004;Rūta;SAULUTĖS;76518034714;Taip;0;5;0;5
9005;Rūta;SAULUTĖS;79192262053;Taip;7;0;3;10
9006;Rūta;SAULUTĖS;42791864630;Taip;0;1;0;1
9007;Rūta;SAULUTĖS;89880409419;Taip;0;0;9;9
9008;Rūta;SAULUTĖS;50734030014;Taip;10;0;0;10
9009;Rūta;SAULUTĖS;75730421646;Ne;0;7;0;7
9010;Rūta;SAULUTĖS;732948370;Taip;0;1;1;2
9011;Rūta;SAULUTĖS;2711671531;Taip;5;0;0;5
9012;Rūta;SAULUTĖS;29483136582;Taip;0;5;0;5
9013;Rūta;SAULUTĖS;5733023163;Taip;0;0;2;2
9014;Rūta;SAULUTĖS;7061384784;Taip;0;0;7;7
9015;Rūta;SAULUTĖS;9994442882;Taip;0;2;0;2
9016;Rūta;SAULUTĖS;2188905055;Taip;10;2;0;12
9017;Sadutė;Kiškučiai;38918375280;Taip;0;2;1;3
9018;Sadutė;Kiškučiai;62408324442;Taip;0;10;0;10
9019;Sadutė;Kiškučiai;12421864073;Ne;0;1;0;1
9020;Sadutė;Kiškučiai;3253659165;Taip;0;2;0;2
9021;Sadutė;Kiškučiai;98527988102;Taip;3;3;0;6
9022;Sadutė;Kiškučiai;62077575922;Ne;0;6;3;9
9023;Sadutė;Kiškučiai;75149739907;Taip;0;1;0;1
9024;Sadutė;Kiškučiai;61357382189;Taip;1;3;0;4
9025;Sadutė;Kiškučiai;1433422421;Taip;5;2;6;13
9026;Sadutė;Kiškučiai;73649870571;Taip;8;0;8;16
9027;Sadutė;Kiškučiai;1092421263;Taip;4;0;0;4
9028;Sadutė;Kiškučiai;1291782232;Taip;0;0;2;2
9029;Sadutė;Kiškučiai;5586949339;Taip;0;0;8;8
9030;Sadutė;Kiškučiai;64959385010;Taip;0;2;0;2
9031;Sadutė;Kiškučiai;9883685724;Taip;0;11;0;11
9032;Sadutė;Kiškučiai;4525909977;Taip;17;0;0;17
9033;Sadutė;Kiškučiai;1533081218;Taip;10;0;5;15
9034;Sadutė;Boružėlės;31020557647;Taip;12;0;3;15
9035;Sadutė;Boružėlės;99171108375;Taip;0;0;1;1
9036;Sadutė;Boružėlės;30046732620;Taip;0;2;0;2
9037;Sadutė;Boružėlės;91943880567;Taip;0;0;1;1
9038;Sadutė;Boružėlės;70505797915;Taip;16;0;5;21
9039;Sadutė;Boružėlės;48817619537;Taip;0;3;0;3
9040;Sadutė;Boružėlės;47883796567;Taip;0;1;3;4
9041;Sadutė;Boružėlės;93561298785;Taip;0;0;1;1
9042;Sadutė;Boružėlės;48327367042;Taip;0;0;3;3
9043;Sadutė;Boružėlės;4064111008;Taip;5;1;1;7
9044;Sadutė;Boružėlės;35237170892;Taip;0;4;0;4
9045;Sadutė;Boružėlės;45569403734;Taip;0;2;0;2
9046;Sadutė;Boružėlės;15950584691;Taip;0;0;2;2
9047;Sadutė;Boružėlės;84758378727;Taip;0;0;2;2
9048;Sadutė;Boružėlės;38373089101;Taip;0;0;1;1
9049;Sadutė;Boružėlės;13779484979;Taip;0;0;1;1
9050;Sadutė;Boružėlės;12989960431;Taip;0;0;1;1
9051;Sadutė;Boružėlės;2414632774;Taip;2;0;3;5
9052;Sadutė;Boružėlės;16493384211;Taip;0;1;8;9
9053;Sadutė;Boružėlės;71576294118;Ne;0;0;1;1
9054;Sadutė;Boružėlės;21011440269;Taip;6;0;2;8
9055;Sadutė;Boružėlės;39222963335;Taip;0;0;5;5
9056;Sadutė;Boružėlės;4695479762;Taip;2;8;0;10
9057;Sadutė;Boružėlės;1920496059;Taip;5;2;0;7
9058;Sadutė;Bitutės;68864977379;Taip;0;1;0;1
9059;Sadutė;Bitutės;37258486995;Ne;22;0;0;22
9060;Sadutė;Bitutės;15479694222;Ne;2;0;0;2
9061;Sadutė;Bitutės;23009676870;Taip;0;1;2;3
9062;Sadutė;Bitutės;67724608574;Taip;5;0;1;6
9063;Sadutė;Bitutės;61807934102;Taip;0;3;1;4
9064;Sadutė;Bitutės;40775963018;Taip;0;0;2;2
9065;Sadutė;Bitutės;38489473571;Taip;0;0;1;1
9066;Sadutė;Bitutės;71457072146;Taip;0;4;0;4
9067;Sadutė;Bitutės;8372941974;Ne;0;1;1;2
9068;Sadutė;Bitutės;6937310439;Taip;1;1;0;2
9069;Sadutė;Bitutės;64711220209;Taip;0;7;0;7
9070;Sadutė;Bitutės;71687440687;Taip;1;0;0;1
9071;Sadutė;Bitutės;5143204888;Ne;0;1;1;2
9072;Sadutė;Bitutės;68856441792;Taip;1;3;0;4
9073;Sadutė;Bitutės;97044964113;Taip;0;0;1;1
9074;Sadutė;Bitutės;63476202833;Taip;0;3;0;3
9075;Sadutė;Bitutės;64311208989;Taip;0;4;0;4
9076;Sadutė;Bitutės;78335876444;Taip;0;0;5;5
9077;Sadutė;Bitutės;2133207259;Taip;1;0;0;1
9078;Sadutė;Bitutės;50846021514;Taip;0;0;3;3
9079;Sadutė;Drugeliai;9090754149;Taip;6;0;1;7
9080;Sadutė;Drugeliai;1552350084;Taip;0;14;0;14
9081;Sadutė;Drugeliai;7910380894;Taip;5;1;0;6
9082;Sadutė;Drugeliai;2467800545;Taip;12;0;0;12
9083;Sadutė;Drugeliai;8713575864;Taip;7;0;0;7
9084;Sadutė;Drugeliai;6994547344;Taip;0;0;2;2
9085;Sadutė;Drugeliai;1782594187;Ne;4;1;0;5
9086;Sadutė;Drugeliai;5816844295;Taip;0;10;1;11
9087;Sadutė;Drugeliai;2095914442;Taip;8;0;2;10
9088;Sadutė;Drugeliai;8803249656;Taip;22;0;0;22
9089;Sadutė;Drugeliai;4901634532;Taip;7;0;1;8
9090;Sadutė;Drugeliai;6196282159;Taip;21;0;0;21
9091;Sadutė;Drugeliai;8953107298;Taip;20;0;0;20
9092;Sadutė;Drugeliai;5139219626;Taip;5;0;1;6
9093;Sadutė;Drugeliai;1735450955;Taip;0;1;0;1
9094;Sadutė;Drugeliai;2064784580;Taip;0;1;0;1
9095;Sadutė;Drugeliai;2883991326;Taip;5;0;0;5
9096;Sadutė;Pėledžiukai;50662732693;Taip;17;0;0;17
9097;Sadutė;Pėledžiukai;26761581977;Taip;0;10;0;10
9098;Sadutė;Pėledžiukai;1885941594;Taip;0;9;0;9
9099;Sadutė;Pėledžiukai;4933574100;Taip;0;4;0;4
9100;Sadutė;Pėledžiukai;6105924871;Taip;2;0;1;3
9101;Sadutė;Pėledžiukai;8870465478;Taip;0;22;0;22
9102;Sadutė;Pėledžiukai;14962142857;Taip;0;8;0;8
9103;Sadutė;Pėledžiukai;92111253012;Taip;0;3;0;3
9104;Sadutė;Pėledžiukai;1594844154;Taip;7;0;0;7
9105;Sadutė;Pėledžiukai;1005751811;Taip;13;7;0;20
9106;Sadutė;Pėledžiukai;45981672295;Taip;2;2;0;4
9107;Sadutė;Pėledžiukai;5864572784;Taip;0;0;1;1
9108;Sadutė;Pėledžiukai;8667620186;Taip;0;10;0;10
9109;Sadutė;Pėledžiukai;9946417453;Taip;0;4;0;4
9110;Sadutė;Pėledžiukai;48818906299;Taip;10;0;0;10
9111;Sadutė;Pėledžiukai;1190667513;Taip;5;2;0;7
9112;Sadutė;Pėledžiukai;1988169256;Taip;0;21;0;21
9113;Sadutė;Kačiukų;1507052440;Taip;15;0;0;15
9114;Sadutė;Kačiukų;1903961488;Taip;5;1;0;6
9115;Sadutė;Kačiukų;2890916313;Taip;0;22;0;22
9116;Sadutė;Kačiukų;2733633163;Taip;0;0;3;3
9117;Sadutė;Kačiukų;3993181500;Taip;0;10;0;10
9118;Sadutė;Kačiukų;1871236869;Taip;3;0;1;4
9119;Sadutė;Kačiukų;1759479328;Taip;0;22;0;22
9120;Sadutė;Kačiukų;8835627470;Taip;20;0;2;22
9121;Sadutė;Kačiukų;1975767401;Taip;5;0;0;5
9122;Sadutė;Kačiukų;2532626934;Taip;0;2;0;2
9123;Sadutė;Kačiukų;2466024649;Taip;3;0;2;5
9124;Sadutė;Kačiukų;6253351299;Taip;0;0;2;2
9125;Sadutė;Kačiukų;2426974464;Taip;0;0;6;6
9126;Sadutė;Kačiukų;5438448926;Taip;10;0;2;12
9127;Sadutė;Kačiukų;8974374101;Taip;0;22;0;22
9128;Sadutė;Kačiukų;9285865812;Taip;7;0;0;7
9129;Sadutė;Kačiukų;4401870028;Taip;0;1;1;2
9130;Sakalėlis;GIRINUKŲ;15886891387;Taip;0;7;0;7
9131;Sakalėlis;GIRINUKŲ;18298832212;Taip;9;0;1;10
9132;Sakalėlis;GIRINUKŲ;2124748537;Taip;0;0;4;4
9133;Sakalėlis;GIRINUKŲ;97259304899;Taip;5;0;6;11
9134;Sakalėlis;GIRINUKŲ;8952808128;Taip;0;0;1;1
9135;Sakalėlis;GIRINUKŲ;1605682818;Taip;0;7;0;7
9136;Sakalėlis;GIRINUKŲ;68379930730;Taip;0;4;0;4
9137;Sakalėlis;GIRINUKŲ;57477662126;Taip;0;0;1;1
9138;Sakalėlis;GIRINUKŲ;78050507580;Taip;6;0;2;8
9139;Sakalėlis;GIRINUKŲ;11432510669;Taip;0;2;1;3
9140;Sakalėlis;GIRINUKŲ;19456041826;Taip;15;0;1;16
9141;Sakalėlis;GIRINUKŲ;28930740067;Taip;0;2;0;2
9142;Sakalėlis;GIRINUKŲ;88344653299;Taip;4;0;0;4
9143;Sakalėlis;GIRINUKŲ;64656067319;Taip;0;5;0;5
9144;Sakalėlis;GIRINUKŲ;15950016412;Taip;3;0;0;3
9145;Sakalėlis;GIRINUKŲ;87950904971;Taip;0;7;0;7
9146;Sakalėlis;GIRINUKŲ;1075787529;Taip;7;0;4;11
9147;Sakalėlis;GIRINUKŲ;44702801581;Taip;0;0;2;2
9148;Sakalėlis;GIRINUKŲ;1421038685;Taip;4;0;5;9
9149;Sakalėlis;GIRINUKŲ;3995095832;Taip;0;5;1;6
9150;Sakalėlis;GIRINUKŲ;9634589602;Taip;5;0;2;7
9151;Sakalėlis;VYTURIUKŲ;330571735;Taip;0;0;1;1
9152;Sakalėlis;VYTURIUKŲ;8520589200;Taip;2;0;0;2
9153;Sakalėlis;VYTURIUKŲ;36411138178;Ne;1;0;1;2
9154;Sakalėlis;VYTURIUKŲ;7852180045;Taip;0;12;9;21
9155;Sakalėlis;VYTURIUKŲ;27291131963;Taip;0;2;0;2
9156;Sakalėlis;VYTURIUKŲ;1822130260;Taip;10;0;0;10
9157;Sakalėlis;VYTURIUKŲ;25558438129;Taip;8;0;0;8
9158;Sakalėlis;VYTURIUKŲ;33360718659;Taip;9;1;0;10
9159;Sakalėlis;VYTURIUKŲ;99937511623;Taip;0;0;7;7
9160;Sakalėlis;VYTURIUKŲ;32956243898;Taip;0;0;1;1
9161;Sakalėlis;VYTURIUKŲ;87806505145;Taip;0;0;1;1
9162;Sakalėlis;VYTURIUKŲ;59067963901;Taip;22;0;0;22
9163;Sakalėlis;VYTURIUKŲ;1371469574;Taip;0;9;0;9
9164;Sakalėlis;VYTURIUKŲ;74622921410;Taip;0;0;1;1
9165;Sakalėlis;VYTURIUKŲ;13953070987;Taip;4;0;5;9
9166;Sakalėlis;VYTURIUKŲ;80747256105;Taip;0;0;9;9
9167;Sakalėlis;VYTURIUKŲ;77801416034;Taip;10;0;0;10
9168;Sakalėlis;VYTURIUKŲ;12601081196;Taip;0;0;5;5
9169;Sakalėlis;DRUGELIŲ;21956747394;Taip;9;1;3;13
9170;Sakalėlis;DRUGELIŲ;25352655265;Taip;0;3;0;3
9171;Sakalėlis;DRUGELIŲ;45025342634;Taip;5;0;0;5
9172;Sakalėlis;DRUGELIŲ;56640981370;Taip;6;0;6;12
9173;Sakalėlis;DRUGELIŲ;91226844252;Taip;0;0;11;11
9174;Sakalėlis;DRUGELIŲ;86990914938;Taip;5;0;7;12
9175;Sakalėlis;DRUGELIŲ;72249916736;Taip;8;0;1;9
9176;Sakalėlis;DRUGELIŲ;76192257851;Taip;4;0;0;4
9177;Sakalėlis;DRUGELIŲ;15476097840;Taip;6;4;0;10
9178;Sakalėlis;DRUGELIŲ;2997731442;Ne;10;0;0;10
9179;Sakalėlis;DRUGELIŲ;62214587998;Taip;0;0;2;2
9180;Sakalėlis;DRUGELIŲ;50107185320;Taip;7;0;1;8
9181;Sakalėlis;DRUGELIŲ;1320801494;Ne;8;0;2;10
9182;Sakalėlis;DRUGELIŲ;10560758846;Taip;0;0;2;2
9183;Sakalėlis;DRUGELIŲ;85527501724;Taip;0;0;2;2
9184;Sakalėlis;DRUGELIŲ;52603313942;Taip;0;0;1;1
9185;Sakalėlis;DRUGELIŲ;1194658676;Taip;8;0;0;8
9186;Sakalėlis;DRUGELIŲ;1508916735;Taip;8;0;0;8
9187;Sakalėlis;DRUGELIŲ;69625812172;Taip;1;0;0;1
9188;Sakalėlis;GENIUKŲ;58012583231;Ne;0;0;2;2
9189;Sakalėlis;GENIUKŲ;1114100138;Ne;0;0;1;1
9190;Sakalėlis;GENIUKŲ;47416622432;Taip;0;4;0;4
9191;Sakalėlis;GENIUKŲ;57612724915;Taip;2;0;0;2
9192;Sakalėlis;GENIUKŲ;63956070819;Taip;0;8;0;8
9193;Sakalėlis;GENIUKŲ;98322175734;Taip;0;0;4;4
9194;Sakalėlis;GENIUKŲ;70569243858;Taip;8;8;0;16
9195;Sakalėlis;GENIUKŲ;87968405810;Taip;7;0;1;8
9196;Sakalėlis;GENIUKŲ;72599730052;Taip;0;4;0;4
9197;Sakalėlis;GENIUKŲ;72915270234;Taip;0;0;3;3
9198;Sakalėlis;GENIUKŲ;24174522552;Taip;0;0;7;7
9199;Sakalėlis;GENIUKŲ;87799673875;Taip;10;0;4;14
9200;Sakalėlis;GENIUKŲ;47647167225;Taip;0;0;1;1
9201;Sakalėlis;GENIUKŲ;31894397351;Taip;0;0;3;3
9202;Sakalėlis;GENIUKŲ;72289518955;Taip;0;0;1;1
9203;Sakalėlis;GENIUKŲ;13087021336;Taip;0;0;13;13
9204;Sakalėlis;GENIUKŲ;96677994919;Taip;0;0;2;2
9205;Sakalėlis;GENIUKŲ;82248904456;Taip;0;0;1;1
9206;Sakalėlis;GENIUKŲ;23722033078;Taip;0;0;5;5
9207;Sakalėlis;GENIUKŲ;78556677636;Taip;0;0;9;9
9208;Sakalėlis;GENIUKŲ;1321373130;Taip;5;0;5;10
9209;Sakalėlis;GENIUKŲ;31151919975;Ne;0;0;4;4
9210;Sakalėlis;VOVERIUKŲ;4430763418;Taip;0;3;0;3
9211;Sakalėlis;VOVERIUKŲ;6190741162;Ne;6;0;5;11
9212;Sakalėlis;VOVERIUKŲ;1702964714;Taip;15;0;0;15
9213;Sakalėlis;VOVERIUKŲ;4495453007;Taip;16;0;0;16
9214;Sakalėlis;VOVERIUKŲ;3962436122;Taip;0;1;0;1
9215;Sakalėlis;VOVERIUKŲ;1946531018;Taip;2;6;0;8
9216;Sakalėlis;VOVERIUKŲ;2796230671;Taip;0;4;2;6
9217;Sakalėlis;VOVERIUKŲ;1210451022;Taip;0;5;0;5
9218;Sakalėlis;VOVERIUKŲ;1912068116;Taip;7;0;0;7
9219;Sakalėlis;VOVERIUKŲ;8662137531;Taip;0;5;0;5
9220;Sakalėlis;VOVERIUKŲ;1104881142;Taip;0;0;2;2
9221;Sakalėlis;VOVERIUKŲ;3678172501;Taip;0;3;0;3
9222;Sakalėlis;VOVERIUKŲ;1133377117;Taip;0;0;6;6
9223;Sakalėlis;VOVERIUKŲ;5782214279;Taip;6;0;2;8
9224;Sakalėlis;VOVERIUKŲ;22614338778;Taip;5;0;0;5
9225;Sakalėlis;VOVERIUKŲ;34464485043;Taip;11;0;2;13
9226;Sakalėlis;VOVERIUKŲ;30987215315;Taip;4;0;0;4
9227;Sakalėlis;VOVERIUKŲ;7567476424;Taip;7;0;0;7
9228;Sakalėlis;VOVERIUKŲ;6180987643;Taip;7;0;3;10
9229;Sakalėlis;PĖLEDŽIUKŲ;1974955778;Taip;0;0;2;2
9230;Sakalėlis;PĖLEDŽIUKŲ;69254656227;Taip;0;0;1;1
9231;Sakalėlis;PĖLEDŽIUKŲ;4573623341;Taip;0;0;8;8
9232;Sakalėlis;PĖLEDŽIUKŲ;60463584826;Taip;0;0;11;11
9233;Sakalėlis;PĖLEDŽIUKŲ;1359444361;Taip;0;0;3;3
9234;Sakalėlis;PĖLEDŽIUKŲ;58113060986;Taip;3;0;0;3
9235;Sakalėlis;PĖLEDŽIUKŲ;89579043958;Taip;0;6;0;6
9236;Sakalėlis;PĖLEDŽIUKŲ;54902207576;Taip;0;6;0;6
9237;Sakalėlis;PĖLEDŽIUKŲ;81593611262;Taip;0;0;1;1
9238;Sakalėlis;PĖLEDŽIUKŲ;33825546706;Taip;5;4;0;9
9239;Sakalėlis;PĖLEDŽIUKŲ;81361557297;Taip;7;0;3;10
9240;Sakalėlis;PĖLEDŽIUKŲ;39504139934;Taip;3;0;0;3
9241;Sakalėlis;PĖLEDŽIUKŲ;67193921335;Taip;5;0;0;5
9242;Sakalėlis;PĖLEDŽIUKŲ;6301366135;Taip;0;5;0;5
9243;Sakalėlis;PĖLEDŽIUKŲ;37201848270;Taip;0;0;1;1
9244;Sakalėlis;PĖLEDŽIUKŲ;49947049847;Taip;0;0;3;3
9245;Sakalėlis;PĖLEDŽIUKŲ;36670171187;Taip;0;0;2;2
9246;Sakalėlis;PĖLEDŽIUKŲ;4364341933;Taip;0;0;2;2
9247;Sakalėlis;PĖLEDŽIUKŲ;79413947806;Taip;9;1;0;10
9248;Sakalėlis;"BITUČIŲ (LOGOPEDINĖ)";1139467130;Taip;9;0;0;9
9249;Sakalėlis;"BITUČIŲ (LOGOPEDINĖ)";4649447372;Taip;11;0;0;11
9250;Sakalėlis;"BITUČIŲ (LOGOPEDINĖ)";1219441890;Taip;0;0;2;2
9251;Sakalėlis;"BITUČIŲ (LOGOPEDINĖ)";16884257622;Taip;0;0;2;2
9252;Sakalėlis;"BITUČIŲ (LOGOPEDINĖ)";4086981816;Ne;0;0;3;3
9253;Sakalėlis;"BITUČIŲ (LOGOPEDINĖ)";4716949191;Taip;0;0;3;3
9254;Sakalėlis;"BITUČIŲ (LOGOPEDINĖ)";7241416465;Ne;0;0;5;5
9255;Sakalėlis;"BITUČIŲ (LOGOPEDINĖ)";2074868084;Taip;0;22;0;22
9256;Sakalėlis;"BITUČIŲ (LOGOPEDINĖ)";6321575268;Taip;4;0;0;4
9257;Sakalėlis;"BITUČIŲ (LOGOPEDINĖ)";9740003273;Taip;0;0;1;1
9258;Sakalėlis;"BITUČIŲ (LOGOPEDINĖ)";1384225025;Ne;0;0;2;2
9259;Sakalėlis;"BITUČIŲ (LOGOPEDINĖ)";8852001037;Taip;7;0;1;8
9260;Sakalėlis;"BORUŽIUKŲ (LOGOPEDINĖ)";68146506860;Taip;0;6;0;6
9261;Sakalėlis;"BORUŽIUKŲ (LOGOPEDINĖ)";92557587855;Ne;5;0;0;5
9262;Sakalėlis;"BORUŽIUKŲ (LOGOPEDINĖ)";32402268054;Taip;0;4;0;4
9263;Sakalėlis;"BORUŽIUKŲ (LOGOPEDINĖ)";8973784809;Taip;0;6;0;6
9264;Sakalėlis;"BORUŽIUKŲ (LOGOPEDINĖ)";22863239773;Taip;0;2;0;2
9265;Sakalėlis;"BORUŽIUKŲ (LOGOPEDINĖ)";70791762492;Taip;7;0;0;7
9266;Sakalėlis;"BORUŽIUKŲ (LOGOPEDINĖ)";9452901338;Taip;0;5;0;5
9267;Sakalėlis;"BORUŽIUKŲ (LOGOPEDINĖ)";76019778588;Taip;0;13;0;13
9268;Sakalėlis;"BORUŽIUKŲ (LOGOPEDINĖ)";4514546151;Ne;0;1;0;1
9269;Sakalėlis;"BORUŽIUKŲ (LOGOPEDINĖ)";50037388220;Taip;1;4;0;5
9270;Sakalėlis;MEŠKUČIŲ;1027765680;Ne;4;0;0;4
9271;Sakalėlis;MEŠKUČIŲ;3371763993;Taip;10;0;0;10
9272;Sakalėlis;MEŠKUČIŲ;4515180509;Taip;13;0;0;13
9273;Sakalėlis;MEŠKUČIŲ;2829386777;Taip;12;0;0;12
9274;Sakalėlis;MEŠKUČIŲ;8936933971;Taip;0;0;4;4
9275;Sakalėlis;MEŠKUČIŲ;9830907922;Taip;0;14;0;14
9276;Sakalėlis;MEŠKUČIŲ;96053733139;Taip;9;12;0;21
9277;Sakalėlis;MEŠKUČIŲ;1552929452;Taip;8;0;0;8
9278;Sakalėlis;MEŠKUČIŲ;1526540031;Ne;5;5;0;10
9279;Sakalėlis;MEŠKUČIŲ;7987368969;Taip;0;0;3;3
9280;Sakalėlis;MEŠKUČIŲ;4612388683;Taip;0;12;0;12
9281;Sakalėlis;MEŠKUČIŲ;4775685174;Taip;5;0;2;7
9282;Sakalėlis;MEŠKUČIŲ;5717022080;Taip;2;0;0;2
9283;Sakalėlis;MEŠKUČIŲ;7085108710;Taip;5;0;0;5
9284;Sakalėlis;MEŠKUČIŲ;69916351348;Taip;16;0;0;16
9285;Sakalėlis;MEŠKUČIŲ;7159705304;Taip;17;0;0;17
9286;Sakalėlis;MEŠKUČIŲ;3337299648;Taip;8;0;0;8
9287;Sakalėlis;MEŠKUČIŲ;43677485606;Taip;1;0;0;1
9288;Sakalėlis;MEŠKUČIŲ;81681433432;Taip;0;7;1;8
9289;Sakalėlis;MEŠKUČIŲ;6727251397;Taip;0;12;0;12
9290;Sakalėlis;KIŠKUČIŲ;5496044442;Taip;9;0;0;9
9291;Sakalėlis;KIŠKUČIŲ;2474164013;Ne;19;0;0;19
9292;Sakalėlis;KIŠKUČIŲ;5405669698;Ne;1;0;0;1
9293;Sakalėlis;KIŠKUČIŲ;9493905856;Taip;0;0;3;3
9294;Sakalėlis;KIŠKUČIŲ;3165387995;Taip;4;0;2;6
9295;Sakalėlis;KIŠKUČIŲ;6603105354;Ne;0;0;2;2
9296;Sakalėlis;KIŠKUČIŲ;3748865437;Taip;0;5;0;5
9297;Sakalėlis;KIŠKUČIŲ;8667155756;Ne;6;0;2;8
9298;Sakalėlis;KIŠKUČIŲ;6706466627;Taip;6;0;2;8
9299;Sakalėlis;KIŠKUČIŲ;4458071075;Taip;14;0;0;14
9300;Sakalėlis;KIŠKUČIŲ;4209146744;Taip;2;0;0;2
9301;Sakalėlis;KIŠKUČIŲ;2780141413;Taip;0;8;0;8
9302;Sakalėlis;KIŠKUČIŲ;4596727938;Taip;0;0;2;2
9303;Sakalėlis;KIŠKUČIŲ;3333037807;Taip;1;0;0;1
9304;Sakalėlis;KIŠKUČIŲ;6700169944;Taip;7;0;0;7
9305;Sakalėlis;KIŠKUČIŲ;8790189865;Taip;5;2;0;7
9306;Sakalėlis;SVIRPLIUKŲ;9322351120;Taip;9;0;6;15
9307;Sakalėlis;SVIRPLIUKŲ;3680732318;Ne;0;8;0;8
9308;Sakalėlis;SVIRPLIUKŲ;4862004373;Taip;12;1;0;13
9309;Sakalėlis;SVIRPLIUKŲ;6579827280;Taip;0;10;0;10
9310;Sakalėlis;SVIRPLIUKŲ;6806170544;Taip;8;0;2;10
9311;Sakalėlis;SVIRPLIUKŲ;8381310908;Taip;4;0;0;4
9312;Sakalėlis;SVIRPLIUKŲ;5795250727;Taip;10;0;0;10
9313;Sakalėlis;SVIRPLIUKŲ;2985239904;Taip;4;1;2;7
9314;Sakalėlis;SVIRPLIUKŲ;3351218789;Ne;2;0;5;7
9315;Sakalėlis;SVIRPLIUKŲ;3927363997;Taip;11;2;0;13
9316;Sakalėlis;SVIRPLIUKŲ;9120873899;Taip;0;22;0;22
9317;Sakalėlis;SVIRPLIUKŲ;1347171934;Taip;17;0;0;17
9318;Sakalėlis;SVIRPLIUKŲ;7672947538;Taip;6;0;1;7
9319;Sakalėlis;SVIRPLIUKŲ;5233697077;Taip;22;0;0;22
9320;Sakalėlis;SVIRPLIUKŲ;2539006620;Taip;0;22;0;22
9321;Salininkų;BORUŽIUKAI;61252066272;Taip;0;1;0;1
9322;Salininkų;BORUŽIUKAI;10179604964;Taip;4;5;0;9
9323;Salininkų;BORUŽIUKAI;69329549093;Taip;7;0;0;7
9324;Salininkų;BORUŽIUKAI;86262807558;Taip;0;0;4;4
9325;Salininkų;BORUŽIUKAI;81713688097;Taip;5;1;0;6
9326;Salininkų;BORUŽIUKAI;32201000670;Taip;0;5;0;5
9327;Salininkų;BORUŽIUKAI;93466518815;Taip;5;8;0;13
9328;Salininkų;BORUŽIUKAI;75056599725;Taip;0;8;0;8
9329;Salininkų;BORUŽIUKAI;39675001939;Taip;0;0;3;3
9330;Salininkų;BORUŽIUKAI;16879258172;Taip;0;0;3;3
9331;Salininkų;BORUŽIUKAI;87653480003;Taip;8;3;0;11
9332;Salininkų;BORUŽIUKAI;1614501473;Taip;0;11;3;14
9333;Salininkų;BORUŽIUKAI;1632485114;Taip;5;0;0;5
9334;Salininkų;BORUŽIUKAI;40053462731;Ne;0;13;0;13
9335;Salininkų;BORUŽIUKAI;54352547774;Taip;2;0;2;4
9336;Salininkų;BORUŽIUKAI;8258045565;Taip;11;0;0;11
9337;Salininkų;BORUŽIUKAI;6978618796;Taip;0;11;0;11
9338;Salininkų;BORUŽIUKAI;8897523583;Taip;0;1;1;2
9339;Salininkų;BORUŽIUKAI;1507178637;Taip;0;1;1;2
9340;Salininkų;BORUŽIUKAI;88149790626;Taip;0;6;0;6
9341;Salininkų;GĖLYTĖS;3015863723;Taip;17;3;0;20
9342;Salininkų;GĖLYTĖS;3323233525;Taip;17;3;0;20
9343;Salininkų;GĖLYTĖS;1832393272;Taip;0;2;0;2
9344;Salininkų;GĖLYTĖS;7665409499;Taip;0;0;1;1
9345;Salininkų;GĖLYTĖS;9890660815;Taip;5;0;2;7
9346;Salininkų;GĖLYTĖS;4323257798;Taip;3;0;0;3
9347;Salininkų;GĖLYTĖS;6850925495;Taip;3;1;0;4
9348;Salininkų;GĖLYTĖS;3585435095;Taip;12;0;0;12
9349;Salininkų;GĖLYTĖS;2760231414;Taip;2;2;2;6
9350;Salininkų;GĖLYTĖS;9724367035;Taip;7;0;1;8
9351;Salininkų;GĖLYTĖS;1658695150;Taip;0;6;1;7
9352;Salininkų;GĖLYTĖS;7383557807;Taip;5;2;0;7
9353;Salininkų;GĖLYTĖS;9344614003;Taip;1;5;0;6
9354;Salininkų;GĖLYTĖS;2808778763;Taip;0;2;0;2
9355;Salininkų;GĖLYTĖS;6656578271;Ne;11;0;0;11
9356;Salininkų;GĖLYTĖS;2278499562;Taip;0;0;1;1
9357;Salininkų;GĖLYTĖS;8995565864;Taip;14;0;0;14
9358;Salininkų;GĖLYTĖS;8394582546;Taip;0;6;0;6
9359;Salininkų;GĖLYTĖS;6327046935;Taip;5;0;0;5
9360;Salininkų;DRUGELIAI;1641123436;Taip;22;0;0;22
9361;Salininkų;DRUGELIAI;1910467994;Taip;0;6;0;6
9362;Salininkų;DRUGELIAI;2812554783;Taip;1;0;1;2
9363;Salininkų;DRUGELIAI;14626363996;Taip;6;0;0;6
9364;Salininkų;DRUGELIAI;1883307260;Taip;5;0;1;6
9365;Salininkų;DRUGELIAI;1948988168;Taip;2;0;5;7
9366;Salininkų;DRUGELIAI;1868857584;Taip;0;0;2;2
9367;Salininkų;DRUGELIAI;1815368137;Taip;10;0;0;10
9368;Salininkų;DRUGELIAI;8157811781;Taip;0;13;0;13
9369;Salininkų;DRUGELIAI;48956671934;Taip;22;0;0;22
9370;Salininkų;DRUGELIAI;1963139815;Taip;5;0;2;7
9371;Salininkų;DRUGELIAI;45194646218;Taip;0;14;0;14
9372;Salininkų;DRUGELIAI;6301139299;Ne;0;0;1;1
9373;Salininkų;DRUGELIAI;6125334614;Taip;1;0;2;3
9374;Salininkų;DRUGELIAI;15199054558;Ne;4;5;0;9
9375;Salininkų;DRUGELIAI;8081095896;Ne;10;0;1;11
9376;Salininkų;DRUGELIAI;1568780329;Taip;2;6;0;8
9377;Salininkų;DRUGELIAI;30123603107;Taip;10;0;1;11
9378;Salininkų;DRUGELIAI;8659656902;Ne;8;0;0;8
9379;Salininkų;ŽIRNIUKAI;5063792784;Taip;0;0;6;6
9380;Salininkų;ŽIRNIUKAI;73016259669;Taip;0;2;1;3
9381;Salininkų;ŽIRNIUKAI;41023354439;Taip;3;0;0;3
9382;Salininkų;ŽIRNIUKAI;76449285846;Taip;0;2;2;4
9383;Salininkų;ŽIRNIUKAI;35611320012;Ne;0;1;0;1
9384;Salininkų;ŽIRNIUKAI;1180792335;Taip;8;0;0;8
9385;Salininkų;ŽIRNIUKAI;22167560908;Taip;0;1;0;1
9386;Salininkų;ŽIRNIUKAI;9513785510;Taip;4;0;2;6
9387;Salininkų;ŽIRNIUKAI;5689344488;Taip;7;0;0;7
9388;Salininkų;ŽIRNIUKAI;2292919406;Taip;0;12;0;12
9389;Salininkų;ŽIRNIUKAI;8683841956;Taip;0;1;0;1
9390;Salininkų;ŽIRNIUKAI;10335028421;Taip;2;2;3;7
9391;Salininkų;ŽIRNIUKAI;8488127476;Taip;13;0;0;13
9392;Salininkų;ŽIRNIUKAI;1723241116;Taip;22;0;0;22
9393;Salininkų;ŽIRNIUKAI;46867660097;Taip;0;10;0;10
9394;Salininkų;ŽIRNIUKAI;8288199783;Taip;6;0;0;6
9395;Salininkų;ŽIRNIUKAI;4269202761;Taip;21;0;0;21
9396;Salininkų;ŽIRNIUKAI;3692008687;Taip;0;15;0;15
9397;Salininkų;ŽIRNIUKAI;91859774311;Taip;5;0;2;7
9398;Salininkų;ŽIRNIUKAI;1065549119;Taip;11;0;0;11
9399;Salininkų;PAUKŠČIUKAI;1521333219;Taip;0;4;0;4
9400;Salininkų;PAUKŠČIUKAI;95919160139;Taip;7;0;0;7
9401;Salininkų;PAUKŠČIUKAI;23990693770;Taip;0;0;4;4
9402;Salininkų;PAUKŠČIUKAI;67593920224;Taip;0;11;0;11
9403;Salininkų;PAUKŠČIUKAI;81888649482;Taip;2;0;0;2
9404;Salininkų;PAUKŠČIUKAI;1153455356;Taip;0;5;0;5
9405;Salininkų;PAUKŠČIUKAI;1470744233;Taip;0;4;0;4
9406;Salininkų;PAUKŠČIUKAI;2031724954;Taip;0;10;0;10
9407;Salininkų;PAUKŠČIUKAI;52499970010;Taip;15;0;0;15
9408;Salininkų;PAUKŠČIUKAI;18178857793;Taip;9;1;0;10
9409;Salininkų;PAUKŠČIUKAI;1439852031;Taip;0;8;0;8
9410;Salininkų;PAUKŠČIUKAI;20609963605;Taip;22;0;0;22
9411;Salininkų;PAUKŠČIUKAI;1918440067;Taip;5;0;0;5
9412;Salininkų;PAUKŠČIUKAI;52194170807;Taip;20;0;0;20
9413;Salininkų;PAUKŠČIUKAI;86019335524;Taip;20;0;0;20
9414;Salininkų;PAUKŠČIUKAI;1586012117;Taip;0;7;0;7
9415;Salininkų;PAUKŠČIUKAI;29341671329;Taip;0;7;0;7
9416;Salininkų;PAUKŠČIUKAI;3878896109;Taip;5;11;0;16
9417;Salininkų;PAUKŠČIUKAI;16967442608;Taip;7;10;0;17
9418;Salvija;Daigelis(šatil);1517130961;Ne;0;5;0;5
9419;Salvija;Daigelis(šatil);1478775998;Taip;0;0;4;4
9420;Salvija;Daigelis(šatil);8802891478;Ne;0;0;6;6
9421;Salvija;Daigelis(šatil);24038366791;Taip;3;0;0;3
9422;Salvija;Daigelis(šatil);1261005294;Taip;10;0;0;10
9423;Salvija;Daigelis(šatil);62170308628;Taip;0;22;0;22
9424;Salvija;Daigelis(šatil);3424917706;Ne;0;0;9;9
9425;Salvija;Daigelis(šatil);5494438837;Taip;0;0;3;3
9426;Salvija;Daigelis(šatil);9908473681;Taip;0;0;3;3
9427;Salvija;Daigelis(šatil);4152602039;Taip;8;0;0;8
9428;Salvija;Daigelis(šatil);7546216874;Taip;0;0;1;1
9429;Salvija;Daigelis(šatil);9456556523;Taip;15;0;1;16
9430;Salvija;Daigelis(šatil);3856351749;Taip;13;0;1;14
9431;Salvija;Daigelis(šatil);1791922219;Taip;0;0;5;5
9432;Salvija;Daigelis(šatil);1653831148;Taip;0;0;1;1
9433;Salvija;Daigelis(šatil);8023422294;Taip;0;0;12;12
9434;Salvija;Daigelis(šatil);7449993309;Taip;0;0;22;22
9435;Salvija;"Pienė (savjon)";22615390885;Taip;0;10;0;10
9436;Salvija;"Pienė (savjon)";9168718017;Taip;17;0;1;18
9437;Salvija;"Pienė (savjon)";4167467237;Taip;0;3;0;3
9438;Salvija;"Pienė (savjon)";8585265946;Taip;0;0;3;3
9439;Salvija;"Pienė (savjon)";1641242817;Taip;6;1;0;7
9440;Salvija;"Pienė (savjon)";85826762998;Taip;0;1;1;2
9441;Salvija;"Pienė (savjon)";58888784609;Taip;0;9;0;9
9442;Salvija;"Pienė (savjon)";94262194866;Taip;0;0;1;1
9443;Salvija;"Pienė (savjon)";47567003954;Taip;0;2;0;2
9444;Salvija;"Pienė (savjon)";43416476269;Taip;0;6;0;6
9445;Salvija;"Pienė (savjon)";4845744417;Taip;0;5;0;5
9446;Salvija;"Pienė (savjon)";2495133021;Taip;0;1;0;1
9447;Salvija;"Pienė (savjon)";57752478379;Taip;0;9;0;9
9448;Salvija;"Pienė (savjon)";1103379012;Taip;0;0;3;3
9449;Saulėtekis;BERŽELIS;37001834066;Taip;21;0;0;21
9450;Saulėtekis;BERŽELIS;29935189464;Ne;0;0;3;3
9451;Saulėtekis;BERŽELIS;95214907923;Taip;0;1;0;1
9452;Saulėtekis;BERŽELIS;49102885577;Taip;0;6;0;6
9453;Saulėtekis;BERŽELIS;18801492293;Taip;0;0;5;5
9454;Saulėtekis;BERŽELIS;43809213927;Taip;0;1;0;1
9455;Saulėtekis;BERŽELIS;17046444483;Taip;0;0;2;2
9456;Saulėtekis;BERŽELIS;14357681543;Taip;0;0;5;5
9457;Saulėtekis;BERŽELIS;27109020149;Taip;0;2;0;2
9458;Saulėtekis;BERŽELIS;42952333477;Taip;0;10;0;10
9459;Saulėtekis;BERŽELIS;88165168902;Taip;0;9;0;9
9460;Saulėtekis;BERŽELIS;19786161536;Taip;0;4;0;4
9461;Saulėtekis;BERŽELIS;55975992548;Taip;0;11;0;11
9462;Saulėtekis;BERŽELIS;9333073549;Taip;0;9;0;9
9463;Saulėtekis;BERŽELIS;9632257866;Taip;11;0;1;12
9464;Saulėtekis;BERŽELIS;24403133622;Taip;10;8;0;18
9465;Saulėtekis;BERŽELIS;7440287746;Taip;10;6;0;16
9466;Saulėtekis;BERŽELIS;1359594045;Taip;3;0;0;3
9467;Saulėtekis;BERŽELIS;1502304241;Ne;0;16;0;16
9468;Saulėtekis;BERŽELIS;19209281962;Taip;0;0;3;3
9469;Saulėtekis;BERŽELIS;2096996257;Taip;15;0;0;15
9470;Saulėtekis;ŠYPSENA;1720125332;Taip;0;1;1;2
9471;Saulėtekis;ŠYPSENA;9972687066;Taip;1;4;0;5
9472;Saulėtekis;ŠYPSENA;7346852524;Ne;19;0;0;19
9473;Saulėtekis;ŠYPSENA;1902333363;Taip;5;5;0;10
9474;Saulėtekis;ŠYPSENA;6072030240;Taip;0;1;0;1
9475;Saulėtekis;ŠYPSENA;8574702901;Taip;8;1;0;9
9476;Saulėtekis;ŠYPSENA;7893982893;Taip;16;0;0;16
9477;Saulėtekis;ŠYPSENA;6501250875;Taip;18;0;0;18
9478;Saulėtekis;ŠYPSENA;9791926936;Taip;5;3;0;8
9479;Saulėtekis;ŠYPSENA;8620689981;Taip;22;0;0;22
9480;Saulėtekis;ŠYPSENA;8143793642;Taip;0;1;0;1
9481;Saulėtekis;ŠYPSENA;8603952810;Taip;2;0;0;2
9482;Saulėtekis;ŠYPSENA;9783450998;Taip;0;1;0;1
9483;Saulėtekis;ŠYPSENA;4909850069;Taip;0;2;0;2
9484;Saulėtekis;NYKŠTUKAI;62765692719;Ne;0;6;0;6
9485;Saulėtekis;NYKŠTUKAI;81074197598;Taip;0;1;0;1
9486;Saulėtekis;NYKŠTUKAI;87539304992;Taip;0;2;0;2
9487;Saulėtekis;NYKŠTUKAI;75818502835;Taip;0;1;0;1
9488;Saulėtekis;NYKŠTUKAI;1769434568;Taip;6;1;0;7
9489;Saulėtekis;NYKŠTUKAI;36050720419;Taip;16;1;0;17
9490;Saulėtekis;NYKŠTUKAI;1623791240;Taip;7;4;0;11
9491;Saulėtekis;NYKŠTUKAI;71042846070;Taip;6;0;0;6
9492;Saulėtekis;NYKŠTUKAI;9701092832;Taip;0;1;0;1
9493;Saulėtekis;NYKŠTUKAI;46936348504;Taip;6;7;0;13
9494;Saulėtekis;NYKŠTUKAI;47570401883;Taip;5;6;0;11
9495;Saulėtekis;NYKŠTUKAI;89956895058;Taip;10;1;0;11
9496;Saulėtekis;NYKŠTUKAI;90708381762;Taip;0;3;0;3
9497;Saulėtekis;NYKŠTUKAI;90484365520;Taip;3;1;0;4
9498;Saulėtekis;NYKŠTUKAI;40443812162;Taip;0;1;0;1
9499;Saulėtekis;NYKŠTUKAI;1288313734;Taip;0;4;0;4
9500;Saulėtekis;NYKŠTUKAI;9282898493;Taip;0;2;0;2
9501;Saulėtekis;PAGRANDUKAS;9428709415;Taip;0;3;0;3
9502;Saulėtekis;PAGRANDUKAS;8102360466;Taip;7;0;0;7
9503;Saulėtekis;PAGRANDUKAS;2371396923;Taip;10;0;1;11
9504;Saulėtekis;PAGRANDUKAS;4152255439;Taip;14;0;0;14
9505;Saulėtekis;PAGRANDUKAS;2209156661;Taip;6;0;1;7
9506;Saulėtekis;PAGRANDUKAS;3220993253;Taip;7;0;0;7
9507;Saulėtekis;PAGRANDUKAS;5552614092;Taip;0;0;2;2
9508;Saulėtekis;PAGRANDUKAS;9497129509;Taip;5;6;0;11
9509;Saulėtekis;PAGRANDUKAS;9918219913;Taip;10;0;0;10
9510;Saulėtekis;PAGRANDUKAS;8517049464;Taip;0;1;0;1
9511;Saulėtekis;PAGRANDUKAS;7186085219;Taip;0;0;2;2
9512;Saulėtekis;PAGRANDUKAS;1020209414;Taip;6;0;1;7
9513;Saulėtekis;PAGRANDUKAS;8745921541;Taip;3;0;0;3
9514;Saulėtekis;PAGRANDUKAS;2728836108;Taip;2;6;0;8
9515;Saulėtekis;PAGRANDUKAS;8390615573;Ne;10;0;1;11
9516;Saulėtekis;PAGRANDUKAS;2698535938;Taip;0;4;0;4
9517;Saulėtekis;PAGRANDUKAS;2656659133;Taip;14;2;0;16
9518;Saulėtekis;RAMUNĖLIŲ;70948000188;Taip;8;1;0;9
9519;Saulėtekis;RAMUNĖLIŲ;21299038354;Taip;0;4;0;4
9520;Saulėtekis;RAMUNĖLIŲ;1456140823;Taip;8;0;2;10
9521;Saulėtekis;RAMUNĖLIŲ;16450627896;Ne;0;0;1;1
9522;Saulėtekis;RAMUNĖLIŲ;60662699125;Taip;14;0;0;14
9523;Saulėtekis;RAMUNĖLIŲ;31291807930;Ne;12;6;0;18
9524;Saulėtekis;RAMUNĖLIŲ;49053923177;Taip;17;0;0;17
9525;Saulėtekis;RAMUNĖLIŲ;42485505048;Ne;6;8;0;14
9526;Saulėtekis;RAMUNĖLIŲ;86593254070;Taip;0;0;8;8
9527;Saulėtekis;RAMUNĖLIŲ;75785868657;Taip;18;0;0;18
9528;Saulėtekis;RAMUNĖLIŲ;10524532865;Taip;7;4;0;11
9529;Saulėtekis;RAMUNĖLIŲ;80037388013;Taip;2;0;0;2
9530;Saulėtekis;RAMUNĖLIŲ;1219435678;Taip;12;5;0;17
9531;Saulėtekis;RAMUNĖLIŲ;29662148323;Taip;15;0;0;15
9532;Saulėtekis;RAMUNĖLIŲ;3394231244;Taip;15;4;0;19
9533;Saulėtekis;RAMUNĖLIŲ;7544912614;Taip;4;3;0;7
9534;Saulėtekis;RAMUNĖLIŲ;1349303787;Taip;0;0;1;1
9535;Saulėtekis;RAMUNĖLIŲ;1103824875;Taip;0;0;1;1
9536;Saulėtekis;PASAKAITĖ;3458088977;Taip;10;0;0;10
9537;Saulėtekis;PASAKAITĖ;80652165734;Taip;0;0;1;1
9538;Saulėtekis;PASAKAITĖ;99932790328;Taip;13;0;0;13
9539;Saulėtekis;PASAKAITĖ;33621514262;Taip;0;0;3;3
9540;Saulėtekis;PASAKAITĖ;96500691386;Taip;4;0;0;4
9541;Saulėtekis;PASAKAITĖ;33485541086;Taip;0;10;0;10
9542;Saulėtekis;PASAKAITĖ;36401102768;Taip;0;3;0;3
9543;Saulėtekis;PASAKAITĖ;71579240842;Ne;0;4;0;4
9544;Saulėtekis;PASAKAITĖ;6833534993;Taip;2;0;0;2
9545;Saulėtekis;PASAKAITĖ;30101217515;Taip;0;5;0;5
9546;Saulėtekis;PASAKAITĖ;38524228416;Taip;0;0;1;1
9547;Saulėtekis;PASAKAITĖ;5068358612;Taip;6;0;0;6
9548;Saulėtekis;PASAKAITĖ;17692658424;Ne;8;1;0;9
9549;Saulėtekis;VARPELIAI;94326821425;Taip;0;12;0;12
9550;Saulėtekis;VARPELIAI;6984530386;Taip;0;1;0;1
9551;Saulėtekis;VARPELIAI;1069782559;Taip;5;0;0;5
9552;Saulėtekis;VARPELIAI;1339984127;Taip;0;7;0;7
9553;Saulėtekis;VARPELIAI;68563453302;Taip;10;2;0;12
9554;Saulėtekis;VARPELIAI;77901730057;Taip;0;9;0;9
9555;Saulėtekis;VARPELIAI;43127755042;Taip;0;1;0;1
9556;Saulėtekis;VARPELIAI;1154284625;Taip;5;1;0;6
9557;Saulėtekis;VARPELIAI;1335149249;Taip;0;2;0;2
9558;Saulėtekis;VARPELIAI;1108321396;Taip;0;0;1;1
9559;Saulėtekis;VARPELIAI;891603633;Taip;0;8;0;8
9560;Saulėtekis;VARPELIAI;36605502570;Taip;0;0;4;4
9561;Saulėtekis;VARPELIAI;2075281680;Taip;12;0;1;13
9562;Saulėtekis;VARPELIAI;1213567219;Ne;1;0;1;2
9563;Saulėtekis;VARPELIAI;61118132521;Ne;8;1;0;9
9564;Saulėtekis;VARPELIAI;7464965841;Taip;0;0;1;1
9565;Saulėtekis;VARPELIAI;6671771491;Taip;8;1;0;9
9566;Saulėtekis;VARPELIAI;8752857993;Taip;0;11;0;11
9567;Saulėtekis;VARPELIAI;2641849320;Ne;9;1;0;10
9568;Saulėtekis;GRŪDELIS;20794781914;Taip;10;6;0;16
9569;Saulėtekis;GRŪDELIS;9132383069;Taip;0;0;2;2
9570;Saulėtekis;GRŪDELIS;67951758325;Ne;22;0;0;22
9571;Saulėtekis;GRŪDELIS;70230805151;Taip;6;0;1;7
9572;Saulėtekis;GRŪDELIS;41775536104;Taip;0;6;0;6
9573;Saulėtekis;GRŪDELIS;12954283491;Taip;0;3;0;3
9574;Saulėtekis;GRŪDELIS;21376960952;Taip;0;5;0;5
9575;Saulėtekis;GRŪDELIS;4027823257;Taip;0;0;1;1
9576;Saulėtekis;GRŪDELIS;1180197203;Taip;0;5;2;7
9577;Saulėtekis;GRŪDELIS;1066191639;Taip;0;2;0;2
9578;Saulėtekis;GRŪDELIS;22570044589;Taip;0;10;0;10
9579;Saulėtekis;GRŪDELIS;1865278537;Taip;6;3;0;9
9580;Saulėtekis;GRŪDELIS;1220962473;Taip;0;4;0;4
9581;Saulėtekis;GRŪDELIS;53906058088;Taip;0;0;2;2
9582;Saulėtekis;GRŪDELIS;1646943569;Taip;8;0;2;10
9583;Saulėtekis;JONVABALIS;5003645081;Taip;2;0;7;9
9584;Saulėtekis;JONVABALIS;21569877958;Taip;15;0;0;15
9585;Saulėtekis;JONVABALIS;6736441901;Taip;5;6;0;11
9586;Saulėtekis;JONVABALIS;1466627555;Taip;0;7;0;7
9587;Saulėtekis;JONVABALIS;1691667254;Taip;21;0;0;21
9588;Saulėtekis;JONVABALIS;1064355395;Taip;0;4;0;4
9589;Saulėtekis;JONVABALIS;1715634399;Taip;5;8;0;13
9590;Saulėtekis;JONVABALIS;1897872021;Taip;0;8;0;8
9591;Saulėtekis;JONVABALIS;1010906684;Taip;12;0;0;12
9592;Saulėtekis;JONVABALIS;97037457833;Taip;22;0;0;22
9593;Saulėtekis;JONVABALIS;1111323783;Taip;3;12;0;15
9594;Saulėtekis;JONVABALIS;84492261206;Taip;0;8;0;8
9595;Saulėtekis;JONVABALIS;72559769416;Taip;2;1;0;3
9596;Saulėtekis;JONVABALIS;29552225924;Taip;2;3;0;5
9597;Saulėtekis;JONVABALIS;1611009868;Taip;19;0;0;19
9598;Saulėtekis;JONVABALIS;4613040294;Taip;11;1;0;12
9599;Saulėtekis;JONVABALIS;1655720839;Taip;13;3;0;16
9600;Saulėtekis;SMALSUČIAI;40877542045;Taip;5;4;0;9
9601;Saulėtekis;SMALSUČIAI;9095968376;Taip;0;9;0;9
9602;Saulėtekis;SMALSUČIAI;86524549051;Taip;0;0;1;1
9603;Saulėtekis;SMALSUČIAI;7030227903;Taip;10;1;0;11
9604;Saulėtekis;SMALSUČIAI;81118611780;Taip;7;2;0;9
9605;Saulėtekis;SMALSUČIAI;38762730531;Ne;0;4;0;4
9606;Saulėtekis;SMALSUČIAI;1808644850;Taip;11;7;0;18
9607;Saulėtekis;SMALSUČIAI;1642031589;Taip;0;15;0;15
9608;Saulėtekis;SMALSUČIAI;29472863931;Taip;0;5;0;5
9609;Saulėtekis;SMALSUČIAI;1568300232;Ne;9;0;1;10
9610;Saulėtekis;SMALSUČIAI;97771948184;Taip;14;0;0;14
9611;Saulėtekis;SMALSUČIAI;7621094096;Taip;0;7;0;7
9612;Saulėtekis;SMALSUČIAI;13451381485;Taip;14;0;0;14
9613;Saulėtekis;SMALSUČIAI;19605249139;Taip;0;1;0;1
9614;Saulėtekis;SMALSUČIAI;1619134034;Taip;3;6;0;9
9615;Saulėtekis;SMALSUČIAI;8673024996;Taip;11;0;0;11
9616;Saulėtekis;SMALSUČIAI;1456865685;Taip;0;8;0;8
9617;Saulėtekis;SMALSUČIAI;32658647272;Taip;6;0;0;6
9618;Saulėtekis;BITUTĖS;7766084857;Taip;6;0;0;6
9619;Saulėtekis;BITUTĖS;4537254306;Taip;0;4;0;4
9620;Saulėtekis;BITUTĖS;60462712074;Taip;1;0;1;2
9621;Saulėtekis;BITUTĖS;1699576940;Taip;0;1;0;1
9622;Saulėtekis;BITUTĖS;9945647968;Taip;18;1;0;19
9623;Saulėtekis;BITUTĖS;1962914764;Taip;12;6;0;18
9624;Saulėtekis;BITUTĖS;1481503733;Taip;6;0;0;6
9625;Saulėtekis;BITUTĖS;8302260087;Taip;0;6;0;6
9626;Saulėtekis;BITUTĖS;2593106154;Taip;0;1;0;1
9627;Saulėtekis;BITUTĖS;2813949848;Taip;15;0;0;15
9628;Saulėtekis;BITUTĖS;3058991890;Taip;0;15;0;15
9629;Saulėtekis;BITUTĖS;9983577817;Taip;0;10;0;10
9630;Saulėtekis;BITUTĖS;7986712728;Taip;0;7;0;7
9631;Saulėtekis;BITUTĖS;6087170055;Taip;5;0;0;5
9632;Saulėtekis;BITUTĖS;7027103276;Taip;0;9;0;9
9633;Saulėtekis;BITUTĖS;7758268674;Taip;13;0;0;13
9634;Saulėtekis;BITUTĖS;2077976415;Taip;8;0;1;9
9635;Saulėtekis;BITUTĖS;9605052795;Taip;18;0;0;18
9636;Saulėtekis;BITUTĖS;7075757274;Taip;11;0;0;11
9637;Saulėtekis;RIEŠUTĖLIAI;3337160930;Taip;0;1;2;3
9638;Saulėtekis;RIEŠUTĖLIAI;2021901593;Taip;0;7;0;7
9639;Saulėtekis;RIEŠUTĖLIAI;7842280836;Taip;0;3;0;3
9640;Saulėtekis;RIEŠUTĖLIAI;2238947856;Taip;0;13;0;13
9641;Saulėtekis;RIEŠUTĖLIAI;84982517658;Taip;0;1;0;1
9642;Saulėtekis;RIEŠUTĖLIAI;3541535891;Taip;8;0;0;8
9643;Saulėtekis;RIEŠUTĖLIAI;8231869593;Taip;10;0;0;10
9644;Saulėtekis;RIEŠUTĖLIAI;36003078842;Taip;0;2;0;2
9645;Saulėtekis;RIEŠUTĖLIAI;4663268649;Taip;0;3;0;3
9646;Saulėtekis;RIEŠUTĖLIAI;25199011812;Taip;0;0;2;2
9647;Saulėtekis;RIEŠUTĖLIAI;81153273188;Taip;0;6;0;6
9648;Saulėtekis;RIEŠUTĖLIAI;1290215067;Taip;0;0;2;2
9649;Saulėtekis;RIEŠUTĖLIAI;7051608858;Taip;12;0;0;12
9650;Saulėtekis;RIEŠUTĖLIAI;9634949452;Taip;9;4;0;13
9651;Saulėtekis;RIEŠUTĖLIAI;4338502152;Taip;5;1;0;6
9652;Saulėtekis;RIEŠUTĖLIAI;8002806189;Taip;0;0;5;5
9653;Saulėtekis;RIEŠUTĖLIAI;9657195627;Taip;3;7;0;10
9654;Skroblinukas;SVIRPLIUKŲ;56496090956;Ne;0;0;3;3
9655;Skroblinukas;SVIRPLIUKŲ;27948464942;Taip;4;0;2;6
9656;Skroblinukas;SVIRPLIUKŲ;92096423589;Taip;0;5;0;5
9657;Skroblinukas;SVIRPLIUKŲ;2034869306;Taip;5;2;0;7
9658;Skroblinukas;SVIRPLIUKŲ;2020866728;Taip;0;1;1;2
9659;Skroblinukas;SVIRPLIUKŲ;1059137398;Taip;0;3;4;7
9660;Skroblinukas;SVIRPLIUKŲ;91070212533;Taip;0;5;0;5
9661;Skroblinukas;SVIRPLIUKŲ;60291417607;Taip;0;6;0;6
9662;Skroblinukas;SVIRPLIUKŲ;18955401411;Taip;4;0;0;4
9663;Skroblinukas;SVIRPLIUKŲ;31484348317;Taip;12;0;2;14
9664;Skroblinukas;SVIRPLIUKŲ;88601994922;Taip;0;9;0;9
9665;Skroblinukas;SVIRPLIUKŲ;1364608720;Taip;2;4;0;6
9666;Skroblinukas;SVIRPLIUKŲ;30925721180;Taip;0;0;4;4
9667;Skroblinukas;SVIRPLIUKŲ;87902801288;Taip;2;2;0;4
9668;Skroblinukas;SVIRPLIUKŲ;1462404838;Ne;0;9;0;9
9669;Skroblinukas;SVIRPLIUKŲ;23551272822;Ne;6;2;1;9
9670;Skroblinukas;SVIRPLIUKŲ;2105394649;Taip;0;2;0;2
9671;Skroblinukas;GANDRIUKŲ;9936253477;Taip;0;2;0;2
9672;Skroblinukas;GANDRIUKŲ;11039821123;Ne;0;10;1;11
9673;Skroblinukas;GANDRIUKŲ;2574443420;Taip;0;0;3;3
9674;Skroblinukas;GANDRIUKŲ;47487985525;Taip;0;3;0;3
9675;Skroblinukas;GANDRIUKŲ;77924018810;Taip;0;1;2;3
9676;Skroblinukas;GANDRIUKŲ;21497082440;Taip;0;2;0;2
9677;Skroblinukas;GANDRIUKŲ;55187339508;Taip;0;3;0;3
9678;Skroblinukas;GANDRIUKŲ;29786434898;Taip;0;1;0;1
9679;Skroblinukas;GANDRIUKŲ;1852949849;Ne;0;3;0;3
9680;Skroblinukas;GANDRIUKŲ;74443337196;Taip;0;0;5;5
9681;Skroblinukas;GANDRIUKŲ;33658383206;Taip;0;10;0;10
9682;Skroblinukas;GANDRIUKŲ;28889483128;Taip;0;1;0;1
9683;Skroblinukas;GANDRIUKŲ;18613971878;Taip;0;0;1;1
9684;Skroblinukas;GANDRIUKŲ;19962514046;Taip;0;17;2;19
9685;Skroblinukas;GANDRIUKŲ;69558864958;Taip;1;15;1;17
9686;Skroblinukas;GANDRIUKŲ;7616559972;Ne;0;1;0;1
9687;Skroblinukas;GANDRIUKŲ;3519615689;Ne;0;5;2;7
9688;Skroblinukas;VYTURIUKŲ;32625726014;Ne;0;6;0;6
9689;Skroblinukas;VYTURIUKŲ;40320573258;Taip;0;11;0;11
9690;Skroblinukas;VYTURIUKŲ;85882169908;Ne;0;16;0;16
9691;Skroblinukas;VYTURIUKŲ;98214579906;Taip;0;2;0;2
9692;Skroblinukas;VYTURIUKŲ;94897926442;Ne;0;0;9;9
9693;Skroblinukas;VYTURIUKŲ;30982591733;Taip;0;5;0;5
9694;Skroblinukas;VYTURIUKŲ;81438612530;Taip;0;9;1;10
9695;Skroblinukas;VYTURIUKŲ;778965033;Taip;0;6;0;6
9696;Skroblinukas;VYTURIUKŲ;89809217827;Taip;0;4;0;4
9697;Skroblinukas;VYTURIUKŲ;25474129751;Taip;5;4;0;9
9698;Skroblinukas;VYTURIUKŲ;9313338574;Ne;0;8;0;8
9699;Skroblinukas;VYTURIUKŲ;152535859;Taip;0;2;0;2
9700;Skroblinukas;VYTURIUKŲ;1935381164;Taip;0;0;2;2
9701;Skroblinukas;VYTURIUKŲ;24808850859;Taip;0;0;3;3
9702;Skroblinukas;VYTURIUKŲ;64034793218;Taip;0;0;6;6
9703;Skroblinukas;VYTURIUKŲ;52489636337;Taip;10;5;0;15
9704;Skroblinukas;VYTURIUKŲ;21966526141;Taip;0;0;1;1
9705;Skroblinukas;VYTURIUKŲ;55519865793;Taip;0;15;0;15
9706;Skroblinukas;VYTURIUKŲ;87202801900;Taip;0;2;0;2
9707;Skroblinukas;VYTURIUKŲ;58117699822;Ne;0;0;1;1
9708;Skroblinukas;VYTURIUKŲ;17906689562;Ne;0;2;0;2
9709;Skroblinukas;VYTURIUKŲ;84113655621;Taip;0;0;2;2
9710;Skroblinukas;VYTURIUKŲ;78319454763;Taip;0;0;3;3
9711;Skroblinukas;GENIUKŲ;1930578755;Taip;15;0;0;15
9712;Skroblinukas;GENIUKŲ;4393041946;Taip;0;0;1;1
9713;Skroblinukas;GENIUKŲ;1325903217;Taip;0;6;0;6
9714;Skroblinukas;GENIUKŲ;8380073853;Taip;0;0;19;19
9715;Skroblinukas;GENIUKŲ;1361836818;Ne;0;0;1;1
9716;Skroblinukas;GENIUKŲ;5766702969;Taip;10;5;3;18
9717;Skroblinukas;GENIUKŲ;4436698905;Taip;0;1;0;1
9718;Skroblinukas;GENIUKŲ;1905085978;Taip;0;0;2;2
9719;Skroblinukas;GENIUKŲ;1557733803;Taip;0;11;0;11
9720;Skroblinukas;GENIUKŲ;9433465007;Taip;0;10;0;10
9721;Skroblinukas;GENIUKŲ;1395950886;Ne;7;0;0;7
9722;Skroblinukas;GENIUKŲ;9777300890;Taip;3;1;0;4
9723;Skroblinukas;GENIUKŲ;1696303051;Taip;1;0;2;3
9724;Skroblinukas;GENIUKŲ;9846569195;Taip;0;0;2;2
9725;Skroblinukas;GENIUKŲ;3746278003;Taip;17;0;0;17
9726;Skroblinukas;GENIUKŲ;4773576465;Taip;0;0;7;7
9727;Skroblinukas;GENIUKŲ;2704157855;Taip;0;6;0;6
9728;Skroblinukas;GENIUKŲ;6129591146;Taip;0;2;0;2
9729;Skroblinukas;GENIUKŲ;3128337104;Ne;0;0;2;2
9730;Skroblinukas;BITUČIŲ;1255323441;Taip;5;0;2;7
9731;Skroblinukas;BITUČIŲ;1934804499;Taip;0;5;0;5
9732;Skroblinukas;BITUČIŲ;2134821488;Taip;5;7;0;12
9733;Skroblinukas;BITUČIŲ;2071447940;Taip;10;0;0;10
9734;Skroblinukas;BITUČIŲ;1659335142;Taip;0;5;0;5
9735;Skroblinukas;BITUČIŲ;6604496585;Ne;6;6;0;12
9736;Skroblinukas;BITUČIŲ;3736883850;Taip;18;0;0;18
9737;Skroblinukas;BITUČIŲ;7191689856;Taip;9;4;0;13
9738;Skroblinukas;BITUČIŲ;8277152812;Taip;0;1;0;1
9739;Skroblinukas;BITUČIŲ;8374103872;Taip;0;2;0;2
9740;Skroblinukas;BITUČIŲ;8618587013;Taip;8;0;1;9
9741;Skroblinukas;BITUČIŲ;4945107862;Ne;0;0;7;7
9742;Skroblinukas;BITUČIŲ;9594078223;Ne;0;3;0;3
9743;Skroblinukas;BITUČIŲ;9075266818;Ne;10;5;0;15
9744;Skroblinukas;BITUČIŲ;1432694920;Taip;0;1;0;1
9745;Skroblinukas;BITUČIŲ;1967305501;Taip;0;0;4;4
9746;Skroblinukas;BITUČIŲ;1688990637;Taip;12;0;0;12
9747;Skroblinukas;BITUČIŲ;1544346282;Taip;5;3;0;8
9748;Skroblinukas;BITUČIŲ;1711568129;Taip;5;0;0;5
9749;Skroblinukas;BORUŽĖLIŲ;2706526326;Taip;0;10;1;11
9750;Skroblinukas;BORUŽĖLIŲ;9725125130;Taip;0;5;0;5
9751;Skroblinukas;BORUŽĖLIŲ;9888115079;Taip;0;8;2;10
9752;Skroblinukas;BORUŽĖLIŲ;8576448571;Taip;6;0;12;18
9753;Skroblinukas;BORUŽĖLIŲ;8946940285;Taip;0;3;0;3
9754;Skroblinukas;BORUŽĖLIŲ;3290115134;Taip;0;0;1;1
9755;Skroblinukas;BORUŽĖLIŲ;9813249677;Taip;0;0;1;1
9756;Skroblinukas;BORUŽĖLIŲ;2101748012;Taip;10;0;4;14
9757;Skroblinukas;BORUŽĖLIŲ;5915278745;Taip;0;5;2;7
9758;Skroblinukas;BORUŽĖLIŲ;6433636135;Taip;0;3;0;3
9759;Skroblinukas;BORUŽĖLIŲ;9475514959;Ne;0;1;0;1
9760;Skroblinukas;SKRUZDĖLIUKŲ;1446835893;Taip;0;11;0;11
9761;Skroblinukas;SKRUZDĖLIUKŲ;2116630768;Taip;0;0;2;2
9762;Skroblinukas;SKRUZDĖLIUKŲ;1710559060;Taip;1;4;0;5
9763;Skroblinukas;SKRUZDĖLIUKŲ;1175660577;Taip;0;0;3;3
9764;Skroblinukas;SKRUZDĖLIUKŲ;21862553841;Taip;0;6;0;6
9765;Skroblinukas;SKRUZDĖLIUKŲ;1611685585;Taip;0;5;0;5
9766;Skroblinukas;SKRUZDĖLIUKŲ;1631945330;Taip;0;0;6;6
9767;Skroblinukas;SKRUZDĖLIUKŲ;58000101216;Taip;0;0;9;9
9768;Skroblinukas;SKRUZDĖLIUKŲ;72528180087;Taip;0;5;0;5
9769;Skroblinukas;SKRUZDĖLIUKŲ;91409992058;Taip;0;0;5;5
9770;Skroblinukas;SKRUZDĖLIUKŲ;60061213883;Taip;0;6;1;7
9771;Skroblinukas;SKRUZDĖLIUKŲ;50466456602;Taip;0;1;0;1
9772;Skroblinukas;SKRUZDĖLIUKŲ;3226377926;Ne;8;0;1;9
9773;Skroblinukas;SKRUZDĖLIUKŲ;42252673755;Taip;0;11;0;11
9774;Skroblinukas;SKRUZDĖLIUKŲ;7896922448;Taip;0;2;0;2
9775;Skroblinukas;SKRUZDĖLIUKŲ;2035304515;Taip;0;7;0;7
9776;Skroblinukas;SKRUZDĖLIUKŲ;1388763405;Taip;10;0;0;10
9777;Skroblinukas;SKRUZDĖLIUKŲ;7416993749;Taip;4;0;0;4
9778;Skroblinukas;ŽVIRBLIUKŲ;9045708140;Taip;7;2;0;9
9779;Skroblinukas;ŽVIRBLIUKŲ;2197158518;Taip;0;3;0;3
9780;Skroblinukas;ŽVIRBLIUKŲ;6266609965;Taip;0;5;0;5
9781;Skroblinukas;ŽVIRBLIUKŲ;5646847921;Taip;0;0;2;2
9782;Skroblinukas;ŽVIRBLIUKŲ;6640062847;Taip;12;0;7;19
9783;Skroblinukas;ŽVIRBLIUKŲ;7921251819;Taip;12;1;0;13
9784;Skroblinukas;ŽVIRBLIUKŲ;5546256869;Taip;5;0;3;8
9785;Skroblinukas;ŽVIRBLIUKŲ;9572912046;Taip;14;7;0;21
9786;Skroblinukas;ŽVIRBLIUKŲ;2097758483;Taip;0;8;0;8
9787;Skroblinukas;ŽVIRBLIUKŲ;2406619611;Taip;0;0;3;3
9788;Skroblinukas;ŽVIRBLIUKŲ;9377215921;Taip;15;0;0;15
9789;Skroblinukas;ŽIOGELIŲ;5157913924;Taip;0;12;0;12
9790;Skroblinukas;ŽIOGELIŲ;9368764758;Taip;0;1;0;1
9791;Skroblinukas;ŽIOGELIŲ;3006521657;Taip;0;2;0;2
9792;Skroblinukas;ŽIOGELIŲ;3771045336;Ne;0;1;0;1
9793;Skroblinukas;ŽIOGELIŲ;6890306112;Taip;0;8;0;8
9794;Skroblinukas;ŽIOGELIŲ;9958188318;Ne;10;1;1;12
9795;Skroblinukas;ŽIOGELIŲ;5688453546;Taip;0;2;4;6
9796;Skroblinukas;ŽIOGELIŲ;6445065388;Taip;7;2;0;9
9797;Skroblinukas;ŽIOGELIŲ;4424763028;Taip;10;0;0;10
9798;Skroblinukas;ŽIOGELIŲ;9353353289;Taip;0;2;7;9
9799;Skroblinukas;ŽIOGELIŲ;5252389111;Taip;4;0;0;4
9800;Skroblinukas;ŽIOGELIŲ;7493915017;Taip;0;1;0;1
9801;Skroblinukas;ŽIOGELIŲ;1970738675;Taip;5;11;5;21
9802;Skroblinukas;STRAZDELIŲ;1054097622;Taip;3;5;0;8
9803;Skroblinukas;STRAZDELIŲ;5433647187;Taip;4;1;0;5
9804;Skroblinukas;STRAZDELIŲ;9915130747;Taip;6;2;0;8
9805;Skroblinukas;STRAZDELIŲ;1159546580;Taip;8;0;0;8
9806;Skroblinukas;STRAZDELIŲ;2310750833;Taip;0;1;0;1
9807;Skroblinukas;STRAZDELIŲ;2184711783;Taip;0;0;1;1
9808;Skroblinukas;STRAZDELIŲ;8875703109;Taip;0;1;0;1
9809;Skroblinukas;STRAZDELIŲ;3010510262;Taip;0;7;0;7
9810;Skroblinukas;STRAZDELIŲ;6489976163;Taip;9;0;0;9
9811;Skroblinukas;STRAZDELIŲ;1669610397;Taip;4;1;0;5
9812;Skroblinukas;STRAZDELIŲ;9541682085;Taip;22;0;0;22
9813;Skroblinukas;STRAZDELIŲ;5566457656;Ne;2;4;2;8
9814;Skroblinukas;STRAZDELIŲ;4571530482;Taip;2;0;0;2
9815;Skroblinukas;DRUGELIŲ;1792672886;Taip;0;0;18;18
9816;Skroblinukas;DRUGELIŲ;1979723351;Taip;0;0;2;2
9817;Skroblinukas;DRUGELIŲ;1964529755;Taip;11;10;0;21
9818;Skroblinukas;DRUGELIŲ;23687553212;Taip;22;0;0;22
9819;Skroblinukas;DRUGELIŲ;86542450905;Taip;0;0;1;1
9820;Skroblinukas;DRUGELIŲ;2019575002;Taip;12;0;1;13
9821;Skroblinukas;DRUGELIŲ;3636028890;Taip;2;0;6;8
9822;Skroblinukas;DRUGELIŲ;2325940694;Taip;6;4;0;10
9823;Skroblinukas;DRUGELIŲ;15977832913;Taip;5;0;2;7
9824;Skroblinukas;DRUGELIŲ;3580045988;Taip;5;4;0;9
9825;Skroblinukas;DRUGELIŲ;1005726705;Taip;0;0;5;5
9826;Skroblinukas;DRUGELIŲ;1791669956;Taip;0;1;0;1
9827;Skroblinukas;DRUGELIŲ;4272941994;Taip;0;0;12;12
9828;Skroblinukas;PELĖDŽIUKŲ;5975039463;Taip;8;0;0;8
9829;Skroblinukas;PELĖDŽIUKŲ;63514584063;Taip;0;16;0;16
9830;Skroblinukas;PELĖDŽIUKŲ;1000422430;Taip;0;12;0;12
9831;Skroblinukas;PELĖDŽIUKŲ;1556675902;Taip;6;0;3;9
9832;Skroblinukas;PELĖDŽIUKŲ;7666122737;Taip;4;0;0;4
9833;Skroblinukas;PELĖDŽIUKŲ;3864043251;Taip;4;0;0;4
9834;Skroblinukas;PELĖDŽIUKŲ;1382981497;Taip;0;1;0;1
9835;Skroblinukas;PELĖDŽIUKŲ;29908502973;Taip;0;3;0;3
9836;Skroblinukas;PELĖDŽIUKŲ;1599112927;Taip;9;1;0;10
9837;Skroblinukas;PELĖDŽIUKŲ;95946607624;Taip;0;5;0;5
9838;Skroblinukas;PELĖDŽIUKŲ;8150037173;Taip;0;2;0;2
9839;Skroblinukas;PELĖDŽIUKŲ;1898486832;Taip;1;0;0;1
9840;Skroblinukas;PELĖDŽIUKŲ;1515227489;Ne;0;5;0;5
9841;Skroblinukas;PELĖDŽIUKŲ;76523308405;Taip;0;14;0;14
9842;Skroblinukas;PELĖDŽIUKŲ;39209870512;Taip;0;2;0;2
9843;Skroblinukas;PELĖDŽIUKŲ;1847074960;Taip;5;0;4;9
9844;Smalsučiai;Žibuoklės;46376560575;Ne;0;2;1;3
9845;Smalsučiai;Žibuoklės;68726523946;Ne;0;12;0;12
9846;Smalsučiai;Žibuoklės;1760728524;Taip;0;4;0;4
9847;Smalsučiai;Žibuoklės;82746324948;Ne;0;2;1;3
9848;Smalsučiai;Žibuoklės;51889095612;Taip;2;7;1;10
9849;Smalsučiai;Žibuoklės;4258713607;Taip;0;12;3;15
9850;Smalsučiai;Žibuoklės;68097436766;Taip;0;2;0;2
9851;Smalsučiai;Žibuoklės;85352082436;Taip;0;0;1;1
9852;Smalsučiai;Žibuoklės;40922293471;Taip;0;5;0;5
9853;Smalsučiai;Žibuoklės;85342418658;Taip;0;5;0;5
9854;Smalsučiai;Žibuoklės;1023262986;Taip;17;0;0;17
9855;Smalsučiai;Žibuoklės;83033796468;Taip;0;2;3;5
9856;Smalsučiai;Žibuoklės;62767756842;Taip;0;4;2;6
9857;Smalsučiai;Žibuoklės;2099765750;Taip;17;0;0;17
9858;Smalsučiai;Žibuoklės;9512217842;Taip;0;2;0;2
9859;Smalsučiai;Žibuoklės;56779125767;Taip;0;6;0;6
9860;Smalsučiai;Žibuoklės;97809921080;Taip;0;5;0;5
9861;Smalsučiai;Aitvarų;53737587501;Taip;7;5;0;12
9862;Smalsučiai;Aitvarų;67243805772;Taip;10;0;0;10
9863;Smalsučiai;Aitvarų;71839472863;Taip;0;1;0;1
9864;Smalsučiai;Aitvarų;26007606072;Taip;0;5;0;5
9865;Smalsučiai;Aitvarų;55212746834;Taip;0;2;1;3
9866;Smalsučiai;Aitvarų;97665693700;Taip;0;6;0;6
9867;Smalsučiai;Aitvarų;70181610962;Ne;0;2;0;2
9868;Smalsučiai;Aitvarų;48426272721;Taip;0;0;4;4
9869;Smalsučiai;Aitvarų;12446167265;Taip;0;2;0;2
9870;Smalsučiai;Aitvarų;68897306811;Taip;0;6;0;6
9871;Smalsučiai;Aitvarų;45731306499;Ne;0;1;0;1
9872;Smalsučiai;Aitvarų;1417945043;Taip;0;14;0;14
9873;Smalsučiai;Aitvarų;5631758578;Taip;0;8;0;8
9874;Smalsučiai;Aitvarų;95501158334;Taip;0;2;2;4
9875;Smalsučiai;Aitvarų;31748074403;Taip;0;3;1;4
9876;Smalsučiai;Aitvarų;1673246147;Taip;6;2;0;8
9877;Smalsučiai;Aitvarų;62387945180;Taip;5;0;2;7
9878;Smalsučiai;Aitvarų;1095159887;Taip;4;1;0;5
9879;Smalsučiai;Aitvarų;1424532027;Ne;0;1;3;4
9880;Smalsučiai;Aitvarų;1567576834;Ne;0;7;0;7
9881;Smalsučiai;Aitvarų;1965194010;Taip;0;0;4;4
9882;Smalsučiai;Sraigiukų;4004275398;Taip;4;0;3;7
9883;Smalsučiai;Sraigiukų;18980466605;Taip;9;1;0;10
9884;Smalsučiai;Sraigiukų;2036701320;Ne;0;0;13;13
9885;Smalsučiai;Sraigiukų;1597721199;Taip;3;1;3;7
9886;Smalsučiai;Sraigiukų;87920436781;Taip;5;0;0;5
9887;Smalsučiai;Sraigiukų;36701180571;Taip;5;0;3;8
9888;Smalsučiai;Sraigiukų;1968415573;Taip;5;2;0;7
9889;Smalsučiai;Sraigiukų;8572292571;Taip;7;0;0;7
9890;Smalsučiai;Sraigiukų;92460059853;Taip;5;0;0;5
9891;Smalsučiai;Sraigiukų;8604112256;Taip;0;0;2;2
9892;Smalsučiai;Sraigiukų;1830368274;Taip;0;0;11;11
9893;Smalsučiai;Sraigiukų;92129554371;Taip;0;4;0;4
9894;Smalsučiai;Sraigiukų;4655599359;Taip;0;0;2;2
9895;Smalsučiai;Sraigiukų;28055409190;Taip;8;1;0;9
9896;Smalsučiai;Sraigiukų;1504060488;Taip;0;1;1;2
9897;Smalsučiai;Sraigiukų;2112871055;Taip;10;0;0;10
9898;Smalsučiai;Sraigiukų;1453463899;Taip;0;0;22;22
9899;Smalsučiai;Sraigiukų;7037820869;Ne;12;0;2;14
9900;Smalsučiai;Sraigiukų;7450298541;Taip;0;1;0;1
9901;Smalsučiai;Sraigiukų;3792738445;Ne;18;0;0;18
9902;Smalsučiai;Saulučių;513516143;Taip;0;0;3;3
9903;Smalsučiai;Saulučių;32382108578;Taip;0;0;1;1
9904;Smalsučiai;Saulučių;38269797498;Ne;0;0;1;1
9905;Smalsučiai;Saulučių;99471280741;Taip;0;6;0;6
9906;Smalsučiai;Saulučių;54610929862;Taip;0;0;6;6
9907;Smalsučiai;Saulučių;98196404299;Taip;14;1;0;15
9908;Smalsučiai;Saulučių;59594678142;Taip;0;0;1;1
9909;Smalsučiai;Saulučių;94734585174;Taip;9;0;0;9
9910;Smalsučiai;Saulučių;73783991852;Taip;7;0;2;9
9911;Smalsučiai;Saulučių;47452987441;Taip;0;0;1;1
9912;Smalsučiai;Saulučių;81834985961;Taip;6;0;3;9
9913;Smalsučiai;Saulučių;1276659532;Taip;4;0;0;4
9914;Smalsučiai;Saulučių;55812291804;Taip;14;0;0;14
9915;Smalsučiai;Saulučių;63886240982;Taip;3;0;0;3
9916;Smalsučiai;Saulučių;57622458673;Ne;0;0;5;5
9917;Smalsučiai;Saulučių;73899364649;Taip;0;0;13;13
9918;Smalsučiai;Saulučių;1575017231;Taip;4;0;0;4
9919;Smalsučiai;Saulučių;6857124432;Taip;4;0;6;10
9920;Smalsučiai;Saulučių;1653798728;Taip;5;0;0;5
9921;Smalsučiai;Viščiukų;13763655324;Taip;12;0;0;12
9922;Smalsučiai;Viščiukų;2802867649;Taip;0;7;0;7
9923;Smalsučiai;Viščiukų;30592434971;Taip;10;1;0;11
9924;Smalsučiai;Viščiukų;18717627431;Taip;0;1;0;1
9925;Smalsučiai;Viščiukų;63575906792;Taip;0;11;0;11
9926;Smalsučiai;Viščiukų;1514166474;Taip;0;4;0;4
9927;Smalsučiai;Viščiukų;37702522563;Taip;0;6;0;6
9928;Smalsučiai;Viščiukų;95945382872;Taip;0;6;0;6
9929;Smalsučiai;Viščiukų;96002139110;Taip;3;3;0;6
9930;Smalsučiai;Viščiukų;1893910089;Taip;9;0;0;9
9931;Smalsučiai;Viščiukų;78496301809;Taip;0;2;0;2
9932;Smalsučiai;Viščiukų;92961881271;Taip;0;2;0;2
9933;Smalsučiai;Viščiukų;6264082741;Taip;12;10;0;22
9934;Smalsučiai;Viščiukų;30464130912;Taip;5;0;0;5
9935;Smalsučiai;Boružėlių;9426629964;Ne;5;0;0;5
9936;Smalsučiai;Boružėlių;1703679877;Taip;6;0;1;7
9937;Smalsučiai;Boružėlių;2022025913;Taip;17;0;0;17
9938;Smalsučiai;Boružėlių;2208462326;Taip;0;12;0;12
9939;Smalsučiai;Boružėlių;6643253926;Taip;3;9;0;12
9940;Smalsučiai;Boružėlių;1473016908;Ne;17;0;0;17
9941;Smalsučiai;Boružėlių;6085020049;Taip;0;15;0;15
9942;Smalsučiai;Boružėlių;8340768848;Ne;9;0;0;9
9943;Smalsučiai;Boružėlių;6578328053;Taip;0;2;0;2
9944;Smalsučiai;Boružėlių;69450514879;Ne;11;3;0;14
9945;Smalsučiai;Boružėlių;4740303929;Taip;8;0;0;8
9946;Smalsučiai;Boružėlių;4046718551;Taip;9;0;0;9
9947;Smalsučiai;Boružėlių;7364431725;Taip;21;0;0;21
9948;Smalsučiai;Boružėlių;2671403814;Taip;8;0;0;8
9949;Smalsučiai;Boružėlių;3063127699;Taip;4;0;0;4
9950;Smalsučiai;Boružėlių;2737886714;Taip;0;9;0;9
9951;Smalsučiai;Boružėlių;4858914868;Taip;6;0;0;6
9952;Smalsučiai;Zuikių;1335301931;Taip;3;0;0;3
9953;Smalsučiai;Zuikių;1154978396;Taip;4;0;1;5
9954;Smalsučiai;Zuikių;4930548597;Taip;0;1;0;1
9955;Smalsučiai;Zuikių;37584386087;Taip;0;3;0;3
9956;Smalsučiai;Zuikių;1384803468;Taip;1;0;5;6
9957;Smalsučiai;Zuikių;49637679464;Taip;0;0;4;4
9958;Smalsučiai;Zuikių;85935601752;Taip;0;1;0;1
9959;Smalsučiai;Zuikių;64619831879;Ne;0;3;0;3
9960;Smalsučiai;Zuikių;13761441573;Taip;0;0;2;2
9961;Smalsučiai;Zuikių;38212233932;Taip;0;4;0;4
9962;Smalsučiai;Zuikių;69940677093;Taip;0;1;1;2
9963;Smalsučiai;Zuikių;85617121883;Taip;0;1;1;2
9964;Smalsučiai;Zuikių;32121383319;Taip;0;0;1;1
9965;Smalsučiai;Nykštukų;2327930850;Taip;0;15;0;15
9966;Smalsučiai;Nykštukų;3787937467;Taip;0;10;0;10
9967;Smalsučiai;Nykštukų;4134975456;Taip;3;0;0;3
9968;Smalsučiai;Nykštukų;9155011285;Taip;0;1;0;1
9969;Smalsučiai;Nykštukų;9582225178;Ne;10;0;0;10
9970;Smalsučiai;Nykštukų;4566816316;Taip;0;3;0;3
9971;Smalsučiai;Nykštukų;1471941426;Taip;0;2;1;3
9972;Smalsučiai;Nykštukų;1458544456;Taip;0;3;0;3
9973;Smalsučiai;Nykštukų;4364810458;Taip;3;0;1;4
9974;Smalsučiai;Nykštukų;6469604093;Taip;6;0;0;6
9975;Smalsučiai;Nykštukų;6358800570;Taip;6;2;0;8
9976;Smalsučiai;Nykštukų;5184903287;Taip;0;1;0;1
9977;Smalsučiai;Nykštukų;7933302912;Taip;0;13;0;13
9978;Smalsučiai;Nykštukų;3757955200;Taip;22;0;0;22
9979;Smalsučiai;Nykštukų;5406430393;Taip;5;2;1;8
9980;Smalsučiai;Nykštukų;9241738140;Taip;12;1;0;13
9981;Smalsučiai;Katinėlių;8259056296;Taip;6;0;0;6
9982;Smalsučiai;Katinėlių;9864518144;Taip;0;4;0;4
9983;Smalsučiai;Katinėlių;2958335372;Taip;8;1;0;9
9984;Smalsučiai;Katinėlių;6090391818;Taip;20;0;2;22
9985;Smalsučiai;Katinėlių;6577214344;Taip;5;0;2;7
9986;Smalsučiai;Katinėlių;8977651419;Taip;0;1;2;3
9987;Smalsučiai;Katinėlių;6406285034;Taip;0;0;1;1
9988;Smalsučiai;Katinėlių;6006832443;Ne;7;3;0;10
9989;Smalsučiai;Katinėlių;7726086066;Taip;3;1;0;4
9990;Smalsučiai;Katinėlių;8128348060;Taip;12;0;0;12
9991;Smalsučiai;Katinėlių;9637877396;Taip;12;0;2;14
9992;Smalsučiai;PELĖDŽIUKAI;8794407618;Taip;0;11;0;11
9993;Smalsučiai;PELĖDŽIUKAI;1374075909;Taip;0;4;0;4
9994;Smalsučiai;PELĖDŽIUKAI;3543889830;Taip;0;2;0;2
9995;Smalsučiai;PELĖDŽIUKAI;86106357239;Taip;0;1;0;1
9996;Smalsučiai;PELĖDŽIUKAI;67362576311;Ne;0;3;0;3
9997;Smalsučiai;PELĖDŽIUKAI;43758366827;Taip;0;3;0;3
9998;Smalsučiai;PELĖDŽIUKAI;42287520446;Taip;0;8;0;8
9999;Smalsučiai;PELĖDŽIUKAI;72912782044;Taip;0;0;1;1
10000;Smalsučiai;PELĖDŽIUKAI;3103358607;Taip;0;3;0;3
10001;Smalsučiai;PELĖDŽIUKAI;66765363937;Taip;0;3;0;3
10002;Smalsučiai;PELĖDŽIUKAI;22888541896;Taip;0;1;0;1
10003;Smalsučiai;PELĖDŽIUKAI;49495262113;Taip;0;1;0;1
10004;Smalsučiai;PELĖDŽIUKAI;98465335011;Ne;2;1;0;3
10005;Smalsučiai;Pingvinukai;8306946163;Taip;0;9;0;9
10006;Smalsučiai;Pingvinukai;1997966082;Taip;0;7;0;7
10007;Smalsučiai;Pingvinukai;4795138729;Taip;16;2;0;18
10008;Smalsučiai;Pingvinukai;2638709634;Taip;0;0;2;2
10009;Smalsučiai;Pingvinukai;6469044880;Taip;0;4;0;4
10010;Smalsučiai;Pingvinukai;1316590100;Taip;0;4;0;4
10011;Smalsučiai;Pingvinukai;2059832436;Taip;7;1;3;11
10012;Smalsučiai;Pingvinukai;8810690546;Taip;5;5;0;10
10013;Smalsučiai;Pingvinukai;4585930202;Taip;0;0;2;2
10014;Smalsučiai;Pingvinukai;9632022271;Taip;0;0;2;2
10015;Smalsučiai;Pingvinukai;1372591510;Taip;0;3;1;4
10016;Smalsučiai;Pingvinukai;8193410963;Taip;6;0;0;6
10017;Smalsučiai;Pingvinukai;3644256220;Taip;0;0;8;8
10018;Smalsučiai;Pingvinukai;4909226602;Taip;4;0;9;13
10019;Smalsučiai;Pingvinukai;2365835087;Taip;3;0;0;3
10020;Smalsučiai;Pingvinukai;5761169841;Taip;2;0;1;3
10021;Smalsučiai;Voverikų;44888860122;Taip;0;2;1;3
10022;Smalsučiai;Voverikų;2618753095;Taip;4;0;0;4
10023;Smalsučiai;Voverikų;7713078413;Taip;0;8;0;8
10024;Smalsučiai;Voverikų;3607226859;Taip;15;0;0;15
10025;Smalsučiai;Voverikų;22791221635;Taip;0;2;0;2
10026;Smalsučiai;Voverikų;7794541741;Taip;12;0;0;12
10027;Smalsučiai;Voverikų;1467603676;Taip;0;2;0;2
10028;Smalsučiai;Voverikų;1982046497;Taip;0;1;0;1
10029;Smalsučiai;Voverikų;1181574676;Taip;0;12;0;12
10030;Smalsučiai;Voverikų;1599488035;Taip;0;5;0;5
10031;Smalsučiai;Voverikų;6207026048;Taip;0;2;0;2
10032;Smalsučiai;Voverikų;19592364606;Taip;5;0;0;5
10033;Smalsučiai;Voverikų;1668692281;Taip;7;0;0;7
10034;Smalsučiai;Voverikų;5730866119;Taip;2;0;0;2
10035;Smalsučiai;Voverikų;1824321380;Taip;0;2;0;2
10036;Smalsučiai;Voverikų;5611487967;Taip;8;0;0;8
10037;Smalsučiai;Voverikų;8520753848;Ne;0;7;0;7
10038;Smalsučiai;Voverikų;4145769042;Taip;0;5;0;5
10039;Spindulėlis;SAULUTĖS;1514479696;Taip;18;0;0;18
10040;Spindulėlis;SAULUTĖS;27408123487;Taip;0;14;0;14
10041;Spindulėlis;SAULUTĖS;9977569249;Ne;2;10;0;12
10042;Spindulėlis;SAULUTĖS;1730248631;Taip;7;0;1;8
10043;Spindulėlis;SAULUTĖS;21152690883;Taip;2;0;0;2
10044;Spindulėlis;SAULUTĖS;1391226466;Taip;0;8;1;9
10045;Spindulėlis;SAULUTĖS;1694423628;Taip;3;3;0;6
10046;Spindulėlis;SAULUTĖS;1679106754;Taip;0;9;0;9
10047;Spindulėlis;SAULUTĖS;4353031174;Taip;6;0;0;6
10048;Spindulėlis;SAULUTĖS;1346035733;Taip;0;4;0;4
10049;Spindulėlis;SAULUTĖS;9903990297;Taip;6;0;0;6
10050;Spindulėlis;SAULUTĖS;92417802345;Taip;0;0;1;1
10051;Spindulėlis;DRUGELIAI;19541905006;Taip;0;3;0;3
10052;Spindulėlis;DRUGELIAI;27928352319;Taip;8;3;0;11
10053;Spindulėlis;DRUGELIAI;1528496272;Taip;11;0;0;11
10054;Spindulėlis;DRUGELIAI;1763306358;Taip;0;8;13;21
10055;Spindulėlis;DRUGELIAI;1939526832;Taip;0;0;1;1
10056;Spindulėlis;DRUGELIAI;2988630379;Taip;18;0;0;18
10057;Spindulėlis;DRUGELIAI;80331157814;Taip;6;3;0;9
10058;Spindulėlis;DRUGELIAI;2137229669;Ne;0;1;0;1
10059;Spindulėlis;DRUGELIAI;60956380679;Taip;0;1;10;11
10060;Spindulėlis;DRUGELIAI;29747353664;Taip;2;0;3;5
10061;Spindulėlis;DRUGELIAI;97661389553;Taip;0;7;0;7
10062;Spindulėlis;DRUGELIAI;2131409282;Taip;9;0;0;9
10063;Spindulėlis;DRUGELIAI;9348576749;Taip;0;0;7;7
10064;Spindulėlis;DRUGELIAI;63344816879;Taip;0;0;8;8
10065;Spindulėlis;DRUGELIAI;18443825776;Taip;0;0;2;2
10066;Spindulėlis;DRUGELIAI;9145337789;Taip;0;0;4;4
10067;Spindulėlis;DRUGELIAI;96365393879;Taip;0;3;0;3
10068;Spindulėlis;DRUGELIAI;7757264510;Taip;6;0;0;6
10069;Spindulėlis;DRUGELIAI;5050019035;Taip;8;0;0;8
10070;Spindulėlis;BITUTĖS;74912418250;Taip;5;4;0;9
10071;Spindulėlis;BITUTĖS;19056425785;Taip;0;6;0;6
10072;Spindulėlis;BITUTĖS;17990017515;Taip;5;0;4;9
10073;Spindulėlis;BITUTĖS;83727622058;Taip;7;0;0;7
10074;Spindulėlis;BITUTĖS;34303994728;Taip;7;0;0;7
10075;Spindulėlis;BITUTĖS;75678343003;Taip;0;0;5;5
10076;Spindulėlis;BITUTĖS;4798024997;Taip;0;8;0;8
10077;Spindulėlis;BITUTĖS;4842304821;Taip;0;3;0;3
10078;Spindulėlis;BITUTĖS;92803008887;Taip;0;4;0;4
10079;Spindulėlis;BITUTĖS;35801673097;Taip;2;5;0;7
10080;Spindulėlis;BITUTĖS;85203448043;Taip;6;0;0;6
10081;Spindulėlis;BITUTĖS;4539792030;Ne;4;0;0;4
10082;Spindulėlis;BITUTĖS;81445263695;Taip;4;0;0;4
10083;Spindulėlis;BITUTĖS;16045001090;Taip;0;9;0;9
10084;Spindulėlis;BITUTĖS;1399847362;Taip;6;0;0;6
10085;Spindulėlis;BITUTĖS;54418444052;Taip;5;0;0;5
10086;Spindulėlis;BITUTĖS;60061983557;Ne;0;0;1;1
10087;Spindulėlis;VARPELIAI;5233044803;Taip;0;2;0;2
10088;Spindulėlis;VARPELIAI;8923393066;Taip;4;0;7;11
10089;Spindulėlis;VARPELIAI;9244494109;Taip;0;0;6;6
10090;Spindulėlis;VARPELIAI;4929866385;Taip;15;0;2;17
10091;Spindulėlis;VARPELIAI;8141324449;Taip;15;0;2;17
10092;Spindulėlis;VARPELIAI;6449284856;Ne;14;0;8;22
10093;Spindulėlis;VARPELIAI;4077985773;Taip;0;3;0;3
10094;Spindulėlis;VARPELIAI;6592057292;Taip;0;0;2;2
10095;Spindulėlis;VARPELIAI;2890377876;Taip;3;0;4;7
10096;Spindulėlis;VARPELIAI;1454039572;Taip;5;3;0;8
10097;Spindulėlis;VARPELIAI;9511051386;Taip;0;0;2;2
10098;Spindulėlis;VARPELIAI;9740815635;Taip;6;0;0;6
10099;Spindulėlis;VARPELIAI;5578151523;Taip;0;0;1;1
10100;Spindulėlis;VARPELIAI;7099787230;Taip;14;0;4;18
10101;Spindulėlis;VARPELIAI;4308169582;Taip;13;0;3;16
10102;Spindulėlis;VARPELIAI;3088386659;Taip;0;0;1;1
10103;Spragtukas;NYKŠTUKAI;1756340613;Taip;0;3;0;3
10104;Spragtukas;NYKŠTUKAI;8226921630;Taip;5;1;0;6
10105;Spragtukas;NYKŠTUKAI;5236797574;Taip;4;6;0;10
10106;Spragtukas;NYKŠTUKAI;9860876807;Taip;0;4;0;4
10107;Spragtukas;NYKŠTUKAI;4069044269;Taip;0;4;0;4
10108;Spragtukas;NYKŠTUKAI;1771141306;Taip;0;14;0;14
10109;Spragtukas;NYKŠTUKAI;1306663967;Taip;0;6;0;6
10110;Spragtukas;NYKŠTUKAI;9965087132;Taip;5;3;0;8
10111;Spragtukas;NYKŠTUKAI;5844437769;Taip;12;0;0;12
10112;Spragtukas;NYKŠTUKAI;2946297529;Taip;6;0;0;6
10113;Spragtukas;NYKŠTUKAI;1570206034;Taip;22;0;0;22
10114;Spragtukas;NYKŠTUKAI;9754594384;Ne;0;4;0;4
10115;Spragtukas;NYKŠTUKAI;5150028968;Taip;0;5;0;5
10116;Spragtukas;SAULUTĖ;89749837388;Ne;0;9;5;14
10117;Spragtukas;SAULUTĖ;3392224465;Taip;1;0;0;1
10118;Spragtukas;SAULUTĖ;1174566363;Taip;0;1;1;2
10119;Spragtukas;SAULUTĖ;10998123453;Taip;0;1;0;1
10120;Spragtukas;SAULUTĖ;48934106998;Taip;0;0;1;1
10121;Spragtukas;SAULUTĖ;34989165939;Ne;0;2;0;2
10122;Spragtukas;SAULUTĖ;59444737813;Taip;0;1;3;4
10123;Spragtukas;SAULUTĖ;1889153590;Taip;2;0;0;2
10124;Spragtukas;SAULUTĖ;53375921406;Ne;0;0;2;2
10125;Spragtukas;SAULUTĖ;50653432030;Taip;0;8;2;10
10126;Spragtukas;SAULUTĖ;4321780080;Taip;0;1;0;1
10127;Spragtukas;SAULUTĖ;51889437335;Taip;17;1;0;18
10128;Spragtukas;SAULUTĖ;7234682005;Taip;0;7;0;7
10129;Spragtukas;SAULUTĖ;42635888133;Taip;0;3;0;3
10130;Spragtukas;SAULUTĖ;80790750169;Taip;8;1;0;9
10131;Spragtukas;SAULUTĖ;96435499947;Taip;0;0;3;3
10132;Spragtukas;SAULUTĖ;91767288727;Taip;12;2;0;14
10133;Spragtukas;SAULUTĖ;94418271961;Taip;0;2;0;2
10134;Spragtukas;SAULUTĖ;5377198769;Taip;0;2;0;2
10135;Spragtukas;SAULUTĖ;14001343134;Taip;3;1;0;4
10136;Spragtukas;SPINDULĖLIAI;61759595543;Taip;0;2;0;2
10137;Spragtukas;SPINDULĖLIAI;35161123605;Taip;0;0;5;5
10138;Spragtukas;SPINDULĖLIAI;89128154852;Taip;0;5;0;5
10139;Spragtukas;SPINDULĖLIAI;1992644726;Taip;0;2;0;2
10140;Spragtukas;SPINDULĖLIAI;78367721963;Taip;0;1;1;2
10141;Spragtukas;SPINDULĖLIAI;18431696631;Taip;2;0;3;5
10142;Spragtukas;SPINDULĖLIAI;7036136306;Taip;0;1;0;1
10143;Spragtukas;SPINDULĖLIAI;88682218237;Taip;0;8;0;8
10144;Spragtukas;SPINDULĖLIAI;19772337903;Taip;0;4;0;4
10145;Spragtukas;SPINDULĖLIAI;84255109367;Taip;0;1;0;1
10146;Spragtukas;SPINDULĖLIAI;73746856181;Taip;0;1;0;1
10147;Spragtukas;SPINDULĖLIAI;25586950966;Ne;0;2;2;4
10148;Spragtukas;SPINDULĖLIAI;67746615170;Taip;0;5;0;5
10149;Spragtukas;SPINDULĖLIAI;22707134829;Taip;0;13;0;13
10150;Spragtukas;SPINDULĖLIAI;54800087274;Taip;0;2;0;2
10151;Spragtukas;SPINDULĖLIAI;71104002732;Taip;0;11;0;11
10152;Spragtukas;GINTARĖLIAI;96995930924;Ne;8;0;0;8
10153;Spragtukas;GINTARĖLIAI;42746731488;Taip;0;21;0;21
10154;Spragtukas;GINTARĖLIAI;38858500522;Taip;0;1;0;1
10155;Spragtukas;GINTARĖLIAI;1437794402;Taip;0;0;1;1
10156;Spragtukas;GINTARĖLIAI;60731415960;Taip;0;8;0;8
10157;Spragtukas;GINTARĖLIAI;29398129736;Taip;0;3;0;3
10158;Spragtukas;GINTARĖLIAI;37209001618;Taip;0;6;0;6
10159;Spragtukas;GINTARĖLIAI;32290835176;Taip;0;6;0;6
10160;Spragtukas;GINTARĖLIAI;68059396649;Taip;0;8;0;8
10161;Spragtukas;GINTARĖLIAI;52904691894;Taip;0;6;0;6
10162;Spragtukas;GINTARĖLIAI;39962240237;Taip;0;13;0;13
10163;Spragtukas;GINTARĖLIAI;49941944569;Taip;0;19;0;19
10164;Spragtukas;GINTARĖLIAI;40971977434;Taip;0;8;4;12
10165;Spragtukas;GINTARĖLIAI;81928765016;Taip;0;5;0;5
10166;Spragtukas;GINTARĖLIAI;1035579583;Taip;0;3;0;3
10167;Spragtukas;GINTARĖLIAI;8554047390;Taip;0;4;0;4
10168;Spragtukas;GINTARĖLIAI;16927181370;Taip;0;7;0;7
10169;Spragtukas;ČIPOLINO;2371848091;Taip;0;15;0;15
10170;Spragtukas;ČIPOLINO;6582680700;Taip;0;3;0;3
10171;Spragtukas;ČIPOLINO;1599958343;Taip;10;3;0;13
10172;Spragtukas;ČIPOLINO;1547670082;Taip;4;5;0;9
10173;Spragtukas;ČIPOLINO;7504632314;Taip;0;1;0;1
10174;Spragtukas;ČIPOLINO;1597988501;Taip;0;1;0;1
10175;Spragtukas;ČIPOLINO;6526633051;Taip;6;0;0;6
10176;Spragtukas;ČIPOLINO;1058970799;Taip;7;5;0;12
10177;Spragtukas;ČIPOLINO;45661532130;Taip;5;2;0;7
10178;Spragtukas;ČIPOLINO;3045382299;Taip;7;0;0;7
10179;Spragtukas;ČIPOLINO;7640805299;Taip;0;7;0;7
10180;Spragtukas;ČIPOLINO;1365907314;Taip;7;0;0;7
10181;Spragtukas;ČIPOLINO;4941531443;Taip;9;1;0;10
10182;Spragtukas;ČIPOLINO;3566797064;Taip;10;0;0;10
10183;Spragtukas;ČIPOLINO;1827458781;Taip;5;0;0;5
10184;Spragtukas;ČIPOLINO;3798118695;Taip;0;22;0;22
10185;Spragtukas;ČIPOLINO;69114720307;Taip;0;3;0;3
10186;Spragtukas;ČIPOLINO;9789977863;Taip;0;3;0;3
10187;Spragtukas;BORUŽĖLĖS;2063156696;Taip;0;3;0;3
10188;Spragtukas;BORUŽĖLĖS;6729635545;Taip;0;4;0;4
10189;Spragtukas;BORUŽĖLĖS;1615068173;Taip;0;12;0;12
10190;Spragtukas;BORUŽĖLĖS;90741594830;Taip;3;4;0;7
10191;Spragtukas;BORUŽĖLĖS;9962282406;Taip;0;2;0;2
10192;Spragtukas;BORUŽĖLĖS;91568484446;Taip;0;3;0;3
10193;Spragtukas;BORUŽĖLĖS;1701035826;Ne;10;4;0;14
10194;Spragtukas;BORUŽĖLĖS;8415429693;Taip;5;0;0;5
10195;Spragtukas;DRUGELIAI;1190479265;Taip;2;0;1;3
10196;Spragtukas;DRUGELIAI;8673799897;Taip;12;0;0;12
10197;Spragtukas;DRUGELIAI;58491995121;Taip;0;0;1;1
10198;Spragtukas;DRUGELIAI;1570209659;Taip;0;7;0;7
10199;Spragtukas;DRUGELIAI;1212579682;Ne;5;0;0;5
10200;Spragtukas;DRUGELIAI;44715566085;Taip;2;0;0;2
10201;Spragtukas;DRUGELIAI;1082350468;Taip;0;0;2;2
10202;Spragtukas;DRUGELIAI;1668434690;Taip;8;0;1;9
10203;Spragtukas;DRUGELIAI;2086501624;Ne;0;1;0;1
10204;Spragtukas;DRUGELIAI;1035631190;Taip;2;0;0;2
10205;Spragtukas;DRUGELIAI;1751370218;Taip;5;0;1;6
10206;Spragtukas;DRUGELIAI;3508228828;Taip;10;1;1;12
10207;Spragtukas;DRUGELIAI;1315478099;Taip;2;1;2;5
10208;Spragtukas;DRUGELIAI;1779321635;Ne;0;1;1;2
10209;Spragtukas;DRUGELIAI;1400542296;Ne;3;0;1;4
10210;Spragtukas;DRUGELIAI;1130377645;Taip;0;0;1;1
10211;Spragtukas;DRUGELIAI;3181801668;Taip;2;1;2;5
10212;Spragtukas;DRUGELIAI;8826099483;Ne;0;0;1;1
10213;Spragtukas;GAIDELIAI;71081903240;Taip;0;2;1;3
10214;Spragtukas;GAIDELIAI;1305123801;Taip;0;2;0;2
10215;Spragtukas;GAIDELIAI;54099559107;Taip;0;3;0;3
10216;Spragtukas;GAIDELIAI;19453957982;Taip;8;0;0;8
10217;Spragtukas;GAIDELIAI;1983906683;Taip;0;2;0;2
10218;Spragtukas;GAIDELIAI;1203266608;Taip;6;0;1;7
10219;Spragtukas;GAIDELIAI;2042294168;Taip;0;3;0;3
10220;Spragtukas;GAIDELIAI;1030566027;Taip;15;7;0;22
10221;Spragtukas;GAIDELIAI;78296815539;Taip;2;0;0;2
10222;Spragtukas;GAIDELIAI;8150653485;Taip;0;5;0;5
10223;Spragtukas;GAIDELIAI;1247838976;Taip;15;7;0;22
10224;Spragtukas;GAIDELIAI;2061441977;Taip;0;0;1;1
10225;Spragtukas;GAIDELIAI;2848207417;Taip;10;12;0;22
10226;Spragtukas;GAIDELIAI;1210698072;Taip;6;0;1;7
10227;Spragtukas;GAIDELIAI;1070119148;Taip;9;9;0;18
10228;Spragtukas;GAIDELIAI;9235972927;Taip;7;3;0;10
10229;Spragtukas;ŽUVELĖS;32858776091;Taip;0;3;0;3
10230;Spragtukas;ŽUVELĖS;2118272247;Taip;10;7;0;17
10231;Spragtukas;ŽUVELĖS;46794033116;Taip;4;1;0;5
10232;Spragtukas;ŽUVELĖS;60980580078;Taip;0;6;0;6
10233;Spragtukas;ŽUVELĖS;82801263312;Taip;0;1;1;2
10234;Spragtukas;ŽUVELĖS;56384144331;Taip;0;5;0;5
10235;Spragtukas;ŽUVELĖS;2032107153;Taip;0;1;1;2
10236;Spragtukas;ŽUVELĖS;20279570129;Ne;0;15;0;15
10237;Spragtukas;ŽUVELĖS;19580966465;Taip;5;1;0;6
10238;Spragtukas;ŽUVELĖS;1953368351;Taip;1;0;0;1
10239;Spragtukas;ŽUVELĖS;271958429;Taip;0;2;0;2
10240;Spragtukas;ŽUVELĖS;1030688447;Taip;5;0;0;5
10241;Spragtukas;ŽUVELĖS;1883944064;Taip;0;22;0;22
10242;Spragtukas;ŽUVELĖS;41147623084;Taip;0;4;0;4
10243;Spragtukas;ŽUVELĖS;22025568463;Ne;0;1;0;1
10244;Spragtukas;ŽUVELĖS;38120721944;Taip;0;11;0;11
10245;Spragtukas;RIEŠUTĖLIAI;8444759709;Taip;0;4;0;4
10246;Spragtukas;RIEŠUTĖLIAI;1384812263;Taip;0;2;0;2
10247;Spragtukas;RIEŠUTĖLIAI;8463747761;Taip;0;6;0;6
10248;Spragtukas;RIEŠUTĖLIAI;1690400583;Taip;10;1;0;11
10249;Spragtukas;RIEŠUTĖLIAI;6419503965;Taip;10;6;0;16
10250;Spragtukas;RIEŠUTĖLIAI;8246512283;Ne;2;9;0;11
10251;Spragtukas;RIEŠUTĖLIAI;1326603216;Taip;5;7;0;12
10252;Spragtukas;RIEŠUTĖLIAI;72636559695;Taip;0;1;2;3
10253;Spragtukas;RIEŠUTĖLIAI;6573750143;Taip;0;1;0;1
10254;Spragtukas;RIEŠUTĖLIAI;5306883933;Ne;0;6;0;6
10255;Spragtukas;RIEŠUTĖLIAI;3654640843;Taip;0;6;0;6
10256;Spragtukas;RIEŠUTĖLIAI;1849644444;Taip;0;1;0;1
10257;Spragtukas;RIEŠUTĖLIAI;9045185920;Taip;8;3;0;11
10258;Spragtukas;RIEŠUTĖLIAI;1800927281;Taip;0;3;0;3
10259;Spragtukas;RIEŠUTĖLIAI;1514277186;Taip;0;3;0;3
10260;Spragtukas;RIEŠUTĖLIAI;4427123314;Taip;0;14;0;14
10261;Spragtukas;RIEŠUTĖLIAI;6322121173;Taip;0;3;0;3
10262;Spragtukas;RIEŠUTĖLIAI;3113106252;Taip;0;3;0;3
10263;Spragtukas;RIEŠUTĖLIAI;9314811354;Taip;0;3;0;3
10264;Spragtukas;VIŠČIUKAI;8429135626;Taip;0;22;0;22
10265;Spragtukas;VIŠČIUKAI;2356476212;Taip;0;5;0;5
10266;Spragtukas;VIŠČIUKAI;7070881522;Taip;0;6;0;6
10267;Spragtukas;VIŠČIUKAI;8652973900;Taip;0;6;0;6
10268;Spragtukas;VIŠČIUKAI;3261213140;Taip;0;2;0;2
10269;Spragtukas;VIŠČIUKAI;8623311748;Taip;4;7;0;11
10270;Spragtukas;VIŠČIUKAI;8297700739;Taip;5;4;0;9
10271;Spragtukas;VIŠČIUKAI;9595221494;Ne;10;2;0;12
10272;Spragtukas;VIŠČIUKAI;6162830167;Taip;12;6;0;18
10273;Spragtukas;VIŠČIUKAI;5689392663;Taip;0;1;0;1
10274;Spragtukas;VIŠČIUKAI;9805841777;Taip;0;3;0;3
10275;Spragtukas;MEŠKIUKAI;4669257062;Taip;2;0;0;2
10276;Spragtukas;MEŠKIUKAI;3968434618;Taip;5;1;0;6
10277;Spragtukas;MEŠKIUKAI;1150727381;Taip;5;5;0;10
10278;Spragtukas;MEŠKIUKAI;9191831532;Taip;12;0;0;12
10279;Spragtukas;MEŠKIUKAI;1272075883;Taip;0;3;0;3
10280;Spragtukas;MEŠKIUKAI;6465991136;Taip;5;1;0;6
10281;Spragtukas;MEŠKIUKAI;9282940430;Taip;0;4;0;4
10282;Spragtukas;MEŠKIUKAI;6503842956;Taip;0;2;0;2
10283;Spragtukas;MEŠKIUKAI;3189741449;Taip;4;2;0;6
10284;Spragtukas;MEŠKIUKAI;4344537391;Taip;6;3;0;9
10285;Spragtukas;MEŠKIUKAI;6757604305;Taip;17;0;0;17
10286;Spragtukas;MEŠKIUKAI;2076126173;Taip;10;12;0;22
10287;Spragtukas;MEŠKIUKAI;7859959104;Taip;0;7;3;10
10288;Spragtukas;MEŠKIUKAI;4548945364;Taip;8;14;0;22
10289;Strazdelis;Žiogelių;59969322783;Taip;7;1;0;8
10290;Strazdelis;Žiogelių;48052363003;Taip;0;4;0;4
10291;Strazdelis;Žiogelių;12739940649;Taip;5;4;0;9
10292;Strazdelis;Žiogelių;79443961061;Taip;0;8;0;8
10293;Strazdelis;Žiogelių;84548133061;Taip;0;3;0;3
10294;Strazdelis;Žiogelių;5449465531;Taip;0;1;0;1
10295;Strazdelis;Žiogelių;57514782479;Taip;20;2;0;22
10296;Strazdelis;Žiogelių;50984917126;Taip;4;2;0;6
10297;Strazdelis;Žiogelių;43128715501;Taip;0;2;2;4
10298;Strazdelis;Žiogelių;1058210612;Taip;0;1;0;1
10299;Strazdelis;Žiogelių;85877157333;Taip;0;2;4;6
10300;Strazdelis;Žiogelių;2110092578;Taip;0;1;0;1
10301;Strazdelis;Žiogelių;90936509570;Taip;9;0;0;9
10302;Strazdelis;Žiogelių;64076729200;Taip;8;8;0;16
10303;Strazdelis;Žiogelių;1858519255;Ne;13;3;0;16
10304;Strazdelis;Žiogelių;20845810823;Taip;0;2;0;2
10305;Strazdelis;Žiogelių;98433672584;Taip;9;0;1;10
10306;Strazdelis;Žiogelių;2086723106;Taip;14;0;0;14
10307;Strazdelis;Žiogelių;20510560289;Taip;0;5;0;5
10308;Strazdelis;Šeimynėlės;3662217925;Taip;22;0;0;22
10309;Strazdelis;Šeimynėlės;4698566091;Taip;0;9;0;9
10310;Strazdelis;Šeimynėlės;8274897977;Taip;10;2;2;14
10311;Strazdelis;Šeimynėlės;45083023033;Taip;7;1;0;8
10312;Strazdelis;Šeimynėlės;5698472204;Taip;11;3;0;14
10313;Strazdelis;Šeimynėlės;29586826889;Ne;17;0;0;17
10314;Strazdelis;Šeimynėlės;6528024720;Taip;5;0;0;5
10315;Strazdelis;Šeimynėlės;43314069648;Taip;8;1;0;9
10316;Strazdelis;Šeimynėlės;4697537943;Taip;8;0;0;8
10317;Strazdelis;Šeimynėlės;9835716116;Ne;5;0;0;5
10318;Strazdelis;Šeimynėlės;3943578036;Ne;10;1;0;11
10319;Strazdelis;Šeimynėlės;2802486859;Taip;0;13;0;13
10320;Strazdelis;Šeimynėlės;4791752179;Taip;3;0;0;3
10321;Strazdelis;Šeimynėlės;7215063033;Taip;11;4;0;15
10322;Strazdelis;Šeimynėlės;7149827850;Taip;11;5;0;16
10323;Strazdelis;Šeimynėlės;1665134387;Taip;16;0;0;16
10324;Strazdelis;Šeimynėlės;1481671624;Taip;1;3;0;4
10325;Strazdelis;Šeimynėlės;6014213362;Taip;1;0;0;1
10326;Strazdelis;Genelio;8754275576;Ne;0;6;0;6
10327;Strazdelis;Genelio;7216768880;Taip;0;3;0;3
10328;Strazdelis;Genelio;1540973269;Taip;0;1;0;1
10329;Strazdelis;Genelio;7120717682;Taip;0;3;0;3
10330;Strazdelis;Genelio;50350281905;Taip;2;3;0;5
10331;Strazdelis;Genelio;1187534672;Taip;0;3;0;3
10332;Strazdelis;Genelio;9198429790;Taip;0;4;0;4
10333;Strazdelis;Genelio;2871673641;Taip;7;10;0;17
10334;Strazdelis;Genelio;6147183190;Taip;22;0;0;22
10335;Strazdelis;Genelio;2078150337;Taip;0;1;0;1
10336;Strazdelis;Genelio;18461074207;Taip;17;0;0;17
10337;Strazdelis;Genelio;1362428967;Taip;7;0;0;7
10338;Strazdelis;Genelio;8801420992;Taip;15;0;0;15
10339;Strazdelis;Genelio;9904719582;Taip;10;0;0;10
10340;Strazdelis;Genelio;7308925265;Taip;5;2;1;8
10341;Strazdelis;Genelio;4655931716;Taip;20;0;0;20
10342;Strazdelis;Genelio;8182994112;Ne;7;2;0;9
10343;Strazdelis;Genelio;5371939820;Taip;17;1;0;18
10344;Strazdelis;Genelio;68605763183;Taip;22;0;0;22
10345;Strazdelis;Vikruolių;58844235230;Taip;0;3;0;3
10346;Strazdelis;Vikruolių;7549142768;Ne;0;2;0;2
10347;Strazdelis;Vikruolių;79337959137;Taip;0;16;0;16
10348;Strazdelis;Vikruolių;56331124076;Ne;0;1;0;1
10349;Strazdelis;Vikruolių;14923406397;Ne;0;10;0;10
10350;Strazdelis;Vikruolių;70999059743;Ne;0;5;0;5
10351;Strazdelis;Vikruolių;33107603963;Ne;8;1;0;9
10352;Strazdelis;Vikruolių;29094108735;Taip;0;1;0;1
10353;Strazdelis;Vikruolių;1952649844;Taip;0;4;0;4
10354;Strazdelis;Vikruolių;75235370334;Taip;1;2;0;3
10355;Strazdelis;Vikruolių;42180634251;Taip;0;2;1;3
10356;Strazdelis;Vikruolių;30372050952;Taip;7;0;0;7
10357;Strazdelis;Vikruolių;39915650220;Ne;0;9;0;9
10358;Strazdelis;Vikruolių;3292943291;Taip;0;2;0;2
10359;Strazdelis;Vikruolių;97790033745;Taip;0;1;0;1
10360;Strazdelis;Vikruolių;96227697952;Taip;2;1;0;3
10361;Strazdelis;Vikruolių;83264226550;Taip;1;0;0;1
10362;Strazdelis;Vyturėlių;89976183528;Taip;0;1;0;1
10363;Strazdelis;Vyturėlių;67195412172;Taip;0;6;0;6
10364;Strazdelis;Vyturėlių;52370891798;Taip;0;11;0;11
10365;Strazdelis;Vyturėlių;21075820140;Ne;2;2;1;5
10366;Strazdelis;Vyturėlių;88801862582;Taip;0;5;0;5
10367;Strazdelis;Vyturėlių;33675356631;Ne;2;1;0;3
10368;Strazdelis;Vyturėlių;71377546049;Taip;7;0;0;7
10369;Strazdelis;Vyturėlių;1499287166;Taip;0;2;0;2
10370;Strazdelis;Vyturėlių;66353793576;Taip;0;1;0;1
10371;Strazdelis;Vyturėlių;39525751316;Taip;0;2;0;2
10372;Strazdelis;Vyturėlių;24240557041;Taip;0;9;0;9
10373;Strazdelis;Vyturėlių;60144664935;Taip;0;1;0;1
10374;Strazdelis;Vyturėlių;53302522911;Taip;0;8;0;8
10375;Strazdelis;Vyturėlių;1888068247;Taip;2;1;0;3
10376;Strazdelis;Vyturėlių;1347273712;Taip;0;4;0;4
10377;Strazdelis;Vyturėlių;1611711233;Taip;15;0;0;15
10378;Strazdelis;Vyturėlių;20384116848;Ne;0;4;0;4
10379;Strazdelis;Vyturėlių;41690491541;Taip;0;2;0;2
10380;Strazdelis;Vyturėlių;62150824334;Ne;0;10;0;10
10381;Strazdelis;Vyturėlių;3320884603;Ne;0;14;0;14
10382;Strazdelis;Varpelio;43722400626;Taip;0;2;0;2
10383;Strazdelis;Varpelio;39502125227;Taip;0;2;0;2
10384;Strazdelis;Varpelio;2502465398;Taip;0;1;0;1
10385;Strazdelis;Varpelio;83919699672;Taip;4;0;0;4
10386;Strazdelis;Varpelio;1426195737;Taip;0;3;0;3
10387;Strazdelis;Varpelio;86957187003;Taip;0;19;0;19
10388;Strazdelis;Varpelio;52211473547;Taip;0;2;0;2
10389;Strazdelis;Varpelio;54646720821;Taip;3;1;0;4
10390;Strazdelis;Varpelio;62063592887;Taip;0;2;0;2
10391;Strazdelis;Varpelio;95260832237;Taip;0;7;0;7
10392;Strazdelis;Varpelio;47899514138;Taip;10;2;0;12
10393;Strazdelis;Varpelio;3636163418;Taip;0;6;0;6
10394;Strazdelis;Varpelio;17045991832;Taip;0;1;0;1
10395;Strazdelis;Varpelio;58143176237;Taip;0;1;0;1
10396;Strazdelis;Varpelio;58440671129;Taip;17;0;0;17
10397;Strazdelis;Varpelio;1785962711;Taip;0;4;0;4
10398;Strazdelis;Varpelio;98818869900;Taip;0;2;0;2
10399;Strazdelis;Varpelio;49277241025;Taip;13;2;0;15
10400;Strazdelis;Varpelio;1707225898;Ne;10;6;0;16
10401;Strazdelis;Pelėdžiukų;13220421668;Taip;0;10;0;10
10402;Strazdelis;Pelėdžiukų;13625184061;Taip;0;2;0;2
10403;Strazdelis;Pelėdžiukų;73711363249;Taip;0;2;0;2
10404;Strazdelis;Pelėdžiukų;66197587093;Taip;0;3;0;3
10405;Strazdelis;Pelėdžiukų;62754553467;Taip;0;3;0;3
10406;Strazdelis;Pelėdžiukų;16453584376;Taip;5;6;0;11
10407;Strazdelis;Pelėdžiukų;72069723016;Taip;0;2;0;2
10408;Strazdelis;Pelėdžiukų;63720428545;Taip;10;6;0;16
10409;Strazdelis;Pelėdžiukų;54050062292;Taip;0;2;0;2
10410;Strazdelis;Pelėdžiukų;18595696353;Taip;3;4;0;7
10411;Strazdelis;Pelėdžiukų;23371576969;Taip;0;2;0;2
10412;Strazdelis;Pelėdžiukų;87689168341;Taip;0;1;0;1
10413;Strazdelis;Pelėdžiukų;23376659452;Taip;0;4;0;4
10414;Strazdelis;Pelėdžiukų;56012252629;Taip;0;6;0;6
10415;Strazdelis;Pelėdžiukų;77589342371;Taip;0;3;0;3
10416;Strazdelis;Pelėdžiukų;91962766970;Taip;0;4;0;4
10417;Strazdelis;Pelėdžiukų;52790577750;Taip;6;0;0;6
10418;Strazdelis;Pelėdžiukų;1140100663;Taip;11;0;0;11
10419;Strazdelis;Saulutės;1693309238;Taip;0;4;0;4
10420;Strazdelis;Saulutės;27177757900;Taip;0;2;4;6
10421;Strazdelis;Saulutės;1886601605;Taip;0;8;7;15
10422;Strazdelis;Saulutės;40932140069;Taip;6;4;0;10
10423;Strazdelis;Saulutės;1523471662;Taip;18;1;0;19
10424;Strazdelis;Saulutės;2854642875;Taip;16;0;0;16
10425;Strazdelis;Saulutės;7578229276;Taip;5;1;0;6
10426;Strazdelis;Saulutės;8710848483;Taip;3;0;0;3
10427;Strazdelis;Saulutės;8808299050;Taip;0;3;0;3
10428;Strazdelis;Saulutės;6614184499;Taip;6;0;0;6
10429;Strazdelis;Saulutės;4129957131;Taip;17;0;0;17
10430;Strazdelis;Saulutės;3425430317;Taip;9;0;0;9
10431;Strazdelis;Saulutės;5059832307;Taip;0;2;2;4
10432;Strazdelis;Saulutės;7081517417;Taip;6;1;0;7
10433;Strazdelis;Saulutės;67641340859;Taip;5;8;0;13
10434;Strazdelis;Saulutės;15298412755;Ne;7;4;0;11
10435;Strazdelis;Saulutės;12713270671;Taip;4;0;0;4
10436;Strazdelis;Saulutės;1802092125;Ne;15;0;0;15
10437;Strazdelis;Saulutės;1391009140;Taip;8;0;0;8
10438;Strazdelis;Saulutės;6779352728;Taip;2;0;0;2
10439;Strazdelis;Saulutės;29225108934;Taip;5;0;0;5
10440;Strazdelis;Bitutės;99973904527;Taip;4;0;0;4
10441;Strazdelis;Bitutės;92799934389;Taip;12;0;0;12
10442;Strazdelis;Bitutės;9065275674;Taip;5;2;1;8
10443;Strazdelis;Bitutės;33123804487;Ne;0;5;0;5
10444;Strazdelis;Bitutės;6523307315;Taip;22;0;0;22
10445;Strazdelis;Bitutės;15920566059;Taip;8;4;0;12
10446;Strazdelis;Bitutės;18222675927;Taip;0;1;0;1
10447;Strazdelis;Bitutės;66254701944;Taip;5;7;0;12
10448;Strazdelis;Bitutės;24001445236;Taip;0;4;0;4
10449;Strazdelis;Bitutės;96062922228;Taip;0;2;0;2
10450;Strazdelis;Bitutės;24669852216;Taip;1;2;0;3
10451;Strazdelis;Bitutės;51702469375;Taip;8;0;0;8
10452;Strazdelis;Bitutės;59837435595;Taip;4;8;0;12
10453;Strazdelis;Bitutės;90089166514;Taip;4;2;0;6
10454;Strazdelis;Bitutės;7812253305;Taip;4;0;0;4
10455;Strazdelis;Bitutės;96077591556;Taip;0;3;0;3
10456;Strazdelis;Bitutės;14459771394;Taip;0;3;0;3
10457;Strazdelis;Bitutės;2673522432;Taip;22;0;0;22
10458;Strazdelis;Mažylių;1955166372;Taip;5;0;0;5
10459;Strazdelis;Mažylių;8415383526;Taip;21;0;0;21
10460;Strazdelis;Mažylių;6931726275;Ne;16;1;0;17
10461;Strazdelis;Mažylių;6311710825;Taip;10;0;0;10
10462;Strazdelis;Mažylių;4873707286;Ne;11;2;0;13
10463;Strazdelis;Mažylių;4076266466;Taip;22;0;0;22
10464;Strazdelis;Mažylių;2824416350;Taip;4;5;1;10
10465;Strazdelis;Mažylių;3610250359;Taip;22;0;0;22
10466;Strazdelis;Mažylių;2580733127;Taip;9;0;0;9
10467;Strazdelis;Mažylių;2251157025;Taip;18;0;0;18
10468;Strazdelis;Mažylių;9401101407;Ne;0;2;0;2
10469;Strazdelis;Mažylių;6527855940;Taip;0;4;1;5
10470;Strazdelis;Pabiručių;1021364759;Taip;6;6;0;12
10471;Strazdelis;Pabiručių;5580738386;Taip;1;0;1;2
10472;Strazdelis;Pabiručių;1706026100;Ne;1;2;0;3
10473;Strazdelis;Pabiručių;8637386316;Taip;1;1;0;2
10474;Strazdelis;Pabiručių;8287554571;Taip;5;0;0;5
10475;Strazdelis;Pabiručių;6555803164;Taip;0;2;0;2
10476;Strazdelis;Pabiručių;3943914976;Taip;1;0;0;1
10477;Strazdelis;Pabiručių;1704292727;Taip;11;0;0;11
10478;Strazdelis;Pabiručių;4617237063;Taip;9;0;0;9
10479;Strazdelis;Pabiručių;3036380561;Taip;9;0;0;9
10480;Strazdelis;Pabiručių;4562530311;Taip;2;5;0;7
10481;Strazdelis;Pabiručių;6046139859;Taip;2;0;0;2
10482;Strazdelis;Pabiručių;4448556404;Taip;10;0;0;10
10483;Strazdelis;Pabiručių;8854150040;Taip;1;0;0;1
10484;Strazdelis;Pabiručių;7393083827;Taip;3;1;0;4
10485;Strazdelis;Pabiručių;1901641517;Taip;11;1;0;12
10486;Strazdelis;Pabiručių;8371999002;Taip;8;1;0;9
10487;Šermukšnėlė;MOLINUKAI;82928987881;Taip;0;0;4;4
10488;Šermukšnėlė;MOLINUKAI;42211665091;Taip;1;0;0;1
10489;Šermukšnėlė;MOLINUKAI;87315703379;Taip;0;4;0;4
10490;Šermukšnėlė;MOLINUKAI;60863269031;Taip;0;5;0;5
10491;Šermukšnėlė;MOLINUKAI;92414041480;Taip;5;0;0;5
10492;Šermukšnėlė;MOLINUKAI;54312555311;Taip;5;0;0;5
10493;Šermukšnėlė;MOLINUKAI;2100740973;Taip;8;0;1;9
10494;Šermukšnėlė;MOLINUKAI;3873114056;Taip;0;0;1;1
10495;Šermukšnėlė;MOLINUKAI;1738008915;Taip;0;12;0;12
10496;Šermukšnėlė;MOLINUKAI;38451276871;Taip;15;0;0;15
10497;Šermukšnėlė;ŠIAUDINUKAI;61916462777;Taip;0;0;1;1
10498;Šermukšnėlė;ŠIAUDINUKAI;40455970268;Taip;0;1;3;4
10499;Šermukšnėlė;ŠIAUDINUKAI;60939430598;Taip;5;0;1;6
10500;Šermukšnėlė;ŠIAUDINUKAI;95999386401;Taip;0;0;1;1
10501;Šermukšnėlė;ŠIAUDINUKAI;26710222684;Taip;0;0;3;3
10502;Šermukšnėlė;ŠIAUDINUKAI;34526101469;Taip;0;8;0;8
10503;Šermukšnėlė;ŠIAUDINUKAI;27112465050;Taip;0;1;0;1
10504;Šermukšnėlė;ŠIAUDINUKAI;33885733234;Taip;0;0;4;4
10505;Šermukšnėlė;ŠIAUDINUKAI;18100145020;Taip;0;0;1;1
10506;Šermukšnėlė;ŠIAUDINUKAI;63943361071;Taip;0;7;0;7
10507;Šermukšnėlė;ŠIAUDINUKAI;16859553972;Taip;0;4;0;4
10508;Šermukšnėlė;ŠIAUDINUKAI;32403224788;Ne;2;0;2;4
10509;Šermukšnėlė;ŠIAUDINUKAI;99444734331;Taip;0;0;3;3
10510;Šermukšnėlė;ŠIAUDINUKAI;3851927973;Taip;0;0;3;3
10511;Šermukšnėlė;TOŠINUKAI;8648722780;Ne;6;0;0;6
10512;Šermukšnėlė;TOŠINUKAI;10371439347;Taip;5;0;0;5
10513;Šermukšnėlė;TOŠINUKAI;5263529062;Taip;0;5;0;5
10514;Šermukšnėlė;TOŠINUKAI;70200454607;Taip;0;0;14;14
10515;Šermukšnėlė;TOŠINUKAI;91969292233;Taip;0;0;1;1
10516;Šermukšnėlė;TOŠINUKAI;1290319484;Taip;0;1;0;1
10517;Šermukšnėlė;TOŠINUKAI;1636627303;Taip;0;0;1;1
10518;Šermukšnėlė;TOŠINUKAI;51058072005;Taip;0;7;0;7
10519;Šermukšnėlė;TOŠINUKAI;1559325175;Taip;0;5;0;5
10520;Šermukšnėlė;TOŠINUKAI;1755108527;Taip;0;0;1;1
10521;Šermukšnėlė;TOŠINUKAI;2137141949;Taip;0;0;3;3
10522;Šermukšnėlė;TOŠINUKAI;1858862320;Taip;6;0;4;10
10523;Šermukšnėlė;TOŠINUKAI;1016403317;Taip;0;8;0;8
10524;Šermukšnėlė;TOŠINUKAI;2477657052;Taip;0;5;0;5
10525;Šermukšnėlė;ODINUKAI;9132691512;Taip;0;0;1;1
10526;Šermukšnėlė;ODINUKAI;33974692298;Taip;5;3;0;8
10527;Šermukšnėlė;ODINUKAI;41864110754;Taip;0;2;0;2
10528;Šermukšnėlė;ODINUKAI;33749192545;Taip;0;0;1;1
10529;Šermukšnėlė;ODINUKAI;56169221671;Taip;0;0;6;6
10530;Šermukšnėlė;ODINUKAI;74932757076;Taip;0;1;0;1
10531;Šermukšnėlė;ODINUKAI;42759782885;Taip;0;0;3;3
10532;Šermukšnėlė;ODINUKAI;72671813439;Taip;0;11;0;11
10533;Šermukšnėlė;ODINUKAI;87510707958;Taip;0;2;0;2
10534;Šermukšnėlė;ODINUKAI;54578226695;Taip;0;0;6;6
10535;Šermukšnėlė;ODINUKAI;29671788305;Taip;0;0;3;3
10536;Šermukšnėlė;ODINUKAI;53753895760;Taip;0;2;0;2
10537;Šermukšnėlė;ODINUKAI;1911285078;Taip;0;0;2;2
10538;Šermukšnėlė;KRIAUKLELĖS;26775257484;Taip;0;12;0;12
10539;Šermukšnėlė;KRIAUKLELĖS;80349025945;Taip;22;0;0;22
10540;Šermukšnėlė;KRIAUKLELĖS;2561033248;Taip;0;8;0;8
10541;Šermukšnėlė;KRIAUKLELĖS;48653098796;Taip;0;7;0;7
10542;Šermukšnėlė;KRIAUKLELĖS;8123096990;Taip;2;7;0;9
10543;Šermukšnėlė;KRIAUKLELĖS;1492328724;Taip;4;0;0;4
10544;Šermukšnėlė;KRIAUKLELĖS;82028252228;Taip;9;0;1;10
10545;Šermukšnėlė;KRIAUKLELĖS;1110375562;Taip;10;9;0;19
10546;Šermukšnėlė;KRIAUKLELĖS;23434568160;Taip;0;0;1;1
10547;Šermukšnėlė;KRIAUKLELĖS;1562494176;Taip;0;8;0;8
10548;Šermukšnėlė;KRIAUKLELĖS;3543061360;Taip;5;2;0;7
10549;Šermukšnėlė;KRIAUKLELĖS;8511421692;Taip;0;0;1;1
10550;Šermukšnėlė;KRIAUKLELĖS;6896990721;Taip;0;0;1;1
10551;Šermukšnėlė;KRIAUKLELĖS;7564745299;Taip;5;9;0;14
10552;Šermukšnėlė;KRIAUKLELĖS;6937555692;Taip;5;5;0;10
10553;Šermukšnėlė;KRIAUKLELĖS;9617044855;Ne;8;5;0;13
10554;Šermukšnėlė;KRIAUKLELĖS;3639954786;Taip;17;0;1;18
10555;Šermukšnėlė;KRIAUKLELĖS;5757405893;Taip;0;0;1;1
10556;Šermukšnėlė;KRIAUKLELĖS;1902848560;Taip;0;5;0;5
10557;Šermukšnėlė;VYTINUKAI;4601810772;Taip;0;4;0;4
10558;Šermukšnėlė;VYTINUKAI;97906920174;Ne;0;0;5;5
10559;Šermukšnėlė;VYTINUKAI;1523361932;Taip;0;0;5;5
10560;Šermukšnėlė;VYTINUKAI;25189813939;Taip;2;4;0;6
10561;Šermukšnėlė;VYTINUKAI;83123267733;Taip;0;3;0;3
10562;Šermukšnėlė;VYTINUKAI;20028832329;Taip;0;3;0;3
10563;Šermukšnėlė;VYTINUKAI;3751769136;Taip;0;0;2;2
10564;Šermukšnėlė;VYTINUKAI;5905000902;Taip;6;5;0;11
10565;Šermukšnėlė;VYTINUKAI;6291531570;Taip;3;0;0;3
10566;Šermukšnėlė;VYTINUKAI;8398961969;Taip;9;6;3;18
10567;Šermukšnėlė;VYTINUKAI;1244964311;Taip;4;0;2;6
10568;Šermukšnėlė;VYTINUKAI;83882579952;Taip;0;9;0;9
10569;Šermukšnėlė;VYTINUKAI;60840526220;Taip;5;0;0;5
10570;Šermukšnėlė;VYTINUKAI;8610668395;Taip;6;0;2;8
10571;Šermukšnėlė;VYTINUKAI;1519623099;Taip;0;7;0;7
10572;Šermukšnėlė;GINTARĖLIAI;3147809450;Taip;6;0;0;6
10573;Šermukšnėlė;GINTARĖLIAI;1167696952;Taip;11;0;0;11
10574;Šermukšnėlė;GINTARĖLIAI;85062380771;Taip;9;0;4;13
10575;Šermukšnėlė;GINTARĖLIAI;35389950541;Taip;6;0;15;21
10576;Šermukšnėlė;GINTARĖLIAI;82240400954;Taip;1;0;0;1
10577;Šermukšnėlė;GINTARĖLIAI;1944687724;Taip;5;0;0;5
10578;Šermukšnėlė;GINTARĖLIAI;1013698297;Taip;10;0;2;12
10579;Šermukšnėlė;GINTARĖLIAI;1853346049;Taip;8;0;0;8
10580;Šermukšnėlė;GINTARĖLIAI;3697936074;Taip;21;0;0;21
10581;Šermukšnėlė;GINTARĖLIAI;2686950289;Ne;0;1;2;3
10582;Šermukšnėlė;GINTARĖLIAI;27183547828;Ne;0;0;4;4
10583;Šermukšnėlė;GINTARĖLIAI;10728235594;Ne;0;0;2;2
10584;Šermukšnėlė;GINTARĖLIAI;42477406335;Taip;12;0;0;12
10585;Šermukšnėlė;GINTARĖLIAI;61300763004;Taip;0;7;0;7
10586;Šermukšnėlė;GINTARĖLIAI;1425285365;Taip;0;0;6;6
10587;Šermukšnėlė;GINTARĖLIAI;6279210465;Taip;5;0;3;8
10588;Šermukšnėlė;AKMENUKAI;17555989996;Taip;0;7;0;7
10589;Šermukšnėlė;AKMENUKAI;60154507177;Ne;4;3;2;9
10590;Šermukšnėlė;AKMENUKAI;6987675764;Taip;0;0;4;4
10591;Šermukšnėlė;AKMENUKAI;84389234313;Taip;3;0;0;3
10592;Šermukšnėlė;AKMENUKAI;35098181817;Taip;0;0;7;7
10593;Šermukšnėlė;AKMENUKAI;20272898512;Taip;0;0;5;5
10594;Šermukšnėlė;AKMENUKAI;95089450234;Taip;0;0;2;2
10595;Šermukšnėlė;AKMENUKAI;1332354208;Taip;0;0;6;6
10596;Šermukšnėlė;AKMENUKAI;1175718969;Taip;5;1;0;6
10597;Šermukšnėlė;AKMENUKAI;27139089487;Taip;0;1;0;1
10598;Šermukšnėlė;AKMENUKAI;42520543068;Taip;0;0;1;1
10599;Šermukšnėlė;AKMENUKAI;76682206033;Taip;7;4;0;11
10600;Šermukšnėlė;AKMENUKAI;1316118025;Taip;0;0;1;1
10601;Šermukšnėlė;AKMENUKAI;3628734426;Taip;2;4;0;6
10602;Šermukšnėlė;AKMENUKAI;82161996761;Taip;0;0;1;1
10603;Šermukšnėlė;SIŪLINUKAI;32417473492;Taip;4;2;1;7
10604;Šermukšnėlė;SIŪLINUKAI;35508499818;Taip;4;2;1;7
10605;Šermukšnėlė;SIŪLINUKAI;1054907277;Taip;0;0;1;1
10606;Šermukšnėlė;SIŪLINUKAI;30853722796;Taip;0;2;0;2
10607;Šermukšnėlė;SIŪLINUKAI;62420710883;Taip;0;0;2;2
10608;Šermukšnėlė;SIŪLINUKAI;25663713043;Taip;0;1;0;1
10609;Šermukšnėlė;SIŪLINUKAI;88123535614;Taip;0;1;0;1
10610;Šermukšnėlė;SIŪLINUKAI;1330471614;Taip;0;1;0;1
10611;Šermukšnėlė;SIŪLINUKAI;1127786451;Taip;0;3;0;3
10612;Šermukšnėlė;SIŪLINUKAI;78916223877;Taip;5;2;3;10
10613;Šermukšnėlė;SIŪLINUKAI;45632551657;Taip;0;6;2;8
10614;Šermukšnėlė;MEDINUKAi;2380988728;Ne;0;8;1;9
10615;Šermukšnėlė;MEDINUKAi;2529526401;Taip;11;0;4;15
10616;Šermukšnėlė;MEDINUKAi;8956573129;Taip;0;7;1;8
10617;Šermukšnėlė;MEDINUKAi;3222466449;Taip;0;0;1;1
10618;Šermukšnėlė;MEDINUKAi;5096946133;Taip;0;8;0;8
10619;Šermukšnėlė;MEDINUKAi;8279692394;Taip;9;0;1;10
10620;Šermukšnėlė;MEDINUKAi;1459253197;Taip;0;0;1;1
10621;Šermukšnėlė;MEDINUKAi;78341448188;Taip;1;0;1;2
10622;Šermukšnėlė;MEDINUKAi;1661977128;Ne;0;0;9;9
10623;Šermukšnėlė;MEDINUKAi;6430627501;Taip;0;5;0;5
10624;Šermukšnėlė;MEDINUKAi;5832072195;Taip;22;0;0;22
10625;Šermukšnėlė;MEDINUKAi;9035625467;Taip;0;0;1;1
10626;Šermukšnėlė;MEDINUKAi;7038705221;Taip;5;0;1;6
10627;Šermukšnėlė;MEDINUKAi;3081548524;Taip;4;6;0;10
10628;Šermukšnėlė;SKUDURINUKAI;2176788727;Taip;10;0;0;10
10629;Šermukšnėlė;SKUDURINUKAI;3949629658;Taip;0;4;0;4
10630;Šermukšnėlė;SKUDURINUKAI;5151843494;Taip;2;0;1;3
10631;Šermukšnėlė;SKUDURINUKAI;3148857617;Taip;10;4;0;14
10632;Šermukšnėlė;SKUDURINUKAI;4201283154;Ne;3;0;3;6
10633;Šermukšnėlė;SKUDURINUKAI;5575518612;Taip;6;0;0;6
10634;Šermukšnėlė;SKUDURINUKAI;5733540837;Taip;5;0;0;5
10635;Šermukšnėlė;SKUDURINUKAI;5397385093;Taip;4;2;0;6
10636;Šermukšnėlė;SKUDURINUKAI;3322053946;Taip;5;5;0;10
10637;Šermukšnėlė;SKUDURINUKAI;5354978646;Taip;4;6;2;12
10638;Šermukšnėlė;SKUDURINUKAI;1882432812;Taip;2;6;5;13
10639;Šermukšnėlė;SKUDURINUKAI;5242187638;Ne;0;0;2;2
10640;Šermukšnėlė;SKUDURINUKAI;5159461963;Taip;5;7;0;12
10641;Šermukšnėlė;SKUDURINUKAI;5545018656;Taip;0;5;0;5
10642;Šermukšnėlė;PAGRANDUKAI;7245206247;Taip;3;2;0;5
10643;Šermukšnėlė;PAGRANDUKAI;5140264695;Taip;4;0;0;4
10644;Šermukšnėlė;PAGRANDUKAI;5159105661;Taip;22;0;0;22
10645;Šermukšnėlė;PAGRANDUKAI;7305013368;Taip;0;1;0;1
10646;Šermukšnėlė;PAGRANDUKAI;1437314920;Taip;0;5;0;5
10647;Šermukšnėlė;PAGRANDUKAI;7843128263;Taip;5;0;0;5
10648;Šermukšnėlė;PAGRANDUKAI;8407947566;Ne;11;0;1;12
10649;Šermukšnėlė;PAGRANDUKAI;2447547509;Taip;4;0;2;6
10650;Šermukšnėlė;PAGRANDUKAI;4086783761;Taip;0;0;2;2
10651;Šermukšnėlė;PAGRANDUKAI;3513568460;Taip;6;0;1;7
10652;Šermukšnėlė;PAGRANDUKAI;4230698872;Ne;7;0;0;7
10653;Šermukšnėlė;PAGRANDUKAI;6067298318;Taip;15;1;0;16
10654;Šypsena;NYKŠTUKAI;5985974927;Taip;6;1;0;7
10655;Šypsena;NYKŠTUKAI;4766170132;Ne;6;0;0;6
10656;Šypsena;NYKŠTUKAI;4936775366;Taip;0;1;11;12
10657;Šypsena;NYKŠTUKAI;7569495879;Taip;0;1;0;1
10658;Šypsena;NYKŠTUKAI;4635232236;Taip;8;6;0;14
10659;Šypsena;NYKŠTUKAI;4677405885;Taip;4;0;2;6
10660;Šypsena;NYKŠTUKAI;1343249939;Taip;5;5;3;13
10661;Šypsena;NYKŠTUKAI;1387130727;Taip;14;0;0;14
10662;Šypsena;NYKŠTUKAI;3025437080;Taip;0;0;8;8
10663;Šypsena;NYKŠTUKAI;1669768648;Ne;10;0;2;12
10664;Šypsena;NYKŠTUKAI;1575413188;Taip;5;7;0;12
10665;Šypsena;NYKŠTUKAI;2005543016;Ne;0;11;0;11
10666;Šypsena;NYKŠTUKAI;6832433711;Taip;5;0;0;5
10667;Šypsena;NYKŠTUKAI;2248628927;Taip;0;2;0;2
10668;Šypsena;NYKŠTUKAI;2995753269;Taip;10;0;1;11
10669;Šypsena;NYKŠTUKAI;1796837022;Taip;0;4;0;4
10670;Šypsena;NYKŠTUKAI;7251064118;Taip;0;0;6;6
10671;Šypsena;SPINDULIUKAI;6444616846;Taip;0;6;0;6
10672;Šypsena;SPINDULIUKAI;1967590536;Taip;0;8;0;8
10673;Šypsena;SPINDULIUKAI;3541189470;Ne;11;0;2;13
10674;Šypsena;SPINDULIUKAI;1272973534;Ne;0;1;0;1
10675;Šypsena;SPINDULIUKAI;1767948457;Ne;0;4;0;4
10676;Šypsena;SPINDULIUKAI;1917246860;Ne;0;22;0;22
10677;Šypsena;SPINDULIUKAI;46569341613;Ne;15;0;0;15
10678;Šypsena;SPINDULIUKAI;42130115068;Taip;0;9;0;9
10679;Šypsena;SPINDULIUKAI;1712017606;Ne;0;1;0;1
10680;Šypsena;SPINDULIUKAI;1996746426;Taip;0;7;0;7
10681;Šypsena;SPINDULIUKAI;4017777389;Taip;3;0;3;6
10682;Šypsena;SPINDULIUKAI;70188972463;Taip;7;0;0;7
10683;Šypsena;SPINDULIUKAI;76332370575;Taip;0;1;0;1
10684;Šypsena;SPINDULIUKAI;2099216049;Taip;10;12;0;22
10685;Šypsena;SPINDULIUKAI;89503728819;Ne;0;2;0;2
10686;Šypsena;SPINDULIUKAI;93678429536;Taip;0;8;0;8
10687;Šypsena;SPINDULIUKAI;8197460768;Taip;0;8;0;8
10688;Šypsena;SPINDULIUKAI;1133113196;Ne;3;6;0;9
10689;Šypsena;SKRUZDELIUKAI;7591001646;Ne;10;5;0;15
10690;Šypsena;SKRUZDELIUKAI;1369664461;Ne;0;3;0;3
10691;Šypsena;SKRUZDELIUKAI;1886141947;Taip;0;0;3;3
10692;Šypsena;SKRUZDELIUKAI;1329170686;Taip;2;0;0;2
10693;Šypsena;SKRUZDELIUKAI;39296351965;Taip;4;1;0;5
10694;Šypsena;SKRUZDELIUKAI;25175991441;Taip;0;1;0;1
10695;Šypsena;SKRUZDELIUKAI;91846404526;Ne;2;6;0;8
10696;Šypsena;SKRUZDELIUKAI;47729405181;Taip;0;1;4;5
10697;Šypsena;SKRUZDELIUKAI;1972212253;Taip;0;2;6;8
10698;Šypsena;SKRUZDELIUKAI;79177095462;Taip;3;4;0;7
10699;Šypsena;SKRUZDELIUKAI;39495782526;Taip;0;9;0;9
10700;Šypsena;SKRUZDELIUKAI;2117865969;Taip;0;2;0;2
10701;Šypsena;SKRUZDELIUKAI;1755934341;Taip;10;0;0;10
10702;Šypsena;SKRUZDELIUKAI;1702152247;Taip;0;5;0;5
10703;Šypsena;SKRUZDELIUKAI;2119267347;Ne;3;5;0;8
10704;Šypsena;SKRUZDELIUKAI;5680397153;Taip;11;0;4;15
10705;Šypsena;SKRUZDELIUKAI;2368339278;Taip;0;9;0;9
10706;Šypsena;Bitutės;51581713246;Ne;0;0;2;2
10707;Šypsena;Bitutės;77031848208;Ne;0;0;2;2
10708;Šypsena;Bitutės;1720218822;Ne;0;0;4;4
10709;Šypsena;Bitutės;89119472685;Taip;0;8;0;8
10710;Šypsena;Bitutės;1872237094;Taip;0;0;1;1
10711;Šypsena;Bitutės;51099062216;Ne;0;0;1;1
10712;Šypsena;Bitutės;93544585309;Ne;0;0;2;2
10713;Šypsena;Bitutės;44505027442;Ne;0;4;0;4
10714;Šypsena;Bitutės;1505433574;Ne;0;0;4;4
10715;Šypsena;MEŠKIUKAI;1114341518;Taip;7;0;2;9
10716;Šypsena;MEŠKIUKAI;8715718525;Taip;4;0;0;4
10717;Šypsena;MEŠKIUKAI;2312828770;Taip;0;1;1;2
10718;Šypsena;MEŠKIUKAI;7438060503;Taip;4;0;7;11
10719;Šypsena;MEŠKIUKAI;1515803985;Ne;5;3;0;8
10720;Šypsena;MEŠKIUKAI;5504570516;Taip;3;0;6;9
10721;Šypsena;MEŠKIUKAI;1063834589;Taip;0;2;0;2
10722;Šypsena;MEŠKIUKAI;1558614852;Ne;10;0;0;10
10723;Šypsena;MEŠKIUKAI;1897176871;Taip;5;3;0;8
10724;Šypsena;MEŠKIUKAI;1181590127;Taip;10;4;2;16
10725;Šypsena;MEŠKIUKAI;4808041625;Taip;7;0;0;7
10726;Šypsena;MEŠKIUKAI;5834057370;Taip;0;8;0;8
10727;Šypsena;MEŠKIUKAI;5928432220;Taip;6;0;0;6
10728;Šypsena;MEŠKIUKAI;2798819321;Taip;0;9;0;9
10729;Šypsena;BORUŽĖLĖS;3506046076;Ne;4;1;0;5
10730;Šypsena;BORUŽĖLĖS;5611440056;Ne;0;1;0;1
10731;Šypsena;BORUŽĖLĖS;7160466766;Taip;0;3;0;3
10732;Šypsena;BORUŽĖLĖS;4038279267;Taip;5;2;0;7
10733;Šypsena;BORUŽĖLĖS;6713182218;Taip;15;4;0;19
10734;Šypsena;BORUŽĖLĖS;8950694484;Taip;8;1;0;9
10735;Šypsena;BORUŽĖLĖS;4344780723;Taip;0;0;15;15
10736;Šypsena;BORUŽĖLĖS;7537442618;Taip;0;2;0;2
10737;Šypsena;BORUŽĖLĖS;3968514430;Taip;0;1;0;1
10738;Šypsena;BORUŽĖLĖS;1893123775;Taip;22;0;0;22
10739;Šypsena;BORUŽĖLĖS;6237208661;Taip;0;0;3;3
10740;Šypsena;BORUŽĖLĖS;6716558946;Taip;22;0;0;22
10741;Šypsena;BORUŽĖLĖS;7519967594;Taip;2;0;0;2
10742;Šnekutis;DRUGELIŲ;1723901018;Taip;0;10;0;10
10743;Šnekutis;DRUGELIŲ;81648325534;Taip;2;0;0;2
10744;Šnekutis;DRUGELIŲ;1245722149;Taip;0;12;0;12
10745;Šnekutis;DRUGELIŲ;1355103006;Taip;0;12;8;20
10746;Šnekutis;DRUGELIŲ;2000728679;Taip;0;1;0;1
10747;Šnekutis;DRUGELIŲ;54635137954;Taip;12;0;0;12
10748;Šnekutis;DRUGELIŲ;50017415248;Taip;0;5;0;5
10749;Šnekutis;DRUGELIŲ;1956224017;Taip;6;0;0;6
10750;Šnekutis;DRUGELIŲ;1159232792;Taip;3;0;6;9
10751;Šnekutis;DRUGELIŲ;2092637040;Taip;15;0;0;15
10752;Šnekutis;DRUGELIŲ;94289379983;Taip;0;3;0;3
10753;Šnekutis;DRUGELIŲ;50085798686;Taip;17;3;0;20
10754;Šnekutis;DRUGELIŲ;13209811505;Taip;0;0;4;4
10755;Šnekutis;DRUGELIŲ;1836892386;Taip;6;0;1;7
10756;Šnekutis;DRUGELIŲ;5962885680;Taip;0;4;0;4
10757;Šnekutis;DRUGELIŲ;4743885834;Taip;0;22;0;22
10758;Šnekutis;DRUGELIŲ;18354631454;Taip;8;0;2;10
10759;Šnekutis;DRUGELIŲ;5029631107;Taip;0;1;0;1
10760;Šnekutis;DRUGELIŲ;4104052524;Taip;0;10;0;10
10761;Šnekutis;DRUGELIŲ;46282997811;Taip;0;12;8;20
10762;Šnekutis;DRUGELIŲ;1867756701;Ne;0;0;1;1
10763;Šnekutis;DRUGELIŲ;2102893949;Taip;5;0;1;6
10764;Šnekutis;DRUGELIŲ;1480772531;Taip;8;7;0;15
10765;Šnekutis;Kačiukų;1156210876;Taip;0;0;3;3
10766;Šnekutis;Kačiukų;1233059816;Taip;0;2;0;2
10767;Šnekutis;Kačiukų;50433076829;Taip;0;0;5;5
10768;Šnekutis;Kačiukų;1179210615;Taip;0;3;0;3
10769;Šnekutis;Kačiukų;1023572132;Taip;0;7;0;7
10770;Šnekutis;Kačiukų;10114111509;Taip;0;6;0;6
10771;Šnekutis;Kačiukų;13211267463;Taip;0;0;10;10
10772;Šnekutis;Kačiukų;1430904579;Taip;0;0;10;10
10773;Šnekutis;Kačiukų;1430790285;Taip;4;0;6;10
10774;Šnekutis;Kačiukų;2027114365;Taip;6;0;0;6
10775;Šnekutis;Kačiukų;41323355319;Taip;9;0;0;9
10776;Šnekutis;Kačiukų;21847996888;Taip;0;1;0;1
10777;Šnekutis;Kačiukų;2026314698;Taip;6;0;1;7
10778;Šnekutis;Kačiukų;1498045991;Taip;0;3;0;3
10779;Šnekutis;Kačiukų;57220861535;Taip;8;0;0;8
10780;Šnekutis;Kačiukų;93604802567;Taip;6;0;0;6
10781;Šnekutis;Kačiukų;88609559814;Taip;0;7;0;7
10782;Šnekutis;Kačiukų;5052576808;Taip;10;0;3;13
10783;Šnekutis;Kačiukų;11446344891;Taip;3;1;0;4
10784;Šnekutis;Kačiukų;81675602998;Taip;0;7;0;7
10785;Šnekutis;Pėlėdžiukų;5188035949;Taip;0;10;0;10
10786;Šnekutis;Pėlėdžiukų;4334155280;Taip;0;0;3;3
10787;Šnekutis;Pėlėdžiukų;77534335117;Taip;15;0;5;20
10788;Šnekutis;Pėlėdžiukų;3312928478;Taip;5;0;3;8
10789;Šnekutis;Pėlėdžiukų;42697936562;Taip;0;0;2;2
10790;Šnekutis;Pėlėdžiukų;7507857415;Taip;3;0;2;5
10791;Šnekutis;Pėlėdžiukų;8866360301;Taip;0;3;0;3
10792;Šnekutis;Pėlėdžiukų;8745465796;Taip;0;22;0;22
10793;Šnekutis;Pėlėdžiukų;3170928052;Taip;3;9;0;12
10794;Šnekutis;Pėlėdžiukų;5321817615;Taip;0;4;0;4
10795;Šnekutis;Pėlėdžiukų;2233161242;Taip;2;0;0;2
10796;Šnekutis;Pėlėdžiukų;5117544317;Taip;3;0;0;3
10797;Šnekutis;Pėlėdžiukų;1835450318;Ne;0;1;0;1
10798;Šnekutis;Pėlėdžiukų;6754580614;Ne;0;1;0;1
10799;Šnekutis;Pėlėdžiukų;1507200600;Taip;0;0;1;1
10800;Šnekutis;Pėlėdžiukų;5615869149;Ne;6;4;0;10
10801;Šnekutis;Pėlėdžiukų;1329958641;Taip;0;0;1;1
10802;Šnekutis;Pėlėdžiukų;5457906245;Taip;10;11;0;21
10803;Šnekutis;Pėlėdžiukų;9511116249;Taip;5;0;1;6
10804;Šnekutis;Pėlėdžiukų;1369660223;Taip;0;0;2;2
10805;Šnekutis;Pėlėdžiukų;1682748852;Taip;6;1;0;7
10806;Šnekutis;Pėlėdžiukų;1447824885;Taip;0;1;0;1
10807;Šnekutis;Boružėlių;4557629310;Taip;10;5;0;15
10808;Šnekutis;Boružėlių;5711964409;Taip;13;0;3;16
10809;Šnekutis;Boružėlių;37382772659;Taip;0;3;1;4
10810;Šnekutis;Boružėlių;84241751923;Taip;0;2;0;2
10811;Šnekutis;Boružėlių;79174984189;Taip;0;10;0;10
10812;Šnekutis;Boružėlių;1249451765;Taip;0;9;0;9
10813;Šnekutis;Boružėlių;1936021189;Taip;0;0;1;1
10814;Šnekutis;Boružėlių;1031911012;Taip;4;0;0;4
10815;Šnekutis;Boružėlių;1985052072;Taip;0;10;0;10
10816;Šnekutis;Boružėlių;1451503127;Taip;22;0;0;22
10817;Šnekutis;Boružėlių;1738802158;Taip;0;15;0;15
10818;Šnekutis;Boružėlių;1744313172;Taip;0;0;1;1
10819;Šnekutis;Boružėlių;1620268693;Taip;9;0;0;9
10820;Šnekutis;Boružėlių;22757448235;Ne;0;8;0;8
10821;Šnekutis;Boružėlių;2259206809;Taip;0;0;2;2
10822;Šnekutis;Boružėlių;54532738133;Taip;18;0;0;18
10823;Šnekutis;Boružėlių;5973303255;Taip;0;0;12;12
10824;Šnekutis;Boružėlių;27150074287;Taip;0;0;1;1
10825;Šnekutis;Boružėlių;1622660874;Taip;0;5;0;5
10826;Šnekutis;Boružėlių;6828079735;Taip;2;1;1;4
10827;Šnekutis;Meškučių;4835202527;Taip;16;2;0;18
10828;Šnekutis;Meškučių;5052137859;Taip;8;0;0;8
10829;Šnekutis;Meškučių;2822538227;Taip;10;0;0;10
10830;Šnekutis;Meškučių;5597629090;Taip;4;0;0;4
10831;Šnekutis;Meškučių;8531521901;Ne;0;0;15;15
10832;Šnekutis;Meškučių;9670205249;Taip;7;0;1;8
10833;Šnekutis;Meškučių;6684395256;Taip;7;0;0;7
10834;Šnekutis;Meškučių;3271262071;Taip;0;0;2;2
10835;Šnekutis;Meškučių;8440160819;Taip;22;0;0;22
10836;Šnekutis;Meškučių;9862362744;Taip;9;0;0;9
10837;Šnekutis;Meškučių;9780684867;Taip;0;0;5;5
10838;Šnekutis;Meškučių;7615716438;Taip;3;0;2;5
10839;Šnekutis;Meškučių;7622868249;Taip;22;0;0;22
10840;Šnekutis;Meškučių;5970951526;Taip;0;5;0;5
10841;Šnekutis;Meškučių;3336605264;Taip;9;6;0;15
10842;Šnekutis;Viščiukų;7434438142;Ne;0;7;0;7
10843;Šnekutis;Viščiukų;9312935803;Taip;0;0;7;7
10844;Šnekutis;Viščiukų;9157136735;Taip;9;0;0;9
10845;Šnekutis;Viščiukų;7089000987;Taip;5;0;0;5
10846;Šnekutis;Viščiukų;3166309530;Taip;0;0;1;1
10847;Šnekutis;Viščiukų;5049964996;Taip;0;2;0;2
10848;Šnekutis;Viščiukų;4143844589;Taip;16;0;0;16
10849;Šnekutis;Viščiukų;3644413861;Taip;0;4;0;4
10850;Šnekutis;Viščiukų;7638626055;Taip;7;0;0;7
10851;Šnekutis;Viščiukų;4992188525;Ne;19;0;0;19
10852;Šnekutis;Viščiukų;7236658561;Ne;0;5;0;5
10853;Šnekutis;Viščiukų;4405567649;Taip;2;11;0;13
10854;Šnekutis;Viščiukų;6578568418;Taip;0;0;2;2
10855;Šnekutis;Viščiukų;9790803767;Taip;10;0;0;10
10856;Užupiukas;VYTURĖLIŲ;61670878339;Taip;0;1;3;4
10857;Užupiukas;VYTURĖLIŲ;78184067796;Taip;5;1;0;6
10858;Užupiukas;VYTURĖLIŲ;31338755810;Taip;0;4;0;4
10859;Užupiukas;VYTURĖLIŲ;33629222941;Taip;0;3;0;3
10860;Užupiukas;VYTURĖLIŲ;85492444123;Taip;0;1;0;1
10861;Užupiukas;VYTURĖLIŲ;266671806;Taip;0;1;0;1
10862;Užupiukas;VYTURĖLIŲ;39058613355;Taip;4;1;0;5
10863;Užupiukas;VYTURĖLIŲ;23371854830;Taip;5;0;0;5
10864;Užupiukas;VYTURĖLIŲ;75976703580;Taip;3;0;0;3
10865;Užupiukas;VYTURĖLIŲ;39079421361;Taip;0;0;8;8
10866;Užupiukas;VYTURĖLIŲ;12401560384;Ne;10;0;0;10
10867;Užupiukas;VYTURĖLIŲ;44770930654;Taip;0;0;2;2
10868;Užupiukas;VYTURĖLIŲ;7060019183;Ne;0;3;0;3
10869;Užupiukas;KAČIUKŲ;61560152825;Taip;0;7;0;7
10870;Užupiukas;KAČIUKŲ;12905151141;Taip;0;0;1;1
10871;Užupiukas;KAČIUKŲ;42027395287;Taip;0;0;1;1
10872;Užupiukas;KAČIUKŲ;31618737243;Taip;0;6;0;6
10873;Užupiukas;KAČIUKŲ;42772205412;Taip;12;0;1;13
10874;Užupiukas;KAČIUKŲ;7659981079;Taip;0;7;0;7
10875;Užupiukas;KAČIUKŲ;22839159539;Ne;0;0;1;1
10876;Užupiukas;KAČIUKŲ;32651983670;Taip;9;2;0;11
10877;Užupiukas;KAČIUKŲ;27226172373;Taip;0;5;1;6
10878;Užupiukas;KAČIUKŲ;1700750771;Taip;0;7;0;7
10879;Užupiukas;KAČIUKŲ;31668159620;Ne;0;0;1;1
10880;Užupiukas;DRUGELIŲ;5406866873;Taip;0;0;10;10
10881;Užupiukas;DRUGELIŲ;1772019951;Taip;4;0;1;5
10882;Užupiukas;DRUGELIŲ;9655636851;Taip;8;0;2;10
10883;Užupiukas;DRUGELIŲ;1662564735;Taip;18;0;0;18
10884;Užupiukas;DRUGELIŲ;9863097416;Taip;13;0;0;13
10885;Užupiukas;DRUGELIŲ;7298322865;Taip;22;0;0;22
10886;Užupiukas;DRUGELIŲ;7056737587;Taip;0;0;19;19
10887;Užupiukas;DRUGELIŲ;8734960045;Taip;12;0;0;12
10888;Užupiukas;DRUGELIŲ;8724566014;Taip;4;0;3;7
10889;Užupiukas;DRUGELIŲ;14139543365;Ne;0;0;3;3
10890;Užupiukas;DRUGELIŲ;1554333137;Taip;12;0;0;12
10891;Užupiukas;DRUGELIŲ;3298267311;Taip;7;2;0;9
10892;Užupiukas;DRUGELIŲ;8341598147;Taip;13;0;3;16
10893;Užupiukas;DRUGELIŲ;9782972949;Taip;5;0;1;6
10894;Užupiukas;DRUGELIŲ;3579499796;Taip;9;0;0;9
10895;Užupiukas;DRUGELIŲ;7140606152;Taip;0;0;5;5
10896;Užupiukas;DRUGELIŲ;2348243399;Taip;15;7;0;22
10897;Užupiukas;DRUGELIŲ;8870229834;Taip;9;0;0;9
10898;Užupiukas;DRUGELIŲ;1679324943;Taip;0;7;0;7
10899;Užupiukas;DRUGELIŲ;9617597828;Taip;2;0;0;2
10900;Užupiukas;DRUGELIŲ;9096157655;Ne;0;0;1;1
10901;Užupiukas;EŽIUKŲ;73657553075;Taip;10;0;1;11
10902;Užupiukas;EŽIUKŲ;1159892685;Taip;15;0;1;16
10903;Užupiukas;EŽIUKŲ;79908666651;Taip;0;0;9;9
10904;Užupiukas;EŽIUKŲ;95981297986;Taip;12;0;5;17
10905;Užupiukas;EŽIUKŲ;27438104059;Taip;3;0;0;3
10906;Užupiukas;EŽIUKŲ;94857555708;Taip;17;0;1;18
10907;Užupiukas;EŽIUKŲ;12023740118;Taip;5;0;1;6
10908;Užupiukas;EŽIUKŲ;98209952363;Taip;5;0;0;5
10909;Užupiukas;EŽIUKŲ;6442996343;Taip;14;0;3;17
10910;Užupiukas;EŽIUKŲ;9843068906;Taip;13;0;2;15
10911;Užupiukas;EŽIUKŲ;17473949362;Taip;12;7;0;19
10912;Užupiukas;EŽIUKŲ;1593878778;Taip;22;0;0;22
10913;Užupiukas;EŽIUKŲ;1535952427;Taip;18;0;0;18
10914;Užupiukas;EŽIUKŲ;1102150432;Taip;0;0;4;4
10915;Užupiukas;EŽIUKŲ;3785893846;Taip;4;0;1;5
10916;Užupiukas;EŽIUKŲ;1338561168;Taip;10;0;10;20
10917;Užupiukas;EŽIUKŲ;1891595719;Ne;0;0;9;9
10918;Užupiukas;EŽIUKŲ;2419842168;Ne;0;0;13;13
10919;Užupiukas;EŽIUKŲ;30379165882;Taip;0;0;1;1
10920;Užupiukas;EŽIUKŲ;7616817709;Taip;8;0;0;8
10921;Užupiukas;EŽIUKŲ;1850295450;Taip;0;0;4;4
10922;Užupiukas;EŽIUKŲ;2924954048;Taip;4;0;1;5
10923;Užupiukas;BORUŽĖLIŲ;6828175620;Taip;7;0;1;8
10924;Užupiukas;BORUŽĖLIŲ;9791681813;Taip;8;0;1;9
10925;Užupiukas;BORUŽĖLIŲ;1503714343;Taip;5;0;2;7
10926;Užupiukas;BORUŽĖLIŲ;8313812681;Taip;0;0;9;9
10927;Užupiukas;BORUŽĖLIŲ;9906475253;Taip;0;0;18;18
10928;Užupiukas;BORUŽĖLIŲ;9677572224;Taip;8;1;0;9
10929;Užupiukas;BORUŽĖLIŲ;2445335267;Taip;11;0;0;11
10930;Užupiukas;BORUŽĖLIŲ;1582921323;Taip;0;0;1;1
10931;Užupiukas;BORUŽĖLIŲ;6526550727;Ne;11;0;0;11
10932;Užupiukas;BORUŽĖLIŲ;9735462228;Taip;7;0;0;7
10933;Užupiukas;BORUŽĖLIŲ;7555702944;Ne;0;0;2;2
10934;Užupiukas;BORUŽĖLIŲ;6073039842;Taip;9;0;1;10
10935;Užupiukas;BORUŽĖLIŲ;3038973312;Taip;0;1;0;1
10936;Užupiukas;BORUŽĖLIŲ;7861121290;Taip;0;5;0;5
10937;Užupiukas;SPINDULIUKŲ;51983057814;Taip;0;0;3;3
10938;Užupiukas;SPINDULIUKŲ;86921401020;Taip;0;0;1;1
10939;Užupiukas;SPINDULIUKŲ;90438855641;Taip;0;0;4;4
10940;Užupiukas;SPINDULIUKŲ;65677644430;Taip;1;0;0;1
10941;Užupiukas;SPINDULIUKŲ;84336476482;Taip;0;0;1;1
10942;Užupiukas;SPINDULIUKŲ;80007333669;Taip;3;3;2;8
10943;Užupiukas;SPINDULIUKŲ;15724999714;Taip;0;0;3;3
10944;Užupiukas;SPINDULIUKŲ;26339684743;Taip;3;0;6;9
10945;Užupiukas;SPINDULIUKŲ;9827529278;Taip;0;0;1;1
10946;Užupiukas;SPINDULIUKŲ;84075926264;Taip;6;0;0;6
10947;Užupiukas;SPINDULIUKŲ;87149966445;Taip;2;4;0;6
10948;Užupiukas;SPINDULIUKŲ;26118376709;Taip;0;0;1;1
10949;Užupiukas;SPINDULIUKŲ;34512830427;Taip;0;0;3;3
10950;Užupiukas;SPINDULIUKŲ;33716467388;Taip;0;10;0;10
10951;Užupiukas;SPINDULIUKŲ;59095867565;Taip;14;0;0;14
10952;Užupiukas;SPINDULIUKŲ;54802123672;Taip;6;0;7;13
10953;Užupiukas;SPINDULIUKŲ;3087557445;Taip;14;0;6;20
10954;Užupiukas;ŽVIRBLIUKŲ;66976483535;Taip;3;0;3;6
10955;Užupiukas;ŽVIRBLIUKŲ;74109296784;Taip;0;0;1;1
10956;Užupiukas;ŽVIRBLIUKŲ;30079394090;Taip;0;0;1;1
10957;Užupiukas;ŽVIRBLIUKŲ;41589248540;Taip;0;0;1;1
10958;Užupiukas;ŽVIRBLIUKŲ;6945412270;Taip;13;0;4;17
10959;Užupiukas;ŽVIRBLIUKŲ;29120240155;Taip;0;0;8;8
10960;Užupiukas;ŽVIRBLIUKŲ;77360572295;Taip;0;0;1;1
10961;Užupiukas;ŽVIRBLIUKŲ;12930564771;Taip;0;0;6;6
10962;Užupiukas;ŽVIRBLIUKŲ;39154080649;Taip;0;11;0;11
10963;Užupiukas;ŽVIRBLIUKŲ;66563646874;Taip;7;0;3;10
10964;Užupiukas;ŽVIRBLIUKŲ;53620240721;Taip;0;0;1;1
10965;Užupiukas;ŽVIRBLIUKŲ;54388164264;Taip;0;0;3;3
10966;Užupiukas;ŽVIRBLIUKŲ;77859943014;Taip;0;8;0;8
10967;Užupiukas;ŽVIRBLIUKŲ;78093835821;Taip;0;0;6;6
10968;Užupiukas;ŽVIRBLIUKŲ;9621834194;Taip;0;0;2;2
10969;Užupiukas;ŽVIRBLIUKŲ;2261114370;Ne;0;0;2;2
10970;Užupiukas;ŽVIRBLIUKŲ;55851979501;Ne;7;0;2;9
10971;Užupiukas;ŽVIRBLIUKŲ;50633300666;Taip;1;1;0;2
10972;Užupiukas;ŽVIRBLIUKŲ;81516820215;Taip;0;4;0;4
10973;Užupiukas;ŽVIRBLIUKŲ;80569399641;Taip;0;0;2;2
10974;Užupiukas;ŽVIRBLIUKŲ;65914465707;Ne;0;0;1;1
10975;Užupiukas;ŽVIRBLIUKŲ;11261333632;Taip;0;0;8;8
10976;Užupiukas;ŽVIRBLIUKŲ;4310051789;Taip;0;6;0;6
10977;Užupiukas;PELĖDŽIUKŲ;94936980824;Taip;0;0;6;6
10978;Užupiukas;PELĖDŽIUKŲ;51703520898;Taip;7;0;0;7
10979;Užupiukas;PELĖDŽIUKŲ;4147741857;Taip;4;1;0;5
10980;Užupiukas;PELĖDŽIUKŲ;40697997174;Taip;5;1;1;7
10981;Užupiukas;PELĖDŽIUKŲ;6447998472;Taip;0;0;7;7
10982;Užupiukas;PELĖDŽIUKŲ;79539936850;Taip;0;0;10;10
10983;Užupiukas;PELĖDŽIUKŲ;91266096205;Taip;0;0;1;1
10984;Užupiukas;PELĖDŽIUKŲ;61722030522;Taip;0;0;8;8
10985;Užupiukas;PELĖDŽIUKŲ;25194791061;Taip;0;0;5;5
10986;Užupiukas;PELĖDŽIUKŲ;55760273994;Taip;0;0;1;1
10987;Užupiukas;PELĖDŽIUKŲ;91904601102;Taip;2;0;0;2
10988;Užupiukas;PELĖDŽIUKŲ;29122831474;Taip;7;0;0;7
10989;Užupiukas;PELĖDŽIUKŲ;91632804337;Taip;0;0;5;5
10990;Užupiukas;PELĖDŽIUKŲ;97373228204;Taip;9;0;0;9
10991;Užupiukas;PELĖDŽIUKŲ;43231263535;Taip;1;0;2;3
10992;Užupiukas;PELĖDŽIUKŲ;38236870957;Taip;0;0;4;4
10993;Užupiukas;PELĖDŽIUKŲ;70640896909;Taip;4;0;4;8
10994;Užupiukas;PELĖDŽIUKŲ;47039147715;Taip;0;0;1;1
10995;Užupiukas;PELĖDŽIUKŲ;41047619045;Ne;0;0;8;8
10996;Užupiukas;PELĖDŽIUKŲ;8865442531;Taip;0;0;1;1
10997;Užupiukas;PELĖDŽIUKŲ;22644512133;Taip;4;0;0;4
10998;Užupiukas;VARPELIŲ;23723147269;Taip;8;5;0;13
10999;Užupiukas;VARPELIŲ;7874627355;Ne;0;15;3;18
11000;Užupiukas;VARPELIŲ;51243697666;Taip;0;0;5;5
11001;Užupiukas;VARPELIŲ;81986379983;Taip;8;0;0;8
11002;Užupiukas;VARPELIŲ;17651645880;Taip;9;3;0;12
11003;Užupiukas;VARPELIŲ;50797530294;Taip;0;0;7;7
11004;Užupiukas;VARPELIŲ;98428714407;Taip;0;0;2;2
11005;Užupiukas;VARPELIŲ;57439594934;Taip;0;0;1;1
11006;Užupiukas;VARPELIŲ;2137620968;Taip;0;0;3;3
11007;Užupiukas;VARPELIŲ;1103878937;Taip;4;0;0;4
11008;Užupiukas;VARPELIŲ;5079596604;Taip;4;0;4;8
11009;Užupiukas;VARPELIŲ;1294561841;Taip;0;0;4;4
11010;Užupiukas;VARPELIŲ;2031306814;Ne;1;0;0;1
11011;Užupiukas;VARPELIŲ;82632886488;Taip;0;0;6;6
11012;Užupiukas;VARPELIŲ;77950386276;Taip;0;0;16;16
11013;Užupiukas;VARPELIŲ;79092366287;Taip;0;0;1;1
11014;Užupiukas;VARPELIŲ;6188599930;Taip;15;0;3;18
11015;Užupiukas;VARPELIŲ;8358242714;Taip;3;0;3;6
11016;Užupiukas;SAULUČIŲ;55683021710;Taip;0;0;1;1
11017;Užupiukas;SAULUČIŲ;64774033504;Taip;11;0;0;11
11018;Užupiukas;SAULUČIŲ;52047323776;Taip;0;0;13;13
11019;Užupiukas;SAULUČIŲ;25118968273;Taip;0;0;2;2
11020;Užupiukas;SAULUČIŲ;1307564992;Taip;0;0;5;5
11021;Užupiukas;SAULUČIŲ;2740412091;Taip;10;0;3;13
11022;Užupiukas;SAULUČIŲ;1577630991;Taip;0;5;7;12
11023;Užupiukas;SAULUČIŲ;1158250810;Taip;0;5;0;5
11024;Užupiukas;SAULUČIŲ;36820708170;Taip;8;0;4;12
11025;Užupiukas;SAULUČIŲ;52600923918;Taip;0;7;0;7
11026;Užupiukas;SAULUČIŲ;10522364665;Taip;0;0;1;1
11027;Užupiukas;SAULUČIŲ;87017671664;Taip;0;12;2;14
11028;Užupiukas;SAULUČIŲ;15815468617;Taip;0;0;4;4
11029;Užupiukas;SAULUČIŲ;73039119839;Taip;0;0;1;1
11030;Užupiukas;SAULUČIŲ;1592276956;Ne;13;0;4;17
11031;Užupiukas;SAULUČIŲ;6467238027;Taip;0;0;2;2
11032;Užupiukas;SAULUČIŲ;2499414724;Taip;0;0;3;3
11033;Užupiukas;LAPIUKŲ;79442829922;Taip;0;0;5;5
11034;Užupiukas;LAPIUKŲ;3309195572;Taip;1;0;3;4
11035;Užupiukas;LAPIUKŲ;7563497568;Taip;0;0;6;6
11036;Užupiukas;LAPIUKŲ;2821350355;Taip;5;0;5;10
11037;Užupiukas;LAPIUKŲ;5665323444;Taip;17;0;0;17
11038;Užupiukas;LAPIUKŲ;22401995674;Taip;2;5;0;7
11039;Užupiukas;LAPIUKŲ;3774364829;Taip;10;0;0;10
11040;Užupiukas;LAPIUKŲ;6236652118;Taip;0;9;1;10
11041;Užupiukas;LAPIUKŲ;4247280316;Taip;8;0;1;9
11042;Užupiukas;LAPIUKŲ;2938276316;Taip;0;0;3;3
11043;Užupiukas;LAPIUKŲ;6478702476;Taip;0;1;6;7
11044;Užupiukas;LAPIUKŲ;4132760111;Taip;0;2;0;2
11045;Užupiukas;LAPIUKŲ;53412835151;Taip;5;0;0;5
11046;Užupiukas;LAPIUKŲ;9197242545;Taip;11;7;0;18
11047;Užupiukas;LAPIUKŲ;3205769002;Ne;2;0;15;17
11048;Užupiukas;LAPIUKŲ;5498369850;Taip;3;0;2;5
11049;Užupiukas;LAPIUKŲ;4608233152;Taip;0;2;1;3
11050;Užupiukas;LAPIUKŲ;6110869303;Taip;2;5;0;7
11051;Užupiukas;LAPIUKŲ;1739403100;Taip;0;0;17;17
11052;Užupiukas;LAPIUKŲ;3231001225;Taip;0;0;10;10
11053;Užupiukas;NYKŠTUKŲ;4710910251;Taip;0;0;7;7
11054;Užupiukas;NYKŠTUKŲ;1718518621;Taip;0;0;1;1
11055;Užupiukas;NYKŠTUKŲ;9991552624;Taip;0;0;1;1
11056;Užupiukas;NYKŠTUKŲ;3048959458;Taip;10;0;9;19
11057;Užupiukas;NYKŠTUKŲ;1651249962;Taip;0;0;2;2
11058;Užupiukas;NYKŠTUKŲ;2390955083;Taip;6;0;1;7
11059;Užupiukas;NYKŠTUKŲ;1809036046;Taip;0;0;4;4
11060;Užupiukas;NYKŠTUKŲ;1100574872;Taip;8;2;0;10
11061;Užupiukas;NYKŠTUKŲ;3861173268;Taip;5;0;2;7
11062;Užupiukas;NYKŠTUKŲ;5072363435;Taip;0;5;4;9
11063;Užupiukas;NYKŠTUKŲ;9446562736;Taip;0;5;4;9
11064;Užupiukas;NYKŠTUKŲ;5116564840;Taip;0;0;3;3
11065;Užupiukas;NYKŠTUKŲ;6119222293;Ne;12;2;0;14
11066;Užupiukas;NYKŠTUKŲ;2724216446;Taip;1;0;0;1
11067;Užupiukas;NYKŠTUKŲ;1684901495;Taip;12;2;0;14
11068;Vandenis;ŽUVĖDRŲ;52063106839;Taip;0;3;0;3
11069;Vandenis;ŽUVĖDRŲ;72923438583;Taip;7;1;0;8
11070;Vandenis;ŽUVĖDRŲ;96459201904;Taip;5;15;0;20
11071;Vandenis;ŽUVĖDRŲ;49204161380;Taip;0;2;0;2
11072;Vandenis;ŽUVĖDRŲ;67472126318;Taip;0;3;0;3
11073;Vandenis;ŽUVĖDRŲ;80186166441;Taip;0;8;0;8
11074;Vandenis;ŽUVĖDRŲ;85287618619;Taip;0;19;0;19
11075;Vandenis;ŽUVĖDRŲ;3639803910;Taip;0;2;0;2
11076;Vandenis;ŽUVĖDRŲ;35581230147;Ne;0;2;0;2
11077;Vandenis;ŽUVĖDRŲ;22764351701;Taip;0;2;0;2
11078;Vandenis;ŽUVĖDRŲ;58324898715;Taip;0;1;0;1
11079;Vandenis;ŽUVĖDRŲ;56648967396;Taip;0;2;0;2
11080;Vandenis;ŽUVĖDRŲ;87398241763;Taip;10;0;0;10
11081;Vandenis;ŽUVĖDRŲ;48908599635;Taip;0;4;0;4
11082;Vandenis;RUONIUKŲ;2422642232;Taip;5;0;4;9
11083;Vandenis;RUONIUKŲ;1051281257;Taip;5;0;4;9
11084;Vandenis;RUONIUKŲ;7565308536;Taip;0;1;0;1
11085;Vandenis;RUONIUKŲ;9518434896;Taip;6;3;0;9
11086;Vandenis;RUONIUKŲ;2638433939;Ne;6;0;1;7
11087;Vandenis;RUONIUKŲ;1120907086;Taip;0;0;3;3
11088;Vandenis;RUONIUKŲ;6476051751;Taip;0;2;0;2
11089;Vandenis;RUONIUKŲ;9162936403;Taip;0;1;1;2
11090;Vandenis;RUONIUKŲ;4713395766;Taip;0;1;0;1
11091;Vandenis;RUONIUKŲ;7754158588;Taip;0;0;2;2
11092;Vandenis;RUONIUKŲ;9527253920;Taip;5;2;2;9
11093;Vandenis;RUONIUKŲ;8971291182;Taip;3;12;1;16
11094;Vandenis;ŽUVYČIŲ;1381872682;Taip;0;0;12;12
11095;Vandenis;ŽUVYČIŲ;46710726661;Taip;0;7;0;7
11096;Vandenis;ŽUVYČIŲ;36923046515;Taip;0;1;0;1
11097;Vandenis;ŽUVYČIŲ;62551219837;Taip;0;2;0;2
11098;Vandenis;ŽUVYČIŲ;18019716512;Taip;0;2;4;6
11099;Vandenis;ŽUVYČIŲ;8894986967;Taip;0;1;0;1
11100;Vandenis;ŽUVYČIŲ;11100629204;Taip;0;1;0;1
11101;Vandenis;ŽUVYČIŲ;50682359453;Taip;0;2;4;6
11102;Vandenis;ŽUVYČIŲ;25215508382;Taip;0;7;0;7
11103;Vandenis;ŽUVYČIŲ;93927825477;Taip;0;1;0;1
11104;Vandenis;ŽUVYČIŲ;32076192238;Taip;0;2;0;2
11105;Vandenis;ŽUVYČIŲ;42672846405;Taip;0;1;0;1
11106;Vandenis;ŽUVYČIŲ;48268115297;Taip;0;2;0;2
11107;Vandenis;ŽUVYČIŲ;57050923237;Taip;0;7;0;7
11108;Vandenis;ŽUVYČIŲ;32078254928;Taip;0;1;0;1
11109;Vandenis;PERLIUKŲ;28286348996;Taip;0;2;1;3
11110;Vandenis;PERLIUKŲ;2494327284;Taip;0;0;1;1
11111;Vandenis;PERLIUKŲ;20458211098;Taip;0;6;0;6
11112;Vandenis;PERLIUKŲ;47333381244;Taip;5;5;0;10
11113;Vandenis;PERLIUKŲ;95498596116;Taip;5;2;0;7
11114;Vandenis;PERLIUKŲ;39662768043;Taip;5;5;1;11
11115;Vandenis;PERLIUKŲ;391453841;Taip;1;3;0;4
11116;Vandenis;PERLIUKŲ;32087433270;Taip;5;2;2;9
11117;Vandenis;PERLIUKŲ;50009330411;Taip;0;1;0;1
11118;Vandenis;PERLIUKŲ;57251416305;Taip;5;1;0;6
11119;Vandenis;PERLIUKŲ;54659569326;Taip;5;1;0;6
11120;Vandenis;PERLIUKŲ;69485657846;Taip;0;1;0;1
11121;Vandenis;PERLIUKŲ;45362889638;Ne;4;1;0;5
11122;Vandenis;PERLIUKŲ;33177236893;Taip;0;1;0;1
11123;Vandenis;PERLIUKŲ;23752943243;Taip;0;2;0;2
11124;Vandenis;PERLIUKŲ;35977990277;Ne;22;0;0;22
11125;Vandenis;PERLIUKŲ;66499269949;Taip;0;1;0;1
11126;Vandenis;PERLIUKŲ;59487083886;Taip;0;1;0;1
11127;Vandenis;PERLIUKŲ;51472939588;Taip;0;2;5;7
11128;Vandenis;PERLIUKŲ;83480564066;Taip;0;2;3;5
11129;Vandenis;PERLIUKŲ;1493719754;Taip;10;2;1;13
11130;Vandenis;ANČIUKŲ;8233407105;Taip;0;2;4;6
11131;Vandenis;ANČIUKŲ;1282499654;Taip;0;2;0;2
11132;Vandenis;ANČIUKŲ;3243079651;Taip;0;10;0;10
11133;Vandenis;ANČIUKŲ;8251169901;Ne;10;5;0;15
11134;Vandenis;ANČIUKŲ;4750141780;Taip;0;5;0;5
11135;Vandenis;ANČIUKŲ;6181866272;Taip;8;1;0;9
11136;Vandenis;ANČIUKŲ;7522472652;Taip;0;1;0;1
11137;Vandenis;ANČIUKŲ;7630017843;Taip;0;1;0;1
11138;Vandenis;ANČIUKŲ;1222539247;Taip;7;0;0;7
11139;Vandenis;ANČIUKŲ;3067868099;Taip;0;4;0;4
11140;Vandenis;ANČIUKŲ;8511948282;Ne;10;1;0;11
11141;Vandenis;ANČIUKŲ;33317650043;Taip;5;2;0;7
11142;Vandenis;ANČIUKŲ;1739780612;Taip;6;0;0;6
11143;Vandenis;ANČIUKŲ;2489776665;Taip;5;0;2;7
11144;Vandenis;ANČIUKŲ;71786730314;Taip;9;1;0;10
11145;Vandenis;ANČIUKŲ;1621481561;Taip;16;0;0;16
11146;Vandenis;ANČIUKŲ;33782837791;Taip;0;7;0;7
11147;Vandenis;VĖŽLIUKŲ;39832993343;Taip;0;5;0;5
11148;Vandenis;VĖŽLIUKŲ;7801129545;Taip;0;6;0;6
11149;Vandenis;VĖŽLIUKŲ;88097898349;Taip;0;1;0;1
11150;Vandenis;VĖŽLIUKŲ;20843785079;Taip;0;6;0;6
11151;Vandenis;VĖŽLIUKŲ;16402149104;Taip;0;3;0;3
11152;Vandenis;VĖŽLIUKŲ;17644420312;Taip;0;1;0;1
11153;Vandenis;VĖŽLIUKŲ;26057060619;Taip;0;1;0;1
11154;Vandenis;VĖŽLIUKŲ;55331810310;Taip;0;5;8;13
11155;Vandenis;VĖŽLIUKŲ;48194812760;Taip;9;0;0;9
11156;Vandenis;VĖŽLIUKŲ;84025519453;Taip;0;1;0;1
11157;Vandenis;VĖŽLIUKŲ;5363853315;Taip;0;2;7;9
11158;Vandenis;VĖŽLIUKŲ;85054617489;Taip;3;8;1;12
11159;Vandenis;VĖŽLIUKŲ;61521559336;Taip;0;10;0;10
11160;Vandenis;VĖŽLIUKŲ;63629799884;Taip;10;2;0;12
11161;Vandenis;VĖŽLIUKŲ;8447593747;Taip;2;2;0;4
11162;Vandenis;VĖŽLIUKŲ;1646554203;Taip;0;0;4;4
11163;Vandenis;VĖŽLIUKŲ;2056980868;Ne;6;0;1;7
11164;Vandenis;VĖŽLIUKŲ;92286914041;Taip;0;2;1;3
11165;Vandenis;AŠTUNKOJŲ;56729656278;Taip;0;1;0;1
11166;Vandenis;AŠTUNKOJŲ;39139875955;Taip;0;2;0;2
11167;Vandenis;AŠTUNKOJŲ;57302718152;Taip;10;0;0;10
11168;Vandenis;AŠTUNKOJŲ;6799539977;Taip;0;1;0;1
11169;Vandenis;AŠTUNKOJŲ;69980435432;Taip;0;2;0;2
11170;Vandenis;AŠTUNKOJŲ;83350314727;Ne;2;0;0;2
11171;Vandenis;AŠTUNKOJŲ;91232893198;Ne;3;3;0;6
11172;Vandenis;AŠTUNKOJŲ;56253560020;Taip;0;4;0;4
11173;Vandenis;AŠTUNKOJŲ;2576662589;Taip;0;1;0;1
11174;Vandenis;AŠTUNKOJŲ;40001674016;Ne;7;0;0;7
11175;Vandenis;AŠTUNKOJŲ;66990746959;Ne;0;5;0;5
11176;Vandenis;AŠTUNKOJŲ;93109763820;Taip;0;2;0;2
11177;Vandenis;AŠTUNKOJŲ;10706508637;Taip;0;1;0;1
11178;Vandenis;AŠTUNKOJŲ;42690205977;Taip;5;2;0;7
11179;Vandenis;AŠTUNKOJŲ;37019206511;Taip;0;3;0;3
11180;Vandenis;AŠTUNKOJŲ;88415992702;Taip;4;1;0;5
11181;Vandenis;AŠTUNKOJŲ;11953155563;Ne;0;3;0;3
11182;Vandenis;GANDRIUKŲ;1455424753;Taip;0;10;0;10
11183;Vandenis;GANDRIUKŲ;6048257249;Taip;0;5;0;5
11184;Vandenis;GANDRIUKŲ;1029909269;Ne;0;0;5;5
11185;Vandenis;GANDRIUKŲ;11961797041;Taip;0;2;0;2
11186;Vandenis;GANDRIUKŲ;80422278900;Taip;0;2;0;2
11187;Vandenis;GANDRIUKŲ;33029527496;Taip;0;11;0;11
11188;Vandenis;GANDRIUKŲ;4633003964;Taip;0;0;5;5
11189;Vandenis;GANDRIUKŲ;9999045766;Taip;0;2;0;2
11190;Vandenis;GANDRIUKŲ;54770618599;Taip;0;5;0;5
11191;Vandenis;GANDRIUKŲ;10538645159;Ne;6;2;0;8
11192;Vandenis;GANDRIUKŲ;20957822945;Taip;0;11;0;11
11193;Vandenis;GANDRIUKŲ;47997751365;Taip;0;2;1;3
11194;Vandenis;GANDRIUKŲ;91684805923;Taip;0;0;6;6
11195;Vandenis;GANDRIUKŲ;48076017461;Taip;5;4;0;9
11196;Vandenis;ŽĄSIUKAI;2812520834;Taip;0;3;2;5
11197;Vandenis;ŽĄSIUKAI;1286716632;Taip;0;2;0;2
11198;Vandenis;ŽĄSIUKAI;11527007102;Taip;5;0;0;5
11199;Vandenis;ŽĄSIUKAI;1373653402;Taip;0;0;2;2
11200;Vandenis;ŽĄSIUKAI;65840410497;Ne;7;2;0;9
11201;Vandenis;ŽĄSIUKAI;53658866238;Taip;7;8;0;15
11202;Vandenis;ŽĄSIUKAI;1217508516;Taip;0;13;3;16
11203;Vandenis;ŽĄSIUKAI;55238344586;Taip;8;2;2;12
11204;Vandenis;ŽĄSIUKAI;23439586487;Taip;0;0;1;1
11205;Vandenis;ŽĄSIUKAI;1397125827;Taip;0;1;0;1
11206;Vandenis;ŽĄSIUKAI;1155423158;Taip;0;7;0;7
11207;Vandenis;PURIENŲ;877974909;Taip;4;0;0;4
11208;Vandenis;PURIENŲ;3823382249;Taip;8;0;0;8
11209;Vandenis;PURIENŲ;43295720034;Taip;2;0;0;2
11210;Vandenis;PURIENŲ;84636435681;Taip;6;0;0;6
11211;Vandenis;PURIENŲ;1958929302;Taip;4;1;0;5
11212;Vandenis;PURIENŲ;39973189502;Taip;0;2;1;3
11213;Vandenis;PURIENŲ;2096950367;Taip;0;6;0;6
11214;Vandenis;PURIENŲ;1633589144;Taip;0;1;0;1
11215;Vandenis;PURIENŲ;1854498462;Taip;0;5;0;5
11216;Vandenis;PURIENŲ;6673346389;Taip;5;1;0;6
11217;Vandenis;PURIENŲ;7168910452;Taip;5;2;0;7
11218;Vandenis;PURIENŲ;2073785910;Taip;1;0;0;1
11219;Vandenis;PURIENŲ;1245031666;Taip;0;1;0;1
11220;Vandenis;PURIENŲ;61120985165;Taip;0;1;0;1
11221;Vandenis;PURIENŲ;38137368394;Taip;6;2;0;8
11222;Vandenis;PURIENŲ;81817138188;Taip;0;1;0;1
11223;Vandenis;PURIENŲ;86947904365;Taip;2;0;0;2
11224;Vandenis;PURIENŲ;1395272045;Taip;3;7;0;10
11225;Vandenis;PURIENŲ;3740778932;Taip;10;1;0;11
11226;Vandenis;VARLIUKAI;5126732658;Taip;0;1;0;1
11227;Vandenis;VARLIUKAI;7091356848;Taip;0;5;0;5
11228;Vandenis;VARLIUKAI;8116532445;Taip;0;1;0;1
11229;Vandenis;VARLIUKAI;7069369080;Taip;0;1;0;1
11230;Vandenis;VARLIUKAI;7924399684;Taip;0;5;0;5
11231;Vandenis;VARLIUKAI;2872343656;Taip;0;6;0;6
11232;Vandenis;VARLIUKAI;6011280420;Taip;18;0;0;18
11233;Vandenis;VARLIUKAI;1187395353;Taip;0;6;0;6
11234;Vandenis;VARLIUKAI;1081385111;Taip;5;0;0;5
11235;Vandenis;VARLIUKAI;9158541919;Taip;0;1;0;1
11236;Vandenis;VARLIUKAI;5959181898;Taip;0;1;0;1
11237;Vandenis;VARLIUKAI;7059385610;Taip;10;1;0;11
11238;Vandenis;VARLIUKAI;2645775090;Taip;0;5;0;5
11239;Vandenis;PINGVINAI;9994373029;Taip;5;1;0;6
11240;Vandenis;PINGVINAI;4085256182;Taip;1;0;2;3
11241;Vandenis;PINGVINAI;1568158992;Taip;8;0;0;8
11242;Vandenis;PINGVINAI;18336904438;Taip;0;1;0;1
11243;Vandenis;PINGVINAI;8689134931;Taip;0;2;0;2
11244;Vandenis;PINGVINAI;9608871155;Taip;0;2;0;2
11245;Vandenis;PINGVINAI;64711327503;Taip;19;0;0;19
11246;Vandenis;PINGVINAI;7381695975;Taip;0;2;0;2
11247;Vandenis;PINGVINAI;43933878402;Taip;0;2;0;2
11248;Vandenis;PINGVINAI;71513217054;Taip;0;1;0;1
11249;Vandenis;PINGVINAI;55421695186;Taip;2;1;0;3
11250;Vandenis;PINGVINAI;24217366528;Taip;0;6;0;6
11251;Vandenis;PINGVINAI;5549292096;Taip;2;5;0;7
11252;Vandenis;PINGVINAI;7408758565;Taip;0;0;1;1
11253;Vandenis;PINGVINAI;4643267945;Taip;18;0;0;18
11254;Vandenis;PINGVINAI;8430706407;Taip;17;0;0;17
11255;Vandenis;PINGVINAI;1535450614;Taip;0;3;5;8
11256;Vandenis;PINGVINAI;35673258175;Taip;0;0;9;9
11257;Vandenis;PINGVINAI;27409922803;Taip;10;0;1;11
11258;Vėjelis;Pumpurėliai;58369004570;Taip;0;2;0;2
11259;Vėjelis;Pumpurėliai;54924516732;Taip;0;6;0;6
11260;Vėjelis;Pumpurėliai;59692503363;Taip;3;0;1;4
11261;Vėjelis;Pumpurėliai;25872613643;Taip;7;0;0;7
11262;Vėjelis;Pumpurėliai;38106696628;Taip;0;9;0;9
11263;Vėjelis;Pumpurėliai;8653964270;Taip;0;9;0;9
11264;Vėjelis;Pumpurėliai;88817521596;Taip;0;3;0;3
11265;Vėjelis;Pumpurėliai;53270546031;Taip;0;1;2;3
11266;Vėjelis;Pumpurėliai;16294883533;Taip;0;2;0;2
11267;Vėjelis;Pumpurėliai;53587810020;Ne;0;1;2;3
11268;Vėjelis;Pumpurėliai;18902976827;Taip;0;1;0;1
11269;Vėjelis;Pumpurėliai;58314846835;Taip;0;3;0;3
11270;Vėjelis;Pumpurėliai;63893850632;Taip;0;1;0;1
11271;Vėjelis;Pumpurėliai;23799231345;Taip;0;1;0;1
11272;Vėjelis;Pumpurėliai;95469370742;Taip;5;1;0;6
11273;Vėjelis;Pumpurėliai;14212441124;Taip;5;1;0;6
11274;Vėjelis;Pumpurėliai;53379180843;Taip;0;10;0;10
11275;Vėjelis;Pumpurėliai;17523450164;Taip;0;3;0;3
11276;Vėjelis;Pumpurėliai;5365237487;Taip;0;1;0;1
11277;Vėjelis;Pumpurėliai;3965445196;Taip;0;5;0;5
11278;Vėjelis;Pumpurėliai;2301011427;Taip;4;8;0;12
11279;Vėjelis;Drugeliai;4746932126;Taip;5;1;0;6
11280;Vėjelis;Drugeliai;1115802837;Taip;22;0;0;22
11281;Vėjelis;Drugeliai;2416832899;Taip;0;17;0;17
11282;Vėjelis;Drugeliai;3276062426;Taip;18;0;0;18
11283;Vėjelis;Drugeliai;9298789434;Taip;12;0;0;12
11284;Vėjelis;Drugeliai;2734024890;Taip;18;1;0;19
11285;Vėjelis;Drugeliai;7981032872;Taip;15;0;0;15
11286;Vėjelis;Drugeliai;7133454882;Taip;3;0;3;6
11287;Vėjelis;Drugeliai;2000277444;Taip;0;0;4;4
11288;Vėjelis;Drugeliai;7752923796;Taip;6;0;0;6
11289;Vėjelis;Drugeliai;7594586198;Taip;0;0;4;4
11290;Vėjelis;Drugeliai;7697394469;Taip;0;0;3;3
11291;Vėjelis;Drugeliai;4066956765;Taip;6;0;1;7
11292;Vėjelis;Drugeliai;9696910320;Taip;0;0;22;22
11293;Vėjelis;Malūnėlis;16498317981;Ne;0;2;0;2
11294;Vėjelis;Malūnėlis;93859592652;Ne;0;2;2;4
11295;Vėjelis;Malūnėlis;12149443904;Taip;5;4;0;9
11296;Vėjelis;Malūnėlis;76098853911;Ne;0;0;3;3
11297;Vėjelis;Malūnėlis;74207410750;Taip;0;10;0;10
11298;Vėjelis;Malūnėlis;69740475863;Ne;0;2;0;2
11299;Vėjelis;Malūnėlis;39671245978;Taip;13;2;0;15
11300;Vėjelis;Malūnėlis;58121447313;Taip;5;0;0;5
11301;Vėjelis;Malūnėlis;68958036563;Taip;0;2;0;2
11302;Vėjelis;Malūnėlis;20593684676;Taip;0;2;0;2
11303;Vėjelis;Malūnėlis;64104308245;Taip;0;0;1;1
11304;Vėjelis;Malūnėlis;14502736200;Taip;0;9;0;9
11305;Vėjelis;Malūnėlis;98024305748;Taip;0;2;0;2
11306;Vėjelis;Malūnėlis;5735207486;Taip;15;2;0;17
11307;Vėjelis;Malūnėlis;4194366404;Taip;2;2;0;4
11308;Vėjelis;Malūnėlis;1603377234;Ne;0;2;1;3
11309;Vėjelis;Malūnėlis;87555226002;Taip;0;3;3;6
11310;Vėjelis;Žvaigždutės;1295818672;Ne;14;0;0;14
11311;Vėjelis;Žvaigždutės;1612878387;Taip;0;0;5;5
11312;Vėjelis;Žvaigždutės;3485366651;Taip;0;11;0;11
11313;Vėjelis;Žvaigždutės;5139323880;Taip;12;0;0;12
11314;Vėjelis;Žvaigždutės;47986392996;Taip;0;0;1;1
11315;Vėjelis;Žvaigždutės;7610485310;Taip;15;3;0;18
11316;Vėjelis;Žvaigždutės;90647333398;Taip;0;9;0;9
11317;Vėjelis;Žvaigždutės;40744700561;Taip;0;15;0;15
11318;Vėjelis;Žvaigždutės;47143492836;Taip;10;9;0;19
11319;Vėjelis;Žvaigždutės;69341469387;Taip;2;10;0;12
11320;Vėjelis;Žvaigždutės;9190085358;Taip;0;18;0;18
11321;Vėjelis;Žvaigždutės;56520156825;Taip;8;14;0;22
11322;Vėjelis;Žvaigždutės;90103717718;Taip;0;4;0;4
11323;Vėjelis;Žvaigždutės;8949760376;Taip;0;0;22;22
11324;Vėjelis;Žvaigždutės;6002719498;Taip;9;13;0;22
11325;Vėjelis;Žvaigždutės;9000966115;Taip;0;3;0;3
11326;Vėjelis;Varpeliai;2759958482;Taip;6;0;1;7
11327;Vėjelis;Varpeliai;898039829;Taip;0;7;0;7
11328;Vėjelis;Varpeliai;58968869099;Taip;0;4;0;4
11329;Vėjelis;Varpeliai;25190615976;Ne;0;0;3;3
11330;Vėjelis;Varpeliai;28696711850;Taip;0;3;0;3
11331;Vėjelis;Varpeliai;47402024682;Taip;0;9;0;9
11332;Vėjelis;Varpeliai;8787363287;Taip;0;8;0;8
11333;Vėjelis;Varpeliai;83608030842;Ne;0;0;1;1
11334;Vėjelis;Varpeliai;71456994638;Taip;0;9;0;9
11335;Vėjelis;Varpeliai;14157070764;Taip;0;0;1;1
11336;Vėjelis;Varpeliai;90996312461;Taip;0;12;0;12
11337;Vėjelis;Varpeliai;86680640521;Taip;0;4;0;4
11338;Vėjelis;Varpeliai;1944266562;Taip;6;0;2;8
11339;Vėjelis;Varpeliai;94214534219;Taip;0;5;0;5
11340;Vėjelis;Varpeliai;89044270439;Taip;10;0;2;12
11341;Vėjelis;Varpeliai;3214710339;Taip;5;0;0;5
11342;Vėjelis;Varpeliai;80942260332;Taip;0;2;0;2
11343;Vėjelis;Varpeliai;80423879616;Taip;0;5;0;5
11344;Vėjelis;Pelėdžiukų;1454662113;Taip;4;4;0;8
11345;Vėjelis;Pelėdžiukų;1467023330;Taip;0;2;0;2
11346;Vėjelis;Pelėdžiukų;1238171728;Taip;0;0;1;1
11347;Vėjelis;Pelėdžiukų;5992665537;Taip;0;9;0;9
11348;Vėjelis;Pelėdžiukų;4024898537;Taip;3;2;0;5
11349;Vėjelis;Pelėdžiukų;24011371444;Ne;5;0;0;5
11350;Vėjelis;Pelėdžiukų;2819491961;Taip;0;0;2;2
11351;Vėjelis;Pelėdžiukų;1990674632;Taip;0;7;0;7
11352;Vėjelis;Pelėdžiukų;1783878104;Taip;0;8;0;8
11353;Vėjelis;Pelėdžiukų;8033732937;Taip;1;5;0;6
11354;Vėjelis;Pelėdžiukų;6618114389;Taip;0;9;0;9
11355;Vėjelis;Pelėdžiukų;1510415602;Taip;0;0;6;6
11356;Vėjelis;Pelėdžiukų;2042863944;Taip;0;9;0;9
11357;Vėjelis;Pelėdžiukų;1347855869;Taip;0;2;1;3
11358;Vėjelis;Pelėdžiukų;4930807661;Taip;0;0;3;3
11359;Vėjelis;Pelėdžiukų;1518855620;Taip;5;7;0;12
11360;Vėjelis;Skruzdeliukų;2021887954;Taip;3;1;1;5
11361;Vėjelis;Skruzdeliukų;1267672356;Taip;0;8;0;8
11362;Vėjelis;Skruzdeliukų;5468993286;Taip;0;1;0;1
11363;Vėjelis;Skruzdeliukų;90185075321;Taip;0;0;2;2
11364;Vėjelis;Skruzdeliukų;1640356242;Taip;0;2;0;2
11365;Vėjelis;Skruzdeliukų;86128256406;Taip;10;1;4;15
11366;Vėjelis;Skruzdeliukų;41268510292;Taip;8;1;0;9
11367;Vėjelis;Skruzdeliukų;1921039937;Taip;0;1;0;1
11368;Vėjelis;Skruzdeliukų;57285479257;Taip;0;1;0;1
11369;Vėjelis;Skruzdeliukų;44482585723;Taip;0;1;0;1
11370;Vėjelis;Skruzdeliukų;77205958956;Ne;0;6;6;12
11371;Vėjelis;Skruzdeliukų;2718251356;Taip;7;0;2;9
11372;Vėjelis;Skruzdeliukų;1934426525;Taip;0;12;0;12
11373;Vėjelis;Skruzdeliukų;64339770365;Taip;0;10;0;10
11374;Vėjelis;Skruzdeliukų;44153389025;Taip;5;0;0;5
11375;Vėjelis;Skruzdeliukų;1284286578;Ne;1;0;3;4
11376;Vėjelis;Skruzdeliukų;1789982154;Taip;0;16;0;16
11377;Vėjelis;Skruzdeliukų;75596757609;Taip;5;0;3;8
11378;Vėjelis;Pieštukų;3255066035;Taip;0;10;0;10
11379;Vėjelis;Pieštukų;76305473353;Taip;0;0;3;3
11380;Vėjelis;Pieštukų;50124109589;Taip;0;17;0;17
11381;Vėjelis;Pieštukų;73287916371;Taip;10;5;0;15
11382;Vėjelis;Pieštukų;60890519853;Taip;0;5;0;5
11383;Vėjelis;Pieštukų;78490601352;Taip;0;0;6;6
11384;Vėjelis;Pieštukų;8386409466;Taip;0;0;20;20
11385;Vėjelis;Pieštukų;8938491367;Taip;0;15;0;15
11386;Vėjelis;Pieštukų;9492690970;Ne;0;0;4;4
11387;Vėjelis;Pieštukų;6386092350;Taip;0;18;0;18
11388;Vėjelis;Pieštukų;8684461171;Taip;0;9;0;9
11389;Vėjelis;Pieštukų;8973530484;Ne;0;0;2;2
11390;Vėjelis;Pieštukų;98588113289;Taip;0;4;0;4
11391;Vėjelis;Pieštukų;9395929106;Ne;0;19;0;19
11392;Vėjelis;Pieštukų;1205392813;Ne;0;6;0;6
11393;Vėjelis;Pieštukų;5031781196;Taip;13;0;0;13
11394;Vėjelis;Ramunėlių;5987294293;Taip;0;9;0;9
11395;Vėjelis;Ramunėlių;8047799576;Taip;20;2;0;22
11396;Vėjelis;Ramunėlių;4745262277;Ne;9;2;0;11
11397;Vėjelis;Ramunėlių;4353239658;Ne;0;1;0;1
11398;Vėjelis;Ramunėlių;7178844364;Taip;6;0;0;6
11399;Vėjelis;Ramunėlių;2164009051;Taip;5;3;0;8
11400;Vėjelis;Ramunėlių;2386927970;Taip;17;0;0;17
11401;Vėjelis;Ramunėlių;2124857941;Taip;17;2;0;19
11402;Vėjelis;Ramunėlių;6455798848;Taip;13;0;0;13
11403;Vėjelis;Ramunėlių;2999425729;Taip;22;0;0;22
11404;Vėjelis;Ramunėlių;6996900411;Taip;5;5;0;10
11405;Vėjelis;Ramunėlių;2289954824;Taip;4;7;0;11
11406;Vėjelis;Ramunėlių;1717847351;Taip;8;1;0;9
11407;Vėjelis;Ramunėlių;6777528441;Taip;0;8;0;8
11408;Vėjelis;Ramunėlių;6891260701;Taip;11;0;0;11
11409;Vėjelis;Ramunėlių;2151737048;Taip;16;2;0;18
11410;Vėjelis;Ramunėlių;7836199284;Taip;11;2;0;13
11411;Vėjelis;Ramunėlių;1331334220;Taip;0;0;7;7
11412;Vėjelis;Nykštukai;43342043904;Ne;0;6;0;6
11413;Vėjelis;Nykštukai;22865699640;Taip;0;3;0;3
11414;Vėjelis;Nykštukai;12487059850;Taip;0;7;0;7
11415;Vėjelis;Nykštukai;20492762368;Ne;2;3;0;5
11416;Vėjelis;Nykštukai;1251348150;Taip;0;8;0;8
11417;Vėjelis;Nykštukai;85352317063;Taip;0;5;0;5
11418;Vėjelis;Nykštukai;89943712210;Taip;0;1;0;1
11419;Vėjelis;Nykštukai;64628040227;Taip;0;9;0;9
11420;Vėjelis;Nykštukai;33235320630;Taip;0;6;0;6
11421;Vėjelis;Nykštukai;29087363179;Taip;0;2;0;2
11422;Vėjelis;Nykštukai;8226906949;Taip;6;2;0;8
11423;Vėjelis;Nykštukai;5207473829;Taip;0;3;2;5
11424;Vėjelis;Nykštukai;4938939921;Taip;13;5;0;18
11425;Vėjelis;Nykštukai;72881976363;Taip;0;11;0;11
11426;Vėjelis;Nykštukai;78465993753;Ne;5;7;0;12
11427;Vėjelis;Nykštukai;63900641942;Taip;0;11;0;11
11428;Vėjelis;Nykštukai;14754302946;Taip;0;2;0;2
11429;Vėjelis;Nykštukai;1053502203;Ne;5;2;0;7
11430;Vėjelis;Nykštukai;47716333909;Taip;0;9;0;9
11431;Vėjelis;BITUTĖS;5902455219;Taip;0;1;0;1
11432;Vėjelis;BITUTĖS;4831426440;Taip;0;2;3;5
11433;Vėjelis;BITUTĖS;74475070018;Taip;0;1;0;1
11434;Vėjelis;BITUTĖS;5517128872;Taip;0;1;0;1
11435;Vėjelis;BITUTĖS;6724813553;Taip;0;1;0;1
11436;Vėjelis;BITUTĖS;4451119031;Taip;0;20;0;20
11437;Vėjelis;BITUTĖS;8721116918;Ne;5;1;0;6
11438;Vėjelis;BITUTĖS;3584347608;Taip;0;2;0;2
11439;Vėjelis;BITUTĖS;9108653045;Taip;0;14;0;14
11440;Vėjelis;BITUTĖS;5508269515;Taip;0;5;0;5
11441;Vėjelis;BITUTĖS;8998452731;Taip;0;1;0;1
11442;Vėjelis;BITUTĖS;9672929606;Taip;7;0;5;12
11443;Vėjelis;BITUTĖS;6451722893;Taip;9;0;3;12
11444;Vėjelis;BITUTĖS;5909697341;Taip;0;3;0;3
11445;Vėjelis;BITUTĖS;9754373141;Taip;0;0;4;4
11446;Vėjelis;BITUTĖS;4906958328;Taip;0;7;0;7
11447;Vėjelis;Boruželės;5325081841;Taip;0;1;0;1
11448;Vėjelis;Boruželės;5381588565;Taip;5;2;0;7
11449;Vėjelis;Boruželės;1863210064;Taip;0;14;0;14
11450;Vėjelis;Boruželės;9037622738;Taip;0;8;0;8
11451;Vėjelis;Boruželės;1588345134;Taip;0;0;3;3
11452;Vėjelis;Boruželės;1751533938;Ne;0;9;0;9
11453;Vėjelis;Boruželės;4733227215;Taip;10;0;2;12
11454;Vėjelis;Boruželės;1429496839;Taip;0;4;0;4
11455;Vėjelis;Boruželės;1931659200;Taip;22;0;0;22
11456;Vėjelis;Boruželės;1076538028;Taip;12;0;0;12
11457;Vėjelis;Boruželės;6658178519;Taip;2;0;0;2
11458;Vėjelis;Boruželės;8666759391;Ne;5;1;3;9
11459;Vėjelis;Boruželės;3844131154;Taip;5;0;0;5
11460;Vėjelis;Boruželės;4747466651;Taip;0;7;0;7
11461;Vėjelis;Boruželės;3473416323;Taip;0;2;0;2
11462;Vėjelis;Boruželės;8141198449;Taip;6;2;0;8
11463;Vėjelis;Boruželės;8121537795;Ne;0;22;0;22
11464;Vėtrungė;Debesėlių;62501279379;Ne;0;5;0;5
11465;Vėtrungė;Debesėlių;684188851;Taip;6;2;0;8
11466;Vėtrungė;Debesėlių;1833285759;Taip;10;3;0;13
11467;Vėtrungė;Debesėlių;31644585040;Ne;4;0;0;4
11468;Vėtrungė;Debesėlių;68262180072;Taip;0;3;2;5
11469;Vėtrungė;Debesėlių;63472451321;Taip;14;1;0;15
11470;Vėtrungė;Debesėlių;97059033453;Ne;0;0;5;5
11471;Vėtrungė;Debesėlių;9844783953;Taip;8;0;0;8
11472;Vėtrungė;Debesėlių;8948342560;Taip;0;5;1;6
11473;Vėtrungė;Debesėlių;28780493289;Taip;12;2;0;14
11474;Vėtrungė;Debesėlių;65861118217;Taip;0;1;0;1
11475;Vėtrungė;Debesėlių;48935809458;Ne;0;2;0;2
11476;Vėtrungė;Debesėlių;92977432447;Ne;5;1;0;6
11477;Vėtrungė;Debesėlių;11835082526;Taip;13;0;0;13
11478;Vėtrungė;Debesėlių;92266460791;Taip;0;0;1;1
11479;Vėtrungė;Debesėlių;30561569339;Ne;4;5;0;9
11480;Vėtrungė;Debesėlių;31570905515;Ne;4;5;0;9
11481;Vėtrungė;Debesėlių;4547247726;Taip;0;10;0;10
11482;Vėtrungė;Debesėlių;1918866964;Taip;11;1;0;12
11483;Vėtrungė;Debesėlių;22961558196;Taip;4;1;0;5
11484;Vėtrungė;Debesėlių;96980344422;Taip;0;12;0;12
11485;Vėtrungė;Zuikių;7585075881;Taip;0;3;1;4
11486;Vėtrungė;Zuikių;4874628984;Taip;11;0;0;11
11487;Vėtrungė;Zuikių;9332362038;Taip;2;2;0;4
11488;Vėtrungė;Zuikių;9407558097;Taip;0;2;0;2
11489;Vėtrungė;Zuikių;4121886031;Taip;0;6;0;6
11490;Vėtrungė;Zuikių;7573021445;Taip;0;1;5;6
11491;Vėtrungė;Zuikių;9742099165;Taip;0;2;0;2
11492;Vėtrungė;Drugelių;98795465390;Taip;0;5;0;5
11493;Vėtrungė;Drugelių;34534856875;Ne;0;4;0;4
11494;Vėtrungė;Drugelių;1019550327;Taip;5;0;1;6
11495;Vėtrungė;Drugelių;26126038013;Taip;0;6;0;6
11496;Vėtrungė;Drugelių;40200404538;Taip;0;2;0;2
11497;Vėtrungė;Drugelių;72462689908;Taip;0;7;0;7
11498;Vėtrungė;Drugelių;38583821324;Ne;0;4;0;4
11499;Vėtrungė;Drugelių;42353807206;Taip;0;7;0;7
11500;Vėtrungė;Drugelių;76967115688;Taip;0;2;0;2
11501;Vėtrungė;Drugelių;68938242748;Taip;3;2;0;5
11502;Vėtrungė;Drugelių;93587767496;Taip;1;5;0;6
11503;Vėtrungė;Drugelių;45715910769;Taip;0;0;1;1
11504;Vėtrungė;Drugelių;1111688152;Taip;10;2;0;12
11505;Vėtrungė;Drugelių;1752676956;Taip;0;5;0;5
11506;Vėtrungė;Drugelių;1128961321;Taip;6;0;0;6
11507;Vėtrungė;Drugelių;88062307371;Taip;10;3;2;15
11508;Vėtrungė;Drugelių;99423172685;Ne;0;2;0;2
11509;Vėtrungė;Drugelių;58224525427;Taip;0;11;0;11
11510;Vėtrungė;Drugelių;1533796435;Taip;14;2;0;16
11511;Vėtrungė;Do-re-mi;6978977383;Taip;12;0;0;12
11512;Vėtrungė;Do-re-mi;4528101179;Taip;0;1;2;3
11513;Vėtrungė;Do-re-mi;6449124019;Taip;0;5;0;5
11514;Vėtrungė;Do-re-mi;3278452234;Taip;0;3;2;5
11515;Vėtrungė;Do-re-mi;2287044278;Taip;11;0;0;11
11516;Vėtrungė;Do-re-mi;2928868412;Taip;0;1;0;1
11517;Vėtrungė;Do-re-mi;2883254822;Taip;0;6;0;6
11518;Vėtrungė;Do-re-mi;7782972361;Taip;0;3;0;3
11519;Vėtrungė;Do-re-mi;7496582551;Taip;11;0;0;11
11520;Vėtrungė;Do-re-mi;5430818470;Taip;0;7;0;7
11521;Vėtrungė;Do-re-mi;1088517019;Ne;18;0;0;18
11522;Vėtrungė;Do-re-mi;5832298824;Ne;4;3;0;7
11523;Vėtrungė;Do-re-mi;7895027909;Taip;0;0;1;1
11524;Vėtrungė;Smalsučių;1024966114;Taip;7;1;1;9
11525;Vėtrungė;Smalsučių;70341931369;Ne;0;2;2;4
11526;Vėtrungė;Smalsučių;12552330015;Taip;0;7;0;7
11527;Vėtrungė;Smalsučių;43313050517;Taip;0;2;2;4
11528;Vėtrungė;Smalsučių;1096312626;Taip;7;0;0;7
11529;Vėtrungė;Smalsučių;58071867972;Ne;0;8;0;8
11530;Vėtrungė;Smalsučių;25185803642;Taip;5;1;0;6
11531;Vėtrungė;Smalsučių;8303270253;Taip;5;3;0;8
11532;Vėtrungė;Smalsučių;10642323891;Taip;0;0;3;3
11533;Vėtrungė;Smalsučių;1637718306;Taip;7;2;0;9
11534;Vėtrungė;Smalsučių;37534609024;Taip;0;2;1;3
11535;Vėtrungė;Smalsučių;18697110620;Taip;7;0;0;7
11536;Vėtrungė;Smalsučių;55178408212;Taip;15;0;1;16
11537;Vėtrungė;Smalsučių;22272024279;Taip;0;1;0;1
11538;Vėtrungė;Smalsučių;1828688039;Taip;0;2;0;2
11539;Vėtrungė;Smalsučių;1649646780;Taip;6;0;0;6
11540;Vėtrungė;Gudručių;39325086836;Taip;0;3;0;3
11541;Vėtrungė;Gudručių;9097027948;Taip;0;9;0;9
11542;Vėtrungė;Gudručių;71205463603;Taip;0;3;0;3
11543;Vėtrungė;Gudručių;37846747830;Taip;0;7;1;8
11544;Vėtrungė;Gudručių;53452204630;Taip;0;6;0;6
11545;Vėtrungė;Gudručių;63918616201;Taip;0;3;2;5
11546;Vėtrungė;Gudručių;71037045946;Taip;9;4;0;13
11547;Vėtrungė;Gudručių;50620488812;Taip;0;3;5;8
11548;Vėtrungė;Gudručių;17639791114;Taip;0;1;0;1
11549;Vėtrungė;Gudručių;45652505960;Taip;0;3;0;3
11550;Vėtrungė;Gudručių;79959834921;Ne;0;8;0;8
11551;Vėtrungė;Gudručių;32639429554;Taip;11;0;1;12
11552;Vėtrungė;Gudručių;72698261170;Taip;0;13;0;13
11553;Vėtrungė;Gudručių;74200855756;Taip;0;5;0;5
11554;Vėtrungė;Gudručių;13233957713;Ne;0;2;0;2
11555;Vėtrungė;Gudručių;29414532281;Ne;0;6;0;6
11556;Vėtrungė;Gudručių;16576620734;Ne;5;5;0;10
11557;Vėtrungė;Gudručių;1120374635;Taip;0;1;0;1
11558;Vėtrungė;Gudručių;77759679609;Taip;0;14;0;14
11559;Vėtrungė;Kodėlčių;1366458234;Taip;19;2;0;21
11560;Vėtrungė;Kodėlčių;1021458176;Taip;0;24;0;24
11561;Vėtrungė;Kodėlčių;1267104594;Taip;0;4;0;4
11562;Vėtrungė;Kodėlčių;1022530443;Taip;11;2;0;13
11563;Vėtrungė;Kodėlčių;1283685496;Taip;2;10;0;12
11564;Vėtrungė;Kodėlčių;20608668180;Taip;5;1;1;7
11565;Vėtrungė;Kodėlčių;3980104822;Taip;5;3;0;8
11566;Vėtrungė;Kodėlčių;31133574731;Taip;17;7;0;24
11567;Vėtrungė;Kodėlčių;49220186521;Taip;10;14;0;24
11568;Vėtrungė;Kodėlčių;41508942219;Taip;6;7;0;13
11569;Vėtrungė;Kodėlčių;1662123237;Taip;0;5;0;5
11570;Vėtrungė;Kodėlčių;1456877681;Taip;0;24;0;24
11571;Vėtrungė;Kodėlčių;90528749634;Taip;10;2;0;12
11572;Vėtrungė;Kodėlčių;1487142899;Taip;12;7;0;19
11573;Vėtrungė;Kodėlčių;19486911273;Taip;6;0;0;6
11574;Vėtrungė;Kodėlčių;56266349747;Taip;0;2;0;2
11575;Vėtrungė;Kodėlčių;1902101426;Taip;0;19;0;19
11576;Vėtrungė;Kodėlčių;9395706055;Ne;0;9;0;9
11577;Vėtrungė;Kodėlčių;3231167303;Taip;3;0;0;3
11578;Vėtrungė;Kodėlčių;4291687553;Ne;10;3;3;16
11579;Vėtrungė;Kodėlčių;18426639118;Taip;5;6;0;11
11580;Vėtrungė;Kodėlčių;1383686133;Taip;10;1;0;11
11581;Vėtrungė;Kodėlčių;6563805572;Taip;7;2;0;9
11582;Vėtrungė;Kodėlčių;1395153496;Taip;0;11;0;11
11583;Vėtrungė;Paukštelių;63512524250;Ne;0;2;5;7
11584;Vėtrungė;Paukštelių;1769926207;Taip;8;0;0;8
11585;Vėtrungė;Paukštelių;1322617786;Taip;22;2;0;24
11586;Vėtrungė;Paukštelių;7921863675;Taip;5;6;0;11
11587;Vėtrungė;Paukštelių;4091719904;Taip;5;1;0;6
11588;Vėtrungė;Paukštelių;4347810256;Taip;7;0;0;7
11589;Vėtrungė;Paukštelių;8915159672;Taip;12;6;0;18
11590;Vėtrungė;Paukštelių;2482436192;Taip;10;0;0;10
11591;Vėtrungė;Paukštelių;6732632515;Taip;22;2;0;24
11592;Vėtrungė;Paukštelių;8897558066;Taip;7;0;0;7
11593;Vėtrungė;Paukštelių;3404120492;Taip;10;0;0;10
11594;Vėtrungė;Paukštelių;8154023892;Ne;19;2;0;21
11595;Vėtrungė;Paukštelių;3721504364;Taip;0;1;2;3
11596;Vėtrungė;Paukštelių;4115995882;Taip;0;6;0;6
11597;Vėtrungė;Paukštelių;1357603285;Taip;7;0;0;7
11598;Vėtrungė;Paukštelių;5994465833;Taip;0;1;0;1
11599;Vėtrungė;Paukštelių;8721035192;Taip;0;24;0;24
11600;Vėtrungė;Paukštelių;6964225210;Taip;5;0;1;6
11601;Vėtrungė;Viščiukų;2809555356;Taip;6;0;0;6
11602;Vėtrungė;Viščiukų;8571622921;Taip;5;13;0;18
11603;Vėtrungė;Viščiukų;3369970611;Taip;0;2;0;2
11604;Vėtrungė;Viščiukų;3200251047;Taip;2;0;0;2
11605;Vėtrungė;Viščiukų;8538678373;Taip;12;0;0;12
11606;Vėtrungė;Viščiukų;7483624989;Taip;0;20;0;20
11607;Vėtrungė;Viščiukų;5670113882;Taip;5;0;0;5
11608;Vėtrungė;Viščiukų;1808699695;Taip;0;1;0;1
11609;Vėtrungė;Viščiukų;7807708310;Taip;6;5;0;11
11610;Vėtrungė;Viščiukų;8961791293;Taip;0;3;0;3
11611;Vėtrungė;Viščiukų;4916692634;Taip;6;0;0;6
11612;Vėtrungė;Viščiukų;4197321604;Taip;11;0;1;12
11613;Vėtrungė;Viščiukų;5217297849;Ne;7;1;0;8
11614;Vėtrungė;Viščiukų;6416245099;Ne;3;4;0;7
11615;Vėtrungė;Viščiukų;8742161467;Taip;1;7;0;8
11616;Vėtrungė;Viščiukų;7558548846;Taip;1;0;0;1
11617;Vėtrungė;Viščiukų;1007578933;Taip;0;1;0;1
11618;Vėtrungė;Nykštukų;29699317546;Taip;7;5;0;12
11619;Vėtrungė;Nykštukų;1474010989;Ne;0;22;0;22
11620;Vėtrungė;Nykštukų;47141854213;Taip;7;10;0;17
11621;Vėtrungė;Nykštukų;76708504248;Taip;0;1;0;1
11622;Vėtrungė;Nykštukų;1754493671;Ne;0;1;0;1
11623;Vėtrungė;Nykštukų;1843306606;Taip;10;10;0;20
11624;Vėtrungė;Nykštukų;5198153485;Taip;6;0;0;6
11625;Vėtrungė;Nykštukų;1630866223;Taip;0;7;0;7
11626;Vėtrungė;Nykštukų;1529226569;Taip;0;4;0;4
11627;Vėtrungė;Nykštukų;1690268842;Taip;10;3;1;14
11628;Vėtrungė;Nykštukų;1279678980;Taip;6;1;0;7
11629;Vėtrungė;Nykštukų;1370336984;Taip;0;7;0;7
11630;Vėtrungė;Nykštukų;78016704795;Taip;14;3;0;17
11631;Vėtrungė;Nykštukų;68628872682;Taip;5;10;0;15
11632;Vėtrungė;Nykštukų;54494917364;Taip;4;0;0;4
11633;Vėtrungė;Nykštukų;87686013986;Taip;7;2;1;10
11634;Vėtrungė;Nykštukų;70610257897;Taip;10;2;0;12
11635;Vėtrungė;Nykštukų;2715736596;Taip;10;0;0;10
11636;Vėtrungė;Nykštukų;1744400765;Taip;16;3;0;19
11637;Vėtrungė;Nykštukų;1360031121;Taip;5;4;0;9
11638;Vėtrungė;Nykštukų;2145081325;Taip;11;3;1;15
11639;Vėtrungė;Nykštukų;2529102855;Taip;7;0;5;12
11640;Vėtrungė;Nykštukų;1611274573;Taip;14;2;1;17
11641;Vėtrungė;Nykštukų;7792694801;Ne;0;3;0;3
11642;Vėtrungė;Meškiukų;2510763357;Taip;15;2;0;17
11643;Vėtrungė;Meškiukų;4713420194;Taip;19;2;0;21
11644;Vėtrungė;Meškiukų;2226654309;Taip;6;1;0;7
11645;Vėtrungė;Meškiukų;7270370939;Taip;5;1;0;6
11646;Vėtrungė;Meškiukų;9543456295;Taip;7;0;0;7
11647;Vėtrungė;Meškiukų;9207846866;Taip;4;2;0;6
11648;Vėtrungė;Meškiukų;9065848425;Taip;7;1;0;8
11649;Vėtrungė;Meškiukų;9491661945;Ne;14;0;0;14
11650;Vėtrungė;Meškiukų;3328447991;Taip;4;0;0;4
11651;Vėtrungė;Meškiukų;9685389270;Ne;9;8;0;17
11652;Vėtrungė;Meškiukų;9313438768;Taip;0;3;0;3
11653;Vėtrungė;Meškiukų;9070732925;Taip;10;5;0;15
11654;Vėtrungė;Meškiukų;3122948974;Taip;5;0;0;5
11655;Vėtrungė;Meškiukų;2880342138;Taip;10;0;0;10
11656;Vėtrungė;Meškiukų;2520926439;Taip;22;2;0;24
11657;Vėtrungė;Meškiukų;7704497739;Taip;8;0;0;8
11658;Vėtrungė;Meškiukų;7143997258;Taip;10;2;0;12
11659;Vėtrungė;Meškiukų;5123894802;Taip;0;6;0;6
11660;Vėtrungė;Meškiukų;4394100006;Taip;6;1;15;22
11661;Vėtrungė;Ąžuoliukų;2471926240;Taip;0;2;0;2
11662;Vėtrungė;Ąžuoliukų;3249689008;Taip;0;2;0;2
11663;Vėtrungė;Ąžuoliukų;7295216791;Taip;0;1;0;1
11664;Vėtrungė;Ąžuoliukų;2440001662;Taip;15;2;0;17
11665;Vėtrungė;Ąžuoliukų;7803736567;Taip;6;2;0;8
11666;Vėtrungė;Ąžuoliukų;1042333710;Ne;2;3;0;5
11667;Vėtrungė;Ąžuoliukų;16216365941;Taip;0;2;0;2
11668;Vėtrungė;Ąžuoliukų;6356914122;Ne;0;4;0;4
11669;Vėtrungė;Ąžuoliukų;2636219826;Taip;6;2;0;8
11670;Vėtrungė;Ąžuoliukų;6479094819;Taip;8;0;0;8
11671;Vėtrungė;Ąžuoliukų;5367369908;Taip;7;2;0;9
11672;Vėtrungė;Ąžuoliukų;4000379945;Taip;0;8;0;8
11673;Vėtrungė;Ąžuoliukų;1789419548;Ne;11;1;0;12
11674;Vėtrungė;Ąžuoliukų;7363490503;Taip;8;0;0;8
11675;Vilnelė;Bitutė;57355144827;Taip;8;3;0;11
11676;Vilnelė;Bitutė;31456400596;Ne;0;6;0;6
11677;Vilnelė;Bitutė;98916301986;Ne;0;10;0;10
11678;Vilnelė;Bitutė;5689110144;Taip;0;2;0;2
11679;Vilnelė;Bitutė;14782861836;Taip;6;6;0;12
11680;Vilnelė;Bitutė;81251620413;Ne;0;2;0;2
11681;Vilnelė;Bitutė;1401796093;Ne;0;0;5;5
11682;Vilnelė;Bitutė;5431869792;Ne;0;12;0;12
11683;Vilnelė;Bitutė;19340293938;Taip;0;18;0;18
11684;Vilnelė;Bitutė;57150212991;Ne;0;8;0;8
11685;Vilnelė;Bitutė;79392670872;Ne;8;0;0;8
11686;Vilnelė;Bitutė;57958541549;Taip;0;0;2;2
11687;Vilnelė;Bitutė;66330140933;Taip;0;7;0;7
11688;Vilnelė;Bitutė;63559597074;Taip;0;0;10;10
11689;Vilnelė;Bitutė;70908264075;Taip;0;9;0;9
11690;Vilnelė;Bitutė;28905654375;Taip;0;2;0;2
11691;Vilnelė;Bitutė;41258849574;Taip;3;0;1;4
11692;Vilnelė;Bitutė;27320200466;Taip;0;1;0;1
11693;Vilnelė;Nykštukas;53049214510;Taip;13;2;0;15
11694;Vilnelė;Nykštukas;1336497125;Taip;5;0;0;5
11695;Vilnelė;Nykštukas;32988468324;Taip;0;5;0;5
11696;Vilnelė;Nykštukas;13583637193;Taip;0;5;0;5
11697;Vilnelė;Nykštukas;23442711820;Taip;0;4;0;4
11698;Vilnelė;Nykštukas;47863474499;Taip;0;1;0;1
11699;Vilnelė;Nykštukas;13231410969;Taip;2;5;0;7
11700;Vilnelė;Nykštukas;1845336128;Taip;0;7;0;7
11701;Vilnelė;Nykštukas;59579013512;Taip;0;6;0;6
11702;Vilnelė;Kodėlčiukas;85452254846;Taip;0;2;0;2
11703;Vilnelė;Kodėlčiukas;6289991945;Taip;5;1;0;6
11704;Vilnelė;Kodėlčiukas;81657018187;Taip;0;2;0;2
11705;Vilnelė;Kodėlčiukas;1448257490;Taip;1;4;0;5
11706;Vilnelė;Kodėlčiukas;69532393507;Taip;0;2;11;13
11707;Vilnelė;Kodėlčiukas;1160794222;Taip;0;6;0;6
11708;Vilnelė;Kodėlčiukas;64950604083;Taip;0;4;0;4
11709;Vilnelė;Kodėlčiukas;99580393765;Taip;0;7;0;7
11710;Vilnelė;Kodėlčiukas;36561742487;Taip;0;2;0;2
11711;Vilnelė;Kodėlčiukas;96900970284;Taip;18;1;0;19
11712;Vilnelė;Kodėlčiukas;85391221236;Taip;0;8;0;8
11713;Vilnelė;Kodėlčiukas;39412868538;Taip;9;0;0;9
11714;Vilnelė;Kodėlčiukas;67110179640;Ne;0;4;0;4
11715;Vilnelė;Kodėlčiukas;35546482171;Taip;0;8;0;8
11716;Vilnelė;Kodėlčiukas;90980722090;Taip;0;5;0;5
11717;Vilnelė;Kodėlčiukas;33652235251;Taip;0;7;0;7
11718;Vilnelė;Kodėlčiukas;32819254615;Ne;6;1;0;7
11719;Vilnelė;Kodėlčiukas;18238619578;Taip;11;6;0;17
11720;Vėrinėlis;GAIDELIAI;2774618380;Taip;11;0;1;12
11721;Vėrinėlis;GAIDELIAI;5429955166;Taip;0;10;0;10
11722;Vėrinėlis;GAIDELIAI;5209398043;Taip;0;10;0;10
11723;Vėrinėlis;GAIDELIAI;1060619471;Ne;11;0;0;11
11724;Vėrinėlis;GAIDELIAI;8885866108;Taip;5;0;2;7
11725;Vėrinėlis;GAIDELIAI;8213498951;Taip;10;0;0;10
11726;Vėrinėlis;GAIDELIAI;6136232912;Taip;16;0;2;18
11727;Vėrinėlis;GAIDELIAI;6058712578;Taip;8;3;0;11
11728;Vėrinėlis;GAIDELIAI;1164396960;Taip;0;5;6;11
11729;Vėrinėlis;GAIDELIAI;8091400240;Taip;17;0;0;17
11730;Vėrinėlis;GAIDELIAI;8728166391;Taip;0;0;6;6
11731;Vėrinėlis;GAIDELIAI;4415030161;Taip;5;14;0;19
11732;Vėrinėlis;GAIDELIAI;8100283579;Taip;1;0;0;1
11733;Vėrinėlis;SAULUTĖ;71830611159;Taip;0;16;0;16
11734;Vėrinėlis;SAULUTĖ;6148700823;Taip;7;6;0;13
11735;Vėrinėlis;SAULUTĖ;1086306523;Ne;6;0;0;6
11736;Vėrinėlis;SAULUTĖ;11343969028;Taip;0;15;0;15
11737;Vėrinėlis;SAULUTĖ;1408704528;Taip;5;0;0;5
11738;Vėrinėlis;SAULUTĖ;1239744245;Taip;5;0;0;5
11739;Vėrinėlis;SAULUTĖ;6004379115;Taip;0;3;0;3
11740;Vėrinėlis;SAULUTĖ;39153716711;Taip;3;3;0;6
11741;Vėrinėlis;SAULUTĖ;9751494612;Taip;15;0;0;15
11742;Vėrinėlis;SAULUTĖ;1897451825;Taip;12;0;0;12
11743;Vėrinėlis;SAULUTĖ;4727265555;Taip;5;12;0;17
11744;Vėrinėlis;SAULUTĖ;1047139776;Taip;0;6;0;6
11745;Vėrinėlis;SAULUTĖ;1493604303;Taip;18;3;0;21
11746;Vėrinėlis;SAULUTĖ;5561043797;Taip;7;0;0;7
11747;Vėrinėlis;SAULUTĖ;9500715949;Taip;0;11;0;11
11748;Vėrinėlis;SAULUTĖ;1803838403;Taip;0;0;3;3
11749;Vėrinėlis;SAULUTĖ;8922728881;Taip;1;2;0;3
11750;Vėrinėlis;SAULUTĖ;84391578139;Taip;8;0;0;8
11751;Vėrinėlis;SAULUTĖ;9391697537;Taip;5;3;0;8
11752;Vėrinėlis;SAULUTĖ;7071043164;Taip;9;7;0;16
11753;Vėrinėlis;NYKŠTUKAI;7168682238;Taip;0;2;0;2
11754;Vėrinėlis;NYKŠTUKAI;668239862;Taip;0;1;0;1
11755;Vėrinėlis;NYKŠTUKAI;8197177876;Taip;5;0;1;6
11756;Vėrinėlis;NYKŠTUKAI;1518907235;Taip;0;0;4;4
11757;Vėrinėlis;NYKŠTUKAI;6065348004;Taip;1;0;0;1
11758;Vėrinėlis;NYKŠTUKAI;7436873997;Ne;10;2;0;12
11759;Vėrinėlis;NYKŠTUKAI;63333257753;Taip;10;0;0;10
11760;Vėrinėlis;NYKŠTUKAI;1261337457;Taip;0;0;15;15
11761;Vėrinėlis;NYKŠTUKAI;1804757495;Taip;0;0;3;3
11762;Vėrinėlis;NYKŠTUKAI;1029210296;Taip;6;0;0;6
11763;Vėrinėlis;NYKŠTUKAI;11459693163;Taip;7;0;0;7
11764;Vėrinėlis;NYKŠTUKAI;1295435839;Taip;0;1;0;1
11765;Vėrinėlis;NYKŠTUKAI;47333446450;Taip;1;0;0;1
11766;Vėrinėlis;NYKŠTUKAI;92480758419;Taip;2;0;5;7
11767;Vėrinėlis;NYKŠTUKAI;38428514086;Ne;7;12;0;19
11768;Vėrinėlis;NYKŠTUKAI;27431479888;Taip;0;0;2;2
11769;Vėrinėlis;NYKŠTUKAI;4229867189;Taip;2;0;0;2
11770;Vėrinėlis;NYKŠTUKAI;41029899086;Ne;0;0;4;4
11771;Vėrinėlis;NYKŠTUKAI;2001903188;Ne;3;0;0;3
11772;Vėrinėlis;NYKŠTUKAI;1251822610;Ne;10;0;0;10
11773;Vėrinėlis;NYKŠTUKAI;22535431362;Taip;0;0;1;1
11774;Vėrinėlis;BURATINAS;1001125426;Taip;11;3;0;14
11775;Vėrinėlis;BURATINAS;99734698213;Taip;8;0;2;10
11776;Vėrinėlis;BURATINAS;58909000723;Taip;0;9;0;9
11777;Vėrinėlis;BURATINAS;42875958735;Ne;0;8;0;8
11778;Vėrinėlis;BURATINAS;4541318324;Taip;0;2;0;2
11779;Vėrinėlis;BURATINAS;78121632796;Taip;4;0;4;8
11780;Vėrinėlis;BURATINAS;25734061057;Taip;17;0;0;17
11781;Vėrinėlis;BURATINAS;68027880109;Taip;13;0;0;13
11782;Vėrinėlis;BURATINAS;2676104110;Taip;4;0;0;4
11783;Vėrinėlis;BURATINAS;12363691267;Taip;9;1;0;10
11784;Vėrinėlis;BURATINAS;99325931907;Taip;4;3;0;7
11785;Vėrinėlis;BURATINAS;40706531692;Taip;0;2;0;2
11786;Vėrinėlis;BURATINAS;3044373634;Taip;12;0;0;12
11787;Vėrinėlis;BURATINAS;24888549934;Taip;0;8;0;8
11788;Vėrinėlis;BURATINAS;38831165210;Taip;0;11;0;11
11789;Vėrinėlis;BURATINAS;37600982027;Ne;0;1;0;1
11790;Vėrinėlis;BURATINAS;8978798314;Taip;0;0;7;7
11791;Vėrinėlis;BURATINAS;1953362884;Taip;10;0;0;10
11792;Vėrinėlis;BURATINAS;79317384797;Taip;12;1;0;13
11793;Vėrinėlis;GINTARĖLIAI;79005449877;Taip;0;2;0;2
11794;Vėrinėlis;GINTARĖLIAI;98927850113;Taip;0;1;2;3
11795;Vėrinėlis;GINTARĖLIAI;85276333294;Taip;3;0;0;3
11796;Vėrinėlis;GINTARĖLIAI;94043814995;Taip;1;0;1;2
11797;Vėrinėlis;GINTARĖLIAI;81355372884;Taip;0;0;1;1
11798;Vėrinėlis;GINTARĖLIAI;2241971642;Taip;0;12;0;12
11799;Vėrinėlis;GINTARĖLIAI;1316071049;Taip;0;1;0;1
11800;Vėrinėlis;GINTARĖLIAI;1200426264;Taip;6;0;1;7
11801;Vėrinėlis;GINTARĖLIAI;78383742417;Taip;0;0;1;1
11802;Vėrinėlis;GINTARĖLIAI;63260347010;Taip;0;0;1;1
11803;Vėrinėlis;GINTARĖLIAI;53823221730;Taip;0;1;0;1
11804;Vėrinėlis;GINTARĖLIAI;64791543104;Taip;0;0;1;1
11805;Vėrinėlis;GINTARĖLIAI;63357719105;Taip;0;1;3;4
11806;Vėrinėlis;GINTARĖLIAI;96157891711;Taip;0;8;0;8
11807;Vėrinėlis;GINTARĖLIAI;76043900105;Taip;0;1;0;1
11808;Vėrinėlis;GINTARĖLIAI;19538705090;Taip;3;0;0;3
11809;Vėrinėlis;GINTARĖLIAI;3183131197;Taip;0;7;0;7
11810;Vėrinėlis;GINTARĖLIAI;2023475725;Taip;0;0;4;4
11811;Vėrinėlis;GINTARĖLIAI;1028694005;Taip;0;3;3;6
11812;Vėrinėlis;RAMUNĖLĖS;71959077340;Taip;11;0;0;11
11813;Vėrinėlis;RAMUNĖLĖS;36922560017;Taip;5;12;0;17
11814;Vėrinėlis;RAMUNĖLĖS;22573601173;Taip;0;5;0;5
11815;Vėrinėlis;RAMUNĖLĖS;1540708366;Taip;5;1;0;6
11816;Vėrinėlis;RAMUNĖLĖS;7178943357;Taip;6;0;2;8
11817;Vėrinėlis;RAMUNĖLĖS;1292880457;Taip;0;0;8;8
11818;Vėrinėlis;RAMUNĖLĖS;36138794708;Taip;10;0;0;10
11819;Vėrinėlis;RAMUNĖLĖS;41342430019;Taip;0;5;0;5
11820;Vėrinėlis;RAMUNĖLĖS;56656769188;Taip;1;0;1;2
11821;Vėrinėlis;RAMUNĖLĖS;1792855817;Taip;20;0;0;20
11822;Vėrinėlis;RAMUNĖLĖS;1979643933;Taip;20;0;0;20
11823;Vėrinėlis;RAMUNĖLĖS;1398564881;Taip;4;0;1;5
11824;Vėrinėlis;RAMUNĖLĖS;68073702260;Taip;9;0;1;10
11825;Vėrinėlis;RAMUNĖLĖS;1133491927;Taip;14;0;0;14
11826;Vėrinėlis;RAMUNĖLĖS;1268710930;Taip;5;0;0;5
11827;Vėrinėlis;RAMUNĖLĖS;1477336890;Taip;16;0;0;16
11828;Vėrinėlis;KODELČIUKŲ;88831634291;Taip;0;4;0;4
11829;Vėrinėlis;KODELČIUKŲ;6798167004;Taip;0;0;3;3
11830;Vėrinėlis;KODELČIUKŲ;7561194911;Taip;0;3;0;3
11831;Vėrinėlis;KODELČIUKŲ;67977504520;Taip;0;12;0;12
11832;Vėrinėlis;KODELČIUKŲ;8080337820;Taip;7;0;3;10
11833;Vėrinėlis;KODELČIUKŲ;51807139150;Taip;0;8;0;8
11834;Vėrinėlis;KODELČIUKŲ;9955087519;Ne;4;0;3;7
11835;Vėrinėlis;KODELČIUKŲ;1129067900;Taip;0;6;0;6
11836;Vėrinėlis;KODELČIUKŲ;43944804765;Taip;0;8;0;8
11837;Vėrinėlis;KODELČIUKŲ;17400501595;Taip;0;11;0;11
11838;Vėrinėlis;KODELČIUKŲ;20342193231;Taip;0;8;0;8
11839;Vėrinėlis;KODELČIUKŲ;47633572816;Taip;0;0;3;3
11840;Vėrinėlis;KODELČIUKŲ;6088489477;Taip;0;6;0;6
11841;Vėrinėlis;KODELČIUKŲ;38040256220;Taip;0;9;0;9
11842;Vėrinėlis;KODELČIUKŲ;1481003777;Taip;7;0;1;8
11843;Vėrinėlis;KODELČIUKŲ;9930767796;Taip;0;13;0;13
11844;Vėrinėlis;KODELČIUKŲ;74375362661;Taip;0;9;0;9
11845;Vėrinėlis;KODELČIUKŲ;9889717756;Taip;2;0;1;3
11846;Vėrinėlis;ŽIRNIUKAI;3074835599;Ne;11;0;1;12
11847;Vėrinėlis;ŽIRNIUKAI;4981127515;Taip;0;0;1;1
11848;Vėrinėlis;ŽIRNIUKAI;7845985650;Ne;7;0;2;9
11849;Vėrinėlis;ŽIRNIUKAI;2815770695;Taip;0;2;1;3
11850;Vėrinėlis;ŽIRNIUKAI;9604483237;Taip;3;0;0;3
11851;Vėrinėlis;ŽIRNIUKAI;9419245081;Taip;0;5;1;6
11852;Vėrinėlis;ŽIRNIUKAI;8329989952;Taip;5;0;9;14
11853;Vėrinėlis;ŽIRNIUKAI;3202518504;Taip;9;0;1;10
11854;Vėrinėlis;ŽIRNIUKAI;4752902173;Taip;6;0;0;6
11855;Vėrinėlis;ŽIRNIUKAI;7237945125;Taip;16;0;0;16
11856;Vėrinėlis;ŽIRNIUKAI;5600815908;Taip;5;0;1;6
11857;Vėrinėlis;ŽIRNIUKAI;7367485961;Taip;0;0;1;1
11858;Vėrinėlis;ŽIRNIUKAI;9340167973;Taip;17;0;2;19
11859;Vėrinėlis;ŽIRNIUKAI;1736733257;Taip;15;0;0;15
11860;Vėrinėlis;VARPELIAI;3316897176;Taip;0;0;2;2
11861;Vėrinėlis;VARPELIAI;3882915774;Taip;6;10;0;16
11862;Vėrinėlis;VARPELIAI;7273090217;Taip;5;0;0;5
11863;Vėrinėlis;VARPELIAI;7233139048;Taip;12;0;0;12
11864;Vėrinėlis;VARPELIAI;3130841241;Taip;10;0;2;12
11865;Vėrinėlis;VARPELIAI;6435612222;Taip;20;0;0;20
11866;Vėrinėlis;VARPELIAI;2337883071;Taip;16;0;2;18
11867;Vėrinėlis;VARPELIAI;6913001318;Ne;5;6;0;11
11868;Vėrinėlis;VARPELIAI;4728119881;Taip;8;0;0;8
11869;Vėrinėlis;VARPELIAI;7224418233;Taip;0;22;0;22
11870;Vėrinėlis;VARPELIAI;3239370561;Taip;0;5;5;10
11871;Vėrinėlis;VARPELIAI;1894717954;Ne;4;0;0;4
11872;Vėrinėlis;VARPELIAI;3667953591;Taip;10;0;0;10
11873;Vėrinėlis;VARPELIAI;8318388772;Taip;6;0;0;6
11874;Vėrinėlis;VARPELIAI;4191386053;Taip;5;8;0;13
11875;Vėrinėlis;VARPELIAI;2633143128;Taip;2;0;0;2
11876;Vėrinėlis;BORUŽĖLĖS;54666417396;Taip;5;5;0;10
11877;Vėrinėlis;BORUŽĖLĖS;57498275265;Taip;0;10;0;10
11878;Vėrinėlis;BORUŽĖLĖS;3703886468;Taip;7;0;0;7
11879;Vėrinėlis;BORUŽĖLĖS;1410929889;Taip;10;6;0;16
11880;Vėrinėlis;BORUŽĖLĖS;65408541019;Ne;12;4;0;16
11881;Vėrinėlis;BORUŽĖLĖS;22726982138;Taip;10;5;0;15
11882;Vėrinėlis;BORUŽĖLĖS;30611731645;Taip;0;3;0;3
11883;Vėrinėlis;BORUŽĖLĖS;39884473503;Taip;10;0;0;10
11884;Vėrinėlis;BORUŽĖLĖS;25071096491;Taip;0;9;0;9
11885;Vėrinėlis;BORUŽĖLĖS;67282950717;Taip;11;0;0;11
11886;Vėrinėlis;BORUŽĖLĖS;7431541945;Taip;8;1;0;9
11887;Vėrinėlis;BORUŽĖLĖS;90264493281;Taip;0;3;0;3
11888;Vėrinėlis;BORUŽĖLĖS;89785057363;Taip;0;19;0;19
11889;Vėrinėlis;BORUŽĖLĖS;1028568095;Taip;14;2;0;16
11890;Vėrinėlis;BORUŽĖLĖS;4789626884;Taip;0;0;6;6
11891;Vėrinėlis;BORUŽĖLĖS;90979069296;Taip;11;0;0;11
11892;Vėrinėlis;BORUŽĖLĖS;67987598880;Taip;0;9;0;9
11893;Vėrinėlis;BORUŽĖLĖS;73256255966;Taip;0;0;2;2
11894;Vėrinėlis;SVEIKUOLIAI;87606501349;Taip;0;0;3;3
11895;Vėrinėlis;SVEIKUOLIAI;19865450007;Taip;5;0;3;8
11896;Vėrinėlis;SVEIKUOLIAI;6869951613;Taip;2;0;0;2
11897;Vėrinėlis;SVEIKUOLIAI;1865151493;Taip;0;0;2;2
11898;Vėrinėlis;SVEIKUOLIAI;1395590011;Ne;8;0;0;8
11899;Vėrinėlis;SVEIKUOLIAI;3975934329;Taip;8;0;0;8
11900;Vėrinėlis;SVEIKUOLIAI;9751037428;Ne;0;8;0;8
11901;Vėrinėlis;SVEIKUOLIAI;1513856520;Taip;10;0;1;11
11902;Vėrinėlis;SVEIKUOLIAI;3562371502;Taip;6;0;0;6
11903;Vėrinėlis;SVEIKUOLIAI;4089567420;Ne;0;0;4;4
11904;Vėrinėlis;SVEIKUOLIAI;5960946826;Taip;11;3;0;14
11905;Vėrinėlis;SVEIKUOLIAI;5496928903;Taip;10;2;0;12
11906;Vėrinėlis;SVEIKUOLIAI;7865276052;Taip;0;0;8;8
11907;Vėrinėlis;SVEIKUOLIAI;7981261038;Taip;12;0;0;12
11908;Vėrinėlis;SVEIKUOLIAI;6278738058;Taip;5;0;1;6
11909;Vėrinėlis;SVEIKUOLIAI;5511584499;Taip;5;12;0;17
11910;Vėrinėlis;SVEIKUOLIAI;6644892686;Taip;10;5;0;15
11911;Vėrinėlis;SVEIKUOLIAI;4958359640;Taip;13;0;0;13
11912;Vėrinėlis;SVEIKUOLIAI;1338287524;Taip;7;5;0;12
11913;Vėrinėlis;ŠIRDELĖS;8579819581;Taip;15;3;0;18
11914;Vėrinėlis;ŠIRDELĖS;2944010445;Taip;0;14;0;14
11915;Vėrinėlis;ŠIRDELĖS;96779456411;Taip;0;0;2;2
11916;Vėrinėlis;ŠIRDELĖS;7167034587;Taip;2;5;0;7
11917;Vėrinėlis;ŠIRDELĖS;3049346950;Taip;14;0;3;17
11918;Vėrinėlis;ŠIRDELĖS;7070058961;Taip;12;0;0;12
11919;Vėrinėlis;ŠIRDELĖS;7130691686;Taip;10;0;0;10
11920;Vėrinėlis;ŠIRDELĖS;8709714647;Taip;8;0;0;8
11921;Vėrinėlis;ŠIRDELĖS;3308843618;Taip;8;1;0;9
11922;Vėrinėlis;ŠIRDELĖS;85262495209;Ne;0;9;0;9
11923;Vėrinėlis;ŠIRDELĖS;4039903678;Taip;14;0;0;14
11924;Vėrinėlis;ŠIRDELĖS;9119967823;Taip;0;0;1;1
11925;Vėrinėlis;ŠIRDELĖS;1467899937;Taip;8;12;0;20
11926;Vėrinėlis;ŠIRDELĖS;7634939364;Taip;10;2;0;12
11927;Vėrinėlis;ŠIRDELĖS;42298331453;Taip;0;2;0;2
11928;Vėrinėlis;ŠIRDELĖS;54361215161;Taip;8;0;1;9
11929;Vėrinėlis;ŠIRDELĖS;1135386852;Taip;17;0;0;17
11930;Vėrinėlis;ŠIRDELĖS;1535567719;Taip;6;4;0;10
11931;Viltenė;Drugeliai;7961006993;Taip;0;3;0;3
11932;Viltenė;Drugeliai;79464006792;Taip;0;8;0;8
11933;Viltenė;Drugeliai;70813966825;Taip;0;7;0;7
11934;Viltenė;Drugeliai;1936464823;Taip;4;1;0;5
11935;Viltenė;Drugeliai;50489733849;Ne;0;5;0;5
11936;Viltenė;Drugeliai;69838945768;Ne;3;0;0;3
11937;Viltenė;Drugeliai;54422258148;Taip;0;1;0;1
11938;Viltenė;Drugeliai;4322306031;Taip;0;4;0;4
11939;Viltenė;Drugeliai;82849073169;Taip;6;0;0;6
11940;Viltenė;Drugeliai;39676814294;Ne;0;6;0;6
11941;Viltenė;Drugeliai;47885567334;Taip;0;7;0;7
11942;Viltenė;Drugeliai;1155378470;Taip;0;6;0;6
11943;Viltenė;Drugeliai;68110722913;Taip;0;4;0;4
11944;Viltenė;Drugeliai;21489308130;Taip;12;0;0;12
11945;Viltenė;Drugeliai;16461652415;Taip;6;6;0;12
11946;Viltenė;Drugeliai;91847807834;Taip;0;7;0;7
11947;Viltenė;Drugeliai;34691221253;Ne;5;10;0;15
11948;Viltenė;Drugeliai;75637599543;Taip;0;1;0;1
11949;Viltenė;Drugeliai;33159619580;Taip;7;2;0;9
11950;Viltenė;Drugeliai;4586042895;Taip;0;2;0;2
11951;Viltenė;Drugeliai;7169597620;Taip;0;1;0;1
11952;Viltenė;Drugeliai;1739353382;Taip;0;7;0;7
11953;Viltenė;Bitučių;1747442313;Taip;0;7;0;7
11954;Viltenė;Bitučių;61093082990;Ne;0;9;0;9
11955;Viltenė;Bitučių;2046122804;Taip;0;7;0;7
11956;Viltenė;Bitučių;74464437862;Taip;0;16;0;16
11957;Viltenė;Bitučių;93664116601;Ne;0;7;0;7
11958;Viltenė;Bitučių;66587678111;Taip;0;5;0;5
11959;Viltenė;Bitučių;65252989761;Taip;0;9;0;9
11960;Viltenė;Bitučių;1702925444;Taip;0;7;0;7
11961;Viltenė;Bitučių;6006470515;Taip;0;7;0;7
11962;Viltenė;Bitučių;8985943715;Taip;0;2;0;2
11963;Viltenė;Bitučių;1656026241;Taip;5;2;0;7
11964;Viltenė;Bitučių;4554162475;Taip;10;0;0;10
11965;Viltenė;Bitučių;1291605426;Taip;0;2;0;2
11966;Viltenė;Bitučių;6322746293;Taip;0;13;0;13
11967;Viltenė;Bitučių;4334881910;Taip;0;5;0;5
11968;Viltenė;Boružėlių;97823483581;Taip;0;7;0;7
11969;Viltenė;Boružėlių;27743584566;Taip;0;1;0;1
11970;Viltenė;Boružėlių;1657346055;Taip;0;6;0;6
11971;Viltenė;Boružėlių;24165965719;Taip;0;6;0;6
11972;Viltenė;Boružėlių;62046262871;Ne;0;1;0;1
11973;Viltenė;Boružėlių;45338320216;Taip;0;8;0;8
11974;Viltenė;Boružėlių;9858448228;Ne;0;5;0;5
11975;Viltenė;Boružėlių;58371160698;Taip;0;10;0;10
11976;Viltenė;Boružėlių;50651685299;Taip;1;0;0;1
11977;Viltenė;Boružėlių;43591393680;Taip;0;9;0;9
11978;Viltenė;Boružėlių;4053036431;Taip;0;1;0;1
11979;Viltenė;Boružėlių;27950438672;Taip;0;3;0;3
11980;Viltenė;Boružėlių;73607402351;Taip;0;6;0;6
11981;Viltenė;Boružėlių;1963420643;Taip;9;1;0;10
11982;Viltenė;Boružėlių;4361513192;Taip;0;5;0;5
11983;Viltenė;Gandriukų;48816849840;Taip;6;6;0;12
11984;Viltenė;Gandriukų;65109318544;Taip;0;2;0;2
11985;Viltenė;Gandriukų;64883562677;Taip;0;4;0;4
11986;Viltenė;Gandriukų;14178563941;Taip;0;2;0;2
11987;Viltenė;Gandriukų;55479966961;Ne;0;6;0;6
11988;Viltenė;Gandriukų;69267964826;Taip;0;4;0;4
11989;Viltenė;Gandriukų;54622802635;Ne;0;1;5;6
11990;Viltenė;Gandriukų;96889901141;Taip;0;2;0;2
11991;Viltenė;Gandriukų;35607778200;Taip;0;1;0;1
11992;Viltenė;Gandriukų;40901810557;Ne;11;1;0;12
11993;Viltenė;Gandriukų;33038163612;Taip;0;2;0;2
11994;Viltenė;Gandriukų;69157590882;Taip;5;0;0;5
11995;Viltenė;Gandriukų;16356755996;Ne;4;0;0;4
11996;Viltenė;Gandriukų;34334946258;Taip;0;4;0;4
11997;Viltenė;Gandriukų;50612310300;Taip;4;4;0;8
11998;Viltenė;Gandriukų;1487205453;Taip;0;1;0;1
11999;Viltenė;Gandriukų;1898136396;Taip;0;1;0;1
12000;Viltenė;Gandriukų;98690857297;Ne;0;1;0;1
12001;Viltenė;Aitvariukai;8367775964;Taip;0;2;0;2
12002;Viltenė;Aitvariukai;95537304111;Taip;0;7;2;9
12003;Viltenė;Aitvariukai;95502667008;Taip;0;10;0;10
12004;Viltenė;Aitvariukai;51598096361;Taip;0;12;0;12
12005;Viltenė;Aitvariukai;15218988953;Taip;0;13;0;13
12006;Viltenė;Aitvariukai;9155192250;Taip;0;8;3;11
12007;Viltenė;Aitvariukai;5304966336;Taip;0;6;0;6
12008;Viltenė;Aitvariukai;3057761137;Ne;0;14;0;14
12009;Viltenė;Aitvariukai;6160715081;Taip;0;22;0;22
12010;Viltenė;Aitvariukai;5919786939;Taip;0;3;0;3
12011;Viltenė;Aitvariukai;17844870669;Taip;0;7;0;7
12012;Viltenė;Aitvariukai;56293220882;Taip;0;1;1;2
12013;Viltenė;Aitvariukai;8259812812;Taip;0;3;0;3
12014;Viltenė;Aitvariukai;23233966729;Taip;0;0;4;4
12015;Viltenė;Aitvariukai;44367763042;Taip;0;7;0;7
12016;Viltenė;Aitvariukai;99398043638;Taip;7;12;0;19
12017;Viltenė;Aitvariukai;55514676697;Taip;0;10;3;13
12018;Viltenė;Aitvariukai;14831307307;Taip;0;7;0;7
12019;Viltenė;Geniukų;5604263567;Taip;0;3;0;3
12020;Viltenė;Geniukų;1822220265;Taip;12;10;0;22
12021;Viltenė;Geniukų;9613791189;Taip;0;7;0;7
12022;Viltenė;Geniukų;6349032936;Taip;0;1;0;1
12023;Viltenė;Geniukų;7537754249;Taip;8;1;0;9
12024;Viltenė;Geniukų;1423254631;Ne;6;0;0;6
12025;Viltenė;Geniukų;3002690526;Taip;15;0;0;15
12026;Viltenė;Geniukų;6276349499;Taip;14;3;0;17
12027;Viltenė;Geniukų;3711956659;Taip;5;11;0;16
12028;Viltenė;Geniukų;1054469254;Taip;9;0;0;9
12029;Viltenė;Geniukų;4295285885;Taip;4;8;0;12
12030;Viltenė;Geniukų;6063181025;Taip;5;0;0;5
12031;Viltenė;Geniukų;1672091332;Ne;10;0;0;10
12032;Viltenė;Geniukų;9396183748;Taip;8;0;0;8
12033;Viltenė;Geniukų;3018271511;Taip;0;3;0;3
12034;Viltenė;Geniukų;49998813869;Taip;0;1;0;1
12035;Viltenė;Geniukų;3389110405;Taip;0;9;0;9
12036;Viltenė;Geniukų;4319685140;Taip;10;2;0;12
12037;Viltenė;Geniukų;6693601673;Taip;12;0;0;12
12038;Viltenė;Geniukų;8329611036;Taip;11;2;0;13
12039;Viltenė;Geniukų;8125023386;Taip;16;0;0;16
12040;Viltenė;Geniukų;8085993647;Taip;10;0;0;10
12041;Viltenė;Geniukų;9035687504;Taip;10;1;0;11
12042;Viltenė;Geniukų;5664573939;Taip;0;22;0;22
12043;Viltenė;Saulutės;2044754943;Taip;14;0;0;14
12044;Viltenė;Saulutės;6848403057;Taip;0;4;0;4
12045;Viltenė;Saulutės;1615415742;Taip;0;7;0;7
12046;Viltenė;Saulutės;7994367286;Taip;0;4;0;4
12047;Viltenė;Saulutės;6664059418;Taip;2;0;0;2
12048;Viltenė;Saulutės;2141002432;Taip;0;20;0;20
12049;Viltenė;Saulutės;8920533673;Taip;1;2;0;3
12050;Viltenė;Saulutės;5024192785;Taip;0;13;0;13
12051;Viltenė;Saulutės;92968672028;Taip;0;7;0;7
12052;Viltenė;Saulutės;3031926564;Taip;0;2;0;2
12053;Viltenė;Saulutės;1918867591;Taip;0;21;0;21
12054;Viltenė;Saulutės;1844509355;Taip;20;0;0;20
12055;Viltenė;Saulutės;7559243300;Taip;10;6;0;16
12056;Viltenė;Saulutės;8512665706;Taip;2;0;0;2
12057;Viltenė;Saulutės;3560474943;Taip;0;1;0;1
12058;Viltenė;Saulutės;2840208662;Taip;0;2;0;2
12059;Viltenė;Saulutės;1252657362;Taip;6;0;0;6
12060;Viltenė;Saulutės;2559945034;Taip;0;5;0;5
12061;Viltenė;Saulutės;2546789906;Taip;0;22;0;22
12062;Viltenė;Saulutės;3401975301;Taip;0;5;0;5
12063;Viltenė;Saulutės;9381280809;Taip;0;22;0;22
12064;Viltenė;Saulutės;9055821628;Taip;9;0;0;9
12065;Viltenė;Saulutės;9858998005;Taip;9;0;0;9
12066;Viltenė;Saulutės;7726650894;Taip;0;19;0;19
12067;Viltenė;Saulutės;3709362712;Taip;7;0;0;7
12068;Viltenė;Saulutės;1841732416;Taip;9;1;0;10
12069;Viltenė;Lapiukų;2016636764;Taip;1;0;0;1
12070;Viltenė;Lapiukų;1650304982;Taip;10;0;0;10
12071;Viltenė;Lapiukų;89844531860;Taip;0;1;0;1
12072;Viltenė;Lapiukų;1884043126;Taip;0;4;0;4
12073;Viltenė;Lapiukų;60092202534;Taip;0;2;0;2
12074;Viltenė;Lapiukų;22318027000;Taip;9;0;0;9
12075;Viltenė;Lapiukų;1559623914;Taip;3;5;0;8
12076;Viltenė;Lapiukų;1503728117;Taip;0;7;0;7
12077;Viltenė;Lapiukų;1042196397;Taip;0;4;0;4
12078;Viltenė;Lapiukų;1210824560;Taip;1;7;0;8
12079;Viltenė;Lapiukų;2065651722;Taip;5;7;0;12
12080;Viltenė;Lapiukų;87698700338;Taip;3;1;0;4
12081;Viltenė;Lapiukų;3526237179;Taip;9;3;0;12
12082;Viltenė;Lapiukų;1662950901;Taip;10;2;0;12
12083;Viltenė;Lapiukų;1350487577;Taip;15;2;0;17
12084;Viltenė;Lapiukų;1592077335;Taip;0;17;0;17
12085;Viltenė;Lapiukų;1281808784;Taip;16;0;0;16
12086;Viltenė;Lapiukų;1726174128;Taip;0;1;0;1
12087;Viltenė;Lapiukų;4470172666;Taip;9;2;0;11
12088;Viltenė;Lapiukų;2527648089;Taip;9;1;0;10
12089;Viltenė;Lapiukų;93894985640;Taip;7;5;0;12
12090;Viltenė;Lapiukų;3259114583;Taip;0;14;0;14
12091;Viltenė;Voveriukai;13795858727;Ne;0;7;0;7
12092;Viltenė;Voveriukai;1306624353;Taip;9;0;0;9
12093;Viltenė;Voveriukai;41763338811;Taip;0;7;0;7
12094;Viltenė;Voveriukai;46757944454;Ne;7;0;0;7
12095;Viltenė;Voveriukai;76569470768;Taip;0;1;0;1
12096;Viltenė;Voveriukai;69882566734;Taip;2;3;0;5
12097;Viltenė;Voveriukai;7245395388;Ne;0;1;0;1
12098;Viltenė;Voveriukai;77847693433;Taip;0;3;0;3
12099;Viltenė;Voveriukai;92175043385;Taip;4;5;0;9
12100;Viltenė;Voveriukai;35466181637;Ne;8;2;0;10
12101;Viltenė;Voveriukai;68243828276;Taip;0;7;0;7
12102;Viltenė;Voveriukai;87296434240;Taip;0;2;0;2
12103;Viltenė;Voveriukai;5357769446;Taip;0;2;0;2
12104;Viltenė;Voveriukai;51997485918;Ne;0;8;0;8
12105;Viltenė;Voveriukai;1872042290;Taip;0;8;0;8
12106;Viltenė;Voveriukai;1926586646;Ne;0;1;0;1
12107;Viltenė;Voveriukai;2008408325;Ne;0;12;0;12
12108;Viltenė;Voveriukai;4441280059;Taip;0;8;0;8
12109;Viltenė;Triušikai;5280690534;Taip;0;0;1;1
12110;Viltenė;Triušikai;9242034622;Taip;3;0;0;3
12111;Viltenė;Triušikai;4604298036;Taip;0;6;0;6
12112;Viltenė;Triušikai;8110413064;Taip;10;0;0;10
12113;Viltenė;Triušikai;7693789849;Taip;22;0;0;22
12114;Viltenė;Triušikai;4036109404;Taip;7;0;0;7
12115;Viltenė;Triušikai;9756519374;Taip;20;0;0;20
12116;Viltenė;Triušikai;9820462941;Taip;5;0;0;5
12117;Viltenė;Triušikai;7928894276;Taip;18;0;0;18
12118;Viltenė;Triušikai;8527270437;Taip;0;1;0;1
12119;Viltenė;Triušikai;6621273812;Taip;11;0;0;11
12120;Viltenė;Triušikai;1598785483;Taip;12;0;0;12
12121;Viltenė;Triušikai;3073228245;Taip;15;0;1;16
12122;Viltenė;Triušikai;2383607612;Taip;4;8;0;12
12123;Viltenė;Triušikai;4195708756;Taip;18;0;0;18
12124;Viltenė;Triušikai;9197007374;Taip;0;0;1;1
12125;Viltenė;Triušikai;5522245968;Taip;10;3;0;13
12126;Viltenė;Kiškučiai;8549631247;Taip;3;0;0;3
12127;Viltenė;Kiškučiai;2884698447;Taip;0;7;0;7
12128;Viltenė;Kiškučiai;6481491422;Taip;0;4;0;4
12129;Viltenė;Kiškučiai;9217178863;Ne;0;4;0;4
12130;Viltenė;Kiškučiai;6555035887;Taip;0;5;0;5
12131;Viltenė;Kiškučiai;9228677568;Taip;20;2;0;22
12132;Viltenė;Kiškučiai;2815105107;Taip;0;2;0;2
12133;Viltenė;Kiškučiai;6511850468;Taip;0;12;0;12
12134;Viltenė;Kiškučiai;8477241365;Taip;11;0;0;11
12135;Viltenė;Kiškučiai;5850652322;Taip;0;5;0;5
12136;Viltenė;Kiškučiai;8840885039;Taip;22;0;0;22
12137;Viltenė;Kiškučiai;4616047113;Taip;2;0;0;2
12138;Viltenė;Kiškučiai;6060648988;Taip;14;4;0;18
12139;Viltenė;Kiškučiai;7796422726;Taip;0;4;0;4
12140;Viltenė;Nykštukų;4003018966;Taip;9;0;0;9
12141;Viltenė;Nykštukų;7912396297;Ne;0;11;0;11
12142;Viltenė;Nykštukų;3738838707;Ne;0;0;1;1
12143;Viltenė;Nykštukų;3777544301;Taip;6;0;1;7
12144;Viltenė;Nykštukų;9597857664;Taip;0;0;4;4
12145;Viltenė;Nykštukų;6642790962;Taip;5;0;0;5
12146;Viltenė;Nykštukų;9572407405;Taip;0;0;1;1
12147;Viltenė;Nykštukų;8473588098;Taip;8;2;0;10
12148;Viltenė;Nykštukų;3995418079;Ne;11;0;0;11
12149;Viltenė;Nykštukų;1399653129;Taip;1;0;0;1
12150;Viltenė;Nykštukų;4121448859;Taip;0;11;0;11
12151;Viltenė;Nykštukų;5599943846;Taip;15;0;0;15
12152;Viltenė;Nykštukų;3164402142;Taip;0;0;1;1
12153;Viltenė;Nykštukų;5379804362;Taip;0;0;1;1
12154;Viltenė;Nykštukų;1936628249;Taip;0;1;0;1
12155;Viltenė;Nykštukų;6721689684;Taip;0;3;0;3
12156;Viltenė;Nykštukų;7526555727;Taip;13;0;0;13
12157;Viltenė;Nykštukų;5552217000;Taip;0;1;0;1
12158;Voveraitė;ŽVIRBLIUKŲ;12366200545;Taip;0;1;0;1
12159;Voveraitė;ŽVIRBLIUKŲ;34170702690;Taip;0;1;0;1
12160;Voveraitė;ŽVIRBLIUKŲ;37044398892;Taip;0;1;0;1
12161;Voveraitė;ŽVIRBLIUKŲ;90970378921;Taip;0;2;0;2
12162;Voveraitė;ŽVIRBLIUKŲ;6903776113;Taip;0;13;0;13
12163;Voveraitė;ŽVIRBLIUKŲ;14865004407;Taip;0;1;0;1
12164;Voveraitė;ŽVIRBLIUKŲ;39956224681;Taip;0;16;0;16
12165;Voveraitė;ŽVIRBLIUKŲ;1261834247;Taip;0;13;0;13
12166;Voveraitė;ŽVIRBLIUKŲ;1055423524;Taip;0;1;0;1
12167;Voveraitė;ŽVIRBLIUKŲ;3137529068;Taip;0;6;0;6
12168;Voveraitė;ŽVIRBLIUKŲ;65838266846;Taip;0;4;0;4
12169;Voveraitė;ŽVIRBLIUKŲ;5357569948;Taip;0;3;0;3
12170;Voveraitė;VOVERIUKŲ;26264960973;Taip;0;1;0;1
12171;Voveraitė;VOVERIUKŲ;46318035221;Taip;4;0;0;4
12172;Voveraitė;VOVERIUKŲ;3818120898;Taip;6;13;0;19
12173;Voveraitė;VOVERIUKŲ;90300459408;Taip;0;2;0;2
12174;Voveraitė;VOVERIUKŲ;57033218205;Taip;15;5;0;20
12175;Voveraitė;VOVERIUKŲ;64724933885;Taip;0;3;0;3
12176;Voveraitė;VOVERIUKŲ;1587569563;Taip;0;2;0;2
12177;Voveraitė;VOVERIUKŲ;89873985894;Taip;0;7;0;7
12178;Voveraitė;VOVERIUKŲ;89216481616;Taip;0;5;0;5
12179;Voveraitė;VOVERIUKŲ;69797506996;Taip;0;7;0;7
12180;Voveraitė;VOVERIUKŲ;76074825733;Taip;14;1;0;15
12181;Voveraitė;VOVERIUKŲ;49205285378;Taip;0;6;0;6
12182;Voveraitė;VOVERIUKŲ;84508228457;Taip;5;8;0;13
12183;Voveraitė;VOVERIUKŲ;61376515242;Taip;0;4;0;4
12184;Voveraitė;VOVERIUKŲ;47111956594;Taip;10;3;0;13
12185;Voveraitė;VOVERIUKŲ;16514161872;Taip;8;0;0;8
12186;Voveraitė;VOVERIUKŲ;22913200509;Taip;10;0;0;10
12187;Voveraitė;VOVERIUKŲ;26080915874;Taip;5;4;0;9
12188;Voveraitė;VOVERIUKŲ;59442802443;Taip;5;2;0;7
12189;Voveraitė;VOVERIUKŲ;1398043988;Taip;1;2;0;3
12190;Voveraitė;VOVERIUKŲ;53801893219;Ne;0;8;0;8
12191;Voveraitė;KIŠKUČIŲ;3615729576;Ne;12;4;0;16
12192;Voveraitė;KIŠKUČIŲ;9231751171;Taip;0;7;0;7
12193;Voveraitė;KIŠKUČIŲ;4338861332;Taip;0;3;0;3
12194;Voveraitė;KIŠKUČIŲ;9933037872;Taip;10;0;0;10
12195;Voveraitė;KIŠKUČIŲ;3113780055;Taip;16;1;0;17
12196;Voveraitė;KIŠKUČIŲ;7069780513;Taip;9;3;0;12
12197;Voveraitė;KIŠKUČIŲ;9997346812;Taip;22;0;0;22
12198;Voveraitė;KIŠKUČIŲ;9703726869;Taip;6;0;0;6
12199;Voveraitė;KIŠKUČIŲ;7314148938;Taip;10;5;0;15
12200;Voveraitė;KIŠKUČIŲ;4511771924;Taip;10;5;0;15
12201;Voveraitė;KIŠKUČIŲ;5521756833;Taip;22;0;0;22
12202;Voveraitė;KIŠKUČIŲ;9007031372;Taip;14;0;0;14
12203;Voveraitė;KIŠKUČIŲ;6369860178;Taip;20;0;0;20
12204;Voveraitė;KIŠKUČIŲ;6649068571;Taip;13;1;0;14
12205;Voveraitė;KIŠKUČIŲ;1775800865;Taip;6;6;0;12
12206;Voveraitė;KIŠKUČIŲ;6433760749;Ne;11;3;0;14
12207;Voveraitė;KODĖLČIUKŲ;3469734853;Taip;0;0;3;3
12208;Voveraitė;KODĖLČIUKŲ;9117809080;Taip;0;5;0;5
12209;Voveraitė;KODĖLČIUKŲ;5467979968;Taip;22;0;0;22
12210;Voveraitė;KODĖLČIUKŲ;1772758517;Ne;17;3;0;20
12211;Voveraitė;KODĖLČIUKŲ;51213803814;Taip;0;3;0;3
12212;Voveraitė;KODĖLČIUKŲ;36749754999;Taip;0;1;0;1
12213;Voveraitė;KODĖLČIUKŲ;4045121781;Taip;5;4;0;9
12214;Voveraitė;KODĖLČIUKŲ;2304004487;Taip;2;0;0;2
12215;Voveraitė;KODĖLČIUKŲ;2208396431;Taip;5;2;0;7
12216;Voveraitė;KODĖLČIUKŲ;6361417566;Taip;4;0;0;4
12217;Voveraitė;KODĖLČIUKŲ;5296850349;Taip;0;9;0;9
12218;Voveraitė;KODĖLČIUKŲ;2763656717;Taip;0;10;0;10
12219;Voveraitė;KODĖLČIUKŲ;4468214107;Taip;5;9;0;14
12220;Voveraitė;KODĖLČIUKŲ;9921313716;Taip;0;0;6;6
12221;Voveraitė;KODĖLČIUKŲ;5449490074;Ne;0;0;10;10
12222;Voveraitė;KODĖLČIUKŲ;7786378018;Ne;0;0;3;3
12223;Voveraitė;MEŠKIUKŲ;4079618555;Taip;0;4;0;4
12224;Voveraitė;MEŠKIUKŲ;3987058753;Taip;0;8;0;8
12225;Voveraitė;MEŠKIUKŲ;3381417855;Taip;0;5;0;5
12226;Voveraitė;MEŠKIUKŲ;3703062195;Taip;8;3;0;11
12227;Voveraitė;MEŠKIUKŲ;8438876806;Taip;12;2;0;14
12228;Voveraitė;MEŠKIUKŲ;1058273156;Taip;0;9;0;9
12229;Voveraitė;MEŠKIUKŲ;9149748841;Taip;0;7;0;7
12230;Voveraitė;MEŠKIUKŲ;1629942114;Taip;0;3;0;3
12231;Voveraitė;MEŠKIUKŲ;6359983706;Taip;0;4;0;4
12232;Voveraitė;MEŠKIUKŲ;1592633500;Taip;10;7;0;17
12233;Voveraitė;MEŠKIUKŲ;5437283673;Taip;5;1;0;6
12234;Voveraitė;MEŠKIUKŲ;7797966139;Taip;7;10;0;17
12235;Voveraitė;MEŠKIUKŲ;3029983180;Taip;0;7;0;7
12236;Voveraitė;MEŠKIUKŲ;9900940313;Taip;1;2;0;3
12237;Voveraitė;MEŠKIUKŲ;4680264973;Ne;1;9;0;10
12238;Voveraitė;MEŠKIUKŲ;5095849577;Taip;4;2;0;6
12239;Voveraitė;MEŠKIUKŲ;6886337758;Taip;2;15;0;17
12240;Voveraitė;BORUŽĖLIŲ;97620560960;Ne;11;0;0;11
12241;Voveraitė;BORUŽĖLIŲ;81073619227;Taip;0;4;0;4
12242;Voveraitė;BORUŽĖLIŲ;77602038332;Taip;6;0;0;6
12243;Voveraitė;BORUŽĖLIŲ;66403987802;Taip;0;1;1;2
12244;Voveraitė;BORUŽĖLIŲ;89152921324;Taip;0;5;0;5
12245;Voveraitė;BORUŽĖLIŲ;34369856708;Taip;0;12;0;12
12246;Voveraitė;BORUŽĖLIŲ;97109418554;Taip;0;4;0;4
12247;Voveraitė;BORUŽĖLIŲ;90671659606;Taip;0;2;0;2
12248;Voveraitė;BORUŽĖLIŲ;32041841165;Taip;0;1;0;1
12249;Voveraitė;BORUŽĖLIŲ;95730702606;Ne;0;2;0;2
12250;Voveraitė;BORUŽĖLIŲ;4440929639;Taip;0;5;10;15
12251;Voveraitė;BORUŽĖLIŲ;14945425849;Ne;0;1;0;1
12252;Voveraitė;BORUŽĖLIŲ;63634109515;Taip;0;1;0;1
12253;Voveraitė;BORUŽĖLIŲ;31214112756;Taip;1;0;0;1
12254;Voveraitė;BORUŽĖLIŲ;36024562927;Taip;0;1;0;1
12255;Voveraitė;BORUŽĖLIŲ;9288862466;Taip;0;2;0;2
12256;Voveraitė;PELĖDŽIUKŲ;59718931996;Taip;0;1;0;1
12257;Voveraitė;PELĖDŽIUKŲ;86565940690;Taip;0;2;0;2
12258;Voveraitė;PELĖDŽIUKŲ;2611108856;Taip;0;6;0;6
12259;Voveraitė;PELĖDŽIUKŲ;2009943498;Taip;2;0;0;2
12260;Voveraitė;PELĖDŽIUKŲ;3114586597;Taip;0;3;0;3
12261;Voveraitė;PELĖDŽIUKŲ;76432985710;Taip;0;3;0;3
12262;Voveraitė;PELĖDŽIUKŲ;74161507529;Ne;0;2;0;2
12263;Voveraitė;PELĖDŽIUKŲ;85594406820;Taip;0;2;0;2
12264;Voveraitė;PELĖDŽIUKŲ;30591405375;Taip;0;18;0;18
12265;Voveraitė;PELĖDŽIUKŲ;42683378356;Taip;5;1;0;6
12266;Voveraitė;PELĖDŽIUKŲ;5232316253;Taip;0;2;0;2
12267;Voveraitė;PELĖDŽIUKŲ;32030461873;Taip;0;1;0;1
12268;Voveraitė;PELĖDŽIUKŲ;1273652060;Ne;0;1;0;1
12269;Voveraitė;PELĖDŽIUKŲ;68050017530;Taip;0;7;0;7
12270;Voveraitė;PELĖDŽIUKŲ;86045196465;Taip;0;3;0;3
12271;Voveraitė;DRUGELIŲ;9623406874;Taip;0;4;0;4
12272;Voveraitė;DRUGELIŲ;1753442884;Taip;5;13;0;18
12273;Voveraitė;DRUGELIŲ;63032690186;Taip;0;3;0;3
12274;Voveraitė;DRUGELIŲ;7974406524;Taip;0;11;0;11
12275;Voveraitė;DRUGELIŲ;2044914624;Taip;6;8;0;14
12276;Voveraitė;DRUGELIŲ;5037713667;Taip;0;2;0;2
12277;Voveraitė;DRUGELIŲ;2031078156;Taip;4;1;0;5
12278;Voveraitė;DRUGELIŲ;80330740714;Taip;5;0;0;5
12279;Voveraitė;DRUGELIŲ;6729475469;Taip;5;6;0;11
12280;Voveraitė;DRUGELIŲ;1397274691;Ne;17;5;0;22
12281;Voveraitė;DRUGELIŲ;1612322367;Taip;0;7;0;7
12282;Voveraitė;DRUGELIŲ;6847620019;Taip;0;15;0;15
12283;Voveraitė;DRUGELIŲ;53507758884;Taip;0;4;0;4
12284;Voveraitė;DRUGELIŲ;1780573926;Taip;0;6;0;6
12285;Voveraitė;DRUGELIŲ;8443005812;Taip;0;1;0;1
12286;Voveraitė;NYKŠTUKŲ;59346262217;Taip;0;10;0;10
12287;Voveraitė;NYKŠTUKŲ;44115826781;Taip;0;1;0;1
12288;Voveraitė;NYKŠTUKŲ;28656009009;Taip;0;5;0;5
12289;Voveraitė;NYKŠTUKŲ;1704834744;Taip;0;2;0;2
12290;Voveraitė;NYKŠTUKŲ;49924157014;Taip;0;4;0;4
12291;Voveraitė;NYKŠTUKŲ;41182124889;Taip;1;2;0;3
12292;Voveraitė;NYKŠTUKŲ;13173711840;Taip;13;0;0;13
12293;Voveraitė;NYKŠTUKŲ;602726070;Taip;0;1;0;1
12294;Voveraitė;NYKŠTUKŲ;27132982320;Taip;0;2;0;2
12295;Voveraitė;NYKŠTUKŲ;107968318;Taip;3;2;0;5
12296;Voveraitė;NYKŠTUKŲ;2762066479;Taip;0;6;0;6
12297;Voveraitė;NYKŠTUKŲ;66612277823;Taip;6;4;0;10
12298;Voveraitė;NYKŠTUKŲ;1022447432;Taip;0;17;0;17
12299;Voveraitė;NYKŠTUKŲ;8666880821;Taip;0;14;0;14
12300;Voveraitė;NYKŠTUKŲ;2051732666;Taip;15;4;0;19
12301;Voveraitė;GENIUKŲ;23764078403;Taip;0;3;0;3
12302;Voveraitė;GENIUKŲ;29342867028;Taip;0;1;0;1
12303;Voveraitė;GENIUKŲ;78138420154;Taip;0;3;0;3
12304;Voveraitė;GENIUKŲ;18103338554;Taip;0;1;0;1
12305;Voveraitė;GENIUKŲ;92953475852;Taip;0;1;0;1
12306;Voveraitė;GENIUKŲ;3092390110;Taip;0;6;0;6
12307;Voveraitė;GENIUKŲ;6272832397;Taip;0;14;0;14
12308;Voveraitė;GENIUKŲ;90596813791;Taip;0;1;0;1
12309;Voveraitė;GENIUKŲ;1281767120;Taip;0;2;0;2
12310;Voveraitė;GENIUKŲ;52600331650;Taip;0;8;0;8
12311;Voveraitė;GENIUKŲ;69003610735;Taip;0;5;0;5
12312;Voveraitė;GENIUKŲ;9980142483;Taip;0;1;0;1
12313;Voveraitė;GENIUKŲ;1279597695;Taip;14;2;0;16
12314;Voveraitė;GENIUKŲ;59078135624;Taip;0;2;0;2
12315;Voveraitė;GENIUKŲ;57470452892;Taip;0;3;0;3
12316;Voveraitė;GENIUKŲ;28782803101;Taip;0;6;0;6
12317;Voveraitė;GENIUKŲ;67618706684;Taip;0;14;0;14
12318;Voveraitė;LAPIUKŲ;8925151080;Taip;7;0;2;9
12319;Voveraitė;LAPIUKŲ;4300235743;Taip;12;0;0;12
12320;Voveraitė;LAPIUKŲ;6684234832;Taip;0;9;6;15
12321;Voveraitė;LAPIUKŲ;1441921029;Taip;4;0;0;4
12322;Voveraitė;LAPIUKŲ;8119493388;Taip;10;0;0;10
12323;Voveraitė;LAPIUKŲ;5804351872;Taip;0;0;2;2
12324;Voveraitė;LAPIUKŲ;2450726148;Taip;0;13;0;13
12325;Voveraitė;LAPIUKŲ;7531020548;Taip;12;3;0;15
12326;Voveraitė;LAPIUKŲ;7244142828;Taip;5;16;0;21
12327;Voveraitė;LAPIUKŲ;5510544648;Taip;0;0;6;6
12328;Voveraitė;LAPIUKŲ;3582805599;Taip;5;0;0;5
12329;Voveraitė;LAPIUKŲ;5705303891;Taip;7;5;0;12
12330;Voveraitė;LAPIUKŲ;6959751328;Taip;6;2;0;8
12331;Voveraitė;EŽIUKŲ;8373093305;Taip;5;2;0;7
12332;Voveraitė;EŽIUKŲ;7990479988;Taip;0;2;0;2
12333;Voveraitė;EŽIUKŲ;2246291631;Taip;15;2;0;17
12334;Voveraitė;EŽIUKŲ;4324619869;Taip;4;2;0;6
12335;Voveraitė;EŽIUKŲ;1960385335;Ne;22;0;0;22
12336;Voveraitė;EŽIUKŲ;2322594823;Taip;22;0;0;22
12337;Voveraitė;EŽIUKŲ;6007396459;Taip;7;1;0;8
12338;Voveraitė;EŽIUKŲ;2662384275;Taip;0;1;0;1
12339;Voveraitė;EŽIUKŲ;4563198733;Taip;6;9;0;15
12340;Voveraitė;EŽIUKŲ;2594535017;Taip;0;5;0;5
12341;Voveraitė;EŽIUKŲ;9912862474;Taip;0;6;0;6
12342;Voveraitė;EŽIUKŲ;1340379090;Taip;0;6;0;6
12343;Voveraitė;EŽIUKŲ;5138855000;Taip;0;3;0;3
12344;Voveraitė;EŽIUKŲ;9195700962;Taip;0;18;0;18
12345;"Trakų Vokė";Voveriukų;7858812338;Taip;8;0;4;12
12346;"Trakų Vokė";Voveriukų;2730385281;Taip;0;0;2;2
12347;"Trakų Vokė";Voveriukų;4854440884;Taip;22;0;0;22
12348;"Trakų Vokė";Voveriukų;2761614687;Taip;22;0;0;22
12349;"Trakų Vokė";Voveriukų;6234943180;Taip;12;0;0;12
12350;"Trakų Vokė";Voveriukų;5909584565;Taip;12;0;0;12
12351;"Trakų Vokė";Voveriukų;3913623741;Taip;5;0;0;5
12352;"Trakų Vokė";Voveriukų;6732422645;Taip;0;0;8;8
12353;"Trakų Vokė";Voveriukų;3209594216;Taip;5;0;1;6
12354;"Trakų Vokė";Voveriukų;5338798362;Taip;7;0;2;9
12355;"Trakų Vokė";Voveriukų;6326568445;Taip;0;1;0;1
12356;"Trakų Vokė";Voveriukų;4040038648;Taip;10;0;2;12
12357;"Trakų Vokė";Voveriukų;7727246187;Ne;0;0;3;3
12358;"Trakų Vokė";Voveriukų;3611639112;Taip;12;0;1;13
12359;"Trakų Vokė";Voveriukų;5206616285;Taip;12;0;1;13
12360;"Trakų Vokė";Boružėlių;84749146259;Taip;0;0;1;1
12361;"Trakų Vokė";Boružėlių;1100961040;Taip;0;0;3;3
12362;"Trakų Vokė";Boružėlių;71993634591;Taip;0;0;2;2
12363;"Trakų Vokė";Boružėlių;1809637955;Taip;1;1;0;2
12364;"Trakų Vokė";Boružėlių;2052523633;Taip;2;0;0;2
12365;"Trakų Vokė";Boružėlių;32336388708;Taip;4;2;0;6
12366;"Trakų Vokė";Boružėlių;39658854196;Taip;13;0;0;13
12367;"Trakų Vokė";Boružėlių;92262591306;Taip;5;0;2;7
12368;"Trakų Vokė";Boružėlių;37080835526;Taip;0;5;0;5
12369;"Trakų Vokė";Boružėlių;9642375918;Taip;13;3;0;16
12370;"Trakų Vokė";Boružėlių;89851471527;Taip;7;6;0;13
12371;"Trakų Vokė";Boružėlių;96632696431;Taip;7;0;0;7
12372;"Trakų Vokė";Boružėlių;1805549433;Taip;0;0;5;5
12373;"Trakų Vokė";Boružėlių;66607811394;Taip;0;0;1;1
12374;"Trakų Vokė";Boružėlių;66867557436;Taip;5;0;3;8
12375;"Trakų Vokė";Boružėlių;68968521202;Taip;0;0;6;6
12376;"Trakų Vokė";Boružėlių;95403241312;Taip;8;8;0;16
12377;"Trakų Vokė";Boružėlių;1837766168;Taip;0;10;0;10
12378;"Trakų Vokė";Boružėlių;2466258377;Ne;0;6;0;6
12379;"Trakų Vokė";BITUTUČIŲ;4903261568;Taip;0;1;3;4
12380;"Trakų Vokė";BITUTUČIŲ;4846130117;Taip;0;0;1;1
12381;"Trakų Vokė";BITUTUČIŲ;1461337199;Taip;8;0;0;8
12382;"Trakų Vokė";BITUTUČIŲ;7792654474;Taip;10;0;0;10
12383;"Trakų Vokė";BITUTUČIŲ;39255784762;Taip;4;0;0;4
12384;"Trakų Vokė";BITUTUČIŲ;1433982328;Ne;13;0;0;13
12385;"Trakų Vokė";BITUTUČIŲ;2918937134;Ne;10;0;2;12
12386;"Trakų Vokė";BITUTUČIŲ;8542147751;Taip;9;0;1;10
12387;"Trakų Vokė";BITUTUČIŲ;1623166260;Taip;10;0;0;10
12388;"Trakų Vokė";BITUTUČIŲ;3406479364;Ne;0;5;0;5
12389;"Trakų Vokė";BITUTUČIŲ;1339594734;Taip;5;0;4;9
12390;"Trakų Vokė";BITUTUČIŲ;95320712086;Taip;14;0;0;14
12391;"Trakų Vokė";BITUTUČIŲ;5526830430;Ne;6;0;5;11
12392;"Trakų Vokė";BITUTUČIŲ;4914675622;Taip;10;0;0;10
12393;"Trakų Vokė";BITUTUČIŲ;1590598232;Taip;16;0;0;16
12394;"Trakų Vokė";BITUTUČIŲ;3373764541;Taip;0;10;0;10
12395;"Trakų Vokė";BITUTUČIŲ;2839396687;Ne;7;0;4;11
12396;"Trakų Vokė";BITUTUČIŲ;4849992906;Ne;8;6;0;14
12397;"Trakų Vokė";BITUTUČIŲ;8857529726;Taip;9;0;0;9
12398;"Trakų Vokė";BITUTUČIŲ;6221283878;Taip;14;0;0;14
12399;"Trakų Vokė";BITUTUČIŲ;7566567901;Taip;0;0;3;3
12400;"Trakų Vokė";BITUTUČIŲ;3098390989;Ne;16;0;0;16
12401;"Trakų Vokė";BITUTUČIŲ;8997890367;Taip;4;0;4;8
12402;"Trakų Vokė";KIŠKUČIŲ;15897808544;Taip;0;0;8;8
12403;"Trakų Vokė";KIŠKUČIŲ;88989814775;Taip;9;0;0;9
12404;"Trakų Vokė";KIŠKUČIŲ;6675993703;Taip;0;0;1;1
12405;"Trakų Vokė";KIŠKUČIŲ;69866048102;Taip;7;0;3;10
12406;"Trakų Vokė";KIŠKUČIŲ;64083541565;Taip;3;0;7;10
12407;"Trakų Vokė";KIŠKUČIŲ;67434532111;Taip;0;17;0;17
12408;"Trakų Vokė";KIŠKUČIŲ;26598573711;Taip;10;0;1;11
12409;"Trakų Vokė";KIŠKUČIŲ;69311478204;Taip;17;0;0;17
12410;"Trakų Vokė";KIŠKUČIŲ;71417288063;Taip;0;0;9;9
12411;"Trakų Vokė";KIŠKUČIŲ;40200309769;Taip;2;0;0;2
12412;"Trakų Vokė";KIŠKUČIŲ;44023296535;Taip;7;4;0;11
12413;"Trakų Vokė";KIŠKUČIŲ;6418198934;Taip;10;0;0;10
12414;"Trakų Vokė";KIŠKUČIŲ;50697040061;Taip;0;0;16;16
12415;"Trakų Vokė";KIŠKUČIŲ;9135918587;Taip;5;0;0;5
12416;"Trakų Vokė";KIŠKUČIŲ;6362889550;Taip;3;0;4;7
12417;"Trakų Vokė";KIŠKUČIŲ;18796898215;Taip;11;0;0;11
12418;"Trakų Vokė";KIŠKUČIŲ;86504089176;Taip;0;0;4;4
12419;"Trakų Vokė";KIŠKUČIŲ;21329819892;Taip;0;1;0;1
12420;"Trakų Vokė";KIŠKUČIŲ;3210453801;Taip;10;0;2;12
12421;Zylutė;Katerok;62853712925;Ne;0;0;1;1
12422;Zylutė;Katerok;27007947432;Ne;0;5;0;5
12423;Zylutė;Katerok;54983937726;Taip;0;0;8;8
12424;Zylutė;Katerok;43987426917;Taip;0;9;0;9
12425;Zylutė;Katerok;86433183983;Taip;0;8;0;8
12426;Zylutė;Katerok;76259638454;Taip;0;4;0;4
12427;Zylutė;Katerok;54959972125;Ne;6;5;0;11
12428;Zylutė;Katerok;80556519366;Taip;0;3;0;3
12429;Zylutė;Katerok;1948356081;Taip;0;2;0;2
12430;Zylutė;Katerok;53283282669;Taip;0;0;12;12
12431;Zylutė;Katerok;91534371407;Taip;0;0;19;19
12432;Zylutė;Katerok;79923744237;Ne;0;2;0;2
12433;Zylutė;Katerok;58190315728;Taip;1;1;0;2
12434;Zylutė;Katerok;58045325209;Taip;0;8;0;8
12435;Zylutė;Katerok;1005572131;Taip;0;0;2;2
12436;Zylutė;"Vesole misiaki";15597884044;Taip;5;0;0;5
12437;Zylutė;"Vesole misiaki";84947394033;Taip;0;1;0;1
12438;Zylutė;"Vesole misiaki";52918539110;Taip;0;2;0;2
12439;Zylutė;"Vesole misiaki";5323116194;Taip;5;2;0;7
12440;Zylutė;"Vesole misiaki";74314676598;Taip;0;6;0;6
12441;Zylutė;"Vesole misiaki";1911748280;Taip;12;0;0;12
12442;Zylutė;"Vesole misiaki";62887824954;Taip;2;0;0;2
12443;Zylutė;"Vesole misiaki";86301183281;Taip;0;5;0;5
12444;Zylutė;"Vesole misiaki";43690245314;Taip;0;1;0;1
12445;Zylutė;"Vesole misiaki";1256879956;Taip;3;0;0;3
12446;Zylutė;"Vesole misiaki";3126726854;Ne;0;6;0;6
12447;Zylutė;"Vesole misiaki";9484752315;Taip;0;7;0;7
12448;Zylutė;"Vesole misiaki";7140223126;Taip;0;1;0;1
12449;Zylutė;"Vesole misiaki";81796510706;Taip;22;0;0;22
12450;Zylutė;"Vesole misiaki";7606434084;Taip;22;0;0;22
12451;Zylutė;"Vesole misiaki";6299191475;Ne;7;7;0;14
12452;Zylutė;NYKŠTUKAI;88823731584;Ne;0;3;0;3
12453;Zylutė;NYKŠTUKAI;91938227358;Ne;0;19;0;19
12454;Zylutė;NYKŠTUKAI;55672880453;Taip;8;2;0;10
12455;Zylutė;NYKŠTUKAI;63798640792;Taip;11;0;0;11
12456;Zylutė;NYKŠTUKAI;19429820228;Ne;11;0;0;11
12457;Zylutė;NYKŠTUKAI;46013925783;Taip;0;1;0;1
12458;Zylutė;NYKŠTUKAI;89083249598;Taip;4;0;0;4
12459;Zylutė;NYKŠTUKAI;53165044678;Taip;0;1;0;1
12460;Zylutė;NYKŠTUKAI;40369749025;Taip;2;3;0;5
12461;Zylutė;NYKŠTUKAI;42712894954;Taip;0;6;0;6
12462;Zylutė;NYKŠTUKAI;87231809477;Taip;0;1;0;1
12463;Zylutė;NYKŠTUKAI;1584743051;Ne;2;3;0;5
12464;Zylutė;NYKŠTUKAI;55136247841;Ne;0;11;0;11
12465;Zylutė;NYKŠTUKAI;1187261223;Taip;0;11;0;11
12466;Zylutė;NYKŠTUKAI;2276463136;Taip;0;1;0;1
12467;Zylutė;NYKŠTUKAI;7042731356;Taip;4;3;0;7
12468;Zylutė;NYKŠTUKAI;35300054087;Taip;0;9;0;9
12469;Zylutė;NYKŠTUKAI;15110117571;Taip;6;8;0;14
12470;Zylutė;NYKŠTUKAI;1699222615;Taip;0;1;0;1
12471;Zylutė;NYKŠTUKAI;3246229837;Taip;5;0;0;5
12472;Zylutė;Ručijok;9913001904;Taip;18;0;0;18
12473;Zylutė;Ručijok;6221528830;Taip;5;0;0;5
12474;Zylutė;Ručijok;3608920051;Taip;0;8;0;8
12475;Zylutė;Ručijok;3117948118;Taip;0;18;0;18
12476;Zylutė;Ručijok;7241045507;Taip;0;6;1;7
12477;Zylutė;Ručijok;3826815202;Taip;8;0;1;9
12478;Zylutė;Ručijok;3943002728;Taip;16;3;0;19
12479;Zylutė;Ručijok;9381656201;Taip;0;7;0;7
12480;Zylutė;Ručijok;2654373943;Taip;1;1;0;2
12481;Zylutė;Ručijok;9325387975;Taip;0;15;0;15
12482;Zylutė;Ručijok;4497904128;Taip;10;8;0;18
12483;Zylutė;Ručijok;1423890598;Taip;8;0;1;9
12484;Zylutė;Ručijok;5264930854;Taip;11;1;0;12
12485;Zylutė;Ručijok;6569135467;Ne;8;0;4;12
12486;Zylutė;Ručijok;3363212754;Taip;0;0;14;14
12487;Zylutė;Raduga;31724596372;Taip;0;1;0;1
12488;Zylutė;Raduga;1598044320;Taip;0;4;0;4
12489;Zylutė;Raduga;1756267879;Taip;5;0;0;5
12490;Zylutė;Raduga;42101273435;Taip;0;4;0;4
12491;Zylutė;Raduga;71494345484;Taip;0;10;0;10
12492;Zylutė;Raduga;24566804095;Taip;0;11;0;11
12493;Zylutė;Raduga;54294082958;Taip;0;5;0;5
12494;Zylutė;Raduga;27116746304;Taip;0;13;0;13
12495;Zylutė;Raduga;69884900143;Taip;0;2;0;2
12496;Zylutė;Raduga;31057429533;Taip;0;7;0;7
12497;Zylutė;Raduga;1035415228;Taip;0;10;0;10
12498;Zylutė;Raduga;1059365398;Taip;0;5;0;5
12499;Zylutė;Raduga;2092027180;Taip;0;17;0;17
12500;Zylutė;Raduga;60768660940;Taip;0;11;0;11
12501;Zylutė;Raduga;1840757726;Taip;0;2;0;2
12502;Zylutė;Raduga;78048289126;Taip;0;2;0;2
12503;Zylutė;Raduga;86343860903;Taip;0;12;0;12
12504;Zylutė;Raduga;6965021762;Taip;0;1;0;1
12505;Zylutė;Raduga;3179737181;Ne;0;3;0;3
12506;Zylutė;Raduga;1098174103;Taip;0;5;0;5
12507;Zylutė;Raduga;5202483589;Taip;0;3;0;3
12508;Zylutė;"Miki Maus";9664467134;Ne;10;0;0;10
12509;Zylutė;"Miki Maus";8336138549;Taip;0;10;0;10
12510;Zylutė;"Miki Maus";8638652914;Ne;0;4;0;4
12511;Zylutė;"Miki Maus";9953834483;Taip;0;2;0;2
12512;Zylutė;"Miki Maus";2445444641;Taip;0;9;0;9
12513;Zylutė;"Miki Maus";9908198854;Taip;7;5;0;12
12514;Zylutė;"Miki Maus";4493469560;Taip;16;0;0;16
12515;Zylutė;"Miki Maus";5027134228;Taip;0;13;0;13
12516;Zylutė;"Miki Maus";4543822765;Taip;5;9;0;14
12517;Zylutė;"Miki Maus";2092319455;Taip;10;5;0;15
12518;Zylutė;Solnyško;52293061924;Taip;0;13;0;13
12519;Zylutė;Solnyško;1212526573;Taip;5;0;0;5
12520;Zylutė;Solnyško;2020113161;Taip;3;0;0;3
12521;Zylutė;Solnyško;37968324911;Taip;0;1;0;1
12522;Zylutė;Solnyško;16723015849;Ne;5;0;0;5
12523;Zylutė;Solnyško;58033645899;Taip;0;9;0;9
12524;Zylutė;Solnyško;98295398362;Taip;7;8;0;15
12525;Zylutė;Solnyško;63287117036;Ne;0;7;0;7
12526;Zylutė;Solnyško;1004049147;Taip;0;7;0;7
12527;Zylutė;Solnyško;2910542367;Taip;0;7;0;7
12528;Zylutė;Solnyško;1979823314;Taip;0;2;0;2
12529;Zylutė;Solnyško;9728065395;Ne;2;0;0;2
12530;Zylutė;Solnyško;36486637873;Ne;0;8;0;8
12531;Zylutė;Solnyško;5090740854;Taip;0;15;0;15
12532;Zylutė;Motyliok;45252076215;Ne;0;21;0;21
12533;Zylutė;Motyliok;45779928616;Taip;0;7;0;7
12534;Zylutė;Motyliok;1001570452;Taip;0;2;0;2
12535;Zylutė;Motyliok;35364823312;Taip;7;6;0;13
12536;Zylutė;Motyliok;20333534526;Taip;0;6;0;6
12537;Zylutė;Motyliok;1801436436;Taip;1;17;0;18
12538;Zylutė;Motyliok;1445891751;Taip;5;5;0;10
12539;Zylutė;Motyliok;1873200936;Taip;4;0;0;4
12540;Zylutė;Motyliok;8546942240;Taip;7;0;0;7
12541;Zylutė;Motyliok;7298260831;Taip;6;7;0;13
12542;Zylutė;Motyliok;5803032683;Taip;16;0;0;16
12543;Zylutė;Motyliok;3089235413;Taip;12;6;0;18
12544;Zylutė;Motyliok;23826981323;Taip;17;2;0;19
12545;Zylutė;Motyliok;1094217042;Taip;18;0;0;18
12546;Zylutė;Motyliok;1145364380;Taip;17;2;0;19
12547;Zylutė;Motyliok;7712651566;Ne;0;1;0;1
12548;Zylutė;ŽVIRBLIUKAI;20569748356;Taip;0;3;3;6
12549;Zylutė;ŽVIRBLIUKAI;8783866036;Taip;13;2;0;15
12550;Zylutė;ŽVIRBLIUKAI;2274290871;Taip;6;6;0;12
12551;Zylutė;ŽVIRBLIUKAI;9902286013;Taip;5;0;0;5
12552;Zylutė;ŽVIRBLIUKAI;4154010905;Taip;10;0;0;10
12553;Zylutė;ŽVIRBLIUKAI;1972826928;Taip;0;5;0;5
12554;Zylutė;ŽVIRBLIUKAI;8018865138;Taip;13;0;0;13
12555;Zylutė;ŽVIRBLIUKAI;3074954453;Taip;0;1;0;1
12556;Zylutė;ŽVIRBLIUKAI;3919565034;Taip;0;0;2;2
12557;Zylutė;ŽVIRBLIUKAI;6865973084;Taip;0;1;5;6
12558;Zylutė;ŽVIRBLIUKAI;2744516236;Taip;4;1;0;5
12559;Zylutė;ŽVIRBLIUKAI;5174329244;Taip;9;0;0;9
12560;Zylutė;ŽVIRBLIUKAI;1939618217;Ne;0;9;2;11
12561;Zylutė;ŽVIRBLIUKAI;8627523283;Taip;5;0;0;5
12562;Zylutė;ŽVIRBLIUKAI;3606566852;Taip;0;2;0;2
12563;Zylutė;ŽVIRBLIUKAI;3115223229;Taip;3;0;3;6
12564;Zylutė;ŽVIRBLIUKAI;8874692591;Taip;6;7;0;13
12565;Zylutė;ŽVIRBLIUKAI;5431521522;Taip;15;7;0;22
12566;Zylutė;ŽVIRBLIUKAI;2792217953;Taip;2;1;0;3
12567;Zylutė;ŽVIRBLIUKAI;6548786007;Ne;5;0;1;6
12568;Zylutė;"DRUŽNYJE REBIATA";12377363480;Taip;22;0;0;22
12569;Zylutė;"DRUŽNYJE REBIATA";1428614163;Taip;0;15;0;15
12570;Zylutė;"DRUŽNYJE REBIATA";1674095701;Taip;0;5;0;5
12571;Zylutė;"DRUŽNYJE REBIATA";3379725202;Taip;0;2;0;2
12572;Zylutė;"DRUŽNYJE REBIATA";67435726524;Taip;0;1;1;2
12573;Zylutė;"DRUŽNYJE REBIATA";3843999609;Taip;10;0;0;10
12574;Zylutė;"DRUŽNYJE REBIATA";3036582121;Ne;0;6;0;6
12575;Zylutė;"DRUŽNYJE REBIATA";9163527400;Ne;0;6;0;6
12576;Zylutė;"DRUŽNYJE REBIATA";2157398751;Taip;0;1;0;1
12577;Zylutė;"DRUŽNYJE REBIATA";4302751308;Taip;0;17;0;17
12578;Zylutė;"DRUŽNYJE REBIATA";8293541980;Taip;7;1;0;8
12579;Zylutė;"DRUŽNYJE REBIATA";5452659798;Taip;11;3;0;14
12580;Zylutė;"DRUŽNYJE REBIATA";5162635301;Taip;0;11;0;11
12581;Zylutė;"DRUŽNYJE REBIATA";7023565057;Taip;13;4;0;17
12582;Zylutė;"DRUŽNYJE REBIATA";5641148690;Taip;0;12;0;12
12583;Zylutė;"DRUŽNYJE REBIATA";7804533930;Taip;1;0;0;1
12584;Zylutė;VIEVERSĖLIAI;4505081448;Taip;5;2;0;7
12585;Zylutė;VIEVERSĖLIAI;2104570334;Taip;0;14;0;14
12586;Zylutė;VIEVERSĖLIAI;72716975865;Taip;7;1;0;8
12587;Zylutė;VIEVERSĖLIAI;3055559237;Taip;0;4;0;4
12588;Zylutė;VIEVERSĖLIAI;2125424949;Taip;0;7;0;7
12589;Zylutė;VIEVERSĖLIAI;5172154642;Taip;0;8;0;8
12590;Zylutė;VIEVERSĖLIAI;2943888466;Taip;4;0;0;4
12591;Zylutė;VIEVERSĖLIAI;6907378757;Taip;10;0;0;10
12592;Zylutė;VIEVERSĖLIAI;6723650872;Taip;3;0;0;3
12593;Zylutė;VIEVERSĖLIAI;3810636967;Taip;5;0;0;5
12594;Zylutė;VIEVERSĖLIAI;6154352500;Taip;0;5;0;5
12595;Zylutė;VIEVERSĖLIAI;4016518230;Taip;0;3;0;3
12596;Zylutė;VIEVERSĖLIAI;9660898505;Taip;0;14;0;14
12597;Zylutė;VIEVERSĖLIAI;57138305703;Ne;0;15;0;15
12598;Zylutė;VIEVERSĖLIAI;5544338521;Taip;11;4;0;15
12599;Zylutė;VIEVERSĖLIAI;1897871944;Taip;1;3;0;4
12600;Zylutė;VIEVERSĖLIAI;4764295850;Taip;0;11;0;11
12601;Zylutė;VIEVERSĖLIAI;1750040659;Taip;6;0;0;6
12602;Želmenėliai;Bitučių;43295789978;Taip;0;2;0;2
12603;Želmenėliai;Bitučių;66377316300;Taip;0;1;0;1
12604;Želmenėliai;Bitučių;8440363769;Taip;0;4;0;4
12605;Želmenėliai;Bitučių;14467050269;Taip;4;0;0;4
12606;Želmenėliai;Bitučių;1342057909;Taip;3;1;0;4
12607;Želmenėliai;Bitučių;83607110446;Taip;5;0;1;6
12608;Želmenėliai;Bitučių;1158828889;Taip;1;2;0;3
12609;Želmenėliai;Bitučių;2162788756;Taip;0;2;0;2
12610;Želmenėliai;Bitučių;3039903984;Ne;3;0;4;7
12611;Želmenėliai;Bitučių;1865274706;Taip;1;0;0;1
12612;Želmenėliai;Bitučių;5501491970;Taip;6;0;1;7
12613;Želmenėliai;Bitučių;7911857247;Taip;0;9;0;9
12614;Želmenėliai;Kačiukų;6806260100;Taip;0;2;1;3
12615;Želmenėliai;Kačiukų;25991128602;Taip;12;2;0;14
12616;Želmenėliai;Kačiukų;50204719384;Taip;0;4;0;4
12617;Želmenėliai;Kačiukų;40147904205;Taip;0;2;1;3
12618;Želmenėliai;Kačiukų;75215159489;Taip;0;13;0;13
12619;Želmenėliai;Kačiukų;68168210430;Ne;5;8;0;13
12620;Želmenėliai;Kačiukų;52474082386;Taip;10;0;0;10
12621;Želmenėliai;Kačiukų;32945118976;Taip;0;7;1;8
12622;Želmenėliai;Kačiukų;72091418618;Taip;5;5;0;10
12623;Želmenėliai;Kačiukų;72029098066;Taip;0;1;0;1
12624;Želmenėliai;Kačiukų;80129197524;Ne;0;2;3;5
12625;Želmenėliai;Kačiukų;59968327015;Taip;0;0;3;3
12626;Želmenėliai;Kačiukų;25744693727;Taip;0;2;0;2
12627;Želmenėliai;Kačiukų;41941728755;Taip;5;0;0;5
12628;Želmenėliai;Kačiukų;2005437403;Taip;0;4;0;4
12629;Želmenėliai;Kačiukų;1744939559;Taip;5;5;0;10
12630;Želmenėliai;Kačiukų;27187464726;Taip;0;2;0;2
12631;Želmenėliai;Voveriukų;1064518850;Taip;0;13;0;13
12632;Želmenėliai;Voveriukų;11316462529;Taip;9;0;2;11
12633;Želmenėliai;Voveriukų;2066711124;Taip;0;1;0;1
12634;Želmenėliai;Voveriukų;51689349222;Taip;0;3;2;5
12635;Želmenėliai;Voveriukų;1799477959;Taip;22;0;0;22
12636;Želmenėliai;Voveriukų;98487229210;Taip;0;11;0;11
12637;Želmenėliai;Voveriukų;56814748796;Taip;20;0;0;20
12638;Želmenėliai;Voveriukų;39766114351;Taip;8;2;0;10
12639;Želmenėliai;Voveriukų;68226657214;Taip;0;11;0;11
12640;Želmenėliai;Voveriukų;1619190849;Taip;8;9;0;17
12641;Želmenėliai;Voveriukų;10990624964;Ne;12;3;0;15
12642;Želmenėliai;Voveriukų;1868937175;Taip;12;0;0;12
12643;Želmenėliai;Voveriukų;77946540922;Taip;0;1;0;1
12644;Želmenėliai;Voveriukų;8218755050;Taip;6;2;5;13
12645;Želmenėliai;Voveriukų;3258904017;Taip;20;0;0;20
12646;Želmenėliai;Voveriukų;6783113916;Taip;10;3;0;13
12647;Želmenėliai;Ežiukų;12336777368;Ne;0;7;0;7
12648;Želmenėliai;Ežiukų;5345737656;Taip;0;3;0;3
12649;Želmenėliai;Ežiukų;34529381726;Taip;0;2;0;2
12650;Želmenėliai;Ežiukų;16400566719;Taip;6;2;0;8
12651;Želmenėliai;Ežiukų;2265545469;Taip;12;1;0;13
12652;Želmenėliai;Ežiukų;28030110904;Taip;6;3;0;9
12653;Želmenėliai;Ežiukų;22209426414;Taip;0;2;0;2
12654;Želmenėliai;Ežiukų;95095279050;Taip;0;2;0;2
12655;Želmenėliai;Ežiukų;21636460884;Taip;0;4;0;4
12656;Želmenėliai;Ežiukų;90992236935;Taip;0;6;0;6
12657;Želmenėliai;Ežiukų;8394779853;Taip;2;18;0;20
12658;Želmenėliai;Ežiukų;1425695010;Ne;0;1;0;1
12659;Želmenėliai;Ežiukų;9234190447;Taip;0;1;0;1
12660;Želmenėliai;Ežiukų;1369976001;Taip;0;14;2;16
12661;Želmenėliai;Ežiukų;8478954608;Taip;0;14;2;16
12662;Želmenėliai;Ežiukų;1799391978;Taip;0;14;2;16
12663;Želmenėliai;Ežiukų;10686783804;Taip;5;1;0;6
12664;Želmenėliai;Peledžiukų;4206128805;Taip;0;13;0;13
12665;Želmenėliai;Peledžiukų;6816346946;Taip;9;4;0;13
12666;Želmenėliai;Peledžiukų;9359070885;Ne;8;7;0;15
12667;Želmenėliai;Peledžiukų;2428447892;Taip;8;1;0;9
12668;Želmenėliai;Peledžiukų;5787772212;Taip;0;3;0;3
12669;Želmenėliai;Peledžiukų;29112205705;Taip;0;1;0;1
12670;Želmenėliai;Peledžiukų;1248541555;Taip;0;6;0;6
12671;Želmenėliai;Peledžiukų;8995804360;Taip;8;1;0;9
12672;Želmenėliai;Peledžiukų;1522141057;Taip;0;0;7;7
12673;Želmenėliai;Peledžiukų;5616709457;Ne;4;0;6;10
12674;Želmenėliai;Peledžiukų;8300887366;Taip;7;2;0;9
12675;Želmenėliai;Peledžiukų;96660519820;Taip;0;3;0;3
12676;Želmenėliai;Peledžiukų;5842563754;Taip;0;14;0;14
12677;Želmenėliai;Peledžiukų;9375550172;Ne;2;5;0;7
12678;Želmenėliai;Peledžiukų;8478564831;Taip;10;0;0;10
12679;Želmenėliai;Peledžiukų;5638817349;Taip;0;3;2;5
12680;Želmenėliai;Peledžiukų;1941723687;Taip;10;0;0;10
12681;Želmenėliai;Peledžiukų;8590746750;Taip;0;1;0;1
12682;Želmenėliai;Drugelių;7664430346;Ne;10;0;0;10
12683;Želmenėliai;Drugelių;3417538909;Taip;0;5;0;5
12684;Želmenėliai;Drugelių;3295852546;Ne;10;3;0;13
12685;Želmenėliai;Drugelių;4739083871;Taip;11;0;2;13
12686;Želmenėliai;Drugelių;3379266015;Taip;4;0;0;4
12687;Želmenėliai;Drugelių;3737786832;Taip;8;0;0;8
12688;Želmenėliai;Drugelių;5633127620;Taip;0;22;0;22
12689;Želmenėliai;Drugelių;1984105453;Taip;16;0;0;16
12690;Želmenėliai;Drugelių;1920917916;Taip;13;2;0;15
12691;Želmenėliai;Drugelių;4652412483;Taip;0;11;0;11
12692;Želmenėliai;Drugelių;5046836398;Taip;13;0;0;13
12693;Želmenėliai;Drugelių;13558387807;Taip;7;1;0;8
12694;Želmenėliai;Drugelių;5143554665;Taip;9;4;0;13
12695;Želmenėliai;Drugelių;7585159351;Taip;0;10;0;10
12696;Želmenėliai;Drugelių;9207984505;Taip;0;3;0;3
12697;Želmenėliai;Drugelių;4634346755;Taip;0;0;5;5
12698;Želmenėliai;Drugelių;4916436238;Taip;6;5;0;11
12699;Želmenėliai;Drugelių;5558795651;Taip;10;4;0;14
12700;Želmenėliai;Voriukų;94772390737;Taip;0;0;5;5
12701;Želmenėliai;Voriukų;95258645888;Ne;0;8;0;8
12702;Želmenėliai;Voriukų;52040816124;Taip;0;1;0;1
12703;Želmenėliai;Voriukų;26335599312;Ne;5;1;0;6
12704;Želmenėliai;Voriukų;82671339119;Taip;0;1;0;1
12705;Želmenėliai;Voriukų;26377076407;Taip;7;2;0;9
12706;Želmenėliai;Voriukų;2017960244;Taip;0;1;0;1
12707;Želmenėliai;Voriukų;1494996935;Taip;0;14;0;14
12708;Želmenėliai;Voriukų;7587565685;Taip;22;0;0;22
12709;Želmenėliai;Voriukų;1299167028;Taip;0;6;0;6
12710;Želmenėliai;Boružėlių;51756630728;Taip;0;14;0;14
12711;Želmenėliai;Boružėlių;5223588064;Taip;0;4;0;4
12712;Želmenėliai;Boružėlių;91372955120;Taip;0;2;0;2
12713;Želmenėliai;Boružėlių;2898358705;Taip;0;2;0;2
12714;Želmenėliai;Boružėlių;63043069680;Taip;5;1;0;6
12715;Želmenėliai;Boružėlių;10462964817;Taip;0;11;0;11
12716;Želmenėliai;Boružėlių;35901929384;Taip;0;4;0;4
12717;Želmenėliai;Boružėlių;39675390598;Taip;0;2;0;2
12718;Želmenėliai;Boružėlių;1290780920;Taip;0;4;0;4
12719;Želmenėliai;Boružėlių;1699958696;Taip;0;10;0;10
12720;Želmenėliai;Boružėlių;98852944217;Ne;5;2;0;7
12721;Želmenėliai;Boružėlių;7502363323;Ne;0;4;0;4
12722;Želmenėliai;Boružėlių;1009164107;Taip;0;10;0;10
12723;Želmenėliai;Boružėlių;92486344928;Taip;0;9;0;9
12724;Želmenėliai;Boružėlių;1802714172;Taip;0;3;0;3
12725;Želmenėliai;Boružėlių;1686751892;Taip;20;0;0;20
12726;Želmenėliai;Boružėlių;1044902564;Ne;5;0;0;5
12727;Želmenėliai;Boružėlių;1933769076;Taip;0;0;2;2
12728;Želmenėliai;Boružėlių;1134743316;Taip;3;2;0;5
12729;Želmenėliai;Boružėlių;9414488405;Taip;2;9;0;11
12730;Želmenėliai;Pūkuotukų;73813829491;Taip;0;8;0;8
12731;Želmenėliai;Pūkuotukų;79879695958;Taip;10;0;2;12
12732;Želmenėliai;Pūkuotukų;54536849345;Taip;0;9;0;9
12733;Želmenėliai;Pūkuotukų;8936734213;Ne;8;0;0;8
12734;Želmenėliai;Pūkuotukų;1213403598;Taip;5;3;0;8
12735;Želmenėliai;Pūkuotukų;1803684569;Taip;0;1;0;1
12736;Želmenėliai;Pūkuotukų;1716801722;Taip;0;18;0;18
12737;Želmenėliai;Pūkuotukų;45440599686;Taip;0;9;0;9
12738;Želmenėliai;Pūkuotukų;50805473649;Taip;6;13;0;19
12739;Želmenėliai;Pūkuotukų;1405460015;Taip;3;0;0;3
12740;Želmenėliai;Pūkuotukų;85619767784;Taip;6;6;0;12
12741;Želmenėliai;Pūkuotukų;1800724034;Taip;0;0;8;8
12742;Želmenėliai;Pūkuotukų;74037118861;Taip;0;5;0;5
12743;Želmenėliai;Pūkuotukų;8706951420;Taip;0;15;0;15
12744;Želmenėliai;Pūkuotukų;7737877729;Taip;0;3;0;3
12745;Želmenėliai;Pūkuotukų;1426827854;Ne;0;1;0;1
12746;Želmenėliai;Pūkuotukų;75198661944;Taip;2;1;0;3
12747;Želmenėliai;Pūkuotukų;2036184590;Taip;0;2;0;2
12748;Želmenėliai;Pūkuotukų;22138795060;Taip;0;6;0;6
12749;Želmenėliai;Pūkuotukų;37152467004;Taip;0;2;0;2
12750;Želmenėliai;Ančiukų;1203343580;Taip;0;8;0;8
12751;Želmenėliai;Ančiukų;4264751761;Taip;24;0;0;24
12752;Želmenėliai;Ančiukų;7940403585;Taip;0;14;0;14
12753;Želmenėliai;Ančiukų;3184074698;Taip;8;0;0;8
12754;Želmenėliai;Ančiukų;2570248893;Taip;6;3;0;9
12755;Želmenėliai;Ančiukų;3014568232;Taip;5;1;0;6
12756;Želmenėliai;Ančiukų;7563461821;Taip;0;24;0;24
12757;Želmenėliai;Ančiukų;4545012342;Taip;0;10;0;10
12758;Želmenėliai;Ančiukų;9351650342;Ne;3;6;0;9
12759;Želmenėliai;Ančiukų;2577850672;Taip;0;1;0;1
12760;Želmenėliai;Ančiukų;4534946646;Taip;4;1;0;5
12761;Želmenėliai;Ančiukų;2111008869;Taip;4;0;0;4
12762;Želmenėliai;Ančiukų;4075533071;Taip;4;1;0;5
12763;Želmenėliai;Ančiukų;6916426436;Taip;0;2;0;2
12764;Želmenėliai;Nykštukų;9611741258;Taip;8;0;0;8
12765;Želmenėliai;Nykštukų;1619143702;Taip;10;0;0;10
12766;Želmenėliai;Nykštukų;9825545754;Taip;20;0;0;20
12767;Želmenėliai;Nykštukų;2794274146;Taip;0;7;0;7
12768;Želmenėliai;Nykštukų;3810550099;Taip;22;0;0;22
12769;Želmenėliai;Nykštukų;6635909614;Taip;9;0;0;9
12770;Želmenėliai;Nykštukų;2846903449;Taip;7;0;0;7
12771;Želmenėliai;Nykštukų;4473677352;Taip;13;0;0;13
12772;Želmenėliai;Nykštukų;8973215240;Taip;8;5;0;13
12773;Želmenėliai;Nykštukų;7505996978;Taip;0;7;0;7
12774;Želmenėliai;Nykštukų;7955645490;Taip;3;11;0;14
12775;Želmenėliai;Nykštukų;5314438217;Taip;0;2;0;2
12776;Želmenėliai;Nykštukų;9995500724;Taip;3;11;0;14
12777;Želmenėliai;Nykštukų;8954705816;Taip;5;0;0;5
12778;Želmenėliai;Lašelių;6799702725;Ne;0;2;0;2
12779;Želmenėliai;Lašelių;8358780570;Taip;0;5;0;5
12780;Želmenėliai;Lašelių;2122665619;Taip;2;0;0;2
12781;Želmenėliai;Lašelių;9006406225;Taip;3;2;0;5
12782;Želmenėliai;Lašelių;5171736943;Taip;10;0;0;10
12783;Želmenėliai;Lašelių;4931835807;Taip;0;2;0;2
12784;Želmenėliai;Lašelių;5147895081;Taip;0;1;0;1
12785;Želmenėliai;Lašelių;7957790300;Taip;6;1;0;7
12786;Želmenėliai;Lašelių;6481952132;Taip;5;2;0;7
12787;Želmenėliai;Lašelių;2563117992;Taip;0;2;0;2
12788;Želmenėliai;Lašelių;6180553648;Taip;6;4;0;10
12789;Želmenėliai;Lašelių;5211426226;Taip;8;7;0;15
12790;Žemyna;Čiauškučiai;96099047169;Taip;5;0;0;5
12791;Žemyna;Čiauškučiai;62565967575;Taip;4;1;0;5
12792;Žemyna;Čiauškučiai;25099273803;Taip;0;0;1;1
12793;Žemyna;Čiauškučiai;49793977825;Taip;0;9;0;9
12794;Žemyna;Čiauškučiai;10288969939;Taip;3;0;2;5
12795;Žemyna;Čiauškučiai;40843229500;Taip;0;8;0;8
12796;Žemyna;Čiauškučiai;69690099920;Taip;10;0;0;10
12797;Žemyna;Čiauškučiai;98477626952;Taip;0;0;2;2
12798;Žemyna;Čiauškučiai;71013970407;Taip;0;4;0;4
12799;Žemyna;Čiauškučiai;56418377668;Taip;0;10;0;10
12800;Žemyna;Čiauškučiai;98919412716;Taip;0;0;1;1
12801;Žemyna;Čiauškučiai;1535497308;Taip;8;0;1;9
12802;Žemyna;Čiauškučiai;89754744294;Taip;1;11;0;12
12803;Žemyna;Čiauškučiai;1790109762;Taip;0;2;3;5
12804;Žemyna;Čiauškučiai;83056273504;Taip;5;0;0;5
12805;Žemyna;Čiauškučiai;1866645242;Taip;0;3;1;4
12806;Žemyna;Čiauškučiai;1609941314;Taip;0;3;0;3
12807;Žemyna;Čiauškučiai;1917294883;Ne;6;0;0;6
12808;Žemyna;Čiauškučiai;1393006122;Taip;2;2;3;7
12809;Žemyna;Čiauškučiai;9409512255;Taip;12;0;4;16
12810;Žemyna;Nykštukai;69634515292;Taip;0;2;0;2
12811;Žemyna;Nykštukai;65677663175;Taip;1;6;0;7
12812;Žemyna;Nykštukai;74969696164;Taip;0;4;1;5
12813;Žemyna;Nykštukai;47974278492;Taip;0;2;0;2
12814;Žemyna;Nykštukai;92159859248;Taip;0;0;2;2
12815;Žemyna;Nykštukai;10344263960;Taip;0;0;2;2
12816;Žemyna;Nykštukai;54029612806;Taip;2;0;0;2
12817;Žemyna;Nykštukai;93378737171;Taip;0;0;7;7
12818;Žemyna;Nykštukai;9556275322;Taip;0;5;1;6
12819;Žemyna;Nykštukai;81683768388;Taip;0;1;0;1
12820;Žemyna;Nykštukai;65117735882;Taip;2;0;1;3
12821;Žemyna;Nykštukai;59441904717;Taip;17;0;0;17
12822;Žemyna;Nykštukai;97712802830;Taip;0;2;0;2
12823;Žemyna;Nykštukai;70694756261;Taip;0;0;7;7
12824;Žemyna;Nykštukai;45269313606;Taip;0;2;0;2
12825;Žemyna;Nykštukai;7670120949;Taip;0;0;5;5
12826;Žemyna;Nykštukai;78280621543;Taip;0;16;0;16
12827;Žemyna;Nykštukai;68982161758;Taip;2;0;2;4
12828;Žemyna;Nykštukai;1674165765;Taip;3;4;0;7
12829;Žemyna;Nykštukai;43708641831;Taip;5;13;0;18
12830;Žemyna;Nykštukai;1337500221;Taip;0;1;0;1
12831;Žemyna;Nykštukai;6546437872;Taip;5;0;0;5
12832;Žemyna;Voveriukai;3135562485;Taip;1;0;1;2
12833;Žemyna;Voveriukai;5940619734;Taip;5;0;0;5
12834;Žemyna;Voveriukai;6812823390;Taip;10;0;0;10
12835;Žemyna;Voveriukai;8500642069;Taip;0;4;0;4
12836;Žemyna;Voveriukai;6430348135;Taip;10;0;0;10
12837;Žemyna;Voveriukai;7925774308;Taip;0;0;1;1
12838;Žemyna;Voveriukai;2412956023;Taip;0;5;0;5
12839;Žemyna;Voveriukai;9958040413;Taip;16;0;1;17
12840;Žemyna;Voveriukai;1531980297;Taip;8;0;0;8
12841;Žemyna;Voveriukai;1114714466;Taip;13;0;0;13
12842;Žemyna;Voveriukai;1807466584;Taip;8;2;0;10
12843;Žemyna;Voveriukai;1543415914;Taip;6;0;3;9
12844;Žemyna;Voveriukai;7125026803;Taip;7;0;0;7
12845;Žemyna;Voveriukai;9148594407;Taip;0;0;2;2
12846;Žemyna;Voveriukai;6701717634;Taip;22;0;0;22
12847;Žemyna;Voveriukai;9866110744;Taip;0;0;1;1
12848;Žemyna;Voveriukai;7693278353;Taip;0;0;2;2
12849;Žemyna;Voveriukai;1118997229;Taip;5;1;0;6
12850;Žemyna;Kiškučiai;85577156077;Taip;8;0;2;10
12851;Žemyna;Kiškučiai;99073448709;Ne;0;9;0;9
12852;Žemyna;Kiškučiai;10048697347;Taip;2;0;0;2
12853;Žemyna;Kiškučiai;26634432947;Taip;0;3;0;3
12854;Žemyna;Kiškučiai;35576046194;Taip;0;1;0;1
12855;Žemyna;Kiškučiai;70742074799;Taip;5;0;0;5
12856;Žemyna;Kiškučiai;81211805661;Taip;0;1;0;1
12857;Žemyna;Kiškučiai;54667537300;Taip;5;0;0;5
12858;Žemyna;Kiškučiai;85184514538;Taip;7;1;0;8
12859;Žemyna;Kiškučiai;81784082355;Taip;22;0;0;22
12860;Žemyna;Kiškučiai;5140727629;Taip;4;2;0;6
12861;Žemyna;Kiškučiai;89531266711;Taip;5;0;1;6
12862;Žemyna;Kiškučiai;5730670827;Taip;1;3;0;4
12863;Žemyna;Kiškučiai;6766660258;Taip;0;4;0;4
12864;Žemyna;Kiškučiai;17162551563;Taip;0;0;2;2
12865;Žemyna;Kiškučiai;69734268809;Taip;0;1;1;2
12866;Žemyna;Kiškučiai;4928267472;Taip;0;0;2;2
12867;Žemyna;Vyturiukai;9232638767;Taip;3;0;0;3
12868;Žemyna;Vyturiukai;38769607968;Taip;5;2;3;10
12869;Žemyna;Vyturiukai;17098859260;Taip;0;1;0;1
12870;Žemyna;Vyturiukai;1687206394;Taip;4;0;0;4
12871;Žemyna;Vyturiukai;5508251792;Taip;3;0;0;3
12872;Žemyna;Vyturiukai;85135645557;Taip;0;2;1;3
12873;Žemyna;Vyturiukai;59506345859;Taip;0;11;0;11
12874;Žemyna;Vyturiukai;89787441782;Taip;3;2;0;5
12875;Žemyna;Vyturiukai;5506889213;Taip;0;2;0;2
12876;Žemyna;Vyturiukai;5306392307;Taip;17;2;0;19
12877;Žemyna;Vyturiukai;9018138289;Taip;0;0;5;5
12878;Žemyna;Vyturiukai;37570629861;Taip;20;1;0;21
12879;Žemyna;Vyturiukai;13242930752;Taip;7;0;0;7
12880;Žemyna;Vyturiukai;96473502730;Taip;4;0;5;9
12881;Žemyna;Vyturiukai;93423088394;Taip;0;5;0;5
12882;Žemyna;Vyturiukai;8040359407;Taip;0;0;5;5
12883;Žemyna;Vyturiukai;6618285685;Taip;0;0;1;1
12884;Žemyna;Pelėdžiukai;24282185059;Taip;4;0;0;4
12885;Žemyna;Pelėdžiukai;91945722729;Taip;0;4;0;4
12886;Žemyna;Pelėdžiukai;31409370999;Taip;0;0;3;3
12887;Žemyna;Pelėdžiukai;74855676264;Taip;0;0;3;3
12888;Žemyna;Pelėdžiukai;36180811193;Taip;0;0;3;3
12889;Žemyna;Pelėdžiukai;61994998037;Taip;0;3;2;5
12890;Žemyna;Pelėdžiukai;36616512238;Taip;0;1;0;1
12891;Žemyna;Pelėdžiukai;30019743988;Taip;0;6;0;6
12892;Žemyna;Pelėdžiukai;68149716927;Taip;2;1;2;5
12893;Žemyna;Pelėdžiukai;67275465624;Taip;0;4;0;4
12894;Žemyna;Pelėdžiukai;55015285610;Ne;0;0;4;4
12895;Žemyna;Pelėdžiukai;46049323529;Taip;22;0;0;22
12896;Žemyna;Pelėdžiukai;1218163998;Taip;0;0;4;4
12897;Žemyna;Pelėdžiukai;5183028594;Taip;0;0;2;2
12898;Žemyna;Pelėdžiukai;1717113454;Taip;6;0;1;7
12899;Žemyna;Vijurkai;3601375855;Ne;0;5;0;5
12900;Žemyna;Vijurkai;64499886011;Taip;0;4;0;4
12901;Žemyna;Vijurkai;38602852015;Taip;0;0;1;1
12902;Žemyna;Vijurkai;60950769448;Taip;0;2;0;2
12903;Žemyna;Vijurkai;1015193590;Taip;0;0;5;5
12904;Žemyna;Vijurkai;64066518112;Taip;0;0;3;3
12905;Žemyna;Vijurkai;62651324131;Taip;4;0;1;5
12906;Žemyna;Vijurkai;38352111116;Taip;0;6;5;11
12907;Žemyna;Vijurkai;55853738457;Taip;0;0;4;4
12908;Žemyna;Vijurkai;1197264568;Taip;0;11;0;11
12909;Žemyna;Vijurkai;36873572743;Taip;0;0;6;6
12910;Žemyna;Vijurkai;63747644828;Taip;0;0;1;1
12911;Žemyna;Vijurkai;1725097139;Taip;0;0;2;2
12912;Žemyna;Vijurkai;31365442622;Taip;0;0;1;1
12913;Žemyna;Vijurkai;76258813568;Taip;0;2;0;2
12914;Žemyna;Vijurkai;42384634418;Taip;0;2;0;2
12915;Žemyna;Vijurkai;38576112962;Taip;0;2;0;2
12916;Žemyna;Vijurkai;22741981912;Taip;0;0;2;2
12917;Žemyna;Vijurkai;80070453149;Taip;0;2;0;2
12918;Žemyna;Šnekučiai;88775150201;Taip;0;0;1;1
12919;Žemyna;Šnekučiai;58578414067;Taip;7;0;0;7
12920;Žemyna;Šnekučiai;9130965949;Taip;0;2;0;2
12921;Žemyna;Šnekučiai;1683299408;Taip;4;9;0;13
12922;Žemyna;Šnekučiai;39175264243;Taip;0;1;0;1
12923;Žemyna;Šnekučiai;35462796459;Taip;14;0;0;14
12924;Žemyna;Šnekučiai;50543973728;Taip;14;0;0;14
12925;Žemyna;Šnekučiai;1595030102;Taip;0;0;4;4
12926;Žemyna;Šnekučiai;6448628301;Taip;11;0;0;11
12927;Žemyna;Šnekučiai;1421842247;Taip;0;0;6;6
12928;Žemyna;Šnekučiai;47562685723;Taip;0;0;3;3
12929;Žemyna;Šnekučiai;32755929074;Taip;12;3;0;15
12930;Žemyna;Šnekučiai;54253890981;Taip;0;0;2;2
12931;Žemyna;Šnekučiai;54823974018;Taip;9;0;0;9
12932;Žemyna;Šnekučiai;1049546597;Taip;3;0;10;13
12933;Žemyna;Šnekučiai;99015221693;Taip;0;1;1;2
12934;Žemyna;Šnekučiai;38604851102;Taip;0;0;8;8
12935;Žemyna;Šnekučiai;1305667359;Taip;15;0;0;15
12936;Žemyna;Šnekučiai;6089122225;Taip;0;4;0;4
12937;Žemyna;Šnekučiai;55748223762;Taip;5;5;0;10
12938;Žemyna;Pabiručiai;88687293547;Ne;9;7;0;16
12939;Žemyna;Pabiručiai;1210307182;Taip;2;5;0;7
12940;Žemyna;Pabiručiai;1265326169;Taip;5;0;1;6
12941;Žemyna;Pabiručiai;4570281722;Taip;17;0;3;20
12942;Žemyna;Pabiručiai;75681135185;Taip;10;0;0;10
12943;Žemyna;Pabiručiai;6775880309;Taip;5;0;0;5
12944;Žemyna;Pabiručiai;80737839511;Taip;0;2;0;2
12945;Žemyna;Pabiručiai;82479499709;Ne;4;0;0;4
12946;Žemyna;Pabiručiai;60610765717;Taip;4;0;0;4
12947;Žemyna;Pabiručiai;14902924855;Taip;0;1;0;1
12948;Žemyna;Pabiručiai;15573695823;Taip;7;6;0;13
12949;Žemyna;Pabiručiai;50687988382;Ne;0;11;0;11
12950;Žemyna;Drugeliai;72801825176;Taip;0;3;0;3
12951;Žemyna;Drugeliai;32383247850;Taip;3;0;0;3
12952;Žemyna;Drugeliai;2100326039;Taip;0;0;5;5
12953;Žemyna;Drugeliai;1571182096;Ne;0;0;1;1
12954;Žemyna;Drugeliai;1471204471;Taip;0;3;0;3
12955;Žemyna;Drugeliai;1882507954;Taip;0;1;0;1
12956;Žemyna;Drugeliai;1623854426;Taip;1;0;0;1
12957;Žemyna;Drugeliai;50369667193;Taip;19;0;0;19
12958;Žemyna;Drugeliai;1705971732;Taip;12;0;1;13
12959;Žemyna;Drugeliai;17784132877;Taip;0;0;3;3
12960;Žemyna;Drugeliai;97625732866;Taip;11;0;0;11
12961;Žemyna;Drugeliai;45222048620;Taip;0;1;0;1
12962;Žemyna;Drugeliai;1654912072;Taip;2;0;0;2
12963;Žemyna;Drugeliai;1968337404;Taip;4;0;0;4
12964;Žemyna;Drugeliai;27867030470;Taip;0;0;1;1
12965;Žemyna;Drugeliai;51870099224;Taip;0;0;5;5
12966;Žemyna;Drugeliai;1941650167;Taip;0;4;0;4
12967;Žemyna;Drugeliai;1541156624;Taip;0;2;0;2
12968;Žemyna;Drugeliai;2113826378;Taip;0;0;4;4
12969;Žemyna;"ŽIRNIUKAI ";6116581655;Taip;3;0;1;4
12970;Žemyna;"ŽIRNIUKAI ";6856737270;Taip;0;0;2;2
12971;Žemyna;"ŽIRNIUKAI ";9912869400;Taip;5;0;2;7
12972;Žemyna;"ŽIRNIUKAI ";9818711030;Taip;1;0;1;2
12973;Žemyna;"ŽIRNIUKAI ";9219519029;Ne;0;7;0;7
12974;Žemyna;"ŽIRNIUKAI ";6293560729;Taip;0;0;6;6
12975;Žemyna;"ŽIRNIUKAI ";5868208651;Ne;11;0;0;11
12976;Žemyna;"ŽIRNIUKAI ";5188496664;Taip;16;0;0;16
12977;Žemyna;"ŽIRNIUKAI ";7764615445;Taip;4;0;1;5
12978;Žemyna;"ŽIRNIUKAI ";9668975591;Taip;3;0;0;3
12979;Žemyna;"ŽIRNIUKAI ";7367602247;Taip;0;11;0;11
12980;Žemyna;"ŽIRNIUKAI ";7280740926;Taip;5;0;2;7
12981;Žemyna;"ŽIRNIUKAI ";6419974691;Taip;0;0;1;1
12982;Žemyna;"ŽIRNIUKAI ";2006173745;Taip;12;0;0;12
12983;Žemyna;"ŽIRNIUKAI ";5727308039;Taip;16;0;0;16
12984;Žemyna;"ŽIRNIUKAI ";2792702536;Taip;8;0;3;11
12985;Žemyna;"ŽIRNIUKAI ";5714771643;Taip;3;0;0;3
12986;Žemyna;"ŽIRNIUKAI ";3992383447;Taip;5;0;2;7
12987;Žemyna;"ŽIRNIUKAI ";4693414703;Taip;0;0;1;1
12988;Žemyna;"ŽIOGELIAI ";3643594001;Taip;0;0;9;9
12989;Žemyna;"ŽIOGELIAI ";7508491119;Taip;9;1;0;10
12990;Žemyna;"ŽIOGELIAI ";4821941126;Taip;0;1;0;1
12991;Žemyna;"ŽIOGELIAI ";8622780639;Taip;3;6;0;9
12992;Žemyna;"ŽIOGELIAI ";4444870782;Taip;2;1;0;3
12993;Žemyna;"ŽIOGELIAI ";9182709647;Taip;10;0;0;10
12994;Žemyna;"ŽIOGELIAI ";7121742098;Taip;10;0;0;10
12995;Žemyna;"ŽIOGELIAI ";4322192775;Taip;20;0;0;20
12996;Žemyna;"ŽIOGELIAI ";6051208732;Taip;7;0;0;7
12997;Žemyna;"ŽIOGELIAI ";9653530823;Taip;5;0;0;5
12998;Žemyna;"ŽIOGELIAI ";2928125522;Ne;12;0;0;12
12999;Žemyna;"ŽIOGELIAI ";7005045961;Taip;5;0;0;5
13000;Žemyna;"ŽIOGELIAI ";5114094924;Taip;7;0;0;7
13001;Žemuogėlė;Boružiukai;64182347253;Taip;0;1;0;1
13002;Žemuogėlė;Boružiukai;23841110826;Taip;10;0;0;10
13003;Žemuogėlė;Boružiukai;89682626079;Taip;1;2;1;4
13004;Žemuogėlė;Boružiukai;21886029194;Taip;5;1;0;6
13005;Žemuogėlė;Boružiukai;95392130582;Taip;0;5;0;5
13006;Žemuogėlė;Boružiukai;3208009994;Taip;0;2;0;2
13007;Žemuogėlė;Boružiukai;1099252682;Taip;0;12;0;12
13008;Žemuogėlė;Boružiukai;2320908623;Taip;0;8;0;8
13009;Žemuogėlė;Boružiukai;1550066922;Taip;10;0;0;10
13010;Žemuogėlė;Boružiukai;1354590098;Taip;0;4;1;5
13011;Žemuogėlė;Boružiukai;1543283524;Taip;0;2;0;2
13012;Žemuogėlė;Boružiukai;1085793430;Taip;0;1;0;1
13013;Žemuogėlė;Boružiukai;1970687025;Taip;0;1;0;1
13014;Žemuogėlė;Boružiukai;52842591023;Taip;0;0;1;1
13015;Žemuogėlė;Boružiukai;97014601220;Taip;5;2;2;9
13016;Žemuogėlė;Boružiukai;5911529759;Taip;0;9;0;9
13017;Žemuogėlė;Boružiukai;31450036105;Taip;10;2;0;12
13018;Žemuogėlė;Boružiukai;93523683833;Taip;0;2;1;3
13019;Žemuogėlė;Boružiukai;1093128368;Taip;0;2;0;2
13020;Žemuogėlė;Boružiukai;70054283264;Taip;1;2;0;3
13021;Žemuogėlė;Boružiukai;40590616715;Taip;5;15;0;20
13022;Žemuogėlė;Boružiukai;1248683052;Taip;10;0;2;12
13023;Žemuogėlė;Boružiukai;2146044539;Taip;5;0;0;5
13024;Žemuogėlė;Šviesuliukai;4766971363;Taip;0;4;0;4
13025;Žemuogėlė;Šviesuliukai;3697024369;Taip;0;2;1;3
13026;Žemuogėlė;Šviesuliukai;8187939143;Taip;0;3;0;3
13027;Žemuogėlė;Šviesuliukai;96167322031;Taip;7;0;2;9
13028;Žemuogėlė;Šviesuliukai;73679997517;Taip;3;1;0;4
13029;Žemuogėlė;Šviesuliukai;24863928147;Taip;0;2;0;2
13030;Žemuogėlė;Šviesuliukai;29436958034;Taip;0;13;0;13
13031;Žemuogėlė;Šviesuliukai;1608544032;Taip;0;1;4;5
13032;Žemuogėlė;Šviesuliukai;9042246873;Taip;8;0;4;12
13033;Žemuogėlė;Šviesuliukai;1859848343;Taip;0;9;0;9
13034;Žemuogėlė;Šviesuliukai;57783467185;Taip;16;0;0;16
13035;Žemuogėlė;Šviesuliukai;75012082294;Taip;0;1;0;1
13036;Žemuogėlė;Šviesuliukai;5395954931;Taip;0;2;0;2
13037;Žemuogėlė;Šviesuliukai;1833523282;Taip;0;1;0;1
13038;Žemuogėlė;Šviesuliukai;3062268362;Taip;8;1;1;10
13039;Žemuogėlė;Šviesuliukai;9864664937;Taip;5;2;0;7
13040;Žemuogėlė;Šviesuliukai;1745679183;Taip;0;3;0;3
13041;Žemuogėlė;Šviesuliukai;9255723192;Taip;0;0;2;2
13042;Žemuogėlė;Šviesuliukai;2740942924;Taip;8;0;0;8
13043;Žemuogėlė;Šviesuliukai;5972567526;Taip;5;0;0;5
13044;Žemuogėlė;Šviesuliukai;1910570858;Taip;0;5;0;5
13045;Žemuogėlė;Lašiukai;88840615083;Ne;0;2;0;2
13046;Žemuogėlė;Lašiukai;32491995013;Taip;0;2;0;2
13047;Žemuogėlė;Lašiukai;1674933700;Ne;0;1;0;1
13048;Žemuogėlė;Lašiukai;53837299006;Taip;5;14;0;19
13049;Žemuogėlė;Lašiukai;51367008137;Taip;8;10;0;18
13050;Žemuogėlė;Lašiukai;46391565859;Taip;0;1;0;1
13051;Žemuogėlė;Lašiukai;23836253539;Taip;0;1;0;1
13052;Žemuogėlė;Lašiukai;71173323434;Taip;5;2;0;7
13053;Žemuogėlė;Lašiukai;84708796864;Taip;0;2;0;2
13054;Žemuogėlė;Lašiukai;78872439982;Taip;3;2;0;5
13055;Žemuogėlė;Skambaliukai;66580736408;Ne;0;10;0;10
13056;Žemuogėlė;Skambaliukai;84666403179;Ne;3;2;1;6
13057;Žemuogėlė;Skambaliukai;31759065949;Taip;0;5;0;5
13058;Žemuogėlė;Skambaliukai;9595187690;Taip;0;0;1;1
13059;Žemuogėlė;Skambaliukai;5784013969;Taip;0;4;0;4
13060;Žemuogėlė;Skambaliukai;4102456092;Taip;0;3;0;3
13061;Žemuogėlė;Skambaliukai;3937319656;Taip;0;2;2;4
13062;Žemuogėlė;Skambaliukai;7593612588;Ne;0;13;0;13
13063;Žemuogėlė;Skambaliukai;9932212577;Ne;1;2;3;6
13064;Žemuogėlė;Skambaliukai;1461676033;Taip;0;2;0;2
13065;Žemuogėlė;Skambaliukai;8499817876;Taip;4;1;0;5
13066;Žemuogėlė;Skambaliukai;37376794703;Taip;5;1;0;6
13067;Žemuogėlė;Skambaliukai;8208792552;Taip;0;5;0;5
13068;Žemuogėlė;Skambaliukai;48157970479;Ne;0;1;0;1
13069;Žemuogėlė;Skambaliukai;42192628191;Taip;0;9;0;9
13070;Žemuogėlė;Skambaliukai;3354347837;Taip;4;2;2;8
13071;Žemuogėlė;Skambaliukai;2692095829;Taip;6;1;0;7
13072;Žemuogėlė;Skambaliukai;13566201686;Taip;17;2;0;19
13073;Žemuogėlė;Skambaliukai;2661677897;Taip;0;1;0;1
13074;Žemuogėlė;Spinduliukai;36386223863;Taip;0;9;0;9
13075;Žemuogėlė;Spinduliukai;50649509868;Taip;1;0;0;1
13076;Žemuogėlė;Spinduliukai;62971657427;Taip;1;0;0;1
13077;Žemuogėlė;Spinduliukai;62210251654;Taip;2;5;0;7
13078;Žemuogėlė;Spinduliukai;5888483930;Ne;0;10;0;10
13079;Žemuogėlė;Spinduliukai;11571302488;Taip;12;7;0;19
13080;Žemuogėlė;Spinduliukai;15246943974;Taip;7;5;0;12
13081;Žemuogėlė;Spinduliukai;54745410330;Taip;0;5;0;5
13082;Žemuogėlė;Spinduliukai;33317814956;Taip;1;0;0;1
13083;Žemuogėlė;Spinduliukai;97511628790;Taip;0;16;0;16
13084;Žemuogėlė;Spinduliukai;38094866639;Taip;5;0;0;5
13085;Žemuogėlė;Spinduliukai;23112873505;Taip;0;8;0;8
13086;Žemuogėlė;Spinduliukai;89316574266;Taip;6;0;0;6
13087;Žemuogėlė;Spinduliukai;89042677798;Taip;0;12;0;12
13088;Žemuogėlė;Spinduliukai;64042870424;Taip;0;14;0;14
13089;Žemuogėlė;Spinduliukai;1296464444;Taip;0;1;0;1
13090;Žemuogėlė;Perliukai;33112231008;Taip;3;2;0;5
13091;Žemuogėlė;Perliukai;28795421460;Taip;0;1;0;1
13092;Žemuogėlė;Perliukai;98006600854;Taip;0;7;0;7
13093;Žemuogėlė;Perliukai;66464155865;Taip;0;3;0;3
13094;Žemuogėlė;Perliukai;58604834495;Taip;0;14;0;14
13095;Žemuogėlė;Perliukai;1366286798;Taip;0;3;0;3
13096;Žemuogėlė;Perliukai;29973978107;Taip;10;0;0;10
13097;Žemuogėlė;Perliukai;77880141132;Taip;1;0;0;1
13098;Žemuogėlė;Perliukai;8952696734;Taip;0;11;0;11
13099;Žemuogėlė;Perliukai;1844596636;Taip;0;5;0;5
13100;Žemuogėlė;Perliukai;96539338587;Taip;0;2;0;2
13101;Žemuogėlė;Perliukai;22761916112;Ne;0;10;0;10
13102;Žemuogėlė;Perliukai;60841198741;Taip;0;1;0;1
13103;Žemuogėlė;Perliukai;58679808617;Taip;10;0;0;10
13104;Žemuogėlė;Drugeliai;94792383091;Taip;1;2;0;3
13105;Žemuogėlė;Drugeliai;7403172794;Taip;0;2;0;2
13106;Žemuogėlė;Drugeliai;1608506638;Taip;0;1;0;1
13107;Žemuogėlė;Drugeliai;1448477562;Taip;0;1;0;1
13108;Žemuogėlė;Drugeliai;1223819270;Ne;0;12;1;13
13109;Žemuogėlė;Drugeliai;3134493860;Taip;0;14;0;14
13110;Žemuogėlė;Drugeliai;711908013;Taip;0;2;0;2
13111;Žemuogėlė;Drugeliai;1628749648;Taip;0;0;2;2
13112;Žemuogėlė;Drugeliai;6962103028;Taip;0;2;1;3
13113;Žemuogėlė;Drugeliai;3977351017;Taip;0;1;0;1
13114;Žemuogėlė;Drugeliai;4231767115;Taip;0;1;0;1
13115;Žemuogėlė;Drugeliai;8737612457;Ne;0;8;0;8
13116;Žemuogėlė;Drugeliai;5147617128;Taip;0;5;0;5
13117;Žemuogėlė;Drugeliai;5625943720;Taip;0;2;2;4
13118;Žemuogėlė;Drugeliai;7714826773;Taip;0;9;0;9
13119;Žemuogėlė;Drugeliai;1907004376;Taip;10;0;0;10
13120;Žemuogėlė;Drugeliai;2102057496;Taip;0;7;0;7
13121;Žemuogėlė;"VIEVERSIUKAI ";7804015060;Taip;5;2;0;7
13122;Žemuogėlė;"VIEVERSIUKAI ";3706531223;Taip;0;1;0;1
13123;Žemuogėlė;"VIEVERSIUKAI ";4565097904;Taip;10;5;0;15
13124;Žemuogėlė;"VIEVERSIUKAI ";1049009199;Taip;0;3;0;3
13125;Žemuogėlė;"VIEVERSIUKAI ";9378432383;Taip;4;3;0;7
13126;Žemuogėlė;"VIEVERSIUKAI ";6747566307;Taip;5;0;0;5
13127;Žemuogėlė;"VIEVERSIUKAI ";4421397490;Taip;3;0;0;3
13128;Žemuogėlė;"VIEVERSIUKAI ";3714945248;Taip;0;19;0;19
13129;Žemuogėlė;"VIEVERSIUKAI ";2001471529;Taip;0;4;0;4
13130;Žemuogėlė;"VIEVERSIUKAI ";2841634296;Taip;0;7;0;7
13131;Žemuogėlė;"VIEVERSIUKAI ";6913038845;Taip;17;0;0;17
13132;Žemuogėlė;"VIEVERSIUKAI ";9579921777;Taip;6;0;0;6
13133;Žemuogėlė;"VIEVERSIUKAI ";6169845677;Taip;11;0;0;11
13134;Žemuogėlė;"VIEVERSIUKAI ";5532053268;Taip;7;0;0;7
13135;Žemuogėlė;"VIEVERSIUKAI ";1356340471;Taip;14;0;0;14
13136;Žemuogėlė;"NYKŠTUKAI ";3458374439;Taip;7;1;0;8
13137;Žemuogėlė;"NYKŠTUKAI ";3765022476;Taip;1;2;0;3
13138;Žemuogėlė;"NYKŠTUKAI ";9519563708;Taip;15;0;0;15
13139;Žemuogėlė;"NYKŠTUKAI ";9693894254;Taip;7;1;0;8
13140;Žemuogėlė;"NYKŠTUKAI ";2555902309;Taip;5;17;0;22
13141;Žemuogėlė;"NYKŠTUKAI ";4536398519;Taip;0;1;0;1
13142;Žemuogėlė;"NYKŠTUKAI ";8757701456;Taip;0;1;0;1
13143;Žemuogėlė;"NYKŠTUKAI ";1844299594;Taip;18;0;0;18
13144;Žemuogėlė;"NYKŠTUKAI ";2132549536;Taip;0;13;0;13
13145;Žemuogėlė;"NYKŠTUKAI ";8496353410;Taip;6;0;0;6
13146;Žemuogėlė;"NYKŠTUKAI ";9592456683;Taip;20;0;0;20
13147;Žemuogėlė;"NYKŠTUKAI ";6581889641;Taip;0;1;5;6
13148;Žemuogėlė;"NYKŠTUKAI ";5266493632;Taip;16;0;0;16
13149;Žemuogėlė;"NYKŠTUKAI ";3237083654;Taip;16;0;0;16
13150;Žemuogėlė;"NYKŠTUKAI ";2259779058;Taip;10;1;0;11
13151;Žemuogėlė;"NYKŠTUKAI ";5418395023;Taip;3;1;0;4
13152;Žemuogėlė;"NYKŠTUKAI ";1733808230;Taip;2;0;0;2
13153;Žemuogėlė;"NYKŠTUKAI ";1713927628;Taip;10;0;0;10
13154;Žemuogėlė;KIŠKUČIAI;9311520300;Taip;0;1;0;1
13155;Žemuogėlė;KIŠKUČIAI;3411390558;Taip;17;5;0;22
13156;Žemuogėlė;KIŠKUČIAI;6963684639;Taip;6;0;0;6
13157;Žemuogėlė;KIŠKUČIAI;1377813636;Taip;0;0;1;1
13158;Žemuogėlė;KIŠKUČIAI;9689082202;Ne;19;0;0;19
13159;Žemuogėlė;KIŠKUČIAI;9955429241;Taip;2;0;0;2
13160;Žemuogėlė;KIŠKUČIAI;5770044886;Taip;2;0;2;4
13161;Žemuogėlė;KIŠKUČIAI;6726124641;Taip;7;0;0;7
13162;Žemuogėlė;KIŠKUČIAI;7177725663;Taip;4;4;0;8
13163;Žemuogėlė;KIŠKUČIAI;9534937419;Taip;1;0;0;1
13164;Žemuogėlė;KIŠKUČIAI;2481547868;Taip;10;0;0;10
13165;Žemuogėlė;KIŠKUČIAI;3612833383;Taip;17;0;0;17
13166;Žemuogėlė;KIŠKUČIAI;3000676765;Taip;0;0;4;4
13167;Žemuogėlė;KIŠKUČIAI;1275552038;Taip;15;0;1;16
13168;Žibutė;PELĖDŽIUKAI;5811023607;Taip;4;0;0;4
13169;Žibutė;PELĖDŽIUKAI;54535455969;Taip;3;8;0;11
13170;Žibutė;PELĖDŽIUKAI;85042822872;Taip;0;0;2;2
13171;Žibutė;PELĖDŽIUKAI;59824395612;Taip;7;1;0;8
13172;Žibutė;PELĖDŽIUKAI;2361682400;Taip;0;3;0;3
13173;Žibutė;PELĖDŽIUKAI;1826763192;Taip;0;2;0;2
13174;Žibutė;PELĖDŽIUKAI;1259481487;Taip;0;1;0;1
13175;Žibutė;PELĖDŽIUKAI;3826875107;Taip;0;7;0;7
13176;Žibutė;PELĖDŽIUKAI;3186792146;Taip;0;0;3;3
13177;Žibutė;PELĖDŽIUKAI;1226458088;Taip;0;7;0;7
13178;Žibutė;PELĖDŽIUKAI;7344095020;Taip;0;0;4;4
13179;Žibutė;PELĖDŽIUKAI;1078105287;Taip;0;4;0;4
13180;Žibutė;PELĖDŽIUKAI;2152452830;Ne;0;10;1;11
13181;Žibutė;PELĖDŽIUKAI;2236930916;Taip;4;1;0;5
13182;Žibutė;PELĖDŽIUKAI;7095870173;Taip;0;7;0;7
13183;Žibutė;PELĖDŽIUKAI;2840754631;Taip;10;0;0;10
13184;Žibutė;PELĖDŽIUKAI;6089325755;Taip;0;0;1;1
13185;Žibutė;PELĖDŽIUKAI;1274409680;Taip;3;17;1;21
13186;Žibutė;KREGŽDUTĖS;65354441552;Ne;2;3;1;6
13187;Žibutė;KREGŽDUTĖS;10520617100;Taip;12;1;4;17
13188;Žibutė;KREGŽDUTĖS;41927765047;Taip;0;0;1;1
13189;Žibutė;KREGŽDUTĖS;69543986022;Taip;0;0;5;5
13190;Žibutė;KREGŽDUTĖS;58408466259;Taip;0;0;4;4
13191;Žibutė;KREGŽDUTĖS;76429804560;Taip;11;6;0;17
13192;Žibutė;KREGŽDUTĖS;70602200548;Taip;0;1;0;1
13193;Žibutė;KREGŽDUTĖS;27387035728;Taip;0;3;1;4
13194;Žibutė;KREGŽDUTĖS;16188398138;Ne;0;1;0;1
13195;Žibutė;KREGŽDUTĖS;74637399002;Taip;5;0;0;5
13196;Žibutė;KREGŽDUTĖS;72101352091;Taip;7;2;0;9
13197;Žibutė;KREGŽDUTĖS;61878941621;Taip;0;8;0;8
13198;Žibutė;KREGŽDUTĖS;68830297615;Taip;0;4;2;6
13199;Žibutė;KREGŽDUTĖS;89599338661;Ne;15;2;0;17
13200;Žibutė;KREGŽDUTĖS;30268398324;Taip;6;0;0;6
13201;Žibutė;KREGŽDUTĖS;19878972163;Taip;0;0;9;9
13202;Žibutė;KREGŽDUTĖS;93449098365;Taip;0;0;2;2
13203;Žibutė;KREGŽDUTĖS;12199795507;Taip;0;2;9;11
13204;Žibutė;KREGŽDUTĖS;21619209538;Taip;11;0;1;12
13205;Žibutė;KREGŽDUTĖS;72754807096;Taip;0;2;3;5
13206;Žibutė;KREGŽDUTĖS;2027777207;Taip;0;4;0;4
13207;Žibutė;KREGŽDUTĖS;1264914533;Taip;0;3;0;3
13208;Žibutė;KREGŽDUTĖS;1735074467;Taip;10;0;3;13
13209;Žibutė;BORUŽĖLĖS;9700866512;Taip;0;0;2;2
13210;Žibutė;BORUŽĖLĖS;3268141759;Ne;0;10;0;10
13211;Žibutė;BORUŽĖLĖS;7774532200;Taip;0;6;0;6
13212;Žibutė;BORUŽĖLĖS;1366469428;Taip;17;0;5;22
13213;Žibutė;BORUŽĖLĖS;2607509585;Taip;1;5;0;6
13214;Žibutė;BORUŽĖLĖS;4825064521;Taip;0;13;0;13
13215;Žibutė;BORUŽĖLĖS;5826523148;Taip;11;1;0;12
13216;Žibutė;BORUŽĖLĖS;5806696915;Taip;10;0;0;10
13217;Žibutė;BORUŽĖLĖS;3957898269;Taip;0;6;0;6
13218;Žibutė;BORUŽĖLĖS;4814936645;Taip;9;0;0;9
13219;Žibutė;BORUŽĖLĖS;1004098038;Taip;22;0;0;22
13220;Žibutė;BORUŽĖLĖS;2880593326;Taip;4;0;0;4
13221;Žibutė;BORUŽĖLĖS;7479437931;Taip;22;0;0;22
13222;Žibutė;BITUTĖS;3194445795;Taip;0;8;0;8
13223;Žibutė;BITUTĖS;14091973543;Taip;10;0;0;10
13224;Žibutė;BITUTĖS;29414890756;Taip;22;0;0;22
13225;Žibutė;BITUTĖS;27182644850;Taip;0;1;0;1
13226;Žibutė;BITUTĖS;9591439732;Taip;0;1;1;2
13227;Žibutė;BITUTĖS;4491727022;Taip;0;4;0;4
13228;Žibutė;BITUTĖS;90040902859;Taip;6;0;0;6
13229;Žibutė;BITUTĖS;12087873516;Taip;2;9;0;11
13230;Žibutė;BITUTĖS;39367516353;Taip;0;0;4;4
13231;Žibutė;BITUTĖS;1192143609;Taip;0;4;0;4
13232;Žibutė;BITUTĖS;72357016152;Taip;0;7;0;7
13233;Žibutė;BITUTĖS;1054908586;Taip;0;6;0;6
13234;Žibutė;BITUTĖS;2603387036;Taip;10;0;1;11
13235;Žibutė;BITUTĖS;1317512329;Taip;0;2;0;2
13236;Žibutė;BITUTĖS;2144866874;Ne;0;2;0;2
13237;Žibutė;BITUTĖS;1010766308;Taip;0;1;0;1
13238;Žibutė;BITUTĖS;1749323904;Taip;0;1;0;1
13239;Žibutė;BITUTĖS;19558564943;Taip;7;2;0;9
13240;Žibutė;BITUTĖS;62187632470;Ne;5;1;3;9
13241;Žibutė;KAČIUKAI;94054589778;Taip;0;3;2;5
13242;Žibutė;KAČIUKAI;25658034484;Taip;0;13;0;13
13243;Žibutė;KAČIUKAI;6736950445;Taip;0;0;7;7
13244;Žibutė;KAČIUKAI;2089960385;Taip;0;1;6;7
13245;Žibutė;KAČIUKAI;29408732286;Taip;0;3;2;5
13246;Žibutė;KAČIUKAI;35959201106;Taip;0;2;8;10
13247;Žibutė;KAČIUKAI;67702702073;Taip;9;0;0;9
13248;Žibutė;KAČIUKAI;60756444655;Ne;0;1;1;2
13249;Žibutė;KAČIUKAI;33367530216;Taip;0;1;1;2
13250;Žibutė;KAČIUKAI;97730387781;Taip;0;3;0;3
13251;Žibutė;KAČIUKAI;51435935201;Taip;0;3;3;6
13252;Žibutė;KAČIUKAI;14243834326;Taip;0;2;3;5
13253;Žibutė;KAČIUKAI;19029125959;Taip;0;1;0;1
13254;Žibutė;KAČIUKAI;10269347801;Taip;0;3;10;13
13255;Žibutė;KAČIUKAI;76137370554;Taip;6;5;0;11
13256;Žibutė;KAČIUKAI;4475507372;Taip;18;3;0;21
13257;Žibutė;KAČIUKAI;2120935059;Taip;0;3;0;3
13258;Žibutė;KAČIUKAI;9655499291;Taip;2;0;0;2
13259;Žibutė;KAČIUKAI;31084244709;Taip;0;3;14;17
13260;Žibutė;ZUIKIAI;8715912139;Taip;7;0;0;7
13261;Žibutė;ZUIKIAI;5416015554;Taip;8;0;1;9
13262;Žibutė;ZUIKIAI;2406005105;Taip;10;0;0;10
13263;Žibutė;ZUIKIAI;3555071718;Taip;13;0;3;16
13264;Žibutė;ZUIKIAI;7531027545;Taip;7;0;3;10
13265;Žibutė;ZUIKIAI;3645481894;Taip;5;1;0;6
13266;Žibutė;ZUIKIAI;6074488747;Taip;0;0;2;2
13267;Žibutė;ZUIKIAI;8880329060;Taip;9;0;0;9
13268;Žibutė;ZUIKIAI;2957525481;Taip;7;0;0;7
13269;Žibutė;ZUIKIAI;5009495840;Ne;17;0;0;17
13270;Žibutė;ZUIKIAI;7136145033;Taip;3;0;0;3
13271;Žibutė;ZUIKIAI;5575614158;Taip;21;0;0;21
13272;Žibutė;ZUIKIAI;5190377896;Taip;5;0;8;13
13273;Žibutė;ZUIKIAI;3191351976;Taip;5;0;1;6
13274;Žibutė;ZUIKIAI;9498011134;Taip;5;1;0;6
13275;Žiedas;Bitutės;569146317;Taip;0;1;0;1
13276;Žiedas;Bitutės;61612709115;Ne;0;1;0;1
13277;Žiedas;Bitutės;52916954220;Taip;0;1;0;1
13278;Žiedas;Bitutės;94672053787;Ne;0;1;0;1
13279;Žiedas;Bitutės;70618764845;Ne;0;5;0;5
13280;Žiedas;Bitutės;86696082162;Ne;0;5;0;5
13281;Žiedas;Bitutės;59723024689;Taip;0;2;0;2
13282;Žiedas;Bitutės;14576604550;Taip;0;1;0;1
13283;Žiedas;Bitutės;35737299683;Taip;0;0;5;5
13284;Žiedas;Bitutės;35961318907;Ne;0;4;0;4
13285;Žiedas;Bitutės;4246111136;Ne;0;1;0;1
13286;Žiedas;Bitutės;55194855496;Taip;4;0;0;4
13287;Žiedas;Bitutės;69138351989;Taip;0;2;0;2
13288;Žiedas;Bitutės;31072310441;Taip;3;1;0;4
13289;Žiedas;Bitutės;54614633445;Taip;0;5;4;9
13290;Žiedas;Bitutės;42649178759;Taip;0;1;0;1
13291;Žiedas;Bitutės;1529539343;Taip;0;4;0;4
13292;Žiedas;Bitutės;4753427269;Taip;0;1;0;1
13293;Žiedas;Bitutės;45167345380;Taip;0;1;0;1
13294;Žiedas;Bitutės;20748238520;Taip;0;0;1;1
13295;Žiedas;Bitutės;53409153553;Taip;0;2;0;2
13296;Žiedas;Bitutės;7708303405;Taip;14;1;0;15
13297;Žiedas;Bitutės;79291005378;Taip;0;6;1;7
13298;Žiedas;Varpeliai;32671505578;Taip;0;5;0;5
13299;Žiedas;Varpeliai;50534384762;Taip;3;1;0;4
13300;Žiedas;Varpeliai;1733596148;Taip;3;0;0;3
13301;Žiedas;Varpeliai;55459877940;Ne;3;2;0;5
13302;Žiedas;Varpeliai;50069962197;Taip;3;1;0;4
13303;Žiedas;Varpeliai;59092030605;Taip;0;2;3;5
13304;Žiedas;Varpeliai;1748932818;Taip;2;2;1;5
13305;Žiedas;Varpeliai;17275054601;Taip;13;0;0;13
13306;Žiedas;Varpeliai;1897597456;Taip;0;1;0;1
13307;Žiedas;Varpeliai;1443451076;Taip;0;16;0;16
13308;Žiedas;Varpeliai;1491929025;Taip;0;3;0;3
13309;Žiedas;Varpeliai;2075892389;Ne;22;0;0;22
13310;Žiedas;Varpeliai;85152640431;Taip;4;2;0;6
13311;Žiedas;Varpeliai;2147350804;Taip;17;0;0;17
13312;Žiedas;Varpeliai;1366570116;Taip;2;7;0;9
13313;Žiedas;Varpeliai;37314210812;Taip;5;0;0;5
13314;Žiedas;Varpeliai;52683198809;Taip;0;2;0;2
13315;Žiedas;Varpeliai;99985645406;Taip;0;5;1;6
13316;Žiedas;Varpeliai;39022317368;Ne;1;0;0;1
13317;Žiedas;Varpeliai;1618815502;Taip;0;6;0;6
13318;Žiedas;Varpeliai;1332249885;Ne;0;4;0;4
13319;Žiedas;Varpeliai;12622490543;Ne;0;7;0;7
13320;Žiedas;Varpeliai;1120478375;Taip;17;2;0;19
13321;Žiedas;Varpeliai;2081656643;Taip;0;2;0;2
13322;Žiedas;Žirniukai;43123840066;Taip;4;2;0;6
13323;Žiedas;Žirniukai;65264733887;Ne;6;0;3;9
13324;Žiedas;Žirniukai;80003937908;Taip;0;3;0;3
13325;Žiedas;Žirniukai;4665596321;Taip;2;0;0;2
13326;Žiedas;Žirniukai;29411390190;Ne;0;1;0;1
13327;Žiedas;Žirniukai;20740539606;Taip;0;4;0;4
13328;Žiedas;Žirniukai;226707253;Taip;0;3;0;3
13329;Žiedas;Žirniukai;81304970766;Taip;9;6;0;15
13330;Žiedas;Žirniukai;66729734455;Taip;0;4;0;4
13331;Žiedas;Žirniukai;28885468502;Ne;0;2;2;4
13332;Žiedas;Žirniukai;50295529511;Taip;9;5;0;14
13333;Žiedas;Žirniukai;42777955874;Ne;0;3;0;3
13334;Žiedas;Žirniukai;23936058075;Taip;5;2;0;7
13335;Žiedas;Žirniukai;29665685563;Taip;0;1;0;1
13336;Žiedas;Žirniukai;22305887643;Taip;0;1;0;1
13337;Žiedas;Žirniukai;83630991208;Taip;0;3;0;3
13338;Žiedas;Žirniukai;38427730823;Ne;0;3;0;3
13339;Žiedas;Žirniukai;33966765931;Taip;4;1;0;5
13340;Žiedas;Žirniukai;56303923223;Taip;0;4;0;4
13341;Žiedas;Žirniukai;39792014616;Ne;0;5;0;5
13342;Žiedas;Žirniukai;31369021056;Taip;14;0;0;14
13343;Žiedas;Žirniukai;34178608904;Taip;0;17;0;17
13344;Žiedas;Žirniukai;1398197280;Taip;0;2;0;2
13345;Žiedas;Žirniukai;1288374706;Taip;0;4;0;4
13346;Žiedas;Žirniukai;1631546874;Ne;0;3;0;3
13347;Žiedas;Žirniukai;1817676038;Taip;0;3;0;3
13348;Žiedas;Žirniukai;85519253910;Taip;0;2;0;2
13349;Žiedas;Žirniukai;2063680054;Taip;10;3;0;13
13350;Žiedas;Ramunėlės;9648580306;Taip;0;1;0;1
13351;Žiedas;Ramunėlės;9736967156;Taip;0;2;2;4
13352;Žiedas;Ramunėlės;4922560649;Taip;0;2;13;15
13353;Žiedas;Ramunėlės;7814504623;Taip;0;0;1;1
13354;Žiedas;Ramunėlės;2095655987;Ne;0;2;0;2
13355;Žiedas;Ramunėlės;6703889237;Taip;0;6;0;6
13356;Žiedas;Ramunėlės;7954517383;Taip;4;1;0;5
13357;Žiedas;Ramunėlės;9247088735;Taip;11;0;0;11
13358;Žiedas;Ramunėlės;9699668892;Taip;0;7;0;7
13359;Žiedas;Ramunėlės;6432090199;Taip;0;19;0;19
13360;Žiedas;Ramunėlės;1139186052;Taip;5;2;10;17
13361;Žiedas;Ramunėlės;5653785844;Taip;0;0;1;1
13362;Žiedas;Ramunėlės;5588136738;Taip;0;6;0;6
13363;Žiedas;Ramunėlės;5626494892;Taip;18;0;0;18
13364;Žiedas;Ramunėlės;2083493509;Taip;0;0;2;2
13365;Žiedas;Ramunėlės;7396006218;Taip;10;0;0;10
13366;Žiedas;Ramunėlės;3586376571;Taip;21;0;0;21
13367;Žiedas;Ramunėlės;6786526552;Taip;5;1;0;6
13368;Žiedas;Ramunėlės;3702078720;Taip;3;0;1;4
13369;Žiedas;Bruknelės;1772492727;Taip;7;0;0;7
13370;Žiedas;Bruknelės;6925923143;Taip;20;1;0;21
13371;Žiedas;Bruknelės;1781950568;Taip;0;10;0;10
13372;Žiedas;Bruknelės;1453937876;Taip;13;0;0;13
13373;Žiedas;Bruknelės;9573180529;Taip;17;2;0;19
13374;Žiedas;Bruknelės;3385568839;Taip;15;6;0;21
13375;Žiedas;Bruknelės;2718046390;Taip;0;5;0;5
13376;Žiedas;Bruknelės;9757771445;Taip;0;11;0;11
13377;Žiedas;Bruknelės;4749655084;Taip;0;1;0;1
13378;Žiedas;Bruknelės;5570910138;Ne;0;8;0;8
13379;Žiedas;Bruknelės;73923918829;Taip;0;5;0;5
13380;Žiedas;Bruknelės;3641595127;Taip;0;6;0;6
13381;Žiedas;Bruknelės;3613860509;Taip;0;6;0;6
13382;Žiedas;Bruknelės;9702211410;Taip;7;8;0;15
13383;Žiedas;Bruknelės;3370495317;Taip;0;11;0;11
13384;Žiedas;Bruknelės;2026462074;Taip;0;0;1;1
13385;Žiedas;Bruknelės;1856012121;Taip;7;0;2;9
13386;Žiedas;Bruknelės;1534169381;Taip;0;1;0;1
13387;Žiedas;Bruknelės;4521161684;Taip;0;6;0;6
13388;Žiedas;Bruknelės;9415269410;Taip;10;0;0;10
13389;Žiedas;Bruknelės;9094287056;Taip;15;0;0;15
13390;Žiedas;Bruknelės;5537717174;Taip;0;8;0;8
13391;Žiedas;Bruknelės;8372385066;Taip;7;0;1;8
13392;Žiedas;Pakalnutės;1063755068;Taip;0;0;1;1
13393;Žiedas;Pakalnutės;42049755986;Taip;6;4;0;10
13394;Žiedas;Pakalnutės;52721173922;Taip;0;2;0;2
13395;Žiedas;Pakalnutės;58252361010;Taip;0;2;0;2
13396;Žiedas;Pakalnutės;2060067625;Taip;0;7;0;7
13397;Žiedas;Pakalnutės;2434909184;Taip;0;1;0;1
13398;Žiedas;Pakalnutės;3616767119;Taip;0;1;0;1
13399;Žiedas;Pakalnutės;1835889494;Taip;0;1;0;1
13400;Žiedas;Pakalnutės;1600420971;Taip;5;4;0;9
13401;Žiedas;Pakalnutės;3930283171;Taip;3;7;0;10
13402;Žiedas;Pakalnutės;1985949180;Taip;0;0;1;1
13403;Žiedas;Pakalnutės;1708363648;Taip;0;6;0;6
13404;Žiedas;Pakalnutės;1779122644;Taip;2;6;0;8
13405;Žiedas;Pakalnutės;9940683245;Taip;0;2;1;3
13406;Žiedas;Pakalnutės;27339844730;Taip;0;6;0;6
13407;Žiedas;Pakalnutės;5812737969;Taip;0;2;0;2
13408;Žiedas;Pakalnutės;1127645903;Ne;0;2;5;7
13409;Žiedas;Pakalnutės;1219022794;Taip;16;1;0;17
13410;Žiedas;Pakalnutės;7647496475;Taip;0;6;0;6
13411;Žiedas;Pakalnutės;1785446716;Taip;0;6;0;6
13412;Žiedas;Pakalnutės;2094277643;Ne;1;0;0;1
13413;Žiedas;Pakalnutės;12960180114;Taip;0;2;0;2
13414;Žiedas;Spanguolytės;5282211767;Taip;0;3;0;3
13415;Žiedas;Spanguolytės;53090437775;Taip;9;2;0;11
13416;Žiedas;Spanguolytės;69245659818;Taip;0;5;0;5
13417;Žiedas;Spanguolytės;9363714015;Taip;0;5;0;5
13418;Žiedas;Spanguolytės;1318132922;Taip;0;3;0;3
13419;Žiedas;Spanguolytės;2037477873;Ne;0;1;0;1
13420;Žiedas;Spanguolytės;5079107907;Taip;0;1;0;1
13421;Žiedas;Spanguolytės;1450251779;Taip;0;5;0;5
13422;Žiedas;Spanguolytės;4502784565;Taip;0;2;0;2
13423;Žiedas;Spanguolytės;7136135394;Taip;7;5;0;12
13424;Žiedas;Spanguolytės;8517250094;Taip;0;0;6;6
13425;Žiedas;Spanguolytės;6815408748;Taip;2;2;0;4
13426;Žiedas;Spanguolytės;36350993825;Taip;7;0;0;7
13427;Žiedas;Spanguolytės;2391924358;Taip;5;2;0;7
13428;Žiedas;Spanguolytės;8172222365;Taip;0;6;0;6
13429;Žiedas;Spanguolytės;9259436243;Taip;10;2;0;12
13430;Žiedas;Spanguolytės;3346603228;Taip;9;1;0;10
13431;Žiedas;Spanguolytės;5451923881;Taip;17;0;0;17
13432;Žiedas;Rožytės;4016573192;Taip;6;0;0;6
13433;Žiedas;Rožytės;1771805131;Taip;8;1;0;9
13434;Žiedas;Rožytės;83777073799;Taip;7;2;0;9
13435;Žiedas;Rožytės;65360328423;Taip;14;0;0;14
13436;Žiedas;Rožytės;8241660222;Taip;10;1;0;11
13437;Žiedas;Rožytės;4621822895;Ne;1;0;2;3
13438;Žiedas;Rožytės;18236935510;Taip;6;5;0;11
13439;Žiedas;Rožytės;37978194696;Taip;22;0;0;22
13440;Žiedas;Rožytės;98235996578;Taip;0;6;0;6
13441;Žiedas;Rožytės;1971475040;Taip;9;1;0;10
13442;Žiedas;Rožytės;2098165226;Taip;0;8;0;8
13443;Žiedas;Rožytės;1079445123;Taip;0;0;4;4
13444;Žiedas;Rožytės;6745229012;Taip;0;6;0;6
13445;Žiedas;Rožytės;1136010138;Taip;8;7;0;15
13446;Žiedas;Rožytės;74421578926;Taip;8;3;0;11
13447;Žiedas;Rožytės;1618505155;Taip;6;1;0;7
13448;Žiedas;Rožytės;47457128214;Taip;15;0;0;15
13449;Žiedas;Rožytės;40744263923;Taip;6;2;0;8
13450;Žiedas;Rožytės;33135652351;Ne;5;0;3;8
13451;Žiedas;Rožytės;87240375524;Taip;22;0;0;22
13452;Žiedas;Rožytės;1893226570;Taip;7;1;0;8
13453;Žiedas;Rožytės;54324583490;Taip;16;0;1;17
13454;Žiedas;Rožytės;7283725455;Taip;14;3;0;17
13455;Žiedas;Rožytės;56707734658;Taip;16;0;0;16
13456;Žiedas;Rožytės;2157262849;Taip;0;10;0;10
13457;Žiedas;Pumpurėliai;5647232875;Taip;9;2;0;11
13458;Žiedas;Pumpurėliai;1048272199;Taip;0;2;0;2
13459;Žiedas;Pumpurėliai;1645402434;Taip;22;0;0;22
13460;Žiedas;Pumpurėliai;5126173608;Taip;4;3;2;9
13461;Žiedas;Pumpurėliai;6443633568;Taip;17;3;0;20
13462;Žiedas;Pumpurėliai;5959899914;Taip;8;10;0;18
13463;Žiedas;Pumpurėliai;5885209631;Taip;6;1;0;7
13464;Žiedas;Pumpurėliai;7578964555;Taip;9;3;0;12
13465;Žiedas;Pumpurėliai;2134466899;Taip;19;0;0;19
13466;Žiedas;Pumpurėliai;1253833615;Taip;7;1;0;8
13467;Žiedas;Pumpurėliai;4497634040;Taip;1;0;3;4
13468;Žiedas;Pumpurėliai;6822887260;Taip;0;7;0;7
13469;Žiedas;Pumpurėliai;5420327672;Taip;7;6;0;13
13470;Žiedas;Pumpurėliai;5108263139;Ne;22;0;0;22
13471;Žiedas;Pumpurėliai;5703750436;Taip;0;1;0;1
13472;Žiedas;Pumpurėliai;7057747531;Taip;7;4;0;11
13473;Žiedas;Pumpurėliai;3857121753;Taip;7;0;0;7
13474;Žiedas;Pumpurėliai;3715928992;Taip;0;0;2;2
13475;Žiedas;Pumpurėliai;9352485926;Taip;12;0;0;12
13476;Žiedas;Pumpurėliai;7333813704;Ne;0;2;0;2
13477;Žiedas;Žemuogėlės;7672879525;Taip;14;0;0;14
13478;Žiedas;Žemuogėlės;7097790025;Taip;2;2;0;4
13479;Žiedas;Žemuogėlės;3387263016;Ne;9;2;0;11
13480;Žiedas;Žemuogėlės;1219634640;Taip;3;0;4;7
13481;Žiedas;Žemuogėlės;8927034492;Taip;0;22;0;22
13482;Žiedas;Žemuogėlės;8208331527;Taip;9;0;0;9
13483;Žiedas;Žemuogėlės;1738121071;Taip;7;4;0;11
13484;Žiedas;Žemuogėlės;9037835899;Ne;17;2;0;19
13485;Žiedas;Žemuogėlės;5652936425;Taip;7;0;0;7
13486;Žiedas;Žemuogėlės;1583038469;Taip;17;0;0;17
13487;Žiedas;Žemuogėlės;8812316692;Taip;19;0;0;19
13488;Žiedas;Žemuogėlės;3178778438;Taip;7;2;6;15
13489;Žiedas;Žemuogėlės;2849254119;Taip;10;7;0;17
13490;Žiedas;Žemuogėlės;5914428064;Taip;9;6;0;15
13491;Žiedas;Žemuogėlės;3900091129;Taip;8;7;0;15
13492;Žiedas;Žemuogėlės;3067962647;Ne;0;15;1;16
13493;Žiedas;Žemuogėlės;9587581470;Taip;10;1;0;11
13494;Žiedas;Žemuogėlės;9218388800;Taip;13;1;0;14
13495;Žiedas;Žemuogėlės;9140396365;Taip;14;1;0;15
13496;Žiedas;Žemuogėlės;6444377924;Taip;11;0;0;11
13497;Žiedas;Žemuogėlės;7172793351;Ne;9;7;0;16
13498;Žiedas;Žemuogėlės;5578227349;Taip;12;1;0;13
13499;Žiedas;"Žibutė ";4983852075;Taip;13;0;0;13
13500;Žiedas;"Žibutė ";9129315784;Taip;0;7;0;7
13501;Žiedas;"Žibutė ";9750690920;Taip;13;2;0;15
13502;Žiedas;"Žibutė ";1333233100;Taip;11;0;0;11
13503;Žiedas;"Žibutė ";8645771800;Taip;22;0;0;22
13504;Žiedas;"Žibutė ";4556559021;Taip;7;1;0;8
13505;Žiedas;"Žibutė ";6041919197;Taip;8;0;0;8
13506;Žiedas;"Žibutė ";7187176169;Taip;5;3;0;8
13507;Žiedas;"Žibutė ";4222689492;Taip;0;1;0;1
13508;Žiedas;"Žibutė ";2182381160;Taip;9;0;0;9
13509;Žiedas;"Žibutė ";4284627073;Taip;5;0;0;5
13510;Žiedas;"Žibutė ";8822472312;Taip;0;4;0;4
13511;Žiedas;"Žibutė ";7952899220;Taip;5;9;0;14
13512;Žiedas;"Žibutė ";1777501190;Taip;0;2;0;2
13513;Žiedas;"Žibutė ";1043230748;Taip;5;0;0;5
13514;Žiedas;"Žibutė ";1844621525;Taip;0;1;0;1
13515;Žiedas;"Žibutė ";9021286246;Taip;0;3;0;3
13516;Žiedas;"Dobiliukai ";88471315730;Taip;10;3;0;13
13517;Žiedas;"Dobiliukai ";1484464986;Taip;9;1;0;10
13518;Žiedas;"Dobiliukai ";34193530;Taip;0;1;0;1
13519;Žiedas;"Dobiliukai ";1529988412;Taip;0;1;0;1
13520;Žiedas;"Dobiliukai ";78720591915;Taip;0;5;0;5
13521;Žiedas;"Dobiliukai ";2763469583;Taip;5;0;0;5
13522;Žiedas;"Dobiliukai ";86877563124;Taip;14;1;0;15
13523;Žiedas;"Dobiliukai ";1458152054;Ne;0;6;0;6
13524;Žiedas;"Dobiliukai ";3414702993;Taip;0;2;0;2
13525;Žiedas;"Dobiliukai ";1007894628;Taip;8;6;0;14
13526;Žiedas;"Dobiliukai ";1625009666;Taip;0;4;0;4
13527;Žiedas;"Dobiliukai ";1868951268;Taip;9;1;0;10
13528;Žiedas;"Dobiliukai ";1824692620;Taip;3;1;0;4
13529;Žiedas;"Dobiliukai ";9058688663;Ne;8;3;0;11
13530;Žiedas;"Dobiliukai ";2026728639;Taip;6;2;0;8
13531;Žiedas;"Dobiliukai ";7150433256;Taip;6;0;0;6
13532;Žiedas;"Dobiliukai ";6145720452;Taip;0;3;0;3
13533;Žiedas;"Dobiliukai ";1030089009;Ne;7;4;0;11
13534;Žiedas;"Dobiliukai ";4807479784;Taip;0;2;0;2
13535;Žiedas;"Dobiliukai ";2507543124;Taip;0;7;0;7
13536;Žiedas;Boružėlės;32267919915;Taip;6;0;0;6
13537;Žiedas;Boružėlės;18549289812;Taip;0;1;0;1
13538;Žiedas;Boružėlės;71843517726;Taip;0;1;0;1
13539;Žiedas;Boružėlės;9117238535;Taip;0;8;0;8
13540;Žiedas;Boružėlės;23799596522;Ne;0;0;1;1
13541;Žiedas;Boružėlės;18469282227;Taip;5;1;0;6
13542;Žiedas;Boružėlės;13070834235;Taip;0;0;4;4
13543;Žiedas;Boružėlės;74893931156;Taip;0;0;1;1
13544;Žiedas;Boružėlės;25196433027;Ne;0;5;0;5
13545;Žiedas;Boružėlės;71241692542;Taip;0;2;0;2
13546;Žiedas;Boružėlės;2025846226;Taip;0;2;0;2
13547;Žiedas;Boružėlės;1748516954;Taip;0;2;0;2
13548;Žiedas;Boružėlės;57434309890;Taip;0;0;1;1
13549;Žiedas;Boružėlės;55246099530;Taip;0;5;0;5
13550;Žiedas;Boružėlės;26141244088;Taip;0;0;12;12
13551;Žiedas;Boružėlės;12163984089;Taip;0;4;0;4
13552;Žiedas;Boružėlės;62185387860;Taip;0;1;0;1
13553;Žiedas;Boružėlės;95883894012;Ne;0;11;0;11
13554;Žiogelis;SKRUZDELYTĖS;4508141956;Taip;0;0;8;8
13555;Žiogelis;SKRUZDELYTĖS;4343510173;Taip;5;9;0;14
13556;Žiogelis;SKRUZDELYTĖS;6346503991;Taip;12;0;2;14
13557;Žiogelis;SKRUZDELYTĖS;18018505301;Taip;0;13;0;13
13558;Žiogelis;SKRUZDELYTĖS;6067622823;Taip;0;1;0;1
13559;Žiogelis;SKRUZDELYTĖS;8702710674;Taip;9;12;0;21
13560;Žiogelis;SKRUZDELYTĖS;4671356872;Taip;3;3;0;6
13561;Žiogelis;SKRUZDELYTĖS;7881358741;Taip;0;3;0;3
13562;Žiogelis;SKRUZDELYTĖS;3750023611;Taip;2;0;0;2
13563;Žiogelis;SKRUZDELYTĖS;3609961581;Taip;7;2;1;10
13564;Žiogelis;SKRUZDELYTĖS;64865699245;Taip;1;2;0;3
13565;Žiogelis;SKRUZDELYTĖS;60959051938;Taip;8;0;0;8
13566;Žiogelis;SKRUZDELYTĖS;95713316600;Taip;11;0;0;11
13567;Žiogelis;SKRUZDELYTĖS;4445888917;Taip;0;1;0;1
13568;Žiogelis;SKRUZDELYTĖS;24941867247;Ne;13;5;0;18
13569;Žiogelis;SKRUZDELYTĖS;6659086172;Ne;17;2;0;19
13570;Žiogelis;SKRUZDELYTĖS;2883732914;Taip;10;12;0;22
13571;Žiogelis;SKRUZDELYTĖS;3189872952;Taip;10;12;0;22
13572;Žiogelis;SKRUZDELYTĖS;9295720241;Taip;18;0;0;18
13573;Žiogelis;SKRUZDELYTĖS;1568915914;Taip;6;5;0;11
13574;Žiogelis;SKRUZDELYTĖS;3203359908;Taip;2;2;1;5
13575;Žiogelis;SKRUZDELYTĖS;3320077143;Taip;10;0;2;12
13576;Žiogelis;ŽIRNIUKAI;7704256764;Taip;0;9;0;9
13577;Žiogelis;ŽIRNIUKAI;2233244282;Taip;0;5;0;5
13578;Žiogelis;ŽIRNIUKAI;8675451323;Taip;0;1;0;1
13579;Žiogelis;ŽIRNIUKAI;85437321236;Taip;4;0;0;4
13580;Žiogelis;ŽIRNIUKAI;1660784232;Taip;22;0;0;22
13581;Žiogelis;ŽIRNIUKAI;1320651707;Taip;4;4;0;8
13582;Žiogelis;ŽIRNIUKAI;1235203700;Taip;2;0;0;2
13583;Žiogelis;ŽIRNIUKAI;1551989977;Taip;2;0;0;2
13584;Žiogelis;ŽIRNIUKAI;3310492752;Taip;3;0;0;3
13585;Žiogelis;ŽIRNIUKAI;5557800297;Taip;6;3;0;9
13586;Žiogelis;ŽIRNIUKAI;3392582853;Taip;10;0;0;10
13587;Žiogelis;ŽIRNIUKAI;2366095661;Taip;3;0;0;3
13588;Žiogelis;ŽIRNIUKAI;1320126836;Taip;0;1;0;1
13589;Žiogelis;ŽIRNIUKAI;1442866468;Taip;22;0;0;22
13590;Žiogelis;ŽIRNIUKAI;6697117406;Taip;3;0;1;4
13591;Žiogelis;ŽIRNIUKAI;9862582346;Taip;6;0;3;9
13592;Žiogelis;ŽIRNIUKAI;7087781379;Taip;12;5;0;17
13593;Žiogelis;ŽIRNIUKAI;4015109974;Taip;12;5;0;17
13594;Žiogelis;ŽIRNIUKAI;9406830518;Taip;6;3;0;9
13595;Žiogelis;ŽIRNIUKAI;3910954904;Taip;2;0;0;2
13596;Žiogelis;ŽIRNIUKAI;4713696984;Taip;0;0;5;5
13597;Žiogelis;DOBILĖLIAI;48593529087;Taip;0;3;0;3
13598;Žiogelis;DOBILĖLIAI;66336692039;Taip;0;0;1;1
13599;Žiogelis;DOBILĖLIAI;80149085891;Ne;5;0;9;14
13600;Žiogelis;DOBILĖLIAI;62821992692;Taip;0;2;5;7
13601;Žiogelis;DOBILĖLIAI;54215852783;Taip;0;0;2;2
13602;Žiogelis;DOBILĖLIAI;93657289013;Ne;0;6;0;6
13603;Žiogelis;DOBILĖLIAI;52411020277;Taip;0;3;0;3
13604;Žiogelis;DOBILĖLIAI;30708203430;Taip;0;2;0;2
13605;Žiogelis;DOBILĖLIAI;98097805447;Taip;0;10;0;10
13606;Žiogelis;DOBILĖLIAI;62488730896;Taip;0;6;0;6
13607;Žiogelis;DOBILĖLIAI;50662980044;Taip;0;2;0;2
13608;Žiogelis;DOBILĖLIAI;41857562297;Taip;0;4;0;4
13609;Žiogelis;DOBILĖLIAI;78375291773;Taip;0;0;2;2
13610;Žiogelis;DOBILĖLIAI;82777324022;Taip;8;6;0;14
13611;Žiogelis;DOBILĖLIAI;1970044099;Taip;0;6;0;6
13612;Žiogelis;DOBILĖLIAI;34243919860;Ne;0;0;3;3
13613;Žiogelis;BORUŽĖLĖS;49537204301;Taip;0;3;0;3
13614;Žiogelis;BORUŽĖLĖS;48952047191;Taip;0;2;1;3
13615;Žiogelis;BORUŽĖLĖS;64779912059;Taip;0;0;4;4
13616;Žiogelis;BORUŽĖLĖS;73428910367;Taip;0;1;0;1
13617;Žiogelis;BORUŽĖLĖS;3136149837;Taip;4;1;0;5
13618;Žiogelis;BORUŽĖLĖS;41126779124;Taip;0;2;0;2
13619;Žiogelis;BORUŽĖLĖS;33241743715;Taip;21;0;0;21
13620;Žiogelis;BORUŽĖLĖS;57249343296;Taip;0;4;0;4
13621;Žiogelis;BORUŽĖLĖS;85673565399;Taip;9;2;0;11
13622;Žiogelis;BORUŽĖLĖS;81464649021;Taip;0;0;6;6
13623;Žiogelis;BORUŽĖLĖS;74697514256;Ne;0;10;0;10
13624;Žiogelis;BORUŽĖLĖS;18978600625;Taip;0;3;0;3
13625;Žiogelis;BORUŽĖLĖS;89033004994;Taip;5;13;0;18
13626;Žiogelis;BORUŽĖLĖS;73146584544;Taip;0;11;0;11
13627;Žiogelis;BORUŽĖLĖS;86839909955;Taip;0;2;1;3
13628;Žiogelis;BORUŽĖLĖS;78885512443;Ne;0;3;0;3
13629;Žiogelis;BORUŽĖLĖS;2000906677;Taip;0;1;0;1
13630;Žiogelis;BORUŽĖLĖS;52901528922;Taip;0;2;0;2
13631;Žiogelis;DRUGELIAI;40049935108;Taip;0;5;0;5
13632;Žiogelis;DRUGELIAI;37505015919;Taip;7;0;4;11
13633;Žiogelis;DRUGELIAI;85453441005;Taip;0;0;6;6
13634;Žiogelis;DRUGELIAI;25631779076;Taip;19;2;0;21
13635;Žiogelis;DRUGELIAI;40186714037;Taip;0;2;0;2
13636;Žiogelis;DRUGELIAI;52847485981;Taip;0;1;0;1
13637;Žiogelis;DRUGELIAI;96369154198;Ne;0;1;3;4
13638;Žiogelis;DRUGELIAI;56579227266;Ne;0;1;8;9
13639;Žiogelis;DRUGELIAI;66037746045;Taip;0;5;0;5
13640;Žiogelis;DRUGELIAI;68621438109;Taip;0;6;0;6
13641;Žiogelis;DRUGELIAI;18225364866;Taip;0;0;1;1
13642;Žiogelis;DRUGELIAI;18957711548;Taip;6;0;0;6
13643;Žiogelis;DRUGELIAI;52855728176;Ne;0;5;0;5
13644;Žiogelis;DRUGELIAI;35609682774;Taip;0;1;0;1
13645;Žiogelis;DRUGELIAI;1096666450;Taip;0;1;0;1
13646;Žiogelis;DRUGELIAI;1237788562;Taip;0;6;0;6
13647;Žiogelis;DRUGELIAI;1867019234;Taip;4;0;0;4
13648;Žiogelis;DRUGELIAI;1082983134;Taip;0;0;2;2
13649;Žiogelis;DRUGELIAI;97696839366;Taip;0;1;2;3
13650;Žiogelis;PELĖDŽIUKAI;25765405268;Taip;0;9;0;9
13651;Žiogelis;PELĖDŽIUKAI;40656416455;Taip;0;7;0;7
13652;Žiogelis;PELĖDŽIUKAI;58435832422;Taip;0;6;0;6
13653;Žiogelis;PELĖDŽIUKAI;65431295185;Taip;0;5;0;5
13654;Žiogelis;PELĖDŽIUKAI;54157468880;Taip;0;1;0;1
13655;Žiogelis;PELĖDŽIUKAI;75990939732;Taip;0;1;0;1
13656;Žiogelis;PELĖDŽIUKAI;46206606894;Taip;0;2;0;2
13657;Žiogelis;PELĖDŽIUKAI;87136010729;Taip;0;1;0;1
13658;Žiogelis;PELĖDŽIUKAI;88467192459;Taip;0;20;0;20
13659;Žiogelis;PELĖDŽIUKAI;23052639699;Taip;0;4;1;5
13660;Žiogelis;PELĖDŽIUKAI;1303123383;Taip;0;2;1;3
13661;Žiogelis;PELĖDŽIUKAI;62633906174;Taip;0;2;0;2
13662;Žiogelis;PELĖDŽIUKAI;2100993889;Ne;0;4;0;4
13663;Žiogelis;PELĖDŽIUKAI;80050087040;Taip;0;19;0;19
13664;Žiogelis;VARPELIAI;98313060080;Taip;0;3;0;3
13665;Žiogelis;VARPELIAI;63443494015;Taip;5;3;0;8
13666;Žiogelis;VARPELIAI;1069475442;Ne;0;3;0;3
13667;Žiogelis;VARPELIAI;72043183625;Taip;0;2;0;2
13668;Žiogelis;VARPELIAI;42165847795;Taip;2;4;0;6
13669;Žiogelis;VARPELIAI;1198917418;Taip;4;7;0;11
13670;Žiogelis;VARPELIAI;1261679627;Taip;4;7;0;11
13671;Žiogelis;VARPELIAI;42895811959;Taip;3;5;0;8
13672;Žiogelis;VARPELIAI;44118139818;Taip;3;4;0;7
13673;Žiogelis;VARPELIAI;7708273984;Taip;18;0;0;18
13674;Žiogelis;VARPELIAI;12932356909;Taip;2;4;0;6
13675;Žiogelis;VARPELIAI;1060830668;Taip;21;0;0;21
13676;Žiogelis;VARPELIAI;9871477318;Taip;18;0;0;18
13677;Žiogelis;VARPELIAI;6225523016;Taip;9;5;0;14
13678;Žiogelis;VARPELIAI;9436611716;Taip;8;8;0;16
13679;Žiogelis;VARPELIAI;2575280329;Taip;0;2;0;2
13680;Žiogelis;VARPELIAI;4402777236;Taip;16;0;0;16
13681;Žiogelis;VARPELIAI;1370071592;Taip;4;6;0;10
13682;Žiogelis;VARPELIAI;9416538794;Taip;7;1;0;8
13683;Žiogelis;VARPELIAI;8983731310;Taip;12;1;0;13
13684;Žiogelis;VARPELIAI;7888873296;Taip;12;4;0;16
13685;Žiogelis;KREGŽDUTĖS;20399291813;Ne;6;2;0;8
13686;Žiogelis;KREGŽDUTĖS;1521276302;Taip;0;1;0;1
13687;Žiogelis;KREGŽDUTĖS;28585504631;Taip;4;0;2;6
13688;Žiogelis;KREGŽDUTĖS;71387182665;Ne;12;1;0;13
13689;Žiogelis;KREGŽDUTĖS;94690046398;Taip;0;1;1;2
13690;Žiogelis;KREGŽDUTĖS;94313785346;Taip;8;1;0;9
13691;Žiogelis;KREGŽDUTĖS;88933947850;Taip;0;0;2;2
13692;Žiogelis;KREGŽDUTĖS;22969768169;Taip;13;0;0;13
13693;Žiogelis;KREGŽDUTĖS;1042591705;Taip;0;3;0;3
13694;Žiogelis;KREGŽDUTĖS;1162630845;Taip;0;1;0;1
13695;Žiogelis;KREGŽDUTĖS;2072071751;Taip;0;1;0;1
13696;Žiogelis;KREGŽDUTĖS;1200247527;Taip;19;0;0;19
13697;Žiogelis;KREGŽDUTĖS;44023584723;Taip;0;1;3;4
13698;Žiogelis;KREGŽDUTĖS;1821759690;Taip;5;1;0;6
13699;Žiogelis;KREGŽDUTĖS;24010106626;Taip;0;11;0;11
13700;Žiogelis;ŽVIRBLIUKAI;5364996984;Taip;13;0;0;13
13701;Žiogelis;ŽVIRBLIUKAI;9568208184;Taip;13;0;0;13
13702;Žiogelis;ŽVIRBLIUKAI;2117192553;Taip;11;0;0;11
13703;Žiogelis;ŽVIRBLIUKAI;5961630249;Taip;6;0;0;6
13704;Žiogelis;ŽVIRBLIUKAI;8683148826;Taip;0;10;0;10
13705;Žiogelis;ŽVIRBLIUKAI;3502278745;Taip;5;0;0;5
13706;Žiogelis;ŽVIRBLIUKAI;5054228916;Taip;8;0;0;8
13707;Žiogelis;ŽVIRBLIUKAI;3308563362;Taip;6;2;0;8
13708;Žiogelis;ŽVIRBLIUKAI;3928697936;Taip;12;0;0;12
13709;Žiogelis;ŽVIRBLIUKAI;1465027680;Taip;18;0;0;18
13710;Žiogelis;ŽVIRBLIUKAI;6495456608;Taip;13;0;0;13
13711;Žiogelis;ŽVIRBLIUKAI;3852211212;Taip;0;2;0;2
13712;Žiogelis;ŽVIRBLIUKAI;9813150014;Taip;14;0;0;14
13713;Žiogelis;BITUTĖS;5639046412;Ne;11;4;0;15
13714;Žiogelis;BITUTĖS;65387706999;Taip;0;3;0;3
13715;Žiogelis;BITUTĖS;98660118094;Taip;15;4;0;19
13716;Žiogelis;BITUTĖS;6963163354;Taip;0;8;0;8
13717;Žiogelis;BITUTĖS;29876596658;Taip;3;0;0;3
13718;Žiogelis;BITUTĖS;84919810287;Taip;0;1;0;1
13719;Žiogelis;BITUTĖS;48896172781;Taip;0;2;0;2
13720;Žiogelis;BITUTĖS;14932261911;Taip;0;2;0;2
13721;Žiogelis;BITUTĖS;67475530006;Ne;0;9;0;9
13722;Žiogelis;BITUTĖS;49836275638;Taip;2;0;0;2
13723;Žiogelis;BITUTĖS;81608736626;Taip;0;0;2;2
13724;Žiogelis;BITUTĖS;39293593638;Taip;0;0;1;1
13725;Žiogelis;BITUTĖS;1617516552;Taip;0;0;2;2
13726;Žiogelis;BITUTĖS;63956907259;Taip;0;2;0;2
13727;Žiogelis;BITUTĖS;73793165310;Taip;0;2;0;2
13728;Žiogelis;BITUTĖS;28788742249;Taip;0;2;0;2
13729;Žiogelis;BITUTĖS;4465151986;Taip;0;6;0;6
13730;Žiogelis;BITUTĖS;45051106222;Taip;0;5;1;6
13731;Žiogelis;BITUTĖS;87755643169;Taip;0;1;0;1
13732;Žiogelis;RIEŠUTĖLIAI;9981130790;Taip;0;22;0;22
13733;Žiogelis;RIEŠUTĖLIAI;9627583831;Taip;9;4;0;13
13734;Žiogelis;RIEŠUTĖLIAI;3420228264;Taip;2;0;0;2
13735;Žiogelis;RIEŠUTĖLIAI;5042341085;Taip;13;0;0;13
13736;Žiogelis;RIEŠUTĖLIAI;3752355139;Taip;0;0;3;3
13737;Žiogelis;RIEŠUTĖLIAI;3296450902;Taip;3;0;0;3
13738;Žiogelis;RIEŠUTĖLIAI;1996517542;Taip;0;22;0;22
13739;Žiogelis;RIEŠUTĖLIAI;5545581078;Taip;6;0;0;6
13740;Žiogelis;RIEŠUTĖLIAI;9790463889;Taip;0;16;0;16
13741;Žiogelis;RIEŠUTĖLIAI;6024752960;Taip;4;1;0;5
13742;Žiogelis;RIEŠUTĖLIAI;8853905367;Taip;4;1;0;5
13743;Žiogelis;RIEŠUTĖLIAI;6760074113;Taip;0;2;0;2
13744;Žiogelis;RIEŠUTĖLIAI;3792114246;Taip;11;1;0;12
13745;Žiogelis;RIEŠUTĖLIAI;8293687695;Taip;8;4;0;12
13746;Žiogelis;RIEŠUTĖLIAI;2455244286;Taip;7;0;0;7
13747;Žolynėlis;Spanguolėlė;25151683915;Taip;0;2;0;2
13748;Žolynėlis;Spanguolėlė;8104525380;Taip;0;2;0;2
13749;Žolynėlis;Spanguolėlė;24353356454;Taip;22;0;0;22
13750;Žolynėlis;Spanguolėlė;97976573561;Taip;5;0;0;5
13751;Žolynėlis;Spanguolėlė;1920564803;Taip;8;2;1;11
13752;Žolynėlis;Spanguolėlė;82641799101;Taip;5;0;2;7
13753;Žolynėlis;Spanguolėlė;95943166746;Taip;4;10;1;15
13754;Žolynėlis;Spanguolėlė;4109395683;Taip;22;0;0;22
13755;Žolynėlis;Spanguolėlė;5717038791;Taip;22;0;0;22
13756;Žolynėlis;Spanguolėlė;15306882704;Taip;0;1;0;1
13757;Žolynėlis;Spanguolėlė;7438853916;Ne;7;5;4;16
13758;Žolynėlis;Spanguolėlė;44063150309;Taip;8;1;1;10
13759;Žolynėlis;Spanguolėlė;8700231970;Taip;0;1;1;2
13760;Žolynėlis;Spanguolėlė;7831076713;Ne;10;0;0;10
13761;Žolynėlis;Spanguolėlė;1901979061;Ne;5;6;0;11
13762;Žolynėlis;"RŪTELĖ (spec)";49076759224;Taip;10;8;0;18
13763;Žolynėlis;"RŪTELĖ (spec)";48837362422;Taip;10;2;0;12
13764;Žolynėlis;"RŪTELĖ (spec)";44929463545;Taip;11;0;0;11
13765;Žolynėlis;"RŪTELĖ (spec)";88879292846;Taip;10;2;0;12
13766;Žolynėlis;"RŪTELĖ (spec)";1954888655;Taip;10;7;1;18
13767;Žolynėlis;"SAULUTĖ (spec)";89488434450;Ne;14;0;0;14
13768;Žolynėlis;"SAULUTĖ (spec)";78150115970;Taip;8;3;0;11
13769;Žolynėlis;"SAULUTĖ (spec)";9468040148;Taip;8;2;0;10
13770;Žolynėlis;"SAULUTĖ (spec)";1153167430;Taip;0;2;0;2
13771;Žolynėlis;"SAULUTĖ (spec)";4438939800;Taip;0;2;0;2
13772;Žolynėlis;"LINELIS (spec)";7717415005;Taip;3;4;0;7
13773;Žolynėlis;"LINELIS (spec)";2665355759;Taip;3;4;0;7
13774;Žolynėlis;"RASAKILA (spec)";99943424821;Taip;0;1;0;1
13775;Žolynėlis;"RASAKILA (spec)";5957587644;Taip;11;4;0;15
13776;Žolynėlis;"RASAKILA (spec)";4971887781;Taip;3;2;0;5
13777;Žolynėlis;"RASAKILA (spec)";3337602618;Ne;0;1;0;1
13778;Žolynėlis;"RASAKILA (spec)";2913607286;Taip;0;1;0;1
13779;Žolynėlis;"RAMUNĖLĖS (spec)";43729773415;Taip;5;0;0;5
13780;Žolynėlis;"RAMUNĖLĖS (spec)";17307655696;Taip;0;2;0;2
13781;Žolynėlis;"RAMUNĖLĖS (spec)";91598708166;Taip;0;1;0;1
13782;Žolynėlis;"RAMUNĖLĖS (spec)";42425570226;Taip;0;2;0;2
13783;Žolynėlis;"RAMUNĖLĖS (spec)";6080154964;Taip;0;2;17;19
13784;Žolynėlis;"RAMUNĖLĖS (spec)";67411709338;Taip;3;2;1;6
13785;Žolynėlis;Dobiliukai;59125596894;Taip;0;5;0;5
13786;Žolynėlis;Dobiliukai;1123243743;Taip;0;7;0;7
13787;Žolynėlis;Dobiliukai;1655571687;Taip;7;1;0;8
13788;Žolynėlis;Dobiliukai;79759781705;Taip;0;2;0;2
13789;Žolynėlis;Dobiliukai;1833898567;Taip;0;2;2;4
13790;Žolynėlis;Dobiliukai;1331253673;Taip;6;2;0;8
13791;Žolynėlis;Dobiliukai;42333222214;Taip;1;1;0;2
13792;Žolynėlis;Dobiliukai;29420971822;Ne;0;2;0;2
13793;Žolynėlis;Dobiliukai;1080834237;Taip;0;19;0;19
13794;Žolynėlis;Dobiliukai;1619061427;Taip;20;2;0;22
13795;Žolynėlis;Dobiliukai;71887799705;Taip;0;1;0;1
13796;Žolynėlis;Dobiliukai;8872394996;Taip;0;4;2;6
13797;Žolynėlis;Dobiliukai;39450377869;Taip;22;0;0;22
13798;Žolynėlis;Dobiliukai;1933377698;Taip;0;2;10;12
13799;Žolynėlis;Aguonėlė;7313345140;Taip;5;0;0;5
13800;Žolynėlis;Aguonėlė;1620578562;Taip;0;11;0;11
13801;Žolynėlis;Aguonėlė;77707724932;Taip;0;2;4;6
13802;Žolynėlis;Aguonėlė;66167062016;Taip;7;2;0;9
13803;Žolynėlis;Aguonėlė;4545601535;Taip;0;9;0;9
13804;Žolynėlis;Aguonėlė;95007685205;Taip;3;2;0;5
13805;Žolynėlis;Aguonėlė;61475380296;Taip;5;1;0;6
13806;Žolynėlis;Aguonėlė;2051626484;Taip;4;5;0;9
13807;Žolynėlis;Aguonėlė;1348748628;Taip;0;5;1;6
13808;Žolynėlis;Aguonėlė;8027151284;Taip;0;12;7;19
13809;Žolynėlis;Aguonėlė;47825918748;Taip;0;10;0;10
13810;Žolynėlis;Aguonėlė;6169887781;Taip;9;0;12;21
13811;Žolynėlis;Aguonėlė;28730145668;Taip;11;0;4;15
13812;Žolynėlis;Aguonėlė;14877714964;Taip;0;7;1;8
13813;Žolynėlis;Aguonėlė;84849092452;Taip;0;2;1;3
13814;Žolynėlis;Aguonėlė;1257427271;Taip;8;1;0;9
13815;Žolynėlis;Aguonėlė;3263848791;Taip;0;0;10;10
13816;Žolynėlis;Aguonėlė;5827146071;Taip;0;2;0;2
13817;Žolynėlis;Aguonėlė;7256502393;Taip;0;2;7;9
13818;Žolynėlis;Aguonėlė;79704789499;Taip;0;2;3;5
13819;Žolynėlis;Pienė;3520272555;Taip;8;9;0;17
13820;Žolynėlis;Pienė;3088932720;Taip;0;3;0;3
13821;Žolynėlis;Pienė;2108221942;Taip;5;0;0;5
13822;Žolynėlis;Pienė;2934361190;Taip;0;13;0;13
13823;Žolynėlis;Pienė;7980206574;Taip;2;0;0;2
13824;Žolynėlis;Pienė;2460982987;Taip;5;0;1;6
13825;Žolynėlis;Pienė;7339110559;Taip;5;7;0;12
13826;Žolynėlis;Pienė;6763515483;Taip;10;0;0;10
13827;Žolynėlis;Pienė;8215427354;Ne;17;0;0;17
13828;Žolynėlis;Pienė;1485195267;Taip;0;2;9;11
13829;Žolynėlis;Pienė;1163753820;Taip;5;0;0;5
13830;Žolynėlis;Pienė;9106152447;Taip;0;7;0;7
13831;Žolynėlis;Pienė;1879046798;Taip;0;0;1;1
13832;Žolynėlis;Pienė;9941248291;Taip;10;0;7;17
13833;Žolynėlis;Pienė;7827343027;Taip;22;0;0;22
13834;Žolynėlis;Čiobreliai;4379062413;Ne;9;4;0;13
13835;Žolynėlis;Čiobreliai;96960531652;Taip;0;1;0;1
13836;Žolynėlis;Čiobreliai;1135293576;Taip;0;6;0;6
13837;Žolynėlis;Čiobreliai;1188610173;Taip;0;7;0;7
13838;Žolynėlis;Čiobreliai;5262662371;Taip;0;8;0;8
13839;Žolynėlis;Čiobreliai;52441582081;Taip;0;2;0;2
13840;Žolynėlis;Čiobreliai;56001262869;Taip;1;2;0;3
13841;Žolynėlis;Čiobreliai;80589192193;Taip;16;0;0;16
13842;Žolynėlis;Čiobreliai;69270565365;Taip;9;6;0;15
13843;Žolynėlis;Čiobreliai;32852326605;Taip;0;4;0;4
13844;Žolynėlis;Čiobreliai;60635877748;Taip;8;0;0;8
13845;Žolynėlis;Čiobreliai;67610580721;Taip;12;8;0;20
13846;Žolynėlis;Čiobreliai;2142241983;Ne;10;8;0;18
13847;Žolynėlis;Čiobreliai;93243311709;Taip;7;8;0;15
13848;Žolynėlis;Čiobreliai;91866724044;Taip;8;3;0;11
13849;Žolynėlis;Čiobreliai;28388449859;Ne;5;2;0;7
13850;Žolynėlis;Čiobreliai;16469644694;Taip;0;2;0;2
13851;Žolynėlis;Čiobreliai;58271736414;Taip;0;2;0;2
13852;Žolynėlis;Čiobreliai;76160324851;Taip;11;3;0;14
13853;Žolynėlis;Avietėlė;1337138547;Taip;14;0;0;14
13854;Žolynėlis;Avietėlė;4618251201;Ne;0;6;11;17
13855;Žolynėlis;Avietėlė;5432464074;Taip;0;2;2;4
13856;Žolynėlis;Avietėlė;3192462197;Taip;0;0;2;2
13857;Žolynėlis;Avietėlė;2881461471;Taip;0;2;0;2
13858;Žolynėlis;Avietėlė;5173171444;Taip;0;1;0;1
13859;Žolynėlis;Avietėlė;3984024179;Taip;13;5;0;18
13860;Žolynėlis;Avietėlė;3149718901;Taip;12;0;10;22
13861;Žolynėlis;Avietėlė;6829144389;Ne;0;2;1;3
13862;Žolynėlis;Avietėlė;6416217971;Taip;16;0;0;16
13863;Žolynėlis;Avietėlė;8646095992;Taip;0;2;0;2
13864;Žolynėlis;Rugiagėlė;5767549779;Taip;7;2;2;11
13865;Žolynėlis;Rugiagėlė;1223126521;Ne;5;16;0;21
13866;Žolynėlis;Rugiagėlė;8547773739;Ne;0;2;0;2
13867;Žolynėlis;Rugiagėlė;25487230804;Taip;0;4;0;4
13868;Žolynėlis;Rugiagėlė;7870236961;Taip;0;20;0;20
13869;Žolynėlis;Rugiagėlė;2785156297;Taip;0;19;3;22
13870;Žolynėlis;Rugiagėlė;3198470147;Taip;0;2;0;2
13871;Žolynėlis;Rugiagėlė;2779563503;Taip;4;0;1;5
13872;Žolynėlis;Rugiagėlė;3422605135;Taip;0;2;1;3
13873;Žolynėlis;Rugiagėlė;5650427433;Ne;0;2;6;8
13874;Žolynėlis;Rugiagėlė;5668288544;Taip;0;2;0;2
13875;Žolynėlis;Rugiagėlė;9997358375;Taip;6;0;1;7
13876;Žuvėdra;"JŪROS ŽVAIGŽDUTĖS";91701621174;Taip;11;0;5;16
13877;Žuvėdra;"JŪROS ŽVAIGŽDUTĖS";64256836669;Taip;0;0;6;6
13878;Žuvėdra;"JŪROS ŽVAIGŽDUTĖS";27394642359;Taip;5;9;0;14
13879;Žuvėdra;"JŪROS ŽVAIGŽDUTĖS";74637620163;Ne;0;0;1;1
13880;Žuvėdra;"JŪROS ŽVAIGŽDUTĖS";8495976081;Ne;1;3;0;4
13881;Žuvėdra;"JŪROS ŽVAIGŽDUTĖS";35541220076;Taip;0;15;0;15
13882;Žuvėdra;"JŪROS ŽVAIGŽDUTĖS";16298551647;Taip;10;0;1;11
13883;Žuvėdra;"JŪROS ŽVAIGŽDUTĖS";12396055288;Taip;0;1;5;6
13884;Žuvėdra;"JŪROS ŽVAIGŽDUTĖS";82033492205;Taip;11;0;3;14
13885;Žuvėdra;"JŪROS ŽVAIGŽDUTĖS";88986915159;Ne;12;0;0;12
13886;Žuvėdra;"JŪROS ŽVAIGŽDUTĖS";3516571980;Taip;10;0;1;11
13887;Žuvėdra;"JŪROS ŽVAIGŽDUTĖS";69459090757;Taip;0;8;0;8
13888;Žuvėdra;"JŪROS ŽVAIGŽDUTĖS";1088862044;Taip;0;12;0;12
13889;Žuvėdra;"JŪROS ŽVAIGŽDUTĖS";63818919795;Ne;6;0;2;8
13890;Žuvėdra;"JŪROS ŽVAIGŽDUTĖS";1132159017;Taip;0;1;0;1
13891;Žuvėdra;"JŪROS ŽVAIGŽDUTĖS";1553949223;Taip;0;0;9;9
13892;Žuvėdra;"JŪROS ŽVAIGŽDUTĖS";83557400243;Taip;6;7;0;13
13893;Žuvėdra;"JŪROS ŽVAIGŽDUTĖS";97427805302;Taip;0;0;1;1
13894;Žuvėdra;"JŪROS ŽVAIGŽDUTĖS";83890207087;Taip;0;11;0;11
13895;Žuvėdra;DELFINUKAI;1298316563;Ne;0;17;0;17
13896;Žuvėdra;DELFINUKAI;23851864127;Taip;0;3;0;3
13897;Žuvėdra;DELFINUKAI;8843700949;Ne;5;0;0;5
13898;Žuvėdra;DELFINUKAI;1203660127;Taip;0;13;0;13
13899;Žuvėdra;DELFINUKAI;87882215162;Taip;0;1;7;8
13900;Žuvėdra;DELFINUKAI;67652620656;Taip;9;6;0;15
13901;Žuvėdra;DELFINUKAI;9911525172;Taip;0;7;0;7
13902;Žuvėdra;DELFINUKAI;34574939898;Taip;0;13;0;13
13903;Žuvėdra;DELFINUKAI;19471902337;Taip;0;18;0;18
13904;Žuvėdra;DELFINUKAI;28021807339;Taip;0;4;0;4
13905;Žuvėdra;DELFINUKAI;8096854841;Taip;9;0;0;9
13906;Žuvėdra;DELFINUKAI;3148638780;Taip;5;7;0;12
13907;Žuvėdra;DELFINUKAI;17110908746;Taip;0;4;0;4
13908;Žuvėdra;DELFINUKAI;3943563359;Taip;0;0;3;3
13909;Žuvėdra;DELFINUKAI;1938808693;Taip;0;0;1;1
13910;Žuvėdra;DELFINUKAI;1147279898;Taip;0;22;0;22
13911;Žuvėdra;DELFINUKAI;5049101816;Taip;0;12;0;12
13912;Žuvėdra;OSMINOŽKI;3069966490;Taip;0;13;3;16
13913;Žuvėdra;OSMINOŽKI;27467834587;Taip;0;0;10;10
13914;Žuvėdra;OSMINOŽKI;40620404515;Ne;9;0;0;9
13915;Žuvėdra;OSMINOŽKI;65157356661;Taip;5;8;0;13
13916;Žuvėdra;OSMINOŽKI;47125994363;Taip;0;5;0;5
13917;Žuvėdra;OSMINOŽKI;21905924984;Taip;0;13;0;13
13918;Žuvėdra;OSMINOŽKI;82141291604;Taip;0;8;0;8
13919;Žuvėdra;OSMINOŽKI;64732685802;Ne;0;3;3;6
13920;Žuvėdra;OSMINOŽKI;1434244321;Taip;0;12;0;12
13921;Žuvėdra;OSMINOŽKI;960934150;Ne;8;4;0;12
13922;Žuvėdra;OSMINOŽKI;1762760384;Taip;0;7;0;7
13923;Žuvėdra;OSMINOŽKI;1963584073;Taip;4;9;0;13
13924;Žuvėdra;OSMINOŽKI;2136463079;Taip;0;3;0;3
13925;Žuvėdra;OSMINOŽKI;74446494235;Taip;0;12;0;12
13926;Žuvėdra;OSMINOŽKI;41564122720;Taip;0;5;0;5
13927;Žuvėdra;OSMINOŽKI;1639340750;Taip;7;1;0;8
13928;Žuvėdra;OSMINOŽKI;3487938908;Ne;0;3;2;5
13929;Žuvėdra;OSMINOŽKI;66236924555;Taip;0;4;0;4
13930;Žuvėdra;OSMINOŽKI;66973380124;Ne;16;0;2;18
13931;Žuvėdra;OSMINOŽKI;3862711062;Ne;9;1;0;10
13932;Žuvėdra;OSMINOŽKI;8134671188;Taip;0;0;5;5
13933;Žuvėdra;OSMINOŽKI;4588593273;Taip;2;0;4;6
13934;Žuvėdra;OSMINOŽKI;55687216943;Ne;7;6;0;13
13935;Žuvėdra;OSMINOŽKI;1236696072;Taip;10;3;0;13
13936;Žuvėdra;RUSALAČKA;24915726868;Taip;5;0;1;6
13937;Žuvėdra;RUSALAČKA;1116645502;Taip;15;0;0;15
13938;Žuvėdra;RUSALAČKA;1195732987;Ne;0;0;7;7
13939;Žuvėdra;RUSALAČKA;1312918359;Taip;0;15;0;15
13940;Žuvėdra;RUSALAČKA;1923452638;Taip;7;0;2;9
13941;Žuvėdra;RUSALAČKA;6468506668;Ne;0;0;3;3
13942;Žuvėdra;RUSALAČKA;8408371550;Taip;5;0;1;6
13943;Žuvėdra;RUSALAČKA;2731016281;Taip;0;15;0;15
13944;Žuvėdra;RUSALAČKA;1164464390;Ne;0;22;0;22
13945;Žuvėdra;RUSALAČKA;1340241206;Taip;0;3;0;3
13946;Žuvėdra;RUSALAČKA;5021263583;Taip;22;0;0;22
13947;Žuvėdra;RUSALAČKA;5489757084;Taip;0;3;0;3
13948;Žuvėdra;RUSALAČKA;14760907606;Taip;2;0;3;5
13949;Žuvėdra;RUSALAČKA;4011849839;Taip;0;1;0;1
13950;Žuvėdra;RUSALAČKA;75901332720;Taip;0;2;0;2
13951;Žuvėdra;RUSALAČKA;5684848140;Taip;20;0;0;20
13952;Žuvėdra;RUSALAČKA;5496071972;Taip;3;0;0;3
13953;Žuvėdra;RUSALAČKA;6612880861;Taip;0;1;0;1
13954;Žuvėdra;RUSALAČKA;1941428466;Taip;7;0;0;7
13955;Žuvėdra;RUSALAČKA;6007871092;Taip;6;3;0;9
13956;Žuvėdra;RUSALAČKA;63053155507;Taip;5;1;0;6
13957;Žuvėdra;JANTARIKI;5674529681;Taip;5;2;0;7
13958;Žuvėdra;JANTARIKI;9421259943;Taip;12;0;0;12
13959;Žuvėdra;JANTARIKI;1509519996;Taip;0;22;0;22
13960;Žuvėdra;JANTARIKI;6537464526;Taip;0;13;0;13
13961;Žuvėdra;JANTARIKI;9870595577;Taip;5;0;1;6
13962;Žuvėdra;JANTARIKI;6294045755;Taip;0;17;0;17
13963;Žuvėdra;JANTARIKI;7710853637;Taip;3;0;0;3
13964;Žuvėdra;JANTARIKI;7630057671;Taip;4;0;0;4
13965;Žuvėdra;JANTARIKI;7368183516;Taip;22;0;0;22
13966;Žuvėdra;JANTARIKI;3068069755;Taip;0;1;0;1
13967;Žuvėdra;JANTARIKI;5151984122;Taip;5;1;0;6
13968;Žuvėdra;JANTARIKI;3185158741;Taip;5;0;0;5
13969;Žuvėdra;JANTARIKI;1200084485;Taip;0;0;10;10
13970;Žuvėdra;JANTARIKI;2694424532;Taip;14;0;0;14
13971;Žuvėdra;JANTARIKI;5198825127;Taip;22;0;0;22
13972;Žuvėdra;JANTARIKI;4177319374;Taip;0;0;1;1
13973;Žuvėdra;JANTARIKI;5561903903;Taip;8;0;0;8
13974;Žuvėdra;"AUKSINĖ ŽUVELĖ";6547167325;Taip;8;0;0;8
13975;Žuvėdra;"AUKSINĖ ŽUVELĖ";8434697374;Taip;0;12;0;12
13976;Žuvėdra;"AUKSINĖ ŽUVELĖ";5157814568;Taip;0;1;0;1
13977;Žuvėdra;"AUKSINĖ ŽUVELĖ";7916717208;Taip;9;4;0;13
13978;Žuvėdra;"AUKSINĖ ŽUVELĖ";4497938258;Taip;0;4;0;4
13979;Žuvėdra;"AUKSINĖ ŽUVELĖ";2092890028;Taip;4;8;0;12
13980;Žuvėdra;"AUKSINĖ ŽUVELĖ";1311162040;Taip;8;4;0;12
13981;Žuvėdra;"AUKSINĖ ŽUVELĖ";3853045274;Taip;0;4;0;4
13982;Žuvėdra;"AUKSINĖ ŽUVELĖ";5764128482;Taip;0;1;0;1
13983;Žuvėdra;"AUKSINĖ ŽUVELĖ";8512570256;Taip;5;0;0;5
13984;Žuvėdra;"AUKSINĖ ŽUVELĖ";9593426121;Taip;5;10;0;15
13985;Žuvėdra;"AUKSINĖ ŽUVELĖ";2019806688;Taip;5;10;0;15
13986;Žuvėdra;"AUKSINĖ ŽUVELĖ";3445649442;Taip;11;0;0;11
13987;Žuvėdra;"AUKSINĖ ŽUVELĖ";6602037942;Taip;3;8;0;11
13988;Žuvėdra;"AUKSINĖ ŽUVELĖ";3464935314;Taip;0;4;0;4
13989;Žvangutis;PELIUKŲ;6701947168;Taip;0;2;0;2
13990;Žvangutis;PELIUKŲ;6068428687;Taip;6;7;0;13
13991;Žvangutis;PELIUKŲ;1165172787;Taip;20;0;0;20
13992;Žvangutis;PELIUKŲ;7202747419;Taip;5;0;0;5
13993;Žvangutis;PELIUKŲ;9149037184;Taip;0;11;0;11
13994;Žvangutis;PELIUKŲ;3665275100;Taip;0;14;0;14
13995;Žvangutis;PELIUKŲ;7320625500;Ne;0;2;0;2
13996;Žvangutis;PELIUKŲ;3513746926;Taip;22;0;0;22
13997;Žvangutis;PELIUKŲ;4053450010;Taip;5;0;0;5
13998;Žvangutis;PELIUKŲ;9408369641;Taip;0;2;0;2
13999;Žvangutis;PELIUKŲ;6110958520;Taip;3;2;0;5
14000;Žvangutis;PELIUKŲ;5012996199;Taip;5;1;0;6
14001;Žvangutis;PELIUKŲ;8288997508;Taip;0;3;0;3
14002;Žvangutis;PELIUKŲ;3817258555;Taip;5;6;0;11
14003;Žvangutis;PELIUKŲ;6844824726;Ne;0;6;0;6
14004;Žvangutis;PELIUKŲ;3315858185;Taip;14;0;0;14
14005;Žvangutis;PELIUKŲ;92356998180;Taip;7;2;1;10
14006;Žvangutis;PELIUKŲ;6815104137;Taip;4;1;0;5
14007;Žvangutis;PELIUKŲ;5683601025;Taip;0;4;0;4
14008;Žvangutis;PELIUKŲ;8617941954;Taip;0;4;0;4
14009;Žvangutis;ANČIUKŲ;63793471104;Taip;0;2;0;2
14010;Žvangutis;ANČIUKŲ;10323604113;Taip;0;1;0;1
14011;Žvangutis;ANČIUKŲ;26860427962;Taip;0;5;0;5
14012;Žvangutis;ANČIUKŲ;4211541351;Taip;0;0;4;4
14013;Žvangutis;ANČIUKŲ;3753209769;Ne;12;0;0;12
14014;Žvangutis;ANČIUKŲ;5959638828;Ne;2;0;0;2
14015;Žvangutis;ANČIUKŲ;1008391034;Taip;0;5;0;5
14016;Žvangutis;ANČIUKŲ;1648977542;Taip;0;4;0;4
14017;Žvangutis;ANČIUKŲ;59628443049;Taip;0;6;0;6
14018;Žvangutis;ANČIUKŲ;72773865306;Taip;0;3;0;3
14019;Žvangutis;ANČIUKŲ;48094219446;Ne;0;4;0;4
14020;Žvangutis;ANČIUKŲ;36450810822;Taip;0;0;3;3
14021;Žvangutis;ANČIUKŲ;40512304884;Taip;5;8;0;13
14022;Žvangutis;ANČIUKŲ;607103192;Ne;0;1;0;1
14023;Žvangutis;ANČIUKŲ;78462097679;Taip;0;12;0;12
14024;Žvangutis;ANČIUKŲ;77005496286;Taip;0;10;1;11
14025;Žvangutis;ANČIUKŲ;90542583948;Taip;0;0;3;3
14026;Žvangutis;ANČIUKŲ;40872355721;Taip;0;0;1;1
14027;Žvangutis;ANČIUKŲ;7611207661;Ne;0;5;0;5
14028;Žvangutis;ANČIUKŲ;1416765181;Taip;0;1;0;1
14029;Žvangutis;ANČIUKŲ;1647547244;Ne;0;3;0;3
14030;Žvangutis;ANČIUKŲ;4181261835;Taip;0;10;0;10
14031;Žvangutis;PELĖDŽIUKŲ;16003414040;Taip;0;0;2;2
14032;Žvangutis;PELĖDŽIUKŲ;93175189832;Taip;0;0;1;1
14033;Žvangutis;PELĖDŽIUKŲ;1353686877;Taip;0;0;2;2
14034;Žvangutis;PELĖDŽIUKŲ;98607926663;Taip;0;1;6;7
14035;Žvangutis;PELĖDŽIUKŲ;9618217868;Taip;0;1;0;1
14036;Žvangutis;PELĖDŽIUKŲ;91140904183;Taip;6;0;4;10
14037;Žvangutis;PELĖDŽIUKŲ;30697407645;Ne;18;0;0;18
14038;Žvangutis;PELĖDŽIUKŲ;86145834840;Taip;0;0;2;2
14039;Žvangutis;PELĖDŽIUKŲ;93894162596;Taip;3;5;3;11
14040;Žvangutis;PELĖDŽIUKŲ;38451136109;Taip;14;0;0;14
14041;Žvangutis;PELĖDŽIUKŲ;39364323060;Taip;0;12;0;12
14042;Žvangutis;PELĖDŽIUKŲ;57033172828;Taip;0;1;8;9
14043;Žvangutis;PELĖDŽIUKŲ;80054829676;Taip;12;1;0;13
14044;Žvangutis;PELĖDŽIUKŲ;11053503331;Taip;0;0;8;8
14045;Žvangutis;PELĖDŽIUKŲ;96992002828;Taip;8;0;0;8
14046;Žvangutis;PELĖDŽIUKŲ;41703990445;Ne;10;2;0;12
14047;Žvangutis;PELĖDŽIUKŲ;5929099485;Taip;0;8;0;8
14048;Žvangutis;PELĖDŽIUKŲ;77044982999;Taip;0;7;3;10
14049;Žvangutis;PELĖDŽIUKŲ;46410307693;Taip;0;0;7;7
14050;Žvangutis;PELĖDŽIUKŲ;18751626988;Taip;6;0;0;6
14051;Žvangutis;PELĖDŽIUKŲ;3049348955;Taip;0;3;0;3
14052;Žvangutis;PELĖDŽIUKŲ;5616640228;Taip;0;2;0;2
14053;Žvangutis;PELĖDŽIUKŲ;77459956838;Taip;0;2;0;2
14054;Žvangutis;PELĖDŽIUKŲ;46159057420;Taip;0;1;2;3
14055;Žvangutis;PELĖDŽIUKŲ;12457255518;Taip;7;3;0;10
14056;Žvangutis;KAČIUKŲ;2291142377;Taip;0;2;0;2
14057;Žvangutis;KAČIUKŲ;1882797491;Taip;0;10;0;10
14058;Žvangutis;KAČIUKŲ;65598561926;Taip;0;2;0;2
14059;Žvangutis;KAČIUKŲ;52676408047;Taip;0;10;0;10
14060;Žvangutis;KAČIUKŲ;1845521463;Taip;0;1;0;1
14061;Žvangutis;KAČIUKŲ;52544167449;Taip;2;11;0;13
14062;Žvangutis;KAČIUKŲ;8697156717;Taip;0;1;0;1
14063;Žvangutis;KAČIUKŲ;23369081648;Taip;5;3;0;8
14064;Žvangutis;KAČIUKŲ;6989839997;Taip;6;0;0;6
14065;Žvangutis;KAČIUKŲ;1369424754;Taip;0;11;0;11
14066;Žvangutis;KAČIUKŲ;1823402065;Taip;0;1;0;1
14067;Žvangutis;KAČIUKŲ;6343552093;Taip;0;18;0;18
14068;Žvangutis;KAČIUKŲ;2145325174;Taip;0;8;0;8
14069;Žvangutis;KAČIUKŲ;7267340112;Taip;3;0;0;3
14070;Žvangutis;KAČIUKŲ;2251482949;Taip;0;12;0;12
14071;Žvangutis;KAČIUKŲ;45857502483;Taip;0;10;0;10
14072;Žvangutis;KAČIUKŲ;1642007971;Taip;0;12;0;12
14073;Žvangutis;KAČIUKŲ;4699447138;Taip;0;6;0;6
14074;Žvangutis;KAČIUKŲ;1862121693;Taip;0;1;0;1
14075;Žvangutis;MEŠKUČIŲ;2755838558;Taip;0;8;0;8
14076;Žvangutis;MEŠKUČIŲ;2411307963;Ne;17;0;0;17
14077;Žvangutis;MEŠKUČIŲ;1324948757;Taip;0;2;0;2
14078;Žvangutis;MEŠKUČIŲ;7581320158;Taip;9;0;0;9
14079;Žvangutis;MEŠKUČIŲ;1322688456;Taip;0;7;0;7
14080;Žvangutis;MEŠKUČIŲ;9468660351;Taip;0;3;0;3
14081;Žvangutis;MEŠKUČIŲ;1185135525;Taip;6;3;0;9
14082;Žvangutis;MEŠKUČIŲ;2600596320;Taip;0;1;0;1
14083;Žvangutis;MEŠKUČIŲ;7721746116;Taip;13;0;0;13
14084;Žvangutis;MEŠKUČIŲ;2623107843;Taip;12;0;0;12
14085;Žvangutis;MEŠKUČIŲ;2598842770;Taip;5;2;0;7
14086;Žvangutis;MEŠKUČIŲ;2570379643;Taip;13;0;0;13
14087;Žvangutis;MEŠKUČIŲ;6723079944;Taip;5;0;0;5
14088;Žvangutis;MEŠKUČIŲ;9036869235;Taip;0;2;0;2
14089;Žvangutis;MEŠKUČIŲ;7483570779;Taip;0;12;0;12
14090;Žvangutis;MEŠKUČIŲ;1282567366;Taip;3;3;0;6
14091;Žvangutis;KIŠKUČIŲ;1687362077;Taip;6;3;0;9
14092;Žvangutis;KIŠKUČIŲ;1886637245;Taip;5;1;0;6
14093;Žvangutis;KIŠKUČIŲ;96443240617;Taip;0;1;0;1
14094;Žvangutis;KIŠKUČIŲ;4249416168;Taip;6;5;0;11
14095;Žvangutis;KIŠKUČIŲ;6661791076;Taip;5;0;0;5
14096;Žvangutis;KIŠKUČIŲ;1615111824;Taip;5;0;0;5
14097;Žvangutis;KIŠKUČIŲ;1096499939;Taip;0;5;0;5
14098;Žvangutis;KIŠKUČIŲ;1481786579;Taip;0;1;0;1
14099;Žvangutis;KIŠKUČIŲ;1334567751;Taip;0;10;0;10
14100;Žvangutis;KIŠKUČIŲ;2138652487;Taip;22;0;0;22
14101;Žvangutis;KIŠKUČIŲ;1693249341;Taip;6;4;0;10
14102;Žvangutis;KIŠKUČIŲ;4798540560;Taip;0;2;0;2
14103;Žvangutis;KIŠKUČIŲ;1847928083;Taip;17;0;0;17
14104;Žvangutis;KIŠKUČIŲ;1665136168;Taip;0;13;0;13
14105;Žvangutis;KIŠKUČIŲ;1251015310;Taip;0;0;2;2
14106;Žvangutis;KIŠKUČIŲ;5563516622;Taip;5;8;0;13
14107;Žvangutis;KIŠKUČIŲ;74528704135;Taip;0;1;0;1
14108;Žvangutis;KIŠKUČIŲ;57385778197;Taip;4;0;15;19
14109;Žvangutis;KIŠKUČIŲ;3775960571;Taip;16;1;0;17
14110;Žvangutis;KIŠKUČIŲ;11567978993;Taip;15;0;0;15
14111;Žvangutis;KIŠKUČIŲ;79808715852;Taip;0;19;0;19
14112;Žvangutis;KIŠKUČIŲ;9134683276;Taip;0;4;0;4
14113;Žirniukas;Boružiukų;85078595504;Ne;0;0;7;7
14114;Žirniukas;Boružiukų;57130875338;Taip;0;2;6;8
14115;Žirniukas;Boružiukų;63316123515;Taip;6;2;0;8
14116;Žirniukas;Boružiukų;7648905323;Taip;0;12;0;12
14117;Žirniukas;Boružiukų;25844087366;Taip;0;1;1;2
14118;Žirniukas;Boružiukų;86712175200;Taip;0;6;0;6
14119;Žirniukas;Boružiukų;68085114059;Ne;4;0;0;4
14120;Žirniukas;Boružiukų;79871296529;Ne;11;0;1;12
14121;Žirniukas;Boružiukų;74201207995;Taip;2;1;0;3
14122;Žirniukas;Boružiukų;5797345627;Taip;3;2;4;9
14123;Žirniukas;Boružiukų;27435013977;Taip;0;6;0;6
14124;Žirniukas;Boružiukų;93794255172;Taip;22;0;0;22
14125;Žirniukas;Boružiukų;63115775194;Taip;0;1;1;2
14126;Žirniukas;Boružiukų;70866622909;Taip;0;1;0;1
14127;Žirniukas;Boružiukų;35928289177;Taip;4;5;0;9
14128;Žirniukas;Boružiukų;67770044313;Taip;8;0;0;8
14129;Žirniukas;Boružiukų;52079839837;Taip;0;0;3;3
14130;Žirniukas;Boružiukų;1746748097;Taip;0;4;0;4
14131;Žirniukas;Smalsučiai;1701389895;Taip;0;5;1;6
14132;Žirniukas;Smalsučiai;65471257240;Ne;7;4;0;11
14133;Žirniukas;Smalsučiai;99019576563;Taip;0;1;2;3
14134;Žirniukas;Smalsučiai;56948775759;Taip;2;1;1;4
14135;Žirniukas;Smalsučiai;83035751096;Taip;0;3;0;3
14136;Žirniukas;Smalsučiai;23221186484;Taip;3;0;0;3
14137;Žirniukas;Smalsučiai;43241022100;Taip;0;0;5;5
14138;Žirniukas;Smalsučiai;54285529186;Taip;6;1;0;7
14139;Žirniukas;Smalsučiai;1382313386;Taip;0;1;1;2
14140;Žirniukas;Smalsučiai;49058747304;Taip;7;0;0;7
14141;Žirniukas;Smalsučiai;6718181545;Taip;3;0;1;4
14142;Žirniukas;Smalsučiai;54685058502;Taip;9;0;0;9
14143;Žirniukas;Smalsučiai;59972903968;Taip;0;1;2;3
14144;Žirniukas;Smalsučiai;4377015113;Taip;0;5;0;5
14145;Žirniukas;Smalsučiai;37416946100;Taip;0;2;0;2
14146;Žirniukas;Smalsučiai;3723155762;Taip;3;0;1;4
14147;Žirniukas;Smalsučiai;3239212369;Taip;0;1;0;1
14148;Žirniukas;Smalsučiai;15527206706;Taip;0;3;0;3
14149;Žirniukas;Smalsučiai;1150580143;Taip;0;0;8;8
14150;Žirniukas;Smalsučiai;7739943293;Ne;0;2;2;4
14151;Žirniukas;Smalsučiai;89146903524;Taip;0;2;2;4
14152;Žirniukas;Gėlyčių;86374817570;Taip;0;0;9;9
14153;Žirniukas;Gėlyčių;51940895885;Taip;4;0;2;6
14154;Žirniukas;Gėlyčių;469740948;Taip;0;1;0;1
14155;Žirniukas;Gėlyčių;1514883654;Ne;0;12;0;12
14156;Žirniukas;Gėlyčių;3807957588;Taip;0;22;0;22
14157;Žirniukas;Gėlyčių;57834170089;Taip;0;14;0;14
14158;Žirniukas;Gėlyčių;9192660067;Taip;0;0;6;6
14159;Žirniukas;Gėlyčių;74425301830;Taip;11;4;0;15
14160;Žirniukas;Gėlyčių;3763537106;Taip;0;0;1;1
14161;Žirniukas;Gėlyčių;7809088591;Taip;5;0;1;6
14162;Žirniukas;Gėlyčių;6649555415;Ne;0;7;8;15
14163;Žirniukas;Gėlyčių;32583177093;Taip;0;2;0;2
14164;Žirniukas;Gėlyčių;91259031678;Taip;0;0;4;4
14165;Žirniukas;Gėlyčių;1804181833;Taip;12;0;0;12
14166;Žirniukas;Gėlyčių;47573534391;Taip;5;3;0;8
14167;Žirniukas;Gėlyčių;5628943541;Taip;0;5;1;6
14168;Žirniukas;Gėlyčių;2072018782;Taip;0;1;0;1
14169;Žirniukas;Gėlyčių;1378845384;Taip;0;6;0;6
14170;Žirniukas;Nykštukų;4378877068;Taip;0;2;0;2
14171;Žirniukas;Nykštukų;2309995947;Taip;3;0;0;3
14172;Žirniukas;Nykštukų;1514504241;Taip;0;5;2;7
14173;Žirniukas;Nykštukų;1064894307;Taip;10;0;0;10
14174;Žirniukas;Nykštukų;1162904969;Taip;0;5;0;5
14175;Žirniukas;Nykštukų;1017483419;Taip;0;1;0;1
14176;Žirniukas;Nykštukų;6957047759;Taip;0;1;0;1
14177;Žirniukas;Nykštukų;2151329751;Taip;8;8;0;16
14178;Žirniukas;Nykštukų;5939918015;Taip;8;0;0;8
14179;Žirniukas;Nykštukų;3010062747;Ne;2;1;4;7
14180;Žirniukas;Nykštukų;2162238771;Taip;0;1;2;3
14181;Žirniukas;Nykštukų;2029018108;Taip;10;1;2;13
14182;Žirniukas;Nykštukų;5987510202;Taip;0;1;0;1
14183;Žirniukas;Nykštukų;5104110821;Taip;5;0;0;5
14184;Žirniukas;Nykštukų;5471647472;Ne;2;0;0;2
14185;Žirniukas;Nykštukų;7644911127;Taip;1;0;0;1
14186;Žirniukas;Nykštukų;6180439078;Taip;2;0;0;2
14187;Žirniukas;Nykštukų;3808838764;Ne;16;1;0;17
14188;Žirniukas;Nykštukų;7975957714;Ne;0;0;5;5
14189;Žirniukas;Saulytės;37852143615;Taip;16;0;0;16
14190;Žirniukas;Saulytės;1409567693;Taip;0;5;0;5
14191;Žirniukas;Saulytės;32419042337;Taip;2;1;0;3
14192;Žirniukas;Saulytės;71263500233;Taip;0;0;18;18
14193;Žirniukas;Saulytės;65898776759;Taip;0;1;0;1
14194;Žirniukas;Saulytės;51172128673;Taip;0;1;0;1
14195;Žirniukas;Saulytės;85066293475;Taip;0;1;0;1
14196;Žirniukas;Saulytės;29420916883;Taip;0;1;0;1
14197;Žirniukas;Saulytės;5189034384;Ne;9;0;0;9
14198;Žirniukas;Saulytės;68565861419;Taip;8;0;0;8
14199;Žirniukas;Saulytės;2294854901;Taip;2;1;0;3
14200;Žirniukas;Saulytės;5188013194;Taip;5;0;3;8
14201;Žirniukas;Saulytės;69810421328;Taip;6;0;1;7
14202;Žirniukas;Saulytės;66153778144;Taip;6;0;7;13
14203;Žirniukas;Saulytės;47491327916;Taip;2;0;8;10
14204;Žirniukas;Saulytės;28992463324;Taip;0;0;1;1
14205;Žirniukas;Saulytės;60060805955;Taip;5;5;0;10
14206;Žirniukas;Saulytės;71922426195;Taip;1;6;0;7
14207;Žirniukas;Drugelių;2141162140;Taip;0;2;0;2
14208;Žirniukas;Drugelių;1294183547;Taip;0;4;0;4
14209;Žirniukas;Drugelių;2557138057;Taip;5;0;0;5
14210;Žirniukas;Drugelių;3068684150;Taip;4;0;11;15
14211;Žirniukas;Drugelių;8644938346;Taip;9;1;0;10
14212;Žirniukas;Drugelių;8190751348;Taip;14;2;0;16
14213;Žirniukas;Drugelių;1991599271;Taip;12;1;0;13
14214;Žirniukas;Drugelių;2282495237;Taip;0;0;7;7
14215;Žirniukas;Drugelių;1961708150;Taip;0;4;0;4
14216;Žirniukas;Drugelių;1393738771;Taip;7;0;1;8
14217;Žirniukas;Drugelių;98962928727;Taip;5;5;0;10
14218;Žirniukas;Drugelių;6409900451;Taip;10;0;3;13
14219;Žirniukas;Drugelių;46265018782;Taip;7;1;3;11
14220;Žirniukas;Drugelių;7190628011;Taip;0;16;0;16
14221;Žirniukas;Drugelių;9374080010;Taip;15;0;1;16
14222;Žirniukas;Drugelių;1095501791;Taip;8;1;0;9
14223;Žirniukas;Pelėdžiukai;1163690644;Taip;0;3;0;3
14224;Žirniukas;Pelėdžiukai;1685677297;Taip;0;3;0;3
14225;Žirniukas;Pelėdžiukai;9424009308;Taip;3;3;0;6
14226;Žirniukas;Pelėdžiukai;1542257475;Taip;0;3;2;5
14227;Žirniukas;Pelėdžiukai;98781117814;Taip;10;0;3;13
14228;Žirniukas;Pelėdžiukai;1158530590;Taip;0;2;3;5
14229;Žirniukas;Pelėdžiukai;1352159915;Taip;0;5;2;7
14230;Žirniukas;Pelėdžiukai;1096649614;Taip;5;11;0;16
14231;Žirniukas;Pelėdžiukai;1699821845;Taip;0;0;1;1
14232;Žirniukas;Pelėdžiukai;52845409413;Taip;5;0;1;6
14233;Žirniukas;Pelėdžiukai;1609778506;Taip;0;0;5;5
14234;Žirniukas;Pelėdžiukai;1506642709;Taip;0;3;0;3
14235;Žirniukas;Pelėdžiukai;98441955394;Taip;0;7;0;7
14236;Žirniukas;Pelėdžiukai;4789330923;Taip;0;0;1;1
14237;Žirniukas;Pelėdžiukai;2118772211;Taip;5;0;0;5
14238;Žirniukas;Pelėdžiukai;1788183728;Taip;12;2;0;14
14239;Žirniukas;Pelėdžiukai;1907669506;Taip;5;5;0;10
14240;Žirniukas;Pelėdžiukai;1607867151;Ne;7;1;1;9
14241;Žirniukas;Pelėdžiukai;1586083174;Taip;0;16;4;20
14242;Žirniukas;Pelėdžiukai;52181077421;Taip;0;0;18;18
14243;Žirniukas;Pelėdžiukai;5479153220;Taip;20;0;0;20
14244;Žirniukas;Pelėdžiukai;4842182809;Taip;0;10;0;10
14245;Žirniukas;ZUIKUČIAI;6624263476;Taip;5;0;0;5
14246;Žirniukas;ZUIKUČIAI;2785102131;Taip;5;0;0;5
14247;Žirniukas;ZUIKUČIAI;6641200341;Taip;10;0;0;10
14248;Žirniukas;ZUIKUČIAI;9647374339;Taip;5;3;0;8
14249;Žirniukas;ZUIKUČIAI;6268788036;Taip;0;9;0;9
14250;Žirniukas;ZUIKUČIAI;1867254291;Taip;3;2;6;11
14251;Žirniukas;ZUIKUČIAI;6834792589;Ne;0;0;2;2
14252;Žirniukas;ZUIKUČIAI;2348752207;Taip;0;0;15;15
14253;Žirniukas;ZUIKUČIAI;7872611724;Taip;4;1;5;10
14254;Žirniukas;ZUIKUČIAI;2636634198;Taip;0;0;12;12
14255;Žirniukas;ZUIKUČIAI;6531175340;Taip;22;0;0;22
14256;Žirniukas;ZUIKUČIAI;8213507698;Taip;8;1;2;11
14257;Žirniukas;ZUIKUČIAI;2528905738;Taip;7;1;0;8
14258;Žirniukas;ZUIKUČIAI;6363169823;Taip;4;0;0;4
14259;Žirniukas;ZUIKUČIAI;5058103759;Taip;7;0;0;7
14260;Žirniukas;ZUIKUČIAI;3610402086;Ne;7;1;2;10
14261;Aušra;Kodėlčiukai;70233681803;Taip;0;2;0;2
14262;Aušra;Kodėlčiukai;40714551025;Taip;0;2;3;5
14263;Aušra;Kodėlčiukai;40499781883;Taip;0;11;0;11
14264;Aušra;Kodėlčiukai;27091243109;Taip;2;3;0;5
14265;Aušra;Kodėlčiukai;9605206310;Taip;0;1;0;1
14266;Aušra;Kodėlčiukai;19504477542;Taip;2;0;0;2
14267;Aušra;Kodėlčiukai;37104403122;Taip;0;3;1;4
14268;Aušra;Kodėlčiukai;22032396703;Taip;0;2;0;2
14269;Aušra;Kodėlčiukai;43666690361;Taip;0;11;0;11
14270;Aušra;Kodėlčiukai;97781409787;Ne;0;6;0;6
14271;Aušra;Kodėlčiukai;68160889669;Taip;5;2;0;7
14272;Aušra;Kodėlčiukai;69081281749;Taip;0;8;0;8
14273;Aušra;Kodėlčiukai;18987709566;Taip;0;5;0;5
14274;Aušra;Kodėlčiukai;10347002342;Taip;0;14;0;14
14275;Aušra;Kodėlčiukai;8913242414;Taip;0;0;1;1
14276;Aušra;Kodėlčiukai;52958921337;Ne;11;2;0;13
14277;Aušra;Kodėlčiukai;3284383302;Taip;0;2;0;2
14278;Aušra;Pelėdžiukai;8686777160;Taip;0;1;0;1
14279;Aušra;Pelėdžiukai;15657824495;Taip;0;15;0;15
14280;Aušra;Pelėdžiukai;1385844067;Taip;8;0;0;8
14281;Aušra;Pelėdžiukai;35429495907;Taip;12;1;0;13
14282;Aušra;Pelėdžiukai;79051821501;Taip;5;7;0;12
14283;Aušra;Pelėdžiukai;14343589644;Taip;0;0;1;1
14284;Aušra;Pelėdžiukai;21234588466;Taip;8;0;0;8
14285;Aušra;Pelėdžiukai;5815377310;Ne;0;7;0;7
14286;Aušra;Pelėdžiukai;23609052737;Taip;6;3;0;9
14287;Aušra;Pelėdžiukai;3823619675;Taip;0;3;0;3
14288;Aušra;Pelėdžiukai;41017803426;Taip;0;0;3;3
14289;Aušra;Pelėdžiukai;58254707316;Ne;0;2;2;4
14290;Aušra;Pelėdžiukai;18943927144;Taip;22;0;0;22
14291;Aušra;Pelėdžiukai;57469542504;Taip;6;2;3;11
14292;Aušra;Pelėdžiukai;2121418946;Taip;5;0;1;6
14293;Aušra;Pelėdžiukai;5409157554;Taip;5;0;0;5
14294;Aušra;Pelėdžiukai;2227238810;Ne;5;1;0;6
14295;Aušra;Pelėdžiukai;2000206874;Taip;0;17;0;17
14296;Aušra;Smalsučiai;1049364899;Taip;0;3;0;3
14297;Aušra;Smalsučiai;95327350432;Taip;9;0;0;9
14298;Aušra;Smalsučiai;1473962346;Taip;0;3;0;3
14299;Aušra;Smalsučiai;1427235223;Taip;0;0;1;1
14300;Aušra;Smalsučiai;2128822237;Taip;0;1;0;1
14301;Aušra;Smalsučiai;81510885976;Ne;0;2;0;2
14302;Aušra;Smalsučiai;1767520195;Taip;5;2;0;7
14303;Aušra;Smalsučiai;76979979920;Taip;0;0;4;4
14304;Aušra;Smalsučiai;97571593143;Taip;0;4;0;4
14305;Aušra;Smalsučiai;59235411329;Taip;0;0;7;7
14306;Aušra;Smalsučiai;42344686036;Ne;0;5;0;5
14307;Aušra;Smalsučiai;2019580127;Taip;15;7;0;22
14308;Aušra;Smalsučiai;95586246863;Taip;0;9;0;9
14309;Aušra;Smalsučiai;66203768924;Taip;0;1;0;1
14310;Aušra;Smalsučiai;7962184651;Taip;0;8;0;8
14311;Aušra;Smalsučiai;12689030409;Taip;0;2;1;3
14312;Aušra;Smalsučiai;98150444770;Taip;0;2;6;8
14313;Aušra;Smalsučiai;1167565535;Taip;0;9;0;9
14314;Aušra;Smalsučiai;52044254281;Taip;6;0;3;9
14315;Aušra;Smalsučiai;1831747749;Taip;8;2;0;10
14316;Aušra;Smalsučiai;5447986535;Taip;22;0;0;22
14317;Aušra;Smalsučiai;7222605763;Taip;0;2;0;2
14318;Aušra;Smalsučiai;4645855409;Taip;0;12;0;12
14319;Aušra;Pagrandukai;7043021721;Taip;0;17;0;17
14320;Aušra;Pagrandukai;2023718424;Taip;0;0;2;2
14321;Aušra;Pagrandukai;8709340592;Taip;10;0;10;20
14322;Aušra;Pagrandukai;5524681006;Taip;0;0;14;14
14323;Aušra;Pagrandukai;4404047456;Taip;5;0;2;7
14324;Aušra;Pagrandukai;3680329197;Taip;8;0;3;11
14325;Aušra;Pagrandukai;2288159223;Taip;22;0;0;22
14326;Aušra;Pagrandukai;4805298824;Taip;0;2;6;8
14327;Aušra;Pagrandukai;29499576216;Taip;6;0;0;6
14328;Aušra;Pagrandukai;1940882109;Taip;0;2;0;2
14329;Aušra;Pagrandukai;7814902928;Taip;0;2;4;6
14330;Aušra;Pagrandukai;9702136789;Taip;0;0;4;4
14331;Aušra;Pagrandukai;6384243597;Taip;0;2;4;6
14332;Aušra;Pagrandukai;1612662076;Taip;0;2;0;2
14333;Aušra;Pagrandukai;3898178166;Ne;0;0;2;2
14334;Aušra;Pagrandukai;4352174590;Taip;20;0;0;20
14335;Aušra;Pagrandukai;1575761029;Taip;0;6;0;6
14336;Aušra;Pagrandukai;5673568541;Taip;0;0;2;2
14337;Aušra;Pagrandukai;1717797530;Taip;13;0;2;15
14338;Aušra;Pagrandukai;5777939563;Taip;0;0;3;3
14339;Aušra;Pagrandukai;1956830515;Taip;5;0;0;5
14340;Aušra;Pagrandukai;8740755922;Taip;1;0;4;5
14341;Aušra;"1A klasė";81428848455;Taip;1;0;0;1
14342;Aušra;"1A klasė";52864653926;Taip;3;0;0;3
14343;Aušra;"1A klasė";5166358753;Taip;2;0;0;2
14344;Aušra;"1A klasė";78030425432;Taip;2;0;0;2
14345;Aušra;"1A klasė";77425098448;Taip;2;0;0;2
14346;Aušra;"1A klasė";13361663464;Taip;2;0;0;2
14347;Aušra;"1A klasė";21856009403;Taip;2;0;0;2
14348;Aušra;"1A klasė";93365393803;Ne;9;0;0;9
14349;Aušra;"1A klasė";44870195034;Taip;6;0;0;6
14350;Aušra;"1A klasė";10272136932;Taip;1;0;0;1
14351;Aušra;"1A klasė";34795588283;Ne;0;22;0;22
14352;Aušra;"1A klasė";29636399665;Taip;2;0;0;2
14353;Aušra;"1A klasė";42015974556;Taip;1;0;0;1
14354;Aušra;"1A klasė";26101766284;Taip;0;22;0;22
14355;Aušra;"1A klasė";19718806057;Taip;3;0;0;3
14356;Aušra;"1A klasė";19920237804;Taip;1;0;0;1
14357;Aušra;"1A klasė";2113586354;Taip;8;0;0;8
14358;Aušra;"1A klasė";70687041413;Taip;1;0;0;1
14359;Aušra;"1A klasė";47725613978;Taip;3;0;0;3
14360;Aušra;"1A klasė";94704151051;Taip;1;0;0;1
14361;Aušra;"1A klasė";20550256232;Taip;1;0;0;1
14362;Aušra;"1A klasė";95948867937;Taip;0;22;0;22
14363;Aušra;"1A klasė";99886964420;Taip;0;22;0;22
14364;Aušra;"1B klasė";35703433862;Taip;8;0;0;8
14365;Aušra;"1B klasė";41039525379;Ne;10;0;0;10
14366;Aušra;"1B klasė";59107169775;Ne;4;0;0;4
14367;Aušra;"1B klasė";41852924528;Taip;1;0;0;1
14368;Aušra;"1B klasė";58526614808;Taip;1;0;0;1
14369;Aušra;"1B klasė";64562667133;Taip;1;0;0;1
14370;Aušra;"1B klasė";36899257479;Ne;1;0;0;1
14371;Aušra;"1B klasė";95076478544;Ne;1;0;0;1
14372;Aušra;"1B klasė";83119050626;Taip;1;0;0;1
14373;Aušra;"1B klasė";52332096506;Taip;3;0;0;3
14374;Aušra;"1B klasė";45165946624;Taip;9;0;0;9
14375;Aušra;"1B klasė";39957179831;Taip;0;22;0;22
14376;Aušra;"1B klasė";22923377435;Ne;3;0;0;3
14377;Aušra;"1B klasė";71596384638;Taip;6;0;0;6
14378;Aušra;"1B klasė";36889923728;Taip;4;0;0;4
14379;Aušra;"1B klasė";48349819906;Ne;1;0;0;1
14380;Aušra;"1B klasė";1815771421;Ne;1;0;0;1
14381;Aušra;"1B klasė";75433637766;Taip;0;22;0;22
14382;Aušra;"1B klasė";92119607174;Taip;1;0;0;1
14383;Aušra;"1B klasė";37339481276;Taip;1;0;0;1
14384;Aušra;"1B klasė";6201728036;Taip;0;22;0;22
14385;Aušra;"1B klasė";57520886724;Taip;0;22;0;22
14386;Aušra;"1B klasė";63920629625;Taip;0;22;0;22
14387;Aušra;"1B klasė";8901585006;Taip;6;0;0;6
14388;Aušra;"1B klasė";52909474598;Ne;1;0;0;1
14389;Aušra;"2A klasė";8497743711;Ne;5;0;0;5
14390;Aušra;"2A klasė";9510786725;Ne;5;0;0;5
14391;Aušra;"2A klasė";5770340819;Ne;1;0;0;1
14392;Aušra;"2A klasė";5792862565;Ne;1;0;0;1
14393;Aušra;"2A klasė";8892613555;Ne;1;0;0;1
14394;Aušra;"2A klasė";7931858964;Ne;5;0;0;5
14395;Aušra;"2A klasė";4399210916;Ne;1;0;0;1
14396;Aušra;"2A klasė";1585279799;Ne;1;0;0;1
14397;Aušra;"2A klasė";2796012982;Ne;1;0;0;1
14398;Aušra;"2A klasė";9584232864;Ne;2;0;0;2
14399;Aušra;"2A klasė";7113793626;Ne;1;0;0;1
14400;Aušra;"2A klasė";2908360090;Ne;1;0;0;1
14401;Aušra;"2A klasė";5825720308;Ne;1;0;0;1
14402;Aušra;"2A klasė";8367064629;Taip;1;0;0;1
14403;Aušra;"2A klasė";7270744347;Ne;0;22;0;22
14404;Aušra;"2A klasė";8632721907;Ne;1;0;0;1
14405;Aušra;"2A klasė";3435983733;Ne;1;0;0;1
14406;Aušra;"2A klasė";7313001921;Ne;2;0;0;2
14407;Aušra;"2A klasė";6942076490;Ne;5;0;0;5
14408;Aušra;"2A klasė";2797588970;Ne;0;22;0;22
14409;Aušra;"2A klasė";6534693192;Ne;2;0;0;2
14410;Aušra;"2A klasė";5657162092;Ne;0;22;0;22
14411;Aušra;"2A klasė";7439801986;Ne;1;0;0;1
14412;Aušra;"2A klasė";4952796453;Ne;1;0;0;1
14413;Aušra;"2A klasė";1404310604;Ne;1;0;0;1
14414;Aušra;"2A klasė";2280410145;Ne;1;0;0;1
14415;Aušra;"2A klasė";75839555732;Taip;1;0;0;1
14416;Aušra;"2A klasė";29945175192;Taip;0;22;0;22
14417;Aušra;"2A klasė";30628368345;Taip;0;22;0;22
14418;Aušra;"2A klasė";96979357769;Taip;0;22;0;22
14419;Aušra;"3A klasė";2863356239;Ne;1;0;0;1
14420;Aušra;"3A klasė";6540515450;Ne;4;0;0;4
14421;Aušra;"3A klasė";6232778631;Ne;2;0;0;2
14422;Aušra;"3A klasė";3115696927;Ne;1;0;0;1
14423;Aušra;"3A klasė";8543429220;Ne;6;0;0;6
14424;Aušra;"3A klasė";1685764132;Ne;1;0;0;1
14425;Aušra;"3A klasė";5340257141;Ne;6;0;0;6
14426;Aušra;"3A klasė";8328298376;Ne;0;22;0;22
14427;Aušra;"3A klasė";4341245904;Ne;1;0;0;1
14428;Aušra;"3A klasė";9430084940;Ne;5;0;0;5
14429;Aušra;"3A klasė";2942755846;Ne;1;0;0;1
14430;Aušra;"3A klasė";3749854924;Ne;1;0;0;1
14431;Aušra;"3A klasė";1448718807;Ne;0;22;0;22
14432;Aušra;"3A klasė";2951199272;Ne;1;0;0;1
14433;Aušra;"3A klasė";2072790876;Ne;2;0;0;2
14434;Aušra;"3A klasė";1414034080;Ne;8;0;0;8
14435;Aušra;"3A klasė";8550981774;Ne;8;0;0;8
14436;Aušra;"3A klasė";4257487788;Ne;2;0;0;2
14437;Aušra;"3A klasė";9332506542;Ne;2;0;0;2
14438;Aušra;"3A klasė";7499852390;Ne;9;0;0;9
14439;Aušra;"3A klasė";8801106119;Ne;8;0;0;8
14440;Aušra;"3A klasė";7435902333;Ne;6;0;0;6
14441;Aušra;"3A klasė";4190936993;Ne;0;22;0;22
14442;Aušra;"3A klasė";4073898542;Ne;1;0;0;1
14443;Aušra;"3A klasė";54244461148;Ne;0;22;0;22
14444;Aušra;"3A klasė";62035537641;Taip;0;22;0;22
14445;Aušra;"4A klasė";7968234670;Ne;1;0;0;1
14446;Aušra;"4A klasė";5809362777;Ne;2;0;0;2
14447;Aušra;"4A klasė";6916574393;Ne;0;22;0;22
14448;Aušra;"4A klasė";6160171536;Ne;1;0;0;1
14449;Aušra;"4A klasė";6846696720;Ne;2;0;0;2
14450;Aušra;"4A klasė";7665944746;Ne;1;0;0;1
14451;Aušra;"4A klasė";1523223244;Ne;1;0;0;1
14452;Aušra;"4A klasė";4708591140;Ne;8;0;0;8
14453;Aušra;"4A klasė";6865621533;Ne;1;0;0;1
14454;Aušra;"4A klasė";9176277054;Ne;2;0;0;2
14455;Aušra;"4A klasė";1996371462;Ne;2;0;0;2
14456;Aušra;"4A klasė";4682402426;Ne;2;0;0;2
14457;Aušra;"4A klasė";3917149879;Ne;0;22;0;22
14458;Aušra;"4A klasė";6022331977;Ne;3;0;0;3
14459;Aušra;"4A klasė";6363653918;Ne;0;22;0;22
14460;Aušra;"4A klasė";3215515556;Ne;1;0;0;1
14461;Aušra;"4A klasė";4799894746;Taip;0;22;0;22
14462;Aušra;"4A klasė";5569669318;Taip;0;22;0;22
14463;Aušra;"4A klasė";4804202746;Taip;0;22;0;22
14464;Aušra;"4A klasė";3253972586;Taip;0;22;0;22
14465;Aušra;"4A klasė";8150460853;Taip;0;22;0;22
14466;Aušra;"2B klasė";7075053685;Ne;1;0;0;1
14467;Aušra;"2B klasė";7405776766;Ne;0;22;0;22
14468;Aušra;"2B klasė";8476695862;Ne;3;0;0;3
14469;Aušra;"2B klasė";2893668707;Ne;1;0;0;1
14470;Aušra;"2B klasė";7321317333;Ne;3;0;0;3
14471;Aušra;"2B klasė";9736905104;Ne;1;0;0;1
14472;Aušra;"2B klasė";4979458559;Ne;2;0;0;2
14473;Aušra;"2B klasė";7886658451;Ne;0;22;0;22
14474;Aušra;"2B klasė";2075587354;Ne;2;0;0;2
14475;Aušra;"2B klasė";5687605664;Ne;0;22;0;22
14476;Aušra;"2B klasė";2610054474;Ne;2;0;0;2
14477;Aušra;"2B klasė";2412235474;Ne;0;22;0;22
14478;Aušra;"2B klasė";9695887585;Ne;1;0;0;1
14479;Aušra;"2B klasė";7697924792;Ne;1;0;0;1
14480;Aušra;"2B klasė";7553225340;Ne;3;0;0;3
14481;Aušra;"2B klasė";5005513948;Ne;1;0;0;1
14482;Aušra;"2B klasė";3225989797;Ne;6;0;0;6
14483;Aušra;"2B klasė";3114317363;Ne;2;0;0;2
14484;Aušra;"2B klasė";7713995959;Ne;1;0;0;1
14485;Aušra;"2B klasė";9600565378;Ne;2;0;0;2
14486;Aušra;"2B klasė";65535488153;Taip;2;0;0;2
14487;Aušra;"2B klasė";98154599269;Taip;0;22;0;22
14488;Aušra;"2B klasė";95798840861;Taip;0;22;0;22
14489;Aušra;"2B klasė";11449775297;Taip;3;0;0;3
14490;Aušra;"2B klasė";2401823401;Ne;2;0;0;2
14491;Aušra;"2B klasė";70054065156;Taip;3;0;0;3
14492;Berželis;"BOŽJI KOROVKI";1612263252;Taip;0;2;0;2
14493;Berželis;"BOŽJI KOROVKI";59374659821;Ne;0;0;3;3
14494;Berželis;"BOŽJI KOROVKI";69799827219;Taip;5;0;0;5
14495;Berželis;"BOŽJI KOROVKI";56738219250;Taip;0;9;0;9
14496;Berželis;"BOŽJI KOROVKI";56482980062;Ne;0;3;0;3
14497;Berželis;"BOŽJI KOROVKI";77431203813;Taip;0;0;1;1
14498;Berželis;"BOŽJI KOROVKI";27150769109;Taip;0;0;2;2
14499;Berželis;"BOŽJI KOROVKI";33843845240;Taip;0;2;0;2
14500;Berželis;"BOŽJI KOROVKI";88322206113;Taip;12;10;0;22
14501;Berželis;"BOŽJI KOROVKI";19460486970;Taip;6;0;0;6
14502;Berželis;PČIOLKI;1923453586;Taip;0;0;10;10
14503;Berželis;PČIOLKI;91965136118;Ne;3;0;0;3
14504;Berželis;PČIOLKI;83552840429;Ne;5;0;0;5
14505;Berželis;PČIOLKI;93628329777;Taip;0;0;1;1
14506;Berželis;PČIOLKI;13541556141;Taip;0;1;0;1
14507;Berželis;PČIOLKI;4330158489;Taip;13;0;0;13
14508;Berželis;PČIOLKI;95780247776;Taip;0;0;3;3
14509;Berželis;PČIOLKI;79546239108;Ne;5;0;2;7
14510;Berželis;PČIOLKI;6959738006;Taip;0;0;1;1
14511;Berželis;PČIOLKI;37637382978;Taip;8;0;0;8
14512;Berželis;PČIOLKI;41988540665;Taip;0;0;1;1
14513;Berželis;PČIOLKI;44215014337;Taip;0;0;1;1
14514;Berželis;PČIOLKI;2066819593;Taip;8;0;0;8
14515;Berželis;PČIOLKI;37451475613;Taip;0;0;7;7
14516;Berželis;PČIOLKI;95587380846;Taip;17;0;0;17
14517;Berželis;PČIOLKI;48161697699;Ne;7;0;0;7
14518;Berželis;PČIOLKI;18002985276;Ne;0;10;0;10
14519;Berželis;PČIOLKI;1776837439;Taip;6;2;0;8
14520;Berželis;PČIOLKI;36854023525;Taip;4;3;0;7
14521;Berželis;PČIOLKI;7512720601;Ne;0;6;0;6
14522;Berželis;SOLNYŠKO;1740077377;Taip;5;2;0;7
14523;Berželis;SOLNYŠKO;1855559693;Taip;0;9;0;9
14524;Berželis;SOLNYŠKO;91676607875;Taip;0;8;0;8
14525;Berželis;SOLNYŠKO;1729593575;Taip;4;6;0;10
14526;Berželis;SOLNYŠKO;2069597007;Taip;0;22;0;22
14527;Berželis;SOLNYŠKO;97145959022;Taip;17;0;0;17
14528;Berželis;SOLNYŠKO;4422816945;Taip;0;7;0;7
14529;Berželis;SOLNYŠKO;9022925550;Taip;0;9;0;9
14530;Berželis;SOLNYŠKO;68853290649;Ne;11;0;0;11
14531;Berželis;SOLNYŠKO;5332069480;Taip;0;5;0;5
14532;Berželis;SOLNYŠKO;1929783185;Taip;0;14;0;14
14533;Berželis;SOLNYŠKO;50400542457;Taip;0;1;0;1
14534;Berželis;BABOČKI;5371508044;Taip;15;0;0;15
14535;Berželis;BABOČKI;1076719080;Taip;22;0;0;22
14536;Berželis;BABOČKI;2030770943;Taip;0;15;0;15
14537;Berželis;BABOČKI;9839929976;Taip;0;16;0;16
14538;Berželis;BABOČKI;4100740863;Taip;20;2;0;22
14539;Berželis;BABOČKI;2667957070;Taip;9;0;0;9
14540;Berželis;BABOČKI;7781031211;Taip;13;0;0;13
14541;Berželis;BABOČKI;2493612905;Taip;12;0;0;12
14542;Berželis;BABOČKI;5688897783;Taip;0;8;0;8
14543;Berželis;BABOČKI;6942559693;Taip;2;0;0;2
14544;Berželis;BABOČKI;9245706377;Taip;11;0;0;11
14545;Berželis;BABOČKI;6352635742;Ne;0;4;0;4
14546;Berželis;BABOČKI;3097809074;Taip;0;1;0;1
14547;Berželis;BABOČKI;3613459846;Taip;13;0;0;13
14548;Berželis;BABOČKI;8448872491;Taip;12;6;0;18
14549;Berželis;BABOČKI;2954451168;Taip;11;0;0;11
14550;Berželis;BABOČKI;4312062240;Taip;0;6;0;6
14551;Berželis;SOVUŠKI;8939353460;Taip;15;0;0;15
14552;Berželis;SOVUŠKI;5879965735;Taip;0;0;7;7
14553;Berželis;SOVUŠKI;1183377037;Ne;0;0;2;2
14554;Berželis;SOVUŠKI;1573177287;Taip;0;12;0;12
14555;Berželis;SOVUŠKI;48932211843;Taip;0;0;5;5
14556;Berželis;SOVUŠKI;11671380984;Taip;0;0;2;2
14557;Berželis;SOVUŠKI;1927042277;Taip;0;8;0;8
14558;Berželis;SOVUŠKI;1865658456;Taip;13;0;0;13
14559;Berželis;SOVUŠKI;1061894314;Taip;15;0;0;15
14560;Berželis;SOVUŠKI;5739686368;Taip;0;0;2;2
14561;Berželis;SOVUŠKI;25985469678;Taip;22;0;0;22
14562;Berželis;SOVUŠKI;2028316867;Ne;0;12;0;12
14563;Berželis;SOVUŠKI;83253240251;Taip;17;2;0;19
14564;Berželis;SOVUŠKI;1470907829;Taip;0;1;0;1
14565;Berželis;SOVUŠKI;9134420285;Ne;0;4;0;4
14566;Berželis;SOVUŠKI;4080387580;Taip;15;0;0;15
14567;Berželis;SOVUŠKI;5337604370;Taip;0;0;4;4
14568;Berželis;SOVUŠKI;1492203156;Taip;0;0;2;2
14569;Berželis;PODSOLNUŠKI;4521372127;Taip;0;3;0;3
14570;Berželis;PODSOLNUŠKI;2214171136;Taip;6;3;0;9
14571;Berželis;PODSOLNUŠKI;97218091736;Taip;15;0;1;16
14572;Berželis;PODSOLNUŠKI;1521982237;Taip;22;0;0;22
14573;Berželis;PODSOLNUŠKI;4013215941;Taip;0;5;0;5
14574;Berželis;PODSOLNUŠKI;7526006253;Taip;3;0;0;3
14575;Berželis;PODSOLNUŠKI;64214150955;Ne;0;1;0;1
14576;Berželis;PODSOLNUŠKI;9024992452;Taip;0;1;0;1
14577;Berželis;PODSOLNUŠKI;5084171353;Taip;1;10;0;11
14578;Berželis;PODSOLNUŠKI;6473498471;Taip;6;0;0;6
14579;Berželis;PODSOLNUŠKI;1067618571;Taip;8;0;0;8
14580;Berželis;PODSOLNUŠKI;3772780161;Taip;14;0;0;14
14581;Berželis;PODSOLNUŠKI;4563582416;Taip;14;0;0;14
14582;Berželis;PODSOLNUŠKI;7227603702;Taip;2;0;0;2
14583;Berželis;PODSOLNUŠKI;6113571093;Ne;7;1;0;8
14584;Berželis;PODSOLNUŠKI;4284157599;Taip;3;2;0;5
14585;Berželis;PODSOLNUŠKI;2615440913;Taip;16;0;0;16
14586;Berželis;"1 klasė";68739754511;Taip;10;0;0;10
14587;Berželis;"1 klasė";5442568208;Taip;1;0;0;1
14588;Berželis;"1 klasė";9168601277;Taip;1;0;0;1
14589;Berželis;"1 klasė";2412399682;Taip;22;0;0;22
14590;Berželis;"1 klasė";34721593327;Taip;22;0;0;22
14591;Berželis;"1 klasė";40956353978;Taip;9;0;0;9
14592;Berželis;"1 klasė";12564193771;Taip;2;0;0;2
14593;Berželis;"1 klasė";3658542055;Taip;0;22;0;22
14594;Berželis;"1 klasė";945754955;Taip;6;0;0;6
14595;Berželis;"2 klasė";66532479024;Ne;0;22;0;22
14596;Berželis;"2 klasė";3554738276;Taip;0;22;0;22
14597;Berželis;"2 klasė";4750570367;Ne;0;22;0;22
14598;Berželis;"2 klasė";67358830655;Taip;0;22;0;22
14599;Berželis;"2 klasė";13521812215;Taip;0;22;0;22
14600;Berželis;"2 klasė";4263364972;Taip;1;0;0;1
14601;Berželis;"2 klasė";4381565277;Ne;2;0;0;2
14602;Berželis;"2 klasė";7489328291;Ne;12;0;0;12
14603;Berželis;"2 klasė";6442475480;Ne;3;0;0;3
14604;Berželis;"2 klasė";3576772433;Ne;8;0;0;8
14605;Berželis;"2 klasė";9657020323;Ne;2;0;0;2
14606;Berželis;"2 klasė";1448407405;Ne;2;0;0;2
14607;Berželis;"3 klasė";2501433917;Ne;5;0;0;5
14608;Berželis;"3 klasė";8322372921;Ne;1;0;0;1
14609;Berželis;"3 klasė";5856177876;Ne;3;0;0;3
14610;Berželis;"3 klasė";6702857359;Ne;9;0;0;9
14611;Berželis;"3 klasė";4245771747;Ne;1;0;0;1
14612;Berželis;"3 klasė";3149377224;Ne;6;0;0;6
14613;Berželis;"3 klasė";3064700283;Ne;7;0;0;7
14614;Berželis;"3 klasė";9998560354;Ne;5;0;0;5
14615;Berželis;"3 klasė";8143634742;Ne;3;0;0;3
14616;Berželis;"3 klasė";9486991928;Ne;7;0;0;7
14617;Berželis;"3 klasė";8921842915;Ne;3;0;0;3
14618;Berželis;"3 klasė";7728620622;Ne;7;0;0;7
14619;Berželis;"3 klasė";2691853015;Ne;6;0;0;6
14620;Berželis;"3 klasė";2955045450;Ne;7;0;0;7
14621;Berželis;"3 klasė";5616257764;Taip;0;22;0;22
14622;Berželis;"3 klasė";50930845005;Taip;1;0;0;1
14623;Berželis;"4 klasė";9853596804;Ne;0;22;0;22
14624;Berželis;"4 klasė";9397809279;Ne;0;22;0;22
14625;Berželis;"4 klasė";5637244096;Ne;2;0;0;2
14626;Berželis;"4 klasė";3565822447;Ne;4;0;0;4
14627;Berželis;"4 klasė";9635029366;Ne;3;0;0;3
14628;Berželis;"4 klasė";3773489172;Ne;1;0;0;1
14629;Berželis;"4 klasė";2155354527;Ne;4;0;0;4
14630;Berželis;"4 klasė";6588688183;Taip;18;0;0;18
14631;Saulutė;Drugeliai;66108847230;Taip;9;1;0;10
14632;Saulutė;Drugeliai;1513449225;Taip;10;0;0;10
14633;Saulutė;Drugeliai;1556270046;Taip;0;0;1;1
14634;Saulutė;Drugeliai;3064199909;Taip;5;0;2;7
14635;Saulutė;Drugeliai;2097055107;Taip;0;2;0;2
14636;Saulutė;Drugeliai;1717909005;Taip;13;1;0;14
14637;Saulutė;Drugeliai;1283800571;Taip;0;9;0;9
14638;Saulutė;Drugeliai;8599199376;Taip;20;0;0;20
14639;Saulutė;Drugeliai;1750571258;Taip;5;3;0;8
14640;Saulutė;Drugeliai;87814849917;Taip;0;1;1;2
14641;Saulutė;Drugeliai;1609952589;Taip;0;3;0;3
14642;Saulutė;Drugeliai;1386800520;Taip;0;1;1;2
14643;Saulutė;Drugeliai;1261384337;Taip;0;2;2;4
14644;Saulutė;Drugeliai;1320018338;Ne;0;0;8;8
14645;Saulutė;Drugeliai;1291318940;Taip;22;0;0;22
14646;Saulutė;Drugeliai;2162114750;Ne;0;0;9;9
14647;Saulutė;Drugeliai;9550046358;Taip;0;1;2;3
14648;Saulutė;Drugeliai;1391904744;Taip;4;1;3;8
14649;Saulutė;Drugeliai;8944601874;Taip;11;4;0;15
14650;Saulutė;Drugeliai;1421523719;Taip;17;0;0;17
14651;Saulutė;Drugeliai;67332285574;Taip;0;0;3;3
14652;Saulutė;Drugeliai;4272320685;Taip;0;1;0;1
14653;Saulutė;"Saulės zuikučiai";2397257894;Taip;5;0;0;5
14654;Saulutė;"Saulės zuikučiai";1888990522;Taip;0;0;2;2
14655;Saulutė;"Saulės zuikučiai";2010774109;Taip;3;11;0;14
14656;Saulutė;"Saulės zuikučiai";3089541630;Taip;11;1;0;12
14657;Saulutė;"Saulės zuikučiai";5148542811;Taip;15;0;1;16
14658;Saulutė;"Saulės zuikučiai";1562393383;Taip;10;0;1;11
14659;Saulutė;"Saulės zuikučiai";9269501176;Taip;10;0;0;10
14660;Saulutė;"Saulės zuikučiai";9521155670;Taip;0;0;1;1
14661;Saulutė;"Saulės zuikučiai";2259917151;Taip;6;0;1;7
14662;Saulutė;"Saulės zuikučiai";3691381351;Taip;2;0;1;3
14663;Saulutė;"Saulės zuikučiai";9146298505;Taip;0;1;3;4
14664;Saulutė;"Saulės zuikučiai";8242602551;Taip;0;0;5;5
14665;Saulutė;"Saulės zuikučiai";1324799653;Taip;16;0;0;16
14666;Saulutė;"Saulės zuikučiai";5247769309;Taip;0;1;7;8
14667;Saulutė;"Saulės zuikučiai";1855999738;Ne;0;1;2;3
14668;Saulutė;"Saulės zuikučiai";2816806902;Taip;9;0;0;9
14669;Saulutė;"Saulės zuikučiai";7844396402;Taip;0;0;10;10
14670;Saulutė;"Saulės zuikučiai";2781003892;Taip;0;0;6;6
14671;Saulutė;Boružėlės;36955032265;Taip;0;0;1;1
14672;Saulutė;Boružėlės;44452051978;Ne;0;1;1;2
14673;Saulutė;Boružėlės;54950572289;Taip;0;1;5;6
14674;Saulutė;Boružėlės;92695618159;Taip;0;0;2;2
14675;Saulutė;Boružėlės;87409240076;Taip;3;0;0;3
14676;Saulutė;Boružėlės;1337654926;Taip;4;6;0;10
14677;Saulutė;Boružėlės;76744652185;Taip;0;1;0;1
14678;Saulutė;Boružėlės;97296161595;Taip;4;3;0;7
14679;Saulutė;Boružėlės;1804521229;Taip;0;0;5;5
14680;Saulutė;Boružėlės;1005459768;Taip;5;0;5;10
14681;Saulutė;Boružėlės;1205642335;Taip;0;1;10;11
14682;Saulutė;Boružėlės;43512415452;Taip;0;0;5;5
14683;Saulutė;Boružėlės;1644704074;Taip;0;0;2;2
14684;Saulutė;Boružėlės;1217446865;Taip;0;1;20;21
14685;Saulutė;Boružėlės;89710141573;Taip;0;1;7;8
14686;Saulutė;Boružėlės;46280382280;Ne;0;0;4;4
14687;Saulutė;Boružėlės;10893091651;Taip;0;1;2;3
14688;Saulutė;Boružėlės;70392220915;Taip;5;3;0;8
14689;Saulutė;Nykštukai;34712531615;Taip;4;0;3;7
14690;Saulutė;Nykštukai;10407286767;Taip;0;6;3;9
14691;Saulutė;Nykštukai;95826894716;Taip;0;3;0;3
14692;Saulutė;Nykštukai;6406135063;Ne;0;1;3;4
14693;Saulutė;Nykštukai;59825470089;Taip;0;0;6;6
14694;Saulutė;Nykštukai;65195759604;Taip;8;1;0;9
14695;Saulutė;Nykštukai;89894943477;Taip;3;0;0;3
14696;Saulutė;Nykštukai;84984808072;Taip;0;6;0;6
14697;Saulutė;Nykštukai;46092441981;Taip;0;6;0;6
14698;Saulutė;Nykštukai;37119876987;Taip;0;0;1;1
14699;Saulutė;Nykštukai;63869261653;Taip;12;0;2;14
14700;Saulutė;Nykštukai;9583443237;Taip;0;4;0;4
14701;Saulutė;Nykštukai;10595557639;Taip;0;0;1;1
14702;Saulutė;Nykštukai;7318452189;Taip;0;16;0;16
14703;Saulutė;Nykštukai;78558743548;Taip;0;0;9;9
14704;Saulutė;Nykštukai;91371507376;Ne;0;0;2;2
14705;Saulutė;Nykštukai;1332002470;Taip;4;4;0;8
14706;Saulutė;Nykštukai;3183309722;Ne;0;0;6;6
14707;Saulutė;Nykštukai;9081236999;Ne;0;0;8;8
14708;Saulutė;Nykštukai;9565528566;Taip;1;19;0;20
14709;Saulutė;Meškiukai;8433646525;Taip;0;3;2;5
14710;Saulutė;Meškiukai;3410606033;Taip;8;0;1;9
14711;Saulutė;Meškiukai;9314889468;Taip;20;0;0;20
14712;Saulutė;Meškiukai;6608003946;Taip;0;4;0;4
14713;Saulutė;Meškiukai;8257363228;Taip;8;0;1;9
14714;Saulutė;Meškiukai;7764493159;Ne;9;0;0;9
14715;Saulutė;Meškiukai;5565832676;Ne;9;0;0;9
14716;Saulutė;Meškiukai;9173336078;Taip;5;1;0;6
14717;Saulutė;Meškiukai;3026114869;Taip;7;0;0;7
14718;Saulutė;Meškiukai;6057668143;Taip;10;0;1;11
14719;Saulutė;Meškiukai;8736917541;Taip;12;0;0;12
14720;Saulutė;Meškiukai;7413098580;Taip;10;0;0;10
14721;Saulutė;Meškiukai;5999318972;Taip;7;0;1;8
14722;Saulutė;Meškiukai;2074473832;Taip;6;0;3;9
14723;Saulutė;Meškiukai;7574225926;Taip;5;0;2;7
14724;Saulutė;Ežiukai;19918665437;Taip;7;0;0;7
14725;Saulutė;Ežiukai;63481737955;Taip;0;0;1;1
14726;Saulutė;Ežiukai;55160240384;Taip;0;16;0;16
14727;Saulutė;Ežiukai;1861612651;Taip;12;0;0;12
14728;Saulutė;Ežiukai;19852146326;Taip;0;1;0;1
14729;Saulutė;Ežiukai;32539394191;Taip;18;1;0;19
14730;Saulutė;Ežiukai;3608072547;Taip;0;2;0;2
14731;Saulutė;Ežiukai;1579654900;Taip;10;0;0;10
14732;Saulutė;Ežiukai;6099238784;Taip;0;0;3;3
14733;Saulutė;Ežiukai;12674831673;Taip;0;0;14;14
14734;Saulutė;Ežiukai;1546200973;Taip;7;0;1;8
14735;Saulutė;Ežiukai;1077526046;Ne;0;0;1;1
14736;Saulutė;Ežiukai;1917058710;Taip;0;0;3;3
14737;Saulutė;Ežiukai;2059267616;Taip;7;0;0;7
14738;Saulutė;Ežiukai;1212865434;Ne;0;0;1;1
14739;Saulutė;Ežiukai;2190922941;Taip;6;0;1;7
14740;Saulutė;Ežiukai;2813274509;Taip;10;0;3;13
14741;Saulutė;Bitutės;4510990261;Taip;5;0;0;5
14742;Saulutė;Bitutės;3272296969;Taip;0;6;0;6
14743;Saulutė;Bitutės;2545930114;Ne;21;0;0;21
14744;Saulutė;Bitutės;2140277182;Taip;10;0;0;10
14745;Saulutė;Bitutės;6044672321;Ne;0;0;7;7
14746;Saulutė;Bitutės;6396954377;Ne;14;0;0;14
14747;Saulutė;Bitutės;3295289082;Taip;0;8;0;8
14748;Saulutė;Bitutės;8390767549;Taip;22;0;0;22
14749;Saulutė;Bitutės;1056158093;Taip;12;0;0;12
14750;Saulutė;Bitutės;7888435573;Taip;6;0;3;9
14751;Saulutė;Bitutės;7297886198;Taip;22;0;0;22
14752;Saulutė;Bitutės;7576532632;Taip;4;7;0;11
14753;Saulutė;Bitutės;8708184278;Taip;14;0;0;14
14754;Saulutė;Bitutės;8040751073;Taip;13;0;2;15
14755;Saulutė;Bitutės;1587328722;Taip;17;0;0;17
14756;Saulutė;Bitutės;8512137633;Taip;17;0;0;17
14757;Saulutė;Bitutės;2725491887;Taip;13;0;0;13
14758;Saulutė;Bitutės;4123500930;Ne;0;0;5;5
14759;Saulutė;Pelėdžiukai;3445723020;Ne;15;1;0;16
14760;Saulutė;Pelėdžiukai;1785740531;Taip;10;1;2;13
14761;Saulutė;Pelėdžiukai;1534183935;Taip;0;0;2;2
14762;Saulutė;Pelėdžiukai;27386434894;Taip;0;0;2;2
14763;Saulutė;Pelėdžiukai;23640604487;Taip;0;0;1;1
14764;Saulutė;Pelėdžiukai;7539721995;Taip;0;2;0;2
14765;Saulutė;Pelėdžiukai;65492344097;Taip;0;0;1;1
14766;Saulutė;Pelėdžiukai;77923802656;Taip;4;0;0;4
14767;Saulutė;Pelėdžiukai;79919438191;Taip;0;0;5;5
14768;Saulutė;Pelėdžiukai;31705050946;Taip;10;0;5;15
14769;Saulutė;Pelėdžiukai;45306237230;Taip;4;1;0;5
14770;Saulutė;Pelėdžiukai;14195215027;Taip;11;0;0;11
14771;Saulutė;Pelėdžiukai;28772515317;Ne;8;0;4;12
14772;Saulutė;Pelėdžiukai;50944263059;Taip;0;0;3;3
14773;Saulutė;Pelėdžiukai;1510434265;Taip;0;3;2;5
14774;Saulutė;Pelėdžiukai;5574049005;Taip;19;0;0;19
14775;Saulutė;Pelėdžiukai;77170708225;Taip;5;0;0;5
14776;Saulutė;Pelėdžiukai;4312318284;Taip;22;0;0;22
14777;Saulutė;Zylutės;91834332717;Taip;0;8;0;8
14778;Saulutė;Zylutės;1277263391;Taip;0;0;8;8
14779;Saulutė;Zylutės;75405796772;Ne;10;0;3;13
14780;Saulutė;Zylutės;6557918941;Taip;0;1;0;1
14781;Saulutė;Zylutės;78967475616;Ne;10;0;4;14
14782;Saulutė;Zylutės;1786491396;Taip;0;7;0;7
14783;Saulutė;Zylutės;55982591521;Taip;0;0;4;4
14784;Saulutė;Zylutės;3246485288;Taip;0;0;5;5
14785;Saulutė;Zylutės;21703177024;Ne;5;0;10;15
14786;Saulutė;Zylutės;54373231773;Taip;0;11;0;11
14787;Saulutė;Zylutės;88168936754;Taip;10;0;2;12
14788;Saulutė;Zylutės;85182498024;Taip;10;1;1;12
14789;Saulutė;Zylutės;98979263108;Taip;0;13;0;13
14790;Saulutė;Zylutės;16622528829;Taip;0;14;0;14
14791;Saulutė;Zylutės;1475031090;Taip;0;0;3;3
14792;Saulutė;Zylutės;57283533169;Taip;0;0;3;3
14793;Saulutė;Zylutės;3450668814;Taip;0;5;0;5
14794;Saulutė;Zylutės;13147367113;Taip;0;4;0;4
14795;Saulutė;"1 klasė";5997216605;Taip;21;1;0;22
14796;Saulutė;"1 klasė";92198716772;Taip;0;1;0;1
14797;Saulutė;"1 klasė";8632066475;Ne;21;1;0;22
14798;Saulutė;"1 klasė";67739063665;Taip;1;1;0;2
14799;Saulutė;"1 klasė";50110262859;Taip;0;1;0;1
14800;Saulutė;"1 klasė";6469772450;Taip;21;1;0;22
14801;Saulutė;"1 klasė";4302511346;Ne;21;1;0;22
14802;Saulutė;"1 klasė";18122758338;Taip;1;1;0;2
14803;Saulutė;"1 klasė";8962761979;Taip;21;1;0;22
14804;Saulutė;"1 klasė";7785909571;Ne;0;1;0;1
14805;Saulutė;"1 klasė";5822529731;Taip;8;1;0;9
14806;Saulutė;"1 klasė";2095347468;Taip;5;1;0;6
14807;Saulutė;"1 klasė";56289088231;Taip;5;1;0;6
14808;Saulutė;"1 klasė";1418237274;Taip;1;1;0;2
14809;Saulutė;"1 klasė";13916981850;Taip;2;1;0;3
14810;Saulutė;"1 klasė";61123463673;Taip;5;1;0;6
14811;Saulutė;"1 klasė";39606108938;Ne;2;1;0;3
14812;Saulutė;"1 klasė";82106514982;Taip;0;1;0;1
14813;Saulutė;"1 klasė";58163470119;Taip;5;1;0;6
14814;Saulutė;"1 klasė";81191097069;Taip;3;1;0;4
14815;Saulutė;"1 klasė";37839378248;Taip;0;1;0;1
14816;Saulutė;"1 klasė";90078805222;Taip;0;1;0;1
14817;Saulutė;"1 klasė";61113930769;Taip;2;1;0;3
14818;Saulutė;"1 klasė";42204884890;Ne;4;1;0;5
14819;Saulutė;"1 klasė";12964000357;Taip;6;1;0;7
14820;Saulutė;"1 klasė";25720655179;Ne;0;1;0;1
14821;Saulutė;"1 klasė";30863736694;Taip;1;1;0;2
14822;Saulutė;"1 klasė";45877127245;Taip;0;1;0;1
14823;Saulutė;"1 klasė";8308288099;Ne;4;1;0;5
14824;Saulutė;"1 klasė";54726632101;Taip;0;1;0;1
14825;Saulutė;"1 klasė";16523279366;Taip;4;1;0;5
14826;Saulutė;"2 klasė";1701868565;Taip;1;1;0;2
14827;Saulutė;"2 klasė";6924270821;Ne;8;1;0;9
14828;Saulutė;"2 klasė";3450860412;Ne;1;1;0;2
14829;Saulutė;"2 klasė";1081812391;Taip;0;1;0;1
14830;Saulutė;"2 klasė";1436690766;Taip;4;1;0;5
14831;Saulutė;"2 klasė";7577219457;Taip;0;1;0;1
14832;Saulutė;"2 klasė";2517511237;Taip;0;1;0;1
14833;Saulutė;"2 klasė";1153099638;Taip;1;1;0;2
14834;Saulutė;"2 klasė";5786453424;Taip;1;1;0;2
14835;Saulutė;"2 klasė";8531372660;Taip;0;1;0;1
14836;Saulutė;"2 klasė";1117229507;Taip;0;1;0;1
14837;Saulutė;"2 klasė";4342595483;Taip;0;1;0;1
14838;Saulutė;"2 klasė";3614749034;Taip;8;1;0;9
14839;Saulutė;"2 klasė";3937034221;Ne;5;1;0;6
14840;Saulutė;"2 klasė";7543978588;Taip;0;1;0;1
14841;Saulutė;"2 klasė";7696948081;Taip;5;1;0;6
14842;Saulutė;"2 klasė";4252242862;Taip;6;1;0;7
14843;Saulutė;"2 klasė";2957436888;Taip;9;1;0;10
14844;Saulutė;"2 klasė";1312993030;Taip;1;1;0;2
14845;Saulutė;"2 klasė";3755300838;Taip;0;1;0;1
14846;Saulutė;"2 klasė";9744870287;Taip;2;1;0;3
14847;Saulutė;"2 klasė";8953313952;Ne;0;1;0;1
14848;Saulutė;"2 klasė";8192525690;Taip;0;1;0;1
14849;Saulutė;"2 klasė";6025668467;Ne;0;1;0;1
14850;Saulutė;"3 klasė";1604607524;Ne;0;1;0;1
14851;Saulutė;"3 klasė";1787634725;Ne;0;1;0;1
14852;Saulutė;"3 klasė";6128992723;Ne;1;1;0;2
14853;Saulutė;"3 klasė";3806787884;Ne;0;1;0;1
14854;Saulutė;"3 klasė";9155511473;Ne;0;1;0;1
14855;Saulutė;"3 klasė";3302267009;Ne;4;1;0;5
14856;Saulutė;"3 klasė";1659579883;Ne;6;1;0;7
14857;Saulutė;"3 klasė";9833653313;Ne;0;1;0;1
14858;Saulutė;"3 klasė";5193599921;Ne;0;1;0;1
14859;Saulutė;"3 klasė";9113434597;Ne;0;1;0;1
14860;Saulutė;"3 klasė";8601544457;Taip;6;1;0;7
14861;Saulutė;"3 klasė";8506064421;Ne;0;1;0;1
14862;Saulutė;"3 klasė";7700196440;Ne;2;1;0;3
14863;Saulutė;"3 klasė";9621988308;Ne;21;1;0;22
14864;Saulutė;"3 klasė";4189732482;Ne;21;1;0;22
14865;Saulutė;"3 klasė";2638495931;Ne;21;1;0;22
14866;Saulutė;"3 klasė";6797161399;Ne;3;1;0;4
14867;Saulutė;"3 klasė";9885756874;Ne;2;1;0;3
14868;Saulutė;"3 klasė";6957680310;Ne;2;1;0;3
14869;Saulutė;"3 klasė";7343265118;Ne;21;1;0;22
14870;Saulutė;"3 klasė";2374587130;Ne;2;1;0;3
14871;Saulutė;"4 klasė";5056875822;Ne;9;1;0;10
14872;Saulutė;"4 klasė";9319954066;Ne;5;1;0;6
14873;Saulutė;"4 klasė";6584576600;Ne;0;1;0;1
14874;Saulutė;"4 klasė";5395865996;Ne;0;1;0;1
14875;Saulutė;"4 klasė";7115874340;Ne;11;1;0;12
14876;Saulutė;"4 klasė";4407219804;Ne;0;1;0;1
14877;Saulutė;"4 klasė";7050670622;Ne;0;1;0;1
14878;Saulutė;"4 klasė";4724713439;Ne;0;1;0;1
14879;Saulutė;"4 klasė";7656351068;Ne;0;1;0;1
14880;Saulutė;"4 klasė";3798600407;Ne;3;1;0;4
14881;Saulutė;"4 klasė";9802910644;Ne;0;1;0;1
14882;Saulutė;"4 klasė";4804531706;Ne;1;1;0;2
14883;Saulutė;"4 klasė";2876473029;Ne;1;1;0;2
14884;Svaja;SAULĖGRĄŽA;1649920341;Taip;0;2;0;2
14885;Svaja;SAULĖGRĄŽA;50510924690;Ne;0;0;1;1
14886;Svaja;SAULĖGRĄŽA;54462393937;Taip;0;1;0;1
14887;Svaja;SAULĖGRĄŽA;57216299421;Ne;11;3;0;14
14888;Svaja;SAULĖGRĄŽA;1181877436;Taip;0;0;1;1
14889;Svaja;SAULĖGRĄŽA;64487515384;Taip;0;0;1;1
14890;Svaja;SAULĖGRĄŽA;25578518444;Taip;0;3;0;3
14891;Svaja;SAULĖGRĄŽA;93651139102;Taip;0;3;0;3
14892;Svaja;SAULĖGRĄŽA;1470843400;Taip;3;0;2;5
14893;Svaja;SAULĖGRĄŽA;63346231562;Taip;7;7;0;14
14894;Svaja;SAULĖGRĄŽA;73391331150;Ne;4;0;2;6
14895;Svaja;SAULĖGRĄŽA;41183537732;Taip;10;0;1;11
14896;Svaja;SAULĖGRĄŽA;30833178157;Taip;0;0;2;2
14897;Svaja;SAULĖGRĄŽA;70507326327;Taip;0;3;0;3
14898;Svaja;SAULĖGRĄŽA;25934507261;Taip;0;0;1;1
14899;Svaja;SAULĖGRĄŽA;70506691027;Taip;0;1;0;1
14900;Svaja;SAULĖGRĄŽA;89047123808;Taip;0;0;2;2
14901;Svaja;SAULĖGRĄŽA;7348182434;Taip;0;2;0;2
14902;Svaja;SAULĖGRĄŽA;1795682827;Taip;0;3;0;3
14903;Svaja;SAULĖGRĄŽA;8011137572;Taip;0;0;3;3
14904;Svaja;SAULĖGRĄŽA;3499148291;Taip;0;6;0;6
14905;Svaja;SAULĖGRĄŽA;4416877973;Taip;0;2;0;2
14906;Svaja;SAULĖGRĄŽA;99005386537;Taip;0;5;0;5
14907;Svaja;"STEBUKLINGAS ŽIBINTAS";9847061480;Taip;11;0;2;13
14908;Svaja;"STEBUKLINGAS ŽIBINTAS";89695643588;Taip;0;0;7;7
14909;Svaja;"STEBUKLINGAS ŽIBINTAS";1660742385;Taip;0;0;3;3
14910;Svaja;"STEBUKLINGAS ŽIBINTAS";9628146488;Taip;0;0;2;2
14911;Svaja;"STEBUKLINGAS ŽIBINTAS";1304775332;Taip;0;0;4;4
14912;Svaja;"STEBUKLINGAS ŽIBINTAS";1903424547;Taip;0;0;4;4
14913;Svaja;"STEBUKLINGAS ŽIBINTAS";30360097999;Taip;0;4;0;4
14914;Svaja;"STEBUKLINGAS ŽIBINTAS";19887874988;Taip;0;0;3;3
14915;Svaja;"STEBUKLINGAS ŽIBINTAS";1967394949;Taip;2;4;0;6
14916;Svaja;"STEBUKLINGAS ŽIBINTAS";36362624522;Taip;0;0;4;4
14917;Svaja;"STEBUKLINGAS ŽIBINTAS";7719185632;Taip;0;7;0;7
14918;Svaja;"STEBUKLINGAS ŽIBINTAS";1297727288;Taip;0;1;0;1
14919;Svaja;"STEBUKLINGAS ŽIBINTAS";30027404222;Taip;0;0;9;9
14920;Svaja;"STEBUKLINGAS ŽIBINTAS";57216954289;Taip;0;8;0;8
14921;Svaja;"STEBUKLINGAS ŽIBINTAS";51382165039;Taip;12;0;3;15
14922;Svaja;"STEBUKLINGAS ŽIBINTAS";1352488176;Taip;2;11;0;13
14923;Svaja;"STEBUKLINGAS ŽIBINTAS";44989143252;Taip;0;0;7;7
14924;Svaja;"STEBUKLINGAS ŽIBINTAS";1943166503;Ne;0;0;2;2
14925;Svaja;"STEBUKLINGAS ŽIBINTAS";6056157113;Taip;0;0;3;3
14926;Svaja;"STEBUKLINGAS ŽIBINTAS";8198614500;Taip;0;0;6;6
14927;Svaja;SAULUTĖ;50207734108;Taip;5;0;1;6
14928;Svaja;SAULUTĖ;20473739993;Taip;2;0;1;3
14929;Svaja;SAULUTĖ;2493749424;Taip;0;0;1;1
14930;Svaja;SAULUTĖ;30719991872;Taip;16;0;1;17
14931;Svaja;SAULUTĖ;6665752307;Taip;16;0;0;16
14932;Svaja;SAULUTĖ;80459437057;Ne;22;0;0;22
14933;Svaja;SAULUTĖ;4968201186;Taip;0;9;0;9
14934;Svaja;SAULUTĖ;6807834176;Taip;0;5;0;5
14935;Svaja;SAULUTĖ;7020342969;Taip;0;3;0;3
14936;Svaja;SAULUTĖ;3633996231;Taip;10;0;1;11
14937;Svaja;SAULUTĖ;2750615517;Taip;5;0;1;6
14938;Svaja;SAULUTĖ;1045300185;Taip;0;0;3;3
14939;Svaja;SAULUTĖ;4341042027;Taip;0;0;2;2
14940;Svaja;SAULUTĖ;3802996573;Taip;0;0;3;3
14941;Svaja;SAULUTĖ;6676145522;Taip;0;0;3;3
14942;Svaja;SAULUTĖ;4293339784;Taip;12;0;0;12
14943;Svaja;SAULUTĖ;9475971731;Taip;10;0;0;10
14944;Svaja;SAULUTĖ;5479482244;Ne;1;0;1;2
14945;Svaja;SAULUTĖ;7473493846;Taip;11;0;1;12
14946;Svaja;SAULUTĖ;5443682744;Ne;16;3;0;19
14947;Svaja;SAULUTĖ;9112198914;Taip;5;0;2;7
14948;Svaja;"AUKSINĖ ŽUVELĖ";43307670660;Taip;2;2;0;4
14949;Svaja;"AUKSINĖ ŽUVELĖ";25194696146;Taip;0;2;0;2
14950;Svaja;"AUKSINĖ ŽUVELĖ";55925058866;Taip;0;0;2;2
14951;Svaja;"AUKSINĖ ŽUVELĖ";1704075006;Ne;0;2;0;2
14952;Svaja;"AUKSINĖ ŽUVELĖ";70641067006;Taip;0;0;1;1
14953;Svaja;"AUKSINĖ ŽUVELĖ";8875237023;Taip;0;0;4;4
14954;Svaja;"AUKSINĖ ŽUVELĖ";8279605005;Taip;0;0;1;1
14955;Svaja;"AUKSINĖ ŽUVELĖ";1437557657;Taip;15;0;1;16
14956;Svaja;"AUKSINĖ ŽUVELĖ";87432529423;Taip;0;0;1;1
14957;Svaja;"AUKSINĖ ŽUVELĖ";58102699652;Ne;0;1;0;1
14958;Svaja;"AUKSINĖ ŽUVELĖ";6593047776;Taip;0;22;0;22
14959;Svaja;"AUKSINĖ ŽUVELĖ";5335776957;Ne;17;0;0;17
14960;Svaja;"AUKSINĖ ŽUVELĖ";8242667827;Taip;5;5;2;12
14961;Svaja;"AUKSINĖ ŽUVELĖ";6211339131;Taip;5;4;2;11
14962;Svaja;"AUKSINĖ ŽUVELĖ";1295012978;Taip;0;0;8;8
14963;Svaja;"AUKSINĖ ŽUVELĖ";64196174690;Taip;5;0;0;5
14964;Svaja;"AUKSINĖ ŽUVELĖ";97298858365;Taip;6;0;1;7
14965;Svaja;"AUKSINĖ ŽUVELĖ";22702341083;Taip;12;0;0;12
14966;Svaja;"AUKSINĖ ŽUVELĖ";2076060840;Taip;7;0;0;7
14967;Svaja;"AUKSINĖ ŽUVELĖ";43223177664;Taip;5;0;0;5
14968;Svaja;"AUKSINĖ ŽUVELĖ";27445299450;Taip;0;0;2;2
14969;Svaja;"PRIE ĮLANKOS";2165716699;Taip;0;0;2;2
14970;Svaja;"PRIE ĮLANKOS";6020060540;Taip;0;0;8;8
14971;Svaja;"PRIE ĮLANKOS";75104768118;Taip;0;0;6;6
14972;Svaja;"PRIE ĮLANKOS";94449039022;Taip;8;0;0;8
14973;Svaja;"PRIE ĮLANKOS";1367687415;Taip;7;0;1;8
14974;Svaja;"PRIE ĮLANKOS";85150525696;Taip;0;8;0;8
14975;Svaja;"PRIE ĮLANKOS";92044111261;Taip;0;1;0;1
14976;Svaja;"PRIE ĮLANKOS";74904581010;Taip;0;1;0;1
14977;Svaja;"PRIE ĮLANKOS";1847775266;Taip;0;10;0;10
14978;Svaja;"PRIE ĮLANKOS";44418402260;Taip;0;0;2;2
14979;Svaja;"PRIE ĮLANKOS";54328462992;Taip;0;0;3;3
14980;Svaja;"PRIE ĮLANKOS";18238622848;Taip;5;0;5;10
14981;Svaja;"PRIE ĮLANKOS";4617061890;Ne;0;0;3;3
14982;Svaja;"PRIE ĮLANKOS";71708072632;Taip;0;0;3;3
14983;Svaja;"PRIE ĮLANKOS";56506642672;Taip;0;0;1;1
14984;Svaja;"PRIE ĮLANKOS";34141773112;Ne;0;0;1;1
14985;Svaja;"PRIE ĮLANKOS";5522433229;Taip;0;9;0;9
14986;Svaja;"PRIE ĮLANKOS";40856210635;Taip;0;0;3;3
14987;Svaja;"PRIE ĮLANKOS";36001411632;Taip;0;0;3;3
14988;Svaja;"PRIE ĮLANKOS";3604946305;Taip;10;0;1;11
14989;Svaja;"PRIE ĮLANKOS";6905550313;Taip;8;0;0;8
14990;Svaja;"1 B klasė";8876971658;Taip;0;22;0;22
14991;Svaja;"1 B klasė";30200636424;Ne;0;8;0;8
14992;Svaja;"1 B klasė";8802243719;Taip;0;6;0;6
14993;Svaja;"1 B klasė";9401605132;Taip;0;12;0;12
14994;Svaja;"1 B klasė";77796846388;Taip;0;12;0;12
14995;Svaja;"1 B klasė";71840791098;Taip;0;3;0;3
14996;Svaja;"1 B klasė";5712106350;Taip;0;5;0;5
14997;Svaja;"1 B klasė";57983452414;Taip;0;12;0;12
14998;Svaja;"1 B klasė";71086654007;Taip;0;11;0;11
14999;Svaja;"1 B klasė";29972474690;Taip;0;7;0;7
15000;Svaja;"1 B klasė";38464012322;Taip;0;2;0;2
15001;Svaja;"1 B klasė";15871540340;Taip;0;3;0;3
15002;Svaja;"1 B klasė";47441661801;Ne;0;3;0;3
15003;Svaja;"1 B klasė";68894832324;Taip;0;7;0;7
15004;Svaja;"1 B klasė";7747921362;Ne;0;5;0;5
15005;Svaja;"1 B klasė";21035820496;Taip;0;4;0;4
15006;Svaja;"1 B klasė";61996055386;Taip;0;5;0;5
15007;Svaja;"1 B klasė";59707838958;Taip;0;3;0;3
15008;Svaja;"1 B klasė";62579722313;Taip;0;3;0;3
15009;Svaja;"1 B klasė";77712240909;Taip;0;3;0;3
15010;Svaja;"1 B klasė";27313057222;Taip;0;22;0;22
15011;Svaja;"1 B klasė";97651620085;Taip;0;4;0;4
15012;Svaja;"1 A klasė";28311552445;Taip;0;12;0;12
15013;Svaja;"1 A klasė";88447528808;Taip;0;3;0;3
15014;Svaja;"1 A klasė";21534170175;Taip;0;3;0;3
15015;Svaja;"1 A klasė";89075087937;Taip;0;22;0;22
15016;Svaja;"1 A klasė";72655912805;Taip;0;3;0;3
15017;Svaja;"1 A klasė";16955510836;Taip;0;4;0;4
15018;Svaja;"1 A klasė";49184638535;Taip;0;22;0;22
15019;Svaja;"1 A klasė";66507774550;Taip;0;4;0;4
15020;Svaja;"1 A klasė";2019179013;Ne;0;6;0;6
15021;Svaja;"1 A klasė";69928474471;Taip;0;7;0;7
15022;Svaja;"1 A klasė";56095979514;Taip;0;12;0;12
15023;Svaja;"1 A klasė";24812635291;Taip;0;4;0;4
15024;Svaja;"1 A klasė";99157757025;Ne;0;4;0;4
15025;Svaja;"1 A klasė";89627730276;Taip;0;9;0;9
15026;Svaja;"1 A klasė";48859926231;Taip;0;8;0;8
15027;Svaja;"1 A klasė";20363553383;Taip;0;3;0;3
15028;Svaja;"1 A klasė";70513111186;Ne;0;5;0;5
15029;Svaja;"1 A klasė";31604152893;Ne;0;11;0;11
15030;Svaja;"1 A klasė";76101749947;Taip;0;22;0;22
15031;Svaja;"1 A klasė";96680395594;Taip;0;7;0;7
15032;Svaja;"1 A klasė";58497063533;Taip;0;13;0;13
15033;Svaja;"1 A klasė";38781141060;Taip;0;4;0;4
15034;Svaja;"1 C klasė";2018073862;Taip;0;4;0;4
15035;Svaja;"1 C klasė";70157518595;Taip;0;6;0;6
15036;Svaja;"1 C klasė";73691352138;Taip;0;3;0;3
15037;Svaja;"1 C klasė";6613028133;Taip;0;5;0;5
15038;Svaja;"1 C klasė";5288858941;Ne;0;3;0;3
15039;Svaja;"1 C klasė";5975083034;Ne;0;22;0;22
15040;Svaja;"1 C klasė";94437606762;Taip;0;22;0;22
15041;Svaja;"1 C klasė";25585032766;Taip;0;22;0;22
15042;Svaja;"1 C klasė";79572045341;Taip;0;20;0;20
15043;Svaja;"1 C klasė";50116820543;Taip;0;3;0;3
15044;Svaja;"1 C klasė";66967032561;Taip;0;22;0;22
15045;Svaja;"1 C klasė";79260508923;Taip;0;6;0;6
15046;Svaja;"1 C klasė";3909240894;Ne;0;3;0;3
15047;Svaja;"1 C klasė";82358174131;Taip;0;3;0;3
15048;Svaja;"1 C klasė";53352329988;Taip;0;3;0;3
15049;Svaja;"1 C klasė";59917024948;Taip;0;3;0;3
15050;Svaja;"1 C klasė";48888360976;Taip;0;3;0;3
15051;Svaja;"1 C klasė";76871144487;Taip;0;5;0;5
15052;Svaja;"1 C klasė";73440582394;Taip;0;3;0;3
15053;Svaja;"1 C klasė";60982723867;Taip;0;22;0;22
15054;Svaja;"1 C klasė";12226488343;Taip;0;5;0;5
15055;Svaja;"2 A klasė";9170681988;Taip;0;2;0;2
15056;Svaja;"2 A klasė";6331528628;Taip;0;2;0;2
15057;Svaja;"2 A klasė";3545160978;Taip;0;22;0;22
15058;Svaja;"2 A klasė";3812365439;Taip;0;4;0;4
15059;Svaja;"2 A klasė";4732976577;Ne;0;4;0;4
15060;Svaja;"2 A klasė";4819506647;Taip;0;7;0;7
15061;Svaja;"2 A klasė";7374204735;Taip;0;2;0;2
15062;Svaja;"2 A klasė";4147975771;Taip;0;2;0;2
15063;Svaja;"2 A klasė";5355661673;Taip;0;4;0;4
15064;Svaja;"2 A klasė";8907191675;Taip;0;2;0;2
15065;Svaja;"2 A klasė";7406969545;Ne;0;2;0;2
15066;Svaja;"2 A klasė";6182584108;Taip;0;2;0;2
15067;Svaja;"2 A klasė";6561055995;Taip;0;2;0;2
15068;Svaja;"2 A klasė";7745440861;Taip;0;2;0;2
15069;Svaja;"2 A klasė";3100769948;Taip;0;2;0;2
15070;Svaja;"2 A klasė";1932041952;Taip;0;2;0;2
15071;Svaja;"2 A klasė";2963665708;Taip;0;3;0;3
15072;Svaja;"2 A klasė";6166818062;Taip;0;3;0;3
15073;Svaja;"2 A klasė";5400447747;Taip;0;15;0;15
15074;Svaja;"2 A klasė";4677183471;Taip;0;3;0;3
15075;Svaja;"2 A klasė";3876795349;Taip;0;3;0;3
15076;Svaja;"2 A klasė";4570702330;Taip;0;13;0;13
15077;Svaja;"2 A klasė";4559408388;Taip;0;5;0;5
15078;Svaja;"2 A klasė";1851430613;Taip;0;9;0;9
15079;Svaja;"2 A klasė";6301200166;Ne;0;2;0;2
15080;Svaja;"2 B klasė";6685023540;Ne;0;3;0;3
15081;Svaja;"2 B klasė";3917545035;Taip;0;22;0;22
15082;Svaja;"2 B klasė";3154268090;Taip;0;3;0;3
15083;Svaja;"2 B klasė";9833804885;Taip;0;5;0;5
15084;Svaja;"2 B klasė";7137011094;Taip;0;3;0;3
15085;Svaja;"2 B klasė";8497722175;Taip;0;3;0;3
15086;Svaja;"2 B klasė";1949789571;Taip;0;2;0;2
15087;Svaja;"2 B klasė";5316972581;Taip;0;22;0;22
15088;Svaja;"2 B klasė";5304302886;Taip;0;2;0;2
15089;Svaja;"2 B klasė";9390649669;Ne;0;5;0;5
15090;Svaja;"2 B klasė";2543801351;Taip;0;2;0;2
15091;Svaja;"2 B klasė";2768998567;Taip;0;2;0;2
15092;Svaja;"2 B klasė";5417233257;Taip;0;2;0;2
15093;Svaja;"2 B klasė";8934053695;Ne;0;4;0;4
15094;Svaja;"2 B klasė";6888324693;Taip;0;2;0;2
15095;Svaja;"2 B klasė";9741563523;Taip;0;2;0;2
15096;Svaja;"2 B klasė";9474581791;Taip;0;3;0;3
15097;Svaja;"2 B klasė";7185891478;Ne;0;22;0;22
15098;Svaja;"2 B klasė";6949932613;Taip;0;7;0;7
15099;Svaja;"2 B klasė";9227257148;Taip;0;2;0;2
15100;Svaja;"2 B klasė";7403841330;Taip;0;5;0;5
15101;Svaja;"2 B klasė";6387070757;Taip;0;3;0;3
15102;Svaja;"2 B klasė";4859522896;Taip;0;5;0;5
15103;Svaja;"2 B klasė";7165840275;Taip;0;2;0;2
15104;Svaja;"2 B klasė";4858401763;Taip;0;5;0;5
15105;Svaja;"2 B klasė";986820082;Taip;0;6;0;6
15106;Svaja;"3 A klasė";6890796785;Taip;0;3;0;3
15107;Svaja;"3 A klasė";4321787638;Taip;0;7;0;7
15108;Svaja;"3 A klasė";8045419081;Taip;0;2;0;2
15109;Svaja;"3 A klasė";3060720122;Taip;0;3;0;3
15110;Svaja;"3 A klasė";4191652201;Taip;0;22;0;22
15111;Svaja;"3 A klasė";2408787820;Taip;0;2;0;2
15112;Svaja;"3 A klasė";2143707618;Taip;0;2;0;2
15113;Svaja;"3 A klasė";9922327181;Taip;0;2;0;2
15114;Svaja;"3 A klasė";7360643147;Taip;0;2;0;2
15115;Svaja;"3 A klasė";9431617139;Taip;0;22;0;22
15116;Svaja;"3 A klasė";5072924063;Taip;0;4;0;4
15117;Svaja;"3 A klasė";1224863574;Ne;0;3;0;3
15118;Svaja;"3 A klasė";5866029763;Ne;0;22;0;22
15119;Svaja;"3 A klasė";5224191012;Taip;0;2;0;2
15120;Svaja;"3 A klasė";2396489897;Taip;0;2;0;2
15121;Svaja;"3 A klasė";3362976996;Taip;0;4;0;4
15122;Svaja;"3 A klasė";6924433006;Taip;0;2;0;2
15123;Svaja;"3 A klasė";6379522088;Taip;0;22;0;22
15124;Svaja;"3 A klasė";6859893256;Taip;0;22;0;22
15125;Svaja;"3 A klasė";7222472406;Taip;0;1;0;1
15126;Svaja;"3 A klasė";8566329547;Ne;0;22;0;22
15127;Svaja;"3 A klasė";8014577929;Taip;0;6;0;6
15128;Svaja;"3 A klasė";5916292577;Taip;0;3;0;3
15129;Svaja;"3 B klasė";4730576902;Taip;0;4;0;4
15130;Svaja;"3 B klasė";1717017574;Taip;0;22;0;22
15131;Svaja;"3 B klasė";6738703814;Taip;0;6;0;6
15132;Svaja;"3 B klasė";9134285226;Taip;0;7;0;7
15133;Svaja;"3 B klasė";5936330139;Taip;0;2;0;2
15134;Svaja;"3 B klasė";5872552939;Taip;0;22;0;22
15135;Svaja;"3 B klasė";7732761679;Taip;0;1;0;1
15136;Svaja;"3 B klasė";9268837216;Taip;0;22;0;22
15137;Svaja;"3 B klasė";3914701993;Taip;0;7;0;7
15138;Svaja;"3 B klasė";6125002433;Taip;0;22;0;22
15139;Svaja;"3 B klasė";7318107259;Taip;0;6;0;6
15140;Svaja;"3 B klasė";3710090923;Taip;0;5;0;5
15141;Svaja;"3 B klasė";4798681160;Taip;0;3;0;3
15142;Svaja;"3 B klasė";2601042375;Taip;0;6;0;6
15143;Svaja;"2 C klasė";4022762780;Taip;0;22;0;22
15144;Svaja;"2 C klasė";5749575112;Taip;0;22;0;22
15145;Svaja;"2 C klasė";8150945946;Taip;0;22;0;22
15146;Svaja;"2 C klasė";1915009909;Taip;0;3;0;3
15147;Svaja;"2 C klasė";4310597965;Taip;0;10;0;10
15148;Svaja;"2 C klasė";8274918664;Taip;0;8;0;8
15149;Svaja;"2 C klasė";4333896021;Taip;0;3;0;3
15150;Svaja;"2 C klasė";5467666579;Taip;0;8;0;8
15151;Svaja;"2 C klasė";5453168902;Ne;0;4;0;4
15152;Svaja;"2 C klasė";1750972673;Taip;0;8;0;8
15153;Svaja;"2 C klasė";5633989310;Taip;0;7;0;7
15154;Svaja;"2 C klasė";4807854408;Taip;0;22;0;22
15155;Svaja;"2 C klasė";9653780566;Taip;0;10;0;10
15156;Svaja;"2 C klasė";8556383911;Ne;0;5;0;5
15157;Svaja;"2 C klasė";5736016717;Taip;0;22;0;22
15158;Svaja;"2 C klasė";6956015602;Taip;0;22;0;22
15159;Svaja;"2 C klasė";4196053724;Taip;0;5;0;5
15160;Svaja;"2 C klasė";6155277279;Ne;0;22;0;22
15161;Svaja;"2 C klasė";6750156163;Taip;0;6;0;6
15162;Svaja;"2 C klasė";3466700144;Taip;0;5;0;5
15163;Svaja;"2 C klasė";9961965117;Taip;0;22;0;22
15164;Svaja;"2 C klasė";4809644609;Taip;0;3;0;3
15165;Svaja;"2 C klasė";1910435736;Taip;0;9;0;9
15166;Svaja;"2 C klasė";5205253544;Taip;0;5;0;5
15167;Svaja;"2 C klasė";6958729265;Taip;0;3;0;3
15168;Vaduvos;PAGRANDUKAI;1048630061;Taip;5;10;0;15
15169;Vaduvos;PAGRANDUKAI;1431863758;Taip;6;0;0;6
15170;Vaduvos;PAGRANDUKAI;8408017356;Taip;0;6;0;6
15171;Vaduvos;PAGRANDUKAI;72724196791;Taip;15;6;0;21
15172;Vaduvos;PAGRANDUKAI;9371067563;Taip;4;2;0;6
15173;Vaduvos;PAGRANDUKAI;9987311980;Taip;0;1;0;1
15174;Vaduvos;PAGRANDUKAI;6425640531;Taip;7;0;2;9
15175;Vaduvos;PAGRANDUKAI;4029586203;Taip;5;0;0;5
15176;Vaduvos;PAGRANDUKAI;18035723255;Ne;6;0;2;8
15177;Vaduvos;PAGRANDUKAI;5954492368;Taip;0;2;0;2
15178;Vaduvos;PAGRANDUKAI;7397068779;Ne;0;3;0;3
15179;Vaduvos;PAGRANDUKAI;8875709110;Taip;0;17;0;17
15180;Vaduvos;PAGRANDUKAI;4789480822;Taip;14;0;0;14
15181;Vaduvos;PAGRANDUKAI;7305111076;Taip;0;2;2;4
15182;Vaduvos;PAGRANDUKAI;2897226343;Taip;7;0;0;7
15183;Vaduvos;PAGRANDUKAI;68848152670;Taip;6;0;1;7
15184;Vaduvos;PAGRANDUKAI;4105978403;Taip;0;6;0;6
15185;Vaduvos;PAGRANDUKAI;3111866557;Ne;17;0;3;20
15186;Vaduvos;PAGRANDUKAI;5428067167;Taip;10;2;0;12
15187;Vaduvos;PAGRANDUKAI;3699578284;Taip;18;0;0;18
15188;Vaduvos;KODĖLČIUKAI;53866301875;Ne;6;0;3;9
15189;Vaduvos;KODĖLČIUKAI;67324784528;Taip;0;2;0;2
15190;Vaduvos;KODĖLČIUKAI;78245732319;Taip;0;1;2;3
15191;Vaduvos;KODĖLČIUKAI;17473821556;Taip;0;10;3;13
15192;Vaduvos;KODĖLČIUKAI;41272273463;Taip;5;0;2;7
15193;Vaduvos;KODĖLČIUKAI;1532675814;Taip;6;0;0;6
15194;Vaduvos;KODĖLČIUKAI;61243424057;Taip;0;0;4;4
15195;Vaduvos;KODĖLČIUKAI;81605493207;Taip;0;0;1;1
15196;Vaduvos;KODĖLČIUKAI;36931517006;Taip;0;1;0;1
15197;Vaduvos;KODĖLČIUKAI;90211578805;Taip;0;6;0;6
15198;Vaduvos;KODĖLČIUKAI;30979103892;Taip;0;0;1;1
15199;Vaduvos;KODĖLČIUKAI;2019573643;Taip;9;4;0;13
15200;Vaduvos;KODĖLČIUKAI;96148085691;Taip;0;5;0;5
15201;Vaduvos;KODĖLČIUKAI;2181614424;Taip;8;3;0;11
15202;Vaduvos;KODĖLČIUKAI;97878811046;Taip;0;0;1;1
15203;Vaduvos;KODĖLČIUKAI;89793734700;Taip;0;0;1;1
15204;Vaduvos;KODĖLČIUKAI;48433447683;Taip;0;7;0;7
15205;Vaduvos;KODĖLČIUKAI;32138087379;Taip;0;3;0;3
15206;Vaduvos;SMALSUČIAI;7786986697;Taip;0;2;1;3
15207;Vaduvos;SMALSUČIAI;12330772986;Taip;0;2;0;2
15208;Vaduvos;SMALSUČIAI;25732368565;Taip;0;0;20;20
15209;Vaduvos;SMALSUČIAI;54606265707;Taip;0;1;1;2
15210;Vaduvos;SMALSUČIAI;85090873161;Taip;0;6;0;6
15211;Vaduvos;SMALSUČIAI;98259624669;Taip;0;1;0;1
15212;Vaduvos;SMALSUČIAI;8183322974;Taip;0;2;0;2
15213;Vaduvos;SMALSUČIAI;78931952732;Taip;0;5;0;5
15214;Vaduvos;SMALSUČIAI;3632802933;Ne;0;0;1;1
15215;Vaduvos;SMALSUČIAI;1107557891;Ne;8;8;0;16
15216;Vaduvos;SMALSUČIAI;4807104855;Taip;0;0;22;22
15217;Vaduvos;SMALSUČIAI;2605583220;Taip;12;0;1;13
15218;Vaduvos;SMALSUČIAI;54193761898;Taip;0;0;6;6
15219;Vaduvos;SMALSUČIAI;5307128703;Taip;6;2;1;9
15220;Vaduvos;SMALSUČIAI;1139509471;Taip;0;0;6;6
15221;Vaduvos;SMALSUČIAI;13178417729;Taip;10;4;0;14
15222;Vaduvos;SMALSUČIAI;72018210447;Taip;12;5;0;17
15223;Vaduvos;SMALSUČIAI;6121365922;Taip;0;0;1;1
15224;Vaduvos;SMALSUČIAI;62183976729;Taip;12;0;3;15
15225;Vaduvos;GILIUKAI;11202010413;Taip;0;17;0;17
15226;Vaduvos;GILIUKAI;1046867513;Ne;12;0;0;12
15227;Vaduvos;GILIUKAI;15757662594;Taip;0;4;0;4
15228;Vaduvos;GILIUKAI;41870343319;Taip;0;5;0;5
15229;Vaduvos;GILIUKAI;97007740148;Taip;0;0;7;7
15230;Vaduvos;GILIUKAI;93702732546;Taip;0;0;2;2
15231;Vaduvos;GILIUKAI;1464016847;Taip;5;0;8;13
15232;Vaduvos;GILIUKAI;2006018986;Taip;11;0;0;11
15233;Vaduvos;GILIUKAI;86095539298;Taip;0;0;3;3
15234;Vaduvos;GILIUKAI;21499108813;Taip;5;0;0;5
15235;Vaduvos;GILIUKAI;59616893535;Taip;12;0;4;16
15236;Vaduvos;GILIUKAI;61046090149;Taip;7;0;2;9
15237;Vaduvos;GILIUKAI;87008942241;Taip;6;0;0;6
15238;Vaduvos;GILIUKAI;56280470781;Taip;22;0;0;22
15239;Vaduvos;GILIUKAI;79437154441;Taip;10;0;0;10
15240;Vaduvos;GILIUKAI;68937983441;Taip;0;11;0;11
15241;Vaduvos;GILIUKAI;1703266825;Taip;5;0;1;6
15242;Vaduvos;GILIUKAI;65843855427;Taip;0;2;0;2
15243;Vaduvos;BORUŽĖLĖS;24887196729;Taip;0;7;0;7
15244;Vaduvos;BORUŽĖLĖS;16882774330;Taip;0;2;0;2
15245;Vaduvos;BORUŽĖLĖS;70693742936;Taip;5;5;0;10
15246;Vaduvos;BORUŽĖLĖS;4670249904;Taip;0;0;3;3
15247;Vaduvos;BORUŽĖLĖS;1385184350;Taip;0;0;1;1
15248;Vaduvos;BORUŽĖLĖS;68420568339;Taip;1;0;1;2
15249;Vaduvos;BORUŽĖLĖS;96803174459;Taip;0;3;0;3
15250;Vaduvos;BORUŽĖLĖS;47465933557;Taip;0;8;0;8
15251;Vaduvos;BORUŽĖLĖS;16006064074;Taip;0;0;1;1
15252;Vaduvos;BORUŽĖLĖS;55138588393;Taip;0;3;0;3
15253;Vaduvos;BORUŽĖLĖS;3172047211;Taip;0;0;2;2
15254;Vaduvos;BORUŽĖLĖS;62521006557;Taip;5;0;7;12
15255;Vaduvos;BORUŽĖLĖS;93924290247;Taip;0;5;4;9
15256;Vaduvos;BORUŽĖLĖS;29983824202;Taip;0;0;4;4
15257;Vaduvos;BORUŽĖLĖS;61243200177;Taip;0;1;0;1
15258;Vaduvos;BORUŽĖLĖS;95104294893;Taip;0;0;11;11
15259;Vaduvos;BORUŽĖLĖS;6155494370;Ne;0;11;0;11
15260;Vaduvos;BORUŽĖLĖS;97423576166;Taip;0;6;0;6
15261;Vaduvos;BORUŽĖLĖS;94906586734;Taip;5;2;0;7
15262;Vaduvos;DRUGELIAI;39687066893;Ne;6;0;2;8
15263;Vaduvos;DRUGELIAI;6192828320;Taip;11;1;0;12
15264;Vaduvos;DRUGELIAI;87671358423;Taip;5;0;0;5
15265;Vaduvos;DRUGELIAI;40872193458;Taip;8;0;0;8
15266;Vaduvos;DRUGELIAI;76644896831;Taip;12;4;0;16
15267;Vaduvos;DRUGELIAI;1241148402;Taip;0;0;2;2
15268;Vaduvos;DRUGELIAI;93406851755;Taip;10;0;0;10
15269;Vaduvos;DRUGELIAI;14297366745;Taip;0;9;0;9
15270;Vaduvos;DRUGELIAI;13888236429;Taip;0;0;7;7
15271;Vaduvos;DRUGELIAI;13203715320;Taip;0;10;0;10
15272;Vaduvos;DRUGELIAI;64074141491;Taip;0;11;5;16
15273;Vaduvos;DRUGELIAI;66359913774;Taip;5;5;0;10
15274;Vaduvos;DRUGELIAI;49738318631;Taip;0;1;0;1
15275;Vaduvos;DRUGELIAI;3174998523;Taip;5;0;0;5
15276;Vaduvos;DRUGELIAI;96892752634;Taip;6;0;0;6
15277;Vaduvos;DRUGELIAI;8802765960;Taip;0;5;1;6
15278;Vaduvos;RIEŠUTĖLIAI;9429028460;Taip;22;0;0;22
15279;Vaduvos;RIEŠUTĖLIAI;9072097216;Taip;0;5;3;8
15280;Vaduvos;RIEŠUTĖLIAI;9178907705;Taip;22;0;0;22
15281;Vaduvos;RIEŠUTĖLIAI;6210729584;Taip;0;8;0;8
15282;Vaduvos;RIEŠUTĖLIAI;9606193112;Taip;12;0;0;12
15283;Vaduvos;RIEŠUTĖLIAI;9540008495;Taip;9;0;1;10
15284;Vaduvos;RIEŠUTĖLIAI;4177935331;Taip;8;0;1;9
15285;Vaduvos;RIEŠUTĖLIAI;9983148737;Taip;5;2;0;7
15286;Vaduvos;RIEŠUTĖLIAI;9062135043;Taip;6;5;0;11
15287;Vaduvos;RIEŠUTĖLIAI;1422507884;Taip;8;0;0;8
15288;Vaduvos;RIEŠUTĖLIAI;6810198013;Taip;0;0;3;3
15289;Vaduvos;RIEŠUTĖLIAI;2417613291;Taip;12;0;0;12
15290;Vaduvos;RIEŠUTĖLIAI;4270137614;Taip;0;1;0;1
15291;Vaduvos;RIEŠUTĖLIAI;3682708061;Taip;0;3;0;3
15292;Vaduvos;RIEŠUTĖLIAI;7181151562;Taip;7;10;0;17
15293;Vaduvos;RIEŠUTĖLIAI;3641822841;Taip;12;0;1;13
15294;Vaduvos;"1 klasė";96473212525;Taip;0;1;0;1
15295;Vaduvos;"1 klasė";35999855339;Taip;0;22;0;22
15296;Vaduvos;"1 klasė";62612515593;Taip;0;22;0;22
15297;Vaduvos;"1 klasė";61830127618;Taip;0;1;0;1
15298;Vaduvos;"1 klasė";4591744662;Taip;0;22;0;22
15299;Vaduvos;"1 klasė";9149523910;Taip;0;22;0;22
15300;Vaduvos;"1 klasė";76662161382;Taip;0;3;0;3
15301;Vaduvos;"1 klasė";18300713872;Taip;0;22;0;22
15302;Vaduvos;"1 klasė";1768173501;Taip;0;7;0;7
15303;Vaduvos;"1 klasė";768455288;Ne;0;22;0;22
15304;Vaduvos;"1 klasė";38462664426;Ne;0;4;0;4
15305;Vaduvos;"1 klasė";63286903462;Taip;0;1;0;1
15306;Vaduvos;"1 klasė";20841176336;Taip;0;22;0;22
15307;Vaduvos;"1 klasė";6049882391;Ne;0;5;0;5
15308;Vaduvos;"1 klasė";38013859931;Taip;0;2;0;2
15309;Vaduvos;"1 klasė";1821644443;Ne;0;3;0;3
15310;Vaduvos;"1 klasė";26934740147;Taip;0;22;0;22
15311;Vaduvos;"1 klasė";7172286009;Taip;0;4;0;4
15312;Vaduvos;"1 klasė";2029363844;Taip;0;22;0;22
15313;Vaduvos;"1 klasė";8188624118;Ne;0;22;0;22
15314;Vaduvos;"2 klasė";8594896510;Taip;0;1;0;1
15315;Vaduvos;"2 klasė";8009941823;Taip;0;1;0;1
15316;Vaduvos;"2 klasė";1060727236;Taip;0;1;0;1
15317;Vaduvos;"2 klasė";2423925079;Taip;0;22;0;22
15318;Vaduvos;"2 klasė";7410760461;Taip;0;22;0;22
15319;Vaduvos;"2 klasė";6487033699;Taip;0;2;0;2
15320;Vaduvos;"2 klasė";1671409152;Taip;0;1;0;1
15321;Vaduvos;"2 klasė";5072769647;Taip;0;1;0;1
15322;Vaduvos;"2 klasė";4637670260;Taip;0;3;0;3
15323;Vaduvos;"2 klasė";7236550835;Taip;0;1;0;1
15324;Vaduvos;"2 klasė";9372936408;Taip;0;1;0;1
15325;Vaduvos;"2 klasė";7243175751;Taip;0;1;0;1
15326;Vaduvos;"2 klasė";2482212122;Taip;0;1;0;1
15327;Vaduvos;"2 klasė";1982860223;Taip;0;1;0;1
15328;Vaduvos;"2 klasė";4447152355;Taip;0;1;0;1
15329;Vaduvos;"2 klasė";2584358725;Taip;0;22;0;22
15330;Vaduvos;"2 klasė";3325229112;Taip;0;1;0;1
15331;Vaduvos;"2 klasė";5531150399;Taip;0;22;0;22
15332;Vaduvos;"2 klasė";6980440631;Taip;0;15;0;15
15333;Vaduvos;"2 klasė";1091221509;Taip;0;2;0;2
15334;Vaduvos;"2 klasė";7614692200;Taip;0;6;0;6
15335;Vaduvos;"2 klasė";8216757208;Taip;0;22;0;22
15336;Vaduvos;"2 klasė";5459268700;Taip;0;22;0;22
15337;Vaduvos;"2 klasė";5593756016;Taip;0;3;0;3
15338;Vaduvos;"2 klasė";1642242442;Taip;0;2;0;2
15339;Vaduvos;"2 klasė";8928517238;Taip;0;2;0;2
15340;Vaduvos;"2 klasė";5099560123;Taip;0;7;0;7
15341;Vaduvos;"2 klasė";7899239147;Taip;0;2;0;2
15342;Vaduvos;"3 klasė";7719637673;Taip;0;5;0;5
15343;Vaduvos;"3 klasė";3784730324;Taip;0;1;0;1
15344;Vaduvos;"3 klasė";1841919654;Taip;0;2;0;2
15345;Vaduvos;"3 klasė";1086186628;Taip;0;1;0;1
15346;Vaduvos;"3 klasė";7838224919;Ne;0;1;0;1
15347;Vaduvos;"3 klasė";9494193819;Taip;0;22;0;22
15348;Vaduvos;"3 klasė";3755145838;Taip;0;22;0;22
15349;Vaduvos;"3 klasė";2149582337;Taip;0;1;0;1
15350;Vaduvos;"3 klasė";6896561963;Taip;0;5;0;5
15351;Vaduvos;"3 klasė";6748405557;Taip;0;1;0;1
15352;Vaduvos;"3 klasė";5523290081;Taip;0;1;0;1
15353;Vaduvos;"3 klasė";5786723345;Ne;0;1;0;1
15354;Vaduvos;"3 klasė";1461738157;Taip;0;2;0;2
15355;Vaduvos;"3 klasė";7786044620;Taip;0;22;0;22
15356;Vaduvos;"3 klasė";1954540001;Taip;0;13;0;13
15357;Vaduvos;"3 klasė";9271050464;Taip;0;4;0;4
15358;Vaduvos;"4 klasė";6654601642;Taip;0;9;0;9
15359;Vaduvos;"4 klasė";8237000050;Taip;0;8;0;8
15360;Vaduvos;"4 klasė";3145407318;Ne;0;4;0;4
15361;Vaduvos;"4 klasė";3333293097;Taip;0;2;0;2
15362;Vaduvos;"4 klasė";5309061557;Taip;0;2;0;2
15363;Vaduvos;"4 klasė";9693003688;Taip;0;22;0;22
15364;Vaduvos;"4 klasė";6371618427;Taip;0;7;0;7
15365;Vaduvos;"4 klasė";4965870077;Taip;0;22;0;22
15366;Vaduvos;"4 klasė";3290259977;Taip;0;2;0;2
15367;Vaduvos;"4 klasė";7585921384;Taip;0;3;0;3
15368;Vaduvos;"4 klasė";8971158534;Taip;0;2;0;2
15369;Vaduvos;"4 klasė";4629364623;Taip;0;2;0;2
15370;Vaduvos;"4 klasė";4106358850;Taip;0;2;0;2
15371;Vaduvos;"4 klasė";7163757633;Taip;0;12;0;12
15372;Vaduvos;"4 klasė";3710305066;Taip;0;2;0;2
15373;Vaduvos;"4 klasė";8401121977;Taip;0;3;0;3
15374;Vaduvos;"4 klasė";1682529973;Ne;0;22;0;22
15375;Vaduvos;"4 klasė";5094558878;Taip;0;2;0;2
15376;Vaduvos;"4 klasė";1741464526;Taip;0;2;0;2
15377;Vaduvos;"4 klasė";3868511136;Taip;0;2;0;2
15378;Vaduvos;"4 klasė";9224232442;Taip;0;5;0;5
15379;Vaduvos;"4 klasė";6583877755;Taip;0;22;0;22
15380;Vilkpėdės;BORUŽĖLĖS;79390794424;Taip;2;1;0;3
15381;Vilkpėdės;BORUŽĖLĖS;61899409496;Ne;5;1;0;6
15382;Vilkpėdės;BORUŽĖLĖS;34554036711;Ne;1;5;0;6
15383;Vilkpėdės;BORUŽĖLĖS;64276583853;Taip;0;7;0;7
15384;Vilkpėdės;BORUŽĖLĖS;93369779426;Taip;10;0;0;10
15385;Vilkpėdės;BORUŽĖLĖS;18177210107;Taip;6;1;0;7
15386;Vilkpėdės;BORUŽĖLĖS;94327243660;Taip;5;3;0;8
15387;Vilkpėdės;BORUŽĖLĖS;25560685550;Taip;5;0;0;5
15388;Vilkpėdės;BORUŽĖLĖS;72601980553;Taip;5;0;0;5
15389;Vilkpėdės;BORUŽĖLĖS;18795042529;Taip;13;0;0;13
15390;Vilkpėdės;BORUŽĖLĖS;1222650684;Taip;0;1;0;1
15391;Vilkpėdės;BORUŽĖLĖS;77110534762;Taip;0;1;0;1
15392;Vilkpėdės;BORUŽĖLĖS;18926013798;Taip;5;4;0;9
15393;Vilkpėdės;BORUŽĖLĖS;96241777448;Ne;5;1;0;6
15394;Vilkpėdės;BORUŽĖLĖS;40831777471;Taip;6;0;0;6
15395;Vilkpėdės;BORUŽĖLĖS;73735463059;Taip;0;8;0;8
15396;Vilkpėdės;BORUŽĖLĖS;12155790021;Taip;0;2;0;2
15397;Vilkpėdės;SKRUZDĖLIUKAI;32683398503;Taip;0;1;0;1
15398;Vilkpėdės;SKRUZDĖLIUKAI;41394645789;Taip;0;2;0;2
15399;Vilkpėdės;SKRUZDĖLIUKAI;61457409195;Ne;6;3;0;9
15400;Vilkpėdės;SKRUZDĖLIUKAI;90226911248;Taip;0;8;0;8
15401;Vilkpėdės;SKRUZDĖLIUKAI;73812058890;Taip;0;4;0;4
15402;Vilkpėdės;SKRUZDĖLIUKAI;18860888473;Taip;5;0;0;5
15403;Vilkpėdės;SKRUZDĖLIUKAI;19719432462;Taip;0;6;0;6
15404;Vilkpėdės;SKRUZDĖLIUKAI;70184817311;Taip;1;6;0;7
15405;Vilkpėdės;SKRUZDĖLIUKAI;93775558547;Taip;5;2;2;9
15406;Vilkpėdės;SKRUZDĖLIUKAI;90816091771;Taip;0;11;0;11
15407;Vilkpėdės;SKRUZDĖLIUKAI;26983231264;Taip;17;0;0;17
15408;Vilkpėdės;SKRUZDĖLIUKAI;89124218945;Taip;0;1;0;1
15409;Vilkpėdės;SKRUZDĖLIUKAI;21841574426;Taip;0;9;0;9
15410;Vilkpėdės;SKRUZDĖLIUKAI;89601406730;Taip;0;2;0;2
15411;Vilkpėdės;SKRUZDĖLIUKAI;60687258266;Taip;9;3;0;12
15412;Vilkpėdės;SKRUZDĖLIUKAI;95408044297;Taip;3;0;0;3
15413;Vilkpėdės;SKRUZDĖLIUKAI;63180329851;Ne;5;2;0;7
15414;Vilkpėdės;SKRUZDĖLIUKAI;3001209213;Taip;15;2;0;17
15415;Vilkpėdės;SKRUZDĖLIUKAI;95615604947;Taip;0;1;0;1
15416;Vilkpėdės;SKRUZDĖLIUKAI;25846393751;Taip;5;0;0;5
15417;Vilkpėdės;SKRUZDĖLIUKAI;33842357499;Taip;10;0;0;10
15418;Vilkpėdės;"1 klasė";45308906788;Taip;0;0;1;1
15419;Vilkpėdės;"1 klasė";31260025568;Taip;0;0;11;11
15420;Vilkpėdės;DRUGELIAI;2420271759;Taip;0;5;0;5
15421;Vilkpėdės;DRUGELIAI;9294350205;Taip;9;0;0;9
15422;Vilkpėdės;DRUGELIAI;2377248778;Taip;0;9;0;9
15423;Vilkpėdės;DRUGELIAI;3351309750;Taip;9;0;1;10
15424;Vilkpėdės;DRUGELIAI;1019057127;Taip;5;0;0;5
15425;Vilkpėdės;DRUGELIAI;1807884737;Taip;18;0;0;18
15426;Vilkpėdės;DRUGELIAI;9894466439;Taip;2;0;0;2
15427;Vilkpėdės;DRUGELIAI;6816745585;Taip;5;0;0;5
15428;Vilkpėdės;DRUGELIAI;9460356725;Taip;13;0;0;13
15429;Vilkpėdės;DRUGELIAI;8015392054;Taip;4;0;0;4
15430;Vilkpėdės;DRUGELIAI;8693750994;Ne;14;0;0;14
15431;Vilkpėdės;DRUGELIAI;2320350937;Taip;8;2;0;10
15432;Vilkpėdės;DRUGELIAI;7795186132;Taip;4;2;0;6
15433;Vilkpėdės;DRUGELIAI;6762306583;Taip;5;17;0;22
15434;Vilkpėdės;DRUGELIAI;9795696242;Taip;0;1;0;1
15435;Vilkpėdės;DRUGELIAI;8581661608;Taip;6;0;0;6
15436;Vilkpėdės;DRUGELIAI;6261547304;Taip;6;0;0;6
15437;Vilkpėdės;ŽIOGELIAI;2065010940;Taip;0;8;0;8
15438;Vilkpėdės;ŽIOGELIAI;1137529145;Taip;0;0;1;1
15439;Vilkpėdės;ŽIOGELIAI;13241568469;Taip;15;0;0;15
15440;Vilkpėdės;ŽIOGELIAI;1052719398;Taip;0;3;0;3
15441;Vilkpėdės;ŽIOGELIAI;1145968615;Taip;10;0;0;10
15442;Vilkpėdės;ŽIOGELIAI;1598018406;Taip;0;1;0;1
15443;Vilkpėdės;ŽIOGELIAI;1136036746;Taip;0;12;0;12
15444;Vilkpėdės;ŽIOGELIAI;51976067616;Taip;0;10;0;10
15445;Vilkpėdės;ŽIOGELIAI;73470824566;Ne;0;5;2;7
15446;Vilkpėdės;ŽIOGELIAI;1795879331;Taip;0;1;1;2
15447;Vilkpėdės;ŽIOGELIAI;2000428715;Taip;2;0;0;2
15448;Vilkpėdės;ŽIOGELIAI;72899151328;Taip;0;1;0;1
15449;Vilkpėdės;ŽIOGELIAI;1527272055;Ne;0;1;0;1
15450;Vilkpėdės;ŽIOGELIAI;25008201566;Taip;0;10;2;12
15451;Vilkpėdės;BITUTĖS;7875898177;Taip;4;1;0;5
15452;Vilkpėdės;BITUTĖS;3935245964;Taip;0;1;0;1
15453;Vilkpėdės;BITUTĖS;9867411687;Taip;10;7;0;17
15454;Vilkpėdės;BITUTĖS;4735164204;Taip;5;0;0;5
15455;Vilkpėdės;BITUTĖS;46561435465;Taip;0;13;0;13
15456;Vilkpėdės;BITUTĖS;48059844727;Taip;0;7;0;7
15457;Vilkpėdės;BITUTĖS;1195392132;Ne;0;0;2;2
15458;Vilkpėdės;BITUTĖS;7634355147;Taip;5;0;0;5
15459;Vilkpėdės;BITUTĖS;4392760215;Ne;0;7;0;7
15460;Vilkpėdės;BITUTĖS;2955411131;Taip;0;2;5;7
15461;Vilkpėdės;BITUTĖS;2736368118;Taip;0;11;0;11
15462;Vilkpėdės;BITUTĖS;4515945951;Taip;2;0;2;4
15463;Vilkpėdės;BITUTĖS;2900581406;Taip;4;1;0;5
15464;Vilkpėdės;BITUTĖS;8865545376;Ne;0;8;0;8
15465;Vilkpėdės;BITUTĖS;4276158771;Taip;0;3;0;3
15466;Vilkpėdės;BITUTĖS;7889480219;Ne;0;10;0;10
15467;Vilkpėdės;BITUTĖS;8128254701;Taip;3;0;2;5
15468;Vilkpėdės;"2 klasė";4562930821;Ne;5;3;0;8
15469;Vilkpėdės;"2 klasė";4450490805;Ne;4;0;0;4
15470;Vilkpėdės;"2 klasė";5753361387;Ne;0;2;0;2
15471;Vilkpėdės;"2 klasė";7678586010;Ne;11;0;0;11
15472;Vilkpėdės;"2 klasė";7567054902;Ne;5;1;0;6
15473;Vilkpėdės;"2 klasė";1894949069;Ne;2;1;0;3
15474;Vilkpėdės;"2 klasė";6750171948;Ne;0;8;0;8
15475;Vilkpėdės;"2 klasė";2877690064;Ne;4;0;0;4
15476;Vilkpėdės;"2 klasė";4975532783;Ne;0;2;0;2
15477;Vilkpėdės;"2 klasė";3096541013;Ne;5;0;0;5
15478;Vilkpėdės;"2 klasė";6334059519;Ne;5;0;0;5
15479;Vilkpėdės;"3 klasė";1827316635;Ne;7;0;0;7
15480;Vilkpėdės;"3 klasė";5788552120;Ne;3;0;0;3
15481;Vilkpėdės;"3 klasė";3008839195;Ne;1;0;0;1
15482;Vilkpėdės;"3 klasė";2097704371;Ne;13;0;0;13
15483;Vilkpėdės;"3 klasė";5948799757;Ne;2;0;0;2
15484;Vilkpėdės;"3 klasė";7851213782;Ne;1;0;0;1
15485;Vilkpėdės;"3 klasė";6408620430;Ne;1;0;0;1
15486;Vilkpėdės;"3 klasė";6786266832;Ne;1;0;0;1
15487;Vilkpėdės;"4 klasė";5691976624;Ne;0;7;0;7
15488;Vilkpėdės;"4 klasė";5064616447;Ne;1;1;0;2
15489;Vilkpėdės;"4 klasė";5959800100;Ne;0;1;0;1
15490;Vilkpėdės;"4 klasė";9264492438;Ne;0;6;0;6
15491;Vilkpėdės;"4 klasė";4656816734;Ne;6;1;0;7
15492;Vilkpėdės;"4 klasė";3688858757;Ne;0;1;0;1
15493;Vilkpėdės;"4 klasė";5115595730;Ne;1;6;0;7
15494;Vilkpėdės;"4 klasė";5877781210;Ne;0;1;0;1
15495;Vilkpėdės;"4 klasė";6917717899;Ne;5;1;0;6
15496;Vilkpėdės;"4 klasė";4672603333;Ne;1;7;0;8
15497;Vilkpėdės;"4 klasė";9436443664;Ne;5;1;0;6
15498;Vilkpėdės;"4 klasė";5522788819;Ne;0;3;0;3
15499;Vilkpėdės;"4 klasė";1115530668;Ne;0;2;0;2
15500;Žiburėlis;Nykštukai;32837087738;Taip;0;2;0;2
15501;Žiburėlis;Nykštukai;57892276898;Taip;5;2;3;10
15502;Žiburėlis;Nykštukai;87417486808;Taip;0;1;9;10
15503;Žiburėlis;Nykštukai;82679341920;Taip;0;1;0;1
15504;Žiburėlis;Nykštukai;73054546792;Taip;0;14;0;14
15505;Žiburėlis;Nykštukai;98670272543;Taip;0;12;0;12
15506;Žiburėlis;Nykštukai;64418469679;Taip;0;7;0;7
15507;Žiburėlis;Nykštukai;61148040564;Taip;0;4;2;6
15508;Žiburėlis;Nykštukai;77674964341;Taip;0;12;0;12
15509;Žiburėlis;Nykštukai;16215414453;Taip;0;1;1;2
15510;Žiburėlis;Nykštukai;16721946185;Taip;0;5;0;5
15511;Žiburėlis;Nykštukai;58253869146;Taip;0;12;0;12
15512;Žiburėlis;Nykštukai;49081936325;Taip;0;11;0;11
15513;Žiburėlis;Nykštukai;25826760783;Taip;5;5;0;10
15514;Žiburėlis;Nykštukai;78861342608;Ne;0;1;0;1
15515;Žiburėlis;Nykštukai;50484332477;Taip;0;2;0;2
15516;Žiburėlis;Nykštukai;90296810303;Taip;4;0;0;4
15517;Žiburėlis;Nykštukai;13256396372;Taip;11;0;0;11
15518;Žiburėlis;Nykštukai;78896331135;Taip;0;1;0;1
15519;Žiburėlis;Nykštukai;68423991252;Taip;0;5;0;5
15520;Žiburėlis;Nykštukai;1133294157;Taip;12;1;0;13
15521;Žiburėlis;Nykštukai;25079486133;Taip;0;6;0;6
15522;Žiburėlis;Nykštukai;9918037209;Taip;0;4;0;4
15523;Žiburėlis;"Žiniukai ";18125169377;Taip;0;1;0;1
15524;Žiburėlis;"Žiniukai ";29552486526;Taip;0;22;0;22
15525;Žiburėlis;"Žiniukai ";70925677727;Taip;0;19;0;19
15526;Žiburėlis;"Žiniukai ";1858285649;Taip;5;1;0;6
15527;Žiburėlis;"Žiniukai ";41774939326;Taip;4;1;0;5
15528;Žiburėlis;"Žiniukai ";1673061718;Taip;7;1;0;8
15529;Žiburėlis;"Žiniukai ";6517292491;Taip;0;19;0;19
15530;Žiburėlis;"Žiniukai ";70987307796;Taip;7;4;2;13
15531;Žiburėlis;"Žiniukai ";5778346952;Taip;0;1;0;1
15532;Žiburėlis;"Žiniukai ";74200469110;Ne;0;4;0;4
15533;Žiburėlis;"Žiniukai ";1770523114;Ne;0;1;0;1
15534;Žiburėlis;"Žiniukai ";90967310390;Taip;2;2;0;4
15535;Žiburėlis;"Žiniukai ";19010380383;Taip;0;1;0;1
15536;Žiburėlis;"Smalsiukai ";5914668910;Ne;0;4;0;4
15537;Žiburėlis;"Smalsiukai ";1673873271;Taip;17;0;0;17
15538;Žiburėlis;"Smalsiukai ";3128936681;Taip;12;0;0;12
15539;Žiburėlis;"Smalsiukai ";31082738591;Ne;0;2;0;2
15540;Žiburėlis;"Smalsiukai ";78850854161;Taip;0;1;0;1
15541;Žiburėlis;"Smalsiukai ";95216886081;Taip;0;5;0;5
15542;Žiburėlis;"Smalsiukai ";37375035477;Taip;0;2;0;2
15543;Žiburėlis;"Smalsiukai ";69181720507;Taip;0;4;1;5
15544;Žiburėlis;"Smalsiukai ";54487369856;Taip;0;1;0;1
15545;Žiburėlis;"Smalsiukai ";81892440397;Taip;0;4;0;4
15546;Žiburėlis;"Smalsiukai ";89219215887;Taip;0;4;0;4
15547;Žiburėlis;"Smalsiukai ";1483522393;Taip;0;1;0;1
15548;Žiburėlis;"Smalsiukai ";93584914250;Taip;5;1;0;6
15549;Žiburėlis;"Smalsiukai ";58094756644;Taip;4;0;0;4
15550;Žiburėlis;"Giliukai ";52216192635;Taip;5;2;0;7
15551;Žiburėlis;"Giliukai ";4355778076;Taip;6;0;1;7
15552;Žiburėlis;"Giliukai ";92490398630;Taip;0;2;1;3
15553;Žiburėlis;"Giliukai ";67168630669;Taip;2;5;0;7
15554;Žiburėlis;"Giliukai ";3867540155;Taip;1;0;0;1
15555;Žiburėlis;"Giliukai ";75538036055;Taip;1;3;0;4
15556;Žiburėlis;"Giliukai ";2796489509;Taip;5;0;0;5
15557;Žiburėlis;"Giliukai ";18739941845;Taip;1;2;0;3
15558;Žiburėlis;"Giliukai ";24639355056;Taip;0;11;0;11
15559;Žiburėlis;"Giliukai ";6519139977;Taip;0;11;0;11
15560;Žiburėlis;"Giliukai ";7861704875;Taip;4;2;0;6
15561;Žiburėlis;"Giliukai ";34873231652;Taip;4;3;0;7
15562;Žiburėlis;"Giliukai ";1125662904;Taip;11;0;0;11
15563;Žiburėlis;"Giliukai ";2175751377;Taip;5;0;0;5
15564;Žiburėlis;"Giliukai ";28985997205;Taip;2;0;0;2
15565;Žiburėlis;"1 klasė";9177048702;Taip;0;22;0;22
15566;Žiburėlis;"1 klasė";91489560481;Taip;21;0;0;21
15567;Žiburėlis;"1 klasė";29289711001;Ne;0;22;0;22
15568;Žiburėlis;"1 klasė";67880120356;Taip;2;0;0;2
15569;Žiburėlis;"1 klasė";56929631997;Taip;17;0;0;17
15570;Žiburėlis;"1 klasė";91397954329;Taip;6;0;0;6
15571;Žiburėlis;"1 klasė";3462265950;Taip;0;22;0;22
15572;Žiburėlis;Meškiukai;7070952018;Taip;0;1;0;1
15573;Žiburėlis;Meškiukai;96004573835;Taip;0;1;0;1
15574;Žiburėlis;Meškiukai;549348368;Taip;0;7;0;7
15575;Žiburėlis;Meškiukai;2270893326;Taip;0;4;0;4
15576;Žiburėlis;Meškiukai;1523632106;Taip;5;0;0;5
15577;Žiburėlis;Meškiukai;9069606713;Taip;0;13;0;13
15578;Žiburėlis;Meškiukai;57749440744;Taip;17;0;0;17
15579;Žiburėlis;Meškiukai;1614403409;Taip;0;1;0;1
15580;Žiburėlis;Meškiukai;808556747;Taip;0;19;0;19
15581;Žiburėlis;Meškiukai;43206636255;Taip;0;3;0;3
15582;Žiburėlis;Meškiukai;50869669391;Taip;0;1;0;1
15583;Žiburėlis;Meškiukai;31669188580;Taip;2;2;0;4
15584;Žiburėlis;Meškiukai;5495813195;Taip;10;1;0;11
15585;Žiburėlis;Viščiukai;7402647048;Taip;20;0;0;20
15586;Žiburėlis;Viščiukai;8215816053;Ne;17;0;0;17
15587;Žiburėlis;Viščiukai;9352485231;Taip;9;0;0;9
15588;Žiburėlis;Viščiukai;4710995351;Taip;5;0;0;5
15589;Žiburėlis;Viščiukai;3646988912;Taip;20;0;0;20
15590;Žiburėlis;Viščiukai;7633450988;Taip;2;0;0;2
15591;Žiburėlis;Viščiukai;2292895729;Taip;4;13;0;17
15592;Žiburėlis;Viščiukai;5098955523;Taip;22;0;0;22
15593;Žiburėlis;Viščiukai;6250610187;Taip;0;9;0;9
15594;Žiburėlis;Viščiukai;5629404179;Taip;17;0;0;17
15595;Žiburėlis;Viščiukai;8686565770;Taip;2;2;0;4
15596;Žiburėlis;Viščiukai;3938379566;Taip;0;12;0;12
15597;Žiburėlis;Viščiukai;5556807335;Taip;17;0;0;17
15598;Žiburėlis;"Drambliukai ";8902837168;Taip;0;1;0;1
15599;Žiburėlis;"Drambliukai ";7862546963;Taip;0;1;0;1
15600;Žiburėlis;"Drambliukai ";8535429783;Taip;0;7;0;7
15601;Žiburėlis;"Drambliukai ";9670396828;Taip;22;0;0;22
15602;Žiburėlis;"Drambliukai ";1720078356;Taip;0;6;0;6
15603;Žiburėlis;"Drambliukai ";5517458323;Taip;8;0;0;8
15604;Žiburėlis;"Drambliukai ";2982016133;Taip;0;2;0;2
15605;Žiburėlis;"Drambliukai ";7424129974;Taip;0;10;0;10
15606;Žiburėlis;"Drambliukai ";5816890413;Taip;21;0;0;21
15607;Žiburėlis;"Drambliukai ";2928528630;Taip;9;4;0;13
15608;Žiburėlis;"Drambliukai ";8109335587;Taip;0;1;0;1
15609;Žiburėlis;"Drambliukai ";4187381976;Taip;2;2;0;4
15610;Žiburėlis;"Drambliukai ";2624326930;Taip;10;2;0;12
15611;Žiburėlis;"Drambliukai ";6300247811;Taip;0;6;0;6
15612;Žiburėlis;"Drambliukai ";3033049328;Taip;0;1;0;1
15613;Žiburėlis;"Drambliukai ";3687703187;Taip;0;6;0;6
15614;Žiburėlis;"Drambliukai ";1876645582;Taip;5;0;0;5
15615;Žiburėlis;"Drambliukai ";5006361324;Taip;0;2;0;2
15616;Žiburėlis;"Drambliukai ";5303511810;Taip;0;10;0;10
15617;Žiburėlis;"Drambliukai ";3262856058;Ne;12;0;0;12
15618;Žiburėlis;"Drambliukai ";7211961512;Ne;0;1;0;1
15619;Žiburėlis;"2 klasė";5587135070;Ne;3;0;0;3
15620;Žiburėlis;"2 klasė";9444201589;Ne;5;0;0;5
15621;Žiburėlis;"2 klasė";7328501055;Ne;2;0;0;2
15622;Žiburėlis;"2 klasė";6532799193;Ne;4;0;0;4
15623;Žiburėlis;"2 klasė";8108287017;Ne;0;22;0;22
15624;Žiburėlis;"2 klasė";8967516850;Ne;4;0;0;4
15625;Žiburėlis;"2 klasė";5730454385;Ne;3;0;0;3
15626;Žiburėlis;"2 klasė";9030168070;Ne;3;0;0;3
15627;Žiburėlis;"2 klasė";2895056046;Ne;8;0;0;8
15628;Žiburėlis;"2 klasė";7971654401;Ne;0;22;0;22
15629;Žiburėlis;"2 klasė";7244452816;Ne;4;0;0;4
15630;Žiburėlis;"2 klasė";5120367724;Ne;3;0;0;3
15631;Žiburėlis;"3 klasė";2145461317;Ne;1;0;0;1
15632;Žiburėlis;"3 klasė";8942909201;Ne;6;0;0;6
15633;Žiburėlis;"3 klasė";6088424692;Ne;0;22;0;22
15634;Žiburėlis;"3 klasė";3493549126;Ne;0;22;0;22
15635;Žiburėlis;"3 klasė";8755335337;Ne;0;22;0;22
15636;Žiburėlis;"3 klasė";7451312098;Ne;1;0;0;1
15637;Žiburėlis;"3 klasė";5999075406;Ne;0;22;0;22
15638;Žiburėlis;"3 klasė";9803636658;Ne;0;22;0;22
15639;Žiburėlis;"3 klasė";6992801094;Ne;5;0;0;5
15640;Žiburėlis;"3 klasė";3931688013;Ne;0;22;0;22
15641;Žiburėlis;"4 klasė";8525158050;Ne;5;0;0;5
15642;Žiburėlis;"4 klasė";6800376566;Ne;0;0;1;1
15643;Žiburėlis;"4 klasė";6362934592;Ne;0;22;0;22
15644;Žiburėlis;"4 klasė";8758526732;Ne;0;22;0;22
15645;Žiburėlis;"4 klasė";2638686151;Ne;13;0;0;13
15646;Žiburėlis;"4 klasė";4067505776;Ne;2;0;0;2
15647;Žiburėlis;"4 klasė";6388681440;Ne;3;0;0;3
15648;Žiburėlis;"4 klasė";5014047026;Ne;0;0;1;1
15649;Žiburėlis;"4 klasė";4827287214;Ne;0;0;1;1
15650;Žiburėlis;"4 klasė";2354284014;Ne;0;22;0;22
15651;Justinukas;SMALSUČIŲ;7005815238;Taip;22;0;0;22
15652;Justinukas;SMALSUČIŲ;13170636069;Taip;0;2;0;2
15653;Justinukas;SMALSUČIŲ;3312575449;Ne;0;2;0;2
15654;Justinukas;SMALSUČIŲ;1773690115;Taip;17;0;3;20
15655;Justinukas;SMALSUČIŲ;46705419124;Taip;0;3;0;3
15656;Justinukas;SMALSUČIŲ;49343952061;Ne;0;5;0;5
15657;Justinukas;SMALSUČIŲ;8741735734;Taip;15;0;1;16
15658;Justinukas;SMALSUČIŲ;2160609412;Ne;0;1;0;1
15659;Justinukas;SMALSUČIŲ;8529082669;Taip;0;8;0;8
15660;Justinukas;SMALSUČIŲ;7678062264;Taip;10;1;0;11
15661;Justinukas;SMALSUČIŲ;1830060403;Taip;5;5;0;10
15662;Justinukas;SMALSUČIŲ;6597383913;Taip;0;6;1;7
15663;Justinukas;SMALSUČIŲ;67366895767;Taip;0;6;0;6
15664;Justinukas;SMALSUČIŲ;9349373645;Ne;5;7;0;12
15665;Justinukas;SMALSUČIŲ;8848775795;Taip;4;1;0;5
15666;Justinukas;SMALSUČIŲ;93600065957;Taip;16;0;0;16
15667;Justinukas;SMALSUČIŲ;2317566323;Taip;8;7;0;15
15668;Justinukas;SMALSUČIŲ;1704933971;Taip;0;0;2;2
15669;Justinukas;SVAJOKLIŲ;9822696769;Taip;0;9;0;9
15670;Justinukas;SVAJOKLIŲ;34905919221;Taip;2;1;0;3
15671;Justinukas;SVAJOKLIŲ;1627717901;Taip;6;1;0;7
15672;Justinukas;SVAJOKLIŲ;6234625191;Ne;0;6;0;6
15673;Justinukas;SVAJOKLIŲ;752609119;Taip;4;2;0;6
15674;Justinukas;SVAJOKLIŲ;3863971540;Taip;0;3;0;3
15675;Justinukas;SVAJOKLIŲ;43527855441;Taip;0;1;0;1
15676;Justinukas;SVAJOKLIŲ;16029286933;Taip;0;3;0;3
15677;Justinukas;SVAJOKLIŲ;8971898312;Taip;0;21;0;21
15678;Justinukas;SVAJOKLIŲ;1216138998;Taip;0;5;0;5
15679;Justinukas;SVAJOKLIŲ;7316804839;Ne;0;1;0;1
15680;Justinukas;SVAJOKLIŲ;3790209561;Taip;2;1;0;3
15681;Justinukas;SVAJOKLIŲ;9558483512;Taip;0;2;0;2
15682;Justinukas;SVAJOKLIŲ;37288931495;Taip;0;11;0;11
15683;Justinukas;SVAJOKLIŲ;8636869322;Taip;10;1;0;11
15684;Justinukas;SVAJOKLIŲ;6766493175;Taip;8;1;0;9
15685;Justinukas;SVAJOKLIŲ;5494500249;Taip;8;1;0;9
15686;Justinukas;SVAJOKLIŲ;6816901962;Taip;0;2;0;2
15687;Justinukas;SVAJOKLIŲ;3657642693;Taip;0;6;0;6
15688;Justinukas;"SAULĖS ZUIKIŲ";1550323727;Taip;3;2;0;5
15689;Justinukas;"SAULĖS ZUIKIŲ";1801800210;Taip;13;1;0;14
15690;Justinukas;"SAULĖS ZUIKIŲ";40999006978;Taip;7;0;0;7
15691;Justinukas;"SAULĖS ZUIKIŲ";29875250126;Taip;5;0;3;8
15692;Justinukas;"SAULĖS ZUIKIŲ";3813820356;Taip;11;5;0;16
15693;Justinukas;"SAULĖS ZUIKIŲ";3215259838;Taip;0;13;0;13
15694;Justinukas;"SAULĖS ZUIKIŲ";66240994100;Taip;6;3;0;9
15695;Justinukas;"SAULĖS ZUIKIŲ";8350429513;Taip;0;5;0;5
15696;Justinukas;"SAULĖS ZUIKIŲ";2532510817;Taip;0;12;0;12
15697;Justinukas;"SAULĖS ZUIKIŲ";52253951149;Taip;7;7;0;14
15698;Justinukas;"SAULĖS ZUIKIŲ";9411813711;Taip;2;0;2;4
15699;Justinukas;"SAULĖS ZUIKIŲ";4887565054;Taip;0;2;2;4
15700;Justinukas;"SAULĖS ZUIKIŲ";1806484271;Ne;9;1;0;10
15701;Justinukas;"SAULĖS ZUIKIŲ";8716574742;Taip;11;0;0;11
15702;Justinukas;"SAULĖS ZUIKIŲ";78270625975;Taip;15;3;0;18
15703;Justinukas;"SAULĖS ZUIKIŲ";5215250778;Taip;17;0;0;17
15704;Justinukas;"SAULĖS ZUIKIŲ";2018007566;Taip;10;0;1;11
15705;Justinukas;"SAULĖS ZUIKIŲ";1590855655;Taip;5;0;0;5
15706;Justinukas;"SAULĖS ZUIKIŲ";49880907488;Taip;9;3;0;12
15707;Justinukas;"SAULĖS ZUIKIŲ";76257661228;Taip;12;8;0;20
15708;Justinukas;"SAULĖS ZUIKIŲ";1967313365;Taip;8;0;0;8
15709;Justinukas;"SAULĖS ZUIKIŲ";56402748009;Ne;5;1;0;6
15710;Justinukas;PABIRUČIŲ;1996480143;Taip;0;1;0;1
15711;Justinukas;PABIRUČIŲ;76659578448;Taip;0;2;1;3
15712;Justinukas;PABIRUČIŲ;1655237708;Taip;0;2;3;5
15713;Justinukas;PABIRUČIŲ;20865224818;Taip;0;2;1;3
15714;Justinukas;PABIRUČIŲ;37019368317;Taip;0;1;0;1
15715;Justinukas;PABIRUČIŲ;23762150256;Taip;0;1;0;1
15716;Justinukas;PABIRUČIŲ;62276887757;Taip;0;5;0;5
15717;Justinukas;PABIRUČIŲ;28457909446;Ne;0;14;0;14
15718;Justinukas;PABIRUČIŲ;70334519732;Taip;0;2;1;3
15719;Justinukas;PABIRUČIŲ;94562009887;Taip;8;0;0;8
15720;Justinukas;PABIRUČIŲ;31817312555;Taip;0;2;2;4
15721;Justinukas;PABIRUČIŲ;16910061636;Taip;0;2;0;2
15722;Justinukas;PABIRUČIŲ;46373287636;Taip;0;0;4;4
15723;Justinukas;PABIRUČIŲ;72517122863;Taip;0;7;0;7
15724;Justinukas;PABIRUČIŲ;42486181827;Taip;0;5;0;5
15725;Justinukas;PABIRUČIŲ;45490599266;Taip;0;14;0;14
15726;Justinukas;PABIRUČIŲ;10573989701;Taip;17;0;0;17
15727;Justinukas;PABIRUČIŲ;1557388485;Taip;4;2;0;6
15728;Justinukas;VYTURIUKŲ;1585956968;Taip;0;7;0;7
15729;Justinukas;VYTURIUKŲ;4056697803;Taip;0;5;0;5
15730;Justinukas;VYTURIUKŲ;1181972027;Taip;0;7;0;7
15731;Justinukas;VYTURIUKŲ;1598234416;Taip;0;2;0;2
15732;Justinukas;VYTURIUKŲ;1511044883;Taip;0;4;0;4
15733;Justinukas;VYTURIUKŲ;1555183700;Taip;0;2;1;3
15734;Justinukas;VYTURIUKŲ;1785794727;Taip;0;2;0;2
15735;Justinukas;VYTURIUKŲ;99512297006;Taip;0;13;0;13
15736;Justinukas;VYTURIUKŲ;28095047700;Taip;10;2;0;12
15737;Justinukas;VYTURIUKŲ;91620507403;Taip;0;10;6;16
15738;Justinukas;VYTURIUKŲ;26842499755;Taip;0;1;0;1
15739;Justinukas;VYTURIUKŲ;1005872691;Taip;10;7;0;17
15740;Justinukas;VYTURIUKŲ;13774489893;Taip;22;0;0;22
15741;Justinukas;VYTURIUKŲ;2002649360;Taip;0;2;0;2
15742;Justinukas;VYTURIUKŲ;30823793919;Taip;12;5;3;20
15743;Justinukas;VYTURIUKŲ;89330918024;Ne;6;0;2;8
15744;Justinukas;VYTURIUKŲ;49578167204;Taip;0;0;4;4
15745;Justinukas;KODĖLČIUKŲ;1378219785;Taip;0;0;2;2
15746;Justinukas;KODĖLČIUKŲ;4946448574;Taip;3;6;0;9
15747;Justinukas;KODĖLČIUKŲ;1418462058;Taip;0;1;0;1
15748;Justinukas;KODĖLČIUKŲ;1022310072;Taip;9;0;4;13
15749;Justinukas;KODĖLČIUKŲ;33481357566;Taip;0;10;0;10
15750;Justinukas;KODĖLČIUKŲ;67436657541;Taip;0;0;1;1
15751;Justinukas;KODĖLČIUKŲ;29009575642;Taip;0;1;0;1
15752;Justinukas;KODĖLČIUKŲ;55428936508;Taip;4;0;2;6
15753;Justinukas;KODĖLČIUKŲ;60187200;Taip;0;0;1;1
15754;Justinukas;KODĖLČIUKŲ;11824002845;Taip;7;0;0;7
15755;Justinukas;KODĖLČIUKŲ;29696816177;Taip;12;0;0;12
15756;Justinukas;KODĖLČIUKŲ;65541524010;Taip;0;4;0;4
15757;Justinukas;KODĖLČIUKŲ;89566764594;Taip;0;0;2;2
15758;Justinukas;KODĖLČIUKŲ;21904117684;Taip;0;2;0;2
15759;Justinukas;KODĖLČIUKŲ;95563958391;Taip;0;0;3;3
15760;Justinukas;KODĖLČIUKŲ;38087400506;Taip;0;0;1;1
15761;Justinukas;KODĖLČIUKŲ;79380650760;Taip;0;5;0;5
15762;Justinukas;KODĖLČIUKŲ;42959183109;Taip;0;17;0;17
15763;Justinukas;KODĖLČIUKŲ;84179174899;Taip;0;1;0;1
15764;Justinukas;KODĖLČIUKŲ;1820490979;Taip;0;0;1;1
15765;Justinukas;KODĖLČIUKŲ;1962802968;Taip;5;3;0;8
15766;Justinukas;VIKRUOLIŲ;57621616956;Taip;5;0;0;5
15767;Justinukas;VIKRUOLIŲ;59108759161;Taip;5;13;0;18
15768;Justinukas;VIKRUOLIŲ;2776259830;Taip;6;2;0;8
15769;Justinukas;VIKRUOLIŲ;79934530654;Taip;0;5;0;5
15770;Justinukas;VIKRUOLIŲ;95467011497;Taip;0;15;0;15
15771;Justinukas;VIKRUOLIŲ;48732379120;Ne;0;6;0;6
15772;Justinukas;VIKRUOLIŲ;1844038414;Taip;10;0;0;10
15773;Justinukas;VIKRUOLIŲ;2952798555;Taip;10;0;4;14
15774;Justinukas;VIKRUOLIŲ;54102488427;Taip;0;9;0;9
15775;Justinukas;VIKRUOLIŲ;28543773229;Taip;4;8;0;12
15776;Justinukas;VIKRUOLIŲ;68853730495;Taip;7;6;0;13
15777;Justinukas;VIKRUOLIŲ;70062275466;Taip;0;2;0;2
15778;Justinukas;VIKRUOLIŲ;80827159258;Taip;11;0;0;11
15779;Justinukas;VIKRUOLIŲ;311074533;Taip;17;0;0;17
15780;Justinukas;VIKRUOLIŲ;7120661911;Taip;7;0;0;7
15781;Justinukas;VIKRUOLIŲ;55151392377;Taip;0;11;0;11
15782;Justinukas;VIKRUOLIŲ;97284171512;Taip;5;0;0;5
15783;Justinukas;VIKRUOLIŲ;1955952962;Ne;0;8;0;8
15784;Justinukas;VIKRUOLIŲ;1480054888;Taip;15;0;0;15
15785;Justinukas;VIKRUOLIŲ;5199005933;Taip;9;6;0;15
15786;Justinukas;PELEDŽIUKŲ;1789533195;Taip;4;2;0;6
15787;Justinukas;PELEDŽIUKŲ;74887990218;Taip;16;0;0;16
15788;Justinukas;PELEDŽIUKŲ;6268022925;Taip;14;0;1;15
15789;Justinukas;PELEDŽIUKŲ;1405642653;Taip;0;2;3;5
15790;Justinukas;PELEDŽIUKŲ;1976450069;Taip;0;0;2;2
15791;Justinukas;PELEDŽIUKŲ;89934673064;Taip;0;1;0;1
15792;Justinukas;PELEDŽIUKŲ;90692179185;Taip;0;6;0;6
15793;Justinukas;PELEDŽIUKŲ;61301662234;Taip;5;6;0;11
15794;Justinukas;PELEDŽIUKŲ;2027779101;Taip;0;0;2;2
15795;Justinukas;PELEDŽIUKŲ;12741015006;Taip;0;1;0;1
15796;Justinukas;PELEDŽIUKŲ;6961211392;Taip;8;0;0;8
15797;Justinukas;PELEDŽIUKŲ;48908098476;Taip;0;6;0;6
15798;Justinukas;PELEDŽIUKŲ;6604163285;Taip;0;13;0;13
15799;Justinukas;PELEDŽIUKŲ;1266695122;Taip;0;5;0;5
15800;Justinukas;PELEDŽIUKŲ;1956136425;Taip;0;5;0;5
15801;Justinukas;PELEDŽIUKŲ;1846303993;Taip;7;3;0;10
15802;Justinukas;ŽIRNIUKŲ;5876182759;Taip;0;1;0;1
15803;Justinukas;ŽIRNIUKŲ;8566530492;Taip;0;2;0;2
15804;Justinukas;ŽIRNIUKŲ;9226989209;Taip;2;0;0;2
15805;Justinukas;ŽIRNIUKŲ;2900181358;Taip;0;4;0;4
15806;Justinukas;ŽIRNIUKŲ;5978993456;Taip;15;0;4;19
15807;Justinukas;ŽIRNIUKŲ;5870609685;Ne;0;2;1;3
15808;Justinukas;ŽIRNIUKŲ;8965456115;Ne;0;12;0;12
15809;Justinukas;ŽIRNIUKŲ;8874979704;Taip;5;9;0;14
15810;Justinukas;ŽIRNIUKŲ;3193143474;Taip;13;0;0;13
15811;Justinukas;ŽIRNIUKŲ;1540892686;Taip;22;0;0;22
15812;Justinukas;ŽIRNIUKŲ;3729297918;Taip;0;0;5;5
15813;Justinukas;ŽIRNIUKŲ;2268124610;Taip;0;4;0;4
15814;Justinukas;GUDRUČIŲ;2241816838;Taip;7;0;0;7
15815;Justinukas;GUDRUČIŲ;6482808707;Taip;8;0;0;8
15816;Justinukas;GUDRUČIŲ;4756483798;Ne;7;0;0;7
15817;Justinukas;GUDRUČIŲ;3206751576;Taip;2;3;0;5
15818;Justinukas;GUDRUČIŲ;6470287041;Taip;2;0;0;2
15819;Justinukas;GUDRUČIŲ;3268913601;Taip;7;1;0;8
15820;Justinukas;GUDRUČIŲ;7710916537;Taip;14;1;0;15
15821;Justinukas;GUDRUČIŲ;4194429972;Ne;10;2;0;12
15822;Justinukas;GUDRUČIŲ;8913463448;Ne;2;1;0;3
15823;Justinukas;GUDRUČIŲ;7854674833;Taip;0;3;0;3
15824;Justinukas;GUDRUČIŲ;3768735503;Taip;13;0;0;13
15825;Justinukas;GUDRUČIŲ;8086378912;Taip;9;0;0;9
15826;Justinukas;GUDRUČIŲ;4271601149;Taip;3;3;0;6
15827;Justinukas;BORUŽIUKŲ;6897988246;Taip;0;1;0;1
15828;Justinukas;BORUŽIUKŲ;4542350401;Taip;10;0;0;10
15829;Justinukas;BORUŽIUKŲ;4347647695;Taip;0;11;0;11
15830;Justinukas;BORUŽIUKŲ;3388483002;Taip;10;0;3;13
15831;Justinukas;BORUŽIUKŲ;9998493076;Taip;0;8;0;8
15832;Justinukas;BORUŽIUKŲ;1129392970;Taip;18;0;0;18
15833;Justinukas;BORUŽIUKŲ;8281005516;Taip;11;0;0;11
15834;Justinukas;BORUŽIUKŲ;1398976932;Taip;0;4;0;4
15835;Justinukas;BORUŽIUKŲ;9823188609;Taip;0;3;0;3
15836;Justinukas;BORUŽIUKŲ;29165025048;Taip;0;0;3;3
15837;Justinukas;BORUŽIUKŲ;5258444578;Taip;5;0;0;5
15838;Justinukas;BORUŽIUKŲ;4574673585;Taip;0;1;0;1
15839;Justinukas;BORUŽIUKŲ;7006338378;Taip;0;1;0;1
15840;Justinukas;BORUŽIUKŲ;7166828675;Ne;0;0;9;9
15841;Justinukas;BORUŽIUKŲ;1172609518;Ne;10;7;0;17
15842;Justinukas;BORUŽIUKŲ;1616324236;Taip;0;17;0;17
15843;Justinukas;BORUŽIUKŲ;3030820917;Taip;5;10;0;15
15844;Aidas;Boružėlių;2027860670;Ne;0;3;0;3
15845;Aidas;Boružėlių;8915901727;Taip;0;3;0;3
15846;Aidas;Boružėlių;5311183877;Taip;0;4;0;4
15847;Aidas;Drugelių;1001916537;Taip;0;1;0;1
15848;Aidas;Drugelių;15257986685;Taip;0;15;0;15
15849;Aidas;Drugelių;1653793823;Taip;4;1;0;5
15850;Aidas;Aitvariukų;30954912922;Taip;5;11;0;16
15851;Aidas;Aitvariukų;3127870635;Taip;0;1;0;1
15852;Aidas;Aitvariukų;3366848846;Taip;0;3;0;3
15853;Aidas;"Meškučių kl.";8177181962;Ne;0;3;0;3
15854;Aidas;"Gaidelių kl.";5100740847;Ne;3;0;0;3
15855;Aidas;"Gaidelių kl.";2501187241;Ne;0;11;0;11
15856;Aidas;"Kiškelių kl";6213577188;Ne;0;1;0;1
15857;Aidas;"Kiškelių kl";9057435844;Ne;0;3;0;3
15858;Aidas;"Kiškelių kl";2681438925;Ne;2;1;0;3
15859;Aidas;"Kiškelių kl";5388697695;Ne;4;0;0;4
15860;Aidas;"Ančiukų kl.";1742331213;Ne;3;0;0;3
15861;Aidas;"Ančiukų kl.";92425322676;Ne;0;2;0;2
15862;Aidas;"Ančiukų kl.";81654551230;Taip;0;2;0;2
15863;Aidas;"Ančiukų kl.";63508565206;Ne;0;2;0;2
15864;Aidas;"Ančiukų kl.";3194974747;Ne;6;0;0;6
15865;Aidas;"Ančiukų kl.";72751441075;Taip;2;0;0;2
15866;Aidas;"Pelėdžiukų kl.";5712688030;Ne;0;1;0;1
15867;Aidas;"Pelėdžiukų kl.";2991400032;Ne;0;2;0;2
15868;Aidas;"Papūgėlių kl.";2184123290;Taip;5;0;0;5
15869;Aidas;"Papūgėlių kl.";4372628947;Ne;0;5;0;5
15870;Aidas;"Papūgėlių kl.";8490224829;Ne;0;1;0;1
15871;Aidas;"Papūgėlių kl.";3442250711;Ne;0;1;0;1
15872;Aidas;"Papūgėlių kl.";9613466086;Taip;14;3;0;17
15873;Aidas;"Saulutės kl.";1535004699;Ne;0;9;0;9
15874;Aidas;"Saulutės kl.";6356218442;Taip;0;22;0;22
15875;Aidas;"Saulutės kl.";9944901942;Ne;0;1;0;1
15876;Aidas;"Saulutės kl.";74897451962;Taip;0;2;0;2
15877;Aidas;"Saulutės kl.";7329254454;Taip;0;2;0;2
15878;Aidas;"Katinėlių kl.";4367406525;Taip;3;0;0;3
15879;Aidas;"Katinėlių kl.";7821044288;Ne;0;4;0;4
15880;Bangelė;Aštuonkojai;20827674346;Taip;0;5;0;5
15881;Bangelė;Aštuonkojai;51571795638;Ne;5;0;1;6
15882;Bangelė;Aštuonkojai;8280327053;Ne;0;0;11;11
15883;Bangelė;Aštuonkojai;81379253837;Taip;5;8;0;13
15884;Bangelė;Aštuonkojai;5142785037;Taip;16;0;0;16
15885;Bangelė;Aštuonkojai;83691968186;Taip;0;17;2;19
15886;Bangelė;Aštuonkojai;76618850202;Taip;0;5;0;5
15887;Bangelė;Aštuonkojai;84855013193;Taip;0;0;4;4
15888;Bangelė;Aštuonkojai;69413101571;Taip;0;4;0;4
15889;Bangelė;Aštuonkojai;24209781144;Taip;0;6;0;6
15890;Bangelė;Aštuonkojai;18979714088;Taip;0;4;0;4
15891;Bangelė;Aštuonkojai;89458174517;Taip;0;2;0;2
15892;Bangelė;Aštuonkojai;70270153561;Ne;0;0;3;3
15893;Bangelė;Aštuonkojai;13284428796;Taip;15;0;0;15
15894;Bangelė;Aštuonkojai;7957072941;Taip;0;2;0;2
15895;Bangelė;Aštuonkojai;24895047229;Taip;0;8;0;8
15896;Bangelė;Aštuonkojai;45145282759;Taip;11;0;5;16
15897;Bangelė;Aštuonkojai;2067377559;Taip;5;5;1;11
15898;Bangelė;Aštuonkojai;1312545465;Taip;0;3;0;3
15899;Bangelė;Aštuonkojai;1862514267;Taip;0;10;0;10
15900;Bangelė;Delfinukai,;7263228478;Taip;5;8;0;13
15901;Bangelė;Delfinukai,;1953702121;Taip;4;0;2;6
15902;Bangelė;Delfinukai,;1594486275;Taip;0;5;0;5
15903;Bangelė;Delfinukai,;22773040549;Taip;0;0;6;6
15904;Bangelė;Delfinukai,;6508452044;Taip;0;5;0;5
15905;Bangelė;Delfinukai,;2045465669;Taip;0;12;2;14
15906;Bangelė;Delfinukai,;95548866362;Taip;0;14;0;14
15907;Bangelė;Delfinukai,;1377575533;Taip;7;4;0;11
15908;Bangelė;Delfinukai,;3044914280;Taip;5;4;0;9
15909;Bangelė;Delfinukai,;2032075296;Taip;0;0;1;1
15910;Bangelė;Delfinukai,;7059603451;Taip;12;5;0;17
15911;Bangelė;Delfinukai,;1053744221;Taip;10;0;0;10
15912;Bangelė;Delfinukai,;4187165474;Taip;0;1;0;1
15913;Bangelė;Delfinukai,;6927540308;Ne;15;0;0;15
15914;Bangelė;"Saulės spindulėliai";7324007016;Taip;0;11;0;11
15915;Bangelė;"Saulės spindulėliai";8693782399;Taip;0;4;0;4
15916;Bangelė;"Saulės spindulėliai";8183516661;Taip;0;10;0;10
15917;Bangelė;"Saulės spindulėliai";65814392847;Taip;2;4;0;6
15918;Bangelė;"Saulės spindulėliai";47925578720;Taip;0;4;0;4
15919;Bangelė;"Saulės spindulėliai";99763916617;Taip;5;3;0;8
15920;Bangelė;"Saulės spindulėliai";22633862463;Taip;4;0;2;6
15921;Bangelė;"Saulės spindulėliai";30494044355;Taip;0;1;0;1
15922;Bangelė;"Saulės spindulėliai";49086959518;Ne;2;0;0;2
15923;Bangelė;"Saulės spindulėliai";97482799588;Ne;0;1;0;1
15924;Bangelė;"Saulės spindulėliai";83292810870;Taip;0;5;0;5
15925;Bangelė;"Saulės spindulėliai";17203636760;Ne;0;3;0;3
15926;Bangelė;"Saulės spindulėliai";95340587554;Taip;4;0;0;4
15927;Bangelė;"Saulės spindulėliai";27628473523;Taip;1;0;0;1
15928;Bangelė;"Saulės spindulėliai";75561871028;Taip;0;14;0;14
15929;Bangelė;"Saulės spindulėliai";26684336190;Taip;0;1;0;1
15930;Bangelė;"Saulės spindulėliai";50893212045;Taip;0;10;0;10
15931;Bangelė;"Saulės spindulėliai";83733094674;Taip;8;0;1;9
15932;Bangelė;"Pingvinukai ";1728085772;Taip;5;0;0;5
15933;Bangelė;"Pingvinukai ";9150185864;Taip;17;0;2;19
15934;Bangelė;"Pingvinukai ";6173470021;Taip;8;0;2;10
15935;Bangelė;"Pingvinukai ";55668308050;Taip;0;17;0;17
15936;Bangelė;"Pingvinukai ";2503946448;Taip;0;10;2;12
15937;Bangelė;"Pingvinukai ";6026399355;Taip;0;3;0;3
15938;Bangelė;"Pingvinukai ";3338203753;Taip;0;0;3;3
15939;Bangelė;"Pingvinukai ";1377734102;Taip;0;3;0;3
15940;Bangelė;"Pingvinukai ";9788923823;Taip;22;0;0;22
15941;Bangelė;"Pingvinukai ";9341038058;Taip;0;10;0;10
15942;Bangelė;"Pingvinukai ";2027892816;Taip;0;1;0;1
15943;Bangelė;"Pingvinukai ";5034268767;Taip;0;0;1;1
15944;Bangelė;"Pingvinukai ";4204797742;Taip;16;4;0;20
15945;Bangelė;"Pingvinukai ";1661384764;Ne;0;0;10;10
15946;Bangelė;"Pingvinukai ";1032881464;Ne;17;0;1;18
15947;Bangelė;"Pingvinukai ";9464115339;Taip;8;0;2;10
15948;Bangelė;"Jūros žvaigždutės ";2872188915;Taip;2;0;2;4
15949;Bangelė;"Jūros žvaigždutės ";7723290276;Taip;0;0;1;1
15950;Bangelė;"Jūros žvaigždutės ";4401389067;Ne;2;0;4;6
15951;Bangelė;"Jūros žvaigždutės ";1528387105;Taip;0;3;0;3
15952;Bangelė;"Jūros žvaigždutės ";6712145066;Taip;0;0;1;1
15953;Bangelė;"Jūros žvaigždutės ";9822287576;Taip;0;1;4;5
15954;Bangelė;"Jūros žvaigždutės ";7375004714;Ne;7;0;0;7
15955;Bangelė;"Jūros žvaigždutės ";7701956270;Taip;7;2;3;12
15956;Bangelė;"Jūros žvaigždutės ";1367082230;Taip;0;0;1;1
15957;Bangelė;"Jūros žvaigždutės ";1348995498;Ne;5;5;0;10
15958;Bangelė;"Jūros žvaigždutės ";8836861853;Taip;0;0;1;1
15959;Bangelė;"Jūros žvaigždutės ";4571869439;Taip;0;1;0;1
15960;Bangelė;"Jūros žvaigždutės ";8758933649;Taip;11;0;0;11
15961;Bangelė;"Jūros žvaigždutės ";9041585534;Taip;17;0;0;17
15962;Bangelė;"Jūros žvaigždutės ";4506651162;Taip;0;0;4;4
15963;Bangelė;"Jūros žvaigždutės ";9672505885;Taip;0;0;2;2
15964;Bangelė;"Jūros žvaigždutės ";7248631013;Taip;4;0;0;4
15965;Bangelė;"Jūros žvaigždutės ";4338067260;Taip;0;0;4;4
15966;Bangelė;Žuvytės;77615973000;Taip;10;1;0;11
15967;Bangelė;Žuvytės;411039166;Taip;0;9;0;9
15968;Bangelė;Žuvytės;7114709352;Taip;17;0;2;19
15969;Bangelė;Žuvytės;28845494407;Taip;4;3;0;7
15970;Bangelė;Žuvytės;9983202427;Ne;0;0;4;4
15971;Bangelė;Žuvytės;3115177810;Ne;11;0;2;13
15972;Bangelė;Žuvytės;1790881495;Taip;0;3;0;3
15973;Bangelė;Žuvytės;1683377649;Taip;0;5;0;5
15974;Bangelė;Žuvytės;6739499483;Ne;0;0;11;11
15975;Bangelė;Žuvytės;47454787439;Taip;0;0;4;4
15976;Bangelė;Žuvytės;5573145836;Taip;0;0;3;3
15977;Bangelė;Žuvytės;3961043533;Taip;8;5;0;13
15978;Bangelė;Žuvytės;5159962168;Taip;10;3;0;13
15979;Bangelė;Žuvytės;1766156349;Taip;0;0;5;5
15980;Bangelė;Žuvytės;2112394008;Taip;10;0;3;13
15981;Bangelė;Žuvytės;1065164865;Taip;0;0;2;2
15982;Bangelė;Žuvytės;5323726165;Taip;13;0;0;13
15983;Bangelė;Žuvytės;42739113312;Ne;7;0;0;7
15984;Bangelė;Ruoniai;77600323792;Taip;9;0;0;9
15985;Bangelė;Ruoniai;78837447598;Taip;4;6;0;10
15986;Bangelė;Ruoniai;34804550825;Taip;17;0;0;17
15987;Bangelė;Ruoniai;7559190407;Taip;6;9;2;17
15988;Bangelė;Ruoniai;11083985386;Taip;0;3;0;3
15989;Bangelė;Ruoniai;76353372848;Taip;0;5;0;5
15990;Bangelė;Ruoniai;99771696381;Taip;5;4;0;9
15991;Bangelė;Ruoniai;17608442103;Taip;7;6;0;13
15992;Bangelė;Ruoniai;60823401986;Taip;7;0;0;7
15993;Bangelė;Ruoniai;1189143700;Taip;3;0;0;3
15994;Bangelė;Ruoniai;84620904798;Taip;0;0;3;3
15995;Bangelė;Ruoniai;37790897510;Taip;3;0;1;4
15996;Bangelė;Ruoniai;84797019693;Ne;0;9;0;9
15997;Bangelė;Ruoniai;2749669816;Taip;6;0;0;6
15998;Bangelė;Ruoniai;1258870576;Taip;3;0;3;6
15999;Bangelė;Ruoniai;91953522637;Taip;0;0;1;1
16000;Bangelė;Ruoniai;99823581960;Taip;0;5;0;5
16001;Bangelė;Ruoniai;2423625777;Taip;5;6;0;11
16002;Bangelė;Ruoniai;1823592268;Taip;0;3;0;3
16003;Gėlynas;PAKALNUTĖ;95681874019;Taip;0;2;0;2
16004;Gėlynas;PAKALNUTĖ;22067595840;Taip;0;2;4;6
16005;Gėlynas;PAKALNUTĖ;99637531213;Taip;0;4;0;4
16006;Gėlynas;PAKALNUTĖ;7735904549;Ne;0;2;0;2
16007;Gėlynas;PAKALNUTĖ;72991081966;Taip;0;8;0;8
16008;Gėlynas;PAKALNUTĖ;85912494214;Taip;0;1;0;1
16009;Gėlynas;PAKALNUTĖ;23134075402;Taip;0;1;0;1
16010;Gėlynas;PAKALNUTĖ;93919808581;Taip;0;7;0;7
16011;Gėlynas;PAKALNUTĖ;65634206992;Taip;0;11;0;11
16012;Gėlynas;PAKALNUTĖ;75827864070;Taip;0;2;0;2
16013;Gėlynas;PAKALNUTĖ;14307514975;Taip;16;0;0;16
16014;Gėlynas;PAKALNUTĖ;31532261756;Taip;0;7;0;7
16015;Gėlynas;PAKALNUTĖ;91530210644;Ne;0;0;12;12
16016;Gėlynas;PAKALNUTĖ;72544014665;Taip;0;10;0;10
16017;Gėlynas;PAKALNUTĖ;40702362906;Taip;5;4;0;9
16018;Gėlynas;PAKALNUTĖ;75222833700;Taip;0;6;0;6
16019;Gėlynas;PAKALNUTĖ;55177015936;Taip;0;9;0;9
16020;Gėlynas;PAKALNUTĖ;1406567756;Taip;0;8;0;8
16021;Gėlynas;PAKALNUTĖ;6375754699;Taip;2;0;0;2
16022;Gėlynas;VARPELIS;10328968209;Taip;6;0;0;6
16023;Gėlynas;VARPELIS;31203005706;Taip;0;9;0;9
16024;Gėlynas;VARPELIS;25587271237;Taip;0;1;0;1
16025;Gėlynas;VARPELIS;69440015944;Taip;0;8;0;8
16026;Gėlynas;VARPELIS;88267408077;Taip;3;15;0;18
16027;Gėlynas;VARPELIS;79659995227;Taip;0;11;0;11
16028;Gėlynas;VARPELIS;15891327132;Taip;0;2;0;2
16029;Gėlynas;VARPELIS;83480285704;Taip;0;0;1;1
16030;Gėlynas;VARPELIS;32029146963;Taip;0;7;0;7
16031;Gėlynas;VARPELIS;49356547308;Taip;0;5;0;5
16032;Gėlynas;VARPELIS;2694971710;Taip;0;0;1;1
16033;Gėlynas;VARPELIS;96358879500;Taip;0;4;0;4
16034;Gėlynas;VARPELIS;81669521777;Ne;0;5;0;5
16035;Gėlynas;VARPELIS;51078077889;Taip;9;0;0;9
16036;Gėlynas;VARPELIS;95226235881;Taip;0;7;0;7
16037;Gėlynas;VARPELIS;1321152075;Taip;0;5;0;5
16038;Gėlynas;VARPELIS;53718930602;Taip;5;0;1;6
16039;Gėlynas;VARPELIS;85776411183;Taip;0;4;0;4
16040;Gėlynas;RAKTAŽOLĖ;1418321973;Taip;0;2;0;2
16041;Gėlynas;RAKTAŽOLĖ;93572183033;Taip;2;1;0;3
16042;Gėlynas;RAKTAŽOLĖ;4508497773;Taip;0;1;0;1
16043;Gėlynas;RAKTAŽOLĖ;63379609794;Taip;1;0;0;1
16044;Gėlynas;RAKTAŽOLĖ;1797681067;Taip;3;17;0;20
16045;Gėlynas;RAKTAŽOLĖ;16850449718;Taip;4;0;0;4
16046;Gėlynas;RAKTAŽOLĖ;1117528954;Ne;0;8;0;8
16047;Gėlynas;RAKTAŽOLĖ;57429063547;Taip;8;4;0;12
16048;Gėlynas;RAKTAŽOLĖ;1483072450;Taip;9;0;0;9
16049;Gėlynas;RAKTAŽOLĖ;7796794153;Taip;0;0;1;1
16050;Gėlynas;RAKTAŽOLĖ;6264361257;Taip;0;11;0;11
16051;Gėlynas;RAKTAŽOLĖ;1047462165;Taip;0;5;0;5
16052;Gėlynas;RAKTAŽOLĖ;1754734306;Taip;0;2;0;2
16053;Gėlynas;RAKTAŽOLĖ;84546885977;Taip;0;5;0;5
16054;Gėlynas;RAKTAŽOLĖ;5135747448;Taip;0;2;0;2
16055;Gėlynas;RAKTAŽOLĖ;7808971151;Taip;0;1;0;1
16056;Gėlynas;SAULĖGRĄŽA;1191494598;Ne;3;0;3;6
16057;Gėlynas;SAULĖGRĄŽA;1407350449;Taip;5;0;0;5
16058;Gėlynas;SAULĖGRĄŽA;1676904275;Taip;0;4;0;4
16059;Gėlynas;SAULĖGRĄŽA;1338585475;Ne;9;5;0;14
16060;Gėlynas;SAULĖGRĄŽA;2050384850;Taip;13;0;0;13
16061;Gėlynas;SAULĖGRĄŽA;85310323038;Taip;0;2;0;2
16062;Gėlynas;SAULĖGRĄŽA;47220216751;Taip;0;2;0;2
16063;Gėlynas;SAULĖGRĄŽA;2099722437;Taip;0;1;0;1
16064;Gėlynas;SAULĖGRĄŽA;86881175896;Taip;5;0;0;5
16065;Gėlynas;SAULĖGRĄŽA;1053422007;Taip;7;0;1;8
16066;Gėlynas;SAULĖGRĄŽA;1608626732;Taip;0;9;0;9
16067;Gėlynas;SAULĖGRĄŽA;44391516295;Taip;0;0;1;1
16068;Gėlynas;SAULĖGRĄŽA;2018911523;Taip;0;0;15;15
16069;Gėlynas;SAULĖGRĄŽA;1431418368;Taip;0;1;0;1
16070;Gėlynas;SAULĖGRĄŽA;8324564359;Taip;9;0;0;9
16071;Gėlynas;RAMUNĖLĖ;4382465307;Taip;0;18;0;18
16072;Gėlynas;RAMUNĖLĖ;8615943743;Taip;2;2;0;4
16073;Gėlynas;RAMUNĖLĖ;1674569569;Taip;0;2;0;2
16074;Gėlynas;RAMUNĖLĖ;5695333666;Taip;0;3;0;3
16075;Gėlynas;RAMUNĖLĖ;90046802421;Taip;4;0;0;4
16076;Gėlynas;RAMUNĖLĖ;1557503831;Taip;2;4;0;6
16077;Gėlynas;RAMUNĖLĖ;2230224971;Taip;11;0;0;11
16078;Gėlynas;RAMUNĖLĖ;5395474698;Taip;0;4;0;4
16079;Gėlynas;RAMUNĖLĖ;2348787949;Taip;6;1;0;7
16080;Gėlynas;RAMUNĖLĖ;3890687425;Taip;10;0;0;10
16081;Gėlynas;RAMUNĖLĖ;5124029118;Ne;0;17;0;17
16082;Gėlynas;RAMUNĖLĖ;9026298982;Ne;0;4;0;4
16083;Gėlynas;RAMUNĖLĖ;6815740588;Ne;3;10;0;13
16084;Gėlynas;RAMUNĖLĖ;5541707540;Taip;0;3;0;3
16085;Gėlynas;ŽIBUTĖ;6898127005;Taip;0;8;0;8
16086;Gėlynas;ŽIBUTĖ;77283628988;Ne;0;7;0;7
16087;Gėlynas;ŽIBUTĖ;1257113113;Taip;0;3;0;3
16088;Gėlynas;ŽIBUTĖ;2417880374;Taip;0;0;13;13
16089;Gėlynas;ŽIBUTĖ;2349352560;Taip;3;0;2;5
16090;Gėlynas;ŽIBUTĖ;4445250490;Taip;2;0;1;3
16091;Gėlynas;ŽIBUTĖ;6528464599;Taip;0;5;3;8
16092;Gėlynas;ŽIBUTĖ;2906909558;Taip;7;0;2;9
16093;Gėlynas;ŽIBUTĖ;9911225363;Taip;6;0;1;7
16094;Gėlynas;ŽIBUTĖ;1897547388;Taip;7;0;0;7
16095;Gėlynas;ŽIBUTĖ;3365442661;Taip;11;0;1;12
16096;Gėlynas;ŽIBUTĖ;7337987259;Taip;1;2;1;4
16097;Gėlynas;ŽIBUTĖ;5634213306;Taip;5;0;0;5
16098;Gėlynas;ŽIBUTĖ;9724668402;Taip;2;0;2;4
16099;Gėlynas;ŽIBUTĖ;2520059010;Taip;0;12;0;12
16100;Obelėlė;Bildukai;43664898514;Taip;6;6;2;14
16101;Obelėlė;Bildukai;58388471530;Taip;0;0;6;6
16102;Obelėlė;Bildukai;34628612328;Taip;10;0;0;10
16103;Obelėlė;Bildukai;2024391462;Taip;22;0;0;22
16104;Obelėlė;Bildukai;15196087730;Ne;9;0;0;9
16105;Obelėlė;Bildukai;75737109657;Taip;0;0;4;4
16106;Obelėlė;Bildukai;1466324860;Taip;5;1;0;6
16107;Obelėlė;Bildukai;52857531341;Taip;8;2;1;11
16108;Obelėlė;Bildukai;68222818886;Ne;5;0;1;6
16109;Obelėlė;Bildukai;1831642058;Taip;0;11;0;11
16110;Obelėlė;Bildukai;13913516066;Taip;3;0;1;4
16111;Obelėlė;Bildukai;14986936220;Taip;0;0;2;2
16112;Obelėlė;Bildukai;88058597079;Taip;3;0;0;3
16113;Obelėlė;Bildukai;22986329944;Ne;17;0;0;17
16114;Obelėlė;Bildukai;29677456066;Taip;0;0;1;1
16115;Obelėlė;Bildukai;646883449;Taip;3;0;1;4
16116;Obelėlė;Bildukai;1816297607;Ne;6;0;3;9
16117;Obelėlė;Bildukai;19376935875;Taip;0;5;3;8
16118;Obelėlė;Gudručiai;83283114997;Taip;0;7;0;7
16119;Obelėlė;Gudručiai;25763539568;Taip;0;10;0;10
16120;Obelėlė;Gudručiai;72425110965;Taip;0;4;0;4
16121;Obelėlė;Gudručiai;77857591361;Taip;0;5;0;5
16122;Obelėlė;Gudručiai;79959560506;Ne;0;6;0;6
16123;Obelėlė;Gudručiai;30827740191;Taip;0;3;0;3
16124;Obelėlė;Gudručiai;49086730989;Taip;0;20;0;20
16125;Obelėlė;Gudručiai;1425516089;Taip;2;0;4;6
16126;Obelėlė;Gudručiai;1379383341;Taip;0;2;0;2
16127;Obelėlė;Gudručiai;1582535117;Taip;0;4;0;4
16128;Obelėlė;Pasakaitė;1695933896;Taip;0;0;1;1
16129;Obelėlė;Pasakaitė;1833543299;Taip;0;1;0;1
16130;Obelėlė;Pasakaitė;1555780072;Taip;0;6;1;7
16131;Obelėlė;Pasakaitė;77743243622;Taip;0;0;2;2
16132;Obelėlė;Pasakaitė;1543298097;Taip;6;0;0;6
16133;Obelėlė;Pasakaitė;79601449969;Taip;5;0;0;5
16134;Obelėlė;Pasakaitė;3330983614;Taip;5;0;0;5
16135;Obelėlė;Pasakaitė;4257479486;Taip;0;0;8;8
16136;Obelėlė;Pasakaitė;8394566707;Taip;0;5;0;5
16137;Obelėlė;Pasakaitė;9527363918;Taip;0;2;0;2
16138;Obelėlė;Pasakaitė;10939948244;Ne;0;0;11;11
16139;Obelėlė;Pasakaitė;1707652145;Taip;9;0;0;9
16140;Obelėlė;Pasakaitė;1141707374;Taip;0;0;1;1
16141;Obelėlė;Pasakaitė;6789881144;Taip;3;0;0;3
16142;Obelėlė;Pasakaitė;6036130112;Taip;0;0;3;3
16143;Obelėlė;Pasakaitė;8324404990;Taip;18;0;0;18
16144;Obelėlė;Pasakaitė;1893470952;Taip;1;0;2;3
16145;Obelėlė;Pasakaitė;7754276632;Taip;0;22;0;22
16146;Obelėlė;Svajokliai;23509261393;Taip;0;10;0;10
16147;Obelėlė;Svajokliai;6994800595;Taip;0;0;11;11
16148;Obelėlė;Svajokliai;7041085872;Taip;0;0;6;6
16149;Obelėlė;Svajokliai;35070707820;Taip;0;10;0;10
16150;Obelėlė;Svajokliai;97950830777;Taip;0;0;1;1
16151;Obelėlė;Svajokliai;97594253013;Taip;0;0;4;4
16152;Obelėlė;Svajokliai;76646326936;Taip;0;0;3;3
16153;Obelėlė;Svajokliai;17252134237;Taip;0;7;0;7
16154;Obelėlė;Svajokliai;15750481943;Taip;0;6;0;6
16155;Obelėlė;Svajokliai;93272717922;Taip;0;10;4;14
16156;Obelėlė;Svajokliai;67212667852;Taip;0;0;8;8
16157;Obelėlė;Svajokliai;64573865421;Taip;0;0;3;3
16158;Obelėlė;Svajokliai;75091826601;Taip;0;0;3;3
16159;Obelėlė;Svajokliai;1784306608;Taip;0;1;0;1
16160;Obelėlė;Smalsučiai;43103357250;Taip;0;0;1;1
16161;Obelėlė;Smalsučiai;1337679766;Taip;5;0;1;6
16162;Obelėlė;Smalsučiai;2107924334;Taip;0;0;5;5
16163;Obelėlė;Smalsučiai;72224972200;Taip;7;0;0;7
16164;Obelėlė;Smalsučiai;72467035839;Taip;0;6;0;6
16165;Obelėlė;Smalsučiai;3220190193;Ne;0;0;4;4
16166;Obelėlė;Smalsučiai;39757539751;Taip;2;0;3;5
16167;Obelėlė;Smalsučiai;27275867716;Ne;0;6;0;6
16168;Obelėlė;Smalsučiai;35495444231;Ne;0;0;9;9
16169;Obelėlė;Smalsučiai;88798186419;Taip;0;0;1;1
16170;Obelėlė;Smalsučiai;97298049429;Taip;0;0;1;1
16171;Obelėlė;Smalsučiai;68776273648;Taip;0;0;10;10
16172;Obelėlė;Smalsučiai;78242377913;Taip;12;1;0;13
16173;Obelėlė;Smalsučiai;2995640371;Taip;7;0;1;8
16174;Obelėlė;Pabiručiai;1547195948;Taip;2;0;0;2
16175;Obelėlė;Pabiručiai;1586544097;Taip;3;0;0;3
16176;Obelėlė;Pabiručiai;94350358246;Taip;0;0;1;1
16177;Obelėlė;Pabiručiai;74915473313;Taip;4;0;3;7
16178;Obelėlė;Pabiručiai;79388410820;Taip;9;0;0;9
16179;Obelėlė;Pabiručiai;40103909643;Taip;0;4;0;4
16180;Obelėlė;Pabiručiai;2662966388;Taip;6;0;0;6
16181;Obelėlė;Pabiručiai;2678719111;Taip;7;0;0;7
16182;Obelėlė;Pabiručiai;1420633482;Taip;7;0;1;8
16183;Obelėlė;Pabiručiai;1698995389;Taip;5;1;0;6
16184;Obelėlė;Pabiručiai;79669290078;Ne;0;0;5;5
16185;Obelėlė;Pabiručiai;31018018065;Taip;5;0;0;5
16186;Obelėlė;Pabiručiai;2015165566;Taip;0;0;6;6
16187;Obelėlė;Pabiručiai;16430825029;Taip;0;5;0;5
16188;Obelėlė;Pabiručiai;8882103124;Taip;5;6;1;12
16189;Obelėlė;Pabiručiai;5471194804;Taip;4;0;1;5
16190;Obelėlė;Pabiručiai;69055416041;Taip;0;13;0;13
16191;Obelėlė;Pabiručiai;1576498450;Taip;0;0;1;1
16192;Obelėlė;Pabiručiai;74455701543;Taip;9;0;9;18
16193;Obelėlė;Pabiručiai;1978974359;Ne;6;0;0;6
16194;Obelėlė;Rieduliukai;8173307704;Taip;0;22;0;22
16195;Obelėlė;Rieduliukai;1706102918;Taip;0;9;0;9
16196;Obelėlė;Rieduliukai;8682794598;Taip;0;0;1;1
16197;Obelėlė;Rieduliukai;8754552660;Taip;19;0;0;19
16198;Obelėlė;Rieduliukai;8092024850;Taip;2;0;0;2
16199;Obelėlė;Rieduliukai;3604960887;Taip;10;3;0;13
16200;Obelėlė;Rieduliukai;4251418414;Taip;3;0;0;3
16201;Obelėlė;Rieduliukai;7128421330;Taip;0;0;1;1
16202;Obelėlė;Rieduliukai;5943314566;Taip;0;22;0;22
16203;Obelėlė;Rieduliukai;6364101139;Taip;12;0;0;12
16204;Obelėlė;Rieduliukai;6691540418;Taip;22;0;0;22
16205;Obelėlė;Rieduliukai;3116100694;Taip;5;0;0;5
16206;Obelėlė;Rieduliukai;5326258755;Taip;0;20;0;20
16207;Obelėlė;Rieduliukai;2770477678;Taip;8;2;1;11
16208;Obelėlė;Žirniukai;2014314139;Taip;0;0;5;5
16209;Obelėlė;Žirniukai;9900484892;Taip;18;0;0;18
16210;Obelėlė;Žirniukai;6325027163;Taip;0;0;1;1
16211;Obelėlė;Žirniukai;6145113624;Taip;13;0;0;13
16212;Obelėlė;Žirniukai;9586720282;Taip;0;22;0;22
16213;Obelėlė;Žirniukai;9567704282;Taip;3;0;0;3
16214;Obelėlė;Žirniukai;8231489868;Taip;6;0;0;6
16215;Obelėlė;Žirniukai;9305279614;Taip;0;1;2;3
16216;Obelėlė;Žirniukai;4995817505;Taip;0;0;3;3
16217;Obelėlė;Žirniukai;4015702815;Taip;5;0;4;9
16218;Obelėlė;Žirniukai;4309139638;Taip;0;0;4;4
16219;Obelėlė;Žirniukai;9736557012;Taip;0;22;0;22
16220;Obelėlė;Žirniukai;6720058972;Taip;4;0;2;6
16221;Obelėlė;Žirniukai;5141585309;Taip;10;0;6;16
16222;Obelėlė;Bičiuliai;9031690002;Taip;7;0;0;7
16223;Obelėlė;Bičiuliai;3425736276;Taip;9;0;0;9
16224;Obelėlė;Bičiuliai;1507072248;Taip;20;0;1;21
16225;Obelėlė;Bičiuliai;5776116844;Taip;5;2;1;8
16226;Obelėlė;Bičiuliai;8487088625;Ne;0;0;11;11
16227;Obelėlė;Bičiuliai;1630067014;Taip;10;0;0;10
16228;Obelėlė;Bičiuliai;1537769810;Taip;2;0;1;3
16229;Obelėlė;Bičiuliai;8371648703;Taip;3;0;0;3
16230;Obelėlė;Bičiuliai;3517342646;Taip;19;0;0;19
16231;Obelėlė;Bičiuliai;8757731600;Taip;15;0;3;18
16232;Obelėlė;Bičiuliai;2329734472;Taip;2;0;2;4
16233;Obelėlė;Bičiuliai;1419189517;Taip;0;0;2;2
16234;Obelėlė;Bičiuliai;5933910526;Taip;2;0;2;4
16235;Obelėlė;Bičiuliai;4220808775;Taip;5;5;3;13
16236;Obelėlė;Bičiuliai;8155712451;Ne;0;5;7;12
16237;Obelėlė;Bičiuliai;7934760271;Taip;7;0;9;16
16238;Obelėlė;Bičiuliai;4849175527;Taip;12;0;0;12
16239;Spygliukas;Bitutės;97773415559;Taip;2;0;0;2
16240;Spygliukas;Bitutės;48097650803;Taip;0;1;0;1
16241;Spygliukas;Bitutės;26529424930;Taip;0;1;0;1
16242;Spygliukas;Bitutės;68487983068;Taip;0;0;2;2
16243;Spygliukas;Bitutės;47077562116;Taip;9;5;0;14
16244;Spygliukas;Bitutės;56991221970;Ne;11;7;0;18
16245;Spygliukas;Bitutės;45296663285;Taip;7;0;0;7
16246;Spygliukas;Bitutės;21074122407;Ne;7;0;0;7
16247;Spygliukas;Bitutės;12711940653;Taip;8;5;0;13
16248;Spygliukas;Bitutės;26697357569;Taip;8;1;0;9
16249;Spygliukas;Bitutės;77970187363;Taip;7;0;1;8
16250;Spygliukas;Bitutės;7829656569;Taip;8;0;0;8
16251;Spygliukas;Bitutės;94937084882;Ne;5;0;0;5
16252;Spygliukas;Bitutės;1076152986;Ne;8;0;0;8
16253;Spygliukas;Bitutės;1122973994;Taip;7;0;0;7
16254;Spygliukas;Bitutės;1227595604;Ne;4;3;0;7
16255;Spygliukas;Bitutės;1971162865;Taip;7;5;3;15
16256;Spygliukas;Bitutės;7020789651;Ne;5;5;0;10
16257;Spygliukas;Kiškučiai;9001243644;Taip;5;10;0;15
16258;Spygliukas;Kiškučiai;2058015313;Taip;7;0;0;7
16259;Spygliukas;Kiškučiai;2980459339;Taip;6;2;0;8
16260;Spygliukas;Kiškučiai;4430242310;Taip;7;0;0;7
16261;Spygliukas;Kiškučiai;7250958367;Taip;2;0;0;2
16262;Spygliukas;Kiškučiai;8646122773;Ne;11;3;0;14
16263;Spygliukas;Kiškučiai;1940209166;Ne;8;0;0;8
16264;Spygliukas;Kiškučiai;2935281062;Ne;8;0;1;9
16265;Spygliukas;Kiškučiai;8048474808;Taip;0;5;3;8
16266;Spygliukas;Kiškučiai;1679263120;Taip;0;6;0;6
16267;Spygliukas;Kiškučiai;5022615426;Taip;4;7;0;11
16268;Spygliukas;Kiškučiai;1855897974;Taip;12;0;0;12
16269;Spygliukas;Kiškučiai;1228469923;Ne;5;5;0;10
16270;Spygliukas;Kiškučiai;8103481313;Taip;5;0;6;11
16271;Spygliukas;Kiškučiai;8992822256;Taip;13;1;0;14
16272;Spygliukas;Kiškučiai;7421000718;Taip;6;0;0;6
16273;Spygliukas;Boružėlės;1238940921;Taip;0;6;0;6
16274;Spygliukas;Boružėlės;1163722642;Taip;0;0;1;1
16275;Spygliukas;Boružėlės;9288806012;Taip;0;1;0;1
16276;Spygliukas;Boružėlės;4104158994;Taip;10;0;1;11
16277;Spygliukas;Boružėlės;10858715103;Taip;0;6;0;6
16278;Spygliukas;Boružėlės;1002603766;Taip;11;6;0;17
16279;Spygliukas;Boružėlės;34209607173;Taip;0;0;1;1
16280;Spygliukas;Boružėlės;1842315404;Taip;0;0;1;1
16281;Spygliukas;Boružėlės;73047963456;Taip;0;0;1;1
16282;Spygliukas;Boružėlės;7114613140;Taip;0;2;0;2
16283;Spygliukas;Boružėlės;92279064240;Taip;6;1;0;7
16284;Spygliukas;Boružėlės;1323720621;Taip;0;7;0;7
16285;Spygliukas;Boružėlės;30201229961;Ne;2;1;1;4
16286;Spygliukas;Boružėlės;1321926079;Taip;7;0;3;10
16287;Spygliukas;Boružėlės;9513387087;Ne;0;0;1;1
16288;Spygliukas;Boružėlės;1193015656;Taip;0;0;3;3
16289;Spygliukas;Ežiukai;9593700812;Taip;0;0;1;1
16290;Spygliukas;Ežiukai;1260920726;Ne;13;0;0;13
16291;Spygliukas;Ežiukai;42285404110;Taip;5;0;0;5
16292;Spygliukas;Ežiukai;2040903312;Taip;12;2;0;14
16293;Spygliukas;Ežiukai;3037648954;Taip;0;0;8;8
16294;Spygliukas;Ežiukai;1211969263;Taip;10;3;0;13
16295;Spygliukas;Ežiukai;7219659640;Taip;0;2;0;2
16296;Spygliukas;Ežiukai;1881745347;Taip;5;4;0;9
16297;Spygliukas;Ežiukai;53324066837;Ne;0;2;0;2
16298;Spygliukas;Ežiukai;9957292202;Taip;0;0;1;1
16299;Spygliukas;Ežiukai;1298381738;Taip;1;0;1;2
16300;Spygliukas;Ežiukai;7649832094;Taip;0;1;2;3
16301;Spygliukas;Ežiukai;5780485510;Taip;2;0;0;2
16302;Spygliukas;Ežiukai;8686118262;Taip;4;0;3;7
16303;Spygliukas;Ežiukai;5253108181;Taip;2;1;0;3
16304;Spygliukas;Ežiukai;3785469286;Taip;0;0;2;2
16305;Spygliukas;Ežiukai;29015391754;Taip;0;0;4;4
16306;Spygliukas;Ežiukai;84556142803;Taip;6;8;0;14
16307;Spygliukas;Geniukai;20248450562;Ne;6;3;0;9
16308;Spygliukas;Geniukai;35839138942;Taip;0;6;0;6
16309;Spygliukas;Geniukai;20458611180;Taip;0;0;3;3
16310;Spygliukas;Geniukai;45881077771;Taip;0;13;0;13
16311;Spygliukas;Geniukai;28639466275;Taip;0;0;6;6
16312;Spygliukas;Geniukai;15887839786;Taip;1;1;0;2
16313;Spygliukas;Geniukai;90555084491;Taip;0;5;0;5
16314;Spygliukas;Geniukai;88332181449;Taip;0;1;0;1
16315;Spygliukas;Geniukai;80768950728;Ne;0;4;0;4
16316;Spygliukas;Geniukai;38040423877;Taip;0;6;0;6
16317;Spygliukas;Geniukai;53280907352;Taip;0;0;3;3
16318;Spygliukas;Geniukai;91727550789;Taip;0;1;1;2
16319;Spygliukas;Geniukai;1482370515;Taip;0;7;0;7
16320;Spygliukas;Geniukai;1908975286;Taip;13;0;0;13
16321;Spygliukas;Geniukai;1012592509;Taip;0;2;0;2
16322;Spygliukas;Geniukai;1847162482;Taip;0;10;0;10
16323;Spygliukas;Geniukai;1398592801;Taip;0;0;1;1
16324;Spygliukas;Riešutėliai;88173456147;Taip;0;7;0;7
16325;Spygliukas;Riešutėliai;72370650994;Taip;0;5;0;5
16326;Spygliukas;Riešutėliai;29046559255;Taip;0;0;5;5
16327;Spygliukas;Riešutėliai;61168086526;Taip;6;0;0;6
16328;Spygliukas;Riešutėliai;60381587208;Taip;0;6;0;6
16329;Spygliukas;Riešutėliai;40730123107;Taip;5;0;0;5
16330;Spygliukas;Riešutėliai;75872222695;Taip;0;0;3;3
16331;Spygliukas;Riešutėliai;77665543739;Taip;0;5;0;5
16332;Spygliukas;Riešutėliai;1580382515;Taip;0;5;0;5
16333;Spygliukas;Riešutėliai;4219250715;Ne;9;0;1;10
16334;Spygliukas;Riešutėliai;1429385840;Taip;0;4;0;4
16335;Spygliukas;Pelėdžiukai;91102341053;Taip;5;0;0;5
16336;Spygliukas;Pelėdžiukai;85751149838;Taip;0;0;2;2
16337;Spygliukas;Pelėdžiukai;17541702082;Ne;0;2;0;2
16338;Spygliukas;Pelėdžiukai;20304216159;Taip;0;0;16;16
16339;Spygliukas;Pelėdžiukai;7675515299;Taip;0;3;0;3
16340;Spygliukas;Pelėdžiukai;78680910249;Taip;3;2;0;5
16341;Spygliukas;Pelėdžiukai;88974807409;Taip;2;0;1;3
16342;Spygliukas;Pelėdžiukai;33559493599;Taip;5;0;5;10
16343;Spygliukas;Pelėdžiukai;41129167567;Taip;0;1;0;1
16344;Spygliukas;Pelėdžiukai;54932584770;Taip;2;4;0;6
16345;Spygliukas;Pelėdžiukai;71499872240;Taip;0;0;2;2
16346;Spygliukas;Pelėdžiukai;31918025260;Taip;0;6;0;6
16347;Spygliukas;Pelėdžiukai;57098709793;Taip;0;1;0;1
16348;Spygliukas;Pelėdžiukai;96967766273;Taip;0;1;0;1
16349;Spygliukas;Pelėdžiukai;1447408559;Taip;0;2;0;2
16350;Spygliukas;Pelėdžiukai;63899991046;Taip;0;4;0;4
16351;Spygliukas;Pelėdžiukai;8252228033;Taip;3;0;4;7
16352;Spygliukas;Pelėdžiukai;67896776952;Taip;6;2;0;8
16353;Spygliukas;Zylutės;6242194100;Taip;5;0;3;8
16354;Spygliukas;Zylutės;5962360012;Taip;0;1;0;1
16355;Spygliukas;Zylutės;2739564216;Taip;0;0;3;3
16356;Spygliukas;Zylutės;4721066953;Taip;17;0;1;18
16357;Spygliukas;Zylutės;7900652746;Taip;0;3;0;3
16358;Spygliukas;Zylutės;4949371837;Taip;12;0;0;12
16359;Spygliukas;Zylutės;6457632191;Ne;22;0;0;22
16360;Spygliukas;Zylutės;4650693672;Taip;12;0;1;13
16361;Spygliukas;Zylutės;9178184431;Taip;3;0;0;3
16362;Spygliukas;Zylutės;1691209405;Taip;8;0;0;8
16363;Spygliukas;Zylutės;4577592862;Ne;8;0;2;10
16364;Spygliukas;Zylutės;4610504338;Taip;2;0;2;4
16365;Spygliukas;Zylutės;6835488489;Taip;0;20;0;20
16366;Spygliukas;Zylutės;3365209400;Ne;0;10;5;15
16367;Spygliukas;Zylutės;3658613027;Ne;5;0;3;8
16368;Spygliukas;Skruzdėliukai;5561426508;Taip;15;0;0;15
16369;Spygliukas;Skruzdėliukai;2177856916;Taip;10;0;0;10
16370;Spygliukas;Skruzdėliukai;8825264090;Taip;5;4;3;12
16371;Spygliukas;Skruzdėliukai;8404929784;Taip;12;0;0;12
16372;Spygliukas;Skruzdėliukai;6931145017;Taip;14;0;2;16
16373;Spygliukas;Skruzdėliukai;3041184642;Taip;0;0;1;1
16374;Spygliukas;Skruzdėliukai;9070219319;Taip;0;11;0;11
16375;Spygliukas;Skruzdėliukai;9285259322;Taip;0;0;2;2
16376;Spygliukas;Skruzdėliukai;8806126755;Taip;12;0;1;13
16377;Spygliukas;Skruzdėliukai;8476882854;Taip;17;1;0;18
16378;Spygliukas;Skruzdėliukai;4245624629;Taip;0;5;2;7
16379;Spygliukas;Skruzdėliukai;6332646009;Taip;8;0;0;8
16380;Spygliukas;Skruzdėliukai;3706443395;Taip;6;0;0;6
16381;Spygliukas;Skruzdėliukai;9112172144;Ne;11;0;1;12
16382;Spygliukas;Skruzdėliukai;2395961015;Taip;0;8;0;8
16383;Spygliukas;Voveraitės;5049529300;Taip;0;0;2;2
16384;Spygliukas;Voveraitės;1367964100;Taip;0;5;0;5
16385;Spygliukas;Voveraitės;1773639994;Taip;0;5;2;7
16386;Spygliukas;Voveraitės;2066739772;Taip;0;0;4;4
16387;Spygliukas;Voveraitės;8596667547;Ne;0;0;8;8
16388;Spygliukas;Voveraitės;1042495269;Taip;0;0;1;1
16389;Spygliukas;Voveraitės;1590677993;Taip;19;0;1;20
16390;Spygliukas;Voveraitės;1030973848;Taip;0;4;1;5
16391;Spygliukas;Voveraitės;1935233612;Ne;0;7;0;7
16392;Spygliukas;Voveraitės;8801225066;Taip;0;0;2;2
16393;Spygliukas;Voveraitės;8453683673;Ne;0;0;4;4
16394;Spygliukas;Voveraitės;16828631895;Taip;0;0;5;5
16395;Spygliukas;Voveraitės;4653108810;Ne;0;8;0;8
16396;Spygliukas;Voveraitės;1045253540;Taip;4;0;3;7
16397;Spygliukas;Voveraitės;2671842885;Taip;0;0;1;1
16398;Spygliukas;Voveraitės;6460911796;Taip;13;0;1;14
16399;Spygliukas;Giliukų;7271659513;Taip;0;7;0;7
16400;Spygliukas;Giliukų;8708083787;Taip;8;7;0;15
16401;Spygliukas;Giliukų;9413950200;Taip;12;0;0;12
16402;Spygliukas;Giliukų;1664878188;Taip;7;1;0;8
16403;Spygliukas;Giliukų;4634660174;Taip;0;0;1;1
16404;Spygliukas;Giliukų;4368224847;Taip;11;0;0;11
16405;Spygliukas;Giliukų;1333556956;Taip;0;0;2;2
16406;Spygliukas;Giliukų;9316731983;Taip;13;0;0;13
16407;Spygliukas;Giliukų;5012876830;Taip;3;0;3;6
16408;Spygliukas;Giliukų;2315421636;Taip;0;5;0;5
16409;Spygliukas;Giliukų;7125425492;Taip;5;0;4;9
16410;Spygliukas;Giliukų;7928675053;Taip;0;0;1;1
16411;Spygliukas;Giliukų;2989701249;Taip;22;0;0;22
16412;Vieversys;Žirniukai;1149316471;Taip;0;7;0;7
16413;Vieversys;Žirniukai;1728554204;Taip;12;0;0;12
16414;Vieversys;Žirniukai;6787960120;Taip;6;0;0;6
16415;Vieversys;Žirniukai;9612415733;Taip;15;1;0;16
16416;Vieversys;Žirniukai;5917328379;Taip;22;0;0;22
16417;Vieversys;Žirniukai;53977164888;Taip;7;1;0;8
16418;Vieversys;Žirniukai;82594887399;Taip;12;0;0;12
16419;Vieversys;Žirniukai;7500147648;Taip;10;1;0;11
16420;Vieversys;Žirniukai;2621046003;Taip;11;0;2;13
16421;Vieversys;Žirniukai;9835682858;Taip;0;15;0;15
16422;Vieversys;Žirniukai;6596979763;Taip;3;2;0;5
16423;Vieversys;Žirniukai;5286521728;Taip;4;13;0;17
16424;Vieversys;Žirniukai;8038341998;Taip;6;2;0;8
16425;Vieversys;Žirniukai;1247565595;Taip;0;1;0;1
16426;Vieversys;Žirniukai;6720355390;Taip;16;0;0;16
16427;Vieversys;Žirniukai;4313822180;Taip;6;0;0;6
16428;Vieversys;Žirniukai;7812227428;Taip;0;7;0;7
16429;Vieversys;Žirniukai;5810605263;Taip;0;0;3;3
16430;Vieversys;Varpelių;28104354125;Taip;0;3;0;3
16431;Vieversys;Varpelių;38299255111;Taip;0;7;0;7
16432;Vieversys;Varpelių;62353706235;Taip;0;10;0;10
16433;Vieversys;Varpelių;77923009476;Ne;8;0;0;8
16434;Vieversys;Varpelių;45357053527;Taip;0;11;0;11
16435;Vieversys;Varpelių;14996772979;Taip;0;1;0;1
16436;Vieversys;Varpelių;44390886220;Taip;0;13;0;13
16437;Vieversys;Varpelių;46546501255;Taip;0;1;0;1
16438;Vieversys;Varpelių;82621820592;Ne;0;7;0;7
16439;Vieversys;Varpelių;7125531057;Taip;0;1;0;1
16440;Vieversys;Varpelių;22124989131;Taip;0;3;0;3
16441;Vieversys;Varpelių;47592438021;Taip;6;0;0;6
16442;Vieversys;Varpelių;69205152313;Taip;9;1;0;10
16443;Vieversys;Varpelių;24253818919;Ne;8;3;0;11
16444;Vieversys;Varpelių;12049674063;Taip;5;0;0;5
16445;Vieversys;Varpelių;27238159965;Taip;0;1;0;1
16446;Vieversys;Kiškučių;30327960835;Taip;0;1;0;1
16447;Vieversys;Kiškučių;39075572706;Taip;0;2;0;2
16448;Vieversys;Kiškučių;96715131735;Ne;2;0;6;8
16449;Vieversys;Kiškučių;64744067804;Taip;0;1;7;8
16450;Vieversys;Kiškučių;14962042306;Taip;0;5;0;5
16451;Vieversys;Kiškučių;66729897399;Ne;0;3;6;9
16452;Vieversys;Kiškučių;1718832864;Taip;0;1;0;1
16453;Vieversys;Kiškučių;1013523504;Taip;0;0;3;3
16454;Vieversys;Kiškučių;2880573300;Taip;0;12;0;12
16455;Vieversys;Kiškučių;27461921981;Taip;0;4;0;4
16456;Vieversys;Kiškučių;1239896208;Taip;0;4;0;4
16457;Vieversys;Kiškučių;1076420513;Taip;0;0;4;4
16458;Vieversys;Kiškučių;9869051482;Taip;0;1;1;2
16459;Vieversys;Kiškučių;1685871173;Taip;0;3;3;6
16460;Vieversys;Kiškučių;6589649248;Taip;4;3;0;7
16461;Vieversys;Kiškučių;6241670100;Ne;0;2;1;3
16462;Vieversys;Kiškučių;9050145547;Taip;6;0;0;6
16463;Vieversys;Kiškučių;9126904852;Taip;6;3;0;9
16464;Vieversys;Kiškučių;70851901929;Taip;0;1;0;1
16465;Vieversys;Kiškučių;32507428250;Taip;0;3;0;3
16466;Vieversys;Kiškučių;55017305306;Taip;0;1;0;1
16467;Vieversys;Pelėdžiukų;8421719030;Taip;0;1;1;2
16468;Vieversys;Pelėdžiukų;94463134058;Taip;0;22;0;22
16469;Vieversys;Pelėdžiukų;5434952733;Taip;17;0;0;17
16470;Vieversys;Pelėdžiukų;7578552471;Taip;0;6;0;6
16471;Vieversys;Pelėdžiukų;2193074123;Taip;21;0;0;21
16472;Vieversys;Pelėdžiukų;6314183312;Taip;0;22;0;22
16473;Vieversys;Pelėdžiukų;7007620994;Taip;11;0;4;15
16474;Vieversys;Pelėdžiukų;9499315463;Taip;12;0;0;12
16475;Vieversys;Pelėdžiukų;9774365819;Taip;8;2;0;10
16476;Vieversys;Pelėdžiukų;9494957750;Taip;5;0;0;5
16477;Vieversys;Pelėdžiukų;2521488728;Taip;5;2;0;7
16478;Vieversys;Pelėdžiukų;6473759470;Taip;7;4;0;11
16479;Vieversys;Pelėdžiukų;1120594293;Taip;0;0;2;2
16480;Vieversys;Pelėdžiukų;1273951001;Taip;8;11;2;21
16481;Vieversys;Pelėdžiukų;48430863473;Taip;10;12;0;22
16482;Vieversys;Pelėdžiukų;50181034746;Taip;11;0;0;11
16483;Vieversys;Pelėdžiukų;52420072025;Taip;0;0;4;4
16484;Vieversys;Pelėdžiukų;1338476746;Taip;0;7;0;7
16485;Vieversys;Pelėdžiukų;1027693153;Taip;16;4;0;20
16486;Vieversys;Pelėdžiukų;5871715452;Taip;9;0;0;9
16487;Vieversys;Pelėdžiukų;7676796264;Taip;5;7;0;12
16488;Vieversys;Pelėdžiukų;9659337657;Taip;21;0;0;21
16489;Vieversys;Pelėdžiukų;3458399180;Taip;8;5;0;13
16490;Vieversys;Saulučių;1541501314;Taip;0;8;0;8
16491;Vieversys;Saulučių;7570842283;Ne;0;9;0;9
16492;Vieversys;Saulučių;61390281978;Taip;0;0;4;4
16493;Vieversys;Saulučių;1061337795;Taip;2;11;1;14
16494;Vieversys;Saulučių;9504543902;Taip;12;0;3;15
16495;Vieversys;Saulučių;1015724611;Taip;12;0;3;15
16496;Vieversys;Saulučių;85223909900;Ne;0;17;0;17
16497;Vieversys;Saulučių;63958110408;Ne;0;7;0;7
16498;Vieversys;Saulučių;27991039593;Taip;0;4;0;4
16499;Vieversys;Saulučių;53189421149;Taip;0;0;2;2
16500;Vieversys;Saulučių;49209207608;Taip;0;11;0;11
16501;Vieversys;Saulučių;94076718641;Taip;0;2;0;2
16502;Vieversys;Saulučių;95352162960;Taip;5;8;0;13
16503;Vieversys;Saulučių;81494754248;Taip;11;1;0;12
16504;Vieversys;Saulučių;12419984038;Taip;0;1;12;13
16505;Vieversys;Saulučių;18608150261;Taip;0;10;0;10
16506;Vieversys;Saulučių;81766053731;Taip;5;2;0;7
16507;Vieversys;Saulučių;1734336095;Taip;14;0;0;14
16508;Vieversys;Saulučių;67610801335;Taip;3;6;0;9
16509;Vieversys;Kregždučių;55553505459;Taip;0;4;0;4
16510;Vieversys;Kregždučių;16002848795;Taip;0;4;0;4
16511;Vieversys;Kregždučių;1933907389;Taip;0;0;1;1
16512;Vieversys;Kregždučių;1462608187;Ne;5;2;0;7
16513;Vieversys;Kregždučių;2130449373;Taip;0;11;0;11
16514;Vieversys;Kregždučių;44086673096;Taip;0;1;0;1
16515;Vieversys;Kregždučių;89223502405;Taip;7;3;0;10
16516;Vieversys;Kregždučių;41215224179;Taip;16;1;2;19
16517;Vieversys;Kregždučių;938801303;Taip;0;3;0;3
16518;Vieversys;Kregždučių;2141967793;Taip;0;5;0;5
16519;Vieversys;Kregždučių;2128428329;Taip;0;5;0;5
16520;Vieversys;Kregždučių;1190396975;Taip;0;4;0;4
16521;Vieversys;Kregždučių;62465517391;Taip;0;3;0;3
16522;Vieversys;Kregždučių;5123994167;Taip;5;0;0;5
16523;Vieversys;Kregždučių;1300013110;Taip;0;1;0;1
16524;Vieversys;Kregždučių;61101237391;Taip;7;2;0;9
16525;Vieversys;Kregždučių;1716198618;Taip;0;4;0;4
16526;Vieversys;Kregždučių;8213134622;Taip;10;0;3;13
16527;Vieversys;Kregždučių;2879546284;Taip;0;0;4;4
16528;Vieversys;Kregždučių;3839507103;Taip;0;1;0;1
16529;Vieversys;Kregždučių;6077365803;Taip;3;0;2;5
16530;Vieversys;Kregždučių;46624143347;Taip;15;0;1;16
16531;Vieversys;Boružėlių;6236703869;Taip;0;1;0;1
16532;Vieversys;Boružėlių;1815073796;Taip;0;1;0;1
16533;Vieversys;Boružėlių;32630544785;Taip;5;0;0;5
16534;Vieversys;Boružėlių;20960056744;Taip;6;8;0;14
16535;Vieversys;Boružėlių;63262366859;Taip;10;0;0;10
16536;Vieversys;Boružėlių;58287759954;Taip;0;0;1;1
16537;Vieversys;Boružėlių;1580917200;Taip;2;8;0;10
16538;Vieversys;Boružėlių;86213464121;Taip;4;1;0;5
16539;Vieversys;Boružėlių;55764266970;Taip;2;0;0;2
16540;Vieversys;Boružėlių;86119860485;Taip;3;0;0;3
16541;Vieversys;Boružėlių;57223617591;Taip;5;0;0;5
16542;Vieversys;Boružėlių;1028950997;Taip;1;0;8;9
16543;Vieversys;Boružėlių;14574836082;Ne;4;1;0;5
16544;Vieversys;Boružėlių;95886969053;Taip;5;0;0;5
16545;Vieversys;Boružėlių;5197639355;Taip;1;1;0;2
16546;Vieversys;Boružėlių;15473504836;Taip;5;0;2;7
16547;Vieversys;Boružėlių;8744701209;Taip;6;2;0;8
16548;Vieversys;Boružėlių;50192413803;Taip;6;0;1;7
16549;Vieversys;Boružėlių;1700010494;Taip;0;7;0;7
16550;Vieversys;Boružėlių;1715902540;Taip;0;4;0;4
16551;Vieversys;Bitučių;75434941104;Taip;3;0;0;3
16552;Vieversys;Bitučių;25198979253;Taip;0;1;1;2
16553;Vieversys;Bitučių;2034386236;Taip;0;19;0;19
16554;Vieversys;Bitučių;83420473111;Taip;0;4;0;4
16555;Vieversys;Bitučių;22717987850;Taip;10;5;0;15
16556;Vieversys;Bitučių;26092685300;Taip;0;15;0;15
16557;Vieversys;Bitučių;93582609868;Taip;0;0;1;1
16558;Vieversys;Bitučių;22275121492;Taip;5;8;0;13
16559;Vieversys;Bitučių;35144734547;Taip;0;2;3;5
16560;Vieversys;Bitučių;34494816770;Taip;0;0;1;1
16561;Vieversys;Bitučių;27123496741;Taip;0;7;0;7
16562;Vieversys;Bitučių;66155667200;Taip;0;2;2;4
16563;Vieversys;Bitučių;7126970560;Taip;0;1;0;1
16564;Vieversys;Bitučių;61951858540;Taip;0;1;0;1
16565;Vieversys;Bitučių;5157022077;Taip;0;6;1;7
16566;Vieversys;Bitučių;1371669237;Taip;0;4;0;4
16567;Vieversys;Smalsučių;1307701524;Taip;0;4;0;4
16568;Vieversys;Smalsučių;89564962534;Taip;5;7;1;13
16569;Vieversys;Smalsučių;8966153890;Taip;7;2;0;9
16570;Vieversys;Smalsučių;65696183376;Taip;5;1;5;11
16571;Vieversys;Smalsučių;50929651251;Taip;0;1;0;1
16572;Vieversys;Smalsučių;65625227882;Taip;0;4;0;4
16573;Vieversys;Smalsučių;29002693436;Taip;0;0;3;3
16574;Vieversys;Smalsučių;41282339758;Taip;0;10;0;10
16575;Vieversys;Smalsučių;72475350152;Taip;9;0;0;9
16576;Vieversys;Smalsučių;61074394922;Taip;10;5;0;15
16577;Vieversys;Smalsučių;11528430680;Taip;0;1;0;1
16578;Vieversys;Smalsučių;67471794738;Taip;0;1;0;1
16579;Vieversys;Smalsučių;13768739410;Taip;0;1;0;1
16580;Vieversys;Smalsučių;79197759451;Taip;8;4;0;12
16581;Vieversys;Smalsučių;6427430220;Ne;0;0;21;21
16582;Vieversys;Smalsučių;2010825247;Taip;0;2;20;22
16583;Vieversys;Smalsučių;2561825171;Taip;0;0;3;3
16584;Vieversys;Smalsučių;1025794194;Taip;0;10;3;13
16585;Vieversys;Kodėlčiukų;16928192553;Taip;0;12;0;12
16586;Vieversys;Kodėlčiukų;42562816168;Taip;6;0;6;12
16587;Vieversys;Kodėlčiukų;2756075736;Taip;3;2;0;5
16588;Vieversys;Kodėlčiukų;69275621813;Taip;5;12;2;19
16589;Vieversys;Kodėlčiukų;1455615413;Taip;14;0;0;14
16590;Vieversys;Kodėlčiukų;1970088958;Taip;15;5;0;20
16591;Vieversys;Kodėlčiukų;1586720551;Taip;2;0;0;2
16592;Vieversys;Kodėlčiukų;9012978017;Taip;0;6;0;6
16593;Vieversys;Kodėlčiukų;1738313365;Taip;0;17;0;17
16594;Vieversys;Kodėlčiukų;1766638116;Taip;5;10;2;17
16595;Vieversys;Kodėlčiukų;1599787985;Taip;6;0;3;9
16596;Vieversys;Kodėlčiukų;1491424075;Taip;6;0;4;10
16597;Vieversys;Kodėlčiukų;1361494430;Taip;10;0;4;14
16598;Vieversys;Kodėlčiukų;9829388743;Taip;0;10;0;10
16599;Vieversys;Kodėlčiukų;1878278158;Taip;0;2;0;2
16600;Vieversys;Kodėlčiukų;7315438787;Taip;0;5;0;5
16601;Vieversys;Kodėlčiukų;16617102917;Taip;0;0;4;4
16602;Vieversys;Kodėlčiukų;93675768307;Taip;0;4;0;4
16603;Vieversys;Kodėlčiukų;3792076932;Taip;11;0;0;11
16604;Vieversys;NYKŠTUKAI;5769453869;Taip;5;1;0;6
16605;Vieversys;NYKŠTUKAI;3917758713;Taip;0;5;0;5
16606;Vieversys;NYKŠTUKAI;9164615794;Taip;7;2;0;9
16607;Vieversys;NYKŠTUKAI;2096514775;Taip;10;0;0;10
16608;Vieversys;NYKŠTUKAI;3684937630;Taip;5;0;0;5
16609;Vieversys;NYKŠTUKAI;6563139211;Taip;0;2;0;2
16610;Vieversys;NYKŠTUKAI;4294676988;Taip;11;0;0;11
16611;Vieversys;NYKŠTUKAI;4835022593;Taip;11;0;0;11
16612;Vieversys;NYKŠTUKAI;4778339658;Taip;15;3;0;18
16613;Vieversys;NYKŠTUKAI;3249717073;Taip;17;0;0;17
16614;Vieversys;NYKŠTUKAI;7120329258;Taip;0;4;0;4
16615;Vieversys;NYKŠTUKAI;9387421639;Taip;7;7;0;14
16616;Vieversys;NYKŠTUKAI;8174124875;Taip;17;0;0;17
16617;Vieversys;NYKŠTUKAI;4187114865;Taip;11;1;0;12
16618;Vieversys;DRUGELIAI;4024758152;Taip;0;3;0;3
16619;Vieversys;DRUGELIAI;6194712643;Taip;0;3;0;3
16620;Vieversys;DRUGELIAI;3405502715;Taip;5;0;0;5
16621;Vieversys;DRUGELIAI;6127272124;Taip;9;0;0;9
16622;Vieversys;DRUGELIAI;5654533451;Taip;0;0;5;5
16623;Vieversys;DRUGELIAI;9972526744;Ne;8;0;0;8
16624;Vieversys;DRUGELIAI;9985374057;Taip;12;0;0;12
16625;Vieversys;DRUGELIAI;7998100115;Taip;0;12;0;12
16626;Vieversys;DRUGELIAI;6110034652;Taip;7;0;1;8
16627;Vieversys;DRUGELIAI;2663322242;Ne;10;0;0;10
16628;Vieversys;DRUGELIAI;7596355010;Taip;0;14;0;14
16629;Vieversys;DRUGELIAI;9308040716;Taip;8;0;0;8
16630;Vieversys;DRUGELIAI;4741252829;Taip;8;0;0;8
16631;Vieversys;DRUGELIAI;4072323869;Taip;9;0;0;9
16632;Vieversys;DRUGELIAI;1931955562;Taip;0;16;0;16
16633;Žirmūnėliai;SAULUTĖS;8030469722;Taip;0;4;0;4
16634;Žirmūnėliai;SAULUTĖS;73664204182;Taip;3;0;0;3
16635;Žirmūnėliai;SAULUTĖS;1725143117;Taip;12;0;0;12
16636;Žirmūnėliai;SAULUTĖS;1073135587;Taip;0;9;0;9
16637;Žirmūnėliai;SAULUTĖS;4598761492;Taip;0;7;0;7
16638;Žirmūnėliai;SAULUTĖS;3128190518;Taip;2;0;0;2
16639;Žirmūnėliai;SAULUTĖS;7562464310;Taip;17;0;0;17
16640;Žirmūnėliai;SAULUTĖS;1478039469;Taip;0;9;0;9
16641;Žirmūnėliai;SAULUTĖS;6896145409;Taip;10;0;0;10
16642;Žirmūnėliai;SAULUTĖS;1255857051;Taip;0;5;0;5
16643;Žirmūnėliai;SAULUTĖS;5009619812;Taip;0;2;0;2
16644;Žirmūnėliai;SAULUTĖS;1582563837;Taip;5;5;5;15
16645;Žirmūnėliai;SAULUTĖS;1381923106;Taip;0;4;0;4
16646;Žirmūnėliai;SAULUTĖS;5037669167;Taip;10;0;2;12
16647;Žirmūnėliai;SAULUTĖS;1761284228;Taip;0;0;3;3
16648;Žirmūnėliai;SAULUTĖS;1894070647;Taip;0;8;0;8
16649;Žirmūnėliai;SAULUTĖS;1347664230;Taip;10;0;0;10
16650;Žirmūnėliai;GILIUKAI;37231106844;Taip;10;0;0;10
16651;Žirmūnėliai;GILIUKAI;5673929155;Taip;0;1;0;1
16652;Žirmūnėliai;GILIUKAI;50829749038;Taip;6;0;0;6
16653;Žirmūnėliai;GILIUKAI;68678277635;Taip;0;9;0;9
16654;Žirmūnėliai;GILIUKAI;1401250193;Taip;6;0;0;6
16655;Žirmūnėliai;GILIUKAI;1818060330;Taip;3;5;0;8
16656;Žirmūnėliai;GILIUKAI;1963980356;Taip;8;0;0;8
16657;Žirmūnėliai;GILIUKAI;1302040861;Ne;0;2;1;3
16658;Žirmūnėliai;GILIUKAI;17294365627;Taip;13;0;1;14
16659;Žirmūnėliai;GILIUKAI;99546532431;Taip;7;0;0;7
16660;Žirmūnėliai;GILIUKAI;1816123753;Taip;0;1;0;1
16661;Žirmūnėliai;GILIUKAI;1308593517;Taip;1;1;0;2
16662;Žirmūnėliai;GILIUKAI;53028161711;Taip;2;5;0;7
16663;Žirmūnėliai;GILIUKAI;6578685370;Ne;20;0;0;20
16664;Žirmūnėliai;GILIUKAI;1493536049;Taip;8;1;0;9
16665;Žirmūnėliai;GILIUKAI;1626619024;Taip;0;3;1;4
16666;Žirmūnėliai;GILIUKAI;8824743884;Taip;0;1;0;1
16667;Žirmūnėliai;GILIUKAI;1039316424;Taip;5;2;0;7
16668;Žirmūnėliai;GILIUKAI;1556389237;Taip;6;1;0;7
16669;Žirmūnėliai;GILIUKAI;1764226619;Taip;6;0;0;6
16670;Žirmūnėliai;DAINORĖLIAI;31231655300;Taip;0;0;19;19
16671;Žirmūnėliai;DAINORĖLIAI;1563132542;Taip;0;0;11;11
16672;Žirmūnėliai;DAINORĖLIAI;1235090013;Taip;14;6;0;20
16673;Žirmūnėliai;DAINORĖLIAI;6274222785;Taip;0;0;3;3
16674;Žirmūnėliai;DAINORĖLIAI;1395294607;Taip;0;0;2;2
16675;Žirmūnėliai;DAINORĖLIAI;7777166572;Taip;0;2;0;2
16676;Žirmūnėliai;DAINORĖLIAI;4136421440;Taip;0;9;0;9
16677;Žirmūnėliai;DAINORĖLIAI;36822027549;Taip;0;0;12;12
16678;Žirmūnėliai;DAINORĖLIAI;22385656372;Taip;0;1;0;1
16679;Žirmūnėliai;DAINORĖLIAI;33296480709;Taip;0;0;3;3
16680;Žirmūnėliai;DAINORĖLIAI;58158145123;Taip;0;0;2;2
16681;Žirmūnėliai;DAINORĖLIAI;1302022463;Taip;0;1;0;1
16682;Žirmūnėliai;DAINORĖLIAI;1017903291;Ne;0;9;0;9
16683;Žirmūnėliai;DAINORĖLIAI;52524235797;Taip;0;0;1;1
16684;Žirmūnėliai;DAINORĖLIAI;5450253994;Taip;10;0;1;11
16685;Žirmūnėliai;DAINORĖLIAI;97123184267;Ne;0;0;3;3
16686;Žirmūnėliai;DAINORĖLIAI;81408646754;Taip;0;10;0;10
16687;Žirmūnėliai;DAINORĖLIAI;67024451309;Taip;6;0;0;6
16688;Žirmūnėliai;DAINORĖLIAI;87693490164;Taip;5;0;17;22
16689;Žirmūnėliai;DAINORĖLIAI;39347099487;Taip;0;3;0;3
16690;Žirmūnėliai;DRUGELIAI;5276699877;Taip;7;0;0;7
16691;Žirmūnėliai;DRUGELIAI;57457297276;Taip;0;2;0;2
16692;Žirmūnėliai;DRUGELIAI;20851917855;Taip;0;15;0;15
16693;Žirmūnėliai;DRUGELIAI;12766765793;Taip;0;1;0;1
16694;Žirmūnėliai;DRUGELIAI;51268874840;Taip;0;1;0;1
16695;Žirmūnėliai;DRUGELIAI;34205058356;Taip;5;0;0;5
16696;Žirmūnėliai;DRUGELIAI;65010448998;Taip;0;1;2;3
16697;Žirmūnėliai;DRUGELIAI;45541156029;Taip;0;3;3;6
16698;Žirmūnėliai;DRUGELIAI;20902834369;Taip;0;2;0;2
16699;Žirmūnėliai;DRUGELIAI;63972399637;Taip;0;2;0;2
16700;Žirmūnėliai;DRUGELIAI;33441696614;Taip;0;0;4;4
16701;Žirmūnėliai;DRUGELIAI;96121856269;Taip;0;1;0;1
16702;Žirmūnėliai;DRUGELIAI;86142962074;Taip;5;0;0;5
16703;Žirmūnėliai;DRUGELIAI;32213803056;Taip;0;3;0;3
16704;Žirmūnėliai;DRUGELIAI;61531418513;Taip;0;2;0;2
16705;Žirmūnėliai;DRUGELIAI;1157270725;Taip;0;10;0;10
16706;Žirmūnėliai;DRUGELIAI;1914464845;Taip;0;1;1;2
16707;Žirmūnėliai;BORUŽIUKAI;78370998321;Ne;0;10;0;10
16708;Žirmūnėliai;BORUŽIUKAI;1035797918;Ne;0;2;1;3
16709;Žirmūnėliai;BORUŽIUKAI;18304538215;Taip;2;0;0;2
16710;Žirmūnėliai;BORUŽIUKAI;95773705800;Taip;0;5;5;10
16711;Žirmūnėliai;BORUŽIUKAI;90766071337;Taip;0;14;0;14
16712;Žirmūnėliai;BORUŽIUKAI;15975463125;Taip;0;2;0;2
16713;Žirmūnėliai;BORUŽIUKAI;1657682030;Taip;0;0;3;3
16714;Žirmūnėliai;BORUŽIUKAI;50544167833;Taip;0;1;0;1
16715;Žirmūnėliai;BORUŽIUKAI;80136538031;Taip;0;8;0;8
16716;Žirmūnėliai;BORUŽIUKAI;85416619940;Taip;0;2;1;3
16717;Žirmūnėliai;BORUŽIUKAI;21555650432;Ne;0;1;2;3
16718;Žirmūnėliai;BORUŽIUKAI;74577288891;Taip;0;0;1;1
16719;Žirmūnėliai;BORUŽIUKAI;66321657576;Taip;0;1;1;2
16720;Žirmūnėliai;BORUŽIUKAI;86703668087;Ne;6;2;0;8
16721;Žirmūnėliai;BORUŽIUKAI;53551605972;Taip;0;7;1;8
16722;Žirmūnėliai;BORUŽIUKAI;39102695648;Ne;0;9;0;9
16723;Žirmūnėliai;EŽIUKAI;92309760554;Taip;0;1;3;4
16724;Žirmūnėliai;EŽIUKAI;44456428269;Taip;9;0;1;10
16725;Žirmūnėliai;EŽIUKAI;35616673148;Taip;0;2;0;2
16726;Žirmūnėliai;EŽIUKAI;54806598855;Taip;0;3;0;3
16727;Žirmūnėliai;EŽIUKAI;46197353715;Taip;0;2;0;2
16728;Žirmūnėliai;EŽIUKAI;17545423567;Taip;2;0;0;2
16729;Žirmūnėliai;EŽIUKAI;52242309849;Taip;0;1;0;1
16730;Žirmūnėliai;EŽIUKAI;20369719665;Taip;0;0;1;1
16731;Žirmūnėliai;EŽIUKAI;16233364560;Taip;0;3;0;3
16732;Žirmūnėliai;EŽIUKAI;33734698275;Ne;0;1;2;3
16733;Žirmūnėliai;EŽIUKAI;83168188715;Taip;0;13;0;13
16734;Žirmūnėliai;EŽIUKAI;61198138773;Taip;0;1;0;1
16735;Žirmūnėliai;ŽVIRBLIUKAI;19423526288;Taip;0;12;0;12
16736;Žirmūnėliai;ŽVIRBLIUKAI;15705213099;Taip;7;2;0;9
16737;Žirmūnėliai;ŽVIRBLIUKAI;60871701395;Taip;0;2;0;2
16738;Žirmūnėliai;ŽVIRBLIUKAI;30822135334;Taip;0;1;0;1
16739;Žirmūnėliai;ŽVIRBLIUKAI;55413493068;Taip;9;3;0;12
16740;Žirmūnėliai;ŽVIRBLIUKAI;77610647849;Taip;0;2;0;2
16741;Žirmūnėliai;ŽVIRBLIUKAI;39786518345;Taip;8;0;1;9
16742;Žirmūnėliai;ŽVIRBLIUKAI;53003464638;Taip;8;0;0;8
16743;Žirmūnėliai;ŽVIRBLIUKAI;49856210236;Taip;10;1;0;11
16744;Žirmūnėliai;ŽVIRBLIUKAI;1150419333;Taip;6;0;0;6
16745;Žirmūnėliai;ŽVIRBLIUKAI;6262600436;Taip;0;2;0;2
16746;Žirmūnėliai;ŽVIRBLIUKAI;73552867802;Taip;0;2;0;2
16747;Žirmūnėliai;ŽVIRBLIUKAI;1492168972;Taip;0;0;1;1
16748;Žirmūnėliai;ŽVIRBLIUKAI;38316483993;Taip;6;0;0;6
16749;Žirmūnėliai;ŽVIRBLIUKAI;1250060420;Taip;5;0;1;6
16750;Žirmūnėliai;ŽVIRBLIUKAI;1477593223;Ne;0;4;0;4
16751;Žirmūnėliai;ŽVIRBLIUKAI;3896978775;Taip;7;0;2;9
16752;Žirmūnėliai;ŽVIRBLIUKAI;7165846395;Taip;10;2;2;14
16753;Žirmūnėliai;ŽVIRBLIUKAI;1049041500;Taip;7;0;0;7
16754;Žirmūnėliai;ŽVIRBLIUKAI;50088185187;Taip;0;5;0;5
16755;Žirmūnėliai;SPALVELĖS;1634724759;Taip;0;1;0;1
16756;Žirmūnėliai;SPALVELĖS;88436070676;Taip;0;2;3;5
16757;Žirmūnėliai;SPALVELĖS;18266666204;Taip;0;1;0;1
16758;Žirmūnėliai;SPALVELĖS;2538608908;Taip;0;5;0;5
16759;Žirmūnėliai;SPALVELĖS;22592450568;Taip;0;5;0;5
16760;Žirmūnėliai;SPALVELĖS;66100956443;Taip;0;0;1;1
16761;Žirmūnėliai;SPALVELĖS;85286691926;Taip;4;9;0;13
16762;Žirmūnėliai;SPALVELĖS;3691651489;Taip;3;7;5;15
16763;Žirmūnėliai;SPALVELĖS;1120531178;Taip;4;0;0;4
16764;Žirmūnėliai;SPALVELĖS;1273301982;Taip;14;0;1;15
16765;Žirmūnėliai;SPALVELĖS;29952298800;Taip;7;0;0;7
16766;Žirmūnėliai;SPALVELĖS;1080735912;Taip;5;5;0;10
16767;Žirmūnėliai;SPALVELĖS;2127930970;Taip;5;3;0;8
16768;Žirmūnėliai;SPALVELĖS;3150467744;Ne;0;0;2;2
16769;Žirmūnėliai;SPALVELĖS;4710829908;Taip;0;2;0;2
16770;Žirmūnėliai;SPALVELĖS;1865240339;Taip;0;2;0;2
16771;Žirmūnėliai;SPALVELĖS;51723882387;Taip;7;2;0;9
16772;Žirmūnėliai;SPALVELĖS;8308074932;Taip;0;3;0;3
16773;Žirmūnėliai;DEBESĖLIAI;37429281370;Taip;0;1;3;4
16774;Žirmūnėliai;DEBESĖLIAI;19044383213;Taip;0;0;4;4
16775;Žirmūnėliai;DEBESĖLIAI;76779474158;Taip;22;0;0;22
16776;Žirmūnėliai;DEBESĖLIAI;18242077086;Taip;15;0;0;15
16777;Žirmūnėliai;DEBESĖLIAI;99393944540;Taip;0;4;0;4
16778;Žirmūnėliai;DEBESĖLIAI;64969220116;Taip;0;18;0;18
16779;Žirmūnėliai;DEBESĖLIAI;1542147528;Taip;8;0;0;8
16780;Žirmūnėliai;DEBESĖLIAI;5527904792;Taip;0;13;0;13
16781;Žirmūnėliai;DEBESĖLIAI;77024387002;Taip;4;0;1;5
16782;Žirmūnėliai;DEBESĖLIAI;6161223611;Taip;0;0;3;3
16783;Žirmūnėliai;DEBESĖLIAI;2263604297;Taip;0;6;0;6
16784;Žirmūnėliai;DEBESĖLIAI;1885292520;Taip;0;0;1;1
16785;Žirmūnėliai;DEBESĖLIAI;1618573494;Taip;9;11;0;20
16786;Žirmūnėliai;DEBESĖLIAI;5611315994;Taip;9;0;0;9
16787;Žirmūnėliai;DEBESĖLIAI;6337036947;Taip;7;0;0;7
16788;Žirmūnėliai;DEBESĖLIAI;2739395691;Ne;15;3;0;18
16789;Žirmūnėliai;DEBESĖLIAI;7528704460;Taip;9;0;0;9
16790;Žirmūnėliai;DEBESĖLIAI;3006508357;Taip;0;0;4;4
16791;Žirmūnėliai;DEBESĖLIAI;5125341440;Taip;14;0;0;14
16792;Žirmūnėliai;VIŠČIUKAI;7892626521;Taip;0;1;0;1
16793;Žirmūnėliai;VIŠČIUKAI;1655437833;Taip;15;0;1;16
16794;Žirmūnėliai;VIŠČIUKAI;8999160836;Taip;6;1;1;8
16795;Žirmūnėliai;VIŠČIUKAI;8209309240;Taip;0;3;0;3
16796;Žirmūnėliai;VIŠČIUKAI;8930536051;Taip;10;0;0;10
16797;Žirmūnėliai;VIŠČIUKAI;2837129621;Taip;14;5;0;19
16798;Žirmūnėliai;VIŠČIUKAI;1273684243;Taip;0;10;0;10
16799;Žirmūnėliai;VIŠČIUKAI;7953019230;Taip;0;7;0;7
16800;Žirmūnėliai;VIŠČIUKAI;6982109508;Taip;0;6;1;7
16801;Žirmūnėliai;VIŠČIUKAI;6594728970;Taip;8;0;0;8
16802;Žirmūnėliai;VIŠČIUKAI;9478256549;Taip;6;1;2;9
16803;Žirmūnėliai;VIŠČIUKAI;5090067954;Taip;7;0;2;9
16804;Žirmūnėliai;VIŠČIUKAI;7422544482;Taip;0;1;0;1
16805;Žirmūnėliai;VIŠČIUKAI;4336415033;Taip;0;0;1;1
16806;Žirmūnėliai;ZUIKUČIŲ;9378860669;Taip;20;0;0;20
16807;Žirmūnėliai;ZUIKUČIŲ;4218266688;Taip;3;0;1;4
16808;Žirmūnėliai;ZUIKUČIŲ;8607934394;Taip;0;1;0;1
16809;Žirmūnėliai;ZUIKUČIŲ;3449815783;Taip;16;0;0;16
16810;Žirmūnėliai;ZUIKUČIŲ;7996709950;Taip;0;1;0;1
16811;Žirmūnėliai;ZUIKUČIŲ;3562689670;Taip;0;5;0;5
16812;Žirmūnėliai;ZUIKUČIŲ;7020486370;Taip;0;3;0;3
16813;Žirmūnėliai;ZUIKUČIŲ;3274576752;Taip;22;0;0;22
16814;Žirmūnėliai;ZUIKUČIŲ;5736502380;Ne;8;2;0;10
16815;Žirmūnėliai;ZUIKUČIŲ;9154874729;Taip;6;0;0;6
16816;Žirmūnėliai;ZUIKUČIŲ;8631248243;Taip;17;0;0;17
16817;Žirmūnėliai;ZUIKUČIŲ;2866010286;Taip;8;1;0;9
16818;Žirmūnėliai;ZUIKUČIŲ;2904787614;Taip;8;1;0;9
16819;Žirmūnėliai;ZUIKUČIŲ;5723289396;Taip;4;0;3;7
16820;Žirmūnėliai;OBUOLIUKAI;9666769523;Taip;0;5;0;5
16821;Žirmūnėliai;OBUOLIUKAI;24877884441;Taip;0;6;0;6
16822;Žirmūnėliai;OBUOLIUKAI;85408994677;Taip;5;0;1;6
16823;Žirmūnėliai;OBUOLIUKAI;2336720944;Taip;2;0;0;2
16824;Žirmūnėliai;OBUOLIUKAI;1110585472;Taip;0;1;2;3
16825;Žirmūnėliai;OBUOLIUKAI;1259227112;Taip;0;0;1;1
16826;Žirmūnėliai;OBUOLIUKAI;89429083939;Taip;1;0;0;1
16827;Žirmūnėliai;OBUOLIUKAI;35353356752;Taip;18;0;0;18
16828;Žirmūnėliai;OBUOLIUKAI;36305353664;Taip;4;8;0;12
16829;Žirmūnėliai;OBUOLIUKAI;24035212527;Taip;0;1;11;12
16830;Žirmūnėliai;OBUOLIUKAI;53081289792;Taip;0;0;2;2
16831;Žirmūnėliai;OBUOLIUKAI;65907675470;Taip;5;1;6;12
16832;Žirmūnėliai;OBUOLIUKAI;4675716163;Taip;4;0;6;10
16833;Žirmūnėliai;OBUOLIUKAI;2216383670;Ne;22;0;0;22
16834;Žirmūnėliai;OBUOLIUKAI;47645482781;Taip;5;0;0;5
16835;Žirmūnėliai;OBUOLIUKAI;9232201424;Taip;13;0;0;13
16836;Žirmūnėliai;OBUOLIUKAI;9448136354;Ne;0;0;11;11
16837;Dainorėliai;SAULUTĖS;79461209783;Ne;2;0;0;2
16838;Dainorėliai;SAULUTĖS;98830139164;Taip;0;14;1;15
16839;Dainorėliai;SAULUTĖS;37708779599;Taip;0;0;5;5
16840;Dainorėliai;SAULUTĖS;84424772471;Taip;2;0;2;4
16841;Dainorėliai;SAULUTĖS;98796240124;Taip;0;1;0;1
16842;Dainorėliai;SAULUTĖS;69556449215;Taip;0;1;0;1
16843;Dainorėliai;SAULUTĖS;84084897419;Taip;0;2;0;2
16844;Dainorėliai;SAULUTĖS;64977015444;Taip;0;0;1;1
16845;Dainorėliai;SAULUTĖS;47323045857;Taip;0;5;5;10
16846;Dainorėliai;SAULUTĖS;18744882489;Taip;0;1;0;1
16847;Dainorėliai;SAULUTĖS;25073134850;Taip;4;1;0;5
16848;Dainorėliai;SAULUTĖS;37660372564;Taip;0;1;2;3
16849;Dainorėliai;SAULUTĖS;69732047046;Taip;3;0;0;3
16850;Dainorėliai;SAULUTĖS;13138644060;Taip;2;0;0;2
16851;Dainorėliai;SAULUTĖS;5155175570;Taip;0;0;3;3
16852;Dainorėliai;SAULUTĖS;92644746397;Taip;0;1;1;2
16853;Dainorėliai;SAULUTĖS;2922026996;Taip;6;0;0;6
16854;Dainorėliai;SAULUTĖS;1889037823;Ne;0;4;3;7
16855;Dainorėliai;SAULUTĖS;2441164154;Taip;5;0;4;9
16856;Dainorėliai;VARPELIAI;11506295275;Taip;0;1;0;1
16857;Dainorėliai;VARPELIAI;87242570532;Taip;3;0;0;3
16858;Dainorėliai;VARPELIAI;18233813290;Taip;0;2;1;3
16859;Dainorėliai;VARPELIAI;6176171443;Taip;4;2;0;6
16860;Dainorėliai;VARPELIAI;88781762328;Taip;13;5;0;18
16861;Dainorėliai;VARPELIAI;9319771186;Taip;6;2;2;10
16862;Dainorėliai;VARPELIAI;8719834064;Taip;18;0;0;18
16863;Dainorėliai;VARPELIAI;5693385617;Taip;0;1;0;1
16864;Dainorėliai;VARPELIAI;8267213392;Ne;0;4;0;4
16865;Dainorėliai;VARPELIAI;5959380807;Taip;0;2;4;6
16866;Dainorėliai;VARPELIAI;2938732886;Taip;0;1;4;5
16867;Dainorėliai;VARPELIAI;3183793211;Taip;0;2;0;2
16868;Dainorėliai;VARPELIAI;2797544232;Taip;0;2;1;3
16869;Dainorėliai;VARPELIAI;65467351140;Taip;9;1;0;10
16870;Dainorėliai;VARPELIAI;8521878734;Taip;10;2;0;12
16871;Dainorėliai;VARPELIAI;1928369859;Taip;2;0;0;2
16872;Dainorėliai;VARPELIAI;6909583023;Taip;0;7;5;12
16873;Dainorėliai;VARPELIAI;6430425182;Taip;1;0;0;1
16874;Dainorėliai;VARPELIAI;4269946363;Taip;0;2;6;8
16875;Dainorėliai;VARPELIAI;1088248393;Taip;0;1;4;5
16876;Dainorėliai;ŽIOGELIAI;88201007119;Taip;0;4;1;5
16877;Dainorėliai;ŽIOGELIAI;31267856584;Ne;3;3;0;6
16878;Dainorėliai;ŽIOGELIAI;87717571411;Taip;4;0;0;4
16879;Dainorėliai;ŽIOGELIAI;18936645521;Ne;0;4;2;6
16880;Dainorėliai;ŽIOGELIAI;35528654099;Taip;0;2;0;2
16881;Dainorėliai;ŽIOGELIAI;29132059636;Taip;0;1;0;1
16882;Dainorėliai;ŽIOGELIAI;32573583030;Taip;0;3;0;3
16883;Dainorėliai;ŽIOGELIAI;1470784692;Taip;0;1;0;1
16884;Dainorėliai;ŽIOGELIAI;35134511946;Taip;0;0;1;1
16885;Dainorėliai;ŽIOGELIAI;17358842027;Taip;0;2;0;2
16886;Dainorėliai;ŽIOGELIAI;54344466523;Taip;0;0;3;3
16887;Dainorėliai;ŽIOGELIAI;63211091321;Taip;3;0;0;3
16888;Dainorėliai;ŽIOGELIAI;45577031767;Taip;6;5;0;11
16889;Dainorėliai;ŽIOGELIAI;92157879830;Ne;0;1;0;1
16890;Dainorėliai;ŽIOGELIAI;80499999855;Taip;2;0;0;2
16891;Dainorėliai;ŽIOGELIAI;72073028506;Ne;2;0;0;2
16892;Dainorėliai;ŽIOGELIAI;78002267589;Taip;0;1;0;1
16893;Dainorėliai;ŽIOGELIAI;3761026792;Taip;0;2;1;3
16894;Dainorėliai;ŽIOGELIAI;71027372459;Taip;2;5;0;7
16895;Dainorėliai;DRUGELIAI;26916172990;Ne;0;19;0;19
16896;Dainorėliai;DRUGELIAI;6411939690;Taip;0;1;0;1
16897;Dainorėliai;DRUGELIAI;50432354832;Taip;7;1;1;9
16898;Dainorėliai;DRUGELIAI;19286303769;Taip;11;0;0;11
16899;Dainorėliai;DRUGELIAI;2483267929;Taip;0;1;0;1
16900;Dainorėliai;DRUGELIAI;1015870220;Taip;11;0;0;11
16901;Dainorėliai;DRUGELIAI;5212308610;Taip;7;3;0;10
16902;Dainorėliai;DRUGELIAI;6404337541;Taip;6;0;2;8
16903;Dainorėliai;DRUGELIAI;94480397292;Taip;9;0;3;12
16904;Dainorėliai;DRUGELIAI;53935690864;Taip;12;0;0;12
16905;Dainorėliai;DRUGELIAI;27521381629;Taip;7;0;0;7
16906;Dainorėliai;DRUGELIAI;86187568203;Taip;8;5;2;15
16907;Dainorėliai;DRUGELIAI;5238082419;Taip;9;0;0;9
16908;Dainorėliai;DRUGELIAI;49483881135;Taip;12;0;0;12
16909;Dainorėliai;DRUGELIAI;3789809082;Ne;5;0;1;6
16910;Dainorėliai;DRUGELIAI;1626877066;Taip;8;0;1;9
16911;Dainorėliai;DRUGELIAI;1158895670;Taip;8;2;1;11
16912;Dainorėliai;DRUGELIAI;4087344015;Taip;12;0;0;12
16913;Dainorėliai;DRUGELIAI;3128897752;Taip;4;0;1;5
16914;Dainorėliai;DRUGELIAI;1357413314;Taip;13;0;0;13
16915;Dainorėliai;DRUGELIAI;1515552402;Ne;0;2;6;8
16916;Dainorėliai;"1 klasė";5010994621;Taip;1;0;0;1
16917;Dainorėliai;"1 klasė";26315465923;Taip;6;0;0;6
16918;Dainorėliai;"1 klasė";6203511535;Taip;4;0;0;4
16919;Dainorėliai;"1 klasė";93738984644;Taip;1;0;0;1
16920;Dainorėliai;"1 klasė";81956978417;Taip;3;0;0;3
16921;Dainorėliai;"1 klasė";24048489264;Ne;1;0;0;1
16922;Dainorėliai;"1 klasė";8562371599;Taip;1;0;0;1
16923;Dainorėliai;"1 klasė";19292860218;Taip;2;0;0;2
16924;Dainorėliai;"1 klasė";14664307658;Ne;2;0;0;2
16925;Dainorėliai;"1 klasė";23144978287;Taip;4;0;0;4
16926;Dainorėliai;"1 klasė";63052774196;Taip;4;0;0;4
16927;Dainorėliai;"1 klasė";97182565649;Taip;1;0;0;1
16928;Dainorėliai;"1 klasė";13846131820;Taip;3;0;0;3
16929;Dainorėliai;"1 klasė";3018657993;Taip;4;0;0;4
16930;Dainorėliai;"2 klasė";1629229178;Ne;3;0;0;3
16931;Dainorėliai;"2 klasė";1734712911;Taip;1;0;0;1
16932;Dainorėliai;"2 klasė";4642369086;Taip;4;0;0;4
16933;Dainorėliai;"2 klasė";3713835329;Taip;2;0;0;2
16934;Dainorėliai;"2 klasė";5181789063;Taip;6;0;0;6
16935;Dainorėliai;"2 klasė";4631981231;Taip;2;0;0;2
16936;Dainorėliai;"2 klasė";6576505338;Ne;2;0;0;2
16937;Dainorėliai;"2 klasė";1185255904;Taip;3;0;0;3
16938;Dainorėliai;"2 klasė";9691052273;Taip;5;0;0;5
16939;Dainorėliai;"2 klasė";2135997501;Taip;2;0;0;2
16940;Dainorėliai;"2 klasė";7013545705;Taip;1;0;0;1
16941;Dainorėliai;"2 klasė";6735081184;Taip;3;0;0;3
16942;Dainorėliai;"2 klasė";6513001151;Taip;1;0;0;1
16943;Dainorėliai;"2 klasė";47031645815;Ne;2;0;0;2
16944;Dainorėliai;"3 klasė";6497830034;Taip;5;0;0;5
16945;Dainorėliai;"3 klasė";5072041112;Taip;2;0;0;2
16946;Dainorėliai;"3 klasė";2164782968;Ne;2;0;0;2
16947;Dainorėliai;"3 klasė";4490125789;Taip;1;0;0;1
16948;Dainorėliai;"3 klasė";8569165891;Taip;1;0;0;1
16949;Dainorėliai;"3 klasė";9630477900;Taip;1;0;0;1
16950;Dainorėliai;"3 klasė";5177714429;Taip;2;0;0;2
16951;Dainorėliai;"3 klasė";7309477306;Taip;2;0;0;2
16952;Dainorėliai;"3 klasė";3683531357;Taip;8;0;0;8
16953;Dainorėliai;"3 klasė";7327414673;Taip;1;0;0;1
16954;Dainorėliai;"3 klasė";1347410803;Taip;2;0;0;2
16955;Dainorėliai;"3 klasė";8916859571;Taip;2;0;0;2
16956;Dainorėliai;"4 klasė";1682094268;Taip;1;0;0;1
16957;Dainorėliai;"4 klasė";1689787684;Taip;3;0;0;3
16958;Dainorėliai;"4 klasė";4956275684;Taip;1;0;0;1
16959;Dainorėliai;"4 klasė";7972267725;Taip;2;0;0;2
16960;Dainorėliai;"4 klasė";4557048583;Taip;1;0;0;1
16961;Dainorėliai;"4 klasė";1744536400;Ne;2;0;0;2
16962;Dainorėliai;"4 klasė";2936271822;Taip;1;0;0;1
16963;Dainorėliai;"4 klasė";4825947023;Ne;11;0;0;11
16964;Dainorėliai;"4 klasė";7179140869;Ne;2;0;0;2
16965;Dainorėliai;"4 klasė";1593283963;Taip;8;0;0;8
16966;Dainorėliai;"4 klasė";8612758782;Taip;2;0;0;2
16967;Lokiukas;BITUTĖS;6758550653;Taip;22;0;0;22
16968;Lokiukas;BITUTĖS;1040288021;Taip;15;3;0;18
16969;Lokiukas;BITUTĖS;1733486244;Taip;7;0;0;7
16970;Lokiukas;BITUTĖS;6336140882;Taip;0;12;0;12
16971;Lokiukas;BITUTĖS;9142262360;Taip;6;4;0;10
16972;Lokiukas;BITUTĖS;1752784666;Taip;17;0;0;17
16973;Lokiukas;BITUTĖS;34546519642;Taip;0;0;1;1
16974;Lokiukas;BITUTĖS;2166382346;Taip;0;1;2;3
16975;Lokiukas;BITUTĖS;7305062511;Taip;2;0;0;2
16976;Lokiukas;BITUTĖS;1025576053;Taip;7;0;1;8
16977;Lokiukas;BITUTĖS;6069516217;Taip;0;3;0;3
16978;Lokiukas;BITUTĖS;7943213321;Taip;4;5;0;9
16979;Lokiukas;BITUTĖS;4007839265;Taip;6;0;0;6
16980;Lokiukas;BITUTĖS;8796640190;Taip;11;0;0;11
16981;Lokiukas;BITUTĖS;5943412920;Taip;4;8;0;12
16982;Lokiukas;BITUTĖS;2885398200;Taip;0;0;1;1
16983;Lokiukas;BITUTĖS;3694653020;Taip;5;1;0;6
16984;Lokiukas;BITUTĖS;4379238557;Taip;0;3;0;3
16985;Lokiukas;BITUTĖS;2052174669;Taip;6;0;2;8
16986;Lokiukas;BITUTĖS;8902619265;Taip;0;6;0;6
16987;Lokiukas;"1 B klasė";60370754283;Taip;7;0;0;7
16988;Lokiukas;"1 B klasė";3262579895;Taip;10;0;0;10
16989;Lokiukas;"1 B klasė";17034757778;Taip;7;0;0;7
16990;Lokiukas;"1 B klasė";79301547085;Ne;6;0;0;6
16991;Lokiukas;"1 B klasė";16889795010;Taip;22;0;0;22
16992;Lokiukas;"1 B klasė";18432518932;Taip;8;0;0;8
16993;Lokiukas;"1 B klasė";2004606839;Taip;22;0;0;22
16994;Lokiukas;"1 B klasė";88947878548;Taip;6;0;0;6
16995;Lokiukas;"1 B klasė";45805925058;Taip;6;0;0;6
16996;Lokiukas;"1 B klasė";70028115546;Taip;7;0;0;7
16997;Lokiukas;"1 B klasė";29198900240;Taip;8;0;0;8
16998;Lokiukas;"1 B klasė";10897713744;Taip;22;0;0;22
16999;Lokiukas;"1 B klasė";77441549037;Taip;7;0;0;7
17000;Lokiukas;"1 B klasė";69089214980;Taip;6;0;0;6
17001;Lokiukas;"1 B klasė";2353550739;Taip;10;0;0;10
17002;Lokiukas;"1 B klasė";17622979450;Taip;8;0;0;8
17003;Lokiukas;"1 B klasė";98289469398;Taip;12;0;0;12
17004;Lokiukas;"1 B klasė";51554951703;Taip;8;0;0;8
17005;Lokiukas;"1 B klasė";45735190114;Taip;22;0;0;22
17006;Lokiukas;"1 B klasė";79597160668;Taip;6;0;0;6
17007;Lokiukas;"1 B klasė";37669645510;Taip;5;0;0;5
17008;Lokiukas;"1 B klasė";15004419516;Taip;5;0;0;5
17009;Lokiukas;"1 B klasė";10240586503;Taip;22;0;0;22
17010;Lokiukas;"1 B klasė";5067673212;Ne;8;0;0;8
17011;Lokiukas;"1 B klasė";66392613629;Taip;8;0;0;8
17012;Lokiukas;"1 B klasė";15445053855;Taip;7;0;0;7
17013;Lokiukas;"1 B klasė";1104333637;Taip;5;0;0;5
17014;Lokiukas;"1 B klasė";35018370441;Taip;4;0;0;4
17015;Lokiukas;"1 B klasė";1716358913;Taip;8;0;0;8
17016;Lokiukas;"1 A klasė";72167964645;Taip;12;0;0;12
17017;Lokiukas;"1 A klasė";67818191566;Taip;4;0;0;4
17018;Lokiukas;"1 A klasė";75613665040;Taip;5;0;0;5
17019;Lokiukas;"1 A klasė";23222644824;Taip;9;0;0;9
17020;Lokiukas;"1 A klasė";52296454506;Ne;22;0;0;22
17021;Lokiukas;"1 A klasė";25058082693;Taip;22;0;0;22
17022;Lokiukas;"1 A klasė";6702448475;Taip;5;0;0;5
17023;Lokiukas;"1 A klasė";42292408557;Taip;5;0;0;5
17024;Lokiukas;"1 A klasė";2143040924;Taip;22;0;0;22
17025;Lokiukas;"1 A klasė";45280536946;Taip;15;0;0;15
17026;Lokiukas;"1 A klasė";82966541165;Taip;5;0;0;5
17027;Lokiukas;"1 A klasė";80180114948;Taip;16;0;0;16
17028;Lokiukas;"1 A klasė";66999644935;Taip;22;0;0;22
17029;Lokiukas;"1 A klasė";43389930516;Taip;5;0;0;5
17030;Lokiukas;"1 A klasė";86623153797;Taip;5;0;0;5
17031;Lokiukas;"1 A klasė";53245573692;Taip;8;0;0;8
17032;Lokiukas;"1 A klasė";14341255985;Taip;4;0;0;4
17033;Lokiukas;"1 A klasė";3206276637;Taip;22;0;0;22
17034;Lokiukas;"1 A klasė";27050402360;Taip;4;0;0;4
17035;Lokiukas;"1 A klasė";38636200254;Ne;5;0;0;5
17036;Lokiukas;"1 A klasė";53544600623;Taip;22;0;0;22
17037;Lokiukas;"1 A klasė";53087036306;Taip;22;0;0;22
17038;Lokiukas;"1 A klasė";5775631777;Ne;5;0;0;5
17039;Lokiukas;"1 A klasė";1143130271;Taip;7;0;0;7
17040;Lokiukas;"1 A klasė";47410036889;Taip;6;0;0;6
17041;Lokiukas;"1 A klasė";79223457439;Ne;7;0;0;7
17042;Lokiukas;GUDRUČIAI;43070670534;Taip;0;1;0;1
17043;Lokiukas;GUDRUČIAI;5198408183;Taip;0;2;0;2
17044;Lokiukas;GUDRUČIAI;88415635113;Taip;0;3;0;3
17045;Lokiukas;GUDRUČIAI;1227430275;Taip;5;4;0;9
17046;Lokiukas;GUDRUČIAI;9747265775;Taip;0;3;0;3
17047;Lokiukas;GUDRUČIAI;95910336503;Taip;2;0;0;2
17048;Lokiukas;GUDRUČIAI;7903535850;Taip;0;5;0;5
17049;Lokiukas;GUDRUČIAI;7497324442;Ne;2;0;0;2
17050;Lokiukas;GUDRUČIAI;93374754851;Ne;0;2;0;2
17051;Lokiukas;GUDRUČIAI;96046361641;Taip;0;4;0;4
17052;Lokiukas;GUDRUČIAI;6628530877;Taip;4;2;0;6
17053;Lokiukas;GUDRUČIAI;25170045140;Ne;20;0;0;20
17054;Lokiukas;GUDRUČIAI;84273668685;Taip;0;1;0;1
17055;Lokiukas;GUDRUČIAI;10948160841;Taip;14;2;0;16
17056;Lokiukas;GUDRUČIAI;4608275224;Taip;12;0;0;12
17057;Lokiukas;GUDRUČIAI;75296600945;Ne;0;3;0;3
17058;Lokiukas;GUDRUČIAI;59840033826;Taip;0;1;0;1
17059;Lokiukas;GUDRUČIAI;1855267362;Taip;0;2;3;5
17060;Lokiukas;BORUŽĖLĖS;1333650630;Ne;0;1;1;2
17061;Lokiukas;BORUŽĖLĖS;67133709394;Taip;16;0;0;16
17062;Lokiukas;BORUŽĖLĖS;66528256040;Taip;7;0;0;7
17063;Lokiukas;BORUŽĖLĖS;4906784415;Taip;10;1;1;12
17064;Lokiukas;BORUŽĖLĖS;36677665098;Taip;0;0;4;4
17065;Lokiukas;BORUŽĖLĖS;1119814512;Taip;11;1;2;14
17066;Lokiukas;BORUŽĖLĖS;52940830874;Taip;15;2;0;17
17067;Lokiukas;BORUŽĖLĖS;1201125655;Taip;5;7;1;13
17068;Lokiukas;BORUŽĖLĖS;82025637099;Taip;4;1;0;5
17069;Lokiukas;BORUŽĖLĖS;131300206;Taip;4;5;0;9
17070;Lokiukas;BORUŽĖLĖS;8846527481;Taip;22;0;0;22
17071;Lokiukas;BORUŽĖLĖS;24601126170;Taip;3;1;0;4
17072;Lokiukas;BORUŽĖLĖS;83528495608;Ne;0;11;0;11
17073;Lokiukas;BORUŽĖLĖS;83086633109;Taip;7;0;1;8
17074;Lokiukas;BORUŽĖLĖS;40082135876;Taip;8;0;4;12
17075;Lokiukas;BORUŽĖLĖS;29396361769;Taip;0;6;0;6
17076;Lokiukas;BORUŽĖLĖS;73515179103;Taip;2;2;2;6
17077;Lokiukas;BORUŽĖLĖS;73696992182;Taip;2;5;0;7
17078;Lokiukas;BORUŽĖLĖS;8240261104;Taip;0;1;0;1
17079;Lokiukas;BORUŽĖLĖS;99183628764;Taip;3;8;1;12
17080;Lokiukas;BORUŽĖLĖS;61807094999;Taip;10;0;0;10
17081;Lokiukas;BORUŽĖLĖS;7495691956;Ne;7;1;0;8
17082;Lokiukas;ANČIUKAI;4617372387;Taip;5;0;1;6
17083;Lokiukas;ANČIUKAI;8630112458;Taip;10;0;0;10
17084;Lokiukas;ANČIUKAI;5518041213;Taip;6;0;0;6
17085;Lokiukas;ANČIUKAI;8738488104;Taip;5;0;2;7
17086;Lokiukas;ANČIUKAI;3744484616;Taip;10;3;0;13
17087;Lokiukas;ANČIUKAI;2625981190;Taip;11;0;0;11
17088;Lokiukas;ANČIUKAI;4442073527;Taip;5;1;0;6
17089;Lokiukas;ANČIUKAI;9307491947;Taip;17;0;0;17
17090;Lokiukas;ANČIUKAI;4849031542;Taip;0;22;0;22
17091;Lokiukas;ANČIUKAI;8286358519;Taip;10;0;1;11
17092;Lokiukas;ANČIUKAI;4585621105;Taip;22;0;0;22
17093;Lokiukas;ANČIUKAI;5522089503;Taip;3;0;1;4
17094;Lokiukas;ANČIUKAI;4206181176;Taip;17;0;0;17
17095;Lokiukas;ANČIUKAI;8576418875;Taip;0;22;0;22
17096;Lokiukas;ANČIUKAI;4858829710;Taip;8;0;1;9
17097;Lokiukas;ANČIUKAI;8329540746;Taip;5;0;0;5
17098;Lokiukas;ANČIUKAI;6869785650;Taip;16;1;0;17
17099;Lokiukas;KODĖLČIUKAI;15406362908;Taip;0;1;0;1
17100;Lokiukas;KODĖLČIUKAI;45122233067;Taip;0;5;0;5
17101;Lokiukas;KODĖLČIUKAI;21802863853;Taip;0;2;0;2
17102;Lokiukas;KODĖLČIUKAI;84682977618;Taip;4;0;0;4
17103;Lokiukas;KODĖLČIUKAI;22979689191;Taip;0;6;0;6
17104;Lokiukas;KODĖLČIUKAI;70730972654;Taip;0;4;0;4
17105;Lokiukas;KODĖLČIUKAI;80754592972;Taip;6;3;0;9
17106;Lokiukas;KODĖLČIUKAI;99706061553;Taip;1;6;0;7
17107;Lokiukas;KODĖLČIUKAI;42138783794;Taip;2;1;0;3
17108;Lokiukas;KODĖLČIUKAI;7785940412;Taip;0;1;1;2
17109;Lokiukas;KODĖLČIUKAI;24099693663;Taip;0;3;6;9
17110;Lokiukas;KODĖLČIUKAI;72092394330;Taip;2;0;1;3
17111;Lokiukas;KODĖLČIUKAI;9413274607;Taip;4;0;3;7
17112;Lokiukas;KODĖLČIUKAI;7324496782;Taip;0;6;0;6
17113;Lokiukas;KODĖLČIUKAI;35769782473;Taip;0;9;0;9
17114;Lokiukas;KODĖLČIUKAI;10811780420;Taip;0;2;0;2
17115;Lokiukas;KODĖLČIUKAI;1151938436;Taip;0;4;0;4
17116;Lokiukas;KODĖLČIUKAI;91855230473;Taip;0;0;6;6
17117;Lokiukas;KODĖLČIUKAI;38531751377;Taip;0;5;0;5
17118;Lokiukas;KODĖLČIUKAI;28796727185;Taip;0;8;0;8
17119;Lokiukas;KODĖLČIUKAI;80793623068;Ne;3;4;0;7
17120;Lokiukas;DRUGELIAI;7942641594;Taip;0;0;2;2
17121;Lokiukas;DRUGELIAI;8568285232;Taip;11;3;0;14
17122;Lokiukas;DRUGELIAI;5453470660;Taip;0;14;0;14
17123;Lokiukas;DRUGELIAI;5879386524;Taip;3;0;2;5
17124;Lokiukas;DRUGELIAI;14605095801;Taip;0;2;0;2
17125;Lokiukas;DRUGELIAI;46838695582;Taip;8;5;0;13
17126;Lokiukas;DRUGELIAI;2642065594;Taip;0;1;0;1
17127;Lokiukas;DRUGELIAI;1626698185;Taip;8;0;0;8
17128;Lokiukas;DRUGELIAI;39222094073;Taip;2;10;0;12
17129;Lokiukas;DRUGELIAI;1695680881;Taip;15;0;0;15
17130;Lokiukas;DRUGELIAI;69364831994;Taip;10;0;1;11
17131;Lokiukas;DRUGELIAI;39975872119;Taip;0;2;0;2
17132;Lokiukas;DRUGELIAI;78106313493;Taip;0;0;1;1
17133;Lokiukas;DRUGELIAI;1625137322;Taip;3;0;0;3
17134;Lokiukas;DRUGELIAI;1381505711;Taip;10;5;0;15
17135;Lokiukas;DRUGELIAI;8452600632;Taip;19;0;1;20
17136;Lokiukas;DRUGELIAI;7386571822;Ne;14;0;0;14
17137;Lokiukas;DRUGELIAI;35890122494;Taip;0;6;0;6
17138;Lokiukas;DRUGELIAI;1210407640;Taip;0;1;2;3
17139;Lokiukas;DRUGELIAI;7591418969;Taip;17;0;0;17
17140;Lokiukas;DRUGELIAI;8270572748;Taip;0;0;1;1
17141;Lokiukas;DRUGELIAI;8036643654;Taip;11;0;4;15
17142;Lokiukas;"2 A klasė";7060929950;Taip;4;0;0;4
17143;Lokiukas;"2 A klasė";8499895935;Taip;22;0;0;22
17144;Lokiukas;"2 A klasė";5737714024;Ne;4;0;0;4
17145;Lokiukas;"2 A klasė";5889819809;Ne;4;0;0;4
17146;Lokiukas;"2 A klasė";6496662759;Taip;15;0;0;15
17147;Lokiukas;"2 A klasė";5700685872;Ne;5;0;0;5
17148;Lokiukas;"2 A klasė";1555365851;Ne;22;0;0;22
17149;Lokiukas;"2 A klasė";2374089307;Taip;4;0;0;4
17150;Lokiukas;"2 A klasė";2607988265;Taip;6;0;0;6
17151;Lokiukas;"2 A klasė";4992275038;Taip;4;0;0;4
17152;Lokiukas;"2 A klasė";1492303633;Taip;8;0;0;8
17153;Lokiukas;"2 A klasė";6856770462;Ne;7;0;0;7
17154;Lokiukas;"2 A klasė";8766212402;Ne;12;0;0;12
17155;Lokiukas;"2 A klasė";5559967651;Taip;14;0;0;14
17156;Lokiukas;"2 A klasė";3528533437;Taip;22;0;0;22
17157;Lokiukas;"2 A klasė";5465758477;Taip;4;0;0;4
17158;Lokiukas;"2 A klasė";7069020705;Ne;8;0;0;8
17159;Lokiukas;"2 A klasė";6129602024;Ne;5;0;0;5
17160;Lokiukas;"2 A klasė";9199283952;Taip;22;0;0;22
17161;Lokiukas;"2 A klasė";8378630091;Taip;5;0;0;5
17162;Lokiukas;"2 A klasė";3138145333;Ne;22;0;0;22
17163;Lokiukas;"2 A klasė";3506723678;Taip;22;0;0;22
17164;Lokiukas;"2 A klasė";4615481025;Ne;5;0;0;5
17165;Lokiukas;"2 A klasė";7553457572;Ne;13;0;0;13
17166;Lokiukas;"2 A klasė";1571404671;Taip;11;0;0;11
17167;Lokiukas;"2 A klasė";1729941577;Taip;8;0;0;8
17168;Lokiukas;"2 B klasė";9114504810;Taip;6;0;0;6
17169;Lokiukas;"2 B klasė";7595514531;Taip;5;0;0;5
17170;Lokiukas;"2 B klasė";7144013238;Taip;22;0;0;22
17171;Lokiukas;"2 B klasė";8235437961;Taip;4;0;0;4
17172;Lokiukas;"2 B klasė";2905935730;Taip;5;0;0;5
17173;Lokiukas;"2 B klasė";8304439625;Taip;13;0;0;13
17174;Lokiukas;"2 B klasė";8954484534;Taip;8;0;0;8
17175;Lokiukas;"2 B klasė";1388342336;Taip;5;0;0;5
17176;Lokiukas;"2 B klasė";4418425219;Taip;5;0;0;5
17177;Lokiukas;"2 B klasė";3364994110;Taip;11;0;0;11
17178;Lokiukas;"2 B klasė";6063796643;Taip;8;0;0;8
17179;Lokiukas;"2 B klasė";6663700618;Taip;5;0;0;5
17180;Lokiukas;"2 B klasė";6151885589;Taip;5;0;0;5
17181;Lokiukas;"2 B klasė";1440437389;Taip;5;0;0;5
17182;Lokiukas;"2 B klasė";2059112380;Taip;4;0;0;4
17183;Lokiukas;"2 B klasė";5745254234;Taip;9;0;0;9
17184;Lokiukas;"2 B klasė";8189433550;Taip;22;0;0;22
17185;Lokiukas;"2 B klasė";5918592397;Taip;8;0;0;8
17186;Lokiukas;"2 B klasė";7722830021;Taip;4;0;0;4
17187;Lokiukas;"2 B klasė";9681048306;Taip;8;0;0;8
17188;Lokiukas;"2 B klasė";1048772300;Taip;6;0;0;6
17189;Lokiukas;"2 B klasė";2021690274;Taip;9;0;0;9
17190;Lokiukas;"2 B klasė";6538311120;Taip;13;0;0;13
17191;Lokiukas;"2 B klasė";8395026474;Ne;4;0;0;4
17192;Lokiukas;"2 B klasė";7439047502;Taip;4;0;0;4
17193;Lokiukas;"2 B klasė";1746819279;Taip;14;0;0;14
17194;Lokiukas;"3 A klasė";2220223549;Taip;22;0;0;22
17195;Lokiukas;"3 A klasė";7349936354;Ne;9;0;0;9
17196;Lokiukas;"3 A klasė";8192834838;Taip;9;0;0;9
17197;Lokiukas;"3 A klasė";7086818828;Taip;8;0;0;8
17198;Lokiukas;"3 A klasė";8959417696;Taip;22;0;0;22
17199;Lokiukas;"3 A klasė";1362995666;Taip;7;0;0;7
17200;Lokiukas;"3 A klasė";4873942674;Taip;10;0;0;10
17201;Lokiukas;"3 A klasė";2745780921;Taip;8;0;0;8
17202;Lokiukas;"3 A klasė";3007573139;Taip;7;0;0;7
17203;Lokiukas;"3 A klasė";5058488696;Taip;10;0;0;10
17204;Lokiukas;"3 A klasė";6008557035;Taip;14;0;0;14
17205;Lokiukas;"3 A klasė";1243245356;Taip;7;0;0;7
17206;Lokiukas;"3 A klasė";9322204885;Taip;7;0;0;7
17207;Lokiukas;"3 A klasė";1822055099;Ne;8;0;0;8
17208;Lokiukas;"3 A klasė";5199360470;Taip;22;0;0;22
17209;Lokiukas;"3 A klasė";5384844998;Taip;22;0;0;22
17210;Lokiukas;"3 A klasė";6353653831;Taip;22;0;0;22
17211;Lokiukas;"3 A klasė";3700837936;Taip;14;0;0;14
17212;Lokiukas;"3 A klasė";6022402998;Taip;9;0;0;9
17213;Lokiukas;"3 A klasė";5942416530;Taip;7;0;0;7
17214;Lokiukas;"3 A klasė";9743363133;Taip;15;0;0;15
17215;Lokiukas;"3 A klasė";2029507962;Taip;11;0;0;11
17216;Lokiukas;"3 A klasė";44496777103;Taip;22;0;0;22
17217;Lokiukas;"3 A klasė";94528954912;Ne;9;0;0;9
17218;Lokiukas;"3 B klasė";9922964495;Taip;9;0;0;9
17219;Lokiukas;"3 B klasė";5562737843;Taip;8;0;0;8
17220;Lokiukas;"3 B klasė";6110849113;Taip;22;0;0;22
17221;Lokiukas;"3 B klasė";8822883914;Taip;22;0;0;22
17222;Lokiukas;"3 B klasė";1860245985;Taip;22;0;0;22
17223;Lokiukas;"3 B klasė";1692231191;Taip;9;0;0;9
17224;Lokiukas;"3 B klasė";4160279615;Taip;7;0;0;7
17225;Lokiukas;"3 B klasė";4368235682;Ne;11;0;0;11
17226;Lokiukas;"3 B klasė";9376247296;Taip;7;0;0;7
17227;Lokiukas;"3 B klasė";7943448919;Taip;22;0;0;22
17228;Lokiukas;"3 B klasė";6270747705;Taip;10;0;0;10
17229;Lokiukas;"3 B klasė";9390626220;Taip;22;0;0;22
17230;Lokiukas;"3 B klasė";4467643205;Taip;10;0;0;10
17231;Lokiukas;"3 B klasė";8175005473;Taip;7;0;0;7
17232;Lokiukas;"3 B klasė";4504812769;Taip;7;0;0;7
17233;Lokiukas;"3 B klasė";6210160161;Taip;8;0;0;8
17234;Lokiukas;"3 B klasė";1727242060;Taip;22;0;0;22
17235;Lokiukas;"3 B klasė";8300861451;Taip;7;0;0;7
17236;Lokiukas;"3 B klasė";7692067948;Taip;7;0;0;7
17237;Lokiukas;"3 B klasė";7728788069;Taip;22;0;0;22
17238;Lokiukas;"3 B klasė";9985555940;Taip;22;0;0;22
17239;Lokiukas;"3 B klasė";4447860405;Taip;9;0;0;9
17240;Lokiukas;"3 B klasė";3823547337;Taip;8;0;0;8
17241;Lokiukas;"3 B klasė";5496591880;Taip;22;0;0;22
17242;Lokiukas;"3 B klasė";1491789191;Taip;7;0;0;7
17243;Lokiukas;"3 B klasė";1419846182;Taip;7;0;0;7
17244;Lokiukas;"3 B klasė";9310088026;Taip;7;0;0;7
17245;Lokiukas;"3 B klasė";1787800667;Taip;7;0;0;7
17246;Lokiukas;"3 B klasė";2284932363;Taip;9;0;0;9
17247;Lokiukas;"4 A klasė";8522739824;Taip;22;0;0;22
17248;Lokiukas;"4 A klasė";6642105064;Taip;7;0;0;7
17249;Lokiukas;"4 A klasė";5852545576;Taip;22;0;0;22
17250;Lokiukas;"4 A klasė";1179863043;Taip;22;0;0;22
17251;Lokiukas;"4 A klasė";4976080351;Taip;10;0;0;10
17252;Lokiukas;"4 A klasė";5300309689;Taip;22;0;0;22
17253;Lokiukas;"4 A klasė";3023836997;Taip;22;0;0;22
17254;Lokiukas;"4 A klasė";6539032697;Ne;22;0;0;22
17255;Lokiukas;"4 A klasė";8651567498;Taip;7;0;0;7
17256;Lokiukas;"4 A klasė";6880671721;Taip;22;0;0;22
17257;Lokiukas;"4 A klasė";2890728780;Taip;22;0;0;22
17258;Lokiukas;"4 A klasė";1275739989;Taip;22;0;0;22
17259;Lokiukas;"4 A klasė";5810597393;Ne;22;0;0;22
17260;Lokiukas;"4 A klasė";3297734813;Taip;22;0;0;22
17261;Lokiukas;"4 A klasė";3216247517;Taip;7;0;0;7
17262;Lokiukas;"4 A klasė";2946985384;Taip;22;0;0;22
17263;Lokiukas;"4 A klasė";4908935009;Taip;9;0;0;9
17264;Lokiukas;"4 A klasė";8585585715;Taip;7;0;0;7
17265;Lokiukas;"4 A klasė";8746221351;Taip;7;0;0;7
17266;Lokiukas;"4 A klasė";7385810354;Taip;8;0;0;8
17267;Lokiukas;"4 A klasė";7202328703;Taip;16;0;0;16
17268;Lokiukas;"4 B klasė";3253826820;Ne;12;0;0;12
17269;Lokiukas;"4 B klasė";8577804440;Taip;8;0;0;8
17270;Lokiukas;"4 B klasė";3401446820;Taip;18;0;0;18
17271;Lokiukas;"4 B klasė";3941060152;Taip;22;0;0;22
17272;Lokiukas;"4 B klasė";6034080022;Taip;22;0;0;22
17273;Lokiukas;"4 B klasė";7802721046;Taip;22;0;0;22
17274;Lokiukas;"4 B klasė";5579944645;Taip;16;0;0;16
17275;Lokiukas;"4 B klasė";1798330886;Taip;10;0;0;10
17276;Lokiukas;"4 B klasė";6827396461;Taip;8;0;0;8
17277;Lokiukas;"4 B klasė";2096424992;Taip;22;0;0;22
17278;Lokiukas;"4 B klasė";7221776688;Taip;22;0;0;22
17279;Lokiukas;"4 B klasė";7010375151;Taip;7;0;0;7
17280;Lokiukas;"4 B klasė";3862533006;Taip;16;0;0;16
17281;Lokiukas;"4 B klasė";8123166445;Ne;10;0;0;10
17282;Lokiukas;"4 B klasė";9742540759;Ne;22;0;0;22
17283;Lokiukas;"4 B klasė";5301990414;Taip;8;0;0;8
17284;Lokiukas;"4 B klasė";4755673524;Taip;18;0;0;18
17285;Lokiukas;"4 B klasė";7851458821;Taip;22;0;0;22
17286;Lokiukas;"4 B klasė";4537888646;Taip;18;0;0;18
17287;Lokiukas;"4 B klasė";9786431252;Taip;11;0;0;11
17288;Lokiukas;"4 B klasė";1956140793;Taip;22;0;0;22
17289;Lokiukas;"4 B klasė";6116726536;Taip;16;0;0;16
17290;Lokiukas;"4 B klasė";3276273861;Taip;11;0;0;11
17291;Lokiukas;"4 B klasė";4648324338;Taip;7;0;0;7
17292;Šaltinėlis;Ančiukų;3011747942;Taip;8;5;0;13
17293;Šaltinėlis;Ančiukų;1811886320;Taip;8;0;0;8
17294;Šaltinėlis;Ančiukų;9769491789;Taip;0;5;0;5
17295;Šaltinėlis;Ančiukų;56396772538;Taip;0;8;0;8
17296;Šaltinėlis;Ančiukų;6462738640;Taip;0;9;0;9
17297;Šaltinėlis;Ančiukų;3493429067;Taip;0;2;0;2
17298;Šaltinėlis;Ančiukų;9218883174;Ne;8;0;0;8
17299;Šaltinėlis;Ančiukų;7133143923;Taip;0;3;0;3
17300;Šaltinėlis;Ančiukų;9820788524;Taip;0;13;0;13
17301;Šaltinėlis;Ančiukų;3691635011;Ne;5;2;0;7
17302;Šaltinėlis;Ančiukų;2630875135;Taip;0;4;0;4
17303;Šaltinėlis;Ančiukų;2973820849;Taip;4;7;0;11
17304;Šaltinėlis;Ančiukų;6487378225;Taip;6;0;0;6
17305;Šaltinėlis;Ančiukų;1464992631;Taip;10;5;0;15
17306;Šaltinėlis;Ančiukų;9274165569;Taip;10;1;0;11
17307;Šaltinėlis;Ančiukų;4332884673;Taip;0;1;0;1
17308;Šaltinėlis;Ančiukų;9362495172;Ne;0;7;1;8
17309;Šaltinėlis;Ančiukų;7737797979;Taip;5;2;0;7
17310;Šaltinėlis;Bitučių;54025577281;Taip;0;11;0;11
17311;Šaltinėlis;Bitučių;6669392157;Taip;0;0;3;3
17312;Šaltinėlis;Bitučių;28956971978;Taip;0;1;0;1
17313;Šaltinėlis;Bitučių;14213856824;Taip;0;0;1;1
17314;Šaltinėlis;Bitučių;80649337160;Taip;0;9;0;9
17315;Šaltinėlis;Bitučių;92958012146;Taip;0;0;1;1
17316;Šaltinėlis;Bitučių;84656960510;Taip;0;0;7;7
17317;Šaltinėlis;Bitučių;83621946293;Taip;0;12;0;12
17318;Šaltinėlis;Bitučių;67808618878;Ne;0;1;0;1
17319;Šaltinėlis;Bitučių;1278910777;Taip;0;5;0;5
17320;Šaltinėlis;Bitučių;9647785988;Ne;6;2;0;8
17321;Šaltinėlis;Bitučių;29482180151;Taip;0;5;0;5
17322;Šaltinėlis;Bitučių;64821172553;Taip;5;0;2;7
17323;Šaltinėlis;Bitučių;25459069972;Ne;0;7;1;8
17324;Šaltinėlis;Bitučių;5056986469;Taip;19;0;0;19
17325;Šaltinėlis;Bitučių;89358384113;Taip;0;0;1;1
17326;Šaltinėlis;Bitučių;4050444191;Taip;0;8;0;8
17327;Šaltinėlis;Bitučių;89093437170;Taip;0;5;0;5
17328;Šaltinėlis;Bitučių;51872331010;Taip;0;0;7;7
17329;Šaltinėlis;Bitučių;5744976843;Taip;0;13;0;13
17330;Šaltinėlis;Saulutės;72372808270;Taip;0;5;0;5
17331;Šaltinėlis;Saulutės;81082410620;Taip;0;2;0;2
17332;Šaltinėlis;Saulutės;70315400705;Ne;0;5;0;5
17333;Šaltinėlis;Saulutės;57847832778;Taip;0;6;0;6
17334;Šaltinėlis;Saulutės;59164202996;Taip;0;8;0;8
17335;Šaltinėlis;Saulutės;3626545396;Ne;0;17;0;17
17336;Šaltinėlis;Saulutės;95542489944;Taip;0;4;0;4
17337;Šaltinėlis;Saulutės;83173349544;Taip;0;6;0;6
17338;Šaltinėlis;Saulutės;19630605543;Taip;3;0;0;3
17339;Šaltinėlis;Saulutės;93256161233;Taip;0;3;0;3
17340;Šaltinėlis;Saulutės;3072314714;Taip;5;0;0;5
17341;Šaltinėlis;Saulutės;35401075864;Ne;0;0;1;1
17342;Šaltinėlis;Saulutės;1924418657;Taip;7;11;0;18
17343;Šaltinėlis;Saulutės;23090033086;Taip;12;0;0;12
17344;Šaltinėlis;Meškiukų;2013810425;Taip;9;4;0;13
17345;Šaltinėlis;Meškiukų;1044723472;Taip;18;0;0;18
17346;Šaltinėlis;Meškiukų;8776976566;Taip;0;13;0;13
17347;Šaltinėlis;Meškiukų;4749756473;Taip;0;0;1;1
17348;Šaltinėlis;Meškiukų;5215769929;Taip;0;13;0;13
17349;Šaltinėlis;Meškiukų;1073305554;Taip;0;0;4;4
17350;Šaltinėlis;Meškiukų;1614411921;Ne;5;9;0;14
17351;Šaltinėlis;Meškiukų;77518622497;Taip;11;1;0;12
17352;Šaltinėlis;Meškiukų;6887838949;Taip;8;0;0;8
17353;Šaltinėlis;Nykštukai;1390316465;Taip;5;0;0;5
17354;Šaltinėlis;Nykštukai;1955018380;Ne;5;3;0;8
17355;Šaltinėlis;Nykštukai;1718488108;Taip;8;3;0;11
17356;Šaltinėlis;Nykštukai;37786438977;Taip;8;5;0;13
17357;Šaltinėlis;Nykštukai;48525545812;Taip;6;4;0;10
17358;Šaltinėlis;Nykštukai;1658370782;Ne;16;0;0;16
17359;Šaltinėlis;Nykštukai;32264290873;Taip;0;10;0;10
17360;Šaltinėlis;Nykštukai;1456486363;Taip;0;2;0;2
17361;Šaltinėlis;Nykštukai;79406746980;Taip;0;4;0;4
17362;Šaltinėlis;Nykštukai;32949623652;Taip;0;12;0;12
17363;Šaltinėlis;Nykštukai;1767635282;Taip;10;0;0;10
17364;Šaltinėlis;Nykštukai;1190394855;Taip;6;0;0;6
17365;Šaltinėlis;Nykštukai;6764006747;Taip;0;2;0;2
17366;Šaltinėlis;Nykštukai;3577137327;Taip;5;3;0;8
17367;Šaltinėlis;Nykštukai;4901977623;Taip;17;0;0;17
17368;Šaltinėlis;Nykštukai;5442943843;Taip;12;3;0;15
17369;Šaltinėlis;Perliukų;17147527171;Ne;0;1;0;1
17370;Šaltinėlis;Perliukų;11083638216;Taip;0;0;4;4
17371;Šaltinėlis;Perliukų;1091056386;Taip;3;0;0;3
17372;Šaltinėlis;Perliukų;52507085619;Taip;6;0;0;6
17373;Šaltinėlis;Perliukų;23301579810;Taip;0;0;1;1
17374;Šaltinėlis;Perliukų;2146141461;Taip;0;0;8;8
17375;Šaltinėlis;Perliukų;1958647188;Taip;0;18;0;18
17376;Šaltinėlis;Perliukų;2034838765;Taip;0;0;1;1
17377;Šaltinėlis;Perliukų;1935762293;Taip;11;0;0;11
17378;Šaltinėlis;Perliukų;1583520894;Ne;0;18;0;18
17379;Šaltinėlis;Perliukų;1023238509;Taip;0;2;0;2
17380;Šaltinėlis;Perliukų;84494627465;Taip;0;3;0;3
17381;Šaltinėlis;Perliukų;1130153806;Taip;8;0;0;8
17382;Šaltinėlis;Perliukų;1004445904;Taip;0;2;0;2
17383;Šaltinėlis;Perliukų;2125176999;Ne;0;0;11;11
17384;Šaltinėlis;Perliukų;9425353041;Taip;0;8;0;8
17385;Šaltinėlis;Perliukų;526307704;Taip;0;19;0;19
17386;Šaltinėlis;Perliukų;7262120071;Ne;0;0;2;2
17387;Šaltinėlis;Perliukų;6068980312;Taip;0;2;0;2
17388;Šaltinėlis;Perliukų;5869977541;Taip;2;7;0;9
17389;Šaltinėlis;Perliukų;4416064304;Ne;5;0;1;6
17390;Šaltinėlis;BORUŽĖLĖS;9762392403;Ne;0;2;0;2
17391;Šaltinėlis;BORUŽĖLĖS;9522524163;Taip;16;3;0;19
17392;Šaltinėlis;BORUŽĖLĖS;5854723120;Taip;0;11;0;11
17393;Šaltinėlis;BORUŽĖLĖS;5799032398;Taip;0;17;0;17
17394;Šaltinėlis;BORUŽĖLĖS;5525740049;Taip;0;6;0;6
17395;Šaltinėlis;BORUŽĖLĖS;4681460322;Taip;19;1;0;20
17396;Šaltinėlis;BORUŽĖLĖS;4430546695;Taip;20;0;0;20
17397;Šaltinėlis;BORUŽĖLĖS;4743907195;Taip;19;0;0;19
17398;Šaltinėlis;1A;86995081866;Taip;0;6;0;6
17399;Šaltinėlis;1A;89489007301;Taip;0;22;0;22
17400;Šaltinėlis;1A;66754907606;Taip;0;22;0;22
17401;Šaltinėlis;1A;9705941341;Taip;0;22;0;22
17402;Šaltinėlis;1A;47045578599;Taip;0;6;0;6
17403;Šaltinėlis;1A;35387543586;Taip;0;1;0;1
17404;Šaltinėlis;1A;40769315138;Taip;0;7;0;7
17405;Šaltinėlis;1A;70948186548;Taip;0;1;0;1
17406;Šaltinėlis;1A;62612067151;Taip;0;2;0;2
17407;Šaltinėlis;1A;38496350161;Taip;0;13;0;13
17408;Šaltinėlis;1A;29683761586;Ne;0;2;0;2
17409;Šaltinėlis;1A;2323456393;Ne;0;22;0;22
17410;Šaltinėlis;1A;9927833966;Ne;0;3;0;3
17411;Šaltinėlis;1A;56279691365;Taip;0;1;0;1
17412;Šaltinėlis;1A;96133834896;Ne;0;22;0;22
17413;Šaltinėlis;1A;7929809205;Ne;0;6;0;6
17414;Šaltinėlis;1A;7563879445;Taip;0;1;0;1
17415;Šaltinėlis;"2A klasė";4843823058;Ne;0;1;0;1
17416;Šaltinėlis;"2A klasė";6044895102;Ne;0;1;0;1
17417;Šaltinėlis;"2A klasė";8680271000;Ne;0;2;0;2
17418;Šaltinėlis;"2A klasė";1839665658;Ne;0;1;0;1
17419;Šaltinėlis;"2A klasė";2076892804;Ne;0;1;0;1
17420;Šaltinėlis;"2A klasė";7967108692;Ne;0;1;0;1
17421;Šaltinėlis;"2A klasė";5012608633;Ne;0;5;0;5
17422;Šaltinėlis;"2A klasė";8445115141;Ne;0;1;0;1
17423;Šaltinėlis;"2A klasė";7214517805;Ne;0;22;0;22
17424;Šaltinėlis;"2A klasė";6876036723;Ne;0;22;0;22
17425;Šaltinėlis;"2A klasė";6171441011;Ne;0;5;0;5
17426;Šaltinėlis;"2A klasė";1450894955;Ne;0;22;0;22
17427;Šaltinėlis;"2A klasė";8898225999;Ne;0;22;0;22
17428;Šaltinėlis;"2A klasė";92001008485;Taip;0;1;0;1
17429;Šaltinėlis;"2B klasė";3329317171;Ne;0;2;0;2
17430;Šaltinėlis;"2B klasė";2089316824;Ne;0;1;0;1
17431;Šaltinėlis;"2B klasė";5776007602;Ne;0;5;0;5
17432;Šaltinėlis;"2B klasė";7420737103;Ne;0;2;0;2
17433;Šaltinėlis;"2B klasė";4141263000;Ne;0;1;0;1
17434;Šaltinėlis;"2B klasė";5999279571;Ne;0;5;0;5
17435;Šaltinėlis;"2B klasė";7142082502;Ne;0;22;0;22
17436;Šaltinėlis;"2B klasė";3037854361;Ne;0;2;0;2
17437;Šaltinėlis;"2B klasė";8219291385;Ne;0;1;0;1
17438;Šaltinėlis;"2B klasė";3863654037;Ne;0;1;0;1
17439;Šaltinėlis;"2B klasė";8380122669;Ne;0;2;0;2
17440;Šaltinėlis;"2B klasė";6719801285;Ne;0;1;0;1
17441;Šaltinėlis;"2B klasė";49275031765;Taip;0;4;0;4
17442;Šaltinėlis;"2B klasė";82404351290;Taip;0;3;0;3
17443;Šaltinėlis;"2B klasė";1756003648;Taip;0;22;0;22
17444;Šaltinėlis;"2B klasė";2002711790;Taip;0;2;0;2
17445;Šaltinėlis;"3A klasė";2010277249;Ne;0;1;0;1
17446;Šaltinėlis;"3A klasė";3553168020;Ne;0;12;0;12
17447;Šaltinėlis;"3A klasė";9341104954;Ne;0;5;0;5
17448;Šaltinėlis;"3A klasė";8714253922;Ne;0;6;0;6
17449;Šaltinėlis;"3A klasė";6948074305;Ne;0;9;0;9
17450;Šaltinėlis;"3A klasė";6765467361;Ne;0;4;0;4
17451;Šaltinėlis;"3A klasė";9057225956;Ne;0;1;0;1
17452;Šaltinėlis;"3A klasė";8503985429;Ne;0;11;0;11
17453;Šaltinėlis;"3A klasė";6443537515;Ne;0;5;0;5
17454;Šaltinėlis;"3A klasė";2154195956;Ne;0;5;0;5
17455;Šaltinėlis;"3A klasė";3636296862;Ne;0;4;0;4
17456;Šaltinėlis;"3A klasė";4062628468;Ne;0;4;0;4
17457;Šaltinėlis;"3A klasė";4977611599;Ne;0;2;0;2
17458;Šaltinėlis;"3A klasė";47857916979;Taip;0;22;0;22
17459;Šaltinėlis;"3A klasė";57928407025;Ne;0;22;0;22
17460;Šaltinėlis;"3A klasė";24414070672;Ne;0;22;0;22
17461;Šaltinėlis;"3A klasė";4884745983;Taip;0;22;0;22
17462;Šaltinėlis;"4A klasė";9593691923;Ne;0;5;0;5
17463;Šaltinėlis;"4A klasė";6511702530;Ne;0;22;0;22
17464;Šaltinėlis;"4A klasė";4852664619;Ne;0;2;0;2
17465;Šaltinėlis;"4A klasė";5000390873;Ne;0;2;0;2
17466;Šaltinėlis;"4A klasė";4673345747;Ne;0;4;0;4
17467;Šaltinėlis;"4A klasė";2890127126;Ne;0;3;0;3
17468;Šaltinėlis;"4A klasė";6507364244;Ne;0;2;0;2
17469;Šaltinėlis;"4A klasė";6109577947;Ne;0;3;0;3
17470;Šaltinėlis;"4A klasė";7820579483;Ne;0;5;0;5
17471;Šaltinėlis;"4A klasė";6716488827;Ne;0;3;0;3
17472;Šaltinėlis;"4A klasė";8503609901;Ne;0;22;0;22
17473;Šaltinėlis;"4A klasė";5212176791;Ne;0;12;0;12
17474;Šaltinėlis;"4A klasė";6810655952;Ne;0;2;0;2
17475;Šaltinėlis;"4A klasė";4699743123;Ne;0;9;0;9
17476;Šaltinėlis;"4A klasė";4989298444;Ne;0;4;0;4
17477;Šaltinėlis;"4A klasė";5234879459;Ne;0;3;0;3
17478;Šaltinėlis;"4A klasė";7307538614;Ne;0;2;0;2
17479;Šaltinėlis;"4A klasė";1322088652;Ne;0;3;0;3
17480;Šaltinėlis;"4A klasė";9980670695;Ne;0;7;0;7
17481;Šaltinėlis;"4A klasė";5574115620;Ne;0;2;0;2
17482;Šaltinėlis;"4A klasė";1765082898;Ne;0;22;0;22
17483;Šaltinėlis;"4A klasė";5623289398;Ne;0;22;0;22
17484;Šaltinėlis;"4A klasė";2310958087;Taip;0;3;0;3
17485;Šaltinėlis;"4A klasė";8431234082;Taip;0;22;0;22
17486;Šaltinėlis;3B;7917468152;Taip;0;1;0;1
17487;Šaltinėlis;3B;5181754988;Ne;0;2;0;2
17488;Šaltinėlis;3B;2413295020;Ne;0;22;0;22
17489;Šaltinėlis;3B;3680528737;Ne;0;3;0;3
17490;Šaltinėlis;3B;7404225862;Ne;0;2;0;2
17491;Šaltinėlis;3B;4335720836;Ne;0;4;0;4
17492;Šaltinėlis;3B;7121732840;Ne;0;2;0;2
17493;Šaltinėlis;3B;5105961386;Ne;0;4;0;4
17494;Šaltinėlis;3B;7316939619;Ne;0;1;0;1
17495;Šaltinėlis;3B;4543101402;Ne;0;3;0;3
17496;Šaltinėlis;3B;4994088781;Ne;0;1;0;1
17497;Šaltinėlis;3B;1687964284;Ne;0;7;0;7
17498;Šaltinėlis;3B;6381956693;Ne;0;4;0;4
17499;Šaltinėlis;3B;3375856084;Ne;0;2;0;2
17500;Šaltinėlis;3B;9708038079;Ne;0;4;0;4
17501;Šaltinėlis;3B;2160937385;Ne;0;2;0;2
17502;Šaltinėlis;3B;8670777468;Ne;0;1;0;1
17503;Gabijėlė;GANDRIUKŲ;80074896113;Taip;0;0;2;2
17504;Gabijėlė;GANDRIUKŲ;57976186090;Taip;0;0;5;5
17505;Gabijėlė;GANDRIUKŲ;78228886019;Taip;0;1;0;1
17506;Gabijėlė;GANDRIUKŲ;65824488786;Taip;0;5;0;5
17507;Gabijėlė;GANDRIUKŲ;58145931856;Taip;0;8;0;8
17508;Gabijėlė;GANDRIUKŲ;92468615840;Taip;0;0;1;1
17509;Gabijėlė;GANDRIUKŲ;54616199708;Taip;0;1;0;1
17510;Gabijėlė;GANDRIUKŲ;54950294060;Taip;4;0;0;4
17511;Gabijėlė;GANDRIUKŲ;1606787727;Taip;0;1;0;1
17512;Gabijėlė;GANDRIUKŲ;43769142642;Taip;0;0;2;2
17513;Gabijėlė;GANDRIUKŲ;36611753307;Taip;0;11;2;13
17514;Gabijėlė;GANDRIUKŲ;77966124767;Taip;0;3;0;3
17515;Gabijėlė;GANDRIUKŲ;26666095358;Taip;0;12;0;12
17516;Gabijėlė;GANDRIUKŲ;53845659478;Taip;0;2;0;2
17517;Gabijėlė;GANDRIUKŲ;68031503463;Taip;0;0;2;2
17518;Gabijėlė;GANDRIUKŲ;27958163601;Taip;0;0;3;3
17519;Gabijėlė;GANDRIUKŲ;12305494453;Taip;1;2;2;5
17520;Gabijėlė;GANDRIUKŲ;3694438650;Ne;5;0;3;8
17521;Gabijėlė;GANDRIUKŲ;62369588485;Taip;0;0;2;2
17522;Gabijėlė;LAKŠTINGALIUKŲ;94564160237;Ne;0;2;2;4
17523;Gabijėlė;LAKŠTINGALIUKŲ;92624581275;Taip;0;1;1;2
17524;Gabijėlė;LAKŠTINGALIUKŲ;38094271521;Taip;0;0;8;8
17525;Gabijėlė;LAKŠTINGALIUKŲ;87667047750;Taip;0;2;2;4
17526;Gabijėlė;LAKŠTINGALIUKŲ;34977494652;Taip;0;3;1;4
17527;Gabijėlė;LAKŠTINGALIUKŲ;24034107401;Taip;11;0;0;11
17528;Gabijėlė;LAKŠTINGALIUKŲ;57442572439;Taip;4;2;0;6
17529;Gabijėlė;LAKŠTINGALIUKŲ;15974374755;Taip;0;0;3;3
17530;Gabijėlė;LAKŠTINGALIUKŲ;53325200270;Taip;0;2;0;2
17531;Gabijėlė;LAKŠTINGALIUKŲ;44723366493;Taip;0;0;2;2
17532;Gabijėlė;LAKŠTINGALIUKŲ;78764062355;Taip;0;0;1;1
17533;Gabijėlė;LAKŠTINGALIUKŲ;94096115282;Taip;0;1;1;2
17534;Gabijėlė;LAKŠTINGALIUKŲ;80865629865;Taip;0;2;0;2
17535;Gabijėlė;LAKŠTINGALIUKŲ;87107559087;Taip;4;6;0;10
17536;Gabijėlė;LAKŠTINGALIUKŲ;58162540225;Ne;0;1;0;1
17537;Gabijėlė;LAKŠTINGALIUKŲ;49652680743;Taip;0;2;3;5
17538;Gabijėlė;LAKŠTINGALIUKŲ;44981766204;Taip;0;0;2;2
17539;Gabijėlė;LAKŠTINGALIUKŲ;64279008849;Taip;0;0;1;1
17540;Gabijėlė;LAKŠTINGALIUKŲ;45682950511;Taip;0;0;1;1
17541;Gabijėlė;LAKŠTINGALIUKŲ;69244396670;Taip;0;0;4;4
17542;Gabijėlė;LAKŠTINGALIUKŲ;48032842307;Taip;4;0;0;4
17543;Gabijėlė;LAKŠTINGALIUKŲ;10026417844;Ne;0;2;0;2
17544;Gabijėlė;LAKŠTINGALIUKŲ;80650155819;Taip;0;2;0;2
17545;Gabijėlė;LAKŠTINGALIUKŲ;3114114973;Taip;0;6;0;6
17546;Gabijėlė;ŽVIRBLIUKŲ;7043775905;Taip;1;0;0;1
17547;Gabijėlė;ŽVIRBLIUKŲ;4475530177;Taip;0;15;7;22
17548;Gabijėlė;ŽVIRBLIUKŲ;5743861607;Taip;5;0;1;6
17549;Gabijėlė;ŽVIRBLIUKŲ;7410541320;Taip;0;20;0;20
17550;Gabijėlė;ŽVIRBLIUKŲ;8036572198;Taip;10;12;0;22
17551;Gabijėlė;ŽVIRBLIUKŲ;4493192224;Taip;17;0;0;17
17552;Gabijėlė;ŽVIRBLIUKŲ;2491503656;Taip;0;3;0;3
17553;Gabijėlė;ŽVIRBLIUKŲ;3268231136;Taip;0;20;0;20
17554;Gabijėlė;ŽVIRBLIUKŲ;8879972953;Taip;5;7;0;12
17555;Gabijėlė;ŽVIRBLIUKŲ;5332825339;Taip;0;0;1;1
17556;Gabijėlė;ŽVIRBLIUKŲ;9627906252;Taip;7;0;0;7
17557;Gabijėlė;ŽVIRBLIUKŲ;1725665169;Ne;0;0;2;2
17558;Gabijėlė;ŽVIRBLIUKŲ;2264669298;Ne;15;0;1;16
17559;Gabijėlė;ŽVIRBLIUKŲ;5942625633;Taip;0;0;1;1
17560;Gabijėlė;ŽVIRBLIUKŲ;7417179112;Taip;7;0;2;9
17561;Gabijėlė;ŽVIRBLIUKŲ;5387026410;Taip;7;0;2;9
17562;Gabijėlė;ŽVIRBLIUKŲ;8292463617;Taip;3;5;0;8
17563;Gabijėlė;GENIUKŲ;3445433386;Taip;0;17;0;17
17564;Gabijėlė;GENIUKŲ;1862655595;Taip;5;0;0;5
17565;Gabijėlė;GENIUKŲ;7312628876;Taip;11;1;0;12
17566;Gabijėlė;GENIUKŲ;1581688238;Taip;5;0;0;5
17567;Gabijėlė;GENIUKŲ;5301905117;Taip;0;16;0;16
17568;Gabijėlė;GENIUKŲ;3176075887;Taip;0;9;0;9
17569;Gabijėlė;GENIUKŲ;6866641272;Taip;13;0;0;13
17570;Gabijėlė;GENIUKŲ;9972967198;Taip;7;0;0;7
17571;Gabijėlė;GENIUKŲ;8305098808;Ne;1;1;0;2
17572;Gabijėlė;GENIUKŲ;4880174255;Taip;0;1;0;1
17573;Gabijėlė;GENIUKŲ;1589534853;Taip;0;1;0;1
17574;Gabijėlė;GENIUKŲ;3020599503;Taip;0;17;0;17
17575;Gabijėlė;GENIUKŲ;4234733280;Taip;0;5;0;5
17576;Gabijėlė;GENIUKŲ;6482824000;Taip;2;0;0;2
17577;Gabijėlė;GENIUKŲ;5962852108;Taip;7;0;0;7
17578;Gabijėlė;GENIUKŲ;7178676049;Taip;10;0;0;10
17579;Gabijėlė;DAGILIUKŲ;9348393550;Taip;14;2;1;17
17580;Gabijėlė;DAGILIUKŲ;4264925447;Taip;14;2;1;17
17581;Gabijėlė;DAGILIUKŲ;9120107749;Taip;16;0;2;18
17582;Gabijėlė;DAGILIUKŲ;9494313873;Taip;4;0;0;4
17583;Gabijėlė;DAGILIUKŲ;7426579018;Taip;19;0;0;19
17584;Gabijėlė;DAGILIUKŲ;9783343968;Taip;0;1;0;1
17585;Gabijėlė;DAGILIUKŲ;3700639354;Taip;3;0;0;3
17586;Gabijėlė;DAGILIUKŲ;8384795164;Taip;0;2;3;5
17587;Gabijėlė;DAGILIUKŲ;4462129182;Taip;22;0;0;22
17588;Gabijėlė;DAGILIUKŲ;8662914262;Taip;0;8;0;8
17589;Gabijėlė;DAGILIUKŲ;9280283478;Taip;17;0;0;17
17590;Gabijėlė;DAGILIUKŲ;1988597157;Ne;22;0;0;22
17591;Gabijėlė;PELEDŽIUKŲ;94478599707;Taip;0;0;1;1
17592;Gabijėlė;PELEDŽIUKŲ;2067646395;Taip;5;0;0;5
17593;Gabijėlė;PELEDŽIUKŲ;1068556799;Taip;0;1;0;1
17594;Gabijėlė;PELEDŽIUKŲ;1171257945;Taip;3;0;6;9
17595;Gabijėlė;PELEDŽIUKŲ;8044682830;Taip;0;1;0;1
17596;Gabijėlė;PELEDŽIUKŲ;43109352262;Taip;0;2;0;2
17597;Gabijėlė;PELEDŽIUKŲ;39679870094;Taip;17;0;0;17
17598;Gabijėlė;PELEDŽIUKŲ;36642141718;Taip;17;0;0;17
17599;Gabijėlė;PELEDŽIUKŲ;1491653325;Taip;3;1;0;4
17600;Gabijėlė;PELEDŽIUKŲ;1608940997;Taip;0;5;0;5
17601;Gabijėlė;PELEDŽIUKŲ;3610392405;Taip;0;0;1;1
17602;Gabijėlė;PELEDŽIUKŲ;4916964663;Taip;4;0;0;4
17603;Gabijėlė;PELEDŽIUKŲ;17443601729;Ne;19;0;0;19
17604;Gabijėlė;PELEDŽIUKŲ;1286307671;Taip;10;4;0;14
17605;Gabijėlė;PELEDŽIUKŲ;37544281230;Taip;0;0;3;3
17606;Gabijėlė;PELEDŽIUKŲ;4726771205;Taip;0;0;1;1
17607;Gabijėlė;PELEDŽIUKŲ;24035160251;Ne;0;0;7;7
17608;Gabijėlė;PELEDŽIUKŲ;38497069329;Taip;5;0;1;6
17609;Gabijėlė;PELEDŽIUKŲ;8746641978;Ne;0;0;1;1
17610;Gabijėlė;KREGZDŽIUKŲ;84945768423;Taip;12;0;1;13
17611;Gabijėlė;KREGZDŽIUKŲ;41661694634;Taip;12;0;0;12
17612;Gabijėlė;KREGZDŽIUKŲ;1743647754;Ne;2;2;0;4
17613;Gabijėlė;KREGZDŽIUKŲ;79544806044;Taip;0;1;0;1
17614;Gabijėlė;KREGZDŽIUKŲ;34683603878;Ne;0;2;2;4
17615;Gabijėlė;KREGZDŽIUKŲ;13013873198;Taip;0;1;1;2
17616;Gabijėlė;KREGZDŽIUKŲ;91643373754;Taip;6;0;4;10
17617;Gabijėlė;KREGZDŽIUKŲ;7298662616;Taip;0;0;1;1
17618;Gabijėlė;KREGZDŽIUKŲ;5884453557;Taip;0;0;1;1
17619;Gabijėlė;KREGZDŽIUKŲ;61217725255;Taip;3;6;0;9
17620;Gabijėlė;KREGZDŽIUKŲ;53576382572;Ne;3;0;0;3
17621;Gabijėlė;KREGZDŽIUKŲ;34998957585;Taip;12;0;8;20
17622;Gabijėlė;KREGZDŽIUKŲ;1770578935;Taip;0;6;1;7
17623;Gabijėlė;KREGZDŽIUKŲ;1455625997;Taip;0;6;0;6
17624;Gabijėlė;KREGZDŽIUKŲ;1937862725;Taip;0;0;3;3
17625;Gabijėlė;KREGZDŽIUKŲ;25732601952;Taip;5;0;0;5
17626;Gabijėlė;KREGZDŽIUKŲ;1217019582;Taip;10;1;0;11
17627;Gabijėlė;KREGZDŽIUKŲ;46552208567;Taip;0;17;0;17
17628;Gabijėlė;KREGZDŽIUKŲ;26058036933;Taip;1;0;0;1
17629;Gabijėlė;KREGZDŽIUKŲ;84120660883;Taip;1;0;0;1
17630;Gabijėlė;KREGZDŽIUKŲ;36447115547;Taip;0;6;0;6
17631;Gabijėlė;KREGZDŽIUKŲ;69294465170;Taip;0;5;0;5
17632;Gabijėlė;ZYLIUKŲ;20248530233;Taip;0;0;5;5
17633;Gabijėlė;ZYLIUKŲ;25691510343;Taip;7;0;0;7
17634;Gabijėlė;ZYLIUKŲ;84464214049;Taip;0;10;0;10
17635;Gabijėlė;ZYLIUKŲ;1505873499;Taip;0;0;2;2
17636;Gabijėlė;ZYLIUKŲ;1523021309;Taip;0;0;1;1
17637;Gabijėlė;ZYLIUKŲ;1642361191;Ne;0;0;1;1
17638;Gabijėlė;ZYLIUKŲ;67189240970;Taip;0;6;0;6
17639;Gabijėlė;ZYLIUKŲ;1036201997;Taip;0;4;0;4
17640;Gabijėlė;ZYLIUKŲ;1240051312;Ne;0;0;2;2
17641;Gabijėlė;ZYLIUKŲ;60548215051;Taip;0;0;3;3
17642;Gabijėlė;ZYLIUKŲ;64168611850;Taip;5;0;8;13
17643;Gabijėlė;ZYLIUKŲ;1988838165;Taip;0;3;0;3
17644;Gabijėlė;ZYLIUKŲ;7778613039;Taip;0;0;2;2
17645;Gabijėlė;ZYLIUKŲ;1583728977;Taip;0;0;2;2
17646;Gabijėlė;ZYLIUKŲ;31458685084;Taip;0;2;0;2
17647;Gabijėlė;ZYLIUKŲ;16804922682;Taip;10;5;0;15
17648;Gabijėlė;ZYLIUKŲ;1213013384;Ne;0;0;7;7
17649;Gabijėlė;ZYLIUKŲ;2010619186;Ne;5;0;2;7
17650;Gabijėlė;VOLUNGĖLIŲ;1779924073;Taip;0;0;2;2
17651;Gabijėlė;VOLUNGĖLIŲ;4166739739;Taip;0;11;0;11
17652;Gabijėlė;VOLUNGĖLIŲ;1492231030;Taip;0;13;0;13
17653;Gabijėlė;VOLUNGĖLIŲ;1317309811;Taip;0;5;0;5
17654;Gabijėlė;VOLUNGĖLIŲ;1523331860;Taip;5;2;1;8
17655;Gabijėlė;VOLUNGĖLIŲ;21740150080;Taip;0;11;0;11
17656;Gabijėlė;VOLUNGĖLIŲ;5558919097;Taip;17;0;0;17
17657;Gabijėlė;VOLUNGĖLIŲ;92191048844;Taip;0;0;1;1
17658;Gabijėlė;VOLUNGĖLIŲ;9683524530;Taip;12;0;5;17
17659;Gabijėlė;VOLUNGĖLIŲ;59837942520;Taip;2;0;0;2
17660;Gabijėlė;VOLUNGĖLIŲ;8480479946;Taip;0;8;0;8
17661;Gabijėlė;VOLUNGĖLIŲ;13265905500;Taip;0;0;2;2
17662;Gabijėlė;VOLUNGĖLIŲ;43737170074;Taip;3;0;2;5
17663;Gabijėlė;VOLUNGĖLIŲ;1480704497;Taip;0;3;0;3
17664;Gabijėlė;VOLUNGĖLIŲ;1669529717;Taip;10;0;0;10
17665;Gabijėlė;VOLUNGĖLIŲ;5704281727;Taip;5;0;0;5
17666;Gabijėlė;VOLUNGĖLIŲ;95685721388;Taip;7;2;0;9
17667;Gabijėlė;VOLUNGĖLIŲ;76416239647;Taip;0;0;1;1
17668;Gabijėlė;VOLUNGĖLIŲ;2102821834;Taip;0;1;0;1
17669;Gabijėlė;VOLUNGĖLIŲ;43869055555;Ne;0;0;1;1
17670;Gabijėlė;VOLUNGĖLIŲ;2051109865;Ne;6;2;0;8
17671;Gabijėlė;VOLUNGĖLIŲ;4662981914;Taip;18;1;0;19
17672;Gabijėlė;VOLUNGĖLIŲ;64252867351;Taip;0;9;0;9
17673;Gabijėlė;ANČIUKŲ;43123279348;Taip;0;9;0;9
17674;Gabijėlė;ANČIUKŲ;2036978425;Taip;0;0;3;3
17675;Gabijėlė;ANČIUKŲ;5219706067;Taip;0;3;0;3
17676;Gabijėlė;ANČIUKŲ;10796114623;Ne;0;9;0;9
17677;Gabijėlė;ANČIUKŲ;3454412432;Taip;4;3;0;7
17678;Gabijėlė;ANČIUKŲ;9822093084;Taip;5;0;3;8
17679;Gabijėlė;ANČIUKŲ;85836097485;Taip;0;0;5;5
17680;Gabijėlė;ANČIUKŲ;28017865889;Taip;0;6;0;6
17681;Gabijėlė;ANČIUKŲ;1917587420;Taip;0;20;0;20
17682;Gabijėlė;ANČIUKŲ;1465584524;Taip;5;0;1;6
17683;Gabijėlė;ANČIUKŲ;6198439092;Taip;0;0;2;2
17684;Gabijėlė;ANČIUKŲ;5783373671;Taip;5;9;0;14
17685;Gabijėlė;ANČIUKŲ;7948343328;Taip;0;0;4;4
17686;Gabijėlė;ANČIUKŲ;2052892422;Taip;0;6;0;6
17687;Gabijėlė;ANČIUKŲ;8111239476;Taip;18;0;1;19
17688;Gabijėlė;ANČIUKŲ;6766770793;Taip;0;0;1;1
17689;Gabijėlė;ANČIUKŲ;8778396292;Taip;0;0;5;5
17690;Gabijėlė;ANČIUKŲ;4085049535;Taip;0;18;0;18
17691;Gabijėlė;BALANDŽIUKŲ;4110081664;Taip;2;0;0;2
17692;Gabijėlė;BALANDŽIUKŲ;6719097956;Taip;0;3;0;3
17693;Gabijėlė;BALANDŽIUKŲ;9157819780;Taip;0;6;0;6
17694;Gabijėlė;BALANDŽIUKŲ;1045338865;Taip;0;7;3;10
17695;Gabijėlė;BALANDŽIUKŲ;4330624300;Taip;0;0;21;21
17696;Gabijėlė;BALANDŽIUKŲ;33124420723;Taip;0;0;13;13
17697;Gabijėlė;BALANDŽIUKŲ;2097260657;Taip;3;0;0;3
17698;Gabijėlė;BALANDŽIUKŲ;8131229306;Taip;2;7;2;11
17699;Gabijėlė;BALANDŽIUKŲ;8525869648;Taip;9;4;0;13
17700;Gabijėlė;BALANDŽIUKŲ;1010721404;Taip;0;1;0;1
17701;Gabijėlė;BALANDŽIUKŲ;56914218692;Taip;0;0;4;4
17702;Gabijėlė;BALANDŽIUKŲ;2260623869;Taip;0;0;14;14
17703;Gabijėlė;BALANDŽIUKŲ;7144977279;Ne;2;0;0;2
17704;Gabijėlė;BALANDŽIUKŲ;2776579713;Taip;3;0;1;4
17705;Gabijėlė;BALANDŽIUKŲ;7977751362;Taip;2;0;0;2
17706;Gabijėlė;BALANDŽIUKŲ;5906952432;Taip;2;0;0;2
17707;Gabijėlė;BALANDŽIUKŲ;9197020006;Taip;0;2;0;2
17708;Gabijėlė;VYTURIUKŲ;2059859352;Taip;1;0;1;2
17709;Gabijėlė;VYTURIUKŲ;87868591956;Taip;0;0;3;3
17710;Gabijėlė;VYTURIUKŲ;1859288888;Taip;8;0;0;8
17711;Gabijėlė;VYTURIUKŲ;44322663690;Ne;9;0;0;9
17712;Gabijėlė;VYTURIUKŲ;1479311429;Ne;10;5;0;15
17713;Gabijėlė;VYTURIUKŲ;4765125810;Taip;7;0;1;8
17714;Gabijėlė;VYTURIUKŲ;1219257874;Taip;0;5;0;5
17715;Gabijėlė;VYTURIUKŲ;39269336820;Taip;0;5;0;5
17716;Gabijėlė;VYTURIUKŲ;1829866148;Taip;0;0;1;1
17717;Gabijėlė;VYTURIUKŲ;1949644078;Taip;1;4;0;5
17718;Gabijėlė;VYTURIUKŲ;47989272121;Ne;0;13;0;13
17719;Gabijėlė;VYTURIUKŲ;5736000160;Taip;0;0;1;1
17720;Gabijėlė;VYTURIUKŲ;9320327120;Taip;5;3;0;8
17721;Gabijėlė;VYTURIUKŲ;4632508075;Taip;0;15;7;22
17722;Gabijėlė;VYTURIUKŲ;1426802917;Taip;0;8;0;8
17723;Gabijėlė;VYTURIUKŲ;41212490042;Ne;0;0;4;4
17724;Gabijėlė;VYTURIUKŲ;1852597048;Taip;1;0;0;1
17725;Gabijėlė;VYTURIUKŲ;1287165224;Taip;0;2;0;2
17726;Gabijėlė;VYTURIUKŲ;34609028374;Taip;0;2;0;2
17727;Gabijėlė;VYTURIUKŲ;48342584892;Taip;11;0;3;14
17728;Gabijėlė;VYTURIUKŲ;90520726029;Taip;10;0;0;10
17729;Gabijėlė;VYTURIUKŲ;6492199649;Taip;0;5;0;5
17730;Pilaitukas;BITUTĖS;27134663020;Taip;14;0;0;14
17731;Pilaitukas;BITUTĖS;93292073339;Taip;14;0;0;14
17732;Pilaitukas;BITUTĖS;99558991322;Taip;0;4;0;4
17733;Pilaitukas;BITUTĖS;46467461875;Taip;7;10;4;21
17734;Pilaitukas;BITUTĖS;97868106590;Taip;4;0;0;4
17735;Pilaitukas;BITUTĖS;56237836622;Taip;4;2;0;6
17736;Pilaitukas;BITUTĖS;98123777614;Taip;1;6;0;7
17737;Pilaitukas;BITUTĖS;88894299577;Taip;0;2;3;5
17738;Pilaitukas;BITUTĖS;49882457703;Taip;12;0;0;12
17739;Pilaitukas;BITUTĖS;98876022289;Taip;0;0;2;2
17740;Pilaitukas;BITUTĖS;32580431386;Taip;0;0;2;2
17741;Pilaitukas;BITUTĖS;36677686051;Taip;5;0;0;5
17742;Pilaitukas;BITUTĖS;89335569661;Taip;5;5;0;10
17743;Pilaitukas;BITUTĖS;74933839730;Taip;0;4;0;4
17744;Pilaitukas;BITUTĖS;26318820010;Taip;0;2;2;4
17745;Pilaitukas;BITUTĖS;68819621853;Taip;0;0;1;1
17746;Pilaitukas;BITUTĖS;92116532227;Taip;0;1;0;1
17747;Pilaitukas;BITUTĖS;1854471823;Taip;0;5;1;6
17748;Pilaitukas;BITUTĖS;95753711905;Ne;0;2;1;3
17749;Pilaitukas;ZUIKUČIAI;66377321935;Taip;0;10;0;10
17750;Pilaitukas;ZUIKUČIAI;27233065857;Ne;0;0;1;1
17751;Pilaitukas;ZUIKUČIAI;74367577786;Taip;0;3;0;3
17752;Pilaitukas;ZUIKUČIAI;37415672544;Taip;10;0;0;10
17753;Pilaitukas;ZUIKUČIAI;50368168240;Taip;0;0;1;1
17754;Pilaitukas;ZUIKUČIAI;21795184411;Taip;0;7;0;7
17755;Pilaitukas;ZUIKUČIAI;63470473930;Taip;7;2;0;9
17756;Pilaitukas;ZUIKUČIAI;49728283339;Taip;0;0;1;1
17757;Pilaitukas;ZUIKUČIAI;45165187254;Taip;0;0;2;2
17758;Pilaitukas;ZUIKUČIAI;62992423192;Taip;0;1;0;1
17759;Pilaitukas;ZUIKUČIAI;86572852457;Taip;0;0;1;1
17760;Pilaitukas;ZUIKUČIAI;6913383121;Ne;8;6;0;14
17761;Pilaitukas;ZUIKUČIAI;44413072002;Taip;12;0;0;12
17762;Pilaitukas;ZUIKUČIAI;53049608654;Taip;0;0;10;10
17763;Pilaitukas;ZUIKUČIAI;79398058989;Taip;0;7;3;10
17764;Pilaitukas;ZUIKUČIAI;8441380474;Taip;3;11;0;14
17765;Pilaitukas;ZUIKUČIAI;1286286153;Taip;0;9;2;11
17766;Pilaitukas;ZUIKUČIAI;83886439719;Taip;4;10;0;14
17767;Pilaitukas;ZUIKUČIAI;3723836301;Taip;0;0;3;3
17768;Pilaitukas;ZUIKUČIAI;1896452184;Taip;0;8;2;10
17769;Pilaitukas;ANČIUKAI;5949185075;Taip;2;0;0;2
17770;Pilaitukas;ANČIUKAI;9724892897;Taip;6;0;0;6
17771;Pilaitukas;ANČIUKAI;36338976218;Taip;3;1;0;4
17772;Pilaitukas;ANČIUKAI;1114477688;Taip;21;1;0;22
17773;Pilaitukas;ANČIUKAI;1512181401;Taip;0;0;1;1
17774;Pilaitukas;ANČIUKAI;3821748678;Taip;2;0;0;2
17775;Pilaitukas;ANČIUKAI;6222888898;Taip;8;0;1;9
17776;Pilaitukas;ANČIUKAI;5206439753;Taip;5;3;0;8
17777;Pilaitukas;ANČIUKAI;79485847381;Taip;10;5;0;15
17778;Pilaitukas;ANČIUKAI;5211988291;Taip;6;0;0;6
17779;Pilaitukas;ANČIUKAI;87760608710;Taip;10;0;10;20
17780;Pilaitukas;ANČIUKAI;7909465673;Taip;0;0;2;2
17781;Pilaitukas;ANČIUKAI;2298935154;Taip;7;0;0;7
17782;Pilaitukas;ANČIUKAI;4694691187;Taip;9;0;0;9
17783;Pilaitukas;ANČIUKAI;9224653856;Taip;10;0;2;12
17784;Pilaitukas;MEŠKIUKAI;57931719105;Taip;0;13;0;13
17785;Pilaitukas;MEŠKIUKAI;14554050141;Taip;0;10;1;11
17786;Pilaitukas;MEŠKIUKAI;9015675095;Taip;5;1;0;6
17787;Pilaitukas;MEŠKIUKAI;2929868229;Taip;11;0;0;11
17788;Pilaitukas;MEŠKIUKAI;9618329726;Taip;5;0;2;7
17789;Pilaitukas;MEŠKIUKAI;4038320896;Taip;0;1;2;3
17790;Pilaitukas;MEŠKIUKAI;3794882532;Taip;0;7;0;7
17791;Pilaitukas;MEŠKIUKAI;18466900688;Taip;6;4;0;10
17792;Pilaitukas;MEŠKIUKAI;2736736697;Ne;0;5;0;5
17793;Pilaitukas;MEŠKIUKAI;39600380611;Taip;5;0;0;5
17794;Pilaitukas;MEŠKIUKAI;5604992163;Taip;13;0;0;13
17795;Pilaitukas;MEŠKIUKAI;9450834035;Taip;13;0;0;13
17796;Pilaitukas;MEŠKIUKAI;5689385925;Taip;6;1;1;8
17797;Pilaitukas;MEŠKIUKAI;1003278169;Ne;8;0;0;8
17798;Pilaitukas;MEŠKIUKAI;5939557073;Taip;10;0;0;10
17799;Pilaitukas;MEŠKIUKAI;6117985788;Taip;20;0;0;20
17800;Pilaitukas;ŽUVYTĖS;93589370424;Taip;0;0;3;3
17801;Pilaitukas;ŽUVYTĖS;49645077501;Taip;0;0;2;2
17802;Pilaitukas;ŽUVYTĖS;10478661553;Taip;4;0;0;4
17803;Pilaitukas;ŽUVYTĖS;4068489824;Taip;5;0;0;5
17804;Pilaitukas;ŽUVYTĖS;81748034503;Taip;0;3;1;4
17805;Pilaitukas;ŽUVYTĖS;62503472334;Taip;0;0;2;2
17806;Pilaitukas;ŽUVYTĖS;20879249256;Taip;0;2;4;6
17807;Pilaitukas;ŽUVYTĖS;7328603850;Taip;0;1;1;2
17808;Pilaitukas;ŽUVYTĖS;61755266054;Taip;4;0;0;4
17809;Pilaitukas;ŽUVYTĖS;63984542506;Taip;0;0;2;2
17810;Pilaitukas;ŽUVYTĖS;95470553230;Taip;1;0;6;7
17811;Pilaitukas;ŽUVYTĖS;93690180882;Ne;0;0;2;2
17812;Pilaitukas;ŽUVYTĖS;20697780436;Ne;0;4;2;6
17813;Pilaitukas;ŽUVYTĖS;17844195687;Taip;0;1;0;1
17814;Pilaitukas;PAUKŠTELIAI;9471549377;Taip;9;0;0;9
17815;Pilaitukas;PAUKŠTELIAI;63957573208;Taip;0;2;0;2
17816;Pilaitukas;PAUKŠTELIAI;67100267095;Taip;7;0;0;7
17817;Pilaitukas;PAUKŠTELIAI;98711809989;Taip;6;0;0;6
17818;Pilaitukas;PAUKŠTELIAI;18957334122;Taip;4;0;2;6
17819;Pilaitukas;PAUKŠTELIAI;61157601075;Ne;7;1;0;8
17820;Pilaitukas;PAUKŠTELIAI;97891667232;Taip;0;10;1;11
17821;Pilaitukas;PAUKŠTELIAI;41623603103;Taip;0;2;1;3
17822;Pilaitukas;PAUKŠTELIAI;67880125472;Taip;0;4;0;4
17823;Pilaitukas;PAUKŠTELIAI;8978245239;Taip;0;6;1;7
17824;Pilaitukas;PAUKŠTELIAI;89662617221;Taip;5;0;0;5
17825;Pilaitukas;PAUKŠTELIAI;40315977143;Taip;6;0;0;6
17826;Pilaitukas;PAUKŠTELIAI;1836597284;Ne;0;0;2;2
17827;Pilaitukas;PAUKŠTELIAI;86837043817;Taip;0;8;0;8
17828;Pilaitukas;PAUKŠTELIAI;51715261040;Taip;3;0;0;3
17829;Pilaitukas;PAUKŠTELIAI;94197429703;Taip;3;7;0;10
17830;Pilaitukas;BORUŽĖLĖS;98045145204;Taip;5;0;2;7
17831;Pilaitukas;BORUŽĖLĖS;2145561638;Taip;0;13;0;13
17832;Pilaitukas;BORUŽĖLĖS;14937983736;Taip;0;0;1;1
17833;Pilaitukas;BORUŽĖLĖS;1704733670;Ne;0;1;1;2
17834;Pilaitukas;BORUŽĖLĖS;8693280134;Taip;0;0;12;12
17835;Pilaitukas;BORUŽĖLĖS;2308673826;Taip;0;0;1;1
17836;Pilaitukas;BORUŽĖLĖS;1714711904;Taip;0;0;3;3
17837;Pilaitukas;BORUŽĖLĖS;2436416327;Taip;5;0;0;5
17838;Pilaitukas;BORUŽĖLĖS;2561804291;Taip;6;0;2;8
17839;Pilaitukas;BORUŽĖLĖS;9414846817;Taip;7;0;3;10
17840;Pilaitukas;BORUŽĖLĖS;56069293343;Taip;0;0;1;1
17841;Pilaitukas;BORUŽĖLĖS;7156205658;Taip;1;2;5;8
17842;Pilaitukas;BORUŽĖLĖS;95439358242;Ne;2;1;0;3
17843;Pilaitukas;BORUŽĖLĖS;6024861998;Taip;7;0;0;7
17844;Pilaitukas;BORUŽĖLĖS;58416972423;Taip;22;0;0;22
17845;Pilaitukas;BORUŽĖLĖS;1779631590;Taip;0;1;0;1
17846;Pilaitukas;BORUŽĖLĖS;3198896300;Taip;0;3;0;3
17847;Pilaitukas;DRUGELIAI;70499278669;Taip;0;7;3;10
17848;Pilaitukas;DRUGELIAI;86192743256;Taip;0;2;0;2
17849;Pilaitukas;DRUGELIAI;1126288017;Taip;10;0;1;11
17850;Pilaitukas;DRUGELIAI;1726899445;Taip;0;0;2;2
17851;Pilaitukas;DRUGELIAI;2032732500;Taip;13;0;0;13
17852;Pilaitukas;DRUGELIAI;1586157196;Taip;0;3;0;3
17853;Pilaitukas;DRUGELIAI;7961518607;Taip;0;3;0;3
17854;Pilaitukas;DRUGELIAI;7082054458;Taip;0;3;0;3
17855;Pilaitukas;DRUGELIAI;1290119150;Taip;11;0;0;11
17856;Pilaitukas;DRUGELIAI;64601938351;Taip;13;1;0;14
17857;Pilaitukas;DRUGELIAI;64496490473;Taip;0;1;2;3
17858;Pilaitukas;DRUGELIAI;93217431744;Taip;14;2;0;16
17859;Pilaitukas;DRUGELIAI;62416017620;Taip;0;0;4;4
17860;Pilaitukas;DRUGELIAI;58250008277;Taip;9;0;2;11
17861;Pilaitukas;DRUGELIAI;38456484551;Taip;0;3;0;3
17862;Pilaitukas;DRUGELIAI;7838787153;Taip;8;2;1;11
17863;Pilaitukas;DRUGELIAI;2613078582;Taip;0;6;0;6
17864;Pilaitukas;DRUGELIAI;9246391309;Taip;6;0;0;6
17865;Pilaitukas;PELIUKAI;89730708991;Taip;0;5;0;5
17866;Pilaitukas;PELIUKAI;28559756114;Taip;8;0;0;8
17867;Pilaitukas;PELIUKAI;54387359229;Taip;5;2;0;7
17868;Pilaitukas;PELIUKAI;29229117661;Taip;6;4;0;10
17869;Pilaitukas;PELIUKAI;15303269615;Taip;20;0;0;20
17870;Pilaitukas;PELIUKAI;12327235652;Ne;0;3;0;3
17871;Pilaitukas;PELIUKAI;26063381713;Taip;4;5;0;9
17872;Pilaitukas;PELIUKAI;90148331957;Taip;4;0;0;4
17873;Pilaitukas;PELIUKAI;89719236172;Ne;0;4;0;4
17874;Pilaitukas;PELIUKAI;3685682772;Taip;0;22;0;22
17875;Pilaitukas;PELIUKAI;25608611239;Taip;4;0;0;4
17876;Pilaitukas;PELIUKAI;54706920576;Taip;2;10;0;12
17877;Pilaitukas;PELIUKAI;1168958446;Taip;8;0;0;8
17878;Pilaitukas;PELIUKAI;8152280709;Taip;14;0;1;15
17879;Pilaitukas;PELIUKAI;1613536796;Taip;15;0;0;15
17880;Pilaitukas;PELIUKAI;42514613325;Taip;4;0;0;4
17881;Pilaitukas;PELIUKAI;1611616941;Taip;0;8;0;8
17882;Pilaitukas;PELIUKAI;1726805610;Taip;0;0;1;1
17883;Pilaitukas;PELIUKAI;68571454940;Ne;3;5;0;8
17884;Pilaitukas;KAČIUKAI;74264627858;Taip;10;6;0;16
17885;Pilaitukas;KAČIUKAI;71072645939;Taip;1;0;0;1
17886;Pilaitukas;KAČIUKAI;4283157555;Taip;2;0;0;2
17887;Pilaitukas;KAČIUKAI;78293798850;Taip;4;1;0;5
17888;Pilaitukas;KAČIUKAI;90472705680;Taip;1;0;1;2
17889;Pilaitukas;KAČIUKAI;92823052045;Taip;3;0;0;3
17890;Pilaitukas;KAČIUKAI;82030031331;Taip;4;0;0;4
17891;Pilaitukas;KAČIUKAI;7032684121;Taip;1;0;1;2
17892;Pilaitukas;KAČIUKAI;91980974377;Taip;0;3;0;3
17893;Pilaitukas;KAČIUKAI;2045735700;Taip;7;0;0;7
17894;Pilaitukas;KAČIUKAI;78048449266;Taip;4;5;0;9
17895;Pilaitukas;KAČIUKAI;1508672511;Taip;11;0;0;11
17896;Pilaitukas;KAČIUKAI;4348058482;Taip;0;6;0;6
17897;Pilaitukas;KAČIUKAI;1056269188;Taip;5;4;0;9
17898;Pilaitukas;KAČIUKAI;9496336005;Taip;0;7;0;7
17899;Pilaitukas;KAČIUKAI;6069797837;Taip;8;0;1;9
17900;Pilaitukas;SAULUTĖS;6646474196;Taip;17;0;0;17
17901;Pilaitukas;SAULUTĖS;9414051187;Taip;22;0;0;22
17902;Pilaitukas;SAULUTĖS;3037850837;Ne;10;0;2;12
17903;Pilaitukas;SAULUTĖS;4745358362;Taip;19;1;0;20
17904;Pilaitukas;SAULUTĖS;1677962644;Taip;19;1;0;20
17905;Pilaitukas;SAULUTĖS;7568744500;Taip;5;0;1;6
17906;Pilaitukas;SAULUTĖS;5407354218;Taip;21;0;0;21
17907;Pilaitukas;SAULUTĖS;6525191057;Taip;0;0;1;1
17908;Pilaitukas;SAULUTĖS;1611371690;Taip;22;0;0;22
17909;Pilaitukas;SAULUTĖS;3483758882;Taip;6;0;4;10
17910;Pilaitukas;SAULUTĖS;7853910193;Taip;11;0;0;11
17911;Pilaitukas;SAULUTĖS;5710747769;Taip;15;5;1;21
17912;Pilaitukas;SAULUTĖS;9974310580;Taip;7;3;0;10
17913;Pilaitukas;SAULUTĖS;9126553732;Taip;9;0;0;9
17914;Pilaitukas;SAULUTĖS;7438112270;Taip;9;0;8;17
17915;Pilaitukas;SAULUTĖS;7594484959;Taip;5;5;0;10
17916;Pilaitukas;MENULIUKAI;2406183145;Taip;12;1;0;13
17917;Pilaitukas;MENULIUKAI;2379660463;Taip;12;1;0;13
17918;Pilaitukas;MENULIUKAI;2862447956;Taip;5;0;0;5
17919;Pilaitukas;MENULIUKAI;5353687011;Taip;10;2;0;12
17920;Pilaitukas;MENULIUKAI;9988041515;Taip;15;1;0;16
17921;Pilaitukas;MENULIUKAI;9108428738;Taip;15;1;0;16
17922;Pilaitukas;MENULIUKAI;1585341963;Taip;0;1;0;1
17923;Pilaitukas;MENULIUKAI;9260893320;Taip;0;0;1;1
17924;Pilaitukas;MENULIUKAI;4623818227;Taip;18;0;1;19
17925;Pilaitukas;MENULIUKAI;5640802570;Taip;19;0;0;19
17926;Pilaitukas;MENULIUKAI;9878890346;Taip;4;2;0;6
17927;Pilaitukas;MENULIUKAI;7334494990;Taip;22;0;0;22
17928;Pilaitukas;MENULIUKAI;8207194955;Taip;1;9;0;10
17929;Pilaitukas;MENULIUKAI;1607454890;Taip;13;0;0;13
17930;Pilaitukas;MENULIUKAI;6102253106;Taip;7;0;0;7
17931;Pilaitukas;ĖŽIUKAI;9793278788;Taip;0;0;1;1
17932;Pilaitukas;ĖŽIUKAI;5740951665;Taip;22;0;0;22
17933;Pilaitukas;ĖŽIUKAI;6308557885;Taip;16;0;0;16
17934;Pilaitukas;ĖŽIUKAI;6514731102;Taip;12;0;0;12
17935;Pilaitukas;ĖŽIUKAI;4591799893;Taip;13;0;0;13
17936;Pilaitukas;ĖŽIUKAI;9653647227;Taip;8;0;4;12
17937;Pilaitukas;ĖŽIUKAI;5326689274;Taip;8;0;4;12
17938;Pilaitukas;ĖŽIUKAI;3541354283;Taip;5;0;0;5
17939;Pilaitukas;ĖŽIUKAI;4082490488;Taip;8;0;2;10
17940;Pilaitukas;ĖŽIUKAI;1729494874;Taip;0;3;0;3
17941;Pilaitukas;ĖŽIUKAI;2242454299;Taip;10;5;1;16
17942;Pilaitukas;ĖŽIUKAI;3913169122;Taip;5;0;3;8
17943;Pilaitukas;ĖŽIUKAI;7342388716;Taip;0;0;1;1
17944;Pilaitukas;ĖŽIUKAI;9038324313;Taip;0;0;7;7
17945;"Naujųjų verkių";Lopšelinė;9840473841;Taip;2;0;0;2
17946;"Naujųjų verkių";Lopšelinė;63932903598;Taip;2;0;0;2
17947;"Naujųjų verkių";Lopšelinė;89540088936;Taip;0;9;0;9
17948;"Naujųjų verkių";Lopšelinė;3572188688;Taip;0;0;2;2
17949;"Naujųjų verkių";Lopšelinė;7916257692;Taip;3;0;0;3
17950;"Naujųjų verkių";Lopšelinė;7872515649;Taip;22;0;0;22
17951;"Naujųjų verkių";Lopšelinė;9200073539;Taip;21;0;0;21
17952;"Naujųjų verkių";Lopšelinė;8429923120;Taip;0;22;0;22
17953;"Naujųjų verkių";Lopšelinė;1536075084;Taip;0;0;8;8
17954;"Naujųjų verkių";Lopšelinė;7010430969;Taip;0;6;0;6
17955;"Naujųjų verkių";Lopšelinė;9462019924;Taip;0;1;0;1
17956;"Naujųjų verkių";Lopšelinė;7734802846;Taip;0;7;0;7
17957;"Naujųjų verkių";Darželinė;52116449181;Taip;0;22;0;22
17958;"Naujųjų verkių";Darželinė;31334483791;Taip;0;13;0;13
17959;"Naujųjų verkių";Darželinė;64888070188;Taip;0;1;0;1
17960;"Naujųjų verkių";Darželinė;12970840107;Taip;10;0;0;10
17961;"Naujųjų verkių";Darželinė;91710448735;Taip;0;5;0;5
17962;"Naujųjų verkių";Darželinė;70974231925;Taip;0;5;0;5
17963;"Naujųjų verkių";Darželinė;96956603806;Taip;0;5;0;5
17964;"Naujųjų verkių";Darželinė;60556803369;Taip;0;1;0;1
17965;"Naujųjų verkių";Darželinė;2636744220;Taip;5;0;0;5
17966;"Naujųjų verkių";Darželinė;1273331977;Taip;0;4;0;4
17967;"Naujųjų verkių";Darželinė;1321551506;Taip;0;11;0;11
17968;"Naujųjų verkių";Darželinė;1061601585;Taip;0;1;0;1
17969;"Naujųjų verkių";Darželinė;4727762605;Taip;0;11;0;11
17970;"Naujųjų verkių";Darželinė;19360482785;Ne;0;6;0;6
17971;"Naujųjų verkių";Darželinė;49937307547;Taip;0;20;0;20
17972;Švelnukas;Pelėdžiukai;97312326369;Taip;8;3;0;11
17973;Švelnukas;Pelėdžiukai;35501839416;Taip;17;0;0;17
17974;Švelnukas;Pelėdžiukai;1102317067;Ne;10;0;0;10
17975;Švelnukas;Pelėdžiukai;54159329795;Taip;0;1;0;1
17976;Švelnukas;Pelėdžiukai;56353311492;Taip;0;0;18;18
17977;Švelnukas;Pelėdžiukai;73720184241;Taip;0;1;0;1
17978;Švelnukas;Pelėdžiukai;94832155557;Taip;6;0;2;8
17979;Švelnukas;Pelėdžiukai;1398812288;Taip;5;0;0;5
17980;Švelnukas;Pelėdžiukai;4006769867;Taip;0;4;0;4
17981;Švelnukas;Pelėdžiukai;39249642586;Taip;0;7;0;7
17982;Švelnukas;Pelėdžiukai;12011187563;Taip;0;0;1;1
17983;Švelnukas;Pelėdžiukai;72764312386;Ne;0;5;2;7
17984;Švelnukas;Pelėdžiukai;59229958089;Taip;0;2;0;2
17985;Švelnukas;Pelėdžiukai;57026029080;Taip;0;0;1;1
17986;Švelnukas;Pelėdžiukai;30679686753;Taip;0;0;3;3
17987;Švelnukas;Pelėdžiukai;50326830712;Taip;6;6;3;15
17988;Švelnukas;Pelėdžiukai;88430357193;Taip;0;0;1;1
17989;Švelnukas;Pelėdžiukai;2123115761;Taip;15;0;0;15
17990;Švelnukas;Ežiukai;62376594516;Taip;0;0;1;1
17991;Švelnukas;Ežiukai;59113412340;Ne;0;1;0;1
17992;Švelnukas;Ežiukai;95227249637;Taip;0;10;0;10
17993;Švelnukas;Ežiukai;94799905208;Ne;0;3;0;3
17994;Švelnukas;Ežiukai;41867077386;Taip;0;0;3;3
17995;Švelnukas;Ežiukai;41365412569;Taip;0;5;0;5
17996;Švelnukas;Ežiukai;55258226673;Taip;0;12;0;12
17997;Švelnukas;Ežiukai;25374873288;Taip;0;7;0;7
17998;Švelnukas;Ežiukai;68667782880;Taip;0;0;4;4
17999;Švelnukas;Ežiukai;15308444101;Taip;0;0;7;7
18000;Švelnukas;Ežiukai;6282389058;Taip;0;0;1;1
18001;Švelnukas;Ežiukai;84293714890;Taip;0;0;2;2
18002;Švelnukas;Ežiukai;1755384216;Ne;0;0;11;11
18003;Švelnukas;Ežiukai;31881188589;Taip;0;0;1;1
18004;Švelnukas;Švelnukai;67100479000;Taip;0;0;2;2
18005;Švelnukas;Švelnukai;37816683435;Taip;0;0;1;1
18006;Švelnukas;Švelnukai;35140428714;Taip;12;2;0;14
18007;Švelnukas;Švelnukai;6143538084;Taip;0;0;1;1
18008;Švelnukas;Švelnukai;16527728167;Taip;0;3;0;3
18009;Švelnukas;Švelnukai;58209041919;Taip;0;1;0;1
18010;Švelnukas;Švelnukai;2637595842;Taip;9;2;0;11
18011;Švelnukas;Švelnukai;71561312482;Ne;0;2;0;2
18012;Švelnukas;Švelnukai;75449064275;Taip;0;0;2;2
18013;Švelnukas;Švelnukai;64875997364;Taip;0;3;0;3
18014;Švelnukas;Švelnukai;32133621075;Taip;0;1;1;2
18015;Švelnukas;Švelnukai;94946505347;Taip;0;8;0;8
18016;Švelnukas;Švelnukai;96723762013;Taip;0;2;0;2
18017;Švelnukas;Švelnukai;85650663405;Taip;0;3;0;3
18018;Švelnukas;Švelnukai;25672016811;Ne;5;5;0;10
18019;Švelnukas;Švelnukai;52909536851;Taip;0;0;1;1
18020;Švelnukas;Švelnukai;80109886791;Taip;0;0;1;1
18021;Švelnukas;Švelnukai;84455755281;Taip;0;6;0;6
18022;Švelnukas;Švelnukai;94117802668;Taip;1;0;0;1
18023;Švelnukas;Boružiukai;1951447127;Taip;5;0;1;6
18024;Švelnukas;Boružiukai;8681264696;Taip;5;2;0;7
18025;Švelnukas;Boružiukai;4711482287;Taip;2;0;6;8
18026;Švelnukas;Boružiukai;8510195634;Taip;0;0;4;4
18027;Švelnukas;Boružiukai;3849957906;Taip;2;0;2;4
18028;Švelnukas;Boružiukai;5974324302;Taip;7;0;6;13
18029;Švelnukas;Boružiukai;9722532034;Taip;5;0;0;5
18030;Švelnukas;Boružiukai;2400781175;Taip;20;0;0;20
18031;Švelnukas;Boružiukai;1264256177;Taip;5;0;8;13
18032;Švelnukas;Boružiukai;6607578153;Taip;2;6;1;9
18033;Švelnukas;Boružiukai;8847738918;Taip;6;0;0;6
18034;Švelnukas;Boružiukai;8787505507;Taip;0;1;0;1
18035;Švelnukas;Boružiukai;4134678301;Ne;0;0;2;2
18036;Švelnukas;Boružiukai;8458233793;Taip;0;0;2;2
18037;Švelnukas;Boružiukai;7967996032;Taip;3;10;0;13
18038;Švelnukas;Smalsučiai;76418408780;Taip;2;0;0;2
18039;Švelnukas;Smalsučiai;82202942341;Taip;0;6;0;6
18040;Švelnukas;Smalsučiai;63394075248;Taip;0;0;8;8
18041;Švelnukas;Smalsučiai;53619702326;Taip;11;0;0;11
18042;Švelnukas;Smalsučiai;1183982303;Taip;2;3;0;5
18043;Švelnukas;Smalsučiai;19117783391;Taip;2;5;2;9
18044;Švelnukas;Smalsučiai;26077395334;Ne;1;13;0;14
18045;Švelnukas;Smalsučiai;15711256627;Taip;9;3;0;12
18046;Švelnukas;Smalsučiai;76563731138;Taip;0;14;0;14
18047;Švelnukas;Smalsučiai;3388721433;Ne;0;1;0;1
18048;Švelnukas;Smalsučiai;1742714140;Taip;7;0;3;10
18049;Švelnukas;Smalsučiai;54425041280;Taip;0;6;0;6
18050;Švelnukas;Smalsučiai;91569132037;Taip;0;5;0;5
18051;Švelnukas;Smalsučiai;34570338962;Taip;5;6;2;13
18052;Švelnukas;Smalsučiai;78611632021;Taip;0;4;0;4
18053;Švelnukas;Smalsučiai;1139744541;Taip;0;0;2;2
18054;Švelnukas;Smalsučiai;15774114007;Taip;0;0;22;22
18055;Švelnukas;Smalsučiai;26312856720;Taip;14;0;0;14
18056;Švelnukas;Nykštukai;5518267134;Ne;0;2;0;2
18057;Švelnukas;Nykštukai;2141519946;Taip;5;1;0;6
18058;Švelnukas;Nykštukai;8771953161;Taip;0;0;1;1
18059;Švelnukas;Nykštukai;5327209876;Taip;0;3;0;3
18060;Švelnukas;Nykštukai;2282356211;Taip;8;0;0;8
18061;Švelnukas;Nykštukai;4697253853;Taip;0;0;4;4
18062;Švelnukas;Nykštukai;7387060610;Taip;0;3;0;3
18063;Švelnukas;Nykštukai;1762528313;Taip;0;0;2;2
18064;Švelnukas;Nykštukai;3473146893;Taip;0;1;0;1
18065;Švelnukas;Nykštukai;2106591525;Taip;3;0;1;4
18066;Švelnukas;Nykštukai;93497358197;Taip;0;8;0;8
18067;Švelnukas;Nykštukai;2971380970;Taip;0;0;3;3
18068;Švelnukas;Nykštukai;3389897065;Taip;0;0;3;3
18069;Švelnukas;Nykštukai;4302735157;Taip;6;5;0;11
18070;Švelnukas;Nykštukai;2785396019;Taip;0;0;4;4
18071;Švelnukas;Nykštukai;6195335543;Ne;0;0;3;3
18072;Boružėlė;"Nykštukai gudručiai";17133057179;Taip;0;8;0;8
18073;Boružėlė;"Nykštukai gudručiai";61157651941;Ne;0;2;1;3
18074;Boružėlė;"Nykštukai gudručiai";89164129422;Taip;0;3;0;3
18075;Boružėlė;"Nykštukai gudručiai";61086657300;Taip;0;8;0;8
18076;Boružėlė;"Nykštukai gudručiai";27819440058;Taip;7;0;0;7
18077;Boružėlė;"Nykštukai gudručiai";62849453206;Taip;0;4;0;4
18078;Boružėlė;"Nykštukai gudručiai";650307889;Taip;0;1;0;1
18079;Boružėlė;"Nykštukai gudručiai";90752643228;Taip;0;2;0;2
18080;Boružėlė;"Nykštukai gudručiai";91349343635;Taip;0;3;0;3
18081;Boružėlė;"Nykštukai gudručiai";52470353273;Taip;15;0;0;15
18082;Boružėlė;"Nykštukai gudručiai";38216036757;Taip;9;2;1;12
18083;Boružėlė;"Nykštukai gudručiai";28726593347;Taip;0;14;1;15
18084;Boružėlė;"Nykštukai gudručiai";47122226309;Taip;0;7;0;7
18085;Boružėlė;"Nykštukai gudručiai";13957276157;Taip;9;3;0;12
18086;Boružėlė;"Nykštukai gudručiai";29807061047;Taip;0;2;2;4
18087;Boružėlė;"Nykštukai gudručiai";68875252308;Taip;2;1;0;3
18088;Boružėlė;"Nykštukai gudručiai";229765248;Taip;0;1;0;1
18089;Boružėlė;"Nykštukai gudručiai";16899340397;Taip;0;1;0;1
18090;Boružėlė;"Nykštukai gudručiai";82591189080;Taip;2;1;0;3
18091;Boružėlė;"Nykštukai gudručiai";5105514215;Taip;1;0;0;1
18092;Boružėlė;"Nykštukai gudručiai";64502791927;Taip;0;6;0;6
18093;Boružėlė;"Nykštukai gudručiai";95194187600;Taip;0;1;0;1
18094;Boružėlė;"Nykštukai gudručiai";37447518757;Taip;0;14;0;14
18095;Boružėlė;"Saulės zuikučiai";85989907396;Taip;14;0;0;14
18096;Boružėlė;"Saulės zuikučiai";19859029063;Taip;0;3;2;5
18097;Boružėlė;"Saulės zuikučiai";92386016898;Taip;0;2;0;2
18098;Boružėlė;"Saulės zuikučiai";32378073529;Taip;0;1;0;1
18099;Boružėlė;"Saulės zuikučiai";65182491064;Taip;0;6;0;6
18100;Boružėlė;"Saulės zuikučiai";31002497704;Taip;0;2;0;2
18101;Boružėlė;"Saulės zuikučiai";24149763183;Taip;0;1;0;1
18102;Boružėlė;"Saulės zuikučiai";34268210765;Taip;0;1;0;1
18103;Boružėlė;"Saulės zuikučiai";85800258410;Taip;0;0;6;6
18104;Boružėlė;"Saulės zuikučiai";5636816841;Taip;0;4;0;4
18105;Boružėlė;"Saulės zuikučiai";90270691161;Taip;0;1;0;1
18106;Boružėlė;"Saulės zuikučiai";92488927896;Taip;0;1;0;1
18107;Boružėlė;"Saulės zuikučiai";59772973857;Taip;0;1;0;1
18108;Boružėlė;"Saulės zuikučiai";44064549128;Taip;5;0;1;6
18109;Boružėlė;"Saulės zuikučiai";39495849527;Ne;0;9;0;9
18110;Boružėlė;"Saulės zuikučiai";21573376804;Taip;14;0;0;14
18111;Boružėlė;"Saulės zuikučiai";44480055238;Ne;3;1;0;4
18112;Boružėlė;"Saulės zuikučiai";33333115262;Taip;0;1;0;1
18113;Boružėlė;Gėlytės;4023646693;Taip;10;0;0;10
18114;Boružėlė;Gėlytės;51321138507;Taip;8;0;0;8
18115;Boružėlė;Gėlytės;62298785353;Taip;6;0;3;9
18116;Boružėlė;Gėlytės;84087304104;Taip;11;0;1;12
18117;Boružėlė;Gėlytės;28968535453;Taip;12;2;0;14
18118;Boružėlė;Gėlytės;11785706048;Taip;11;0;1;12
18119;Boružėlė;Gėlytės;81433480408;Taip;5;1;0;6
18120;Boružėlė;Gėlytės;51923600458;Taip;0;0;3;3
18121;Boružėlė;Gėlytės;77207874939;Taip;0;1;0;1
18122;Boružėlė;Gėlytės;86742600111;Taip;0;2;1;3
18123;Boružėlė;Gėlytės;43579952892;Taip;7;0;2;9
18124;Boružėlė;Gėlytės;69393873241;Taip;8;1;0;9
18125;Boružėlė;Gėlytės;54530233692;Ne;0;1;0;1
18126;Boružėlė;Gėlytės;25443948372;Taip;5;0;0;5
18127;Boružėlė;Gėlytės;33639051694;Taip;0;0;1;1
18128;Boružėlė;Gėlytės;33266635443;Taip;8;0;0;8
18129;Boružėlė;Gėlytės;3118969668;Ne;0;7;0;7
18130;Boružėlė;Gėlytės;56693699464;Taip;0;0;8;8
18131;Boružėlė;Gėlytės;1010790194;Taip;0;2;0;2
18132;Boružėlė;Gėlytės;5306841409;Taip;11;2;0;13
18133;Boružėlė;Smalsutis;2086485441;Taip;0;5;0;5
18134;Boružėlė;Smalsutis;5129244830;Taip;5;3;0;8
18135;Boružėlė;Smalsutis;6927100979;Taip;0;2;0;2
18136;Boružėlė;Smalsutis;2887130633;Taip;5;0;0;5
18137;Boružėlė;Smalsutis;5267216044;Taip;5;2;0;7
18138;Boružėlė;Smalsutis;2917508421;Taip;10;0;0;10
18139;Boružėlė;Smalsutis;5708558321;Taip;5;3;0;8
18140;Boružėlė;Smalsutis;6484173786;Taip;0;2;0;2
18141;Boružėlė;Smalsutis;2132904457;Taip;0;6;0;6
18142;Boružėlė;Smalsutis;77513300382;Ne;2;0;0;2
18143;Boružėlė;Smalsutis;5618586722;Taip;2;2;0;4
18144;Boružėlė;Smalsutis;2447148171;Ne;0;2;0;2
18145;Boružėlė;Drugeliai;22364321459;Taip;0;5;0;5
18146;Boružėlė;Drugeliai;62673076395;Taip;0;2;0;2
18147;Boružėlė;Drugeliai;7846729818;Taip;6;0;0;6
18148;Boružėlė;Drugeliai;17934430709;Taip;0;5;0;5
18149;Boružėlė;Drugeliai;2832927610;Ne;0;1;0;1
18150;Boružėlė;Drugeliai;60850304458;Taip;0;2;1;3
18151;Boružėlė;Drugeliai;61687966416;Ne;10;1;0;11
18152;Boružėlė;Drugeliai;64005720465;Ne;0;1;0;1
18153;Boružėlė;Drugeliai;1317543345;Taip;0;1;0;1
18154;Boružėlė;Drugeliai;87323054466;Taip;0;2;2;4
18155;Boružėlė;Drugeliai;89040863632;Taip;0;2;0;2
18156;Boružėlė;Drugeliai;98019366092;Taip;0;2;0;2
18157;Boružėlė;Drugeliai;38702331698;Taip;0;2;2;4
18158;Boružėlė;Drugeliai;39872094732;Taip;0;0;1;1
18159;Boružėlė;Drugeliai;51684663458;Taip;0;11;6;17
18160;Boružėlė;Drugeliai;4219138834;Ne;0;2;0;2
18161;Boružėlė;Drugeliai;48910246287;Taip;0;3;0;3
18162;Boružėlė;Drugeliai;88659085306;Taip;8;2;0;10
18163;Boružėlė;Drugeliai;68002181211;Taip;0;8;0;8
18164;Boružėlė;Drugeliai;56479442138;Taip;0;2;16;18
18165;Boružėlė;Vyturėliai;1950269258;Taip;0;10;0;10
18166;Boružėlė;Vyturėliai;1591582954;Taip;0;12;0;12
18167;Boružėlė;Vyturėliai;3322567969;Taip;5;1;0;6
18168;Boružėlė;Vyturėliai;1718509953;Taip;0;1;0;1
18169;Boružėlė;Vyturėliai;8311383437;Taip;22;0;0;22
18170;Boružėlė;Vyturėliai;7534482245;Taip;0;1;0;1
18171;Boružėlė;Vyturėliai;3310676316;Taip;0;5;0;5
18172;Boružėlė;Vyturėliai;87834777247;Ne;0;13;0;13
18173;Boružėlė;Vyturėliai;50071056728;Taip;10;10;0;20
18174;Boružėlė;Vyturėliai;43300167107;Taip;0;1;0;1
18175;Boružėlė;Vyturėliai;2098408445;Taip;0;2;0;2
18176;Boružėlė;Vyturėliai;8706461730;Taip;0;2;0;2
18177;Boružėlė;Vyturėliai;5337704114;Taip;0;2;0;2
18178;Boružėlė;Vyturėliai;8146684259;Taip;0;3;0;3
18179;Boružėlė;Vyturėliai;67504667512;Taip;0;2;0;2
18180;Boružėlė;Vyturėliai;5811751925;Taip;0;2;0;2
18181;Boružėlė;Žvaigždutės;43607170469;Ne;0;2;1;3
18182;Boružėlė;Žvaigždutės;45978328301;Taip;5;0;4;9
18183;Boružėlė;Žvaigždutės;11257181283;Taip;0;2;0;2
18184;Boružėlė;Žvaigždutės;55597294544;Taip;0;2;0;2
18185;Boružėlė;Žvaigždutės;56257835408;Taip;0;0;2;2
18186;Boružėlė;Žvaigždutės;14720838994;Taip;0;3;0;3
18187;Boružėlė;Žvaigždutės;53465974644;Taip;2;0;4;6
18188;Boružėlė;Žvaigždutės;18917842445;Ne;0;3;0;3
18189;Boružėlė;Ąžuoliukai;5774358876;Taip;0;4;3;7
18190;Boružėlė;Ąžuoliukai;4519645340;Taip;2;8;0;10
18191;Boružėlė;Ąžuoliukai;24315678618;Taip;0;4;0;4
18192;Boružėlė;Ąžuoliukai;4994696176;Taip;0;4;0;4
18193;Boružėlė;Ąžuoliukai;2618814096;Ne;5;0;0;5
18194;Boružėlė;Ąžuoliukai;6439902117;Taip;4;0;0;4
18195;Boružėlė;Ąžuoliukai;3040376382;Taip;3;1;0;4
18196;Boružėlė;Ąžuoliukai;3912668735;Taip;0;2;0;2
18197;Boružėlė;Ąžuoliukai;3840860155;Taip;3;0;1;4
18198;Boružėlė;Ąžuoliukai;3869817904;Taip;9;2;0;11
18199;Boružėlė;Ąžuoliukai;7722277859;Taip;4;0;0;4
18200;Boružėlė;Ąžuoliukai;6954794465;Taip;0;2;1;3
18201;Boružėlė;Ąžuoliukai;6545116373;Taip;0;6;0;6
18202;Boružėlė;Ąžuoliukai;5832223872;Taip;0;2;3;5
18203;Boružėlė;Ąžuoliukai;3695411422;Taip;5;1;0;6
18204;Boružėlė;Ąžuoliukai;1143453501;Taip;10;0;0;10
18205;Boružėlė;Ąžuoliukai;5490593122;Taip;10;4;0;14
18206;Boružėlė;Ąžuoliukai;5148410392;Ne;0;0;2;2
18207;Boružėlė;Ąžuoliukai;45181369655;Taip;0;4;0;4
18208;Boružėlė;Ąžuoliukai;6022191251;Taip;2;0;0;2
18209;Boružėlė;Saulutės;55049551150;Taip;0;4;2;6
18210;Boružėlė;Saulutės;1311485296;Taip;0;6;1;7
18211;Boružėlė;Saulutės;64389558278;Taip;0;3;0;3
18212;Boružėlė;Saulutės;46425201501;Taip;0;4;0;4
18213;Boružėlė;Saulutės;1399195259;Taip;7;3;0;10
18214;Boružėlė;Saulutės;72321159041;Taip;0;1;0;1
18215;Boružėlė;Saulutės;1910653135;Taip;0;9;8;17
18216;Boružėlė;Saulutės;1527135537;Taip;0;2;1;3
18217;Boružėlė;Saulutės;8814486475;Taip;0;2;0;2
18218;Boružėlė;Saulutės;48414697489;Taip;0;6;0;6
18219;Boružėlė;Saulutės;3004650727;Taip;0;0;1;1
18220;Boružėlė;Saulutės;4567360023;Taip;0;2;0;2
18221;Boružėlė;Saulutės;96500755145;Ne;0;3;0;3
18222;Boružėlė;Saulutės;1506999888;Taip;0;2;0;2
18223;Boružėlė;Saulutės;2402968573;Taip;0;2;0;2
18224;Boružėlė;Saulutės;2690216341;Ne;12;3;0;15
18225;Boružėlė;Saulutės;8659850691;Taip;0;2;0;2
18226;Boružėlė;Saulutės;4562962568;Taip;0;2;0;2
18227;Boružėlė;Saulutės;64347371263;Taip;0;1;0;1
18228;Boružėlė;Saulutės;28382049716;Taip;10;2;2;14
18229;Boružėlė;Saulutės;1040409859;Taip;4;0;0;4
18230;Boružėlė;Saulutės;1750151078;Taip;0;2;5;7
18231;Boružėlė;Ežiukai;1637965530;Taip;0;2;0;2
18232;Boružėlė;Ežiukai;80490841186;Taip;20;0;0;20
18233;Boružėlė;Ežiukai;9645420240;Taip;0;1;0;1
18234;Boružėlė;Ežiukai;97765175729;Taip;2;2;0;4
18235;Boružėlė;Ežiukai;9436674675;Taip;0;10;0;10
18236;Boružėlė;Ežiukai;58923894463;Taip;10;2;0;12
18237;Boružėlė;Ežiukai;27456755162;Taip;0;2;0;2
18238;Boružėlė;Ežiukai;1339605077;Taip;0;9;0;9
18239;Boružėlė;Ežiukai;80239337645;Taip;0;1;0;1
18240;Boružėlė;Ežiukai;1007058344;Taip;10;1;0;11
18241;Boružėlė;Ežiukai;86859788504;Taip;5;1;0;6
18242;Boružėlė;Ežiukai;1431869021;Taip;0;2;0;2
18243;Boružėlė;Ežiukai;1474967056;Taip;0;2;0;2
18244;Boružėlė;Ežiukai;62548032852;Taip;1;2;0;3
18245;Boružėlė;Ežiukai;17258743024;Taip;0;2;0;2
18246;Boružėlė;Ežiukai;31109596405;Taip;10;5;0;15
18247;Boružėlė;Ežiukai;49403734292;Taip;13;0;0;13
18248;Boružėlė;Ežiukai;46486992436;Taip;3;2;0;5
18249;Boružėlė;Ežiukai;39704329817;Ne;7;2;0;9
18250;Boružėlė;Ežiukai;61932744418;Taip;7;2;0;9
18251;Boružėlė;Ežiukai;1459630343;Taip;0;2;0;2
18252;Boružėlė;Boružiukai;3140264242;Taip;0;3;0;3
18253;Boružėlė;Boružiukai;9720535449;Taip;5;4;1;10
18254;Boružėlė;Boružiukai;6435556131;Taip;5;4;1;10
18255;Boružėlė;Boružiukai;1583223569;Taip;9;0;0;9
18256;Boružėlė;Boružiukai;3955841578;Taip;9;0;0;9
18257;Boružėlė;Boružiukai;8259586236;Taip;9;0;0;9
18258;Boružėlė;Boružiukai;1663216529;Taip;2;0;0;2
18259;Boružėlė;Boružiukai;9271331800;Taip;7;2;0;9
18260;Boružėlė;Boružiukai;8357946299;Taip;17;1;0;18
18261;Boružėlė;Boružiukai;9838823214;Taip;12;2;0;14
18262;Boružėlė;Boružiukai;5298170118;Taip;0;5;0;5
18263;Boružėlė;Boružiukai;6293878183;Taip;0;2;0;2
18264;Boružėlė;Boružiukai;6242220139;Taip;0;4;0;4
18265;Boružėlė;Boružiukai;6972646373;Taip;1;2;1;4
18266;Boružėlė;Boružiukai;7216558291;Taip;0;10;0;10
18267;Boružėlė;Nykštukai;9913813461;Taip;0;1;0;1
18268;Boružėlė;Nykštukai;6049501362;Ne;0;4;0;4
18269;Boružėlė;Nykštukai;8683282162;Ne;5;2;0;7
18270;Boružėlė;Nykštukai;8141240094;Taip;6;2;0;8
18271;Boružėlė;Nykštukai;5187411500;Taip;6;2;1;9
18272;Boružėlė;Nykštukai;1130980139;Taip;2;1;0;3
18273;Boružėlė;Nykštukai;4999277693;Taip;0;3;0;3
18274;Boružėlė;Nykštukai;6463583187;Taip;0;2;1;3
18275;Boružėlė;Nykštukai;4509233532;Taip;9;1;0;10
18276;Boružėlė;Nykštukai;3136028536;Taip;2;1;0;3
18277;Boružėlė;Nykštukai;6724101421;Taip;5;0;0;5
18278;Boružėlė;Nykštukai;2211576663;Taip;0;9;0;9
18279;Boružėlė;Nykštukai;1559001916;Taip;0;2;0;2
18280;Boružėlė;Nykštukai;3129825206;Taip;0;7;0;7
18281;Boružėlė;Nykštukai;3952645542;Taip;14;4;0;18
18282;Boružėlė;Nykštukai;4233602822;Taip;0;2;0;2
18283;Boružėlė;Nykštukai;6990311896;Taip;0;4;2;6
18284;Žaliakalnio;Drugeliai;13682689553;Taip;0;0;3;3
18285;Žaliakalnio;Drugeliai;27904847662;Ne;0;3;0;3
18286;Žaliakalnio;Drugeliai;46069159390;Ne;0;6;0;6
18287;Žaliakalnio;Drugeliai;86878699666;Taip;0;2;0;2
18288;Žaliakalnio;Drugeliai;31358267062;Ne;2;1;0;3
18289;Žaliakalnio;Drugeliai;66587671546;Taip;0;3;0;3
18290;Žaliakalnio;Drugeliai;25885672997;Ne;0;0;1;1
18291;Žaliakalnio;Drugeliai;95162958789;Ne;3;0;1;4
18292;Žaliakalnio;Drugeliai;32706729925;Taip;0;1;0;1
18293;Žaliakalnio;Drugeliai;66150716129;Taip;0;6;0;6
18294;Žaliakalnio;Drugeliai;25938547290;Taip;10;1;0;11
18295;Žaliakalnio;Drugeliai;6781426791;Taip;1;0;0;1
18296;Žaliakalnio;Drugeliai;2049672202;Taip;0;7;0;7
18297;Žaliakalnio;Drugeliai;7563809721;Taip;6;6;0;12
18298;Žaliakalnio;Drugeliai;3711311672;Taip;0;2;0;2
18299;Žaliakalnio;Drugeliai;94833433433;Taip;0;1;0;1
18300;Žaliakalnio;Boružėlių;82492655622;Taip;0;1;0;1
18301;Žaliakalnio;Boružėlių;42466567091;Taip;9;0;0;9
18302;Žaliakalnio;Boružėlių;47810583989;Taip;3;0;2;5
18303;Žaliakalnio;Boružėlių;33301958715;Taip;5;4;0;9
18304;Žaliakalnio;Boružėlių;3965607452;Ne;0;1;0;1
18305;Žaliakalnio;Boružėlių;75317286407;Taip;0;0;2;2
18306;Žaliakalnio;Boružėlių;4250791818;Taip;0;13;0;13
18307;Žaliakalnio;Boružėlių;93570287071;Ne;0;0;2;2
18308;Žaliakalnio;Boružėlių;1083342257;Ne;0;9;0;9
18309;Žaliakalnio;Boružėlių;46244764767;Ne;5;9;0;14
18310;Žaliakalnio;Boružėlių;75758855114;Taip;0;0;4;4
18311;Žaliakalnio;Boružėlių;50460143975;Taip;0;0;1;1
18312;Žaliakalnio;Boružėlių;91780252395;Ne;0;11;0;11
18313;Žaliakalnio;Boružėlių;60736665152;Taip;0;3;0;3
18314;Žaliakalnio;Boružėlių;82839531225;Taip;0;5;0;5
18315;Žaliakalnio;Zuikučiai;1592051491;Taip;4;5;0;9
18316;Žaliakalnio;Zuikučiai;6088333997;Taip;10;1;0;11
18317;Žaliakalnio;Zuikučiai;2673619031;Taip;0;1;0;1
18318;Žaliakalnio;Zuikučiai;5843314345;Taip;0;3;0;3
18319;Žaliakalnio;Zuikučiai;7447278960;Taip;5;12;0;17
18320;Žaliakalnio;Zuikučiai;2180165053;Taip;12;4;0;16
18321;Žaliakalnio;Zuikučiai;6823528666;Taip;5;7;0;12
18322;Žaliakalnio;Zuikučiai;3509064089;Taip;0;7;0;7
18323;Žaliakalnio;Zuikučiai;7000429934;Taip;0;8;0;8
18324;Žaliakalnio;Zuikučiai;5730610895;Taip;3;1;0;4
18325;Žaliakalnio;Zuikučiai;6881070397;Taip;0;6;0;6
18326;Žaliakalnio;Zuikučiai;8209559343;Taip;7;7;0;14
18327;Žaliakalnio;Zuikučiai;3835667120;Taip;0;6;0;6
18328;Žaliakalnio;Zuikučiai;5422289286;Ne;0;10;0;10
18329;Žaliakalnio;Zuikučiai;9799056285;Taip;5;0;0;5
18330;Žaliakalnio;Zuikučiai;1321592040;Taip;0;3;0;3
18331;Žaliakalnio;Zuikučiai;8298313285;Taip;0;3;0;3
18332;Žaliakalnio;Zuikučiai;9331287916;Taip;5;7;0;12
18333;Žaliakalnio;Zuikučiai;6726832258;Taip;5;5;0;10
18334;Žaliakalnio;Bitutė;23692122313;Ne;0;6;0;6
18335;Žaliakalnio;Bitutė;1581365258;Taip;0;2;0;2
18336;Žaliakalnio;Bitutė;26003637304;Taip;0;6;0;6
18337;Žaliakalnio;Bitutė;1673236492;Taip;2;1;0;3
18338;Žaliakalnio;Bitutė;56222558457;Taip;0;7;0;7
18339;Žaliakalnio;Bitutė;46360583256;Taip;4;1;0;5
18340;Žaliakalnio;Bitutė;1027036769;Ne;0;8;0;8
18341;Žaliakalnio;Bitutė;2059763621;Taip;0;0;2;2
18342;Žaliakalnio;Bitutė;21032761681;Taip;0;2;0;2
18343;Žaliakalnio;Bitutė;1275007023;Taip;0;4;0;4
18344;Žaliakalnio;Bitutė;1142844672;Taip;0;6;0;6
18345;Žaliakalnio;Bitutė;1447567627;Taip;0;6;0;6
18346;Žaliakalnio;Bitutė;1919996835;Ne;0;6;0;6
18347;Žaliakalnio;Bitutė;1824370122;Taip;0;9;0;9
18348;Žaliakalnio;Bitutė;64628389691;Taip;0;1;0;1
18349;Žaliakalnio;Bitutė;1909837418;Ne;0;3;0;3
18350;Žaliakalnio;Bitutė;56508324349;Taip;0;19;0;19
18351;Žaliakalnio;Bitutė;52109524827;Taip;0;22;0;22
18352;Žaliakalnio;Nykštukų;9057678671;Ne;0;9;0;9
18353;Žaliakalnio;Nykštukų;8640423692;Taip;3;0;0;3
18354;Žaliakalnio;Nykštukų;19192494119;Taip;4;1;0;5
18355;Žaliakalnio;Nykštukų;91524700281;Taip;0;5;0;5
18356;Žaliakalnio;Nykštukų;6560740320;Taip;0;4;0;4
18357;Žaliakalnio;Nykštukų;1932906021;Taip;0;1;0;1
18358;Žaliakalnio;Nykštukų;1753760382;Taip;0;3;0;3
18359;Žaliakalnio;Nykštukų;4936664829;Taip;0;1;0;1
18360;Žaliakalnio;Nykštukų;1657390839;Taip;6;1;0;7
18361;Žaliakalnio;Nykštukų;2655227703;Taip;0;5;0;5
18362;Žaliakalnio;Nykštukų;8085215871;Taip;0;3;0;3
18363;Žaliakalnio;Nykštukų;8469042778;Taip;0;8;0;8
18364;Žaliakalnio;Nykštukų;41844570217;Ne;1;0;0;1
18365;Žaliakalnio;Nykštukų;6638075273;Ne;0;18;0;18
18366;Žaliakalnio;Nykštukų;21744638321;Taip;0;2;0;2
18367;Žaliakalnio;Nykštukų;1514982516;Taip;0;2;0;2
18368;Žaliakalnio;Nykštukų;9918175249;Ne;0;10;0;10
18369;Žaliakalnio;Nykštukų;1497932659;Ne;0;1;0;1
18370;Žaliakalnio;Nykštukų;5946168564;Ne;22;0;0;22
18371;Žaliakalnio;ŽIOGELIAI;2607433844;Taip;2;4;0;6
18372;Žaliakalnio;ŽIOGELIAI;2432935088;Ne;22;0;0;22
18373;Žaliakalnio;ŽIOGELIAI;7862756576;Ne;6;0;2;8
18374;Žaliakalnio;ŽIOGELIAI;3058369504;Ne;0;3;0;3
18375;Žaliakalnio;ŽIOGELIAI;5428225559;Ne;8;5;0;13
18376;Žaliakalnio;ŽIOGELIAI;38025903441;Taip;0;1;0;1
18377;Žaliakalnio;ŽIOGELIAI;96127127960;Taip;6;1;0;7
18378;Žaliakalnio;ŽIOGELIAI;15344653714;Taip;3;11;0;14
18379;Žaliakalnio;ŽIOGELIAI;69892069029;Taip;5;2;0;7
18380;Žaliakalnio;ŽIOGELIAI;1589546605;Taip;0;11;0;11
18381;Žaliakalnio;ŽIOGELIAI;1012597457;Taip;0;5;0;5
18382;Žaliakalnio;ŽIOGELIAI;24900419959;Ne;0;11;0;11
18383;Žaliakalnio;ŽIOGELIAI;1357321617;Taip;0;1;0;1
18384;Žaliakalnio;ŽIOGELIAI;98394011032;Ne;0;3;0;3
18385;Žaliakalnio;ŽIOGELIAI;2201538495;Taip;11;2;0;13
18386;Žaliakalnio;ŽIOGELIAI;1967580906;Ne;5;0;0;5
18387;Žaliakalnio;ŽIOGELIAI;19165022144;Taip;0;1;0;1
18388;Žaliakalnio;ŽIOGELIAI;55967554391;Taip;8;0;0;8
18389;Žaliakalnio;ŽIOGELIAI;44058368949;Ne;0;3;0;3
18390;Volungė;Bitutės;2549910818;Ne;0;0;3;3
18391;Volungė;Bitutės;47050212421;Taip;0;1;0;1
18392;Volungė;Bitutės;12723194236;Ne;0;0;4;4
18393;Volungė;Bitutės;13542355518;Taip;0;0;9;9
18394;Volungė;Bitutės;82311993400;Taip;0;5;0;5
18395;Volungė;Bitutės;36063217784;Ne;0;0;3;3
18396;Volungė;Bitutės;1437653430;Ne;0;0;7;7
18397;Volungė;Bitutės;86020309344;Taip;0;0;3;3
18398;Volungė;Bitutės;1452196930;Ne;0;0;6;6
18399;Volungė;Bitutės;1046956717;Ne;0;0;3;3
18400;Volungė;Bitutės;18885218232;Taip;0;0;4;4
18401;Volungė;Bitutės;1213909538;Taip;0;0;1;1
18402;Volungė;Bitutės;1900962235;Taip;0;8;0;8
18403;Volungė;Bitutės;53305676926;Taip;0;16;0;16
18404;Volungė;Bitutės;1173228172;Taip;0;0;4;4
18405;Volungė;Bitutės;54390741416;Ne;5;1;0;6
18406;Volungė;Bitutės;1433101716;Ne;10;3;0;13
18407;Volungė;Bitutės;1234100483;Taip;0;0;7;7
18408;Volungė;Bitutės;63185257654;Taip;0;10;0;10
18409;Volungė;Bitutės;1938817757;Ne;0;0;5;5
18410;Volungė;Bitutės;1601358808;Taip;0;0;6;6
18411;Volungė;Bitutės;1605974968;Taip;4;0;1;5
18412;Volungė;Boružiukai;70594069052;Taip;15;0;0;15
18413;Volungė;Boružiukai;29221149335;Ne;17;0;0;17
18414;Volungė;Boružiukai;1044330259;Taip;0;13;0;13
18415;Volungė;Boružiukai;83724618799;Taip;0;0;7;7
18416;Volungė;Boružiukai;17939180277;Taip;0;0;1;1
18417;Volungė;Boružiukai;1404032512;Taip;1;0;2;3
18418;Volungė;Boružiukai;3924673024;Taip;0;0;7;7
18419;Volungė;Boružiukai;74451460970;Taip;8;3;0;11
18420;Volungė;Boružiukai;50076033275;Ne;0;0;5;5
18421;Volungė;Boružiukai;28521139566;Ne;6;0;0;6
18422;Volungė;Boružiukai;96547780998;Taip;8;0;1;9
18423;Volungė;Boružiukai;64735215987;Taip;0;7;0;7
18424;Volungė;Boružiukai;33643259323;Taip;5;0;2;7
18425;Volungė;Boružiukai;32259897897;Ne;0;2;0;2
18426;Volungė;Boružiukai;15495903063;Ne;0;0;4;4
18427;Volungė;Boružiukai;92516817330;Taip;2;0;2;4
18428;Volungė;Boružiukai;19870362159;Taip;0;0;1;1
18429;Volungė;Boružiukai;1699471816;Taip;0;0;2;2
18430;Volungė;Boružiukai;1695388167;Ne;0;0;9;9
18431;Volungė;Žvirbliukai;1862673253;Taip;0;0;4;4
18432;Volungė;Žvirbliukai;87185412767;Ne;0;0;2;2
18433;Volungė;Žvirbliukai;73677227470;Taip;0;0;3;3
18434;Volungė;Žvirbliukai;33864104545;Taip;5;0;4;9
18435;Volungė;Žvirbliukai;51999447522;Taip;0;0;7;7
18436;Volungė;Žvirbliukai;33437446320;Taip;0;8;1;9
18437;Volungė;Žvirbliukai;58770101384;Taip;5;0;10;15
18438;Volungė;Žvirbliukai;77965211614;Taip;0;0;22;22
18439;Volungė;Žvirbliukai;54054647743;Taip;2;0;3;5
18440;Volungė;Žvirbliukai;50724446122;Taip;0;0;3;3
18441;Volungė;Žvirbliukai;1866419277;Taip;8;0;0;8
18442;Volungė;Žvirbliukai;1400614987;Ne;14;0;1;15
18443;Volungė;Žvirbliukai;1002996169;Taip;7;4;0;11
18444;Volungė;Žvirbliukai;57009443613;Taip;0;3;0;3
18445;Volungė;Žvirbliukai;1184098245;Taip;0;0;5;5
18446;Volungė;Žvirbliukai;1177104323;Taip;0;0;17;17
18447;Volungė;Žvirbliukai;7623915697;Taip;0;0;7;7
18448;Volungė;Žvirbliukai;6426464927;Taip;0;0;9;9
18449;Volungė;Žiogeliai;20829614346;Taip;0;0;1;1
18450;Volungė;Žiogeliai;6453272974;Taip;0;0;16;16
18451;Volungė;Žiogeliai;50525901200;Taip;6;0;0;6
18452;Volungė;Žiogeliai;1766449043;Taip;0;0;1;1
18453;Volungė;Žiogeliai;16359638255;Taip;0;0;1;1
18454;Volungė;Žiogeliai;4472358109;Taip;0;0;8;8
18455;Volungė;Žiogeliai;99572426508;Ne;0;8;0;8
18456;Volungė;Žiogeliai;18572342676;Ne;5;0;12;17
18457;Volungė;Žiogeliai;1574141255;Taip;0;0;2;2
18458;Volungė;Žiogeliai;83169035513;Taip;0;0;14;14
18459;Volungė;Žiogeliai;52112359999;Ne;11;0;1;12
18460;Volungė;Žiogeliai;73555360631;Ne;0;0;1;1
18461;Volungė;Žiogeliai;71074516561;Taip;0;0;8;8
18462;Volungė;Žiogeliai;11298375135;Taip;0;12;0;12
18463;Volungė;Žiogeliai;55920793056;Taip;4;1;4;9
18464;Volungė;Žiogeliai;1812871720;Taip;14;0;5;19
18465;Volungė;Žiogeliai;23806383679;Taip;0;0;8;8
18466;Volungė;Pelėdžiukai;1032406917;Taip;0;14;0;14
18467;Volungė;Pelėdžiukai;2106837525;Taip;6;0;3;9
18468;Volungė;Pelėdžiukai;1105647976;Ne;2;0;0;2
18469;Volungė;Pelėdžiukai;1705153224;Taip;4;0;0;4
18470;Volungė;Pelėdžiukai;2048619311;Taip;0;22;0;22
18471;Volungė;Pelėdžiukai;1205393441;Taip;0;1;0;1
18472;Volungė;Pelėdžiukai;9097775073;Ne;9;0;0;9
18473;Volungė;Pelėdžiukai;1938717633;Taip;5;11;0;16
18474;Volungė;Pelėdžiukai;56766828567;Taip;5;0;0;5
18475;Volungė;Pelėdžiukai;6977873198;Taip;9;0;0;9
18476;Volungė;Pelėdžiukai;1917593287;Taip;7;0;7;14
18477;Volungė;Pelėdžiukai;2558681375;Taip;3;0;1;4
18478;Volungė;Pelėdžiukai;85731265908;Taip;0;0;2;2
18479;Volungė;Pelėdžiukai;1861218588;Taip;0;0;4;4
18480;Volungė;Pelėdžiukai;5483140534;Taip;0;1;0;1
18481;Volungė;Pelėdžiukai;8236836742;Ne;0;0;5;5
18482;Volungė;Pelėdžiukai;1158253769;Ne;0;0;1;1
18483;Volungė;Pelėdžiukai;3632828615;Taip;5;0;0;5
18484;Volungė;Drugeliai;2111319986;Taip;0;0;1;1
18485;Volungė;Drugeliai;1742777458;Taip;0;0;7;7
18486;Volungė;Drugeliai;2139675610;Taip;0;1;0;1
18487;Volungė;Drugeliai;1752357091;Taip;12;0;0;12
18488;Volungė;Drugeliai;1974360497;Taip;5;0;4;9
18489;Volungė;Drugeliai;86769531194;Taip;0;0;2;2
18490;Volungė;Drugeliai;3803129970;Taip;7;0;0;7
18491;Volungė;Drugeliai;1726933019;Taip;0;0;11;11
18492;Volungė;Drugeliai;1333045175;Taip;0;0;7;7
18493;Volungė;Drugeliai;1173302471;Taip;0;22;0;22
18494;Volungė;Drugeliai;1900204936;Taip;0;5;0;5
18495;Volungė;Drugeliai;1333755594;Taip;0;0;2;2
18496;Volungė;Drugeliai;1539188909;Taip;0;0;11;11
18497;Volungė;Drugeliai;1731981819;Taip;0;5;0;5
18498;Volungė;Drugeliai;44878463386;Taip;3;0;0;3
18499;Volungė;Drugeliai;2763686861;Taip;0;0;3;3
18500;Volungė;Drugeliai;19340864795;Taip;0;0;2;2
18501;Volungė;Drugeliai;3155184296;Taip;6;0;5;11
18502;Volungė;Drugeliai;7075466773;Taip;9;0;10;19
18503;Volungė;Drugeliai;1291153830;Taip;8;8;0;16
18504;Volungė;Drugeliai;1167124464;Taip;5;0;6;11
18505;Volungė;"SKRUZDĖLIUKAI ";8174587725;Taip;14;0;0;14
18506;Volungė;"SKRUZDĖLIUKAI ";7521910384;Taip;14;0;0;14
18507;Volungė;"SKRUZDĖLIUKAI ";5240126123;Taip;0;0;1;1
18508;Volungė;"SKRUZDĖLIUKAI ";8268202101;Taip;0;0;8;8
18509;Volungė;"SKRUZDĖLIUKAI ";2566901599;Taip;14;0;2;16
18510;Volungė;"SKRUZDĖLIUKAI ";3215314804;Taip;0;0;2;2
18511;Volungė;"SKRUZDĖLIUKAI ";2420242319;Taip;0;0;4;4
18512;Volungė;"SKRUZDĖLIUKAI ";1120682487;Taip;8;1;2;11
18513;Volungė;"SKRUZDĖLIUKAI ";8963841949;Ne;0;0;2;2
18514;Volungė;"SKRUZDĖLIUKAI ";1366066359;Taip;0;0;2;2
18515;Volungė;"SKRUZDĖLIUKAI ";9068889427;Ne;0;0;3;3
18516;Volungė;"SKRUZDĖLIUKAI ";6565522808;Taip;0;0;3;3
18517;Volungė;"SKRUZDĖLIUKAI ";3356901662;Taip;22;0;0;22
18518;Volungė;"SKRUZDĖLIUKAI ";9082860913;Taip;12;0;2;14
18519;Volungė;"SKRUZDĖLIUKAI ";7973680488;Taip;0;1;0;1
18520;Volungė;"SKRUZDĖLIUKAI ";9629567682;Taip;11;0;2;13
18521;Volungė;"SKRUZDĖLIUKAI ";3814647332;Taip;2;0;3;5
18522;Volungė;Zylutės;8784150784;Taip;5;2;0;7
18523;Volungė;Zylutės;8287344195;Taip;6;4;0;10
18524;Volungė;Zylutės;5710662590;Taip;5;0;2;7
18525;Volungė;Zylutės;1164632050;Taip;9;0;0;9
18526;Volungė;Zylutės;1528289101;Taip;0;0;2;2
18527;Volungė;Zylutės;1642961608;Taip;0;22;0;22
18528;Volungė;Zylutės;4839484528;Taip;7;0;7;14
18529;Volungė;Zylutės;9188994935;Taip;0;6;2;8
18530;Volungė;Zylutės;8285309230;Taip;0;22;0;22
18531;Volungė;Zylutės;7149986415;Taip;0;0;1;1
18532;Volungė;Zylutės;5174427959;Ne;0;0;7;7
18533;Volungė;Zylutės;7867741556;Taip;0;5;0;5
18534;Volungė;Zylutės;3430719834;Ne;0;8;1;9
18535;Volungė;Zylutės;8459167833;Taip;0;0;2;2
18536;Volungė;Zylutės;6028582927;Taip;3;0;0;3
18537;Volungė;Zylutės;2547777148;Taip;22;0;0;22
18538;Giliukas;SMALSUČIAI;84750777858;Taip;15;0;2;17
18539;Giliukas;SMALSUČIAI;1869027087;Taip;0;2;0;2
18540;Giliukas;SMALSUČIAI;80254838594;Taip;0;22;0;22
18541;Giliukas;SMALSUČIAI;4163391813;Taip;0;22;0;22
18542;Giliukas;SMALSUČIAI;1431811346;Taip;0;2;3;5
18543;Giliukas;SMALSUČIAI;1910800137;Taip;0;2;1;3
18544;Giliukas;SMALSUČIAI;8284364049;Taip;0;2;0;2
18545;Giliukas;SMALSUČIAI;1733875411;Taip;0;4;0;4
18546;Giliukas;SMALSUČIAI;2617670085;Ne;0;6;0;6
18547;Giliukas;SMALSUČIAI;76463522285;Taip;0;0;1;1
18548;Giliukas;SMALSUČIAI;51201920656;Taip;0;0;2;2
18549;Giliukas;SMALSUČIAI;1771662094;Taip;10;2;2;14
18550;Giliukas;SMALSUČIAI;60766023175;Taip;0;0;1;1
18551;Giliukas;SMALSUČIAI;50289768374;Taip;0;22;0;22
18552;Giliukas;SMALSUČIAI;76716908362;Taip;6;4;2;12
18553;Giliukas;SMALSUČIAI;7223355423;Taip;0;7;0;7
18554;Giliukas;SMALSUČIAI;1649456516;Taip;17;0;5;22
18555;Giliukas;SMALSUČIAI;51723671912;Ne;10;1;0;11
18556;Giliukas;SMALSUČIAI;1665908531;Taip;0;2;0;2
18557;Giliukas;SMALSUČIAI;1969508164;Ne;4;1;0;5
18558;Giliukas;SMALSUČIAI;1624952768;Ne;2;2;2;6
18559;Giliukas;GUDRUČIAI;47667170356;Ne;0;2;0;2
18560;Giliukas;GUDRUČIAI;44324261160;Taip;0;22;0;22
18561;Giliukas;GUDRUČIAI;2051045114;Taip;0;22;0;22
18562;Giliukas;GUDRUČIAI;1524900421;Taip;0;2;0;2
18563;Giliukas;GUDRUČIAI;20294403486;Taip;0;2;0;2
18564;Giliukas;GUDRUČIAI;13047826874;Taip;6;3;1;10
18565;Giliukas;GUDRUČIAI;45976793843;Taip;3;5;0;8
18566;Giliukas;GUDRUČIAI;96391124646;Taip;0;2;0;2
18567;Giliukas;GUDRUČIAI;77697629121;Taip;0;0;4;4
18568;Giliukas;GUDRUČIAI;135044370;Taip;0;2;0;2
18569;Giliukas;GUDRUČIAI;41761163148;Taip;1;0;0;1
18570;Giliukas;GUDRUČIAI;9254755937;Ne;0;0;2;2
18571;Giliukas;GUDRUČIAI;34919241837;Taip;0;10;0;10
18572;Giliukas;GUDRUČIAI;13279159942;Taip;0;1;0;1
18573;Giliukas;GUDRUČIAI;13946513947;Taip;0;0;9;9
18574;Giliukas;GUDRUČIAI;41666529831;Ne;0;3;3;6
18575;Giliukas;GUDRUČIAI;26006763829;Taip;2;2;0;4
18576;Giliukas;GUDRUČIAI;9455477992;Taip;0;7;0;7
18577;Giliukas;GUDRUČIAI;1203715568;Taip;0;2;1;3
18578;Giliukas;GUDRUČIAI;2157057125;Taip;0;22;0;22
18579;Giliukas;ŠNEKUČIAI;1463748654;Taip;0;12;0;12
18580;Giliukas;ŠNEKUČIAI;1664239181;Taip;0;1;0;1
18581;Giliukas;ŠNEKUČIAI;1289574961;Taip;0;10;0;10
18582;Giliukas;ŠNEKUČIAI;9461909264;Taip;5;0;1;6
18583;Giliukas;ŠNEKUČIAI;34155615138;Taip;0;2;0;2
18584;Giliukas;ŠNEKUČIAI;14318411597;Taip;0;0;1;1
18585;Giliukas;ŠNEKUČIAI;2006450088;Ne;0;1;0;1
18586;Giliukas;ŠNEKUČIAI;40373221046;Taip;0;2;0;2
18587;Giliukas;ŠNEKUČIAI;8575067944;Ne;7;2;0;9
18588;Giliukas;ŠNEKUČIAI;26109227683;Taip;0;3;1;4
18589;Giliukas;ŠNEKUČIAI;4053376466;Ne;0;2;12;14
18590;Giliukas;ŠNEKUČIAI;1406371374;Ne;0;0;3;3
18591;Giliukas;ŠNEKUČIAI;10326073797;Taip;0;2;0;2
18592;Giliukas;ŠNEKUČIAI;7732836522;Taip;11;0;0;11
18593;Giliukas;ŠNEKUČIAI;5914236976;Taip;7;0;12;19
18594;Giliukas;ŠNEKUČIAI;9225515816;Taip;0;2;0;2
18595;Giliukas;ŠNEKUČIAI;6453425490;Taip;22;0;0;22
18596;Giliukas;ŠNEKUČIAI;1190611675;Ne;0;2;4;6
18597;Giliukas;ŠNEKUČIAI;9747155435;Taip;0;22;0;22
18598;Giliukas;ŠNEKUČIAI;6154379463;Taip;0;22;0;22
18599;Giliukas;PABIRUČIAI;9401247559;Taip;0;2;0;2
18600;Giliukas;PABIRUČIAI;6384202904;Taip;0;0;7;7
18601;Giliukas;PABIRUČIAI;24030146209;Taip;0;22;0;22
18602;Giliukas;PABIRUČIAI;3847358328;Taip;0;10;0;10
18603;Giliukas;PABIRUČIAI;9693949103;Taip;0;2;0;2
18604;Giliukas;PABIRUČIAI;1890147760;Taip;0;22;0;22
18605;Giliukas;PABIRUČIAI;1469477982;Taip;0;2;0;2
18606;Giliukas;PABIRUČIAI;3983555939;Taip;6;2;3;11
18607;Giliukas;PABIRUČIAI;7780118692;Taip;0;2;2;4
18608;Giliukas;PABIRUČIAI;2951628295;Taip;0;2;0;2
18609;Giliukas;PABIRUČIAI;5994213515;Taip;0;22;0;22
18610;Giliukas;PABIRUČIAI;5787041097;Taip;22;0;0;22
18611;Giliukas;PABIRUČIAI;4854370266;Taip;3;2;0;5
18612;Giliukas;PABIRUČIAI;4987348316;Taip;0;2;0;2
18613;Giliukas;PABIRUČIAI;7159681896;Taip;0;0;1;1
18614;Giliukas;PABIRUČIAI;4916844983;Taip;5;1;0;6
18615;"Lazdynų mokykla";Drugeliai;10453975773;Taip;0;11;0;11
18616;"Lazdynų mokykla";Drugeliai;1246702054;Taip;0;0;1;1
18617;"Lazdynų mokykla";Drugeliai;93091209041;Taip;12;3;1;16
18618;"Lazdynų mokykla";Drugeliai;43541072654;Taip;0;9;4;13
18619;"Lazdynų mokykla";Drugeliai;1117304239;Taip;0;1;5;6
18620;"Lazdynų mokykla";Drugeliai;9890308887;Ne;0;7;3;10
18621;"Lazdynų mokykla";Drugeliai;9380814933;Taip;0;2;0;2
18622;"Lazdynų mokykla";Drugeliai;6209271043;Taip;2;1;3;6
18623;"Lazdynų mokykla";Drugeliai;7154882168;Taip;0;22;0;22
18624;"Lazdynų mokykla";Drugeliai;6835150864;Taip;4;5;0;9
18625;"Lazdynų mokykla";Drugeliai;9449948668;Taip;6;6;0;12
18626;"Lazdynų mokykla";Drugeliai;4520091712;Taip;0;0;4;4
18627;"Lazdynų mokykla";Drugeliai;1177208864;Taip;0;0;6;6
18628;"Lazdynų mokykla";Drugeliai;3711708570;Ne;8;4;0;12
18629;"Lazdynų mokykla";Zuikučiai;1837465174;Taip;0;16;0;16
18630;"Lazdynų mokykla";Zuikučiai;1065999533;Taip;0;2;0;2
18631;"Lazdynų mokykla";Zuikučiai;40995112936;Taip;5;0;0;5
18632;"Lazdynų mokykla";Zuikučiai;9591838054;Taip;0;5;0;5
18633;"Lazdynų mokykla";Zuikučiai;8847547438;Ne;12;0;0;12
18634;"Lazdynų mokykla";Zuikučiai;6615724604;Taip;0;1;0;1
18635;"Lazdynų mokykla";Zuikučiai;9386629495;Taip;8;0;0;8
18636;"Lazdynų mokykla";Zuikučiai;25106446270;Ne;0;6;0;6
18637;"Lazdynų mokykla";Zuikučiai;9123178095;Taip;0;16;0;16
18638;"Lazdynų mokykla";Zuikučiai;6848743350;Taip;6;13;0;19
18639;"Lazdynų mokykla";Zuikučiai;1365362641;Taip;5;0;0;5
18640;"Lazdynų mokykla";Zuikučiai;3435025978;Taip;0;0;16;16
18641;"Lazdynų mokykla";Zuikučiai;7549389699;Ne;22;0;0;22
18642;"Lazdynų mokykla";RUPG;14305754762;Taip;0;0;3;3
18643;"Lazdynų mokykla";RUPG;40990471173;Taip;22;0;0;22
18644;"Lazdynų mokykla";RUPG;36268808517;Taip;0;22;0;22
18645;"Lazdynų mokykla";RUPG;4867721872;Taip;0;0;3;3
18646;"Lazdynų mokykla";RUPG;9840858941;Ne;10;0;0;10
18647;"Lazdynų mokykla";RUPG;3702185382;Taip;1;0;10;11
18648;"Lazdynų mokykla";RUPG;12946825485;Taip;3;8;0;11
18649;"Lazdynų mokykla";RUPG;33658230571;Taip;0;9;0;9
18650;"Lazdynų mokykla";RUPG;62603312655;Taip;0;0;3;3
18651;"Lazdynų mokykla";RUPG;2010518086;Ne;0;0;2;2
18652;"Lazdynų mokykla";RUPG;9341499222;Taip;5;0;4;9
18653;"Lazdynų mokykla";RUPG;85389197930;Taip;0;0;5;5
18654;"„Atžalyno” mokykla-darželis";Giliukai;20731737855;Ne;0;0;10;10
18655;"„Atžalyno” mokykla-darželis";Giliukai;4689820608;Taip;5;0;3;8
18656;"„Atžalyno” mokykla-darželis";Giliukai;96760511860;Taip;0;0;1;1
18657;"„Atžalyno” mokykla-darželis";Giliukai;11283726979;Taip;0;7;0;7
18658;"„Atžalyno” mokykla-darželis";Giliukai;79370702446;Taip;0;7;0;7
18659;"„Atžalyno” mokykla-darželis";Giliukai;5473807824;Taip;7;0;0;7
18660;"„Atžalyno” mokykla-darželis";Giliukai;812540977;Taip;0;1;0;1
18661;"„Atžalyno” mokykla-darželis";Giliukai;16939194895;Taip;0;0;3;3
18662;"„Atžalyno” mokykla-darželis";Giliukai;1360239148;Taip;0;4;0;4
18663;"„Atžalyno” mokykla-darželis";Giliukai;2561427539;Ne;0;1;1;2
18664;"„Atžalyno” mokykla-darželis";Giliukai;21100054429;Taip;0;2;0;2
18665;"„Atžalyno” mokykla-darželis";Giliukai;75040764923;Taip;0;5;0;5
18666;"„Atžalyno” mokykla-darželis";Giliukai;9526480686;Taip;0;7;0;7
18667;"„Atžalyno” mokykla-darželis";Giliukai;63188100368;Taip;2;0;1;3
18668;"„Atžalyno” mokykla-darželis";Giliukai;1687257249;Taip;0;9;0;9
18669;"„Atžalyno” mokykla-darželis";Giliukai;8477084613;Taip;0;10;0;10
18670;"„Atžalyno” mokykla-darželis";Giliukai;9671080677;Taip;0;0;1;1
18671;"„Atžalyno” mokykla-darželis";Giliukai;87635454714;Taip;0;0;5;5
18672;"„Atžalyno” mokykla-darželis";Riešutėliai;62142172359;Taip;0;12;0;12
18673;"„Atžalyno” mokykla-darželis";Riešutėliai;31330839773;Taip;6;2;0;8
18674;"„Atžalyno” mokykla-darželis";Riešutėliai;1035650951;Taip;13;0;0;13
18675;"„Atžalyno” mokykla-darželis";Riešutėliai;27965090417;Ne;0;13;0;13
18676;"„Atžalyno” mokykla-darželis";Riešutėliai;4309031068;Ne;0;0;5;5
18677;"„Atžalyno” mokykla-darželis";Riešutėliai;6177714133;Taip;0;0;1;1
18678;"„Atžalyno” mokykla-darželis";Riešutėliai;1298900423;Taip;0;0;7;7
18679;"„Atžalyno” mokykla-darželis";Riešutėliai;64311414937;Taip;0;0;2;2
18680;"„Atžalyno” mokykla-darželis";Riešutėliai;2172405172;Ne;0;0;4;4
18681;"„Atžalyno” mokykla-darželis";Riešutėliai;79970541004;Taip;0;0;15;15
18682;"„Atžalyno” mokykla-darželis";Riešutėliai;94770065539;Ne;0;1;0;1
18683;"„Atžalyno” mokykla-darželis";Riešutėliai;79939366466;Taip;0;7;2;9
18684;"„Atžalyno” mokykla-darželis";Riešutėliai;10955918317;Taip;0;0;1;1
18685;"„Atžalyno” mokykla-darželis";Riešutėliai;19312623259;Taip;0;4;0;4
18686;"„Atžalyno” mokykla-darželis";Riešutėliai;5921479520;Taip;0;0;12;12
18687;"Vilniaus Emilijos Pliaterytės progimnazija";PELĖDŽIUKAI;1475766630;Taip;0;22;0;22
18688;"Vilniaus Emilijos Pliaterytės progimnazija";PELĖDŽIUKAI;6025990670;Taip;12;0;0;12
18689;"Vilniaus Emilijos Pliaterytės progimnazija";PELĖDŽIUKAI;1758561647;Taip;0;4;0;4
18690;"Vilniaus Emilijos Pliaterytės progimnazija";PELĖDŽIUKAI;11101488283;Taip;0;2;0;2
18691;"Vilniaus Emilijos Pliaterytės progimnazija";PELĖDŽIUKAI;1551926849;Taip;0;7;2;9
18692;"Vilniaus Emilijos Pliaterytės progimnazija";PELĖDŽIUKAI;9980215936;Ne;3;0;3;6
18693;"Vilniaus Emilijos Pliaterytės progimnazija";PELĖDŽIUKAI;6406833864;Taip;0;11;0;11
18694;"Vilniaus Emilijos Pliaterytės progimnazija";PELĖDŽIUKAI;3049460994;Taip;3;0;0;3
18695;"Vilniaus Emilijos Pliaterytės progimnazija";PELĖDŽIUKAI;7540156488;Taip;0;8;0;8
18696;"Vilniaus Emilijos Pliaterytės progimnazija";PELĖDŽIUKAI;4146983741;Taip;0;1;3;4
18697;"Vilniaus Emilijos Pliaterytės progimnazija";PELĖDŽIUKAI;9886869275;Taip;4;1;1;6
18698;"Vilniaus Emilijos Pliaterytės progimnazija";PELĖDŽIUKAI;63585262568;Taip;0;0;2;2
18699;"Vilniaus Emilijos Pliaterytės progimnazija";PELĖDŽIUKAI;1412529910;Taip;0;0;2;2
18700;"Vilniaus Emilijos Pliaterytės progimnazija";PELĖDŽIUKAI;8202177756;Taip;0;0;1;1
18701;"Vilniaus Emilijos Pliaterytės progimnazija";PELĖDŽIUKAI;1362468297;Ne;0;3;0;3
18702;"Vilniaus Emilijos Pliaterytės progimnazija";PELĖDŽIUKAI;96590022188;Taip;0;0;6;6
18703;"Vilniaus Emilijos Pliaterytės progimnazija";PELĖDŽIUKAI;2787942076;Taip;0;2;0;2
18704;"Vilniaus Emilijos Pliaterytės progimnazija";BITUTĖS;1266987365;Taip;0;2;0;2
18705;"Vilniaus Emilijos Pliaterytės progimnazija";BITUTĖS;1381033889;Taip;12;0;1;13
18706;"Vilniaus Emilijos Pliaterytės progimnazija";BITUTĖS;4569189295;Taip;0;2;0;2
18707;"Vilniaus Emilijos Pliaterytės progimnazija";BITUTĖS;48399220211;Taip;5;1;0;6
18708;"Vilniaus Emilijos Pliaterytės progimnazija";BITUTĖS;2514450574;Ne;0;2;0;2
18709;"Vilniaus Emilijos Pliaterytės progimnazija";BITUTĖS;16065326151;Taip;2;2;2;6
18710;"Vilniaus Emilijos Pliaterytės progimnazija";BITUTĖS;21354424968;Taip;0;2;0;2
18711;"Vilniaus Emilijos Pliaterytės progimnazija";BITUTĖS;9056362645;Taip;0;12;0;12
18712;"Vilniaus Emilijos Pliaterytės progimnazija";BITUTĖS;39510115701;Ne;0;1;0;1
18713;"Vilniaus Emilijos Pliaterytės progimnazija";BITUTĖS;6725344622;Ne;0;18;0;18
18714;"Vilniaus Emilijos Pliaterytės progimnazija";BITUTĖS;6010639117;Taip;14;0;0;14
18715;"Vilniaus Emilijos Pliaterytės progimnazija";BITUTĖS;9725646179;Taip;5;0;2;7
18716;"Vilniaus Emilijos Pliaterytės progimnazija";BITUTĖS;1601646622;Taip;0;2;3;5
18717;"Vilniaus Emilijos Pliaterytės progimnazija";BITUTĖS;4795999477;Ne;0;2;2;4
18718;"Vilniaus Emilijos Pliaterytės progimnazija";BITUTĖS;9872199634;Taip;1;0;0;1
18719;"Vilniaus Emilijos Pliaterytės progimnazija";BITUTĖS;6105675285;Ne;0;0;6;6
18720;"Vilniaus Emilijos Pliaterytės progimnazija";BITUTĖS;2149264761;Taip;0;0;2;2
18721;"Vilniaus Emilijos Pliaterytės progimnazija";BITUTĖS;9328626733;Taip;4;0;0;4
18722;"Vilniaus Emilijos Pliaterytės progimnazija";BITUTĖS;1212916505;Taip;5;2;0;7
18723;"Vilniaus Emilijos Pliaterytės progimnazija";BITUTĖS;61614055656;Taip;0;2;3;5
18724;"Vilniaus Emilijos Pliaterytės progimnazija";BITUTĖS;2046056078;Taip;0;0;1;1
18725;"Vilniaus Emilijos Pliaterytės progimnazija";BITUTĖS;1323653656;Taip;0;2;0;2
18726;"Vilniaus Emilijos Pliaterytės progimnazija";BITUTĖS;5322173245;Taip;7;0;0;7
18727;"Vilniaus Emilijos Pliaterytės progimnazija";BITUTĖS;3416526776;Taip;5;0;2;7
18728;"Vilniaus Karaliaus Mindaugo pagrindinė mokykla";"NAUJA 1";1450039671;Ne;0;0;1;1
18729;"Vilniaus Karaliaus Mindaugo pagrindinė mokykla";"NAUJA 1";1823039323;Taip;0;0;3;3
18730;"Vilniaus Karaliaus Mindaugo pagrindinė mokykla";"NAUJA 1";8096536272;Ne;0;1;0;1
18731;"Vilniaus Karaliaus Mindaugo pagrindinė mokykla";"NAUJA 1";7596203918;Taip;3;0;3;6
18732;"Vilniaus Karaliaus Mindaugo pagrindinė mokykla";"NAUJA 1";45774870210;Taip;5;5;0;10
18733;"Vilniaus Karaliaus Mindaugo pagrindinė mokykla";"NAUJA 1";3680257542;Ne;0;0;5;5
18734;"Vilniaus Karaliaus Mindaugo pagrindinė mokykla";"NAUJA 1";1401502095;Taip;0;6;4;10
18735;"Vilniaus Karaliaus Mindaugo pagrindinė mokykla";"NAUJA 1";1257750782;Taip;4;0;0;4
18736;"Vilniaus Karaliaus Mindaugo pagrindinė mokykla";"NAUJA 1";1969208564;Ne;0;0;6;6
18737;"Vilniaus Karaliaus Mindaugo pagrindinė mokykla";"NAUJA 1";1860540266;Taip;0;0;3;3
18738;"Vilniaus Karaliaus Mindaugo pagrindinė mokykla";"NAUJA 1";47224065699;Taip;0;0;1;1
18739;"Vilniaus Karaliaus Mindaugo pagrindinė mokykla";"NAUJA 1";9555191234;Ne;0;0;16;16
18740;"Vilniaus Karaliaus Mindaugo pagrindinė mokykla";"NAUJA 1";18362159086;Taip;7;0;4;11
18741;"Vilniaus Karaliaus Mindaugo pagrindinė mokykla";"NAUJA 1";9136681731;Taip;0;0;5;5
18742;"Vilniaus Karaliaus Mindaugo pagrindinė mokykla";"NAUJA 2";1244335689;Ne;0;0;8;8
18743;"Vilniaus Karaliaus Mindaugo pagrindinė mokykla";"NAUJA 2";30247081871;Taip;0;1;1;2
18744;"Vilniaus Karaliaus Mindaugo pagrindinė mokykla";"NAUJA 2";22190489474;Taip;0;0;2;2
18745;"Vilniaus Karaliaus Mindaugo pagrindinė mokykla";"NAUJA 2";52007245002;Taip;0;0;2;2
18746;"Vilniaus Karaliaus Mindaugo pagrindinė mokykla";"NAUJA 2";42856875754;Ne;0;0;8;8
18747;"Vilniaus Karaliaus Mindaugo pagrindinė mokykla";"NAUJA 2";66357034848;Taip;0;0;1;1
18748;"Vilniaus Karaliaus Mindaugo pagrindinė mokykla";"NAUJA 2";9926365944;Ne;1;0;3;4
18749;"Vilniaus Karaliaus Mindaugo pagrindinė mokykla";"NAUJA 2";34474268952;Taip;0;0;16;16
18750;"Vilniaus Karaliaus Mindaugo pagrindinė mokykla";"NAUJA 2";51014054575;Taip;0;0;1;1
18751;"Vilniaus Karaliaus Mindaugo pagrindinė mokykla";"NAUJA 2";1774272972;Ne;0;0;1;1
18752;"Vilniaus Karaliaus Mindaugo pagrindinė mokykla";"NAUJA 2";6408313774;Taip;0;0;5;5
18753;"Vilniaus Karaliaus Mindaugo pagrindinė mokykla";"NAUJA 2";1161763218;Taip;0;0;3;3
18754;"Vilniaus Karaliaus Mindaugo pagrindinė mokykla";"NAUJA 2";2941071757;Taip;1;0;0;1
18755;"Vilniaus Karaliaus Mindaugo pagrindinė mokykla";"NAUJA 2";7501280559;Taip;0;0;3;3
18756;"Vilniaus Karaliaus Mindaugo pagrindinė mokykla";"NAUJA 2";66035912812;Ne;1;0;2;3
18757;"Vilniaus Karaliaus Mindaugo pagrindinė mokykla";"NAUJA 2";3763454607;Taip;5;0;2;7
18758;"Vilniaus Karaliaus Mindaugo pagrindinė mokykla";"NAUJA 3";76067902652;Taip;0;0;5;5
18759;"Vilniaus Karaliaus Mindaugo pagrindinė mokykla";"NAUJA 3";22824695222;Taip;0;5;0;5
18760;"Vilniaus Karaliaus Mindaugo pagrindinė mokykla";"NAUJA 3";15620943297;Taip;0;2;0;2
18761;"Vilniaus Karaliaus Mindaugo pagrindinė mokykla";"NAUJA 3";29462854972;Ne;0;5;0;5
18762;"Vilniaus Karaliaus Mindaugo pagrindinė mokykla";"NAUJA 3";46789173270;Ne;0;0;3;3
18763;"Vilniaus Karaliaus Mindaugo pagrindinė mokykla";"NAUJA 3";93362540292;Taip;0;0;3;3
18764;"Vilniaus Karaliaus Mindaugo pagrindinė mokykla";"NAUJA 3";39314644760;Taip;0;6;0;6
18765;"Vilniaus Karaliaus Mindaugo pagrindinė mokykla";"NAUJA 3";63005020529;Taip;0;0;1;1
18766;"Vilniaus Karaliaus Mindaugo pagrindinė mokykla";"NAUJA 3";69875233191;Taip;0;5;0;5
18767;"Vilniaus Karaliaus Mindaugo pagrindinė mokykla";"NAUJA 3";81435594438;Taip;6;0;1;7
18768;"Vilniaus Karaliaus Mindaugo pagrindinė mokykla";"NAUJA 3";1933781186;Ne;0;1;0;1
18769;"Vilniaus Karaliaus Mindaugo pagrindinė mokykla";"NAUJA 3";5728013837;Taip;0;0;11;11
18770;"Vilniaus Karaliaus Mindaugo pagrindinė mokykla";"NAUJA 3";14289501964;Taip;0;0;4;4
18771;"Vilniaus Karaliaus Mindaugo pagrindinė mokykla";"NAUJA 3";29504643080;Taip;0;0;22;22
18772;"Vilniaus Karaliaus Mindaugo pagrindinė mokykla";"NAUJA 3";23714493433;Taip;0;0;13;13
18773;"Vilniaus Karaliaus Mindaugo pagrindinė mokykla";"NAUJA 3";1480855516;Taip;0;0;5;5
18774;"Vilniaus Karaliaus Mindaugo pagrindinė mokykla";"NAUJA 3";82128363155;Taip;0;4;0;4
18775;"Vilniaus Karaliaus Mindaugo pagrindinė mokykla";"NAUJA 3";3974287828;Ne;0;0;3;3
18776;"Vilniaus Baltupių progimnazija";Kodėlčiukai;39367902407;Taip;0;1;0;1
18777;"Vilniaus Baltupių progimnazija";Kodėlčiukai;14007025976;Taip;0;0;1;1
18778;"Vilniaus Baltupių progimnazija";Kodėlčiukai;71242132208;Taip;3;5;0;8
18779;"Vilniaus Baltupių progimnazija";Kodėlčiukai;85383004980;Taip;0;0;1;1
18780;"Vilniaus Baltupių progimnazija";Kodėlčiukai;55625325952;Taip;4;0;0;4
18781;"Vilniaus Baltupių progimnazija";Kodėlčiukai;16355778437;Ne;0;5;0;5
18782;"Vilniaus Baltupių progimnazija";Kodėlčiukai;41941052897;Taip;0;0;3;3
18783;"Vilniaus Baltupių progimnazija";Kodėlčiukai;43948925208;Taip;0;0;1;1
18784;"Vilniaus Baltupių progimnazija";Kodėlčiukai;41791737317;Taip;0;4;0;4
18785;"Vilniaus Baltupių progimnazija";Kodėlčiukai;69400709859;Taip;4;0;0;4
18786;"Vilniaus Baltupių progimnazija";Kodėlčiukai;10510784037;Taip;0;0;2;2
18787;"Vilniaus Baltupių progimnazija";Smalsučiai;6378279947;Taip;0;3;0;3
18788;"Vilniaus Baltupių progimnazija";Smalsučiai;72920136125;Taip;4;0;0;4
18789;"Vilniaus Baltupių progimnazija";Smalsučiai;6691656559;Taip;0;6;0;6
18790;"Vilniaus Baltupių progimnazija";Smalsučiai;26377121363;Taip;0;3;1;4
18791;"Vilniaus Baltupių progimnazija";Smalsučiai;54374237984;Taip;0;0;6;6
18792;"Vilniaus Baltupių progimnazija";Smalsučiai;44112608775;Taip;0;0;3;3
18793;"Vilniaus Baltupių progimnazija";Smalsučiai;14961029346;Taip;0;5;0;5
18794;"Vilniaus Baltupių progimnazija";Smalsučiai;55042661269;Taip;0;1;0;1
18795;"Vilniaus Baltupių progimnazija";Smalsučiai;85563395776;Taip;0;6;0;6
18796;"Vilniaus Baltupių progimnazija";Smalsučiai;1474110400;Taip;0;0;2;2
18797;"Vilniaus Baltupių progimnazija";Smalsučiai;58618032928;Taip;0;0;2;2
18798;"Vilniaus Baltupių progimnazija";Smalsučiai;8033817151;Taip;0;0;3;3
18799;"Vilniaus Baltupių progimnazija";Smalsučiai;1377633427;Ne;0;0;6;6
18800;"Vilniaus Baltupių progimnazija";Smalsučiai;9561915342;Taip;0;1;0;1
18801;"Vilniaus Baltupių progimnazija";Svajokliai;77443527742;Taip;0;0;3;3
18802;"Vilniaus Baltupių progimnazija";Svajokliai;1124861465;Taip;0;0;7;7
18803;"Vilniaus Baltupių progimnazija";Svajokliai;84147129210;Taip;0;0;4;4
18804;"Vilniaus Baltupių progimnazija";Svajokliai;44197089077;Taip;0;0;2;2
18805;"Vilniaus Baltupių progimnazija";Svajokliai;10296915277;Taip;0;0;1;1
18806;"Vilniaus Baltupių progimnazija";Svajokliai;6141821323;Taip;0;0;2;2
18807;"Vilniaus Baltupių progimnazija";Svajokliai;9897957182;Ne;2;0;2;4
18808;"Vilniaus Baltupių progimnazija";Svajokliai;6836526948;Taip;0;0;7;7
18809;"Vilniaus Baltupių progimnazija";Svajokliai;50679337916;Ne;0;0;1;1
18810;"Vilniaus Baltupių progimnazija";Svajokliai;86159748827;Ne;0;0;2;2
18811;"Vilniaus Baltupių progimnazija";Svajokliai;7315821989;Taip;0;0;1;1
18812;"Vilniaus Baltupių progimnazija";Svajokliai;85006202845;Ne;0;0;6;6
18813;"Vilniaus Baltupių progimnazija";Svajokliai;73329089772;Taip;0;2;1;3
18814;"Vilniaus Baltupių progimnazija";Svajokliai;5165936773;Taip;0;0;2;2
18815;"Vilniaus Baltupių progimnazija";Svajokliai;3555057263;Taip;0;22;0;22
18816;"Vilniaus Baltupių progimnazija";Žiniukai;49864549520;Ne;3;0;0;3
18817;"Vilniaus Baltupių progimnazija";Žiniukai;45338766326;Taip;1;0;3;4
18818;"Vilniaus Baltupių progimnazija";Žiniukai;7172910408;Taip;2;0;1;3
18819;"Vilniaus Baltupių progimnazija";Žiniukai;83439477631;Taip;0;0;1;1
18820;"Vilniaus Baltupių progimnazija";Žiniukai;96970348855;Taip;0;0;1;1
18821;"Vilniaus Baltupių progimnazija";Žiniukai;22749485803;Ne;0;1;0;1
18822;"Vilniaus Baltupių progimnazija";Žiniukai;21356492489;Ne;8;1;0;9
18823;"Vilniaus Baltupių progimnazija";Žiniukai;66442714295;Taip;0;3;0;3
18824;"Vilniaus Baltupių progimnazija";Žiniukai;69737288391;Taip;0;1;0;1
18825;"Vilniaus Baltupių progimnazija";Žiniukai;23763005302;Taip;4;0;0;4
18826;"Vilniaus Baltupių progimnazija";Žiniukai;5703301527;Taip;14;3;0;17
18827;"Vilniaus Baltupių progimnazija";Žiniukai;59153301160;Taip;0;0;1;1
18828;"Vilniaus Baltupių progimnazija";Žiniukai;3909042390;Taip;0;0;8;8
18829;"Vilniaus Baltupių progimnazija";Žiniukai;6434969626;Taip;6;2;0;8
18830;"Vilniaus Baltupių progimnazija";Žiniukai;52985512945;Taip;0;1;0;1
18831;"Vilniaus Levo Karsavimo vidurinė mokykla";"Priešmokyklinukai A";14440714117;Ne;0;0;8;8
18832;"Vilniaus Levo Karsavimo vidurinė mokykla";"Priešmokyklinukai A";82502598495;Taip;0;6;0;6
18833;"Vilniaus Levo Karsavimo vidurinė mokykla";"Priešmokyklinukai A";93157311332;Taip;5;0;3;8
18834;"Vilniaus Levo Karsavimo vidurinė mokykla";"Priešmokyklinukai A";28093592809;Taip;0;0;3;3
18835;"Vilniaus Levo Karsavimo vidurinė mokykla";"Priešmokyklinukai A";70364015727;Ne;9;6;0;15
18836;"Vilniaus Levo Karsavimo vidurinė mokykla";"Priešmokyklinukai A";4273890878;Taip;6;0;1;7
18837;"Vilniaus Levo Karsavimo vidurinė mokykla";"Priešmokyklinukai A";77019635269;Taip;0;4;0;4
18838;"Vilniaus Levo Karsavimo vidurinė mokykla";"Priešmokyklinukai A";15574258138;Ne;3;0;0;3
18839;"Vilniaus Levo Karsavimo vidurinė mokykla";"Priešmokyklinukai A";7147965267;Ne;0;22;0;22
18840;"Vilniaus Levo Karsavimo vidurinė mokykla";"Priešmokyklinukai A";58496565193;Taip;8;0;1;9
18841;"Vilniaus Levo Karsavimo vidurinė mokykla";"Priešmokyklinukai A";25498748126;Ne;4;6;0;10
18842;"Vilniaus Levo Karsavimo vidurinė mokykla";"Priešmokyklinukai A";77438050638;Taip;0;0;7;7
18843;"Vilniaus Levo Karsavimo vidurinė mokykla";"Priešmokyklinukai A";36430214688;Taip;0;0;1;1
18844;"Vilniaus Levo Karsavimo vidurinė mokykla";"Priešmokyklinukai A";94004273598;Taip;0;5;0;5
18845;"Vilniaus Levo Karsavimo vidurinė mokykla";"Priešmokyklinukai A";1371307111;Taip;6;0;2;8
18846;"Vilniaus Levo Karsavimo vidurinė mokykla";"Priešmokyklinukai b";90184376409;Taip;0;5;0;5
18847;"Vilniaus Levo Karsavimo vidurinė mokykla";"Priešmokyklinukai b";6151061931;Taip;6;0;3;9
18848;"Vilniaus Levo Karsavimo vidurinė mokykla";"Priešmokyklinukai b";1938391715;Ne;0;7;0;7
18849;"Vilniaus Levo Karsavimo vidurinė mokykla";"Priešmokyklinukai b";66160874700;Taip;0;0;8;8
18850;"Vilniaus Levo Karsavimo vidurinė mokykla";"Priešmokyklinukai b";38820365517;Taip;0;2;0;2
18851;"Vilniaus Levo Karsavimo vidurinė mokykla";"Priešmokyklinukai b";22149054613;Taip;0;9;0;9
18852;"Vilniaus Levo Karsavimo vidurinė mokykla";"Priešmokyklinukai b";2531327145;Taip;0;1;0;1
18853;"Vilniaus Levo Karsavimo vidurinė mokykla";"Priešmokyklinukai b";78913604764;Taip;0;9;0;9
18854;"Vilniaus Levo Karsavimo vidurinė mokykla";"Priešmokyklinukai b";89656947611;Taip;0;0;10;10
18855;"Vilniaus Levo Karsavimo vidurinė mokykla";"Priešmokyklinukai b";56625898576;Taip;0;0;6;6
18856;"Vilniaus Levo Karsavimo vidurinė mokykla";"Priešmokyklinukai b";66998252884;Taip;0;5;0;5
18857;"Vilniaus Levo Karsavimo vidurinė mokykla";"Priešmokyklinukai b";30728353672;Ne;7;0;0;7
18858;"Vilniaus Levo Karsavimo vidurinė mokykla";"Priešmokyklinukai b";31278810938;Taip;0;6;0;6
18859;"Vilniaus Levo Karsavimo vidurinė mokykla";"Priešmokyklinukai b";3893943727;Ne;0;0;4;4
18860;"Vilniaus Levo Karsavimo vidurinė mokykla";"Priešmokyklinukai b";51125720677;Taip;0;8;0;8
18861;"Vilniaus Liepkalnio Pagrindinė Mokykla";Bitutės;85942649944;Taip;0;6;4;10
18862;"Vilniaus Liepkalnio Pagrindinė Mokykla";Bitutės;15384883293;Taip;0;6;1;7
18863;"Vilniaus Liepkalnio Pagrindinė Mokykla";Bitutės;41301452936;Ne;13;6;0;19
18864;"Vilniaus Liepkalnio Pagrindinė Mokykla";Bitutės;68347661358;Taip;1;6;0;7
18865;"Vilniaus Liepkalnio Pagrindinė Mokykla";Bitutės;4437933849;Taip;0;6;1;7
18866;"Vilniaus Liepkalnio Pagrindinė Mokykla";Bitutės;4760866352;Taip;0;6;0;6
18867;"Vilniaus Liepkalnio Pagrindinė Mokykla";Bitutės;70408565216;Ne;0;6;4;10
18868;"Vilniaus Liepkalnio Pagrindinė Mokykla";Bitutės;11323385715;Taip;0;8;1;9
18869;"Vilniaus Liepkalnio Pagrindinė Mokykla";Bitutės;2118993423;Taip;5;6;0;11
18870;"Vilniaus Liepkalnio Pagrindinė Mokykla";Bitutės;53619465080;Taip;6;6;0;12
18871;"Vilniaus Liepkalnio Pagrindinė Mokykla";Bitutės;5991259497;Taip;0;6;0;6
18872;"Vilniaus Liepkalnio Pagrindinė Mokykla";Bitutės;52218753980;Taip;0;6;0;6
18873;"Vilniaus Liepkalnio Pagrindinė Mokykla";Bitutės;3007372384;Taip;0;22;0;22
18874;"Vilniaus Liepkalnio Pagrindinė Mokykla";Bitutės;4972232696;Taip;0;22;0;22
18875;"Vilniaus Liepkalnio Pagrindinė Mokykla";Bitutės;7760450278;Ne;0;11;1;12
18876;"Vilniaus Pranciškaus Skorinos gimnazija";Saulytė;8111363055;Taip;0;7;0;7
18877;"Vilniaus Pranciškaus Skorinos gimnazija";Saulytė;2930371388;Taip;1;0;4;5
18878;"Vilniaus Pranciškaus Skorinos gimnazija";Saulytė;70791039097;Ne;0;5;0;5
18879;"Vilniaus Pranciškaus Skorinos gimnazija";Saulytė;8632571006;Ne;2;1;2;5
18880;"Vilniaus Pranciškaus Skorinos gimnazija";Saulytė;66664410121;Taip;1;2;1;4
18881;"Vilniaus Pranciškaus Skorinos gimnazija";Saulytė;3790508177;Taip;0;4;0;4
18882;"Vilniaus Pranciškaus Skorinos gimnazija";Saulytė;27125411489;Taip;1;0;1;2
18883;"Vilniaus Pranciškaus Skorinos gimnazija";Saulytė;72738955088;Taip;3;7;0;10
18884;"Vilniaus Pranciškaus Skorinos gimnazija";Saulytė;67729297941;Ne;0;9;0;9
18885;"Vilniaus Pranciškaus Skorinos gimnazija";Saulytė;2386940016;Taip;0;0;6;6
18886;"Vilniaus Pranciškaus Skorinos gimnazija";Saulytė;1483885253;Taip;3;0;1;4
18887;"Vilniaus Pranciškaus Skorinos gimnazija";Saulytė;4909904794;Taip;2;0;4;6
18888;"Vilniaus Pranciškaus Skorinos gimnazija";Saulytė;4666237893;Taip;0;4;0;4
18889;"Vilniaus Pranciškaus Skorinos gimnazija";Saulytė;87925810917;Taip;12;1;1;14
18890;"Vilniaus Pranciškaus Skorinos gimnazija";Saulytė;9701472893;Taip;0;12;0;12
18891;"Vilniaus Pranciškaus Skorinos gimnazija";Saulytė;31343765777;Taip;3;2;0;5
18892;"Vilniaus Pranciškaus Skorinos gimnazija";Saulytė;55421475688;Taip;1;0;2;3
18893;"Vilniaus Pranciškaus Skorinos gimnazija";Saulytė;55086628871;Taip;0;0;4;4
18894;"Vilniaus Simono Konarskio vidurinės mokykla";"1 gr.";9759567795;Taip;7;0;0;7
18895;"Vilniaus Simono Konarskio vidurinės mokykla";"1 gr.";3165852410;Ne;4;0;0;4
18896;"Vilniaus Simono Konarskio vidurinės mokykla";"1 gr.";9585599736;Taip;4;0;0;4
18897;"Vilniaus Simono Konarskio vidurinės mokykla";"1 gr.";38075556139;Taip;2;0;0;2
18898;"Vilniaus Simono Konarskio vidurinės mokykla";"1 gr.";90764462777;Taip;4;0;0;4
18899;"Vilniaus Simono Konarskio vidurinės mokykla";"1 gr.";78809378214;Taip;12;0;0;12
18900;"Vilniaus Simono Konarskio vidurinės mokykla";"1 gr.";5553972538;Taip;9;0;0;9
18901;"Vilniaus Simono Konarskio vidurinės mokykla";"1 gr.";7881088760;Taip;6;0;0;6
18902;"Vilniaus Trakų Vokės gimnazija";Priešmokyklinė;86951309976;Taip;0;1;1;2
18903;"Vilniaus Trakų Vokės gimnazija";Priešmokyklinė;68332465021;Taip;0;0;3;3
18904;"Vilniaus Trakų Vokės gimnazija";Priešmokyklinė;89375639444;Taip;0;0;1;1
18905;"Vilniaus Trakų Vokės gimnazija";Priešmokyklinė;49306819367;Taip;0;1;1;2
18906;"Vilniaus Trakų Vokės gimnazija";Priešmokyklinė;86317439855;Taip;0;0;2;2
18907;"Vilniaus Trakų Vokės gimnazija";Priešmokyklinė;5104422489;Taip;0;0;10;10
18908;"Vilniaus Trakų Vokės gimnazija";Priešmokyklinė;63420742280;Taip;0;11;0;11
18909;"Vilniaus Trakų Vokės gimnazija";Priešmokyklinė;3795096854;Taip;0;0;2;2
18910;"Vilniaus Trakų Vokės gimnazija";Priešmokyklinė;55269223931;Taip;8;1;7;16
18911;"Vilniaus Trakų Vokės gimnazija";Priešmokyklinė;30728775392;Taip;0;0;2;2
18912;"Vilniaus Trakų Vokės gimnazija";Priešmokyklinė;93253698828;Taip;0;6;0;6
18913;"Vilniaus Trakų Vokės gimnazija";Priešmokyklinė;13225336236;Ne;0;0;2;2
18914;"Vilniaus Trakų Vokės gimnazija";Priešmokyklinė;28771899278;Taip;5;3;3;11
18915;"Vilniaus Trakų Vokės gimnazija";Priešmokyklinė;98169988178;Taip;10;0;0;10
18916;"Vilniaus Trakų Vokės gimnazija";Priešmokyklinė;6066619225;Ne;0;1;2;3
18917;"Vilniaus Trakų Vokės gimnazija";Priešmokyklinė;45478578368;Taip;4;3;9;16
18918;"Vilniaus Trakų Vokės gimnazija";Priešmokyklinė;1591065244;Ne;8;0;9;17
18919;"Vilniaus Trakų Vokės gimnazija";Priešmokyklinė;50146560386;Taip;0;1;4;5
18920;"Vilniaus Trakų Vokės gimnazija";Priešmokyklinė;1442702945;Ne;0;7;6;13
18921;"Vilniaus Trakų Vokės gimnazija";Priešmokyklinė;53040741124;Ne;3;0;1;4
18922;"Vilniaus Trakų Vokės gimnazija";Priešmokyklinė;2981889811;Taip;0;9;3;12
18923;"Vilniaus Trakų Vokės gimnazija";Priešmokyklinė;3385439676;Ne;0;7;2;9
18924;"Vilniaus Trakų Vokės gimnazija";Priešmokyklinė;1007914987;Taip;0;0;5;5
18925;"Vilniaus Salininkų gimnazija";"Priešmokyklinė A";1394788152;Taip;0;1;0;1
18926;"Vilniaus Salininkų gimnazija";"Priešmokyklinė A";77895776678;Taip;0;1;0;1
18927;"Vilniaus Salininkų gimnazija";"Priešmokyklinė A";92807961547;Taip;0;4;0;4
18928;"Vilniaus Salininkų gimnazija";"Priešmokyklinė A";50041849206;Taip;0;0;1;1
18929;"Vilniaus Salininkų gimnazija";"Priešmokyklinė A";1540549473;Taip;0;0;2;2
18930;"Vilniaus Salininkų gimnazija";"Priešmokyklinė A";12284569395;Taip;0;0;3;3
18931;"Vilniaus Salininkų gimnazija";"Priešmokyklinė A";67687224119;Taip;0;1;0;1
18932;"Vilniaus Salininkų gimnazija";"Priešmokyklinė A";49134796971;Ne;5;1;2;8
18933;"Vilniaus Salininkų gimnazija";"Priešmokyklinė A";85552015560;Taip;0;3;0;3
18934;"Vilniaus Salininkų gimnazija";"Priešmokyklinė A";18610156473;Taip;10;2;0;12
18935;"Vilniaus Salininkų gimnazija";"Priešmokyklinė A";20709806421;Taip;0;0;3;3
18936;"Vilniaus Salininkų gimnazija";"Priešmokyklinė A";34881195086;Taip;0;0;22;22
18937;"Vilniaus Spindulio pagrindinė mokykla";PM3;22030335700;Taip;0;3;0;3
18938;"Vilniaus Spindulio pagrindinė mokykla";PM3;8795608401;Taip;0;5;0;5
18939;"Vilniaus Spindulio pagrindinė mokykla";PM3;2103735244;Ne;0;5;0;5
18940;"Vilniaus Spindulio pagrindinė mokykla";PM3;41136453710;Taip;0;22;0;22
18941;"Vilniaus Spindulio pagrindinė mokykla";PM3;70574764659;Ne;0;3;0;3
18942;"Vilniaus Spindulio pagrindinė mokykla";PM3;17630756294;Taip;0;5;0;5
18943;"Vilniaus Spindulio pagrindinė mokykla";PM3;54486099400;Ne;0;5;0;5
18944;"Vilniaus Spindulio pagrindinė mokykla";PM3;7514187959;Taip;0;22;0;22
18945;"Vilniaus Spindulio pagrindinė mokykla";PM3;5781921709;Taip;0;22;0;22
18946;"Vilniaus Spindulio pagrindinė mokykla";PM3;99658181383;Taip;0;22;0;22
18947;"Vilniaus Spindulio pagrindinė mokykla";PM3;1284623590;Taip;15;0;0;15
18948;"Vilniaus Spindulio pagrindinė mokykla";PM3;17822017066;Taip;0;3;0;3
18949;"Vilniaus Spindulio pagrindinė mokykla";PM3;33144992509;Taip;0;3;0;3
18950;"Vilniaus Spindulio pagrindinė mokykla";PM3;2917212490;Taip;5;0;0;5
18951;"Vilniaus Spindulio pagrindinė mokykla";PM3;88363839374;Taip;0;22;0;22
18952;"Vilniaus Spindulio pagrindinė mokykla";PM3;1894317616;Taip;5;0;0;5
18953;"Vilniaus Spindulio pagrindinė mokykla";PM3;8898033177;Taip;0;5;0;5
18954;"Vilniaus Spindulio pagrindinė mokykla";PM2;27440263748;Taip;0;1;0;1
18955;"Vilniaus Spindulio pagrindinė mokykla";PM2;51690968594;Taip;0;5;0;5
18956;"Vilniaus Spindulio pagrindinė mokykla";PM2;43845081378;Taip;0;0;7;7
18957;"Vilniaus Spindulio pagrindinė mokykla";PM2;27893322293;Taip;0;5;2;7
18958;"Vilniaus Spindulio pagrindinė mokykla";PM2;5161772691;Taip;0;6;0;6
18959;"Vilniaus Spindulio pagrindinė mokykla";PM2;48405198914;Ne;0;5;7;12
18960;"Vilniaus Spindulio pagrindinė mokykla";PM2;18833749556;Ne;7;5;0;12
18961;"Vilniaus Spindulio pagrindinė mokykla";PM2;1848422504;Taip;0;9;6;15
18962;"Vilniaus Spindulio pagrindinė mokykla";PM2;79405143301;Taip;0;8;0;8
18963;"Vilniaus Spindulio pagrindinė mokykla";PM2;52558402241;Ne;0;0;1;1
18964;"Vilniaus Spindulio pagrindinė mokykla";PM2;19400591566;Ne;0;1;2;3
18965;"Vilniaus Spindulio pagrindinė mokykla";PM2;1681147196;Taip;0;7;0;7
18966;"Vilniaus Spindulio pagrindinė mokykla";PM2;3743948734;Taip;0;9;7;16
18967;"Vilniaus Spindulio pagrindinė mokykla";PM2;522862985;Taip;5;4;0;9
18968;"Vilniaus Spindulio pagrindinė mokykla";PM2;1973616698;Taip;0;3;6;9
18969;"Vilniaus Spindulio pagrindinė mokykla";PM2;98043756261;Taip;0;4;0;4
18970;"Vilniaus Spindulio pagrindinė mokykla";PM2;22505400502;Taip;0;5;6;11
18971;"Vilniaus Spindulio pagrindinė mokykla";PM2;73482318690;Taip;0;5;0;5
18972;"Vilniaus Spindulio pagrindinė mokykla";PM2;87635746750;Taip;0;5;0;5
18973;"Vilniaus Spindulio pagrindinė mokykla";PM2;67686277420;Taip;0;5;0;5
18974;"Vilniaus Spindulio pagrindinė mokykla";PM1;98100269824;Taip;0;6;0;6
18975;"Vilniaus Spindulio pagrindinė mokykla";PM1;58307494214;Taip;3;3;0;6
18976;"Vilniaus Spindulio pagrindinė mokykla";PM1;41169357305;Taip;0;5;0;5
18977;"Vilniaus Spindulio pagrindinė mokykla";PM1;57584604376;Taip;0;6;0;6
18978;"Vilniaus Spindulio pagrindinė mokykla";PM1;58599577293;Taip;0;13;0;13
18979;"Vilniaus Spindulio pagrindinė mokykla";PM1;11041001881;Taip;16;0;0;16
18980;"Vilniaus Spindulio pagrindinė mokykla";PM1;50503204807;Ne;0;1;0;1
18981;"Vilniaus Spindulio pagrindinė mokykla";PM1;87462575095;Ne;0;10;0;10
18982;"Vilniaus Spindulio pagrindinė mokykla";PM1;84379794486;Taip;0;12;0;12
18983;"Vilniaus Spindulio pagrindinė mokykla";PM1;75007072429;Ne;0;1;0;1
18984;"Vilniaus Spindulio pagrindinė mokykla";PM1;58418836409;Taip;4;0;0;4
18985;"Vilniaus Spindulio pagrindinė mokykla";PM1;96702943483;Taip;0;9;0;9
18986;"Vilniaus Spindulio pagrindinė mokykla";PM1;1365783673;Taip;0;8;0;8
18987;"Vilniaus Spindulio pagrindinė mokykla";PM1;4290344470;Taip;7;0;0;7
18988;"Vilniaus Spindulio pagrindinė mokykla";PM1;35360386686;Taip;3;0;0;3
18989;"Vilniaus Spindulio pagrindinė mokykla";PM1;22999687853;Taip;0;1;0;1
18990;"Vilniaus Spindulio pagrindinė mokykla";PM1;66762368813;Taip;0;3;0;3
18991;"Vilniaus Spindulio pagrindinė mokykla";PM1;64966809812;Taip;0;1;0;1
18992;"Vilniaus Vladislavo Sirokomlės vidurinė mokykla";Nykštukai;5907733019;Ne;0;1;6;7
18993;"Vilniaus Vladislavo Sirokomlės vidurinė mokykla";Nykštukai;55996765657;Taip;0;1;0;1
18994;"Vilniaus Vladislavo Sirokomlės vidurinė mokykla";Nykštukai;29678276716;Taip;0;1;2;3
18995;"Vilniaus Vladislavo Sirokomlės vidurinė mokykla";Nykštukai;33995576904;Taip;0;1;0;1
18996;"Vilniaus Vladislavo Sirokomlės vidurinė mokykla";Nykštukai;1147411049;Taip;5;1;0;6
18997;"Vilniaus Vladislavo Sirokomlės vidurinė mokykla";Nykštukai;24628844486;Taip;0;22;0;22
18998;"Vilniaus Vladislavo Sirokomlės vidurinė mokykla";Nykštukai;67322017045;Taip;0;1;0;1
18999;"Vilniaus Vladislavo Sirokomlės vidurinė mokykla";Nykštukai;1288513624;Taip;5;1;0;6
19000;"Vilniaus Vladislavo Sirokomlės vidurinė mokykla";Nykštukai;75293895773;Taip;3;1;0;4
19001;"Vilniaus Vladislavo Sirokomlės vidurinė mokykla";Nykštukai;19225308100;Taip;0;22;0;22
19002;"Vilniaus Vladislavo Sirokomlės vidurinė mokykla";Nykštukai;54815489159;Taip;0;1;0;1
19003;"Vilniaus Vladislavo Sirokomlės vidurinė mokykla";Nykštukai;78888983611;Taip;6;1;3;10
19004;"Vilniaus Vladislavo Sirokomlės vidurinė mokykla";Nykštukai;95872052773;Ne;0;1;1;2
19005;"Vilniaus Vladislavo Sirokomlės vidurinė mokykla";Nykštukai;9991093616;Ne;0;1;2;3
19006;"Vilniaus Vladislavo Sirokomlės vidurinė mokykla";Nykštukai;86336781386;Taip;0;22;0;22
19007;"Vilniaus Vladislavo Sirokomlės vidurinė mokykla";Smurfai;2896777542;Taip;0;22;0;22
19008;"Vilniaus Vladislavo Sirokomlės vidurinė mokykla";Smurfai;1649779105;Taip;0;7;0;7
19009;"Vilniaus Vladislavo Sirokomlės vidurinė mokykla";Smurfai;23540725045;Taip;0;10;0;10
19010;"Vilniaus Vladislavo Sirokomlės vidurinė mokykla";Smurfai;94242891208;Taip;0;22;0;22
19011;"Vilniaus Vladislavo Sirokomlės vidurinė mokykla";Smurfai;42097592326;Ne;0;7;0;7
19012;"Vilniaus Vladislavo Sirokomlės vidurinė mokykla";Smurfai;5042045981;Taip;0;1;1;2
19013;"Vilniaus Vladislavo Sirokomlės vidurinė mokykla";Smurfai;9509140514;Ne;0;9;0;9
19014;"Vilniaus Vladislavo Sirokomlės vidurinė mokykla";Smurfai;86662025175;Taip;0;1;0;1
19015;"Vilniaus Vladislavo Sirokomlės vidurinė mokykla";Smurfai;4227711744;Taip;0;22;0;22
19016;"Vilniaus Vladislavo Sirokomlės vidurinė mokykla";Smurfai;1464969756;Taip;0;1;1;2
19017;"Vilniaus Vladislavo Sirokomlės vidurinė mokykla";Smurfai;1087544768;Taip;0;22;0;22
19018;"Vilniaus Vladislavo Sirokomlės vidurinė mokykla";Smurfai;2272950944;Ne;0;9;0;9
19019;"Vilniaus Vladislavo Sirokomlės vidurinė mokykla";Smurfai;1804439867;Ne;0;1;0;1
19020;"Vilniaus Vladislavo Sirokomlės vidurinė mokykla";Smurfai;4742282433;Taip;8;1;1;10
19021;"Vilniaus „Pelėdos” pradinė mokykla";Bitutės;2071487643;Taip;4;2;0;6
19022;"Vilniaus „Pelėdos” pradinė mokykla";Bitutės;6832201394;Taip;8;0;0;8
19023;"Vilniaus „Pelėdos” pradinė mokykla";Bitutės;6652853494;Ne;0;1;0;1
19024;"Vilniaus „Pelėdos” pradinė mokykla";Bitutės;22352755573;Taip;0;1;2;3
19025;"Vilniaus „Pelėdos” pradinė mokykla";Bitutės;41693125052;Taip;0;3;0;3
19026;"Vilniaus „Pelėdos” pradinė mokykla";Bitutės;95143505795;Taip;0;1;1;2
19027;"Vilniaus „Pelėdos” pradinė mokykla";Bitutės;35501298377;Taip;0;4;0;4
19028;"Vilniaus „Pelėdos” pradinė mokykla";Bitutės;96374638070;Taip;0;1;0;1
19029;"Vilniaus „Pelėdos” pradinė mokykla";Bitutės;33465555087;Ne;0;1;0;1
19030;"Vilniaus „Pelėdos” pradinė mokykla";Bitutės;42360927832;Taip;0;13;0;13
19031;"Vilniaus „Pelėdos” pradinė mokykla";Bitutės;6900693954;Taip;2;4;0;6
19032;"Vilniaus „Pelėdos” pradinė mokykla";Bitutės;42778766894;Taip;0;1;1;2
19033;"Vilniaus „Pelėdos” pradinė mokykla";Bitutės;1269674740;Taip;0;1;2;3
19034;"Vilniaus „Pelėdos” pradinė mokykla";Bitutės;54002272670;Taip;0;13;0;13
19035;"Vilniaus „Pelėdos” pradinė mokykla";Bitutės;45993070238;Taip;0;9;0;9
19036;"Vilniaus „Pelėdos” pradinė mokykla";Bitutės;9108397707;Taip;0;1;3;4
19037;"Vilniaus „Pelėdos” pradinė mokykla";Bitutės;59056959064;Taip;0;1;4;5
19038;"Vilniaus „Pelėdos” pradinė mokykla";Bitutės;96481283521;Taip;5;6;0;11
19039;"Vilniaus „Pelėdos” pradinė mokykla";Boružėlės;30916402061;Taip;0;3;0;3
19040;"Vilniaus „Pelėdos” pradinė mokykla";Boružėlės;53188954130;Taip;0;0;1;1
19041;"Vilniaus „Pelėdos” pradinė mokykla";Boružėlės;22444416208;Taip;2;0;0;2
19042;"Vilniaus „Pelėdos” pradinė mokykla";Boružėlės;12734259561;Taip;1;0;3;4
19043;"Vilniaus „Pelėdos” pradinė mokykla";Boružėlės;79520961509;Taip;0;1;0;1
19044;"Vilniaus „Pelėdos” pradinė mokykla";Boružėlės;7162837286;Taip;0;10;6;16
19045;"Vilniaus „Pelėdos” pradinė mokykla";Boružėlės;46876861220;Taip;0;0;1;1
19046;"Vilniaus „Pelėdos” pradinė mokykla";Boružėlės;71191048199;Taip;0;5;0;5
19047;"Vilniaus „Pelėdos” pradinė mokykla";Boružėlės;78123951465;Taip;0;13;0;13
19048;"Vilniaus „Pelėdos” pradinė mokykla";Boružėlės;4532680677;Taip;0;0;2;2
19049;"Vilniaus „Pelėdos” pradinė mokykla";Boružėlės;89825498541;Taip;0;4;0;4
19050;"Vilniaus „Pelėdos” pradinė mokykla";Boružėlės;91937671865;Taip;0;0;4;4
19051;"Vilniaus „Pelėdos” pradinė mokykla";Boružėlės;10329586004;Taip;2;0;1;3
19052;"Vilniaus Joachimo Lelevelio vidurinė mokykla";0A;30530145422;Taip;5;0;2;7
19053;"Vilniaus Joachimo Lelevelio vidurinė mokykla";0A;22182253769;Taip;4;8;0;12
19054;"Vilniaus Joachimo Lelevelio vidurinė mokykla";0A;79489468964;Ne;0;7;0;7
19055;"Vilniaus Joachimo Lelevelio vidurinė mokykla";0A;1139560173;Taip;2;0;2;4
19056;"Vilniaus Joachimo Lelevelio vidurinė mokykla";0A;29594212376;Taip;0;0;3;3
19057;"Vilniaus Joachimo Lelevelio vidurinė mokykla";0A;37558958175;Taip;0;0;6;6
19058;"Vilniaus Joachimo Lelevelio vidurinė mokykla";0A;37117140680;Taip;0;5;0;5
19059;"Vilniaus Joachimo Lelevelio vidurinė mokykla";0A;1387685923;Ne;8;3;1;12
19060;"Vilniaus Joachimo Lelevelio vidurinė mokykla";0A;2854451964;Taip;0;5;0;5
19061;"Vilniaus Joachimo Lelevelio vidurinė mokykla";0A;6690564929;Taip;0;0;3;3
19062;"Vilniaus Joachimo Lelevelio vidurinė mokykla";0A;87447355522;Taip;5;4;0;9
19063;"Vilniaus Joachimo Lelevelio vidurinė mokykla";0A;9406527428;Ne;0;0;6;6
19064;"Vilniaus Joachimo Lelevelio vidurinė mokykla";0A;82446674090;Taip;0;0;3;3
19065;"Vilniaus Joachimo Lelevelio vidurinė mokykla";0A;6764953389;Taip;0;0;2;2
19066;"Vilniaus Joachimo Lelevelio vidurinė mokykla";0A;6406533101;Taip;1;6;0;7
19067;"Vilniaus Joachimo Lelevelio vidurinė mokykla";0B;38745665842;Taip;0;1;0;1
19068;"Vilniaus Joachimo Lelevelio vidurinė mokykla";0B;8972073812;Ne;0;0;5;5
19069;"Vilniaus Joachimo Lelevelio vidurinė mokykla";0B;23254881487;Taip;7;0;2;9
19070;"Vilniaus Joachimo Lelevelio vidurinė mokykla";0B;67336376881;Taip;0;5;0;5
19071;"Vilniaus Joachimo Lelevelio vidurinė mokykla";0B;9032277414;Taip;0;0;5;5
19072;"Vilniaus Joachimo Lelevelio vidurinė mokykla";0B;3392530766;Taip;0;7;0;7
19073;"Vilniaus Joachimo Lelevelio vidurinė mokykla";0B;52675265822;Taip;5;0;3;8
19074;"Vilniaus Joachimo Lelevelio vidurinė mokykla";0B;80290130560;Taip;0;2;0;2
19075;"Vilniaus Joachimo Lelevelio vidurinė mokykla";0B;37365823648;Ne;5;5;0;10
19076;"Vilniaus Joachimo Lelevelio vidurinė mokykla";0B;20323559123;Ne;0;0;6;6
19077;"Vilniaus Joachimo Lelevelio vidurinė mokykla";0B;1992741773;Taip;0;9;0;9
19078;"Vilniaus Joachimo Lelevelio vidurinė mokykla";0B;94980538706;Taip;5;3;0;8
19079;"Vilniaus Joachimo Lelevelio vidurinė mokykla";0B;9917295097;Taip;3;11;0;14
19080;"Vilniaus Joachimo Lelevelio vidurinė mokykla";0B;3385391317;Taip;0;22;0;22
19081;"Vilniaus Joachimo Lelevelio vidurinė mokykla";0B;6777530638;Ne;0;0;3;3
19082;"Vilniaus Joachimo Lelevelio vidurinė mokykla";0B;3507030971;Taip;7;0;11;18
19083;"Vilniaus Joachimo Lelevelio vidurinė mokykla";0B;8900287515;Taip;0;0;7;7
19084;"Vilniaus Joachimo Lelevelio vidurinė mokykla";0B;78820258664;Taip;0;4;0;4
19085;"Vilniaus Joachimo Lelevelio vidurinė mokykla";0B;32468645385;Taip;0;22;0;22
19086;"Vilniaus Joachimo Lelevelio vidurinė mokykla";0B;46936589086;Taip;0;0;7;7
19087;"Vilniaus Joachimo Lelevelio vidurinė mokykla";0C;7785594191;Taip;0;1;0;1
19088;"Vilniaus Joachimo Lelevelio vidurinė mokykla";0C;64132212674;Taip;8;0;0;8
19089;"Vilniaus Joachimo Lelevelio vidurinė mokykla";0C;77834846979;Taip;0;24;0;24
19090;"Vilniaus Joachimo Lelevelio vidurinė mokykla";0C;10836076854;Taip;5;2;0;7
19091;"Vilniaus Joachimo Lelevelio vidurinė mokykla";0C;4064562873;Taip;10;0;1;11
19092;"Vilniaus Joachimo Lelevelio vidurinė mokykla";0C;7474239709;Taip;0;24;0;24
19093;"Vilniaus Juzefo Ignacijaus Kraševskio gimnazija";Priešmokyklinė;3992602769;Ne;7;5;0;12
19094;"Vilniaus Juzefo Ignacijaus Kraševskio gimnazija";Priešmokyklinė;1636593104;Taip;0;0;2;2
19095;"Vilniaus Juzefo Ignacijaus Kraševskio gimnazija";Priešmokyklinė;96528175390;Ne;4;0;0;4
19096;"Vilniaus Juzefo Ignacijaus Kraševskio gimnazija";Priešmokyklinė;2386972224;Taip;0;5;1;6
19097;"Vilniaus Juzefo Ignacijaus Kraševskio gimnazija";Priešmokyklinė;87397764928;Taip;0;1;0;1
19098;"Vilniaus Juzefo Ignacijaus Kraševskio gimnazija";Priešmokyklinė;7947779677;Taip;0;0;8;8
19099;"Vilniaus Juzefo Ignacijaus Kraševskio gimnazija";Priešmokyklinė;7348967815;Ne;0;0;10;10
19100;"Vilniaus Juzefo Ignacijaus Kraševskio gimnazija";Priešmokyklinė;91109920216;Ne;0;0;7;7
19101;"Vilniaus Juzefo Ignacijaus Kraševskio gimnazija";Priešmokyklinė;18683776970;Taip;0;6;0;6
19102;"Vilniaus Juzefo Ignacijaus Kraševskio gimnazija";Priešmokyklinė;45246620717;Taip;0;8;0;8
19103;"Vilniaus Juzefo Ignacijaus Kraševskio gimnazija";Priešmokyklinė;3286294868;Ne;0;0;9;9
19104;"Vilniaus Juzefo Ignacijaus Kraševskio gimnazija";Priešmokyklinė;3025885967;Ne;10;5;0;15
19105;"Vilniaus Juzefo Ignacijaus Kraševskio gimnazija";Priešmokyklinė;13035175969;Taip;0;6;6;12
19106;"Vilniaus Juzefo Ignacijaus Kraševskio gimnazija";Priešmokyklinė;1744052084;Ne;5;0;5;10
19107;"Vilniaus Juzefo Ignacijaus Kraševskio gimnazija";Priešmokyklinė;3454973035;Taip;0;9;0;9
19108;"Vilniaus Juzefo Ignacijaus Kraševskio gimnazija";Priešmokyklinė;9640287886;Ne;18;0;3;21
19109;"Vilniaus Juzefo Ignacijaus Kraševskio gimnazija";Priešmokyklinė;17989172493;Ne;0;10;0;10
19110;"Vilniaus Juzefo Ignacijaus Kraševskio gimnazija";Priešmokyklinė;7866325130;Taip;13;2;2;17
19111;"Vilniaus Jono Pauliaus II progimnazija";Bitutės;2221329657;Taip;0;4;0;4
19112;"Vilniaus Jono Pauliaus II progimnazija";Bitutės;1787688071;Taip;0;2;1;3
19113;"Vilniaus Jono Pauliaus II progimnazija";Bitutės;74095271790;Taip;4;2;4;10
19114;"Vilniaus Jono Pauliaus II progimnazija";Bitutės;75018613955;Taip;0;2;0;2
19115;"Vilniaus Jono Pauliaus II progimnazija";Bitutės;41958962804;Taip;0;4;0;4
19116;"Vilniaus Jono Pauliaus II progimnazija";Bitutės;5290505392;Taip;8;2;1;11
19117;"Vilniaus Jono Pauliaus II progimnazija";Bitutės;62687105812;Taip;0;11;0;11
19118;"Vilniaus Jono Pauliaus II progimnazija";Bitutės;50802361323;Ne;0;3;0;3
19119;"Vilniaus Jono Pauliaus II progimnazija";Bitutės;1051397178;Taip;7;2;0;9
19120;"Vilniaus Jono Pauliaus II progimnazija";Bitutės;18366436287;Taip;0;5;0;5
19121;"Vilniaus Jono Pauliaus II progimnazija";Bitutės;98525894524;Ne;0;9;0;9
19122;"Vilniaus Jono Pauliaus II progimnazija";Bitutės;66886951759;Taip;0;3;0;3
19123;"Vilniaus Jono Pauliaus II progimnazija";Bitutės;1678282458;Taip;0;3;0;3
19124;"Vilniaus Jono Pauliaus II progimnazija";Bitutės;23410902042;Taip;0;5;0;5
19125;"Vilniaus Jono Pauliaus II progimnazija";Bitutės;38208558755;Taip;0;5;0;5
19126;"Vilniaus Jono Pauliaus II progimnazija";Bitutės;1498711260;Taip;7;5;0;12
19127;"Vilniaus Jono Pauliaus II progimnazija";Bitutės;94323422162;Taip;0;2;8;10
19128;"Vilniaus Jono Pauliaus II progimnazija";Bitutės;6373945450;Taip;0;9;0;9
19129;"Vilniaus Jono Pauliaus II progimnazija";Bitutės;1834961037;Ne;8;2;1;11
19130;"Vilniaus Jono Pauliaus II progimnazija";Bitutės;7289945805;Ne;10;4;0;14
19131;"Vilniaus Jono Pauliaus II progimnazija";Bitutės;52202199212;Taip;0;2;0;2
19132;"Vilniaus Jono Pauliaus II progimnazija";Nykštukai;56882212708;Taip;0;2;0;2
19133;"Vilniaus Jono Pauliaus II progimnazija";Nykštukai;84864692736;Taip;0;4;0;4
19134;"Vilniaus Jono Pauliaus II progimnazija";Nykštukai;19330722623;Ne;0;3;0;3
19135;"Vilniaus Jono Pauliaus II progimnazija";Nykštukai;41798150203;Taip;0;22;0;22
19136;"Vilniaus Jono Pauliaus II progimnazija";Nykštukai;1497044775;Ne;0;22;0;22
19137;"Vilniaus Jono Pauliaus II progimnazija";Nykštukai;18174475384;Taip;0;3;3;6
19138;"Vilniaus Jono Pauliaus II progimnazija";Nykštukai;29793632667;Taip;8;2;0;10
19139;"Vilniaus Jono Pauliaus II progimnazija";Nykštukai;2067239710;Taip;0;9;0;9
19140;"Vilniaus Jono Pauliaus II progimnazija";Nykštukai;95238329605;Taip;0;14;0;14
19141;"Vilniaus Jono Pauliaus II progimnazija";Nykštukai;66947843128;Taip;0;2;0;2
19142;"Vilniaus Jono Pauliaus II progimnazija";Nykštukai;96241985330;Taip;0;3;3;6
19143;"Vilniaus Jono Pauliaus II progimnazija";Nykštukai;98624493006;Taip;0;2;0;2
19144;"Vilniaus Jono Pauliaus II progimnazija";Nykštukai;1538884930;Taip;0;3;1;4
19145;"Vilniaus Jono Pauliaus II progimnazija";Nykštukai;97057444920;Taip;0;2;0;2
19146;"Vilniaus Jono Pauliaus II progimnazija";Nykštukai;58033050070;Taip;0;12;0;12
19147;"Vilniaus Jono Pauliaus II progimnazija";Nykštukai;5744439022;Taip;0;3;4;7
19148;"Vilniaus Jono Pauliaus II progimnazija";Nykštukai;30095924180;Taip;0;3;1;4
19149;"Vilniaus Jono Pauliaus II progimnazija";Nykštukai;17663780748;Ne;6;7;0;13
19150;"Vilniaus Jono Pauliaus II progimnazija";Nykštukai;33970738232;Taip;0;3;2;5
19151;"Vilniaus Jono Pauliaus II progimnazija";Nykštukai;28504232181;Taip;0;7;0;7
19152;"Vilniaus Jono Pauliaus II progimnazija";Nykštukai;65927108137;Ne;0;3;1;4
19153;"Vilniaus Jono Pauliaus II progimnazija";Nykštukai;5282646148;Ne;0;7;0;7
19154;"Vilniaus Jono Pauliaus II progimnazija";Nykštukai;29750547072;Taip;0;4;0;4
19155;"Vilniaus Jono Pauliaus II progimnazija";Nykštukai;6636967120;Ne;0;3;0;3
19156;"Vilniaus Jono Pauliaus II progimnazija";Nykštukai;76004865730;Ne;0;11;0;11
19157;"Vilniaus Jono Pauliaus II progimnazija";Nykštukai;1681910702;Taip;0;22;0;22
19158;"Vilniaus Jono Pauliaus II progimnazija";Spindulėlis;86349879099;Taip;0;7;0;7
19159;"Vilniaus Jono Pauliaus II progimnazija";Spindulėlis;71621781260;Taip;0;2;0;2
19160;"Vilniaus Jono Pauliaus II progimnazija";Spindulėlis;40232303318;Taip;0;2;1;3
19161;"Vilniaus Jono Pauliaus II progimnazija";Spindulėlis;18772270293;Taip;0;2;0;2
19162;"Vilniaus Jono Pauliaus II progimnazija";Spindulėlis;2092126666;Taip;0;2;0;2
19163;"Vilniaus Jono Pauliaus II progimnazija";Spindulėlis;18296155488;Taip;0;9;0;9
19164;"Vilniaus Jono Pauliaus II progimnazija";Spindulėlis;82826774977;Taip;0;4;0;4
19165;"Vilniaus Jono Pauliaus II progimnazija";Spindulėlis;13277721739;Taip;0;2;0;2
19166;"Vilniaus Jono Pauliaus II progimnazija";Spindulėlis;27320886907;Taip;0;2;0;2
19167;"Vilniaus Jono Pauliaus II progimnazija";Spindulėlis;90544626686;Ne;0;2;0;2
19168;"Vilniaus Jono Pauliaus II progimnazija";Spindulėlis;50461103065;Ne;0;4;0;4
19169;"Vilniaus Jono Pauliaus II progimnazija";Spindulėlis;23815562807;Taip;0;9;0;9
19170;"Vilniaus Jono Pauliaus II progimnazija";Spindulėlis;9433070239;Taip;0;2;2;4
19171;"Vilniaus Jono Pauliaus II progimnazija";Spindulėlis;14763149919;Taip;0;7;0;7
19172;"Vilniaus Jono Pauliaus II progimnazija";Spindulėlis;13620421173;Ne;0;2;0;2
19173;"Vilniaus Jono Pauliaus II progimnazija";Spindulėlis;68654751373;Taip;3;2;0;5
19174;"Vilniaus Jono Pauliaus II progimnazija";Spindulėlis;71644061437;Taip;0;2;1;3
19175;"Vilniaus Jono Pauliaus II progimnazija";Spindulėlis;9413926262;Ne;0;22;0;22
19176;"Vilniaus Jono Pauliaus II progimnazija";Spindulėlis;1881484420;Ne;0;2;1;3
19177;"Vilniaus Jono Pauliaus II progimnazija";Žiniukai;18666752189;Taip;0;2;0;2
19178;"Vilniaus Jono Pauliaus II progimnazija";Žiniukai;16243269254;Taip;0;7;0;7
19179;"Vilniaus Jono Pauliaus II progimnazija";Žiniukai;2268141397;Taip;0;4;0;4
19180;"Vilniaus Jono Pauliaus II progimnazija";Žiniukai;15095928335;Taip;0;2;0;2
19181;"Vilniaus Jono Pauliaus II progimnazija";Žiniukai;97421699352;Taip;5;2;0;7
19182;"Vilniaus Jono Pauliaus II progimnazija";Žiniukai;87167492911;Taip;4;4;0;8
19183;"Vilniaus Jono Pauliaus II progimnazija";Žiniukai;86166153049;Ne;4;8;0;12
19184;"Vilniaus Jono Pauliaus II progimnazija";Žiniukai;23756278273;Taip;0;6;0;6
19185;"Vilniaus Jono Pauliaus II progimnazija";Žiniukai;76860078254;Taip;0;2;0;2
19186;"Vilniaus Jono Pauliaus II progimnazija";Žiniukai;59698476683;Taip;4;2;1;7
19187;"Vilniaus Jono Pauliaus II progimnazija";Žiniukai;1265276800;Ne;0;2;0;2
19188;"Vilniaus Jono Pauliaus II progimnazija";Žiniukai;52145954352;Taip;0;2;2;4
19189;"Vilniaus Jono Pauliaus II progimnazija";Žiniukai;13144507021;Taip;5;2;2;9
19190;"Vilniaus Jono Pauliaus II progimnazija";Žiniukai;2145527582;Ne;0;4;0;4
19191;"Vilniaus Jono Pauliaus II progimnazija";Žiniukai;74531978509;Taip;0;4;0;4
19192;"Vilniaus Jono Pauliaus II progimnazija";Žiniukai;45823285175;Taip;7;2;0;9
19193;"Vilniaus Jono Pauliaus II progimnazija";Žiniukai;63967215708;Taip;12;2;0;14
19194;"Vilniaus Jono Pauliaus II progimnazija";Žiniukai;88089833901;Ne;0;2;0;2
19195;"Vilniaus Jono Pauliaus II progimnazija";Žiniukai;71421862891;Taip;0;2;0;2
19196;"Vilniaus Jono Pauliaus II progimnazija";Žiniukai;94546685371;Taip;3;5;0;8
19197;"Vilniaus Jono Pauliaus II progimnazija";Žiniukai;1883620780;Taip;0;2;1;3
19198;"Vilniaus Jono Pauliaus II progimnazija";Žiniukai;64083158642;Ne;11;2;1;14
19199;"Vilniaus Senamiesčio vidurinė mokykla";PG1;1059396976;Taip;0;9;0;9
19200;"Vilniaus Senamiesčio vidurinė mokykla";PG1;2094485999;Taip;2;1;0;3
19201;"Vilniaus Senamiesčio vidurinė mokykla";PG1;4793402013;Taip;0;1;1;2
19202;"Vilniaus Senamiesčio vidurinė mokykla";PG1;30428486005;Ne;0;1;1;2
19203;"Vilniaus Senamiesčio vidurinė mokykla";PG1;1369622524;Taip;0;22;0;22
19204;"Vilniaus Senamiesčio vidurinė mokykla";PG1;56224529599;Ne;2;1;0;3
19205;"Vilniaus Senamiesčio vidurinė mokykla";PG1;65977368065;Taip;0;11;0;11
19206;"Vilniaus Senamiesčio vidurinė mokykla";PG1;54923779499;Taip;0;3;0;3
19207;"Vilniaus Senamiesčio vidurinė mokykla";PG1;5575633653;Ne;10;1;1;12
19208;"Vilniaus Senamiesčio vidurinė mokykla";PG1;1813072867;Taip;0;11;0;11
19209;"Vilniaus Senamiesčio vidurinė mokykla";PG1;7764171885;Taip;0;1;0;1
19210;"Vilniaus Senamiesčio vidurinė mokykla";PG1;152363521;Taip;0;22;0;22
