Nr.;"Darželio pavadinimas";"Grupės pavadinimas";"Vaiko Identifikacinis Nr.";"Deklaruotas mieste";"Pateisintos dėl ligos";"Pateisintos dėl kitų priežasčių";"Nepateisintos dienos";"Praleistos dienos Viso"
1;Aitvaras;"VIJURKAI (ALERG.)";82386048619;Taip;0;0;14;14
2;Aitvaras;"VIJURKAI (ALERG.)";86008218554;Taip;2;1;0;3
3;Aitvaras;"VIJURKAI (ALERG.)";44900473149;Taip;0;4;0;4
4;Aitvaras;"VIJURKAI (ALERG.)";9065712699;Taip;0;3;0;3
5;Aitvaras;"VIJURKAI (ALERG.)";63345306760;Taip;2;3;0;5
6;Aitvaras;"VIJURKAI (ALERG.)";84623684490;Taip;0;5;0;5
7;Aitvaras;"VIJURKAI (ALERG.)";16402806518;Taip;9;0;1;10
8;Aitvaras;"VIJURKAI (ALERG.)";74266054705;Taip;9;0;1;10
9;Aitvaras;"VIJURKAI (ALERG.)";40455080945;Taip;0;6;0;6
10;Aitvaras;"VIJURKAI (ALERG.)";1156348512;Taip;0;2;0;2
11;Aitvaras;"VIJURKAI (ALERG.)";3724722474;Taip;6;0;0;6
12;Aitvaras;"VIJURKAI (ALERG.)";15430509460;Taip;15;0;0;15
13;Aitvaras;"VIJURKAI (ALERG.)";1795308718;Taip;19;1;0;20
14;Aitvaras;"VIJURKAI (ALERG.)";1130945040;Taip;0;0;1;1
15;Aitvaras;"VIJURKAI (ALERG.)";1652249394;Taip;4;1;0;5
16;Aitvaras;"VIJURKAI (ALERG.)";33729670803;Taip;10;0;1;11
17;Aitvaras;"SMALSUČIAI (ALERG.)";1396233353;Taip;0;9;0;9
18;Aitvaras;"SMALSUČIAI (ALERG.)";19974574043;Taip;3;0;0;3
19;Aitvaras;"SMALSUČIAI (ALERG.)";28583194438;Taip;13;1;0;14
20;Aitvaras;"SMALSUČIAI (ALERG.)";23092799474;Taip;0;4;0;4
21;Aitvaras;"SMALSUČIAI (ALERG.)";1286577536;Taip;15;0;0;15
22;Aitvaras;"SMALSUČIAI (ALERG.)";63572158244;Taip;0;7;0;7
23;Aitvaras;"SMALSUČIAI (ALERG.)";2259914595;Taip;0;9;0;9
24;Aitvaras;"SMALSUČIAI (ALERG.)";65184449922;Taip;0;0;1;1
25;Aitvaras;"SMALSUČIAI (ALERG.)";35989222658;Taip;0;2;0;2
26;Aitvaras;"SMALSUČIAI (ALERG.)";38025877986;Taip;6;1;0;7
27;Aitvaras;"SMALSUČIAI (ALERG.)";2758970705;Taip;0;0;2;2
28;Aitvaras;"SMALSUČIAI (ALERG.)";64844875547;Taip;7;3;0;10
29;Aitvaras;"SMALSUČIAI (ALERG.)";909566870;Taip;0;4;0;4
30;Aitvaras;"SMALSUČIAI (ALERG.)";40103691282;Taip;0;1;1;2
31;Aitvaras;"SMALSUČIAI (ALERG.)";91112093978;Taip;9;2;0;11
32;Aitvaras;PADAUŽIUKAI;891634233;Taip;14;3;0;17
33;Aitvaras;PADAUŽIUKAI;37239090522;Taip;11;0;0;11
34;Aitvaras;PADAUŽIUKAI;51360850840;Taip;5;1;0;6
35;Aitvaras;PADAUŽIUKAI;8487865580;Taip;20;0;0;20
36;Aitvaras;PADAUŽIUKAI;56549255312;Taip;0;1;0;1
37;Aitvaras;PADAUŽIUKAI;83870816281;Taip;0;4;0;4
38;Aitvaras;PADAUŽIUKAI;18199282002;Taip;10;0;1;11
39;Aitvaras;PADAUŽIUKAI;98187921839;Taip;5;0;0;5
40;Aitvaras;PADAUŽIUKAI;76493460153;Taip;0;5;2;7
41;Aitvaras;PADAUŽIUKAI;23252314829;Taip;0;4;0;4
42;Aitvaras;PADAUŽIUKAI;2910005555;Taip;7;0;0;7
43;Aitvaras;PADAUŽIUKAI;18037655336;Taip;0;4;1;5
44;Aitvaras;PADAUŽIUKAI;7240754055;Taip;13;0;0;13
45;Aitvaras;PADAUŽIUKAI;44035041676;Taip;0;5;0;5
46;Aitvaras;PADAUŽIUKAI;53743278288;Taip;6;0;0;6
47;Aitvaras;PADAUŽIUKAI;80728374682;Taip;0;0;1;1
48;Aitvaras;PADAUŽIUKAI;57489495125;Taip;0;1;1;2
49;Aitvaras;PADAUŽIUKAI;86739069318;Taip;0;1;0;1
50;Aitvaras;PADAUŽIUKAI;33594031405;Taip;5;1;1;7
51;Aitvaras;"AITVARIUKAI (ALERG.)";37391225613;Taip;5;5;0;10
52;Aitvaras;"AITVARIUKAI (ALERG.)";85103026654;Taip;0;1;0;1
53;Aitvaras;"AITVARIUKAI (ALERG.)";76280361479;Taip;0;7;0;7
54;Aitvaras;"AITVARIUKAI (ALERG.)";36359228257;Taip;9;5;0;14
55;Aitvaras;"AITVARIUKAI (ALERG.)";2674192321;Taip;20;0;0;20
56;Aitvaras;"AITVARIUKAI (ALERG.)";13670186807;Taip;20;0;0;20
57;Aitvaras;"AITVARIUKAI (ALERG.)";31074942686;Taip;0;9;0;9
58;Aitvaras;"AITVARIUKAI (ALERG.)";12962784212;Ne;0;6;0;6
59;Aitvaras;"AITVARIUKAI (ALERG.)";1542575012;Taip;19;0;0;19
60;Aitvaras;"AITVARIUKAI (ALERG.)";1223627682;Taip;8;0;0;8
61;Aitvaras;"AITVARIUKAI (ALERG.)";3471031093;Taip;15;0;0;15
62;Aitvaras;"AITVARIUKAI (ALERG.)";9810370596;Taip;12;0;0;12
63;Aitvaras;"AITVARIUKAI (ALERG.)";34735287315;Taip;0;5;6;11
64;Aitvaras;"AITVARIUKAI (ALERG.)";4833313373;Taip;0;1;1;2
65;Aitvaras;"AITVARIUKAI (ALERG.)";84919478493;Taip;7;0;0;7
66;Aitvaras;"AITVARIUKAI (ALERG.)";9745864667;Taip;20;0;0;20
67;Aitvaras;"AITVARIUKAI (ALERG.)";5389627560;Taip;6;0;0;6
68;Aitvaras;"AITVARIUKAI (ALERG.)";5956333024;Taip;8;7;0;15
69;Aitvaras;"AITVARIUKAI (ALERG.)";1636794584;Taip;19;0;0;19
70;Aitvaras;"AITVARIUKAI (ALERG.)";2953536545;Taip;14;0;0;14
71;Aitvaras;"AITVARIUKAI (ALERG.)";3535659630;Taip;0;0;5;5
72;Aitvaras;"AITVARIUKAI (ALERG.)";3488467265;Taip;7;0;0;7
73;Aitvaras;"AITVARIUKAI (ALERG.)";2566375128;Taip;0;1;0;1
74;Aitvaras;"AITVARIUKAI (ALERG.)";6356432078;Taip;8;0;0;8
75;Aitvaras;"SAULĖS ZUIKUČIAI  (ALERG.)";1019661577;Taip;0;1;0;1
76;Aitvaras;"SAULĖS ZUIKUČIAI  (ALERG.)";55369747065;Taip;0;0;6;6
77;Aitvaras;"SAULĖS ZUIKUČIAI  (ALERG.)";5204534227;Taip;0;0;1;1
78;Aitvaras;"SAULĖS ZUIKUČIAI  (ALERG.)";89623351867;Taip;0;0;1;1
79;Aitvaras;"SAULĖS ZUIKUČIAI  (ALERG.)";837021325;Taip;10;0;0;10
80;Aitvaras;"SAULĖS ZUIKUČIAI  (ALERG.)";1207249857;Taip;5;9;0;14
81;Aitvaras;"SAULĖS ZUIKUČIAI  (ALERG.)";30174058452;Taip;0;1;0;1
82;Aitvaras;"SAULĖS ZUIKUČIAI  (ALERG.)";24247118884;Taip;3;8;0;11
83;Aitvaras;"SAULĖS ZUIKUČIAI  (ALERG.)";1516018865;Taip;0;4;0;4
84;Aitvaras;"SAULĖS ZUIKUČIAI  (ALERG.)";1392528718;Taip;0;1;0;1
85;Aitvaras;"SAULĖS ZUIKUČIAI  (ALERG.)";1892295973;Taip;0;1;0;1
86;Aitvaras;"SAULĖS ZUIKUČIAI  (ALERG.)";1011446683;Taip;20;0;0;20
87;Aitvaras;"SAULĖS ZUIKUČIAI  (ALERG.)";2021772475;Taip;3;0;0;3
88;Aitvaras;"SAULĖS ZUIKUČIAI  (ALERG.)";1872130301;Taip;10;1;0;11
89;Aitvaras;"SAULĖS ZUIKUČIAI  (ALERG.)";6745376381;Taip;1;1;0;2
90;Aitvaras;"SAULĖS ZUIKUČIAI  (ALERG.)";3433178644;Taip;0;2;0;2
91;Aitvaras;"SAULĖS ZUIKUČIAI  (ALERG.)";69352006024;Taip;2;14;0;16
92;Aitvaras;"SAULĖS ZUIKUČIAI  (ALERG.)";2083332491;Taip;5;1;0;6
93;Aitvaras;"SAULĖS ZUIKUČIAI  (ALERG.)";61721665912;Taip;5;6;0;11
94;Aitvaras;"SAULĖS ZUIKUČIAI  (ALERG.)";6238828251;Taip;0;0;9;9
95;Aitvaras;"SAULĖS ZUIKUČIAI  (ALERG.)";99037281876;Taip;0;2;0;2
96;Aitvaras;"ŽEMYNUKAI (ALERG.)";1301667420;Taip;0;11;0;11
97;Aitvaras;"ŽEMYNUKAI (ALERG.)";47686798724;Taip;0;0;4;4
98;Aitvaras;"ŽEMYNUKAI (ALERG.)";94080483856;Taip;0;1;1;2
99;Aitvaras;"ŽEMYNUKAI (ALERG.)";1621302802;Taip;0;13;0;13
100;Aitvaras;"ŽEMYNUKAI (ALERG.)";7592535089;Taip;20;0;0;20
101;Aitvaras;"ŽEMYNUKAI (ALERG.)";5083382326;Taip;17;0;0;17
102;Aitvaras;"ŽEMYNUKAI (ALERG.)";3001619281;Taip;18;1;0;19
103;Aitvaras;"ŽEMYNUKAI (ALERG.)";4708741626;Taip;0;2;0;2
104;Aitvaras;"ŽEMYNUKAI (ALERG.)";85826303673;Taip;14;0;0;14
105;Aitvaras;"ŽEMYNUKAI (ALERG.)";44139920757;Taip;2;5;0;7
106;Aitvaras;"ŽEMYNUKAI (ALERG.)";9845539641;Taip;20;0;0;20
107;Aitvaras;"ŽEMYNUKAI (ALERG.)";1600657305;Taip;8;5;0;13
108;Aitvaras;"ŽEMYNUKAI (ALERG.)";1652681820;Taip;0;3;0;3
109;Aitvaras;"ŽEMYNUKAI (ALERG.)";6166757095;Taip;0;0;2;2
110;Aitvaras;"ŽEMYNUKAI (ALERG.)";1201862001;Taip;14;0;6;20
111;Aitvaras;"ŽEMYNUKAI (ALERG.)";5595233402;Taip;20;0;0;20
112;Aitvaras;"ŽEMYNUKAI (ALERG.)";2650483861;Taip;16;0;0;16
113;Aitvaras;"ŽEMYNUKAI (ALERG.)";5922357091;Taip;10;4;1;15
114;Aitvaras;"ŽEMYNUKAI (ALERG.)";8970519668;Taip;0;3;0;3
115;Aitvaras;"ŽEMYNUKAI (ALERG.)";84922258988;Taip;14;3;0;17
116;Aitvaras;"ŽEMYNUKAI (ALERG.)";1494094426;Taip;0;10;0;10
117;Aitvaras;"LINKSMUČIAI (ALERG.)";5238819066;Taip;0;4;0;4
118;Aitvaras;"LINKSMUČIAI (ALERG.)";7109001184;Taip;1;0;0;1
119;Aitvaras;"LINKSMUČIAI (ALERG.)";5378212904;Taip;20;0;0;20
120;Aitvaras;"LINKSMUČIAI (ALERG.)";3655710511;Taip;8;0;0;8
121;Aitvaras;"LINKSMUČIAI (ALERG.)";1091372798;Taip;14;1;0;15
122;Aitvaras;"LINKSMUČIAI (ALERG.)";6572235324;Taip;15;0;0;15
123;Aitvaras;"LINKSMUČIAI (ALERG.)";8666824607;Taip;10;1;2;13
124;Aitvaras;"LINKSMUČIAI (ALERG.)";5612991255;Taip;8;0;0;8
125;Aitvaras;"LINKSMUČIAI (ALERG.)";5330618557;Taip;20;0;0;20
126;Aitvaras;"LINKSMUČIAI (ALERG.)";5504431748;Taip;6;0;0;6
127;Aitvaras;"LINKSMUČIAI (ALERG.)";8206046301;Taip;20;0;0;20
128;Aitvaras;"LINKSMUČIAI (ALERG.)";4480921300;Taip;15;3;0;18
129;Aitvaras;"LINKSMUČIAI (ALERG.)";8178703988;Taip;16;0;0;16
130;Aitvaras;"LINKSMUČIAI (ALERG.)";1532588441;Taip;14;0;0;14
131;Aitvaras;"LINKSMUČIAI (ALERG.)";7260577885;Taip;1;1;0;2
132;Aitvaras;"LINKSMUČIAI (ALERG.)";1599183050;Taip;5;0;1;6
133;Aitvaras;"LINKSMUČIAI (ALERG.)";3944373116;Taip;14;1;0;15
134;Aitvaras;"LINKSMUČIAI (ALERG.)";1115202169;Taip;14;1;0;15
135;Aitvaras;"LINKSMUČIAI (ALERG.)";4613894944;Taip;7;0;0;7
136;Aitvaras;"LINKSMUČIAI (ALERG.)";4120515569;Taip;17;0;0;17
137;Aitvaras;NAMINUKAI;40344230133;Taip;10;0;0;10
138;Aitvaras;NAMINUKAI;1493048970;Taip;20;0;0;20
139;Aitvaras;NAMINUKAI;1306408890;Taip;4;0;0;4
140;Aitvaras;NAMINUKAI;59572108690;Taip;5;0;2;7
141;Aitvaras;NAMINUKAI;74628671065;Taip;0;4;0;4
142;Aitvaras;NAMINUKAI;70367340825;Taip;6;0;0;6
143;Aitvaras;NAMINUKAI;62126044317;Taip;0;10;0;10
144;Aitvaras;NAMINUKAI;1790437467;Taip;0;4;0;4
145;Aitvaras;NAMINUKAI;46021715174;Taip;5;0;1;6
146;Aitvaras;NAMINUKAI;85560586048;Taip;3;0;0;3
147;Aitvaras;NAMINUKAI;26906648835;Taip;9;2;0;11
148;Aitvaras;NAMINUKAI;1681260995;Taip;6;0;1;7
149;Aitvaras;NAMINUKAI;42556460388;Taip;1;5;0;6
150;Aitvaras;NAMINUKAI;54496602809;Taip;0;10;0;10
151;Aitvaras;NAMINUKAI;1487264184;Taip;8;0;0;8
152;Aitvaras;NAMINUKAI;97382092851;Taip;11;2;0;13
153;Aitvaras;NAMINUKAI;1886917840;Taip;9;2;0;11
154;Aitvaras;NAMINUKAI;6647800967;Taip;5;0;1;6
155;Aitvaras;NAMINUKAI;52679806772;Taip;16;0;0;16
156;Aitvaras;NAMINUKAI;1500548803;Taip;5;4;0;9
157;Aitvaras;NAMINUKAI;5103057090;Taip;13;0;0;13
158;Aitvaras;NAMINUKAI;3836513736;Taip;6;0;3;9
159;Aitvaras;ŠELMIAI;9332771711;Taip;15;0;0;15
160;Aitvaras;ŠELMIAI;6550426644;Taip;16;1;0;17
161;Aitvaras;ŠELMIAI;5818794912;Taip;0;0;3;3
162;Aitvaras;ŠELMIAI;58780461337;Taip;7;0;1;8
163;Aitvaras;ŠELMIAI;43711349817;Taip;9;0;0;9
164;Aitvaras;ŠELMIAI;7469656671;Taip;6;0;0;6
165;Aitvaras;ŠELMIAI;2408952971;Taip;11;0;0;11
166;Aitvaras;ŠELMIAI;2330782717;Taip;14;0;0;14
167;Aitvaras;ŠELMIAI;47875842134;Taip;0;4;0;4
168;Aitvaras;ŠELMIAI;40799643122;Taip;0;7;0;7
169;Aitvaras;ŠELMIAI;8784628567;Taip;8;0;0;8
170;Aitvaras;ŠELMIAI;2601983670;Taip;5;2;0;7
171;Aitvaras;ŠELMIAI;1387254053;Taip;0;0;1;1
172;Aitvaras;ŠELMIAI;8503279655;Taip;3;1;0;4
173;Aitvaras;ŠELMIAI;1105354193;Taip;0;10;0;10
174;Aitvaras;ŠELMIAI;2034293999;Taip;19;0;1;20
175;Aitvaras;ŠELMIAI;2804106417;Taip;14;0;0;14
176;Aitvaras;ŠELMIAI;2711888522;Taip;14;0;0;14
177;Aitvaras;ŠELMIAI;1996524718;Taip;14;0;0;14
178;Aitvaras;ŠELMIAI;4110585744;Taip;5;2;0;7
179;Aitvaras;ŠELMIAI;6010324894;Taip;12;0;1;13
180;Aitvaras;KODĖLČIUKAI;403821197;Taip;4;5;0;9
181;Aitvaras;KODĖLČIUKAI;64683090780;Taip;14;0;0;14
182;Aitvaras;KODĖLČIUKAI;87846069433;Taip;5;2;0;7
183;Aitvaras;KODĖLČIUKAI;12216502128;Taip;1;5;0;6
184;Aitvaras;KODĖLČIUKAI;46998364516;Taip;0;8;0;8
185;Aitvaras;KODĖLČIUKAI;45833790181;Taip;0;4;0;4
186;Aitvaras;KODĖLČIUKAI;89194677727;Taip;0;5;0;5
187;Aitvaras;KODĖLČIUKAI;69145890005;Taip;0;2;0;2
188;Aitvaras;KODĖLČIUKAI;24017694836;Taip;0;0;2;2
189;Aitvaras;KODĖLČIUKAI;64205113506;Taip;9;1;0;10
190;Aitvaras;KODĖLČIUKAI;54438500410;Taip;6;1;0;7
191;Aitvaras;KODĖLČIUKAI;2136550853;Taip;19;0;0;19
192;Aitvaras;KODĖLČIUKAI;75662895254;Taip;4;2;2;8
193;Aitvaras;KODĖLČIUKAI;1355296093;Taip;15;1;0;16
194;Aitvaras;KODĖLČIUKAI;1850900990;Taip;1;4;0;5
195;Aitvaras;KODĖLČIUKAI;30517554931;Taip;5;6;0;11
196;Aitvaras;KODĖLČIUKAI;2092431875;Taip;0;4;1;5
197;Aitvaras;KODĖLČIUKAI;1371102633;Taip;15;0;0;15
198;Aitvaras;KODĖLČIUKAI;1641140396;Taip;20;0;0;20
199;Aitvaras;KODĖLČIUKAI;9649742132;Taip;9;1;0;10
200;Aitvaras;KODĖLČIUKAI;1315081684;Taip;11;0;2;13
201;Aitvaras;PABIRUČIAI;1288810999;Taip;10;0;3;13
202;Aitvaras;PABIRUČIAI;3178965623;Taip;0;1;0;1
203;Aitvaras;PABIRUČIAI;8065540507;Taip;17;0;1;18
204;Aitvaras;PABIRUČIAI;6501943902;Taip;16;0;0;16
205;Aitvaras;PABIRUČIAI;3101015381;Taip;7;0;0;7
206;Aitvaras;PABIRUČIAI;4350590529;Taip;0;0;1;1
207;Aitvaras;PABIRUČIAI;7777235021;Taip;14;0;1;15
208;Aitvaras;PABIRUČIAI;5641224483;Taip;5;1;0;6
209;Aitvaras;PABIRUČIAI;1830134108;Taip;2;9;0;11
210;Aitvaras;PABIRUČIAI;8121858940;Taip;0;6;0;6
211;Aitvaras;PABIRUČIAI;2452780076;Taip;10;0;0;10
212;Aitvaras;PABIRUČIAI;5905456814;Taip;5;0;0;5
213;Aitvaras;PABIRUČIAI;1761446849;Taip;6;0;0;6
214;Aitvaras;PABIRUČIAI;6739827530;Taip;0;7;0;7
215;Aitvaras;PABIRUČIAI;2807595769;Taip;0;8;0;8
216;Aitvaras;PABIRUČIAI;1252145346;Taip;6;0;3;9
217;Aitvaras;PABIRUČIAI;7455895024;Taip;0;5;0;5
218;Aitvaras;PABIRUČIAI;8439586875;Taip;13;1;0;14
219;Aitvaras;PABIRUČIAI;8043062737;Taip;19;0;0;19
220;Aitvaras;"SVAJOKLIAI  (ALERG.)";5770779699;Taip;14;0;0;14
221;Aitvaras;"SVAJOKLIAI  (ALERG.)";2159901439;Taip;5;3;0;8
222;Aitvaras;"SVAJOKLIAI  (ALERG.)";1553462849;Taip;11;0;0;11
223;Aitvaras;"SVAJOKLIAI  (ALERG.)";8366627546;Taip;6;5;0;11
224;Aitvaras;"SVAJOKLIAI  (ALERG.)";1398792964;Taip;0;7;0;7
225;Aitvaras;"SVAJOKLIAI  (ALERG.)";1834535594;Taip;12;0;0;12
226;Aitvaras;"SVAJOKLIAI  (ALERG.)";7083046536;Taip;12;0;0;12
227;Aitvaras;"SVAJOKLIAI  (ALERG.)";3716313515;Taip;6;0;0;6
228;Aitvaras;"SVAJOKLIAI  (ALERG.)";1606267845;Taip;0;6;0;6
229;Aitvaras;"SVAJOKLIAI  (ALERG.)";5856250605;Taip;14;1;0;15
230;Aitvaras;"SVAJOKLIAI  (ALERG.)";2004112424;Taip;20;0;0;20
231;Aitvaras;"SVAJOKLIAI  (ALERG.)";6084096300;Taip;0;10;0;10
232;Aitvaras;"SVAJOKLIAI  (ALERG.)";5750154036;Taip;0;1;0;1
233;Aitvaras;"SVAJOKLIAI  (ALERG.)";6201118021;Taip;9;4;0;13
234;Aitvaras;"SVAJOKLIAI  (ALERG.)";1773366241;Taip;18;0;0;18
235;Aitvaras;"SVAJOKLIAI  (ALERG.)";1940545723;Taip;9;2;0;11
236;Aitvaras;"SVAJOKLIAI  (ALERG.)";3133031845;Taip;14;0;0;14
237;Aitvaras;"SVAJOKLIAI  (ALERG.)";1275561645;Taip;9;2;0;11
238;Aitvaras;"SVAJOKLIAI  (ALERG.)";1481849611;Taip;14;0;1;15
239;Aitvaras;"SVAJOKLIAI  (ALERG.)";1090979323;Taip;13;1;0;14
240;Aitvaras;"SVAJOKLIAI  (ALERG.)";1879540041;Taip;19;0;0;19
241;Aitvaras;"SVAJOKLIAI  (ALERG.)";1347364985;Taip;14;0;0;14
242;Aitvaras;"SVAJOKLIAI  (ALERG.)";5425259260;Taip;17;0;0;17
243;Atžalėlės;Gėlytės;28219993536;Taip;0;4;0;4
244;Atžalėlės;Gėlytės;63065430971;Taip;0;0;1;1
245;Atžalėlės;Gėlytės;42516348711;Ne;0;0;12;12
246;Atžalėlės;Gėlytės;91973899274;Taip;0;0;4;4
247;Atžalėlės;Gėlytės;67614970563;Taip;5;0;1;6
248;Atžalėlės;Gėlytės;23898319471;Ne;3;0;1;4
249;Atžalėlės;Gėlytės;92549162266;Ne;11;0;0;11
250;Atžalėlės;Gėlytės;46113919448;Taip;10;0;4;14
251;Atžalėlės;Gėlytės;28334054013;Taip;11;0;0;11
252;Atžalėlės;Gėlytės;84635439691;Taip;0;0;2;2
253;Atžalėlės;Gėlytės;20861477621;Taip;0;0;6;6
254;Atžalėlės;Gėlytės;5980426022;Ne;1;0;2;3
255;Atžalėlės;Gėlytės;6248765693;Taip;0;0;6;6
256;Atžalėlės;Gėlytės;74767205037;Taip;5;0;0;5
257;Atžalėlės;Gėlytės;45220122220;Taip;1;0;4;5
258;Atžalėlės;Gėlytės;16280202740;Taip;11;0;0;11
259;Atžalėlės;Gėlytės;67950853185;Taip;9;0;0;9
260;Atžalėlės;Gėlytės;95195013544;Taip;5;4;0;9
261;Atžalėlės;Gėlytės;2004639307;Taip;11;0;0;11
262;Atžalėlės;Gėlytės;7157406678;Taip;5;0;7;12
263;Atžalėlės;Gėlytės;98084870071;Taip;0;0;2;2
264;Atžalėlės;Drugeliai;4643154006;Taip;10;1;0;11
265;Atžalėlės;Drugeliai;6903666624;Taip;10;7;0;17
266;Atžalėlės;Drugeliai;4902947406;Taip;0;0;7;7
267;Atžalėlės;Drugeliai;6570245757;Taip;6;0;4;10
268;Atžalėlės;Drugeliai;9491132884;Taip;4;3;0;7
269;Atžalėlės;Drugeliai;6132569107;Taip;7;0;0;7
270;Atžalėlės;Drugeliai;2315790531;Taip;7;0;0;7
271;Atžalėlės;Drugeliai;6782007470;Taip;0;10;0;10
272;Atžalėlės;Drugeliai;8393217418;Taip;0;6;0;6
273;Atžalėlės;Drugeliai;1805496887;Taip;0;0;15;15
274;Atžalėlės;Drugeliai;5417971068;Taip;6;0;0;6
275;Atžalėlės;Drugeliai;9463215947;Taip;1;10;0;11
276;Atžalėlės;Drugeliai;7953922166;Taip;13;6;0;19
277;Atžalėlės;Drugeliai;1830572633;Taip;13;0;0;13
278;Atžalėlės;Drugeliai;5147078840;Taip;0;2;0;2
279;Atžalėlės;Drugeliai;9222670655;Taip;9;5;0;14
280;Atžalėlės;Drugeliai;77261118958;Taip;5;6;1;12
281;Atžalėlės;Drugeliai;1429493246;Taip;16;0;0;16
282;Atžalėlės;Drugeliai;6114426973;Taip;20;0;0;20
283;Atžalėlės;Drugeliai;1456979448;Taip;10;3;0;13
284;Atžalėlės;Drugeliai;4884599397;Taip;0;0;3;3
285;Atžalėlės;Drugeliai;8718036014;Taip;0;0;3;3
286;Atžalėlės;Drugeliai;3571134734;Taip;10;10;0;20
287;Atžalėlės;Gandriukai;28910361902;Taip;2;8;0;10
288;Atžalėlės;Gandriukai;32154742975;Taip;0;5;0;5
289;Atžalėlės;Gandriukai;93452036571;Taip;13;0;0;13
290;Atžalėlės;Gandriukai;4483002806;Taip;0;11;1;12
291;Atžalėlės;Gandriukai;16442821393;Taip;0;4;0;4
292;Atžalėlės;Gandriukai;1197205716;Taip;6;0;1;7
293;Atžalėlės;Gandriukai;70694002130;Taip;7;0;0;7
294;Atžalėlės;Gandriukai;87334806437;Taip;0;4;0;4
295;Atžalėlės;Gandriukai;1204800605;Taip;13;1;0;14
296;Atžalėlės;Gandriukai;1074259644;Taip;4;2;0;6
297;Atžalėlės;Gandriukai;66107666615;Taip;11;0;0;11
298;Atžalėlės;Gandriukai;2124150483;Taip;0;5;0;5
299;Atžalėlės;Gandriukai;63867153552;Taip;5;0;0;5
300;Atžalėlės;Gandriukai;87567915519;Taip;0;1;0;1
301;Atžalėlės;Gandriukai;82049064201;Taip;3;1;2;6
302;Atžalėlės;Gandriukai;78120202936;Taip;10;1;0;11
303;Atžalėlės;Gandriukai;1011601294;Taip;0;5;0;5
304;Atžalėlės;Gandriukai;1299048195;Taip;2;1;0;3
305;Atžalėlės;Gandriukai;80500800894;Taip;0;1;1;2
306;Atžalėlės;Gandriukai;519493490;Taip;0;7;0;7
307;Atžalėlės;Gandriukai;23453799177;Taip;0;13;0;13
308;Atžalėlės;Gandriukai;78664848612;Taip;10;0;0;10
309;Atžalėlės;Voveriukai;21599916055;Taip;0;6;0;6
310;Atžalėlės;Voveriukai;30370285022;Taip;0;3;0;3
311;Atžalėlės;Voveriukai;64596277701;Taip;10;0;0;10
312;Atžalėlės;Voveriukai;84392505831;Taip;13;3;0;16
313;Atžalėlės;Voveriukai;3379307367;Taip;0;0;3;3
314;Atžalėlės;Voveriukai;62325712598;Taip;7;0;3;10
315;Atžalėlės;Voveriukai;1312772153;Taip;0;0;2;2
316;Atžalėlės;Voveriukai;53559306492;Taip;0;4;0;4
317;Atžalėlės;Voveriukai;2488405485;Taip;0;3;0;3
318;Atžalėlės;Voveriukai;39714182342;Taip;15;1;0;16
319;Atžalėlės;Voveriukai;6975941393;Taip;0;2;0;2
320;Atžalėlės;Voveriukai;1865339755;Taip;0;0;6;6
321;Atžalėlės;Voveriukai;8138683218;Taip;9;1;0;10
322;Atžalėlės;Voveriukai;4467364336;Taip;0;2;0;2
323;Atžalėlės;Voveriukai;1804802235;Taip;5;2;0;7
324;Atžalėlės;Voveriukai;1316154666;Taip;6;0;0;6
325;Atžalėlės;Voveriukai;9699811980;Taip;6;7;0;13
326;Atžalėlės;Voveriukai;8847754477;Taip;9;3;0;12
327;Atžalėlės;Voveriukai;7689394485;Taip;14;0;0;14
328;Atžalėlės;Žirniukai;4098210138;Taip;11;0;2;13
329;Atžalėlės;Žirniukai;1500456945;Taip;0;0;7;7
330;Atžalėlės;Žirniukai;1450609695;Taip;0;6;0;6
331;Atžalėlės;Žirniukai;1844980319;Taip;8;0;1;9
332;Atžalėlės;Žirniukai;5997958773;Taip;6;0;2;8
333;Atžalėlės;Žirniukai;6177038838;Taip;8;0;0;8
334;Atžalėlės;Žirniukai;1722233272;Taip;9;5;0;14
335;Atžalėlės;Žirniukai;5310990513;Taip;0;6;0;6
336;Atžalėlės;Žirniukai;8524244526;Taip;9;0;11;20
337;Atžalėlės;Žirniukai;1704679306;Taip;7;0;5;12
338;Atžalėlės;Žirniukai;7702502252;Taip;4;12;0;16
339;Atžalėlės;Žirniukai;9189223222;Taip;10;6;0;16
340;Atžalėlės;Žirniukai;3283415814;Taip;9;1;0;10
341;Atžalėlės;Žirniukai;1146492807;Taip;3;0;3;6
342;Atžalėlės;Žirniukai;5897022357;Taip;0;0;3;3
343;Atžalėlės;Žirniukai;3870758086;Taip;11;0;2;13
344;Atžalėlės;Žirniukai;1036410428;Taip;5;0;2;7
345;Atžalėlės;Žirniukai;7356877676;Taip;0;7;0;7
346;Atžalėlės;Ežiukai;5432433423;Taip;0;6;0;6
347;Atžalėlės;Ežiukai;8819893830;Taip;0;11;1;12
348;Atžalėlės;Ežiukai;8695865604;Taip;0;18;0;18
349;Atžalėlės;Ežiukai;4682216852;Taip;0;0;5;5
350;Atžalėlės;Ežiukai;4284673729;Taip;5;0;10;15
351;Atžalėlės;Ežiukai;1431197358;Taip;5;0;0;5
352;Atžalėlės;Ežiukai;4177753994;Taip;6;0;2;8
353;Atžalėlės;Ežiukai;5742471497;Taip;19;0;0;19
354;Atžalėlės;Ežiukai;2385614957;Taip;8;0;2;10
355;Atžalėlės;Ežiukai;9715625283;Taip;5;0;15;20
356;Atžalėlės;Ežiukai;6202250600;Taip;12;0;5;17
357;Atžalėlės;Ežiukai;6024189665;Taip;9;0;4;13
358;Atžalėlės;Ežiukai;4238773173;Taip;15;0;0;15
359;Atžalėlės;Ežiukai;2131592139;Taip;9;1;0;10
360;Atžalėlės;Ežiukai;8201582382;Taip;1;6;8;15
361;Atžalėlės;Ežiukai;4362058013;Taip;1;6;8;15
362;Atžalėlės;Ežiukai;3191066669;Taip;19;0;0;19
363;Atžalėlės;Ežiukai;1137741059;Taip;5;0;0;5
364;Atžalėlės;Paukšteliai;77693032830;Ne;9;2;0;11
365;Atžalėlės;Paukšteliai;99097316080;Taip;0;0;3;3
366;Atžalėlės;Paukšteliai;1576891322;Taip;7;0;1;8
367;Atžalėlės;Paukšteliai;18833055728;Taip;0;0;2;2
368;Atžalėlės;Paukšteliai;72360139252;Taip;9;6;0;15
369;Atžalėlės;Paukšteliai;89028851257;Taip;0;0;2;2
370;Atžalėlės;Paukšteliai;54417643140;Taip;0;6;0;6
371;Atžalėlės;Paukšteliai;88525056192;Taip;0;0;4;4
372;Atžalėlės;Paukšteliai;1046971571;Taip;5;6;3;14
373;Atžalėlės;Paukšteliai;50283267330;Taip;0;4;3;7
374;Atžalėlės;Paukšteliai;90664899396;Taip;3;0;3;6
375;Atžalėlės;Paukšteliai;35472285094;Taip;0;5;0;5
376;Atžalėlės;Paukšteliai;93762990685;Taip;1;3;0;4
377;Atžalėlės;Paukšteliai;42752976301;Taip;0;5;1;6
378;Atžalėlės;Paukšteliai;27330226432;Taip;0;6;3;9
379;Atžalėlės;Paukšteliai;57459192709;Taip;5;13;0;18
380;Atžalėlės;Paukšteliai;5438129052;Taip;0;0;8;8
381;Atžalėlės;Paukšteliai;1772202805;Taip;19;0;0;19
382;Atžalėlės;Meškiukai;26878092629;Taip;0;9;0;9
383;Atžalėlės;Meškiukai;1083996834;Taip;0;14;0;14
384;Atžalėlės;Meškiukai;53385285795;Taip;15;0;2;17
385;Atžalėlės;Meškiukai;57197465236;Taip;8;0;0;8
386;Atžalėlės;Meškiukai;91094623082;Taip;2;6;0;8
387;Atžalėlės;Meškiukai;52163840804;Taip;14;0;0;14
388;Atžalėlės;Meškiukai;97667536161;Taip;4;7;0;11
389;Atžalėlės;Meškiukai;32165722689;Taip;0;0;1;1
390;Atžalėlės;Meškiukai;59994970570;Taip;14;0;2;16
391;Atžalėlės;Meškiukai;60841336326;Taip;0;0;1;1
392;Atžalėlės;Meškiukai;83433461267;Taip;0;4;0;4
393;Atžalėlės;Meškiukai;78909909613;Taip;0;1;0;1
394;Atžalėlės;Meškiukai;46263888918;Taip;0;3;0;3
395;Atžalėlės;Meškiukai;30776087985;Taip;16;0;0;16
396;Atžalėlės;Meškiukai;40388417436;Taip;1;7;0;8
397;Atžalėlės;Meškiukai;45860181171;Taip;0;10;0;10
398;Atžalėlės;Meškiukai;76280495364;Taip;5;6;0;11
399;Atžalėlės;Meškiukai;1448431632;Taip;0;8;0;8
400;Atžalėlės;Meškiukai;4702130326;Taip;3;7;0;10
401;Aušrelė;PASAKIUKAI;94997479625;Taip;0;2;0;2
402;Aušrelė;PASAKIUKAI;9759865004;Ne;13;4;1;18
403;Aušrelė;PASAKIUKAI;1552951030;Taip;0;4;1;5
404;Aušrelė;PASAKIUKAI;73000891950;Taip;0;7;0;7
405;Aušrelė;PASAKIUKAI;93192830033;Taip;1;1;0;2
406;Aušrelė;PASAKIUKAI;31870837550;Taip;3;2;2;7
407;Aušrelė;PASAKIUKAI;89564834407;Taip;1;6;1;8
408;Aušrelė;PASAKIUKAI;4475401842;Taip;10;5;0;15
409;Aušrelė;PASAKIUKAI;2771851348;Taip;0;7;0;7
410;Aušrelė;PASAKIUKAI;4988271727;Taip;0;0;5;5
411;Aušrelė;PASAKIUKAI;5713243418;Taip;0;0;1;1
412;Aušrelė;PASAKIUKAI;41231905740;Ne;0;6;0;6
413;Aušrelė;PASAKIUKAI;58007820848;Taip;0;0;2;2
414;Aušrelė;PASAKIUKAI;4631390072;Taip;0;4;0;4
415;Aušrelė;PASAKIUKAI;9221298641;Taip;2;0;0;2
416;Aušrelė;PASAKIUKAI;1496680911;Taip;10;2;0;12
417;Aušrelė;BORUŽĖLĖS;87964799762;Taip;0;12;0;12
418;Aušrelė;BORUŽĖLĖS;61325054660;Taip;0;20;0;20
419;Aušrelė;BORUŽĖLĖS;83835736230;Taip;0;8;0;8
420;Aušrelė;BORUŽĖLĖS;59306871998;Taip;5;8;0;13
421;Aušrelė;BORUŽĖLĖS;48228818029;Taip;0;20;0;20
422;Aušrelė;BORUŽĖLĖS;1392484369;Taip;11;0;1;12
423;Aušrelė;BORUŽĖLĖS;4180888362;Taip;0;9;0;9
424;Aušrelė;BORUŽĖLĖS;20968351121;Taip;0;6;0;6
425;Aušrelė;BORUŽĖLĖS;18340420698;Taip;0;5;0;5
426;Aušrelė;BORUŽĖLĖS;82713803790;Taip;0;3;0;3
427;Aušrelė;BORUŽĖLĖS;1380454183;Taip;7;0;1;8
428;Aušrelė;BORUŽĖLĖS;1155372704;Taip;0;0;3;3
429;Aušrelė;BORUŽĖLĖS;48794175299;Taip;8;0;1;9
430;Aušrelė;BORUŽĖLĖS;1578867221;Taip;0;4;2;6
431;Aušrelė;BORUŽĖLĖS;58941591666;Taip;0;4;0;4
432;Aušrelė;BORUŽĖLĖS;93138986438;Taip;0;4;0;4
433;Aušrelė;BORUŽĖLĖS;1985405666;Taip;6;0;0;6
434;Aušrelė;BORUŽĖLĖS;26547524160;Taip;0;6;0;6
435;Aušrelė;BORUŽĖLĖS;9818954496;Taip;9;0;6;15
436;Aušrelė;BORUŽĖLĖS;6109287607;Taip;5;8;0;13
437;Aušrelė;SMALSUČIAI;76459345433;Ne;0;5;1;6
438;Aušrelė;SMALSUČIAI;17931731597;Taip;0;2;0;2
439;Aušrelė;SMALSUČIAI;74365190360;Taip;0;8;0;8
440;Aušrelė;SMALSUČIAI;1951435363;Taip;0;1;0;1
441;Aušrelė;SMALSUČIAI;3392276890;Taip;5;2;3;10
442;Aušrelė;SMALSUČIAI;14080739740;Taip;4;6;0;10
443;Aušrelė;SMALSUČIAI;73050137188;Taip;0;10;0;10
444;Aušrelė;SMALSUČIAI;49563719275;Taip;18;0;0;18
445;Aušrelė;SMALSUČIAI;7859894371;Taip;0;6;0;6
446;Aušrelė;SMALSUČIAI;1883795851;Taip;5;0;0;5
447;Aušrelė;SMALSUČIAI;68223308125;Ne;0;0;4;4
448;Aušrelė;SMALSUČIAI;90185478786;Taip;0;1;0;1
449;Aušrelė;SMALSUČIAI;95035102498;Taip;0;2;3;5
450;Aušrelė;SMALSUČIAI;26235102809;Taip;5;4;0;9
451;Aušrelė;SMALSUČIAI;42158121278;Taip;5;2;2;9
452;Aušrelė;SMALSUČIAI;78823564616;Taip;0;10;0;10
453;Aušrelė;SMALSUČIAI;1944021609;Taip;5;0;0;5
454;Aušrelė;SMALSUČIAI;1322089393;Taip;3;1;0;4
455;Aušrelė;KODĖLČIUKAI;12032618723;Taip;10;1;0;11
456;Aušrelė;KODĖLČIUKAI;75580617180;Taip;0;6;0;6
457;Aušrelė;KODĖLČIUKAI;50864528673;Ne;3;1;0;4
458;Aušrelė;KODĖLČIUKAI;76302896259;Taip;0;15;0;15
459;Aušrelė;KODĖLČIUKAI;2427329184;Taip;5;5;0;10
460;Aušrelė;KODĖLČIUKAI;24201363476;Taip;9;1;0;10
461;Aušrelė;KODĖLČIUKAI;39887348225;Taip;4;4;0;8
462;Aušrelė;KODĖLČIUKAI;8837069458;Taip;0;0;3;3
463;Aušrelė;KODĖLČIUKAI;36096756485;Taip;0;11;0;11
464;Aušrelė;KODĖLČIUKAI;1058114795;Taip;10;0;0;10
465;Aušrelė;KODĖLČIUKAI;19415824416;Taip;0;1;0;1
466;Aušrelė;KODĖLČIUKAI;4476948928;Taip;0;7;0;7
467;Aušrelė;KODĖLČIUKAI;44971525276;Taip;0;12;0;12
468;Aušrelė;KODĖLČIUKAI;26185247513;Taip;0;20;0;20
469;Aušrelė;PELĖDŽIUKAI;34891640909;Taip;5;8;0;13
470;Aušrelė;PELĖDŽIUKAI;1792774415;Taip;11;5;0;16
471;Aušrelė;PELĖDŽIUKAI;5955421544;Ne;9;3;0;12
472;Aušrelė;PELĖDŽIUKAI;1706417053;Taip;5;0;1;6
473;Aušrelė;PELĖDŽIUKAI;31441512644;Taip;9;11;0;20
474;Aušrelė;PELĖDŽIUKAI;2030362509;Taip;6;9;0;15
475;Aušrelė;PELĖDŽIUKAI;1296552763;Taip;10;0;0;10
476;Aušrelė;PELĖDŽIUKAI;1160772086;Taip;10;6;0;16
477;Aušrelė;PELĖDŽIUKAI;1352195876;Taip;5;0;1;6
478;Aušrelė;PELĖDŽIUKAI;1599595256;Taip;3;1;0;4
479;Aušrelė;PELĖDŽIUKAI;2125080379;Taip;0;0;5;5
480;Aušrelė;PELĖDŽIUKAI;1539176090;Taip;20;0;0;20
481;Aušrelė;PELĖDŽIUKAI;1225272131;Taip;15;0;0;15
482;Aušrelė;PELĖDŽIUKAI;1868818387;Taip;1;0;0;1
483;Aušrelė;PELĖDŽIUKAI;2987088389;Ne;5;0;0;5
484;Aušrelė;PELĖDŽIUKAI;6909708079;Taip;6;1;1;8
485;Aušrelė;PELĖDŽIUKAI;1506444915;Taip;9;10;0;19
486;Aušrelė;PELĖDŽIUKAI;5304765447;Taip;11;2;0;13
487;Aušrelė;PELĖDŽIUKAI;85739624682;Taip;10;0;0;10
488;Aušrelė;AITVARIUKAI;49583107808;Taip;16;0;0;16
489;Aušrelė;AITVARIUKAI;2045076279;Taip;0;5;2;7
490;Aušrelė;AITVARIUKAI;1153416324;Taip;0;16;4;20
491;Aušrelė;AITVARIUKAI;1340754039;Taip;0;1;0;1
492;Aušrelė;AITVARIUKAI;42721248496;Taip;0;20;0;20
493;Aušrelė;AITVARIUKAI;79695989966;Taip;0;9;0;9
494;Aušrelė;AITVARIUKAI;1045290039;Taip;0;11;0;11
495;Aušrelė;AITVARIUKAI;1511069809;Taip;0;9;0;9
496;Aušrelė;AITVARIUKAI;51119593813;Taip;4;0;0;4
497;Aušrelė;AITVARIUKAI;5813735533;Taip;10;0;1;11
498;Aušrelė;AITVARIUKAI;18117725053;Taip;6;0;1;7
499;Aušrelė;AITVARIUKAI;1036752305;Taip;0;10;0;10
500;Aušrelė;AITVARIUKAI;27629722512;Taip;0;2;0;2
501;Aušrelė;AITVARIUKAI;1830501248;Taip;0;9;0;9
502;Aušrelė;AITVARIUKAI;65369497777;Taip;0;20;0;20
503;Aušrelė;AITVARIUKAI;1388327674;Taip;0;5;2;7
504;Aušrelė;AITVARIUKAI;1750555187;Taip;6;0;0;6
505;Aušrelė;AITVARIUKAI;8221635058;Taip;0;4;2;6
506;Aušrelė;AITVARIUKAI;1163757003;Taip;7;5;0;12
507;Aušrelė;AITVARIUKAI;4865289474;Taip;13;2;0;15
508;Aušrelė;BITUTĖS;2096291405;Taip;0;9;0;9
509;Aušrelė;BITUTĖS;6519246290;Taip;0;19;0;19
510;Aušrelė;BITUTĖS;54807413055;Taip;8;5;0;13
511;Aušrelė;BITUTĖS;7915176432;Taip;0;4;0;4
512;Aušrelė;BITUTĖS;2085252423;Taip;0;10;0;10
513;Aušrelė;BITUTĖS;1039658170;Taip;0;17;0;17
514;Aušrelė;BITUTĖS;7887450828;Taip;5;0;0;5
515;Aušrelė;BITUTĖS;1680740501;Taip;0;7;0;7
516;Aušrelė;BITUTĖS;1666951645;Taip;0;6;0;6
517;Aušrelė;BITUTĖS;1372660806;Taip;0;6;0;6
518;Aušrelė;BITUTĖS;1958425979;Taip;0;6;0;6
519;Aušrelė;BITUTĖS;59219298991;Taip;3;2;0;5
520;Aušrelė;BITUTĖS;65962324027;Taip;0;8;0;8
521;Aušrelė;BITUTĖS;1561253093;Taip;0;4;0;4
522;Aušrelė;BITUTĖS;72441793163;Taip;0;12;0;12
523;Aušrelė;ŽIRNIUKAI;6761263775;Taip;5;1;5;11
524;Aušrelė;ŽIRNIUKAI;3553233149;Taip;5;0;0;5
525;Aušrelė;ŽIRNIUKAI;2827216981;Taip;0;4;0;4
526;Aušrelė;ŽIRNIUKAI;2852596989;Taip;0;10;10;20
527;Aušrelė;ŽIRNIUKAI;7930717076;Taip;3;1;0;4
528;Aušrelė;ŽIRNIUKAI;4942168388;Taip;0;18;2;20
529;Aušrelė;ŽIRNIUKAI;6507218940;Taip;0;6;0;6
530;Aušrelė;ŽIRNIUKAI;2266390402;Taip;0;4;0;4
531;Aušrelė;ŽIRNIUKAI;2390128933;Taip;0;11;0;11
532;Aušrelė;ŽIRNIUKAI;9443641849;Taip;0;2;0;2
533;Aušrelė;ŽIRNIUKAI;1556010005;Taip;8;0;0;8
534;Aušrelė;ŽIRNIUKAI;7609339123;Taip;20;0;0;20
535;Aušrelė;ŽIRNIUKAI;7070013052;Taip;6;0;0;6
536;Aušrelė;GRYBUKAI;6002434911;Taip;0;8;0;8
537;Aušrelė;GRYBUKAI;4288695809;Taip;7;0;0;7
538;Aušrelė;GRYBUKAI;3807967685;Taip;10;0;0;10
539;Aušrelė;GRYBUKAI;7327544406;Taip;10;1;0;11
540;Aušrelė;GRYBUKAI;5046027475;Taip;0;16;0;16
541;Aušrelė;GRYBUKAI;9566144610;Taip;16;0;0;16
542;Aušrelė;GRYBUKAI;3320399046;Taip;14;0;5;19
543;Aušrelė;GRYBUKAI;7723159748;Taip;19;0;0;19
544;Aušrelė;GRYBUKAI;7367268748;Taip;15;0;0;15
545;Aušrelė;GRYBUKAI;6109859056;Taip;16;0;0;16
546;Aušrelė;GRYBUKAI;3581155949;Taip;9;4;1;14
547;Aušrelė;GRYBUKAI;2030555139;Taip;5;6;0;11
548;Aušrelė;GRYBUKAI;1976613166;Taip;10;1;0;11
549;Aušrelė;GRYBUKAI;8338569001;Taip;13;0;0;13
550;Aušrelė;GRYBUKAI;6186758486;Taip;9;1;0;10
551;Aušrelė;DRUGELIAI;1502146844;Taip;0;2;0;2
552;Aušrelė;DRUGELIAI;1408751702;Taip;0;8;0;8
553;Aušrelė;DRUGELIAI;6604681536;Taip;0;20;0;20
554;Aušrelė;DRUGELIAI;4146051969;Taip;0;20;0;20
555;Aušrelė;DRUGELIAI;5055972872;Taip;14;1;0;15
556;Aušrelė;DRUGELIAI;2974714806;Taip;0;20;0;20
557;Aušrelė;DRUGELIAI;5935579452;Taip;10;5;0;15
558;Aušrelė;DRUGELIAI;8960462835;Taip;11;1;0;12
559;Aušrelė;DRUGELIAI;7682402576;Taip;0;10;0;10
560;Aušrelė;DRUGELIAI;5478028396;Taip;20;0;0;20
561;Aušrelė;DRUGELIAI;8372554796;Taip;2;7;0;9
562;Aušrelė;DRUGELIAI;8230362307;Taip;0;7;1;8
563;Aušrelė;DRUGELIAI;2751501830;Taip;0;6;0;6
564;Aušrelė;DRUGELIAI;1327431679;Taip;0;6;0;6
565;Aušrelė;DRUGELIAI;9555255381;Ne;7;0;0;7
566;Aušrelė;DRUGELIAI;9440600785;Taip;5;5;0;10
567;Aušrelė;DRUGELIAI;6037757548;Taip;0;9;0;9
568;Aušrelė;DRUGELIAI;6995749373;Taip;0;6;0;6
569;Aušrelė;NYKŠTUKAI;7861208185;Taip;10;1;0;11
570;Aušrelė;NYKŠTUKAI;6886505025;Taip;0;6;0;6
571;Aušrelė;NYKŠTUKAI;6673034329;Taip;10;0;0;10
572;Aušrelė;NYKŠTUKAI;3206495858;Taip;10;1;0;11
573;Aušrelė;NYKŠTUKAI;8243716759;Taip;1;9;1;11
574;Aušrelė;NYKŠTUKAI;5777214701;Taip;0;7;0;7
575;Aušrelė;NYKŠTUKAI;3165692699;Taip;4;2;0;6
576;Aušrelė;NYKŠTUKAI;91282753561;Taip;0;8;0;8
577;Aušrelė;NYKŠTUKAI;4306578299;Taip;13;0;0;13
578;Aušrelė;NYKŠTUKAI;6084682084;Taip;6;0;0;6
579;Aušrelė;NYKŠTUKAI;3682523696;Taip;7;0;0;7
580;Aušrelė;NYKŠTUKAI;1928260563;Taip;10;1;0;11
581;Aušrelė;NYKŠTUKAI;4957581753;Taip;5;1;0;6
582;Aušrelė;NYKŠTUKAI;6277405405;Taip;0;13;0;13
583;Aušrelė;NYKŠTUKAI;1543314096;Taip;2;0;0;2
584;Aušrelė;NYKŠTUKAI;1549962200;Taip;5;10;0;15
585;Aušrelė;NYKŠTUKAI;2626569015;Taip;0;12;0;12
586;Aušrelė;NYKŠTUKAI;2574681867;Taip;9;2;4;15
587;Beržynėlis;SVIRPLIUKAI;29356394553;Taip;9;1;0;10
588;Beržynėlis;SVIRPLIUKAI;45685658789;Taip;5;3;0;8
589;Beržynėlis;SVIRPLIUKAI;74856278886;Taip;0;2;0;2
590;Beržynėlis;SVIRPLIUKAI;1207208151;Taip;7;0;0;7
591;Beržynėlis;SVIRPLIUKAI;6690309946;Taip;14;0;0;14
592;Beržynėlis;SVIRPLIUKAI;1895493234;Taip;7;2;0;9
593;Beržynėlis;SVIRPLIUKAI;1583090840;Taip;10;0;0;10
594;Beržynėlis;SVIRPLIUKAI;7289803632;Taip;2;2;0;4
595;Beržynėlis;SVIRPLIUKAI;1682929565;Taip;14;0;0;14
596;Beržynėlis;SVIRPLIUKAI;1612137286;Taip;6;0;0;6
597;Beržynėlis;SVIRPLIUKAI;71505149611;Taip;7;0;0;7
598;Beržynėlis;SVIRPLIUKAI;1395819329;Taip;9;0;1;10
599;Beržynėlis;SVIRPLIUKAI;7248602510;Taip;1;0;0;1
600;Beržynėlis;SVIRPLIUKAI;3641421009;Taip;20;0;0;20
601;Beržynėlis;SVIRPLIUKAI;9566341884;Taip;8;1;0;9
602;Beržynėlis;SVIRPLIUKAI;3278699117;Taip;8;7;0;15
603;Beržynėlis;SVIRPLIUKAI;1838631438;Taip;10;0;0;10
604;Beržynėlis;SVIRPLIUKAI;1639928056;Taip;12;1;0;13
605;Beržynėlis;SVIRPLIUKAI;1136091326;Taip;6;0;0;6
606;Beržynėlis;SVIRPLIUKAI;1516309509;Taip;4;2;0;6
607;Beržynėlis;SVIRPLIUKAI;6395436937;Taip;4;3;0;7
608;Beržynėlis;PELEDŽIUKAI;2121542860;Taip;0;2;6;8
609;Beržynėlis;PELEDŽIUKAI;65579212579;Taip;6;2;1;9
610;Beržynėlis;PELEDŽIUKAI;38733472229;Taip;6;2;0;8
611;Beržynėlis;PELEDŽIUKAI;83976497862;Taip;0;0;3;3
612;Beržynėlis;PELEDŽIUKAI;10345838607;Ne;0;14;0;14
613;Beržynėlis;PELEDŽIUKAI;86725749973;Taip;3;0;1;4
614;Beržynėlis;PELEDŽIUKAI;85094175778;Taip;0;2;0;2
615;Beržynėlis;PELEDŽIUKAI;90464109575;Taip;0;5;0;5
616;Beržynėlis;PELEDŽIUKAI;12603200766;Taip;0;2;0;2
617;Beržynėlis;PELEDŽIUKAI;26390520766;Ne;7;1;0;8
618;Beržynėlis;PELEDŽIUKAI;38966821601;Taip;0;9;0;9
619;Beržynėlis;PELEDŽIUKAI;98803060215;Taip;6;0;0;6
620;Beržynėlis;PELEDŽIUKAI;18199829748;Ne;9;0;0;9
621;Beržynėlis;PELEDŽIUKAI;62599537262;Taip;11;0;1;12
622;Beržynėlis;PELEDŽIUKAI;50307051477;Taip;0;0;7;7
623;Beržynėlis;PELEDŽIUKAI;45266242827;Taip;4;2;0;6
624;Beržynėlis;PELEDŽIUKAI;29838611902;Taip;10;0;0;10
625;Beržynėlis;PELEDŽIUKAI;32134295447;Taip;0;5;0;5
626;Beržynėlis;PELEDŽIUKAI;35916710802;Taip;0;8;5;13
627;Beržynėlis;ŽIOGELIAI;73555363332;Taip;0;4;0;4
628;Beržynėlis;ŽIOGELIAI;9737673167;Taip;0;0;1;1
629;Beržynėlis;ŽIOGELIAI;50686761208;Ne;8;0;1;9
630;Beržynėlis;ŽIOGELIAI;11586645391;Taip;7;0;0;7
631;Beržynėlis;ŽIOGELIAI;19892724367;Taip;10;2;0;12
632;Beržynėlis;ŽIOGELIAI;46844790286;Taip;5;8;0;13
633;Beržynėlis;ŽIOGELIAI;23484694902;Taip;0;0;1;1
634;Beržynėlis;ŽIOGELIAI;6082843533;Taip;0;5;0;5
635;Beržynėlis;ŽIOGELIAI;13290088644;Taip;0;1;0;1
636;Beržynėlis;ŽIOGELIAI;48258183822;Taip;15;2;0;17
637;Beržynėlis;ŽIOGELIAI;87966535672;Taip;0;2;0;2
638;Beržynėlis;ŽIOGELIAI;48768116923;Taip;9;0;0;9
639;Beržynėlis;ŽIOGELIAI;80418262829;Taip;5;1;0;6
640;Beržynėlis;ŽIOGELIAI;69508373227;Taip;9;6;0;15
641;Beržynėlis;ŽIOGELIAI;59717323779;Ne;0;1;0;1
642;Beržynėlis;ŽIOGELIAI;6002421623;Ne;0;15;0;15
643;Beržynėlis;ŽIOGELIAI;69893760439;Taip;6;0;0;6
644;Beržynėlis;ŽIOGELIAI;1893270997;Taip;0;2;1;3
645;Beržynėlis;ŽIOGELIAI;9035951859;Taip;2;2;1;5
646;Beržynėlis;ŽIOGELIAI;7929997884;Taip;2;2;0;4
647;Beržynėlis;ŽIOGELIAI;5114301953;Taip;10;4;0;14
648;Beržynėlis;ŽVIRBLIUKAI;7520394353;Taip;11;4;0;15
649;Beržynėlis;ŽVIRBLIUKAI;95544821432;Taip;0;6;5;11
650;Beržynėlis;ŽVIRBLIUKAI;1426962644;Taip;2;4;0;6
651;Beržynėlis;ŽVIRBLIUKAI;1527942602;Taip;0;6;3;9
652;Beržynėlis;ŽVIRBLIUKAI;1910024785;Taip;15;2;0;17
653;Beržynėlis;ŽVIRBLIUKAI;1367442186;Taip;10;0;1;11
654;Beržynėlis;ŽVIRBLIUKAI;1823144276;Taip;9;2;0;11
655;Beržynėlis;ŽVIRBLIUKAI;1464556813;Taip;0;2;0;2
656;Beržynėlis;ŽVIRBLIUKAI;1945230630;Taip;10;0;1;11
657;Beržynėlis;ŽVIRBLIUKAI;1466742506;Taip;5;0;4;9
658;Beržynėlis;ŽVIRBLIUKAI;2023412985;Taip;3;4;1;8
659;Beržynėlis;ŽVIRBLIUKAI;1578089280;Taip;0;3;0;3
660;Beržynėlis;ŽVIRBLIUKAI;96946855305;Taip;10;0;0;10
661;Beržynėlis;ŽVIRBLIUKAI;2067928004;Taip;7;0;0;7
662;Beržynėlis;ŽVIRBLIUKAI;87592204193;Taip;0;1;0;1
663;Beržynėlis;ŽVIRBLIUKAI;62962970458;Taip;9;6;2;17
664;Beržynėlis;ŽVIRBLIUKAI;17743947386;Taip;8;0;0;8
665;Beržynėlis;ŽVIRBLIUKAI;80762814965;Taip;6;0;1;7
666;Beržynėlis;ŽVIRBLIUKAI;30539063473;Taip;3;2;0;5
667;Beržynėlis;ŽVIRBLIUKAI;1885972165;Taip;5;1;0;6
668;Beržynėlis;ŽVIRBLIUKAI;75283423384;Taip;4;0;0;4
669;Beržynėlis;ŽVIRBLIUKAI;81022321678;Taip;10;4;0;14
670;Beržynėlis;ŽVIRBLIUKAI;1391844432;Taip;0;2;14;16
671;Beržynėlis;ŽVIRBLIUKAI;1014895926;Taip;9;2;5;16
672;Beržynėlis;ŽIRNIUKAI;6334152631;Taip;16;0;0;16
673;Beržynėlis;ŽIRNIUKAI;2971686368;Taip;19;0;0;19
674;Beržynėlis;ŽIRNIUKAI;7589778533;Taip;12;0;0;12
675;Beržynėlis;ŽIRNIUKAI;4577837021;Taip;20;0;0;20
676;Beržynėlis;ŽIRNIUKAI;9409317403;Taip;0;2;0;2
677;Beržynėlis;ŽIRNIUKAI;5473666098;Taip;11;0;0;11
678;Beržynėlis;ŽIRNIUKAI;6739927917;Taip;0;2;0;2
679;Beržynėlis;ŽIRNIUKAI;9503352345;Taip;3;0;0;3
680;Beržynėlis;ŽIRNIUKAI;5189335842;Taip;11;0;0;11
681;Beržynėlis;ŽIRNIUKAI;6293884233;Taip;10;0;0;10
682;Beržynėlis;ŽIRNIUKAI;3209966996;Taip;2;0;0;2
683;Beržynėlis;ŽIRNIUKAI;6218165554;Taip;3;0;0;3
684;Beržynėlis;VIŠČIUKAI;9996171088;Taip;2;0;0;2
685;Beržynėlis;VIŠČIUKAI;8688852668;Taip;6;0;0;6
686;Beržynėlis;VIŠČIUKAI;3149966189;Taip;2;0;0;2
687;Beržynėlis;VIŠČIUKAI;9088059487;Taip;0;0;1;1
688;Beržynėlis;VIŠČIUKAI;9540292311;Taip;5;0;0;5
689;Beržynėlis;VIŠČIUKAI;8297427176;Taip;11;0;0;11
690;Beržynėlis;VIŠČIUKAI;1325972861;Taip;4;6;0;10
691;Beržynėlis;VIŠČIUKAI;4970999989;Taip;6;0;0;6
692;Beržynėlis;VIŠČIUKAI;4035764376;Taip;11;0;0;11
693;Beržynėlis;VIŠČIUKAI;5308596559;Taip;10;3;0;13
694;Beržynėlis;VIŠČIUKAI;8881566865;Taip;4;0;0;4
695;Beržynėlis;VIŠČIUKAI;5194416351;Taip;8;2;0;10
696;Beržynėlis;VIŠČIUKAI;9754455116;Taip;11;1;0;12
697;Beržynėlis;VIŠČIUKAI;5069929376;Taip;4;0;3;7
698;Bildukas;"Svetliački savaitinė";39959905586;Taip;0;11;0;11
699;Bildukas;"Svetliački savaitinė";40673143772;Taip;7;0;0;7
700;Bildukas;"Svetliački savaitinė";51199543540;Taip;9;2;4;15
701;Bildukas;"Svetliački savaitinė";10255936371;Taip;9;0;6;15
702;Bildukas;"Svetliački savaitinė";1882022060;Taip;20;0;0;20
703;Bildukas;"Svetliački savaitinė";80327840821;Taip;8;0;3;11
704;Bildukas;"Svetliački savaitinė";96874940646;Taip;0;1;1;2
705;Bildukas;"Svetliački savaitinė";27240409925;Taip;6;3;0;9
706;Bildukas;"Svetliački savaitinė";6441340680;Taip;4;0;0;4
707;Bildukas;"Svetliački savaitinė";5968419467;Taip;11;3;0;14
708;Bildukas;"Svetliački savaitinė";1029617146;Taip;2;5;0;7
709;Bildukas;"Svetliački savaitinė";1643122874;Taip;2;4;0;6
710;Bildukas;"Svetliački savaitinė";8968652761;Taip;8;4;0;12
711;Bildukas;"Svetliački savaitinė";70033583066;Taip;7;1;0;8
712;Bildukas;"Svetliački savaitinė";75301544496;Taip;7;0;0;7
713;Bildukas;"Svetliački savaitinė";1023163775;Ne;2;10;0;12
714;Bildukas;"Svetliački savaitinė";13885215871;Taip;3;0;0;3
715;Bildukas;"Svetliački savaitinė";25050688839;Ne;11;0;0;11
716;Bildukas;"Svetliački savaitinė";57163941360;Taip;0;6;0;6
717;Bildukas;"Svetliački savaitinė";49294883079;Ne;3;0;0;3
718;Bildukas;"Svetliački savaitinė";9535522910;Ne;4;0;0;4
719;Bildukas;"Svetliački savaitinė";1183272346;Taip;10;0;0;10
720;Bildukas;"Svetliački savaitinė";1165636981;Taip;10;0;1;11
721;Bildukas;"Zaičiata savaitinė ( keli alergiški vaikai)";9229489686;Taip;14;0;0;14
722;Bildukas;"Zaičiata savaitinė ( keli alergiški vaikai)";3531285331;Taip;0;5;7;12
723;Bildukas;"Zaičiata savaitinė ( keli alergiški vaikai)";3654667879;Taip;5;0;0;5
724;Bildukas;"Zaičiata savaitinė ( keli alergiški vaikai)";2091204077;Taip;0;5;0;5
725;Bildukas;"Zaičiata savaitinė ( keli alergiški vaikai)";1047459617;Taip;4;1;0;5
726;Bildukas;"Zaičiata savaitinė ( keli alergiški vaikai)";6219872984;Taip;0;0;1;1
727;Bildukas;"Zaičiata savaitinė ( keli alergiški vaikai)";8382899180;Taip;15;0;0;15
728;Bildukas;"Zaičiata savaitinė ( keli alergiški vaikai)";1486878343;Taip;0;4;0;4
729;Bildukas;"Zaičiata savaitinė ( keli alergiški vaikai)";9756326725;Taip;9;0;5;14
730;Bildukas;"Zaičiata savaitinė ( keli alergiški vaikai)";5794471794;Taip;10;0;0;10
731;Bildukas;"Zaičiata savaitinė ( keli alergiški vaikai)";9835391223;Taip;20;0;0;20
732;Bildukas;"Zaičiata savaitinė ( keli alergiški vaikai)";9156801640;Taip;10;4;0;14
733;Bildukas;"Zaičiata savaitinė ( keli alergiški vaikai)";4112888719;Taip;3;5;5;13
734;Bildukas;Gnomiki;1113168085;Taip;0;0;8;8
735;Bildukas;Gnomiki;1125206576;Taip;0;20;0;20
736;Bildukas;Gnomiki;1502213914;Taip;8;0;0;8
737;Bildukas;Gnomiki;7898746258;Taip;7;0;0;7
738;Bildukas;Gnomiki;1376514473;Taip;0;8;0;8
739;Bildukas;Gnomiki;4014493868;Taip;3;10;0;13
740;Bildukas;Gnomiki;4623727349;Taip;20;0;0;20
741;Bildukas;Gnomiki;4377803110;Taip;17;0;0;17
742;Bildukas;Gnomiki;5217751936;Taip;1;14;0;15
743;Bildukas;Gnomiki;9569296370;Taip;12;0;0;12
744;Bildukas;Gnomiki;5844470373;Taip;19;0;0;19
745;Bildukas;Gnomiki;6548776238;Taip;12;2;5;19
746;Bildukas;Gnomiki;6388514464;Taip;3;10;0;13
747;Bildukas;Gnomiki;3226370339;Taip;0;7;4;11
748;Bildukas;Zvonočki;1475108434;Taip;0;1;7;8
749;Bildukas;Zvonočki;60443994539;Ne;0;5;5;10
750;Bildukas;Zvonočki;4866401336;Taip;6;1;0;7
751;Bildukas;Zvonočki;12186791267;Taip;2;1;1;4
752;Bildukas;Zvonočki;84771452636;Ne;11;2;0;13
753;Bildukas;Zvonočki;1180357950;Taip;15;0;0;15
754;Bildukas;Zvonočki;99302309410;Taip;0;5;0;5
755;Bildukas;Zvonočki;52281960273;Taip;0;0;1;1
756;Bildukas;Zvonočki;48069555680;Taip;20;0;0;20
757;Bildukas;Zvonočki;82932493433;Taip;0;13;0;13
758;Bildukas;Zvonočki;1409708149;Taip;4;5;0;9
759;Bildukas;Zvonočki;91777282521;Taip;0;9;0;9
760;Bildukas;Zvonočki;1713133196;Taip;0;1;1;2
761;Bildukas;Zvonočki;1956741726;Taip;0;0;2;2
762;Bildukas;Zvonočki;1234033395;Ne;3;0;0;3
763;Bildukas;Zvonočki;9575263475;Taip;0;1;0;1
764;Bildukas;Zvonočki;4404602365;Taip;0;8;1;9
765;Birutės;SKRUZDELIUKŲ;83624863787;Taip;0;9;1;10
766;Birutės;SKRUZDELIUKŲ;29496817352;Taip;0;13;0;13
767;Birutės;SKRUZDELIUKŲ;8361780904;Taip;0;4;0;4
768;Birutės;SKRUZDELIUKŲ;58791168169;Taip;0;1;0;1
769;Birutės;SKRUZDELIUKŲ;78964625621;Taip;2;0;0;2
770;Birutės;SKRUZDELIUKŲ;99346448051;Taip;0;6;1;7
771;Birutės;SKRUZDELIUKŲ;19076257808;Taip;6;0;0;6
772;Birutės;SKRUZDELIUKŲ;85127282520;Taip;5;0;0;5
773;Birutės;SKRUZDELIUKŲ;99534190736;Taip;8;0;0;8
774;Birutės;SKRUZDELIUKŲ;64883674106;Taip;0;6;1;7
775;Birutės;SKRUZDELIUKŲ;92392234959;Taip;0;9;0;9
776;Birutės;SKRUZDELIUKŲ;83120545528;Taip;5;2;0;7
777;Birutės;SKRUZDELIUKŲ;1227083798;Taip;0;6;0;6
778;Birutės;SKRUZDELIUKŲ;19555366863;Taip;8;6;0;14
779;Birutės;SKRUZDELIUKŲ;1517824834;Taip;14;1;0;15
780;Birutės;SKRUZDELIUKŲ;43601620086;Taip;4;1;2;7
781;Birutės;SKRUZDELIUKŲ;66276243365;Taip;0;5;0;5
782;Birutės;SKRUZDELIUKŲ;5360951559;Ne;11;0;0;11
783;Birutės;SKRUZDELIUKŲ;1123582705;Taip;0;1;0;1
784;Birutės;BITUČIŲ;7678475961;Ne;10;0;0;10
785;Birutės;BITUČIŲ;1599159924;Taip;10;0;1;11
786;Birutės;BITUČIŲ;4427232735;Taip;15;0;0;15
787;Birutės;BITUČIŲ;33770983649;Taip;0;16;1;17
788;Birutės;BITUČIŲ;87693588654;Taip;9;0;0;9
789;Birutės;BITUČIŲ;1234596925;Taip;12;0;2;14
790;Birutės;BITUČIŲ;2975442228;Taip;11;0;1;12
791;Birutės;BITUČIŲ;5770026060;Taip;11;0;0;11
792;Birutės;BITUČIŲ;98391790116;Taip;16;0;0;16
793;Birutės;BITUČIŲ;5947971037;Taip;12;2;0;14
794;Birutės;BITUČIŲ;3870702348;Taip;0;0;1;1
795;Birutės;BITUČIŲ;7149060118;Taip;11;0;0;11
796;Birutės;BITUČIŲ;1064449916;Taip;7;4;0;11
797;Birutės;BITUČIŲ;3436637062;Taip;2;0;0;2
798;Birutės;BITUČIŲ;6748290604;Taip;8;0;1;9
799;Birutės;BITUČIŲ;9769645272;Taip;15;0;0;15
800;Birutės;BITUČIŲ;7237104750;Taip;10;0;0;10
801;Birutės;BITUČIŲ;8465645434;Taip;11;0;4;15
802;Birutės;BITUČIŲ;6006110601;Taip;2;0;0;2
803;Birutės;BITUČIŲ;9722922540;Taip;17;0;0;17
804;Birutės;BITUČIŲ;5018151097;Taip;17;0;0;17
805;Birutės;BITUČIŲ;6115354862;Taip;20;0;0;20
806;Birutės;BITUČIŲ;7386694567;Taip;19;0;0;19
807;Birutės;BITUČIŲ;7856891698;Taip;5;5;0;10
808;Birutės;BORUŽIUKAI;40376432941;Taip;5;6;0;11
809;Birutės;BORUŽIUKAI;83627433055;Taip;6;3;1;10
810;Birutės;BORUŽIUKAI;48493277224;Taip;0;1;1;2
811;Birutės;BORUŽIUKAI;1244627213;Taip;0;7;2;9
812;Birutės;BORUŽIUKAI;44098551169;Taip;10;0;0;10
813;Birutės;BORUŽIUKAI;1228407191;Taip;5;2;0;7
814;Birutės;BORUŽIUKAI;76900751891;Taip;6;0;0;6
815;Birutės;BORUŽIUKAI;78441249067;Taip;0;16;0;16
816;Birutės;BORUŽIUKAI;1735549924;Taip;10;0;0;10
817;Birutės;BORUŽIUKAI;1905393478;Taip;11;0;0;11
818;Birutės;BORUŽIUKAI;1427891290;Taip;0;9;1;10
819;Birutės;BORUŽIUKAI;44844176536;Taip;0;5;0;5
820;Birutės;BORUŽIUKAI;81284166606;Taip;11;0;0;11
821;Birutės;BORUŽIUKAI;2014751710;Ne;19;0;0;19
822;Birutės;BORUŽIUKAI;22452517583;Taip;1;7;0;8
823;Birutės;BORUŽIUKAI;9450257904;Taip;0;2;0;2
824;Birutės;BORUŽIUKAI;1473662465;Taip;0;0;1;1
825;Birutės;BORUŽIUKAI;1596098119;Taip;10;0;0;10
826;Birutės;BORUŽIUKAI;60466633757;Taip;14;5;0;19
827;Birutės;BORUŽIUKAI;4217246188;Taip;12;6;2;20
828;Birutės;BORUŽIUKAI;70370187632;Taip;7;4;0;11
829;Birutės;DRUGELIAI;91202819016;Taip;0;2;0;2
830;Birutės;DRUGELIAI;1884820602;Taip;14;0;0;14
831;Birutės;DRUGELIAI;1447494370;Taip;6;0;0;6
832;Birutės;DRUGELIAI;79438789443;Taip;0;6;0;6
833;Birutės;DRUGELIAI;77244600491;Taip;0;0;3;3
834;Birutės;DRUGELIAI;49162494334;Taip;17;0;0;17
835;Birutės;DRUGELIAI;22036269009;Taip;5;3;0;8
836;Birutės;DRUGELIAI;3213573357;Taip;9;5;0;14
837;Birutės;DRUGELIAI;6601619845;Taip;0;0;7;7
838;Birutės;DRUGELIAI;6880300182;Taip;0;1;1;2
839;Birutės;DRUGELIAI;3490951066;Taip;7;0;0;7
840;Birutės;DRUGELIAI;1163666527;Taip;0;1;2;3
841;Birutės;DRUGELIAI;1346957081;Taip;0;2;0;2
842;Birutės;DRUGELIAI;88939598407;Taip;0;2;0;2
843;Birutės;DRUGELIAI;1950295916;Taip;5;0;1;6
844;Birutės;DRUGELIAI;5272792732;Taip;7;0;1;8
845;Birutės;DRUGELIAI;9886554192;Ne;9;0;0;9
846;Birutės;DRUGELIAI;9662009307;Taip;19;0;0;19
847;Birutės;DRUGELIAI;9860683556;Taip;0;0;1;1
848;Birutės;DRUGELIAI;32821891070;Taip;5;7;3;15
849;Birutės;DRUGELIAI;3682136019;Ne;11;1;0;12
850;Birutės;DRUGELIAI;53416654439;Taip;1;0;0;1
851;Bitutė;Aitvariukų;3254061362;Taip;7;0;0;7
852;Bitutė;Aitvariukų;6674923740;Taip;5;0;0;5
853;Bitutė;Aitvariukų;8394685672;Taip;2;7;0;9
854;Bitutė;Aitvariukų;3796188100;Taip;8;0;0;8
855;Bitutė;Aitvariukų;1564763789;Taip;0;5;0;5
856;Bitutė;Aitvariukų;1162903905;Taip;10;0;0;10
857;Bitutė;Aitvariukų;1560715159;Taip;0;15;0;15
858;Bitutė;Aitvariukų;7456328992;Taip;11;0;0;11
859;Bitutė;Aitvariukų;6204566294;Taip;4;0;0;4
860;Bitutė;Aitvariukų;2518730247;Taip;24;0;0;24
861;Bitutė;Aitvariukų;5810344229;Taip;5;2;0;7
862;Bitutė;Aitvariukų;5895868876;Taip;24;0;0;24
863;Bitutė;Aitvariukų;8743734366;Taip;7;3;0;10
864;Bitutė;Aitvariukų;7036780275;Taip;24;0;0;24
865;Bitutė;Aitvariukų;2804203556;Taip;16;7;0;23
866;Bitutė;Aitvariukų;5455919343;Taip;0;12;0;12
867;Bitutė;Aitvariukų;6737174004;Taip;2;17;0;19
868;Bitutė;Aitvariukų;3432065233;Taip;0;10;0;10
869;Bitutė;Aitvariukų;5679397165;Taip;8;9;0;17
870;Bitutė;Ežiukų;78233050805;Taip;5;2;0;7
871;Bitutė;Ežiukų;25827361426;Taip;10;0;0;10
872;Bitutė;Ežiukų;43167655810;Taip;1;0;0;1
873;Bitutė;Ežiukų;38137764071;Taip;0;5;0;5
874;Bitutė;Ežiukų;40949937934;Taip;3;0;0;3
875;Bitutė;Ežiukų;67601917966;Taip;0;2;0;2
876;Bitutė;Ežiukų;89380579477;Taip;5;0;1;6
877;Bitutė;Ežiukų;99245885176;Taip;5;7;0;12
878;Bitutė;Ežiukų;63533171001;Taip;7;0;0;7
879;Bitutė;Ežiukų;75254163778;Taip;10;9;0;19
880;Bitutė;Ežiukų;1824939092;Taip;9;0;1;10
881;Bitutė;Ežiukų;21280284948;Taip;0;6;0;6
882;Bitutė;Ežiukų;1262030751;Taip;12;0;0;12
883;Bitutė;Ežiukų;57841590670;Taip;5;5;0;10
884;Bitutė;Ežiukų;70388118169;Taip;0;1;0;1
885;Bitutė;Ežiukų;56287634684;Taip;5;0;3;8
886;Bitutė;Ežiukų;4315172747;Taip;6;0;0;6
887;Bitutė;Ežiukų;9838379838;Taip;10;14;0;24
888;Bitutė;Ežiukų;80674416290;Taip;0;2;0;2
889;Bitutė;Ežiukų;42098027592;Taip;13;0;0;13
890;Bitutė;Ežiukų;17953339860;Taip;14;0;0;14
891;Bitutė;Žvirbliukų;5513662035;Taip;0;4;0;4
892;Bitutė;Žvirbliukų;76504719475;Taip;6;2;0;8
893;Bitutė;Žvirbliukų;29837823635;Taip;5;0;1;6
894;Bitutė;Žvirbliukų;40578882341;Taip;14;0;1;15
895;Bitutė;Žvirbliukų;73214901448;Taip;7;1;0;8
896;Bitutė;Žvirbliukų;239058855;Taip;0;11;5;16
897;Bitutė;Žvirbliukų;94263857872;Taip;16;1;0;17
898;Bitutė;Žvirbliukų;4311138099;Taip;9;7;0;16
899;Bitutė;Žvirbliukų;27177678441;Taip;0;1;0;1
900;Bitutė;Žvirbliukų;87682328632;Taip;5;0;0;5
901;Bitutė;Žvirbliukų;93097026538;Taip;9;1;0;10
902;Bitutė;Žvirbliukų;2004079473;Taip;9;0;0;9
903;Bitutė;Žvirbliukų;2045667491;Taip;9;1;0;10
904;Bitutė;Žvirbliukų;1342209916;Taip;4;1;1;6
905;Bitutė;Žvirbliukų;1235354320;Taip;12;1;0;13
906;Bitutė;Žvirbliukų;1086803168;Taip;0;7;0;7
907;Bitutė;Žvirbliukų;54838528906;Taip;14;0;0;14
908;Bitutė;Žvirbliukų;5365203210;Taip;9;0;0;9
909;Bitutė;Žvirbliukų;13826670333;Taip;0;6;0;6
910;Bitutė;Gandriukų;3966405515;Taip;6;5;0;11
911;Bitutė;Gandriukų;7514115839;Taip;0;2;0;2
912;Bitutė;Gandriukų;51971919596;Taip;0;10;0;10
913;Bitutė;Gandriukų;1344880094;Taip;0;10;0;10
914;Bitutė;Gandriukų;98415490683;Taip;0;8;0;8
915;Bitutė;Gandriukų;23567520688;Taip;0;11;0;11
916;Bitutė;Gandriukų;81321203386;Taip;4;9;0;13
917;Bitutė;Gandriukų;11791642887;Taip;0;1;0;1
918;Bitutė;Gandriukų;79414646688;Taip;0;9;1;10
919;Bitutė;Gandriukų;53324014378;Taip;0;7;0;7
920;Bitutė;Gandriukų;93924466303;Taip;0;2;0;2
921;Bitutė;Gandriukų;85983344716;Taip;5;6;0;11
922;Bitutė;Gandriukų;2144684074;Taip;0;10;0;10
923;Bitutė;Gandriukų;27322436232;Taip;0;6;0;6
924;Bitutė;Gandriukų;69158292877;Taip;0;7;0;7
925;Bitutė;Gandriukų;12362142191;Taip;0;3;0;3
926;Bitutė;Gandriukų;66620895469;Taip;6;4;0;10
927;Bitutė;Gandriukų;1131101584;Taip;0;7;3;10
928;Bitutė;Pelėdžiukai;33881269329;Taip;0;4;0;4
929;Bitutė;Pelėdžiukai;72420328957;Taip;13;0;0;13
930;Bitutė;Pelėdžiukai;67449612148;Taip;5;6;0;11
931;Bitutė;Pelėdžiukai;1947476206;Taip;11;0;0;11
932;Bitutė;Pelėdžiukai;7262132445;Taip;0;5;0;5
933;Bitutė;Pelėdžiukai;69535700910;Taip;5;3;1;9
934;Bitutė;Pelėdžiukai;6951613601;Taip;14;2;0;16
935;Bitutė;Pelėdžiukai;44798518501;Taip;1;4;3;8
936;Bitutė;Pelėdžiukai;83983037344;Taip;0;5;0;5
937;Bitutė;Pelėdžiukai;70745977571;Taip;3;6;0;9
938;Bitutė;Pelėdžiukai;28682412356;Taip;5;3;1;9
939;Bitutė;Pelėdžiukai;63918223424;Taip;8;7;0;15
940;Bitutė;Pelėdžiukai;59961877984;Taip;5;0;0;5
941;Bitutė;Pelėdžiukai;3850772845;Taip;2;2;1;5
942;Bitutė;Pelėdžiukai;1347785713;Taip;7;2;1;10
943;Bitutė;Pelėdžiukai;28604993900;Taip;5;2;0;7
944;Bitutė;Pelėdžiukai;82195110042;Taip;0;7;0;7
945;Bitutė;Pelėdžiukai;1915447382;Ne;4;0;0;4
946;Bitutė;Pelėdžiukai;53488410946;Taip;9;0;0;9
947;Bitutė;Pelėdžiukai;68998683110;Taip;5;6;4;15
948;Bitutė;Pelėdžiukai;38867323639;Taip;0;3;0;3
949;Bitutė;Boružėlių;8519978626;Taip;10;0;0;10
950;Bitutė;Boružėlių;6586888742;Taip;11;0;3;14
951;Bitutė;Boružėlių;5783154071;Taip;5;10;0;15
952;Bitutė;Boružėlių;6052204491;Taip;14;0;0;14
953;Bitutė;Boružėlių;37105491775;Taip;6;14;0;20
954;Bitutė;Boružėlių;50869152455;Taip;14;0;1;15
955;Bitutė;Boružėlių;1783776913;Taip;24;0;0;24
956;Bitutė;Boružėlių;9683582019;Taip;12;0;0;12
957;Bitutė;Boružėlių;7352524951;Taip;11;1;0;12
958;Bitutė;Boružėlių;27144303911;Taip;20;0;0;20
959;Bitutė;Boružėlių;6572832247;Taip;11;0;0;11
960;Bitutė;Boružėlių;1802887869;Taip;10;1;3;14
961;Bitutė;Boružėlių;51054491845;Taip;14;1;0;15
962;Bitutė;Boružėlių;5653055907;Taip;17;0;2;19
963;Bitutė;Boružėlių;1809034174;Taip;24;0;0;24
964;Bitutė;Boružėlių;5644789669;Taip;5;1;0;6
965;Bitutė;Boružėlių;2350260809;Taip;12;0;1;13
966;Bitutė;Boružėlių;1307749129;Taip;19;0;0;19
967;Bitutė;Boružėlių;3980455738;Taip;11;1;0;12
968;Bitutė;Boružėlių;6678928989;Taip;0;16;0;16
969;Bitutė;Šokliukų;2775304620;Taip;10;1;0;11
970;Bitutė;Šokliukų;8754340459;Taip;6;2;0;8
971;Bitutė;Šokliukų;91649072251;Taip;0;1;0;1
972;Bitutė;Šokliukų;22504941477;Taip;5;1;0;6
973;Bitutė;Šokliukų;84694903978;Taip;0;6;0;6
974;Bitutė;Šokliukų;1385876629;Taip;10;2;0;12
975;Bitutė;Šokliukų;4054959628;Taip;5;1;3;9
976;Bitutė;Šokliukų;2104500642;Taip;4;2;0;6
977;Bitutė;Šokliukų;71957147569;Taip;0;1;0;1
978;Bitutė;Šokliukų;74038944722;Taip;9;1;0;10
979;Bitutė;Šokliukų;9314363274;Taip;0;24;0;24
980;Bitutė;Šokliukų;1703630417;Taip;0;6;0;6
981;Bitutė;Šokliukų;80788107109;Taip;0;0;2;2
982;Bitutė;Šokliukų;14787330368;Taip;17;1;0;18
983;Bitutė;Šokliukų;11128936533;Taip;8;0;3;11
984;Bitutė;Šokliukų;26573486858;Taip;0;2;0;2
985;Bitutė;Šokliukų;1709788155;Taip;7;0;0;7
986;Bitutė;Šokliukų;6591291681;Taip;13;0;1;14
987;Bitutė;Šokliukų;86636444738;Taip;9;2;0;11
988;Bitutė;Šokliukų;1956718350;Taip;6;3;2;11
989;Bitutė;Drugelių;1861373542;Taip;11;1;0;12
990;Bitutė;Drugelių;57770829048;Taip;0;2;0;2
991;Bitutė;Drugelių;74525712637;Taip;11;0;0;11
992;Bitutė;Drugelių;56620848568;Taip;14;6;0;20
993;Bitutė;Drugelių;7236048627;Taip;6;0;0;6
994;Bitutė;Drugelių;2049938111;Taip;8;0;0;8
995;Bitutė;Drugelių;58668298206;Taip;19;3;0;22
996;Bitutė;Drugelių;1863634233;Taip;14;0;1;15
997;Bitutė;Drugelių;72872147664;Taip;0;5;0;5
998;Bitutė;Drugelių;9550491607;Taip;0;17;0;17
999;Bitutė;Drugelių;48695762145;Taip;6;3;0;9
1000;Bitutė;Drugelių;3982159333;Taip;12;4;0;16
1001;Bitutė;Drugelių;29300327608;Taip;12;0;0;12
1002;Bitutė;Drugelių;50605497381;Taip;0;15;0;15
1003;Bitutė;Drugelių;1030677273;Taip;0;10;0;10
1004;Bitutė;Drugelių;92700808654;Ne;11;0;0;11
1005;Bitutė;Drugelių;3319657847;Taip;0;3;4;7
1006;Bitutė;Kiškučių;1926912966;Taip;0;15;0;15
1007;Bitutė;Kiškučių;41598049089;Taip;14;2;0;16
1008;Bitutė;Kiškučių;20823074269;Taip;11;3;0;14
1009;Bitutė;Kiškučių;2004589442;Taip;0;17;0;17
1010;Bitutė;Kiškučių;1514919519;Taip;6;15;0;21
1011;Bitutė;Kiškučių;1756799209;Taip;0;2;0;2
1012;Bitutė;Kiškučių;7858925572;Taip;0;0;1;1
1013;Bitutė;Kiškučių;1946893053;Taip;10;9;0;19
1014;Bitutė;Kiškučių;39963735248;Taip;10;0;0;10
1015;Bitutė;Kiškučių;55394933894;Taip;0;1;0;1
1016;Bitutė;Kiškučių;34076798361;Taip;0;9;0;9
1017;Bitutė;Kiškučių;83034164893;Taip;0;18;0;18
1018;Bitutė;Kiškučių;28698703670;Taip;0;7;0;7
1019;Bitutė;Kiškučių;51014007755;Taip;0;9;0;9
1020;Bitutė;Kiškučių;85845989245;Taip;5;6;0;11
1021;Bitutė;Kiškučių;23952001143;Taip;11;0;0;11
1022;Bitutė;Kiškučių;55763538285;Taip;5;0;1;6
1023;Bitutė;Kiškučių;55722176820;Taip;10;3;0;13
1024;Bitutė;Kiškučių;41836931870;Taip;0;1;0;1
1025;Bitutė;Kiškučių;16096919364;Ne;0;9;0;9
1026;Bitutė;"Viščiukų ";3723040682;Taip;0;6;0;6
1027;Bitutė;"Viščiukų ";3804171750;Taip;8;6;0;14
1028;Bitutė;"Viščiukų ";8545377054;Taip;8;0;0;8
1029;Bitutė;"Viščiukų ";5406667195;Taip;0;1;0;1
1030;Bitutė;"Viščiukų ";4458990772;Taip;0;3;0;3
1031;Bitutė;"Viščiukų ";7113693496;Taip;21;0;0;21
1032;Bitutė;"Viščiukų ";8186706520;Taip;19;4;0;23
1033;Bitutė;"Viščiukų ";6044969600;Taip;10;3;0;13
1034;Bitutė;"Viščiukų ";9602659259;Taip;9;0;2;11
1035;Bitutė;"Viščiukų ";2190439190;Taip;9;1;0;10
1036;Bitutė;"Viščiukų ";9855080887;Taip;0;1;0;1
1037;Bitutė;"Viščiukų ";4177331531;Taip;9;0;0;9
1038;Bitutė;"Viščiukų ";2483462846;Taip;7;2;0;9
1039;Bitutė;"Viščiukų ";2886154457;Taip;7;0;1;8
1040;Bitutė;"Viščiukų ";7678106084;Taip;4;1;0;5
1041;Bitutė;"Skruzdėliukai ";37364063140;Taip;2;6;3;11
1042;Bitutė;"Skruzdėliukai ";95252521365;Taip;9;1;0;10
1043;Bitutė;"Skruzdėliukai ";1590580158;Taip;0;11;0;11
1044;Bitutė;"Skruzdėliukai ";5910842956;Taip;6;1;0;7
1045;Bitutė;"Skruzdėliukai ";1913421864;Taip;9;1;0;10
1046;Bitutė;"Skruzdėliukai ";38436660859;Taip;5;0;9;14
1047;Bitutė;"Skruzdėliukai ";2126118124;Taip;7;0;1;8
1048;Bitutė;"Skruzdėliukai ";2031043488;Taip;5;9;0;14
1049;Bitutė;"Skruzdėliukai ";55469634385;Taip;9;0;1;10
1050;Bitutė;"Skruzdėliukai ";1130379531;Taip;4;6;2;12
1051;Bitutė;"Skruzdėliukai ";87960363246;Taip;8;6;0;14
1052;Bitutė;"Skruzdėliukai ";1064809221;Taip;0;22;2;24
1053;Bitutė;"Skruzdėliukai ";1521753712;Taip;10;0;1;11
1054;Bitutė;"Skruzdėliukai ";1354608761;Taip;5;1;0;6
1055;Bitutė;"Skruzdėliukai ";1307910515;Taip;0;10;2;12
1056;Bitutė;"Skruzdėliukai ";2311037144;Taip;5;1;0;6
1057;Bitutė;"Skruzdėliukai ";41659768159;Taip;9;0;0;9
1058;Bitutė;"Skruzdėliukai ";5886190377;Taip;3;5;0;8
1059;Bitutė;"Skruzdėliukai ";61233878620;Taip;0;5;2;7
1060;Bitutė;"Nykštukų ";1733189730;Taip;13;7;0;20
1061;Bitutė;"Nykštukų ";2740656695;Taip;0;0;7;7
1062;Bitutė;"Nykštukų ";3227252972;Taip;9;0;0;9
1063;Bitutė;"Nykštukų ";4764586168;Taip;13;0;0;13
1064;Bitutė;"Nykštukų ";5126303823;Taip;0;0;1;1
1065;Bitutė;"Nykštukų ";1904108612;Taip;9;1;0;10
1066;Bitutė;"Nykštukų ";5109258680;Taip;6;0;2;8
1067;Bitutė;"Nykštukų ";1423694056;Taip;4;0;1;5
1068;Bitutė;"Nykštukų ";2812580726;Taip;9;0;0;9
1069;Bitutė;"Nykštukų ";4913483444;Taip;8;0;0;8
1070;Bitutė;"Nykštukų ";1907876695;Taip;6;0;0;6
1071;Bitutė;"Nykštukų ";7720798466;Taip;6;0;0;6
1072;Bitutė;"Nykštukų ";1662815358;Taip;6;2;1;9
1073;Bitutė;"Nykštukų ";9966437881;Taip;21;0;0;21
1074;Bitutė;"Nykštukų ";6169426273;Taip;14;0;2;16
1075;Bitutė;"Nykštukų ";9166624750;Taip;24;0;0;24
1076;Coliukė;DRUGELIAI;4408284518;Taip;17;0;0;17
1077;Coliukė;DRUGELIAI;3919482569;Taip;2;4;0;6
1078;Coliukė;DRUGELIAI;3346269598;Taip;0;0;1;1
1079;Coliukė;DRUGELIAI;1600495468;Taip;9;1;0;10
1080;Coliukė;DRUGELIAI;9183391434;Taip;0;9;0;9
1081;Coliukė;DRUGELIAI;2159103903;Taip;0;2;0;2
1082;Coliukė;DRUGELIAI;1458763954;Taip;1;0;0;1
1083;Coliukė;DRUGELIAI;7920728387;Taip;9;1;0;10
1084;Coliukė;DRUGELIAI;6972921877;Taip;7;0;0;7
1085;Coliukė;DRUGELIAI;6860757091;Taip;0;5;3;8
1086;Coliukė;DRUGELIAI;6011110970;Ne;10;0;0;10
1087;Coliukė;DRUGELIAI;1968467455;Taip;0;2;0;2
1088;Coliukė;DRUGELIAI;1240946719;Taip;0;10;0;10
1089;Coliukė;DRUGELIAI;4645245689;Taip;15;0;0;15
1090;Coliukė;DRUGELIAI;1882520335;Taip;0;4;0;4
1091;Coliukė;DRUGELIAI;8517128464;Taip;0;1;0;1
1092;Coliukė;DRUGELIAI;1328505569;Ne;6;1;0;7
1093;Coliukė;DRUGELIAI;5678858566;Taip;0;5;0;5
1094;Coliukė;BITUTĖS;53223262449;Ne;10;5;0;15
1095;Coliukė;BITUTĖS;2006601280;Taip;6;2;0;8
1096;Coliukė;BITUTĖS;44291325944;Taip;0;4;0;4
1097;Coliukė;BITUTĖS;8017702268;Ne;0;1;0;1
1098;Coliukė;BITUTĖS;30220840133;Ne;0;1;0;1
1099;Coliukė;BITUTĖS;58282533952;Ne;4;0;0;4
1100;Coliukė;BITUTĖS;41174692847;Taip;2;9;0;11
1101;Coliukė;BITUTĖS;93361426448;Taip;0;5;0;5
1102;Coliukė;BITUTĖS;69258022561;Taip;0;12;0;12
1103;Coliukė;BITUTĖS;82989338835;Taip;0;6;0;6
1104;Coliukė;BITUTĖS;37161702858;Taip;9;0;0;9
1105;Coliukė;BITUTĖS;77967081365;Taip;5;0;0;5
1106;Coliukė;BITUTĖS;77204026281;Taip;0;9;0;9
1107;Coliukė;BITUTĖS;25298531632;Taip;5;1;0;6
1108;Coliukė;BITUTĖS;1199350941;Taip;0;13;0;13
1109;Coliukė;BITUTĖS;1960898805;Taip;2;9;0;11
1110;Coliukė;BITUTĖS;58421006265;Taip;0;6;0;6
1111;Coliukė;BITUTĖS;6926730624;Taip;0;3;0;3
1112;Coliukė;BITUTĖS;8457120425;Taip;9;0;0;9
1113;Coliukė;BITUTĖS;9311775782;Taip;17;3;0;20
1114;Coliukė;BITUTĖS;81003830638;Taip;1;4;0;5
1115;Coliukė;BITUTĖS;36554487034;Taip;10;3;0;13
1116;Coliukė;BITUTĖS;1423711475;Taip;0;1;0;1
1117;Coliukė;BITUTĖS;2002555659;Taip;0;15;0;15
1118;Coliukė;VABALIUKAI;62876576078;Taip;0;2;0;2
1119;Coliukė;VABALIUKAI;51782207208;Taip;0;7;0;7
1120;Coliukė;VABALIUKAI;26012978171;Taip;11;0;0;11
1121;Coliukė;VABALIUKAI;18718511212;Taip;11;2;0;13
1122;Coliukė;VABALIUKAI;26698840369;Taip;0;8;0;8
1123;Coliukė;VABALIUKAI;78760440826;Taip;0;13;0;13
1124;Coliukė;VABALIUKAI;1556841186;Taip;7;0;0;7
1125;Coliukė;VABALIUKAI;6025281817;Taip;0;6;0;6
1126;Coliukė;VABALIUKAI;22951260339;Taip;5;6;0;11
1127;Coliukė;VABALIUKAI;33158793202;Taip;0;1;0;1
1128;Coliukė;VABALIUKAI;33587152454;Taip;0;8;0;8
1129;Coliukė;VABALIUKAI;82064520362;Taip;19;0;0;19
1130;Coliukė;VABALIUKAI;57504928606;Taip;17;1;0;18
1131;Coliukė;VABALIUKAI;1654628972;Taip;8;1;1;10
1132;Coliukė;VABALIUKAI;5944299310;Taip;0;4;0;4
1133;Coliukė;VABALIUKAI;4649987214;Taip;19;0;0;19
1134;Coliukė;VABALIUKAI;5672562299;Taip;14;0;0;14
1135;Coliukė;VABALIUKAI;63258983714;Taip;6;2;0;8
1136;Coliukė;VABALIUKAI;99200764707;Taip;10;0;0;10
1137;Coliukė;VABALIUKAI;1476750428;Taip;11;0;0;11
1138;Coliukė;VABALIUKAI;6775470024;Taip;9;0;0;9
1139;Coliukė;VABALIUKAI;8323242104;Taip;9;5;0;14
1140;Coliukė;NYKŠTUKAI;1659532709;Taip;20;0;0;20
1141;Coliukė;NYKŠTUKAI;88866481329;Taip;0;2;0;2
1142;Coliukė;NYKŠTUKAI;1812071213;Taip;5;6;0;11
1143;Coliukė;NYKŠTUKAI;43313407836;Taip;0;0;4;4
1144;Coliukė;NYKŠTUKAI;3738703854;Taip;11;2;0;13
1145;Coliukė;NYKŠTUKAI;1997515382;Taip;0;0;1;1
1146;Coliukė;NYKŠTUKAI;1625018276;Taip;0;16;0;16
1147;Coliukė;NYKŠTUKAI;1267427191;Taip;4;2;0;6
1148;Coliukė;NYKŠTUKAI;1963122314;Taip;0;20;0;20
1149;Coliukė;NYKŠTUKAI;4917899323;Taip;2;6;0;8
1150;Coliukė;NYKŠTUKAI;4747481676;Taip;0;8;0;8
1151;Coliukė;NYKŠTUKAI;83027842354;Taip;8;1;0;9
1152;Coliukė;NYKŠTUKAI;2168987649;Taip;4;0;1;5
1153;Coliukė;NYKŠTUKAI;2684151591;Taip;0;8;0;8
1154;Coliukė;NYKŠTUKAI;4499924331;Taip;4;1;0;5
1155;Coliukė;NYKŠTUKAI;9383567339;Taip;6;2;0;8
1156;Coliukė;NYKŠTUKAI;4806478786;Taip;0;0;2;2
1157;Coliukė;NYKŠTUKAI;7566429633;Taip;0;5;0;5
1158;Coliukė;NYKŠTUKAI;9542366183;Taip;20;0;0;20
1159;Coliukė;NYKŠTUKAI;7670166244;Taip;0;10;0;10
1160;Coliukė;NYKŠTUKAI;1166820133;Taip;4;0;0;4
1161;Coliukė;GĖLYTĖS;8835394030;Taip;0;9;0;9
1162;Coliukė;GĖLYTĖS;3427704550;Taip;0;7;0;7
1163;Coliukė;GĖLYTĖS;7248705010;Taip;15;0;0;15
1164;Coliukė;GĖLYTĖS;1318558913;Taip;4;0;1;5
1165;Coliukė;GĖLYTĖS;3318808813;Taip;12;0;2;14
1166;Coliukė;GĖLYTĖS;4498253271;Taip;7;2;0;9
1167;Coliukė;GĖLYTĖS;3323738649;Taip;0;3;0;3
1168;Coliukė;GĖLYTĖS;9331485675;Taip;12;0;6;18
1169;Coliukė;GĖLYTĖS;8149118599;Taip;5;0;0;5
1170;Coliukė;GĖLYTĖS;8209209881;Taip;0;16;1;17
1171;Coliukė;GĖLYTĖS;9885547263;Taip;0;0;2;2
1172;Coliukė;GĖLYTĖS;5139645108;Taip;5;8;0;13
1173;Coliukė;"BORUŽĖLĖS (SPEC.)";1988394967;Taip;5;10;0;15
1174;Coliukė;"BORUŽĖLĖS (SPEC.)";6795666500;Taip;0;9;1;10
1175;Coliukė;"BORUŽĖLĖS (SPEC.)";3746858489;Taip;5;1;0;6
1176;Coliukė;"BORUŽĖLĖS (SPEC.)";3101380476;Taip;10;0;1;11
1177;Coliukė;"BORUŽĖLĖS (SPEC.)";92299314212;Taip;0;4;1;5
1178;Coliukė;"BORUŽĖLĖS (SPEC.)";2080118127;Taip;1;2;0;3
1179;Coliukė;"BORUŽĖLĖS (SPEC.)";8070499557;Taip;3;10;0;13
1180;Coliukė;"BORUŽĖLĖS (SPEC.)";2617816991;Taip;2;0;3;5
1181;Coliukė;"BORUŽĖLĖS (SPEC.)";9368334915;Taip;0;1;0;1
1182;Coliukė;"BORUŽĖLĖS (SPEC.)";1233731506;Taip;5;0;0;5
1183;Coliukė;"BORUŽĖLĖS (SPEC.)";1644303265;Taip;0;8;0;8
1184;Coliukė;"BORUŽĖLĖS (SPEC.)";60578936717;Taip;6;6;0;12
1185;Čiauškutis;BITUTĖS;78373250443;Taip;10;5;0;15
1186;Čiauškutis;BITUTĖS;3499391608;Taip;11;3;0;14
1187;Čiauškutis;BITUTĖS;1443155220;Taip;7;8;0;15
1188;Čiauškutis;BITUTĖS;2012201854;Taip;1;2;4;7
1189;Čiauškutis;BITUTĖS;38387916428;Taip;5;0;11;16
1190;Čiauškutis;BITUTĖS;1804509009;Taip;18;0;0;18
1191;Čiauškutis;BITUTĖS;22717947028;Taip;0;5;0;5
1192;Čiauškutis;BITUTĖS;3917667527;Taip;5;0;0;5
1193;Čiauškutis;BITUTĖS;4600623461;Taip;0;1;0;1
1194;Čiauškutis;BITUTĖS;27158851138;Taip;0;1;0;1
1195;Čiauškutis;BITUTĖS;8030685444;Taip;0;3;0;3
1196;Čiauškutis;ŽVIRBLIUKAI;7440425102;Ne;5;0;0;5
1197;Čiauškutis;ŽVIRBLIUKAI;7312776041;Ne;5;0;0;5
1198;Čiauškutis;ŽVIRBLIUKAI;1298724775;Taip;8;0;0;8
1199;Čiauškutis;ŽVIRBLIUKAI;1301573542;Taip;6;0;0;6
1200;Čiauškutis;ŽVIRBLIUKAI;2554011985;Ne;0;2;3;5
1201;Čiauškutis;ŽVIRBLIUKAI;2044220236;Taip;18;0;1;19
1202;Čiauškutis;ŽVIRBLIUKAI;5900996969;Taip;11;0;0;11
1203;Čiauškutis;ŽVIRBLIUKAI;6170362846;Taip;0;13;3;16
1204;Čiauškutis;ŽVIRBLIUKAI;1036358147;Taip;9;4;0;13
1205;Čiauškutis;ŽVIRBLIUKAI;9072764004;Taip;8;0;1;9
1206;Čiauškutis;ŽVIRBLIUKAI;8690876173;Ne;0;2;3;5
1207;Čiauškutis;SAULUTĖS;4267461379;Taip;5;4;0;9
1208;Čiauškutis;SAULUTĖS;60189459128;Taip;14;0;0;14
1209;Čiauškutis;SAULUTĖS;9140042522;Taip;7;5;0;12
1210;Čiauškutis;SAULUTĖS;2976888531;Taip;5;3;0;8
1211;Čiauškutis;SAULUTĖS;1798962981;Taip;0;1;3;4
1212;Čiauškutis;SAULUTĖS;6279678482;Taip;0;2;0;2
1213;Čiauškutis;SAULUTĖS;35965163532;Taip;19;0;0;19
1214;Čiauškutis;SAULUTĖS;2312273972;Taip;14;5;0;19
1215;Čiauškutis;EŽIUKAI;1624692126;Taip;5;0;0;5
1216;Čiauškutis;EŽIUKAI;30738331224;Taip;10;0;0;10
1217;Čiauškutis;EŽIUKAI;32462147501;Taip;10;0;0;10
1218;Čiauškutis;EŽIUKAI;20874037407;Taip;9;0;0;9
1219;Čiauškutis;EŽIUKAI;54848304991;Taip;17;0;0;17
1220;Čiauškutis;EŽIUKAI;1437126272;Taip;2;0;0;2
1221;Čiauškutis;EŽIUKAI;3653044274;Taip;7;0;0;7
1222;Čiauškutis;EŽIUKAI;1824372731;Taip;3;0;0;3
1223;Čiauškutis;EŽIUKAI;1960094598;Taip;4;0;2;6
1224;Čiauškutis;EŽIUKAI;1575387912;Taip;7;4;1;12
1225;Čiauškutis;EŽIUKAI;37100318588;Taip;0;0;3;3
1226;Čiauškutis;EŽIUKAI;32956407401;Taip;0;5;0;5
1227;Čiauškutis;DRUGELIAI;1332686904;Taip;0;1;0;1
1228;Čiauškutis;DRUGELIAI;8974089037;Taip;5;0;0;5
1229;Čiauškutis;DRUGELIAI;1417978731;Taip;0;0;5;5
1230;Čiauškutis;DRUGELIAI;7011763860;Taip;0;0;3;3
1231;Čiauškutis;DRUGELIAI;47625081475;Taip;0;10;0;10
1232;Čiauškutis;DRUGELIAI;45303538716;Taip;10;0;0;10
1233;Čiauškutis;DRUGELIAI;8375416027;Taip;5;0;2;7
1234;Čiauškutis;DRUGELIAI;1480363762;Taip;8;0;2;10
1235;Čiauškutis;GENELIAI;3888278518;Taip;9;0;2;11
1236;Čiauškutis;GENELIAI;4442345827;Taip;18;2;0;20
1237;Čiauškutis;GENELIAI;6476417522;Taip;14;0;0;14
1238;Čiauškutis;GENELIAI;9679979305;Taip;10;0;0;10
1239;Čiauškutis;GENELIAI;32342661810;Taip;0;3;5;8
1240;Čiauškutis;GENELIAI;76993441149;Taip;0;3;0;3
1241;Čiauškutis;GENELIAI;48375767334;Taip;7;0;0;7
1242;Čiauškutis;GENELIAI;29844230217;Taip;14;1;0;15
1243;Čiauškutis;GENELIAI;48881709481;Taip;9;0;1;10
1244;Čiauškutis;GENELIAI;47866559654;Taip;11;0;0;11
1245;Čiauškutis;GENELIAI;1330717109;Taip;8;0;0;8
1246;Čiauškutis;LINKSMUČIAI;3127896063;Ne;0;0;2;2
1247;Čiauškutis;LINKSMUČIAI;1691137830;Taip;14;0;1;15
1248;Čiauškutis;LINKSMUČIAI;75421786315;Taip;0;0;2;2
1249;Čiauškutis;LINKSMUČIAI;70507237430;Taip;0;0;2;2
1250;Čiauškutis;LINKSMUČIAI;65948673886;Taip;9;1;1;11
1251;Čiauškutis;LINKSMUČIAI;5587488205;Taip;11;0;1;12
1252;Čiauškutis;LINKSMUČIAI;32426102534;Taip;10;0;1;11
1253;Čiauškutis;LINKSMUČIAI;9722014294;Taip;7;11;0;18
1254;Čiauškutis;LINKSMUČIAI;54471558189;Taip;0;0;3;3
1255;Čiauškutis;LINKSMUČIAI;13187502295;Taip;8;2;0;10
1256;Čiauškutis;LINKSMUČIAI;1452900014;Taip;19;0;0;19
1257;Čiauškutis;LINKSMUČIAI;2049302005;Taip;19;0;0;19
1258;Čiauškutis;KIŠKUČIAI;1380571576;Taip;14;6;0;20
1259;Čiauškutis;KIŠKUČIAI;4817007142;Taip;8;1;0;9
1260;Čiauškutis;KIŠKUČIAI;1474355889;Taip;0;1;1;2
1261;Čiauškutis;KIŠKUČIAI;26779062894;Taip;11;1;0;12
1262;Čiauškutis;KIŠKUČIAI;72264057427;Taip;0;3;0;3
1263;Čiauškutis;KIŠKUČIAI;8808041204;Taip;4;1;0;5
1264;Čiauškutis;KIŠKUČIAI;8884708945;Taip;12;0;1;13
1265;Čiauškutis;KIŠKUČIAI;2099735647;Taip;12;0;0;12
1266;Čiauškutis;LAPIUKAI;67405154291;Taip;4;0;2;6
1267;Čiauškutis;LAPIUKAI;1486206292;Taip;4;0;0;4
1268;Čiauškutis;LAPIUKAI;1719875491;Taip;0;0;2;2
1269;Čiauškutis;LAPIUKAI;1849532875;Ne;5;0;0;5
1270;Čiauškutis;LAPIUKAI;60265156684;Taip;6;0;0;6
1271;Čiauškutis;LAPIUKAI;1938531597;Ne;12;0;0;12
1272;Čiauškutis;LAPIUKAI;31203540590;Taip;10;0;0;10
1273;Čiauškutis;MEŠKUČIAI;34145100746;Taip;0;0;1;1
1274;Čiauškutis;MEŠKUČIAI;1923832961;Taip;10;0;3;13
1275;Čiauškutis;MEŠKUČIAI;95088279233;Taip;0;0;6;6
1276;Čiauškutis;PELĖDŽIUKAI;6572444114;Taip;0;0;2;2
1277;Čiauškutis;PELĖDŽIUKAI;7060197354;Taip;0;4;4;8
1278;Čiauškutis;PELĖDŽIUKAI;7961309940;Taip;8;0;0;8
1279;Čiauškutis;PELĖDŽIUKAI;8728572783;Taip;5;3;0;8
1280;Čiauškutis;PELĖDŽIUKAI;1253449294;Taip;11;0;0;11
1281;Čiauškutis;PELĖDŽIUKAI;82575455120;Taip;0;0;2;2
1282;Čiauškutis;PELĖDŽIUKAI;6165710260;Taip;4;6;0;10
1283;Čiauškutis;PELĖDŽIUKAI;1546096184;Taip;0;0;2;2
1284;Čiauškutis;PELĖDŽIUKAI;4135020826;Taip;5;0;2;7
1285;Čiauškutis;PELĖDŽIUKAI;1422589887;Taip;10;0;0;10
1286;Čiauškutis;PELĖDŽIUKAI;30480486366;Taip;2;0;1;3
1287;Čiauškutis;PELĖDŽIUKAI;70690874267;Taip;10;0;2;12
1288;Čiauškutis;NYKŠTUKAI;6258150407;Taip;5;10;0;15
1289;Čiauškutis;NYKŠTUKAI;1778900145;Taip;9;0;0;9
1290;Čiauškutis;NYKŠTUKAI;4846025153;Taip;11;0;0;11
1291;Čiauškutis;NYKŠTUKAI;4898534899;Taip;20;0;0;20
1292;Čiauškutis;NYKŠTUKAI;4917339896;Taip;0;1;0;1
1293;Čiauškutis;NYKŠTUKAI;7367933940;Taip;5;0;0;5
1294;Čiauškutis;NYKŠTUKAI;24468474924;Taip;0;5;0;5
1295;Delfinukas;Boružėlių;6531930806;Taip;7;0;0;7
1296;Delfinukas;Boružėlių;8076961367;Taip;3;0;1;4
1297;Delfinukas;Boružėlių;8439204095;Taip;9;1;0;10
1298;Delfinukas;Boružėlių;5783537897;Taip;9;0;1;10
1299;Delfinukas;Boružėlių;4989239822;Taip;0;0;2;2
1300;Delfinukas;Boružėlių;7638190553;Taip;9;0;0;9
1301;Delfinukas;Boružėlių;8728791932;Taip;7;0;0;7
1302;Delfinukas;Boružėlių;2784942324;Taip;0;1;0;1
1303;Delfinukas;Boružėlių;6700068320;Taip;10;0;0;10
1304;Delfinukas;Boružėlių;7277680544;Taip;20;0;0;20
1305;Delfinukas;Boružėlių;9099945815;Taip;9;1;0;10
1306;Delfinukas;Boružėlių;1212995285;Taip;10;0;0;10
1307;Delfinukas;Saulytės;65798709244;Taip;20;0;0;20
1308;Delfinukas;Saulytės;76643778833;Taip;2;6;0;8
1309;Delfinukas;Saulytės;35058841521;Taip;20;0;0;20
1310;Delfinukas;Saulytės;9918028862;Taip;14;0;0;14
1311;Delfinukas;Saulytės;1260108624;Taip;1;0;0;1
1312;Delfinukas;Saulytės;79934072325;Taip;0;6;0;6
1313;Delfinukas;Saulytės;2096874518;Taip;0;6;0;6
1314;Delfinukas;Saulytės;5912904296;Taip;14;0;0;14
1315;Delfinukas;Saulytės;2009324145;Taip;0;5;0;5
1316;Delfinukas;Saulytės;27140729689;Taip;0;6;0;6
1317;Delfinukas;Saulytės;46847640903;Taip;8;0;0;8
1318;Delfinukas;Saulytės;4142864015;Taip;0;8;0;8
1319;Delfinukas;Saulytės;86601289023;Taip;10;0;0;10
1320;Delfinukas;Saulytės;16785309188;Taip;10;2;0;12
1321;Delfinukas;Saulytės;34563800372;Taip;19;0;0;19
1322;Delfinukas;Saulytės;2074439295;Taip;1;0;0;1
1323;Delfinukas;Saulytės;1364873935;Taip;6;3;0;9
1324;Delfinukas;Saulytės;1939499375;Taip;14;0;0;14
1325;Delfinukas;Saulytės;1813240176;Taip;6;0;1;7
1326;Delfinukas;Pelėdžiukų;9520598359;Taip;12;0;0;12
1327;Delfinukas;Pelėdžiukų;5018815345;Taip;0;0;20;20
1328;Delfinukas;Pelėdžiukų;8938997208;Taip;20;0;0;20
1329;Delfinukas;Pelėdžiukų;6572690788;Taip;10;0;0;10
1330;Delfinukas;Pelėdžiukų;7487111570;Taip;3;0;3;6
1331;Delfinukas;Pelėdžiukų;4631456002;Taip;9;0;0;9
1332;Delfinukas;Pelėdžiukų;3397350274;Taip;8;0;0;8
1333;Delfinukas;Pelėdžiukų;3804996594;Taip;8;0;0;8
1334;Delfinukas;Pelėdžiukų;1136182876;Taip;8;0;0;8
1335;Delfinukas;Pelėdžiukų;7873373923;Taip;2;0;0;2
1336;Delfinukas;Pelėdžiukų;8936645508;Taip;0;5;0;5
1337;Delfinukas;Pelėdžiukų;2066127119;Taip;8;0;0;8
1338;Delfinukas;Pelėdžiukų;2869506388;Taip;0;0;1;1
1339;Delfinukas;Pelėdžiukų;6844500395;Taip;11;0;0;11
1340;Delfinukas;Pelėdžiukų;9074294473;Taip;0;0;4;4
1341;Delfinukas;Varliukų;1153333591;Taip;0;5;0;5
1342;Delfinukas;Varliukų;1091165849;Taip;0;1;0;1
1343;Delfinukas;Varliukų;1421633312;Taip;3;1;0;4
1344;Delfinukas;Varliukų;9573336239;Taip;0;2;0;2
1345;Delfinukas;Varliukų;1251961268;Taip;5;4;0;9
1346;Delfinukas;Varliukų;1789047913;Taip;0;14;0;14
1347;Delfinukas;Varliukų;3678131609;Taip;6;0;0;6
1348;Delfinukas;Varliukų;1194444282;Taip;6;1;0;7
1349;Delfinukas;Varliukų;9347513042;Taip;8;10;0;18
1350;Delfinukas;Varliukų;8875479631;Taip;0;13;0;13
1351;Delfinukas;Varliukų;3344476309;Taip;15;2;0;17
1352;Delfinukas;Varliukų;3955783379;Taip;1;13;0;14
1353;Delfinukas;Varliukų;9502789660;Taip;8;0;0;8
1354;Delfinukas;Varliukų;3489297719;Taip;3;6;0;9
1355;Delfinukas;Varliukų;1948438336;Taip;9;0;0;9
1356;Delfinukas;Varliukų;9266646602;Taip;20;0;0;20
1357;Delfinukas;Varliukų;3674481373;Taip;9;1;0;10
1358;Delfinukas;Varpelių;1201971467;Taip;5;4;0;9
1359;Delfinukas;Varpelių;16192036601;Ne;9;0;0;9
1360;Delfinukas;Varpelių;17472648959;Taip;0;1;0;1
1361;Delfinukas;Varpelių;73187227229;Taip;6;2;0;8
1362;Delfinukas;Varpelių;62769117892;Taip;5;5;0;10
1363;Delfinukas;Varpelių;70985723823;Ne;0;9;0;9
1364;Delfinukas;Varpelių;8855690221;Taip;6;11;0;17
1365;Delfinukas;Varpelių;3093606855;Taip;8;1;0;9
1366;Delfinukas;Varpelių;6393090675;Taip;2;4;0;6
1367;Delfinukas;Varpelių;1268754720;Taip;0;6;0;6
1368;Delfinukas;Varpelių;1959331544;Taip;9;0;0;9
1369;Delfinukas;Varpelių;3718612458;Taip;19;0;0;19
1370;Delfinukas;Varpelių;43859975789;Taip;5;0;0;5
1371;Delfinukas;Varpelių;2531571615;Taip;3;1;0;4
1372;Delfinukas;Varpelių;91028452879;Taip;0;4;0;4
1373;Delfinukas;Varpelių;1325054642;Taip;0;3;0;3
1374;Delfinukas;Varpelių;4239224971;Taip;0;7;0;7
1375;Delfinukas;Varpelių;1650166115;Taip;0;1;0;1
1376;Delfinukas;Delfinukai;6190642132;Taip;8;7;0;15
1377;Delfinukas;Delfinukai;17266052771;Taip;8;0;0;8
1378;Delfinukas;Delfinukai;57676205527;Taip;4;10;0;14
1379;Delfinukas;Delfinukai;71523999168;Taip;4;10;0;14
1380;Delfinukas;Delfinukai;46276990963;Taip;0;5;0;5
1381;Delfinukas;Delfinukai;7528505426;Taip;12;0;0;12
1382;Delfinukas;Delfinukai;6561536457;Taip;10;0;0;10
1383;Delfinukas;Delfinukai;29449834997;Taip;0;0;20;20
1384;Delfinukas;Delfinukai;1188049956;Taip;5;0;0;5
1385;Delfinukas;Delfinukai;545765924;Taip;11;0;1;12
1386;Delfinukas;Delfinukai;1430155044;Taip;10;1;0;11
1387;Delfinukas;Delfinukai;8227660508;Taip;15;0;0;15
1388;Delfinukas;Delfinukai;7886801955;Taip;0;0;20;20
1389;Delfinukas;Delfinukai;1160537966;Taip;20;0;0;20
1390;Delfinukas;Delfinukai;26626004000;Taip;0;0;20;20
1391;Delfinukas;Drugeliai;83704349624;Taip;0;6;0;6
1392;Delfinukas;Drugeliai;86042798636;Taip;0;0;1;1
1393;Delfinukas;Drugeliai;74847760830;Taip;3;0;0;3
1394;Delfinukas;Drugeliai;35812802830;Taip;0;7;1;8
1395;Delfinukas;Drugeliai;2960662435;Taip;0;0;1;1
1396;Delfinukas;Drugeliai;11940207202;Taip;0;2;6;8
1397;Delfinukas;Drugeliai;94713648240;Taip;0;2;4;6
1398;Delfinukas;Drugeliai;2402204674;Taip;0;1;5;6
1399;Delfinukas;Drugeliai;1882976317;Taip;0;1;4;5
1400;Delfinukas;Drugeliai;9168812609;Taip;0;6;10;16
1401;Delfinukas;Drugeliai;5024726028;Taip;0;2;2;4
1402;Delfinukas;Drugeliai;88370692635;Taip;0;1;0;1
1403;Delfinukas;Drugeliai;4435982727;Taip;0;0;1;1
1404;Delfinukas;Drugeliai;2402524470;Taip;0;0;3;3
1405;Delfinukas;Drugeliai;2135364149;Taip;3;0;5;8
1406;Delfinukas;Drugeliai;33466088300;Taip;4;0;0;4
1407;Delfinukas;Drugeliai;8782782031;Taip;0;1;0;1
1408;Delfinukas;Žuvytės;31776667512;Taip;0;5;0;5
1409;Delfinukas;Žuvytės;47377556072;Taip;0;6;0;6
1410;Delfinukas;Žuvytės;82176273307;Taip;6;1;0;7
1411;Delfinukas;Žuvytės;53152433196;Taip;10;5;0;15
1412;Delfinukas;Žuvytės;21095307036;Taip;0;0;20;20
1413;Delfinukas;Žuvytės;94392092103;Ne;6;0;0;6
1414;Delfinukas;Žuvytės;57461575212;Taip;2;6;1;9
1415;Delfinukas;Žuvytės;40665480700;Taip;0;9;0;9
1416;Delfinukas;Žuvytės;3310208029;Taip;7;5;0;12
1417;Delfinukas;Žuvytės;1693121016;Taip;7;2;0;9
1418;Delfinukas;Žuvytės;82936702613;Taip;9;0;0;9
1419;Delfinukas;Žuvytės;30104416225;Taip;0;1;0;1
1420;Delfinukas;Žuvytės;31006890017;Taip;4;0;0;4
1421;Delfinukas;Žuvytės;49489087212;Taip;4;4;0;8
1422;Delfinukas;Žuvytės;29649846186;Taip;9;0;0;9
1423;Delfinukas;Žuvytės;24363585231;Taip;0;1;0;1
1424;Delfinukas;Žuvytės;9330213866;Taip;4;1;0;5
1425;Delfinukas;Žuvytės;30064453011;Taip;0;14;5;19
1426;Delfinukas;Žuvytės;1238188049;Taip;12;0;0;12
1427;Delfinukas;Žuvytės;59541249199;Taip;14;0;0;14
1428;Delfinukas;Delfinai;8335398345;Taip;10;0;0;10
1429;Delfinukas;Delfinai;37530814188;Taip;4;1;0;5
1430;Delfinukas;Delfinai;1435104895;Taip;12;0;0;12
1431;Delfinukas;Delfinai;2308733347;Taip;6;4;0;10
1432;Delfinukas;Delfinai;1876110301;Taip;14;0;0;14
1433;Delfinukas;Delfinai;1101237825;Taip;17;1;0;18
1434;Delfinukas;Delfinai;11528618044;Taip;0;9;0;9
1435;Delfinukas;Delfinai;26554152266;Taip;6;5;0;11
1436;Delfinukas;Delfinai;51442842468;Taip;0;4;0;4
1437;Delfinukas;Delfinai;84024727184;Taip;4;1;0;5
1438;Delfinukas;Delfinai;1382754985;Taip;0;2;0;2
1439;Delfinukas;Delfinai;1515422367;Taip;4;0;4;8
1440;Delfinukas;Delfinai;71828460624;Taip;4;0;0;4
1441;Delfinukas;Delfinai;4549364929;Taip;20;0;0;20
1442;Delfinukas;Delfinai;4497323553;Taip;20;0;0;20
1443;Delfinukas;Delfinai;1037795359;Taip;0;6;0;6
1444;Delfinukas;Delfinai;83920976768;Taip;19;0;0;19
1445;Delfinukas;Delfinai;1963422247;Taip;16;0;0;16
1446;Delfinukas;Delfinai;9821969586;Taip;0;7;0;7
1447;Delfinukas;Delfinai;4569691896;Taip;13;1;0;14
1448;Delfinukas;Paukšteliai;6047881184;Taip;19;0;0;19
1449;Delfinukas;Paukšteliai;8038737019;Taip;0;0;20;20
1450;Delfinukas;Paukšteliai;9628317328;Taip;7;1;0;8
1451;Delfinukas;Paukšteliai;5797308373;Taip;1;1;0;2
1452;Delfinukas;Paukšteliai;5241426445;Taip;10;6;0;16
1453;Delfinukas;Paukšteliai;8099120371;Taip;0;0;20;20
1454;Delfinukas;Paukšteliai;3108430680;Taip;9;0;0;9
1455;Delfinukas;Paukšteliai;7663934825;Taip;5;2;0;7
1456;Delfinukas;Paukšteliai;2382077576;Taip;0;4;0;4
1457;Delfinukas;Paukšteliai;1200205376;Taip;7;0;0;7
1458;Delfinukas;Paukšteliai;4347116918;Taip;0;0;1;1
1459;Delfinukas;Paukšteliai;1922513830;Taip;15;1;0;16
1460;Delfinukas;Paukšteliai;7629622746;Taip;9;0;0;9
1461;Delfinukas;Paukšteliai;8335034956;Taip;20;0;0;20
1462;Delfinukas;Paukšteliai;6337962165;Taip;6;0;0;6
1463;Delfinukas;Kiškučiai;67554154339;Taip;7;0;0;7
1464;Delfinukas;Kiškučiai;7766292005;Taip;0;4;0;4
1465;Delfinukas;Kiškučiai;98742243823;Taip;5;5;0;10
1466;Delfinukas;Kiškučiai;1498120150;Taip;5;5;0;10
1467;Delfinukas;Kiškučiai;7920401664;Taip;8;1;0;9
1468;Delfinukas;Kiškučiai;1767369189;Taip;4;4;0;8
1469;Delfinukas;Kiškučiai;1495145663;Taip;0;4;0;4
1470;Delfinukas;Kiškučiai;1301231548;Taip;20;0;0;20
1471;Delfinukas;Kiškučiai;1613911039;Taip;1;2;2;5
1472;Delfinukas;Kiškučiai;1477374660;Taip;10;0;0;10
1473;Delfinukas;Kiškučiai;2993704795;Taip;1;1;0;2
1474;Delfinukas;Kiškučiai;1487082744;Taip;12;1;0;13
1475;Delfinukas;Kiškučiai;99919425286;Taip;7;0;0;7
1476;Delfinukas;Kiškučiai;1011101007;Ne;5;0;0;5
1477;Delfinukas;Kiškučiai;2063259303;Taip;11;2;0;13
1478;Delfinukas;Kiškučiai;1166370228;Taip;9;1;0;10
1479;Delfinukas;Kiškučiai;96861425670;Taip;4;0;0;4
1480;Delfinukas;Kiškučiai;60320557464;Taip;4;1;0;5
1481;Delfinukas;Kiškučiai;1594700604;Taip;9;8;0;17
1482;Dobilėlis;"II grupė";1186330934;Taip;6;0;0;6
1483;Dobilėlis;"II grupė";17440499472;Taip;5;4;0;9
1484;Dobilėlis;"II grupė";92147631467;Taip;13;0;2;15
1485;Dobilėlis;"II grupė";68068847689;Taip;0;2;2;4
1486;Dobilėlis;"II grupė";1173849791;Taip;9;3;0;12
1487;Dobilėlis;"II grupė";1291132247;Taip;0;3;0;3
1488;Drevinukas;ZUIKUČIAI;5686116320;Taip;5;0;1;6
1489;Drevinukas;ZUIKUČIAI;85288014888;Taip;0;7;1;8
1490;Drevinukas;ZUIKUČIAI;56028675283;Taip;10;5;0;15
1491;Drevinukas;ZUIKUČIAI;4784716615;Taip;6;0;0;6
1492;Drevinukas;ZUIKUČIAI;2070374746;Taip;3;0;0;3
1493;Drevinukas;ZUIKUČIAI;7632515230;Taip;5;0;0;5
1494;Drevinukas;ZUIKUČIAI;9803670483;Taip;4;0;0;4
1495;Drevinukas;ZUIKUČIAI;5046355276;Taip;0;8;0;8
1496;Drevinukas;ZUIKUČIAI;8661862777;Taip;0;0;2;2
1497;Drevinukas;ZUIKUČIAI;2074070030;Taip;0;0;7;7
1498;Drevinukas;ZUIKUČIAI;6304169257;Taip;0;1;6;7
1499;Drevinukas;ZUIKUČIAI;3657451903;Taip;0;0;1;1
1500;Drevinukas;ZUIKUČIAI;4332606643;Taip;4;0;1;5
1501;Drevinukas;ZUIKUČIAI;1987939679;Taip;0;0;10;10
1502;Drevinukas;ZUIKUČIAI;1123115847;Taip;0;4;2;6
1503;Drevinukas;ZUIKUČIAI;9336227821;Taip;4;0;4;8
1504;Drevinukas;ZUIKUČIAI;6425268903;Taip;0;14;2;16
1505;Drevinukas;AŽUOLIUKŲ;4980076288;Taip;5;1;0;6
1506;Drevinukas;AŽUOLIUKŲ;64560340218;Taip;11;1;0;12
1507;Drevinukas;AŽUOLIUKŲ;17456144256;Taip;9;0;0;9
1508;Drevinukas;AŽUOLIUKŲ;3066586415;Taip;0;0;6;6
1509;Drevinukas;AŽUOLIUKŲ;1250033881;Taip;9;0;0;9
1510;Drevinukas;AŽUOLIUKŲ;22050717457;Taip;0;0;4;4
1511;Drevinukas;AŽUOLIUKŲ;74690633233;Taip;5;4;0;9
1512;Drevinukas;AŽUOLIUKŲ;1798044901;Taip;0;0;15;15
1513;Drevinukas;AŽUOLIUKŲ;73923305630;Taip;0;1;0;1
1514;Drevinukas;AŽUOLIUKŲ;29000633056;Taip;6;0;0;6
1515;Drevinukas;AŽUOLIUKŲ;96655135353;Taip;0;6;0;6
1516;Drevinukas;AŽUOLIUKŲ;1254845545;Taip;0;3;0;3
1517;Drevinukas;AŽUOLIUKŲ;46006802320;Taip;9;1;0;10
1518;Drevinukas;AŽUOLIUKŲ;49704496121;Taip;9;0;0;9
1519;Drevinukas;AŽUOLIUKŲ;1978599912;Taip;9;0;0;9
1520;Drevinukas;AŽUOLIUKŲ;9657606451;Taip;0;5;0;5
1521;Drevinukas;AŽUOLIUKŲ;4150306697;Taip;0;14;0;14
1522;Drevinukas;AŽUOLIUKŲ;71447591085;Taip;16;0;0;16
1523;Drevinukas;AŽUOLIUKŲ;2483043689;Taip;6;0;1;7
1524;Drevinukas;PELĖDŽIUKAI;4694536057;Taip;4;0;0;4
1525;Drevinukas;PELĖDŽIUKAI;3114995856;Taip;10;0;0;10
1526;Drevinukas;PELĖDŽIUKAI;67211396910;Taip;0;3;0;3
1527;Drevinukas;PELĖDŽIUKAI;49359528680;Taip;0;3;3;6
1528;Drevinukas;PELĖDŽIUKAI;98918406807;Taip;0;0;1;1
1529;Drevinukas;PELĖDŽIUKAI;51830569951;Taip;0;4;0;4
1530;Drevinukas;PELĖDŽIUKAI;24866634007;Taip;6;4;2;12
1531;Drevinukas;PELĖDŽIUKAI;98431492077;Taip;5;0;0;5
1532;Drevinukas;PELĖDŽIUKAI;54578654099;Taip;0;5;0;5
1533;Drevinukas;PELĖDŽIUKAI;62264151217;Taip;0;6;0;6
1534;Drevinukas;PELĖDŽIUKAI;53607306428;Taip;7;1;0;8
1535;Drevinukas;PELĖDŽIUKAI;45489453961;Ne;0;5;7;12
1536;Drevinukas;PELĖDŽIUKAI;11985365230;Taip;0;3;1;4
1537;Drevinukas;PELĖDŽIUKAI;83204594508;Taip;0;3;3;6
1538;Drevinukas;PELĖDŽIUKAI;78255352251;Taip;5;0;0;5
1539;Drevinukas;PELĖDŽIUKAI;59835545517;Taip;18;0;0;18
1540;Drevinukas;PELĖDŽIUKAI;12709943846;Taip;10;2;0;12
1541;Drevinukas;PELĖDŽIUKAI;69217298162;Taip;0;4;2;6
1542;Drevinukas;PELĖDŽIUKAI;47576956459;Taip;10;4;1;15
1543;Drevinukas;PELĖDŽIUKAI;61881364454;Taip;10;0;0;10
1544;Drevinukas;BORUŽĖLĖS;24300552411;Taip;20;0;0;20
1545;Drevinukas;BORUŽĖLĖS;39014589824;Taip;0;5;2;7
1546;Drevinukas;BORUŽĖLĖS;3625661236;Taip;0;6;0;6
1547;Drevinukas;BORUŽĖLĖS;41776089342;Taip;6;9;0;15
1548;Drevinukas;BORUŽĖLĖS;46323011887;Taip;7;7;0;14
1549;Drevinukas;BORUŽĖLĖS;17722412785;Taip;0;4;5;9
1550;Drevinukas;BORUŽĖLĖS;1437074990;Taip;0;0;7;7
1551;Drevinukas;BORUŽĖLĖS;8325320616;Taip;5;0;1;6
1552;Drevinukas;BORUŽĖLĖS;1577311253;Taip;0;4;2;6
1553;Drevinukas;BORUŽĖLĖS;6539595624;Taip;20;0;0;20
1554;Drevinukas;BORUŽĖLĖS;7570410899;Taip;19;0;0;19
1555;Drevinukas;BORUŽĖLĖS;1929303009;Taip;0;0;5;5
1556;Drevinukas;BORUŽĖLĖS;64093448834;Taip;9;0;2;11
1557;Drevinukas;BORUŽĖLĖS;59090501289;Taip;14;0;0;14
1558;Drevinukas;BORUŽĖLĖS;1585468549;Taip;5;9;0;14
1559;Drevinukas;BORUŽĖLĖS;1276720097;Taip;0;2;2;4
1560;Drevinukas;BORUŽĖLĖS;47549756124;Taip;5;0;2;7
1561;Drevinukas;BORUŽĖLĖS;3604979285;Taip;9;0;1;10
1562;Drevinukas;BORUŽĖLĖS;78348414683;Taip;15;0;0;15
1563;Drevinukas;BORUŽĖLĖS;1970787957;Taip;0;16;0;16
1564;Drevinukas;BORUŽĖLĖS;30667895560;Taip;9;0;0;9
1565;Drevinukas;BORUŽĖLĖS;83194462453;Taip;0;5;0;5
1566;Drevinukas;BORUŽĖLĖS;63665560323;Taip;0;0;2;2
1567;Drevinukas;BITUTĖS;81036035477;Taip;0;1;0;1
1568;Drevinukas;BITUTĖS;96688324084;Taip;0;5;0;5
1569;Drevinukas;BITUTĖS;30808032808;Taip;0;1;0;1
1570;Drevinukas;BITUTĖS;24223024745;Taip;0;0;2;2
1571;Drevinukas;BITUTĖS;7088781332;Taip;0;2;0;2
1572;Drevinukas;BITUTĖS;67343152327;Taip;0;8;0;8
1573;Drevinukas;BITUTĖS;79654459964;Taip;0;4;1;5
1574;Drevinukas;BITUTĖS;13511159834;Taip;0;1;0;1
1575;Drevinukas;BITUTĖS;7874030637;Taip;0;1;0;1
1576;Drevinukas;BITUTĖS;86268382049;Taip;0;1;0;1
1577;Drevinukas;BITUTĖS;73165075762;Taip;0;1;1;2
1578;Drevinukas;BITUTĖS;91352351942;Taip;2;4;2;8
1579;Drevinukas;BITUTĖS;43573400232;Taip;0;3;0;3
1580;Drevinukas;BITUTĖS;43087053446;Taip;1;0;2;3
1581;Drevinukas;BITUTĖS;81362980445;Taip;0;4;0;4
1582;Drevinukas;BITUTĖS;66058660804;Taip;0;9;0;9
1583;Drevinukas;BITUTĖS;56016757119;Taip;0;2;2;4
1584;Drevinukas;BITUTĖS;62294117396;Taip;0;1;0;1
1585;Drevinukas;BITUTĖS;71273092994;Taip;0;5;0;5
1586;Drevinukas;BITUTĖS;53025453998;Taip;3;0;0;3
1587;Drevinukas;NYKŠTUKAI;1720464417;Taip;0;0;1;1
1588;Drevinukas;NYKŠTUKAI;6095020718;Taip;0;0;1;1
1589;Drevinukas;NYKŠTUKAI;7753238387;Taip;19;0;0;19
1590;Drevinukas;NYKŠTUKAI;5679723776;Taip;0;5;0;5
1591;Drevinukas;NYKŠTUKAI;2857797268;Taip;0;0;1;1
1592;Drevinukas;NYKŠTUKAI;3875062228;Taip;1;0;4;5
1593;Drevinukas;NYKŠTUKAI;8479979176;Taip;9;0;0;9
1594;Drevinukas;NYKŠTUKAI;2531207946;Taip;10;0;0;10
1595;Drevinukas;NYKŠTUKAI;1152161183;Taip;0;0;4;4
1596;Drevinukas;NYKŠTUKAI;6256572875;Taip;4;0;0;4
1597;Drevinukas;NYKŠTUKAI;8936058501;Taip;0;0;3;3
1598;Drevinukas;NYKŠTUKAI;8130416781;Taip;5;0;0;5
1599;Drevinukas;NYKŠTUKAI;3972897839;Taip;0;0;9;9
1600;Drevinukas;NYKŠTUKAI;7520907833;Taip;10;1;0;11
1601;Drevinukas;NYKŠTUKAI;8625382465;Taip;6;0;0;6
1602;Drevinukas;NYKŠTUKAI;5521378389;Taip;0;1;0;1
1603;Drevinukas;SMALSUČIAI;3032536983;Taip;14;0;0;14
1604;Drevinukas;SMALSUČIAI;8556218971;Taip;0;0;4;4
1605;Drevinukas;SMALSUČIAI;5524567803;Taip;5;0;1;6
1606;Drevinukas;SMALSUČIAI;9016985238;Taip;9;0;1;10
1607;Drevinukas;SMALSUČIAI;2929598743;Taip;0;2;0;2
1608;Drevinukas;SMALSUČIAI;6373230526;Taip;20;0;0;20
1609;Drevinukas;SMALSUČIAI;4404254932;Taip;0;0;6;6
1610;Drevinukas;SMALSUČIAI;2378493422;Taip;18;0;0;18
1611;Drevinukas;SMALSUČIAI;8984653958;Taip;7;3;0;10
1612;Drevinukas;SMALSUČIAI;5620887702;Taip;5;4;0;9
1613;Drevinukas;SMALSUČIAI;2281463885;Taip;1;0;2;3
1614;Drevinukas;SMALSUČIAI;3725760478;Taip;5;0;4;9
1615;Drevinukas;SMALSUČIAI;4662426451;Taip;10;0;0;10
1616;Drevinukas;ŽVIRBLIUKAI;5348609358;Taip;15;0;0;15
1617;Drevinukas;ŽVIRBLIUKAI;2312241894;Taip;15;0;0;15
1618;Drevinukas;ŽVIRBLIUKAI;5394143000;Taip;0;10;0;10
1619;Drevinukas;ŽVIRBLIUKAI;3871506691;Taip;3;1;0;4
1620;Drevinukas;ŽVIRBLIUKAI;6914111231;Taip;3;1;0;4
1621;Drevinukas;ŽVIRBLIUKAI;3377957769;Taip;2;0;4;6
1622;Drevinukas;ŽVIRBLIUKAI;1343431478;Taip;10;0;1;11
1623;Drevinukas;ŽVIRBLIUKAI;1829421385;Taip;6;0;1;7
1624;Drevinukas;ŽVIRBLIUKAI;8262224710;Taip;0;3;0;3
1625;Drevinukas;ŽVIRBLIUKAI;2935175014;Taip;0;3;1;4
1626;Drevinukas;ŽVIRBLIUKAI;3046196006;Taip;0;6;0;6
1627;Drevinukas;ŽVIRBLIUKAI;4260123123;Taip;0;0;1;1
1628;Drugelis;NYKŠTUKŲ;86452076401;Taip;0;2;1;3
1629;Drugelis;NYKŠTUKŲ;22204482690;Taip;3;0;0;3
1630;Drugelis;NYKŠTUKŲ;18603741278;Taip;0;1;0;1
1631;Drugelis;NYKŠTUKŲ;9263055716;Taip;6;0;1;7
1632;Drugelis;NYKŠTUKŲ;91204781931;Taip;0;6;0;6
1633;Drugelis;NYKŠTUKŲ;53978775822;Taip;0;2;2;4
1634;Drugelis;NYKŠTUKŲ;9923093174;Taip;1;4;0;5
1635;Drugelis;NYKŠTUKŲ;67195315804;Taip;0;5;0;5
1636;Drugelis;NYKŠTUKŲ;2593184133;Taip;0;2;0;2
1637;Drugelis;NYKŠTUKŲ;41833447251;Taip;0;2;4;6
1638;Drugelis;NYKŠTUKŲ;40524667913;Taip;0;1;0;1
1639;Drugelis;NYKŠTUKŲ;14998254512;Taip;7;1;0;8
1640;Drugelis;NYKŠTUKŲ;62834741685;Taip;0;5;0;5
1641;Drugelis;NYKŠTUKŲ;88553764001;Taip;0;2;0;2
1642;Drugelis;NYKŠTUKŲ;69762633803;Taip;5;1;0;6
1643;Drugelis;NYKŠTUKŲ;16524288155;Taip;0;1;0;1
1644;Drugelis;SMALSUČIŲ;3479833265;Taip;4;0;0;4
1645;Drugelis;SMALSUČIŲ;1217635751;Taip;8;0;10;18
1646;Drugelis;SMALSUČIŲ;1288160341;Taip;11;2;0;13
1647;Drugelis;SMALSUČIŲ;27569805506;Taip;0;5;0;5
1648;Drugelis;SMALSUČIŲ;1856912386;Taip;0;2;2;4
1649;Drugelis;SMALSUČIŲ;1576853049;Taip;6;5;0;11
1650;Drugelis;SMALSUČIŲ;1901608445;Taip;13;2;1;16
1651;Drugelis;SMALSUČIŲ;3096906506;Taip;0;4;0;4
1652;Drugelis;SMALSUČIŲ;7406396614;Taip;0;2;0;2
1653;Drugelis;SMALSUČIŲ;1255315664;Taip;5;0;0;5
1654;Drugelis;SMALSUČIŲ;1160161173;Taip;0;5;0;5
1655;Drugelis;SMALSUČIŲ;1843605624;Taip;0;3;0;3
1656;Drugelis;SMALSUČIŲ;1506988472;Taip;3;4;0;7
1657;Drugelis;SMALSUČIŲ;1991420008;Taip;3;4;0;7
1658;Drugelis;SMALSUČIŲ;1421438458;Taip;0;10;0;10
1659;Drugelis;SMALSUČIŲ;53874036107;Taip;0;2;0;2
1660;Drugelis;SMALSUČIŲ;1961898730;Taip;4;2;0;6
1661;Drugelis;SMALSUČIŲ;4788423265;Taip;0;0;5;5
1662;Drugelis;SMALSUČIŲ;1541276266;Taip;0;4;0;4
1663;Drugelis;SMALSUČIŲ;5954059321;Taip;19;0;0;19
1664;Drugelis;SMALSUČIŲ;1888002607;Taip;0;8;0;8
1665;Drugelis;MUMINUKŲ;89109375373;Taip;5;1;0;6
1666;Drugelis;MUMINUKŲ;10841811704;Taip;14;0;0;14
1667;Drugelis;MUMINUKŲ;55662263930;Taip;11;0;1;12
1668;Drugelis;MUMINUKŲ;78391738678;Taip;4;3;0;7
1669;Drugelis;MUMINUKŲ;63076864410;Taip;0;1;0;1
1670;Drugelis;MUMINUKŲ;44627668646;Taip;6;2;0;8
1671;Drugelis;MUMINUKŲ;78311619943;Taip;0;1;0;1
1672;Drugelis;MUMINUKŲ;35386244403;Taip;0;5;0;5
1673;Drugelis;MUMINUKŲ;16512391370;Taip;8;0;2;10
1674;Drugelis;MUMINUKŲ;37910900277;Ne;0;6;0;6
1675;Drugelis;MUMINUKŲ;88073976875;Taip;5;1;0;6
1676;Drugelis;MUMINUKŲ;85362607749;Taip;0;1;0;1
1677;Drugelis;MUMINUKŲ;13989264253;Taip;0;11;2;13
1678;Drugelis;MUMINUKŲ;25002448923;Taip;7;1;0;8
1679;Drugelis;MUMINUKŲ;55339135155;Taip;0;6;0;6
1680;Drugelis;MUMINUKŲ;82465836364;Taip;0;0;4;4
1681;Drugelis;MUMINUKŲ;63173368598;Taip;0;5;0;5
1682;Drugelis;MUMINUKŲ;1761079726;Taip;0;5;0;5
1683;Drugelis;MUMINUKŲ;82441447907;Taip;2;0;2;4
1684;Drugelis;MUMINUKŲ;70288969200;Taip;0;1;0;1
1685;Drugelis;MUMINUKŲ;72147158912;Taip;0;1;0;1
1686;Drugelis;PŪKUOTUKAI;49035429728;Taip;0;6;0;6
1687;Drugelis;PŪKUOTUKAI;3156382280;Taip;3;1;0;4
1688;Drugelis;PŪKUOTUKAI;59819126556;Taip;10;0;1;11
1689;Drugelis;PŪKUOTUKAI;4989130624;Taip;14;6;0;20
1690;Drugelis;PŪKUOTUKAI;1657445173;Taip;11;5;0;16
1691;Drugelis;PŪKUOTUKAI;27379769302;Taip;9;0;1;10
1692;Drugelis;PŪKUOTUKAI;91538620813;Taip;3;1;0;4
1693;Drugelis;PŪKUOTUKAI;57217727711;Taip;14;0;0;14
1694;Drugelis;PŪKUOTUKAI;1240607928;Taip;0;7;0;7
1695;Drugelis;PŪKUOTUKAI;68716515660;Taip;5;0;0;5
1696;Drugelis;PŪKUOTUKAI;1162058481;Taip;8;2;0;10
1697;Drugelis;PŪKUOTUKAI;3161396176;Taip;2;0;0;2
1698;Drugelis;PŪKUOTUKAI;5649225445;Taip;3;0;0;3
1699;Drugelis;PŪKUOTUKAI;1060282804;Taip;3;0;0;3
1700;Drugelis;PŪKUOTUKAI;20943932955;Taip;0;0;1;1
1701;Drugelis;PŪKUOTUKAI;1667056936;Taip;0;1;4;5
1702;Drugelis;PŪKUOTUKAI;63777226415;Taip;12;2;0;14
1703;Drugelis;PŪKUOTUKAI;1651512363;Taip;5;0;1;6
1704;Drugelis;PŪKUOTUKAI;1546655542;Taip;7;4;0;11
1705;Drugelis;SPINDULIUKAI;6594452094;Taip;8;2;1;11
1706;Drugelis;SPINDULIUKAI;7609530453;Taip;0;0;2;2
1707;Drugelis;SPINDULIUKAI;1142209285;Taip;0;1;0;1
1708;Drugelis;SPINDULIUKAI;4158475365;Taip;14;0;0;14
1709;Drugelis;SPINDULIUKAI;9510744779;Taip;0;0;12;12
1710;Drugelis;SPINDULIUKAI;8717445483;Taip;16;0;0;16
1711;Drugelis;SPINDULIUKAI;7477547789;Taip;5;0;0;5
1712;Drugelis;SPINDULIUKAI;4825232236;Taip;1;5;0;6
1713;Drugelis;SPINDULIUKAI;5515894973;Taip;3;0;0;3
1714;Drugelis;SPINDULIUKAI;7447519502;Taip;5;3;0;8
1715;Drugelis;SPINDULIUKAI;7590759136;Taip;13;7;0;20
1716;Drugelis;SPINDULIUKAI;8752459733;Taip;0;4;0;4
1717;Drugelis;SPINDULIUKAI;7719697394;Taip;0;0;12;12
1718;Drugelis;SPINDULIUKAI;5692743298;Taip;0;6;0;6
1719;Drugelis;KIŠKUČIAI;3551095669;Taip;0;2;0;2
1720;Drugelis;KIŠKUČIAI;9316073597;Taip;0;2;0;2
1721;Drugelis;KIŠKUČIAI;3061896520;Taip;0;2;1;3
1722;Drugelis;KIŠKUČIAI;8070030439;Taip;0;2;1;3
1723;Drugelis;KIŠKUČIAI;9612696781;Taip;0;0;1;1
1724;Drugelis;KIŠKUČIAI;5691833295;Taip;0;0;10;10
1725;Drugelis;KIŠKUČIAI;4927896706;Taip;0;0;4;4
1726;Drugelis;KIŠKUČIAI;5902687211;Taip;6;0;0;6
1727;Drugelis;KIŠKUČIAI;1785724340;Taip;5;2;0;7
1728;Drugelis;KIŠKUČIAI;6038184222;Taip;15;0;0;15
1729;Drugelis;KIŠKUČIAI;6321332888;Taip;11;4;0;15
1730;Drugelis;KIŠKUČIAI;6452921695;Taip;4;0;0;4
1731;Drugelis;KIŠKUČIAI;6632884258;Taip;11;1;0;12
1732;Drugelis;KIŠKUČIAI;8591548746;Taip;4;0;0;4
1733;"Du gaideliai";Uodelių;7084763712;Taip;10;0;0;10
1734;"Du gaideliai";Uodelių;1758546983;Taip;10;3;1;14
1735;"Du gaideliai";Uodelių;94639433266;Taip;3;0;0;3
1736;"Du gaideliai";Uodelių;1230622413;Taip;12;4;0;16
1737;"Du gaideliai";Uodelių;6715434585;Taip;0;8;0;8
1738;"Du gaideliai";Uodelių;1500684755;Taip;20;0;0;20
1739;"Du gaideliai";Uodelių;4387568448;Taip;0;1;4;5
1740;"Du gaideliai";Uodelių;6750787450;Taip;9;1;0;10
1741;"Du gaideliai";Uodelių;2601122166;Taip;20;0;0;20
1742;"Du gaideliai";Uodelių;5430986033;Taip;0;1;0;1
1743;"Du gaideliai";Uodelių;1876870081;Taip;13;1;0;14
1744;"Du gaideliai";Uodelių;1962859229;Taip;5;0;0;5
1745;"Du gaideliai";Uodelių;1557413692;Taip;6;6;0;12
1746;"Du gaideliai";Uodelių;3560637865;Taip;10;2;0;12
1747;"Du gaideliai";Uodelių;7783203480;Taip;9;1;0;10
1748;"Du gaideliai";Uodelių;9324740716;Taip;5;0;0;5
1749;"Du gaideliai";Uodelių;1211005513;Taip;13;0;0;13
1750;"Du gaideliai";Uodelių;1549762923;Taip;7;0;0;7
1751;"Du gaideliai";Uodelių;2159833613;Taip;20;0;0;20
1752;"Du gaideliai";Uodelių;6203383711;Taip;8;0;0;8
1753;"Du gaideliai";OŽIUKŲ;25738622801;Taip;15;0;0;15
1754;"Du gaideliai";OŽIUKŲ;50087080642;Taip;15;0;0;15
1755;"Du gaideliai";OŽIUKŲ;91470338843;Taip;0;7;0;7
1756;"Du gaideliai";OŽIUKŲ;1479672134;Taip;10;0;0;10
1757;"Du gaideliai";OŽIUKŲ;88801178853;Taip;0;2;0;2
1758;"Du gaideliai";OŽIUKŲ;60934378499;Taip;0;1;0;1
1759;"Du gaideliai";OŽIUKŲ;1128234653;Taip;0;5;0;5
1760;"Du gaideliai";OŽIUKŲ;14681393632;Taip;6;10;0;16
1761;"Du gaideliai";OŽIUKŲ;13384312035;Taip;10;0;0;10
1762;"Du gaideliai";OŽIUKŲ;30562958921;Taip;10;1;0;11
1763;"Du gaideliai";OŽIUKŲ;1291620608;Taip;1;1;0;2
1764;"Du gaideliai";OŽIUKŲ;1628346439;Taip;11;3;0;14
1765;"Du gaideliai";OŽIUKŲ;1304400387;Taip;5;1;0;6
1766;"Du gaideliai";OŽIUKŲ;80297570999;Taip;1;0;0;1
1767;"Du gaideliai";OŽIUKŲ;1512578437;Ne;5;1;0;6
1768;"Du gaideliai";OŽIUKŲ;1261678548;Taip;0;9;0;9
1769;"Du gaideliai";OŽIUKŲ;1791530261;Taip;0;19;0;19
1770;"Du gaideliai";OŽIUKŲ;73447542654;Taip;5;0;0;5
1771;"Du gaideliai";OŽIUKŲ;1906486044;Taip;0;6;0;6
1772;"Du gaideliai";OŽIUKŲ;41922349110;Taip;6;1;0;7
1773;"Du gaideliai";OŽIUKŲ;6161829923;Taip;20;0;0;20
1774;"Du gaideliai";OŽIUKŲ;85962801220;Taip;11;2;0;13
1775;"Du gaideliai";OŽIUKŲ;1923863232;Taip;6;4;0;10
1776;"Du gaideliai";Vištyčių;1888402861;Taip;9;5;0;14
1777;"Du gaideliai";Vištyčių;31139048776;Taip;7;10;0;17
1778;"Du gaideliai";Vištyčių;25898248315;Taip;0;7;0;7
1779;"Du gaideliai";Vištyčių;56826255179;Taip;1;10;0;11
1780;"Du gaideliai";Vištyčių;11621795110;Taip;0;7;0;7
1781;"Du gaideliai";Vištyčių;59558745879;Taip;12;0;1;13
1782;"Du gaideliai";Vištyčių;14599820571;Taip;10;0;0;10
1783;"Du gaideliai";Vištyčių;8087660692;Taip;20;0;0;20
1784;"Du gaideliai";Vištyčių;46193129936;Taip;0;8;0;8
1785;"Du gaideliai";Vištyčių;82205925738;Taip;3;4;0;7
1786;"Du gaideliai";Vištyčių;9173656753;Taip;3;9;0;12
1787;"Du gaideliai";Vištyčių;1277603882;Taip;3;8;0;11
1788;"Du gaideliai";Vištyčių;73654636959;Taip;1;0;0;1
1789;"Du gaideliai";Vištyčių;1850550387;Taip;10;4;0;14
1790;"Du gaideliai";Vištyčių;1258859998;Taip;0;2;0;2
1791;"Du gaideliai";Vištyčių;2157315097;Taip;0;1;0;1
1792;"Du gaideliai";Vištyčių;1823681047;Taip;12;5;0;17
1793;"Du gaideliai";Vištyčių;5028304472;Taip;20;0;0;20
1794;"Du gaideliai";GAIDŽIUKŲ;9478614075;Taip;7;0;0;7
1795;"Du gaideliai";GAIDŽIUKŲ;32735548453;Taip;5;0;0;5
1796;"Du gaideliai";GAIDŽIUKŲ;13544785168;Taip;10;0;0;10
1797;"Du gaideliai";GAIDŽIUKŲ;98790674632;Taip;12;3;0;15
1798;"Du gaideliai";GAIDŽIUKŲ;94409399599;Taip;0;6;0;6
1799;"Du gaideliai";GAIDŽIUKŲ;67678569738;Taip;0;2;0;2
1800;"Du gaideliai";GAIDŽIUKŲ;10671107948;Taip;0;4;0;4
1801;"Du gaideliai";GAIDŽIUKŲ;62233928653;Taip;5;0;0;5
1802;"Du gaideliai";GAIDŽIUKŲ;24753427184;Taip;16;0;0;16
1803;"Du gaideliai";GAIDŽIUKŲ;63476686143;Ne;0;4;1;5
1804;"Du gaideliai";GAIDŽIUKŲ;65144471076;Taip;0;7;0;7
1805;"Du gaideliai";GAIDŽIUKŲ;83990613379;Taip;0;3;0;3
1806;"Du gaideliai";GAIDŽIUKŲ;74161177222;Taip;9;0;0;9
1807;"Du gaideliai";GAIDŽIUKŲ;97364620242;Ne;0;13;0;13
1808;"Du gaideliai";GAIDŽIUKŲ;8471369515;Taip;0;6;0;6
1809;"Du gaideliai";GAIDŽIUKŲ;79558840364;Taip;5;1;0;6
1810;"Du gaideliai";GAIDŽIUKŲ;71411267197;Taip;0;1;0;1
1811;"Du gaideliai";GAIDŽIUKŲ;8643242715;Taip;0;1;0;1
1812;"Du gaideliai";GAIDŽIUKŲ;87984135142;Taip;8;5;0;13
1813;"Du gaideliai";GAIDŽIUKŲ;40776415914;Taip;6;1;0;7
1814;"Du gaideliai";Musyčių;4144269068;Taip;20;0;0;20
1815;"Du gaideliai";Musyčių;3370029981;Taip;0;6;0;6
1816;"Du gaideliai";Musyčių;5103483956;Taip;0;2;0;2
1817;"Du gaideliai";Musyčių;4378924981;Taip;3;1;0;4
1818;"Du gaideliai";Musyčių;7373413569;Taip;12;3;0;15
1819;"Du gaideliai";Musyčių;6783206132;Taip;12;0;0;12
1820;"Du gaideliai";Musyčių;3507387826;Taip;7;8;0;15
1821;"Du gaideliai";Musyčių;1785976627;Taip;11;0;0;11
1822;"Du gaideliai";Musyčių;2921485707;Taip;4;0;0;4
1823;"Du gaideliai";Musyčių;5894974508;Taip;5;2;4;11
1824;"Du gaideliai";Musyčių;1135098595;Taip;1;5;0;6
1825;"Du gaideliai";Musyčių;5652662610;Taip;4;1;0;5
1826;"Du gaideliai";Musyčių;6348951959;Taip;19;0;0;19
1827;"Du gaideliai";Musyčių;3854355215;Taip;5;9;0;14
1828;"Du gaideliai";Musyčių;3849899284;Taip;11;0;0;11
1829;"Du gaideliai";Musyčių;2262425557;Taip;20;0;0;20
1830;"Du gaideliai";Musyčių;6417648753;Taip;2;0;10;12
1831;"Du gaideliai";MALŪNO;6247706405;Taip;10;0;0;10
1832;"Du gaideliai";MALŪNO;6870356241;Taip;10;3;0;13
1833;"Du gaideliai";MALŪNO;7033276798;Taip;7;0;0;7
1834;"Du gaideliai";MALŪNO;6053941133;Taip;0;6;0;6
1835;"Du gaideliai";MALŪNO;1268479215;Taip;14;0;0;14
1836;"Du gaideliai";MALŪNO;5728374219;Taip;10;0;0;10
1837;"Du gaideliai";MALŪNO;6015360076;Taip;0;14;0;14
1838;"Du gaideliai";MALŪNO;5998344519;Taip;12;0;2;14
1839;"Du gaideliai";MALŪNO;8043896286;Taip;20;0;0;20
1840;"Du gaideliai";MALŪNO;2240947701;Taip;8;0;3;11
1841;"Du gaideliai";MALŪNO;6120647567;Taip;13;1;0;14
1842;"Du gaideliai";MALŪNO;4798503931;Taip;10;0;0;10
1843;"Du gaideliai";MALŪNO;3247101840;Taip;15;0;0;15
1844;Eglutė;NYKŠTUKAI;5943856319;Taip;10;0;0;10
1845;Eglutė;NYKŠTUKAI;9402686801;Taip;0;15;0;15
1846;Eglutė;NYKŠTUKAI;2783338563;Taip;5;6;5;16
1847;Eglutė;NYKŠTUKAI;2252971349;Taip;10;0;0;10
1848;Eglutė;NYKŠTUKAI;6544877723;Taip;13;0;0;13
1849;Eglutė;NYKŠTUKAI;1050313582;Taip;15;0;0;15
1850;Eglutė;NYKŠTUKAI;1534556744;Taip;10;0;4;14
1851;Eglutė;NYKŠTUKAI;6093932811;Taip;2;3;5;10
1852;Eglutė;NYKŠTUKAI;3473388722;Taip;13;0;1;14
1853;Eglutė;NYKŠTUKAI;3006381069;Taip;0;0;5;5
1854;Eglutė;NYKŠTUKAI;5563593953;Taip;0;4;0;4
1855;Eglutė;NYKŠTUKAI;2597978713;Taip;0;0;11;11
1856;Eglutė;NYKŠTUKAI;6105927493;Taip;9;0;0;9
1857;Eglutė;NYKŠTUKAI;4230594049;Taip;11;0;1;12
1858;Eglutė;NYKŠTUKAI;5505398901;Taip;0;0;17;17
1859;Eglutė;NYKŠTUKAI;2651867769;Taip;7;0;1;8
1860;Eglutė;NYKŠTUKAI;8493750509;Taip;5;0;0;5
1861;Eglutė;NYKŠTUKAI;7491022301;Taip;3;0;2;5
1862;Eglutė;NYKŠTUKAI;3483007385;Taip;0;0;19;19
1863;Aušrinė;Varpeliai;40427909744;Taip;5;3;0;8
1864;Aušrinė;Varpeliai;73663919787;Taip;0;4;0;4
1865;Aušrinė;Varpeliai;1182643102;Taip;6;13;0;19
1866;Aušrinė;Varpeliai;2030227606;Taip;20;0;0;20
1867;Aušrinė;Varpeliai;51725342242;Ne;2;3;0;5
1868;Aušrinė;Varpeliai;1448250372;Taip;6;7;0;13
1869;Aušrinė;Varpeliai;68192824475;Taip;0;0;1;1
1870;Aušrinė;Varpeliai;69919525470;Taip;0;11;0;11
1871;Aušrinė;Varpeliai;11187944085;Taip;0;1;0;1
1872;Aušrinė;Varpeliai;1278319590;Taip;19;0;0;19
1873;Aušrinė;Varpeliai;3356127625;Taip;14;0;0;14
1874;Aušrinė;Varpeliai;1148796296;Taip;5;5;0;10
1875;Aušrinė;Varpeliai;1927141701;Taip;5;0;2;7
1876;Aušrinė;Varpeliai;1515536619;Taip;0;1;0;1
1877;Aušrinė;Varpeliai;1996032555;Taip;14;0;2;16
1878;Aušrinė;Varpeliai;9989277772;Taip;11;0;2;13
1879;Aušrinė;Varpeliai;5306416511;Taip;0;3;0;3
1880;Aušrinė;Varpeliai;1000417905;Taip;5;10;0;15
1881;Aušrinė;Bitutės;58768831540;Taip;12;1;0;13
1882;Aušrinė;Bitutės;97658375230;Taip;18;0;0;18
1883;Aušrinė;Bitutės;1303589037;Taip;0;5;0;5
1884;Aušrinė;Bitutės;1601648171;Taip;10;0;1;11
1885;Aušrinė;Bitutės;4903762612;Taip;11;0;0;11
1886;Aušrinė;Bitutės;17061806895;Taip;0;4;0;4
1887;Aušrinė;Bitutės;6443602669;Taip;0;0;4;4
1888;Aušrinė;Bitutės;7796318812;Taip;0;7;0;7
1889;Aušrinė;Bitutės;83017543760;Taip;0;1;0;1
1890;Aušrinė;Bitutės;6318538591;Taip;0;3;0;3
1891;Aušrinė;Bitutės;3035781587;Taip;5;0;0;5
1892;Aušrinė;Bitutės;9605160359;Taip;14;3;0;17
1893;Aušrinė;Bitutės;5090847702;Taip;2;0;2;4
1894;Aušrinė;Bitutės;25590576293;Taip;0;8;0;8
1895;Aušrinė;Bitutės;7507448059;Taip;5;0;0;5
1896;Aušrinė;Bitutės;1291308838;Taip;12;1;0;13
1897;Aušrinė;Bitutės;63299644698;Taip;14;2;0;16
1898;Aušrinė;Bitutės;2526585854;Taip;8;0;3;11
1899;Aušrinė;Drugeliai;32489318287;Taip;11;0;0;11
1900;Aušrinė;Drugeliai;1343667707;Taip;5;1;0;6
1901;Aušrinė;Drugeliai;96010737590;Taip;15;2;0;17
1902;Aušrinė;Drugeliai;5729812682;Taip;0;1;0;1
1903;Aušrinė;Drugeliai;1133359254;Taip;7;4;8;19
1904;Aušrinė;Drugeliai;30244366906;Taip;5;3;0;8
1905;Aušrinė;Drugeliai;1974161463;Taip;11;5;0;16
1906;Aušrinė;Drugeliai;1184543607;Taip;10;0;0;10
1907;Aušrinė;Drugeliai;1573790467;Taip;5;4;1;10
1908;Aušrinė;Drugeliai;1944291082;Taip;14;0;0;14
1909;Aušrinė;Drugeliai;48118825872;Taip;5;2;3;10
1910;Aušrinė;Drugeliai;2069277030;Taip;12;0;0;12
1911;Aušrinė;Drugeliai;1065470806;Taip;9;0;10;19
1912;Aušrinė;Drugeliai;1206863546;Taip;0;4;2;6
1913;Aušrinė;Drugeliai;2022412040;Taip;16;0;0;16
1914;Aušrinė;Drugeliai;1501614270;Taip;0;0;3;3
1915;Aušrinė;Drugeliai;6265909152;Taip;17;0;0;17
1916;Aušrinė;Drugeliai;1532235421;Taip;5;0;1;6
1917;Aušrinė;Drugeliai;2212814026;Taip;11;0;1;12
1918;Aušrinė;Boružėlės;7052024709;Taip;0;11;1;12
1919;Aušrinė;Boružėlės;1298127839;Taip;7;1;0;8
1920;Aušrinė;Boružėlės;8364033602;Taip;20;0;0;20
1921;Aušrinė;Boružėlės;1151612627;Taip;5;2;0;7
1922;Aušrinė;Boružėlės;1009453682;Taip;12;5;0;17
1923;Aušrinė;Boružėlės;3544848804;Taip;8;0;1;9
1924;Aušrinė;Boružėlės;6136579994;Taip;1;9;0;10
1925;Aušrinė;Boružėlės;8463758715;Taip;4;5;0;9
1926;Aušrinė;Boružėlės;4579700769;Taip;8;1;0;9
1927;Aušrinė;Boružėlės;7268811782;Taip;9;6;0;15
1928;Aušrinė;Boružėlės;3042409414;Taip;10;5;0;15
1929;Aušrinė;Boružėlės;1831094707;Taip;13;0;0;13
1930;Aušrinė;Boružėlės;3593323270;Taip;14;2;0;16
1931;Aušrinė;Boružėlės;3795927209;Taip;12;4;0;16
1932;Aušrinė;Boružėlės;5283207520;Taip;7;0;2;9
1933;Aušrinė;Boružėlės;1116822936;Taip;11;0;0;11
1934;Aušrinė;Boružėlės;6226967695;Taip;3;0;0;3
1935;Aušrinė;Boružėlės;9226214856;Taip;11;0;0;11
1936;Aušrinė;Boružėlės;4562536818;Taip;9;0;0;9
1937;Aušrinė;Boružėlės;71379978884;Ne;13;0;0;13
1938;Aušrinė;Zuikučiai;5776170550;Taip;19;0;0;19
1939;Aušrinė;Zuikučiai;9641020899;Taip;11;0;1;12
1940;Aušrinė;Zuikučiai;5277217733;Taip;20;0;0;20
1941;Aušrinė;Zuikučiai;6375484280;Taip;9;2;0;11
1942;Aušrinė;Zuikučiai;1502013942;Taip;11;3;4;18
1943;Aušrinė;Zuikučiai;2190583964;Taip;5;0;0;5
1944;Aušrinė;Zuikučiai;3920229653;Taip;5;0;5;10
1945;Aušrinė;Zuikučiai;5563356449;Taip;3;0;1;4
1946;Aušrinė;Zuikučiai;9501262918;Taip;4;0;1;5
1947;Aušrinė;Zuikučiai;8756465854;Taip;7;7;3;17
1948;Aušrinė;Zuikučiai;6756184787;Taip;20;0;0;20
1949;Aušrinė;Zuikučiai;4288487063;Taip;15;0;0;15
1950;Aušrinė;Zuikučiai;5768470608;Taip;14;0;0;14
1951;Aušrinė;Zuikučiai;1440531672;Taip;13;0;0;13
1952;Aušrinė;Zuikučiai;7194803557;Taip;20;0;0;20
1953;Aušrinė;Zuikučiai;2309358870;Taip;14;0;0;14
1954;Aušrinė;Zuikučiai;2304972692;Taip;10;4;2;16
1955;Aušrinė;Meškiukai;5204445760;Taip;4;9;0;13
1956;Aušrinė;Meškiukai;3269357241;Taip;0;8;0;8
1957;Aušrinė;Meškiukai;2583331243;Taip;10;3;0;13
1958;Aušrinė;Meškiukai;2948716989;Taip;9;6;0;15
1959;Aušrinė;Meškiukai;2055282010;Taip;9;0;0;9
1960;Aušrinė;Meškiukai;3346154143;Taip;6;3;0;9
1961;Aušrinė;Meškiukai;3276075664;Taip;12;0;1;13
1962;Aušrinė;Meškiukai;2778931038;Taip;11;0;4;15
1963;Aušrinė;Meškiukai;8092890260;Taip;6;3;0;9
1964;Aušrinė;Meškiukai;8465864375;Taip;12;0;3;15
1965;Aušrinė;Meškiukai;7784329873;Taip;10;0;0;10
1966;Aušrinė;Meškiukai;7089883250;Taip;0;12;0;12
1967;Aušrinė;Meškiukai;6525761466;Taip;20;0;0;20
1968;Aušrinė;Meškiukai;5043122065;Taip;16;0;0;16
1969;Aušrinė;Meškiukai;3998988004;Taip;6;6;2;14
1970;Aušrinė;Meškiukai;7358925256;Taip;6;0;0;6
1971;Aušrinė;Meškiukai;5128863532;Taip;13;0;2;15
1972;"Geniukų kalvė";SAULUTĖS;97391898211;Ne;0;1;1;2
1973;"Geniukų kalvė";SAULUTĖS;50484102538;Taip;0;6;0;6
1974;"Geniukų kalvė";SAULUTĖS;22439864337;Taip;0;1;0;1
1975;"Geniukų kalvė";SAULUTĖS;71971614175;Taip;5;0;0;5
1976;"Geniukų kalvė";SAULUTĖS;19739642721;Taip;0;5;0;5
1977;"Geniukų kalvė";SAULUTĖS;87723170266;Taip;0;3;0;3
1978;"Geniukų kalvė";SAULUTĖS;88770807216;Taip;0;13;2;15
1979;"Geniukų kalvė";SAULUTĖS;22867530415;Ne;0;2;0;2
1980;"Geniukų kalvė";SAULUTĖS;80569810851;Taip;3;1;0;4
1981;"Geniukų kalvė";SAULUTĖS;68771652481;Taip;0;13;0;13
1982;"Geniukų kalvė";SAULUTĖS;88828238496;Taip;0;2;0;2
1983;"Geniukų kalvė";SAULUTĖS;83181896988;Taip;3;0;0;3
1984;"Geniukų kalvė";SAULUTĖS;50839305875;Taip;16;4;0;20
1985;"Geniukų kalvė";SAULUTĖS;70163293669;Taip;0;0;2;2
1986;"Geniukų kalvė";SAULUTĖS;54754447084;Taip;0;4;0;4
1987;"Geniukų kalvė";SAULUTĖS;35212920132;Taip;0;6;0;6
1988;"Geniukų kalvė";SAULUTĖS;94596443429;Taip;5;1;0;6
1989;"Geniukų kalvė";SAULUTĖS;95119267553;Taip;10;3;0;13
1990;"Geniukų kalvė";SAULUTĖS;75895159280;Taip;8;0;0;8
1991;"Geniukų kalvė";SAULUTĖS;65948850463;Taip;3;1;1;5
1992;"Geniukų kalvė";SAULUTĖS;89508036774;Taip;6;4;0;10
1993;"Geniukų kalvė";SAULUTĖS;98495225027;Taip;16;4;0;20
1994;"Geniukų kalvė";BITUTĖS;7745656622;Taip;2;1;0;3
1995;"Geniukų kalvė";BITUTĖS;6520429663;Taip;5;0;0;5
1996;"Geniukų kalvė";BITUTĖS;6466912385;Taip;0;1;5;6
1997;"Geniukų kalvė";BITUTĖS;2718961466;Taip;20;0;0;20
1998;"Geniukų kalvė";BITUTĖS;4967513360;Taip;0;2;5;7
1999;"Geniukų kalvė";BITUTĖS;2016254460;Taip;0;5;0;5
2000;"Geniukų kalvė";BITUTĖS;5776314197;Taip;6;0;0;6
2001;"Geniukų kalvė";BITUTĖS;1897809684;Taip;0;1;3;4
2002;"Geniukų kalvė";BITUTĖS;4105170344;Taip;1;0;0;1
2003;"Geniukų kalvė";BITUTĖS;8872900558;Taip;0;2;1;3
2004;"Geniukų kalvė";BITUTĖS;6511955882;Taip;5;1;0;6
2005;"Geniukų kalvė";BITUTĖS;6500641378;Taip;8;5;0;13
2006;"Geniukų kalvė";BITUTĖS;2143334688;Taip;9;1;0;10
2007;"Geniukų kalvė";BITUTĖS;3984265624;Taip;0;0;1;1
2008;"Geniukų kalvė";BITUTĖS;4813232640;Taip;10;0;0;10
2009;"Geniukų kalvė";BITUTĖS;9676782662;Taip;2;0;0;2
2010;"Geniukų kalvė";BITUTĖS;4647433927;Taip;0;10;0;10
2011;"Geniukų kalvė";BITUTĖS;5257713434;Taip;0;10;0;10
2012;"Geniukų kalvė";BITUTĖS;2031800114;Taip;0;2;3;5
2013;"Geniukų kalvė";KIŠKUČIAI;1568133009;Taip;15;5;0;20
2014;"Geniukų kalvė";KIŠKUČIAI;7664689396;Taip;0;0;9;9
2015;"Geniukų kalvė";KIŠKUČIAI;4844734556;Taip;1;0;0;1
2016;"Geniukų kalvė";KIŠKUČIAI;4758435835;Taip;0;0;2;2
2017;"Geniukų kalvė";KIŠKUČIAI;2729442911;Taip;0;0;3;3
2018;"Geniukų kalvė";KIŠKUČIAI;4661051023;Taip;8;0;1;9
2019;"Geniukų kalvė";KIŠKUČIAI;23023070502;Taip;14;0;1;15
2020;"Geniukų kalvė";KIŠKUČIAI;8668696743;Ne;12;0;1;13
2021;"Geniukų kalvė";KIŠKUČIAI;2262014110;Taip;1;2;0;3
2022;"Geniukų kalvė";KIŠKUČIAI;1947173142;Taip;1;0;0;1
2023;"Geniukų kalvė";KIŠKUČIAI;43097490633;Taip;0;20;0;20
2024;"Geniukų kalvė";KIŠKUČIAI;23153198194;Taip;6;0;1;7
2025;"Geniukų kalvė";KIŠKUČIAI;2043786151;Taip;8;2;0;10
2026;"Geniukų kalvė";KIŠKUČIAI;1460456166;Taip;9;0;0;9
2027;"Geniukų kalvė";KIŠKUČIAI;8939171238;Taip;11;0;0;11
2028;"Geniukų kalvė";KIŠKUČIAI;7839383630;Taip;17;0;0;17
2029;"Geniukų kalvė";KIŠKUČIAI;2140334255;Taip;20;0;0;20
2030;"Geniukų kalvė";KIŠKUČIAI;2301758912;Taip;4;0;0;4
2031;"Geniukų kalvė";KIŠKUČIAI;8635708009;Taip;0;20;0;20
2032;"Geniukų kalvė";KIŠKUČIAI;9081596975;Taip;13;0;0;13
2033;"Geniukų kalvė";KIŠKUČIAI;2337226175;Taip;5;0;1;6
2034;"Geniukų kalvė";VYTURĖLIAI;91633670390;Taip;0;1;0;1
2035;"Geniukų kalvė";VYTURĖLIAI;27433933081;Taip;10;2;0;12
2036;"Geniukų kalvė";VYTURĖLIAI;93578160269;Ne;8;0;0;8
2037;"Geniukų kalvė";VYTURĖLIAI;73702027599;Ne;8;0;0;8
2038;"Geniukų kalvė";VYTURĖLIAI;43457570841;Ne;0;3;0;3
2039;"Geniukų kalvė";VYTURĖLIAI;83612705234;Taip;0;1;0;1
2040;"Geniukų kalvė";VYTURĖLIAI;92967424590;Taip;0;1;0;1
2041;"Geniukų kalvė";VYTURĖLIAI;91532192571;Taip;0;3;0;3
2042;"Geniukų kalvė";VYTURĖLIAI;60793380826;Taip;9;0;0;9
2043;"Geniukų kalvė";VYTURĖLIAI;71553800692;Taip;6;0;0;6
2044;"Geniukų kalvė";VYTURĖLIAI;32731577118;Taip;6;0;0;6
2045;"Geniukų kalvė";VYTURĖLIAI;2088336409;Taip;12;0;0;12
2046;"Geniukų kalvė";VYTURĖLIAI;21213070417;Ne;0;1;0;1
2047;"Geniukų kalvė";VYTURĖLIAI;28229850220;Taip;0;1;0;1
2048;"Geniukų kalvė";VYTURĖLIAI;89176368447;Ne;7;0;0;7
2049;"Geniukų kalvė";VYTURĖLIAI;92776604959;Taip;10;3;0;13
2050;"Geniukų kalvė";VYTURĖLIAI;53430469011;Taip;0;2;0;2
2051;"Geniukų kalvė";VYTURĖLIAI;77639318512;Taip;0;2;0;2
2052;"Geniukų kalvė";VYTURĖLIAI;1131917679;Taip;0;5;0;5
2053;"Geniukų kalvė";DRUGELIAI;46050191161;Taip;5;5;0;10
2054;"Geniukų kalvė";DRUGELIAI;11531299319;Taip;5;4;0;9
2055;"Geniukų kalvė";DRUGELIAI;37570191268;Taip;5;2;0;7
2056;"Geniukų kalvė";DRUGELIAI;41117619560;Taip;0;2;0;2
2057;"Geniukų kalvė";DRUGELIAI;80173832943;Ne;6;3;0;9
2058;"Geniukų kalvė";DRUGELIAI;79674404559;Taip;4;0;0;4
2059;"Geniukų kalvė";DRUGELIAI;50522707614;Taip;4;0;0;4
2060;"Geniukų kalvė";DRUGELIAI;72591209415;Taip;0;4;0;4
2061;"Geniukų kalvė";DRUGELIAI;56872543521;Taip;0;1;1;2
2062;"Geniukų kalvė";DRUGELIAI;90336374948;Taip;5;1;1;7
2063;"Geniukų kalvė";DRUGELIAI;23422495596;Taip;5;0;0;5
2064;"Geniukų kalvė";DRUGELIAI;20968739747;Taip;3;2;1;6
2065;"Geniukų kalvė";DRUGELIAI;64035235105;Ne;4;4;0;8
2066;"Geniukų kalvė";DRUGELIAI;59483867231;Taip;0;1;3;4
2067;"Geniukų kalvė";DRUGELIAI;1395993314;Taip;6;5;0;11
2068;"Geniukų kalvė";DRUGELIAI;1318135788;Taip;0;0;2;2
2069;"Geniukų kalvė";DRUGELIAI;9656415371;Taip;0;3;0;3
2070;"Geniukų kalvė";DRUGELIAI;6553877473;Taip;9;4;2;15
2071;"Geniukų kalvė";"SAULĖS ZUIKUČIAI";37079991701;Taip;4;0;1;5
2072;"Geniukų kalvė";"SAULĖS ZUIKUČIAI";49352255237;Taip;0;4;0;4
2073;"Geniukų kalvė";"SAULĖS ZUIKUČIAI";90227736128;Taip;5;10;0;15
2074;"Geniukų kalvė";"SAULĖS ZUIKUČIAI";54856843273;Taip;14;0;0;14
2075;"Geniukų kalvė";"SAULĖS ZUIKUČIAI";1806626063;Taip;0;2;1;3
2076;"Geniukų kalvė";"SAULĖS ZUIKUČIAI";88504194684;Taip;7;0;0;7
2077;"Geniukų kalvė";"SAULĖS ZUIKUČIAI";1776042329;Taip;5;3;1;9
2078;"Geniukų kalvė";"SAULĖS ZUIKUČIAI";1716204178;Taip;8;0;1;9
2079;"Geniukų kalvė";"SAULĖS ZUIKUČIAI";1774738349;Taip;7;0;0;7
2080;"Geniukų kalvė";"SAULĖS ZUIKUČIAI";2120890722;Taip;0;12;0;12
2081;"Geniukų kalvė";"SAULĖS ZUIKUČIAI";87718471880;Taip;0;4;0;4
2082;"Geniukų kalvė";"SAULĖS ZUIKUČIAI";1415719190;Taip;10;0;0;10
2083;"Geniukų kalvė";"SAULĖS ZUIKUČIAI";83443339743;Taip;0;20;0;20
2084;"Geniukų kalvė";"SAULĖS ZUIKUČIAI";26215340428;Taip;0;0;1;1
2085;"Geniukų kalvė";"SAULĖS ZUIKUČIAI";1084055203;Taip;3;2;0;5
2086;"Geniukų kalvė";"SAULĖS ZUIKUČIAI";75791398203;Taip;0;0;3;3
2087;"Geniukų kalvė";"SAULĖS ZUIKUČIAI";1810973279;Taip;11;0;0;11
2088;"Geniukų kalvė";"SAULĖS ZUIKUČIAI";2094764804;Taip;14;0;0;14
2089;"Geniukų kalvė";"SAULĖS ZUIKUČIAI";3553253934;Taip;17;0;0;17
2090;"Geniukų kalvė";"SAULĖS ZUIKUČIAI";2056340856;Ne;7;2;0;9
2091;"Geniukų kalvė";"SAULĖS ZUIKUČIAI";9669281441;Taip;20;0;0;20
2092;"Geniukų kalvė";SMALSUČIAI;44345867922;Taip;16;0;0;16
2093;"Geniukų kalvė";SMALSUČIAI;82277353185;Taip;0;0;3;3
2094;"Geniukų kalvė";SMALSUČIAI;19181427380;Taip;14;0;1;15
2095;"Geniukų kalvė";SMALSUČIAI;1684481833;Taip;14;0;0;14
2096;"Geniukų kalvė";SMALSUČIAI;14939415217;Taip;5;0;1;6
2097;"Geniukų kalvė";SMALSUČIAI;1990303616;Taip;15;1;0;16
2098;"Geniukų kalvė";SMALSUČIAI;62774512989;Taip;20;0;0;20
2099;"Geniukų kalvė";SMALSUČIAI;45542289762;Taip;0;4;5;9
2100;"Geniukų kalvė";SMALSUČIAI;23964009189;Taip;0;1;0;1
2101;"Geniukų kalvė";SMALSUČIAI;42328019754;Taip;0;2;0;2
2102;"Geniukų kalvė";SMALSUČIAI;90435684305;Taip;7;0;0;7
2103;"Geniukų kalvė";SMALSUČIAI;84974376966;Taip;0;6;0;6
2104;"Geniukų kalvė";SMALSUČIAI;97616612192;Taip;3;0;0;3
2105;"Geniukų kalvė";SMALSUČIAI;1031455575;Taip;3;0;0;3
2106;"Geniukų kalvė";SMALSUČIAI;93834840514;Taip;0;5;0;5
2107;"Geniukų kalvė";SMALSUČIAI;67762121244;Ne;2;4;0;6
2108;"Geniukų kalvė";SMALSUČIAI;1663744490;Taip;9;0;0;9
2109;"Geniukų kalvė";SMALSUČIAI;2003986836;Taip;20;0;0;20
2110;"Geniukų kalvė";SMALSUČIAI;1248190435;Taip;12;0;0;12
2111;"Geniukų kalvė";SMALSUČIAI;5792552722;Taip;0;5;1;6
2112;"Geniukų kalvė";SMALSUČIAI;6253940549;Taip;5;4;0;9
2113;"Geniukų kalvė";SMALSUČIAI;9416843495;Taip;3;0;0;3
2114;"Geniukų kalvė";RUDNOSIUKAI;2082749897;Taip;0;9;0;9
2115;"Geniukų kalvė";RUDNOSIUKAI;7352976665;Taip;16;0;0;16
2116;"Geniukų kalvė";RUDNOSIUKAI;12109348143;Taip;5;0;0;5
2117;"Geniukų kalvė";RUDNOSIUKAI;6728268857;Taip;0;3;3;6
2118;"Geniukų kalvė";RUDNOSIUKAI;87858628237;Taip;4;0;0;4
2119;"Geniukų kalvė";RUDNOSIUKAI;36553641202;Taip;0;7;0;7
2120;"Geniukų kalvė";RUDNOSIUKAI;36295276899;Taip;0;3;0;3
2121;"Geniukų kalvė";RUDNOSIUKAI;16810843163;Taip;0;3;0;3
2122;"Geniukų kalvė";RUDNOSIUKAI;75926614045;Taip;13;1;0;14
2123;"Geniukų kalvė";RUDNOSIUKAI;42849805342;Taip;7;0;0;7
2124;"Geniukų kalvė";RUDNOSIUKAI;51320722945;Ne;5;0;0;5
2125;"Geniukų kalvė";RUDNOSIUKAI;96448080708;Taip;5;1;0;6
2126;"Geniukų kalvė";RUDNOSIUKAI;1727967870;Taip;5;0;3;8
2127;"Geniukų kalvė";RUDNOSIUKAI;1794537433;Taip;2;0;0;2
2128;"Geniukų kalvė";RUDNOSIUKAI;29353737550;Taip;12;1;0;13
2129;"Geniukų kalvė";RUDNOSIUKAI;6928979691;Taip;2;1;0;3
2130;"Geniukų kalvė";RUDNOSIUKAI;73331235731;Taip;5;0;0;5
2131;"Geniukų kalvė";RUDNOSIUKAI;7269049874;Taip;10;0;0;10
2132;"Geniukų kalvė";PELĖDŽIUKAI;1933003833;Taip;0;1;3;4
2133;"Geniukų kalvė";PELĖDŽIUKAI;1624933726;Taip;10;0;0;10
2134;"Geniukų kalvė";PELĖDŽIUKAI;3599151643;Taip;6;0;0;6
2135;"Geniukų kalvė";PELĖDŽIUKAI;37670000746;Taip;5;4;0;9
2136;"Geniukų kalvė";PELĖDŽIUKAI;14839311346;Taip;0;2;0;2
2137;"Geniukų kalvė";PELĖDŽIUKAI;31140342871;Taip;1;0;5;6
2138;"Geniukų kalvė";PELĖDŽIUKAI;70097449722;Taip;0;9;0;9
2139;"Geniukų kalvė";PELĖDŽIUKAI;11476134327;Taip;0;1;0;1
2140;"Geniukų kalvė";PELĖDŽIUKAI;53385228310;Ne;5;7;2;14
2141;"Geniukų kalvė";PELĖDŽIUKAI;68752448767;Taip;8;0;0;8
2142;"Geniukų kalvė";PELĖDŽIUKAI;57595197116;Taip;1;1;0;2
2143;"Geniukų kalvė";PELĖDŽIUKAI;61225085978;Taip;0;8;0;8
2144;"Geniukų kalvė";PELĖDŽIUKAI;83623361401;Ne;7;3;0;10
2145;"Geniukų kalvė";PELĖDŽIUKAI;67649373235;Taip;10;0;0;10
2146;"Geniukų kalvė";PELĖDŽIUKAI;87751274075;Taip;12;0;1;13
2147;"Geniukų kalvė";PELĖDŽIUKAI;71884588832;Taip;10;0;3;13
2148;"Geniukų kalvė";PELĖDŽIUKAI;26733422046;Taip;0;0;7;7
2149;"Geniukų kalvė";PELĖDŽIUKAI;96267794763;Taip;0;0;5;5
2150;"Geniukų kalvė";PELĖDŽIUKAI;1658082075;Taip;0;0;4;4
2151;"Geniukų kalvė";PELĖDŽIUKAI;1239061261;Taip;0;1;0;1
2152;"Geniukų kalvė";PELĖDŽIUKAI;91734868433;Taip;5;2;0;7
2153;"Geniukų kalvė";BORUŽĖLĖS;33438588586;Taip;5;0;0;5
2154;"Geniukų kalvė";BORUŽĖLĖS;51353124475;Ne;0;1;3;4
2155;"Geniukų kalvė";BORUŽĖLĖS;1246234700;Taip;11;0;0;11
2156;"Geniukų kalvė";BORUŽĖLĖS;30865528880;Taip;5;0;0;5
2157;"Geniukų kalvė";BORUŽĖLĖS;66632618838;Taip;0;5;0;5
2158;"Geniukų kalvė";BORUŽĖLĖS;35180545728;Taip;0;2;2;4
2159;"Geniukų kalvė";BORUŽĖLĖS;96954076142;Taip;0;1;0;1
2160;"Geniukų kalvė";BORUŽĖLĖS;27479616927;Taip;6;0;0;6
2161;"Geniukų kalvė";BORUŽĖLĖS;30015301622;Taip;0;0;2;2
2162;"Geniukų kalvė";BORUŽĖLĖS;26912425905;Taip;0;0;2;2
2163;"Geniukų kalvė";BORUŽĖLĖS;38949678625;Taip;3;5;0;8
2164;"Geniukų kalvė";BORUŽĖLĖS;80957343774;Taip;7;0;1;8
2165;"Geniukų kalvė";BORUŽĖLĖS;50218457812;Taip;3;0;3;6
2166;"Geniukų kalvė";BORUŽĖLĖS;8916930503;Taip;5;0;1;6
2167;"Geniukų kalvė";BORUŽĖLĖS;2038860438;Taip;0;20;0;20
2168;"Geniukų kalvė";BORUŽĖLĖS;74161080879;Taip;8;0;1;9
2169;"Geniukų kalvė";BORUŽĖLĖS;93542861144;Taip;0;0;1;1
2170;"Geniukų kalvė";BORUŽĖLĖS;1923449545;Taip;0;0;1;1
2171;"Geniukų kalvė";BORUŽĖLĖS;1073117547;Taip;11;0;0;11
2172;"Geniukų kalvė";PAGRANDUKAI;2938446054;Taip;0;4;0;4
2173;"Geniukų kalvė";PAGRANDUKAI;1237228692;Taip;5;1;0;6
2174;"Geniukų kalvė";PAGRANDUKAI;6737863183;Taip;2;4;0;6
2175;"Geniukų kalvė";PAGRANDUKAI;9990243525;Taip;11;0;1;12
2176;"Geniukų kalvė";PAGRANDUKAI;6174114461;Taip;20;0;0;20
2177;"Geniukų kalvė";PAGRANDUKAI;3826265557;Taip;5;0;2;7
2178;"Geniukų kalvė";PAGRANDUKAI;5542539934;Taip;9;0;0;9
2179;"Geniukų kalvė";PAGRANDUKAI;5704223824;Taip;6;4;0;10
2180;"Geniukų kalvė";PAGRANDUKAI;6024288147;Taip;3;7;0;10
2181;"Geniukų kalvė";PAGRANDUKAI;1051563985;Taip;4;2;0;6
2182;"Geniukų kalvė";PAGRANDUKAI;6070945557;Taip;5;0;0;5
2183;"Geniukų kalvė";PAGRANDUKAI;2659298240;Taip;4;2;1;7
2184;"Geniukų kalvė";PAGRANDUKAI;2217221922;Taip;13;0;0;13
2185;"Geniukų kalvė";PAGRANDUKAI;8271041553;Taip;6;2;0;8
2186;"Geniukų kalvė";PAGRANDUKAI;9976423099;Taip;20;0;0;20
2187;"Geniukų kalvė";PAGRANDUKAI;3762178533;Taip;10;1;0;11
2188;"Geniukų kalvė";PAGRANDUKAI;2426186771;Taip;5;0;0;5
2189;"Geniukų kalvė";NYKŠTUKAI;8095693657;Taip;6;0;0;6
2190;"Geniukų kalvė";NYKŠTUKAI;4958738745;Taip;5;1;1;7
2191;"Geniukų kalvė";NYKŠTUKAI;4271763719;Taip;14;4;2;20
2192;"Geniukų kalvė";NYKŠTUKAI;9069256760;Taip;8;0;10;18
2193;"Geniukų kalvė";NYKŠTUKAI;7501831333;Taip;19;0;0;19
2194;"Geniukų kalvė";NYKŠTUKAI;3493492581;Taip;1;2;0;3
2195;"Geniukų kalvė";NYKŠTUKAI;3180116136;Taip;5;1;0;6
2196;"Geniukų kalvė";NYKŠTUKAI;2904091819;Taip;5;2;0;7
2197;"Geniukų kalvė";NYKŠTUKAI;5245434552;Taip;14;2;0;16
2198;"Geniukų kalvė";NYKŠTUKAI;6794151223;Taip;13;0;0;13
2199;"Geniukų kalvė";NYKŠTUKAI;4777155321;Taip;11;0;0;11
2200;"Geniukų kalvė";NYKŠTUKAI;4186376527;Taip;11;0;0;11
2201;"Geniukų kalvė";NYKŠTUKAI;6674038058;Taip;15;0;0;15
2202;"Geniukų kalvė";NYKŠTUKAI;5161535756;Taip;16;0;0;16
2203;"Geniukų kalvė";NYKŠTUKAI;3085228868;Taip;11;0;1;12
2204;"Geniukų kalvė";NYKŠTUKAI;1037854104;Taip;10;1;1;12
2205;"Geniukų kalvė";NYKŠTUKAI;1499735818;Taip;16;0;0;16
2206;Gelvonėlis;ĄŽUOLIUKAI;36610437375;Taip;0;2;0;2
2207;Gelvonėlis;ĄŽUOLIUKAI;48593832088;Taip;2;2;0;4
2208;Gelvonėlis;ĄŽUOLIUKAI;71199691102;Taip;0;8;0;8
2209;Gelvonėlis;ĄŽUOLIUKAI;2218767947;Taip;12;0;0;12
2210;Gelvonėlis;ĄŽUOLIUKAI;5393404051;Taip;13;0;0;13
2211;Gelvonėlis;ĄŽUOLIUKAI;7277516341;Taip;12;0;0;12
2212;Gelvonėlis;ĄŽUOLIUKAI;40127507796;Taip;10;6;0;16
2213;Gelvonėlis;ĄŽUOLIUKAI;98009116912;Taip;8;0;0;8
2214;Gelvonėlis;ĄŽUOLIUKAI;91507293029;Taip;5;3;0;8
2215;Gelvonėlis;ĄŽUOLIUKAI;79847096929;Taip;5;0;5;10
2216;Gelvonėlis;ĄŽUOLIUKAI;70550528579;Taip;14;2;0;16
2217;Gelvonėlis;ĄŽUOLIUKAI;51375531815;Taip;0;1;1;2
2218;Gelvonėlis;ĄŽUOLIUKAI;17021411833;Taip;0;1;0;1
2219;Gelvonėlis;ĄŽUOLIUKAI;9970883470;Taip;19;0;0;19
2220;Gelvonėlis;ĄŽUOLIUKAI;1902998389;Taip;0;8;0;8
2221;Gelvonėlis;ĄŽUOLIUKAI;7822842578;Taip;0;0;5;5
2222;Gelvonėlis;ĄŽUOLIUKAI;2146163687;Taip;10;0;0;10
2223;Gelvonėlis;ĄŽUOLIUKAI;71076083278;Taip;15;0;1;16
2224;Gelvonėlis;ĄŽUOLIUKAI;89916945860;Ne;0;1;0;1
2225;Gelvonėlis;ĄŽUOLIUKAI;1776015014;Taip;5;3;0;8
2226;Gelvonėlis;ĄŽUOLIUKAI;43250059460;Taip;0;1;0;1
2227;Gelvonėlis;ĄŽUOLIUKAI;22201650331;Taip;0;2;0;2
2228;Gelvonėlis;ŽVIRBLIUKAI;1772713183;Taip;20;0;0;20
2229;Gelvonėlis;ŽVIRBLIUKAI;1801724527;Ne;0;8;0;8
2230;Gelvonėlis;ŽVIRBLIUKAI;83360239551;Taip;0;0;18;18
2231;Gelvonėlis;ŽVIRBLIUKAI;21250325232;Taip;0;1;0;1
2232;Gelvonėlis;ŽVIRBLIUKAI;5798439412;Taip;5;0;0;5
2233;Gelvonėlis;ŽVIRBLIUKAI;23181505838;Taip;0;13;0;13
2234;Gelvonėlis;ŽVIRBLIUKAI;2997738880;Taip;0;0;3;3
2235;Gelvonėlis;ŽVIRBLIUKAI;1373771258;Taip;15;3;0;18
2236;Gelvonėlis;ŽVIRBLIUKAI;92420286100;Taip;12;2;0;14
2237;Gelvonėlis;ŽVIRBLIUKAI;41610307448;Taip;10;0;1;11
2238;Gelvonėlis;ŽVIRBLIUKAI;87746258537;Taip;9;8;0;17
2239;Gelvonėlis;ŽVIRBLIUKAI;6635285387;Taip;6;0;0;6
2240;Gelvonėlis;ŽVIRBLIUKAI;1938913528;Taip;6;8;0;14
2241;Gelvonėlis;ŽVIRBLIUKAI;2096702999;Taip;8;2;1;11
2242;Gelvonėlis;ŽVIRBLIUKAI;17044138057;Taip;0;0;3;3
2243;Gelvonėlis;ŽVIRBLIUKAI;84863800926;Taip;2;6;1;9
2244;Gelvonėlis;ŽVIRBLIUKAI;1355742622;Taip;6;4;0;10
2245;Gelvonėlis;ŽVIRBLIUKAI;90961913967;Taip;14;0;0;14
2246;Gelvonėlis;ŽVIRBLIUKAI;1827511187;Taip;10;0;0;10
2247;Gelvonėlis;ŽVIRBLIUKAI;1835508505;Taip;6;0;4;10
2248;Gelvonėlis;ŽVIRBLIUKAI;9784762153;Taip;0;11;5;16
2249;Gelvonėlis;ŽVIRBLIUKAI;9919860358;Taip;11;0;0;11
2250;Gelvonėlis;RASELĖS;27296649662;Taip;6;1;0;7
2251;Gelvonėlis;RASELĖS;11994848859;Taip;0;1;2;3
2252;Gelvonėlis;RASELĖS;32532059858;Taip;3;0;0;3
2253;Gelvonėlis;RASELĖS;40035134521;Taip;0;10;0;10
2254;Gelvonėlis;RASELĖS;57163457394;Taip;0;4;0;4
2255;Gelvonėlis;RASELĖS;23568664214;Taip;0;4;0;4
2256;Gelvonėlis;RASELĖS;41750260566;Taip;0;4;0;4
2257;Gelvonėlis;RASELĖS;3461354329;Taip;0;2;0;2
2258;Gelvonėlis;RASELĖS;95413117888;Taip;0;6;0;6
2259;Gelvonėlis;RASELĖS;3325116198;Taip;0;4;1;5
2260;Gelvonėlis;RASELĖS;2153676615;Taip;0;10;0;10
2261;Gelvonėlis;RASELĖS;87254295179;Taip;0;11;0;11
2262;Gelvonėlis;RASELĖS;47302438188;Taip;6;0;0;6
2263;Gelvonėlis;RASELĖS;66162315180;Taip;0;5;0;5
2264;Gelvonėlis;RASELĖS;32893563601;Taip;6;0;0;6
2265;Gelvonėlis;RASELĖS;18324768783;Taip;0;1;0;1
2266;Gelvonėlis;RASELĖS;11697172905;Taip;11;3;0;14
2267;Gelvonėlis;RASELĖS;1221420212;Taip;6;3;0;9
2268;Gelvonėlis;RASELĖS;43145774484;Taip;5;0;3;8
2269;Gelvonėlis;RASELĖS;18237108866;Taip;0;7;0;7
2270;Gelvonėlis;RASELĖS;3271118581;Taip;9;0;0;9
2271;Gelvonėlis;RASELĖS;79607769503;Ne;10;4;0;14
2272;Gelvonėlis;RASELĖS;96792124844;Ne;10;4;0;14
2273;Gelvonėlis;SAULUTĖ;35428558838;Taip;19;0;0;19
2274;Gelvonėlis;SAULUTĖ;57792200616;Taip;6;1;0;7
2275;Gelvonėlis;SAULUTĖ;84202281636;Taip;0;1;0;1
2276;Gelvonėlis;SAULUTĖ;38629832653;Taip;1;5;0;6
2277;Gelvonėlis;SAULUTĖ;473144281;Taip;1;0;0;1
2278;Gelvonėlis;SAULUTĖ;81833782531;Taip;5;2;0;7
2279;Gelvonėlis;SAULUTĖ;72048682220;Taip;4;4;0;8
2280;Gelvonėlis;SAULUTĖ;33845988568;Taip;4;2;0;6
2281;Gelvonėlis;SAULUTĖ;66520207357;Taip;10;1;0;11
2282;Gelvonėlis;SAULUTĖ;45588179697;Taip;5;5;0;10
2283;Gelvonėlis;SAULUTĖ;4316492518;Taip;0;2;0;2
2284;Gelvonėlis;SAULUTĖ;17005717219;Taip;0;10;0;10
2285;Gelvonėlis;SAULUTĖ;59265250104;Taip;0;6;0;6
2286;Gelvonėlis;SAULUTĖ;6346945643;Taip;6;5;0;11
2287;Gelvonėlis;SAULUTĖ;35992063196;Taip;0;3;0;3
2288;Gelvonėlis;SAULUTĖ;11807134557;Taip;0;1;0;1
2289;Gelvonėlis;SAULUTĖ;80973545044;Taip;0;0;20;20
2290;Gelvonėlis;PELĖDŽIUKAI;72281404967;Taip;4;0;2;6
2291;Gelvonėlis;PELĖDŽIUKAI;58820730862;Taip;0;3;0;3
2292;Gelvonėlis;PELĖDŽIUKAI;15735896493;Taip;0;0;2;2
2293;Gelvonėlis;PELĖDŽIUKAI;59868339873;Taip;0;13;0;13
2294;Gelvonėlis;PELĖDŽIUKAI;91191192491;Taip;0;8;0;8
2295;Gelvonėlis;PELĖDŽIUKAI;2044305781;Taip;0;2;0;2
2296;Gelvonėlis;PELĖDŽIUKAI;54577279896;Taip;10;4;2;16
2297;Gelvonėlis;PELĖDŽIUKAI;71918920181;Taip;5;5;0;10
2298;Gelvonėlis;PELĖDŽIUKAI;90921912769;Ne;5;11;0;16
2299;Gelvonėlis;PELĖDŽIUKAI;45653629924;Taip;0;14;0;14
2300;Gelvonėlis;PELĖDŽIUKAI;52663286630;Taip;5;4;2;11
2301;Gelvonėlis;PELĖDŽIUKAI;16588607945;Taip;0;16;0;16
2302;Gelvonėlis;PELĖDŽIUKAI;10505090360;Taip;7;4;0;11
2303;Gelvonėlis;PELĖDŽIUKAI;9898346862;Taip;0;11;3;14
2304;Gelvonėlis;PELĖDŽIUKAI;15109448940;Taip;0;1;1;2
2305;Gelvonėlis;PELĖDŽIUKAI;3227827255;Taip;8;0;0;8
2306;Gelvonėlis;PELĖDŽIUKAI;75070203296;Taip;9;1;3;13
2307;Gelvonėlis;PELĖDŽIUKAI;1955777921;Taip;10;1;0;11
2308;Gelvonėlis;PELĖDŽIUKAI;24391920760;Taip;10;4;0;14
2309;Gelvonėlis;PELĖDŽIUKAI;31736209837;Taip;9;1;0;10
2310;Gelvonėlis;PELĖDŽIUKAI;67940634367;Taip;5;2;1;8
2311;Gelvonėlis;PELĖDŽIUKAI;83653321747;Taip;6;4;0;10
2312;Gelvonėlis;DRUGELIAI;5098282548;Taip;12;0;0;12
2313;Gelvonėlis;DRUGELIAI;50383394228;Ne;10;4;0;14
2314;Gelvonėlis;DRUGELIAI;68841073274;Taip;8;5;0;13
2315;Gelvonėlis;DRUGELIAI;1775227032;Taip;4;1;0;5
2316;Gelvonėlis;DRUGELIAI;67365224459;Taip;10;0;0;10
2317;Gelvonėlis;DRUGELIAI;1042715433;Ne;16;1;0;17
2318;Gelvonėlis;DRUGELIAI;59592904001;Taip;6;6;0;12
2319;Gelvonėlis;DRUGELIAI;5759356754;Taip;11;0;0;11
2320;Gelvonėlis;DRUGELIAI;6405741006;Taip;14;0;0;14
2321;Gelvonėlis;DRUGELIAI;9595350871;Taip;4;1;0;5
2322;Gelvonėlis;DRUGELIAI;1750552925;Taip;0;15;0;15
2323;Gelvonėlis;DRUGELIAI;26468121179;Taip;0;6;0;6
2324;Gelvonėlis;DRUGELIAI;19782508652;Taip;9;1;0;10
2325;Gelvonėlis;DRUGELIAI;86895427397;Taip;2;1;0;3
2326;Gelvonėlis;DRUGELIAI;3859776410;Taip;6;1;0;7
2327;Gelvonėlis;DRUGELIAI;19955601762;Taip;16;0;0;16
2328;Gelvonėlis;DRUGELIAI;71806077882;Taip;19;1;0;20
2329;Gelvonėlis;DRUGELIAI;8475204684;Taip;5;3;0;8
2330;Gelvonėlis;DRUGELIAI;4830374546;Taip;16;4;0;20
2331;Gelvonėlis;DRUGELIAI;6226970200;Taip;11;0;0;11
2332;Gelvonėlis;DRUGELIAI;2622967319;Taip;6;5;0;11
2333;Gelvonėlis;VARPELIAI;3059903126;Taip;10;0;5;15
2334;Gelvonėlis;VARPELIAI;9149117970;Taip;0;7;6;13
2335;Gelvonėlis;VARPELIAI;3483144401;Taip;5;0;2;7
2336;Gelvonėlis;VARPELIAI;6451557430;Taip;1;5;0;6
2337;Gelvonėlis;VARPELIAI;6225854165;Taip;14;0;0;14
2338;Gelvonėlis;VARPELIAI;2791652988;Taip;2;0;0;2
2339;Gelvonėlis;VARPELIAI;2638430817;Taip;7;0;7;14
2340;Gelvonėlis;VARPELIAI;9396676137;Taip;6;0;0;6
2341;Gelvonėlis;VARPELIAI;9353066785;Taip;10;0;0;10
2342;Gelvonėlis;VARPELIAI;9059244134;Taip;12;0;0;12
2343;Gelvonėlis;VARPELIAI;1987204544;Taip;0;5;0;5
2344;Gelvonėlis;VARPELIAI;8515746171;Taip;14;0;0;14
2345;Gelvonėlis;VARPELIAI;9600526942;Taip;0;0;16;16
2346;Gelvonėlis;VARPELIAI;1387948936;Taip;0;0;11;11
2347;Gelvonėlis;VARPELIAI;3121251271;Taip;0;0;2;2
2348;Gelvonėlis;VARPELIAI;1462716950;Taip;14;0;0;14
2349;Gelvonėlis;VARPELIAI;6949090250;Taip;20;0;0;20
2350;Gelvonėlis;BORUŽĖLĖS;22575527531;Taip;0;6;0;6
2351;Gelvonėlis;BORUŽĖLĖS;1163833201;Taip;16;1;0;17
2352;Gelvonėlis;BORUŽĖLĖS;1236944078;Taip;11;3;0;14
2353;Gelvonėlis;BORUŽĖLĖS;3379601736;Taip;0;12;0;12
2354;Gelvonėlis;BORUŽĖLĖS;1597669426;Taip;9;0;0;9
2355;Gelvonėlis;BORUŽĖLĖS;31744699590;Taip;3;7;0;10
2356;Gelvonėlis;BORUŽĖLĖS;9108760720;Taip;0;7;0;7
2357;Gelvonėlis;BORUŽĖLĖS;9777094764;Taip;14;0;0;14
2358;Gelvonėlis;BORUŽĖLĖS;3936144045;Taip;0;2;0;2
2359;Gelvonėlis;BORUŽĖLĖS;12715604772;Taip;0;4;0;4
2360;Gelvonėlis;BORUŽĖLĖS;8050788182;Taip;8;8;0;16
2361;Gelvonėlis;BORUŽĖLĖS;30812081628;Taip;15;0;0;15
2362;Gelvonėlis;BORUŽĖLĖS;1183745610;Taip;6;5;0;11
2363;Gelvonėlis;BORUŽĖLĖS;1836155450;Taip;9;3;0;12
2364;Gelvonėlis;BORUŽĖLĖS;1400871061;Taip;7;0;0;7
2365;Gelvonėlis;BORUŽĖLĖS;87693970225;Taip;0;17;0;17
2366;Gelvonėlis;BORUŽĖLĖS;69221565557;Taip;9;0;0;9
2367;Gelvonėlis;BORUŽĖLĖS;79899652046;Taip;12;0;0;12
2368;Gelvonėlis;BORUŽĖLĖS;7903272826;Taip;18;1;0;19
2369;Gelvonėlis;NYKŠTUKAI;6604992169;Taip;15;3;0;18
2370;Gelvonėlis;NYKŠTUKAI;6556472766;Taip;19;1;0;20
2371;Gelvonėlis;NYKŠTUKAI;7182180008;Taip;2;1;0;3
2372;Gelvonėlis;NYKŠTUKAI;6598178467;Taip;11;1;1;13
2373;Gelvonėlis;NYKŠTUKAI;8885088900;Taip;11;1;0;12
2374;Gelvonėlis;NYKŠTUKAI;8622621570;Taip;20;0;0;20
2375;Gelvonėlis;NYKŠTUKAI;2400289466;Taip;14;2;0;16
2376;Gelvonėlis;NYKŠTUKAI;5129492284;Taip;0;1;0;1
2377;Gelvonėlis;NYKŠTUKAI;9493536517;Taip;1;0;0;1
2378;Gelvonėlis;NYKŠTUKAI;2288951845;Taip;3;4;0;7
2379;Gelvonėlis;NYKŠTUKAI;2515471132;Taip;0;0;4;4
2380;Gelvonėlis;NYKŠTUKAI;6505814802;Taip;7;1;0;8
2381;Gelvonėlis;NYKŠTUKAI;6319058542;Taip;9;0;0;9
2382;Gelvonėlis;NYKŠTUKAI;9538571448;Taip;14;0;0;14
2383;Gelvonėlis;NYKŠTUKAI;9147186080;Taip;15;2;0;17
2384;Gelvonėlis;NYKŠTUKAI;7919814808;Taip;12;2;0;14
2385;Gelvonėlis;BITUTĖS;7759317220;Taip;14;0;0;14
2386;Gelvonėlis;BITUTĖS;6196065515;Taip;2;0;0;2
2387;Gelvonėlis;BITUTĖS;2504468098;Taip;0;9;0;9
2388;Gelvonėlis;BITUTĖS;7983982378;Taip;0;5;0;5
2389;Gelvonėlis;BITUTĖS;5721858659;Taip;8;0;0;8
2390;Gelvonėlis;BITUTĖS;9667024635;Taip;6;3;0;9
2391;Gelvonėlis;BITUTĖS;9323579468;Taip;14;0;0;14
2392;Gelvonėlis;BITUTĖS;4855800131;Taip;8;1;0;9
2393;Gelvonėlis;BITUTĖS;1753617545;Taip;15;0;0;15
2394;Gelvonėlis;BITUTĖS;6189110767;Taip;1;1;0;2
2395;Gelvonėlis;BITUTĖS;3843881329;Taip;1;0;0;1
2396;Gelvonėlis;BITUTĖS;9184192787;Taip;7;2;0;9
2397;Gelvonėlis;BITUTĖS;9369121356;Taip;9;0;0;9
2398;Gelvonėlis;BITUTĖS;2119550116;Taip;14;0;0;14
2399;Gelvonėlis;BITUTĖS;9286500887;Taip;0;4;6;10
2400;Gelvonėlis;BITUTĖS;5095782784;Taip;14;0;0;14
2401;Gelvonėlis;BITUTĖS;1516164123;Taip;7;3;0;10
2402;Gelvonėlis;BITUTĖS;7226051965;Taip;0;0;13;13
2403;Gelvonėlis;BITUTĖS;3788522708;Taip;0;3;0;3
2404;Gelvonėlis;RAMUNĖLĖS;5047022305;Taip;5;0;1;6
2405;Gelvonėlis;RAMUNĖLĖS;1085845218;Taip;14;0;0;14
2406;Gelvonėlis;RAMUNĖLĖS;5511174729;Taip;19;0;0;19
2407;Gelvonėlis;RAMUNĖLĖS;1284359362;Taip;0;4;0;4
2408;Gelvonėlis;RAMUNĖLĖS;69073786634;Taip;3;0;0;3
2409;Gelvonėlis;RAMUNĖLĖS;8775661719;Taip;0;1;0;1
2410;Gelvonėlis;RAMUNĖLĖS;6255253658;Taip;0;1;1;2
2411;Gelvonėlis;RAMUNĖLĖS;21684706944;Taip;0;3;0;3
2412;Gelvonėlis;RAMUNĖLĖS;75676389361;Taip;20;0;0;20
2413;Gelvonėlis;RAMUNĖLĖS;9387523651;Taip;5;7;0;12
2414;Gelvonėlis;RAMUNĖLĖS;2140799517;Taip;0;2;0;2
2415;Gelvonėlis;RAMUNĖLĖS;3830940009;Taip;0;2;0;2
2416;Gelvonėlis;RAMUNĖLĖS;3089755141;Taip;15;0;0;15
2417;Gelvonėlis;RAMUNĖLĖS;2077783219;Taip;0;1;1;2
2418;Gelvonėlis;RAMUNĖLĖS;1408313697;Taip;6;3;0;9
2419;Gelvonėlis;RAMUNĖLĖS;3670612781;Taip;0;1;0;1
2420;Gelvonėlis;RAMUNĖLĖS;1624125024;Taip;9;7;0;16
2421;Gelvonėlis;RAMUNĖLĖS;3147489259;Taip;5;8;0;13
2422;Gervelė;ŽIRNIUKAI;3525060645;Taip;12;1;0;13
2423;Gervelė;ŽIRNIUKAI;94487630173;Taip;8;0;1;9
2424;Gervelė;ŽIRNIUKAI;2551280794;Taip;0;16;0;16
2425;Gervelė;ŽIRNIUKAI;7302238728;Taip;5;1;0;6
2426;Gervelė;ŽIRNIUKAI;5989713844;Taip;10;0;0;10
2427;Gervelė;ŽIRNIUKAI;4560752068;Taip;0;3;0;3
2428;Gervelė;ŽIRNIUKAI;87619285504;Taip;19;0;0;19
2429;Gervelė;ŽIRNIUKAI;1991238577;Taip;0;3;0;3
2430;Gervelė;ŽIRNIUKAI;9515308666;Taip;7;9;0;16
2431;Gervelė;ŽIRNIUKAI;1616949023;Taip;10;0;3;13
2432;Gervelė;ŽIRNIUKAI;4943974662;Taip;13;5;0;18
2433;Gervelė;ŽIRNIUKAI;8152446576;Taip;11;2;0;13
2434;Gervelė;ŽIRNIUKAI;6967078836;Taip;5;0;0;5
2435;Gervelė;ŽIRNIUKAI;3015424614;Taip;12;0;4;16
2436;Gervelė;ŽIRNIUKAI;1704033440;Taip;1;1;0;2
2437;Gervelė;ŽIRNIUKAI;89076506192;Taip;15;0;0;15
2438;Gervelė;ŽIRNIUKAI;2167744244;Taip;10;5;0;15
2439;Gervelė;ŽIRNIUKAI;3427400844;Taip;9;3;0;12
2440;Gervelė;ŽIRNIUKAI;7697761552;Taip;8;1;0;9
2441;Gervelė;LAŠIUKAI;52142182972;Taip;5;1;0;6
2442;Gervelė;LAŠIUKAI;73803372762;Taip;0;0;5;5
2443;Gervelė;LAŠIUKAI;1697536098;Taip;0;6;0;6
2444;Gervelė;LAŠIUKAI;1617055167;Taip;0;14;0;14
2445;Gervelė;LAŠIUKAI;3278950938;Taip;0;0;2;2
2446;Gervelė;LAŠIUKAI;1492459180;Taip;0;8;0;8
2447;Gervelė;LAŠIUKAI;49013139623;Taip;5;0;0;5
2448;Gervelė;LAŠIUKAI;2019214634;Taip;20;0;0;20
2449;Gervelė;LAŠIUKAI;1860333208;Taip;19;0;0;19
2450;Gervelė;LAŠIUKAI;8454703111;Taip;0;1;0;1
2451;Gervelė;LAŠIUKAI;1921567602;Taip;8;0;0;8
2452;Gervelė;LAŠIUKAI;88273293270;Taip;12;0;0;12
2453;Gervelė;LAŠIUKAI;8035942210;Taip;5;8;0;13
2454;Gervelė;LAŠIUKAI;2191126539;Taip;10;0;0;10
2455;Gervelė;LAŠIUKAI;2632272974;Taip;0;12;0;12
2456;Gervelė;LAŠIUKAI;62782512806;Taip;9;5;0;14
2457;Gervelė;LAŠIUKAI;85689668690;Taip;8;1;0;9
2458;Gervelė;LAŠIUKAI;1792726318;Ne;5;11;0;16
2459;Gervelė;PABIRUČIAI;48497142461;Ne;5;0;0;5
2460;Gervelė;PABIRUČIAI;1928679740;Taip;0;0;1;1
2461;Gervelė;PABIRUČIAI;24724452164;Taip;2;0;0;2
2462;Gervelė;PABIRUČIAI;30126718224;Taip;0;5;0;5
2463;Gervelė;PABIRUČIAI;15891512215;Taip;10;0;1;11
2464;Gervelė;PABIRUČIAI;65086547895;Taip;3;6;0;9
2465;Gervelė;PABIRUČIAI;32101040739;Taip;5;0;6;11
2466;Gervelė;PABIRUČIAI;97418410809;Ne;0;4;0;4
2467;Gervelė;PABIRUČIAI;4265845947;Taip;5;0;0;5
2468;Gervelė;PABIRUČIAI;44678807307;Ne;0;0;5;5
2469;Gervelė;PABIRUČIAI;5085234839;Taip;10;0;0;10
2470;Gervelė;PABIRUČIAI;65751519550;Taip;10;0;0;10
2471;Gervelė;PABIRUČIAI;1303396562;Taip;6;0;7;13
2472;Gervelė;PABIRUČIAI;2017094793;Taip;0;0;1;1
2473;Gervelė;PABIRUČIAI;76731434799;Taip;20;0;0;20
2474;Gervelė;PABIRUČIAI;8302493906;Ne;5;5;0;10
2475;Gervelė;PABIRUČIAI;1371549808;Taip;0;8;0;8
2476;Gervelė;PABIRUČIAI;27435616549;Taip;0;1;0;1
2477;Gervelė;PABIRUČIAI;1413157604;Taip;0;0;1;1
2478;Gervelė;BITUTĖS;98970443751;Taip;2;0;0;2
2479;Gervelė;BITUTĖS;47945657061;Taip;14;1;0;15
2480;Gervelė;BITUTĖS;64688647985;Taip;7;1;0;8
2481;Gervelė;BITUTĖS;1545499809;Taip;11;4;0;15
2482;Gervelė;BITUTĖS;73134084618;Taip;0;1;0;1
2483;Gervelė;BITUTĖS;59156024051;Taip;14;0;0;14
2484;Gervelė;BITUTĖS;12701715977;Taip;0;1;0;1
2485;Gervelė;BITUTĖS;29756975817;Taip;0;6;0;6
2486;Gervelė;BITUTĖS;33044536438;Ne;7;1;0;8
2487;Gervelė;BITUTĖS;1897895689;Taip;10;1;0;11
2488;Gervelė;BITUTĖS;87075838181;Taip;5;1;0;6
2489;Gervelė;BITUTĖS;85855349922;Taip;5;9;0;14
2490;Gervelė;BITUTĖS;75507305203;Taip;0;8;0;8
2491;Gervelė;BITUTĖS;4092917137;Taip;11;0;0;11
2492;Gervelė;BURATINO;54142931109;Taip;0;12;0;12
2493;Gervelė;BURATINO;1772051140;Taip;0;5;0;5
2494;Gervelė;BURATINO;1690867495;Taip;3;0;0;3
2495;Gervelė;BURATINO;29832889771;Taip;15;1;0;16
2496;Gervelė;BURATINO;1815418720;Taip;0;12;0;12
2497;Gervelė;BURATINO;1106442860;Taip;6;0;0;6
2498;Gervelė;BURATINO;80029915729;Taip;0;11;0;11
2499;Gervelė;BURATINO;6168558862;Taip;0;15;0;15
2500;Gervelė;BURATINO;92859033264;Taip;0;2;0;2
2501;Gervelė;BURATINO;1083567209;Taip;19;0;0;19
2502;Gervelė;BURATINO;3784549444;Taip;11;6;0;17
2503;Gervelė;BURATINO;7620764911;Taip;8;0;3;11
2504;Gervelė;BURATINO;5440557094;Taip;15;0;0;15
2505;Gervelė;BURATINO;9202293067;Taip;8;0;0;8
2506;Gervelė;BURATINO;8195558041;Taip;6;12;0;18
2507;Gervelė;BURATINO;9909794030;Taip;0;8;0;8
2508;Gervelė;BURATINO;3022690832;Taip;6;3;0;9
2509;Gervelė;BURATINO;3825101647;Ne;20;0;0;20
2510;Gervelė;VIŠČIUKŲ;4394752176;Taip;0;11;0;11
2511;Gervelė;VIŠČIUKŲ;7020599764;Taip;2;0;0;2
2512;Gervelė;VIŠČIUKŲ;5953552777;Taip;0;5;0;5
2513;Gervelė;VIŠČIUKŲ;6951455424;Taip;0;0;1;1
2514;Gervelė;VIŠČIUKŲ;8016341646;Taip;14;0;0;14
2515;Gervelė;VIŠČIUKŲ;6263562066;Ne;5;0;0;5
2516;Gervelė;VIŠČIUKŲ;9970293084;Taip;16;1;0;17
2517;Gervelė;VIŠČIUKŲ;6287806975;Taip;9;0;3;12
2518;Gervelė;VIŠČIUKŲ;5267617723;Taip;11;1;0;12
2519;Gervelė;VIŠČIUKŲ;1400044294;Taip;9;5;0;14
2520;Gervelė;VIŠČIUKŲ;7935059565;Taip;4;0;1;5
2521;Gervelė;VIŠČIUKŲ;8012122042;Taip;5;0;0;5
2522;Gervelė;VIŠČIUKŲ;7050837754;Taip;6;0;3;9
2523;Gervelė;VIŠČIUKŲ;6228025635;Taip;6;0;0;6
2524;Gervelė;VIŠČIUKŲ;2185853339;Taip;8;0;0;8
2525;Gervelė;VIŠČIUKŲ;8840658383;Taip;8;0;1;9
2526;Gervelė;VIŠČIUKŲ;5685222621;Taip;2;0;1;3
2527;Gilužis;Skruzdėliukų;35511006307;Taip;17;0;0;17
2528;Gilužis;Skruzdėliukų;44807904472;Taip;15;0;0;15
2529;Gilužis;Skruzdėliukų;1671692484;Taip;5;1;0;6
2530;Gilužis;Skruzdėliukų;1615293331;Taip;1;2;0;3
2531;Gilužis;Skruzdėliukų;5161095299;Taip;8;0;0;8
2532;Gilužis;Skruzdėliukų;70959404439;Taip;0;3;0;3
2533;Gilužis;Skruzdėliukų;8120898865;Taip;9;0;0;9
2534;Gilužis;Skruzdėliukų;8840822243;Taip;13;0;0;13
2535;Gilužis;Skruzdėliukų;4611735601;Taip;17;1;0;18
2536;Gilužis;Skruzdėliukų;4747769984;Taip;5;0;0;5
2537;Gilužis;Skruzdėliukų;5920357223;Taip;4;4;0;8
2538;Gilužis;Skruzdėliukų;8595541498;Taip;8;1;0;9
2539;Gilužis;Skruzdėliukų;5365582271;Taip;1;6;0;7
2540;Gilužis;Skruzdėliukų;7364297673;Taip;15;0;0;15
2541;Gilužis;Skruzdėliukų;4362244070;Taip;12;1;0;13
2542;Gilužis;Skruzdėliukų;2093487071;Taip;11;0;5;16
2543;Gilužis;Skruzdėliukų;2042514241;Taip;1;0;1;2
2544;Gilužis;Skruzdėliukų;2218793969;Taip;18;0;0;18
2545;Gilužis;Skruzdėliukų;3216004438;Taip;10;5;0;15
2546;Gilužis;Skruzdėliukų;7766747590;Taip;12;0;0;12
2547;Gilužis;Nykštukų;94828544657;Taip;9;1;0;10
2548;Gilužis;Nykštukų;65865096435;Taip;0;2;0;2
2549;Gilužis;Nykštukų;41863620605;Taip;11;0;0;11
2550;Gilužis;Nykštukų;10456837723;Taip;7;0;0;7
2551;Gilužis;Nykštukų;18927429626;Taip;5;1;0;6
2552;Gilužis;Nykštukų;30714242097;Taip;0;0;2;2
2553;Gilužis;Nykštukų;72071736122;Taip;0;1;0;1
2554;Gilužis;Nykštukų;25086526218;Taip;2;1;0;3
2555;Gilužis;Nykštukų;37179053472;Taip;0;4;0;4
2556;Gilužis;Nykštukų;64182110384;Taip;0;20;0;20
2557;Gilužis;Nykštukų;51989833076;Taip;0;8;0;8
2558;Gilužis;Nykštukų;36855170422;Taip;0;1;2;3
2559;Gilužis;Nykštukų;49638196733;Taip;5;0;0;5
2560;Gilužis;Nykštukų;21430317293;Taip;8;0;0;8
2561;Gilužis;Nykštukų;93696234277;Taip;5;1;1;7
2562;Gilužis;Nykštukų;36105195245;Taip;13;1;0;14
2563;Gilužis;Nykštukų;2330374550;Taip;0;8;0;8
2564;Gilužis;Nykštukų;38286886127;Taip;0;3;9;12
2565;Gilužis;Nykštukų;51801100240;Taip;6;1;0;7
2566;Gilužis;Bitučių;7667792304;Taip;5;1;0;6
2567;Gilužis;Bitučių;33601993265;Taip;0;4;5;9
2568;Gilužis;Bitučių;36591400178;Taip;5;1;0;6
2569;Gilužis;Bitučių;16762351251;Taip;0;1;0;1
2570;Gilužis;Bitučių;79835099585;Taip;11;1;0;12
2571;Gilužis;Bitučių;86856314276;Taip;0;10;0;10
2572;Gilužis;Bitučių;6761901941;Taip;0;1;0;1
2573;Gilužis;Bitučių;86204525039;Taip;13;0;0;13
2574;Gilužis;Bitučių;66936354561;Taip;5;0;0;5
2575;Gilužis;Bitučių;31841898314;Taip;8;1;0;9
2576;Gilužis;Bitučių;37713407129;Taip;0;14;0;14
2577;Gilužis;Bitučių;99678737297;Taip;5;1;0;6
2578;Gilužis;Bitučių;35872947177;Taip;10;0;0;10
2579;Gilužis;Bitučių;67925251330;Taip;0;5;0;5
2580;Gilužis;Bitučių;75877736009;Taip;6;1;0;7
2581;Gilužis;Bitučių;77265792587;Taip;4;6;0;10
2582;Gilužis;Bitučių;98929035480;Taip;8;1;0;9
2583;Gilužis;Bitučių;16441506448;Taip;7;3;0;10
2584;Gilužis;Bitučių;60029145569;Taip;10;0;0;10
2585;Gilužis;Bitučių;6748923923;Taip;9;2;0;11
2586;Gilužis;Bitučių;84012597609;Taip;9;5;0;14
2587;Gilužis;Bitučių;44591290522;Taip;10;1;0;11
2588;Gilužis;Kačiukų;64044950817;Taip;14;5;0;19
2589;Gilužis;Kačiukų;97044945526;Taip;9;0;0;9
2590;Gilužis;Kačiukų;2452430134;Taip;5;1;0;6
2591;Gilužis;Kačiukų;97366385111;Taip;6;1;0;7
2592;Gilužis;Kačiukų;98833692687;Taip;9;4;0;13
2593;Gilužis;Kačiukų;90653192774;Taip;7;0;0;7
2594;Gilužis;Kačiukų;43427840545;Taip;10;0;0;10
2595;Gilužis;Kačiukų;69179380194;Taip;6;0;0;6
2596;Gilužis;Kačiukų;93911699181;Taip;9;0;0;9
2597;Gilužis;Kačiukų;27145205823;Taip;6;0;1;7
2598;Gilužis;Kačiukų;11999596704;Taip;0;2;0;2
2599;Gilužis;Kačiukų;40327951625;Taip;3;8;0;11
2600;Gilužis;Kačiukų;32385951346;Taip;9;0;0;9
2601;Gilužis;Kačiukų;69814504535;Ne;5;1;5;11
2602;Gilužis;Kačiukų;48813257365;Ne;10;10;0;20
2603;Gilužis;Kačiukų;71678818697;Taip;3;0;0;3
2604;Gilužis;Kačiukų;90150093965;Taip;0;10;0;10
2605;Gilužis;Kačiukų;88997906780;Taip;5;1;0;6
2606;Gilužis;Kačiukų;1483999429;Taip;0;9;0;9
2607;Gilužis;Kačiukų;8442202778;Taip;9;0;1;10
2608;Gilužis;Kačiukų;1642252063;Taip;10;1;0;11
2609;Gilužis;Pelėdžiukų;28030501676;Taip;5;0;0;5
2610;Gilužis;Pelėdžiukų;5726426223;Taip;0;1;0;1
2611;Gilužis;Pelėdžiukų;16234698170;Taip;9;0;0;9
2612;Gilužis;Pelėdžiukų;67700612490;Taip;6;3;0;9
2613;Gilužis;Pelėdžiukų;51205862390;Taip;6;0;0;6
2614;Gilužis;Pelėdžiukų;93263653918;Taip;5;4;0;9
2615;Gilužis;Pelėdžiukų;61132410107;Taip;0;6;0;6
2616;Gilužis;Pelėdžiukų;62062383570;Taip;10;5;0;15
2617;Gilužis;Pelėdžiukų;79192054914;Taip;6;2;0;8
2618;Gilužis;Pelėdžiukų;53479123084;Taip;8;5;0;13
2619;Gilužis;Pelėdžiukų;22977705605;Taip;5;6;0;11
2620;Gilužis;Pelėdžiukų;22799444042;Taip;5;4;1;10
2621;Gilužis;Pelėdžiukų;60053609696;Taip;0;4;0;4
2622;Gilužis;Pelėdžiukų;58046857856;Taip;2;4;0;6
2623;Gilužis;Pelėdžiukų;89984610092;Taip;0;4;3;7
2624;Gilužis;Pelėdžiukų;23013185518;Taip;14;0;0;14
2625;Gilužis;Pelėdžiukų;50090534112;Taip;1;10;0;11
2626;Gilužis;Pelėdžiukų;48885794712;Taip;5;0;0;5
2627;Gilužis;Pelėdžiukų;68971431550;Taip;0;4;0;4
2628;Gilužis;Pelėdžiukų;65593927737;Taip;9;1;0;10
2629;Gilužis;Pelėdžiukų;55062344648;Taip;2;4;0;6
2630;Gilužis;Pelėdžiukų;4037228503;Taip;0;1;0;1
2631;Gilužis;Drugelių;78348593667;Taip;0;1;0;1
2632;Gilužis;Drugelių;9184268838;Taip;5;5;0;10
2633;Gilužis;Drugelių;48661024580;Taip;9;4;0;13
2634;Gilužis;Drugelių;23066248600;Taip;10;1;1;12
2635;Gilužis;Drugelių;1437220475;Taip;0;3;0;3
2636;Gilužis;Drugelių;78471541055;Taip;0;4;0;4
2637;Gilužis;Drugelių;32201401076;Taip;3;0;1;4
2638;Gilužis;Drugelių;88492331198;Taip;0;4;0;4
2639;Gilužis;Drugelių;49548271216;Taip;0;9;0;9
2640;Gilužis;Drugelių;70078053276;Taip;0;3;1;4
2641;Gilužis;Drugelių;34173898307;Taip;6;1;0;7
2642;Gilužis;Drugelių;67880087360;Taip;0;2;0;2
2643;Gilužis;Drugelių;28352939067;Taip;0;4;1;5
2644;Gilužis;Drugelių;73290159635;Taip;5;3;6;14
2645;Gilužis;Drugelių;36023384252;Taip;7;0;0;7
2646;Gilužis;Drugelių;86110181512;Taip;0;4;1;5
2647;Gilužis;Drugelių;21922874503;Taip;11;0;0;11
2648;Gilužis;Drugelių;46357319970;Taip;11;0;0;11
2649;Gilužis;Drugelių;44522730563;Taip;5;4;0;9
2650;Gilužis;Drugelių;1951561868;Taip;0;8;0;8
2651;Gilužis;Drugelių;1515789192;Taip;0;0;2;2
2652;Gilužis;Drugelių;3866604956;Taip;6;4;0;10
2653;Gilužis;Saulučių;17896774143;Taip;15;0;0;15
2654;Gilužis;Saulučių;9918995545;Taip;0;2;0;2
2655;Gilužis;Saulučių;4209000927;Taip;0;0;2;2
2656;Gilužis;Saulučių;8595551150;Taip;12;0;0;12
2657;Gilužis;Saulučių;4575619425;Taip;0;4;2;6
2658;Gilužis;Saulučių;8224691148;Taip;20;0;0;20
2659;Gilužis;Saulučių;4473810097;Taip;10;0;0;10
2660;Gilužis;Saulučių;1649256496;Taip;10;0;1;11
2661;Gilužis;Saulučių;96550272401;Taip;20;0;0;20
2662;Gilužis;Saulučių;69504888193;Taip;6;0;0;6
2663;Gilužis;Saulučių;2391630554;Taip;7;0;5;12
2664;Gilužis;Saulučių;18997894859;Taip;12;2;0;14
2665;Gilužis;Saulučių;7744997250;Taip;0;0;5;5
2666;Gilužis;Saulučių;32730847948;Taip;5;0;4;9
2667;Gilužis;Saulučių;3181765606;Taip;15;0;0;15
2668;Gilužis;Saulučių;5905237803;Taip;6;0;0;6
2669;Gilužis;Saulučių;79805583046;Taip;1;0;2;3
2670;Gilužis;Saulučių;2872439079;Taip;0;0;6;6
2671;Gilužis;Saulučių;28447690974;Taip;0;0;1;1
2672;Gilužis;Saulučių;87425898496;Taip;0;0;2;2
2673;Gilužis;Saulučių;35650138667;Taip;0;4;0;4
2674;Gilužis;Saulučių;9367673896;Taip;10;0;0;10
2675;Gilužis;Paukštelių;1911733577;Ne;10;1;0;11
2676;Gilužis;Paukštelių;2033250993;Taip;14;0;0;14
2677;Gilužis;Paukštelių;1124568431;Ne;9;1;1;11
2678;Gilužis;Paukštelių;1120628451;Taip;2;2;0;4
2679;Gilužis;Paukštelių;1772207635;Taip;10;3;0;13
2680;Gilužis;Paukštelių;9252084783;Taip;5;4;0;9
2681;Gilužis;Paukštelių;4265465127;Taip;0;4;0;4
2682;Gilužis;Paukštelių;1797199356;Taip;12;4;0;16
2683;Gilužis;Paukštelių;93844800610;Taip;10;0;0;10
2684;Gilužis;Paukštelių;92163197528;Taip;10;5;0;15
2685;Gilužis;Paukštelių;1962922981;Taip;6;0;0;6
2686;Gilužis;Paukštelių;2769830772;Taip;6;0;0;6
2687;Gilužis;Paukštelių;1259168003;Taip;7;1;0;8
2688;Gilužis;Paukštelių;91148708775;Taip;5;0;0;5
2689;Gilužis;Paukštelių;8933516128;Taip;12;0;0;12
2690;Gilužis;Paukštelių;93151301892;Taip;13;0;0;13
2691;Gilužis;Paukštelių;1067512693;Taip;0;20;0;20
2692;Gilužis;Paukštelių;65698608589;Taip;19;0;0;19
2693;Gilužis;Paukštelių;1413931545;Taip;15;0;0;15
2694;Gilužis;Paukštelių;4754994261;Taip;13;0;0;13
2695;Gilužis;Obuoliukų;27834192987;Taip;10;0;0;10
2696;Gilužis;Obuoliukų;1050659357;Taip;3;3;0;6
2697;Gilužis;Obuoliukų;72582220264;Taip;9;5;0;14
2698;Gilužis;Obuoliukų;1840213846;Taip;11;2;1;14
2699;Gilužis;Obuoliukų;2134161601;Taip;6;0;0;6
2700;Gilužis;Obuoliukų;1637726675;Taip;5;1;0;6
2701;Gilužis;Obuoliukų;1404236599;Taip;0;20;0;20
2702;Gilužis;Obuoliukų;1847232194;Taip;0;6;0;6
2703;Gilužis;Obuoliukų;93652771548;Taip;13;1;0;14
2704;Gilužis;Obuoliukų;2031851095;Taip;5;4;0;9
2705;Gilužis;Obuoliukų;8015495924;Taip;5;0;4;9
2706;Gilužis;Obuoliukų;96799037695;Taip;5;4;0;9
2707;Gilužis;Obuoliukų;2138402546;Taip;10;0;0;10
2708;Gilužis;Obuoliukų;1923605078;Taip;2;0;1;3
2709;Gilužis;Obuoliukų;1236164928;Taip;0;0;1;1
2710;Gilužis;Obuoliukų;84834458261;Taip;9;2;0;11
2711;Gilužis;Obuoliukų;5121769570;Taip;14;0;1;15
2712;Gilužis;Obuoliukų;1428994411;Taip;11;0;0;11
2713;Gilužis;Obuoliukų;5899163275;Taip;14;0;0;14
2714;Gilužis;Obuoliukų;2126527730;Taip;5;3;0;8
2715;Gilužis;Obuoliukų;53388692764;Taip;16;0;0;16
2716;Gilužis;KIŠKUČIŲ;2118119414;Taip;0;3;5;8
2717;Gilužis;KIŠKUČIŲ;1017937594;Taip;0;0;1;1
2718;Gilužis;KIŠKUČIŲ;98584480044;Taip;3;1;0;4
2719;Gilužis;KIŠKUČIŲ;1191967409;Taip;20;0;0;20
2720;Gilužis;KIŠKUČIŲ;1025400197;Taip;2;0;0;2
2721;Gilužis;KIŠKUČIŲ;1841556598;Taip;0;1;0;1
2722;Gilužis;KIŠKUČIŲ;1452016675;Taip;1;0;0;1
2723;Gilužis;KIŠKUČIŲ;24558082285;Taip;20;0;0;20
2724;Gilužis;KIŠKUČIŲ;31157032738;Taip;0;1;0;1
2725;Gilužis;KIŠKUČIŲ;1869058578;Taip;2;0;0;2
2726;Gilužis;KIŠKUČIŲ;1464348972;Taip;5;0;0;5
2727;Gilužis;KIŠKUČIŲ;7740703388;Taip;0;4;5;9
2728;Gilužis;KIŠKUČIŲ;1589884646;Taip;3;0;6;9
2729;Gilužis;KIŠKUČIŲ;54636558233;Taip;11;0;0;11
2730;Gilužis;KIŠKUČIŲ;1453976300;Taip;0;1;0;1
2731;Gilužis;KIŠKUČIŲ;57074114440;Taip;6;3;0;9
2732;Gilužis;KIŠKUČIŲ;15192433393;Taip;10;0;1;11
2733;Gilužis;KIŠKUČIŲ;1307302669;Taip;16;0;0;16
2734;Gilužis;KIŠKUČIŲ;1569805585;Taip;14;0;0;14
2735;Gilužis;Meškučių;5008795520;Taip;0;4;0;4
2736;Gilužis;Meškučių;82153247890;Taip;11;0;0;11
2737;Gilužis;Meškučių;9104396905;Taip;4;0;2;6
2738;Gilužis;Meškučių;15672746324;Taip;0;4;0;4
2739;Gilužis;Meškučių;8278207628;Taip;0;1;0;1
2740;Gilužis;Meškučių;5988529284;Taip;15;0;5;20
2741;Gilužis;Meškučių;2144919007;Taip;3;0;0;3
2742;Gilužis;Meškučių;6840555273;Taip;0;3;0;3
2743;Gilužis;Meškučių;1664140841;Taip;6;0;0;6
2744;Gilužis;Meškučių;1201973661;Taip;5;5;0;10
2745;Gilužis;Meškučių;99889836604;Taip;5;0;0;5
2746;Gilužis;Meškučių;93541096118;Taip;11;2;0;13
2747;Gilužis;Meškučių;41791785706;Taip;0;20;0;20
2748;Gilužis;Meškučių;3104707033;Taip;6;0;0;6
2749;Gilužis;Meškučių;3884351522;Taip;8;1;0;9
2750;Gilužis;Meškučių;1003733551;Taip;5;0;2;7
2751;Gilužis;Meškučių;41887832166;Taip;0;2;0;2
2752;Gilužis;Meškučių;57285847418;Taip;20;0;0;20
2753;Gilužis;Meškučių;37771334557;Taip;5;9;0;14
2754;Gilužis;Meškučių;3451034791;Taip;0;20;0;20
2755;Gilužis;Pagrandukai;4956685016;Taip;9;0;0;9
2756;Gilužis;Pagrandukai;7937643339;Taip;5;0;0;5
2757;Gilužis;Pagrandukai;4147821853;Taip;10;1;0;11
2758;Gilužis;Pagrandukai;3132445117;Taip;0;1;0;1
2759;Gilužis;Pagrandukai;8899557365;Taip;14;0;0;14
2760;Gilužis;Pagrandukai;2661894041;Taip;17;0;0;17
2761;Gilužis;Pagrandukai;5109935385;Taip;10;1;0;11
2762;Gilužis;Pagrandukai;3335512812;Taip;10;4;0;14
2763;Gilužis;Pagrandukai;6093514885;Taip;0;20;0;20
2764;Gilužis;Pagrandukai;4156613717;Taip;12;0;0;12
2765;Gilužis;Pagrandukai;5713786735;Taip;11;0;0;11
2766;Gilužis;Pagrandukai;2784416935;Taip;5;0;0;5
2767;Gilužis;Pagrandukai;6315155554;Taip;11;0;0;11
2768;Gilužis;Pagrandukai;1146713023;Taip;9;0;0;9
2769;Gilužis;Pagrandukai;9362581908;Taip;10;5;0;15
2770;Gilužis;Pagrandukai;3473889426;Taip;10;5;0;15
2771;Gilužis;Pagrandukai;7228498662;Taip;7;0;0;7
2772;Gilužis;Pagrandukai;1459273692;Taip;9;0;0;9
2773;Gilužis;Boružėlių;9421351780;Taip;20;0;0;20
2774;Gilužis;Boružėlių;9332056404;Taip;0;20;0;20
2775;Gilužis;Boružėlių;7810223775;Taip;0;20;0;20
2776;Gilužis;Boružėlių;3258640163;Taip;0;20;0;20
2777;Gilužis;Boružėlių;7742783427;Taip;20;0;0;20
2778;Gilužis;Boružėlių;7998695149;Taip;20;0;0;20
2779;Gilužis;Boružėlių;9833451628;Taip;9;2;0;11
2780;Gilužis;Boružėlių;6404411477;Taip;15;0;0;15
2781;Gilužis;Boružėlių;1222370750;Taip;14;1;0;15
2782;Gilužis;Boružėlių;5217748032;Taip;17;0;0;17
2783;Gilužis;Boružėlių;7358572344;Taip;6;2;0;8
2784;Gilužis;Boružėlių;4617259961;Taip;13;0;1;14
2785;Gilužis;Boružėlių;9186274541;Taip;12;0;0;12
2786;Gilužis;Boružėlių;6121625070;Taip;0;20;0;20
2787;Gilužis;Boružėlių;3419281756;Taip;20;0;0;20
2788;Gilužis;Boružėlių;4403218878;Taip;15;0;0;15
2789;Gilužis;Boružėlių;5989314494;Taip;6;0;0;6
2790;Gilužis;Boružėlių;6270071724;Taip;8;2;0;10
2791;Gilužis;Boružėlių;9503516686;Taip;14;0;0;14
2792;Gintarėlis;PAPŪGĖLĖS;32751650045;Taip;7;4;1;12
2793;Gintarėlis;PAPŪGĖLĖS;3100442808;Taip;5;9;0;14
2794;Gintarėlis;PAPŪGĖLĖS;41950550071;Taip;0;1;0;1
2795;Gintarėlis;PAPŪGĖLĖS;36019373990;Ne;9;1;0;10
2796;Gintarėlis;PAPŪGĖLĖS;47480197789;Taip;0;13;0;13
2797;Gintarėlis;PAPŪGĖLĖS;96134869997;Taip;5;2;0;7
2798;Gintarėlis;PAPŪGĖLĖS;77802363719;Taip;0;4;0;4
2799;Gintarėlis;PAPŪGĖLĖS;62371949439;Taip;10;4;0;14
2800;Gintarėlis;PAPŪGĖLĖS;25360163411;Taip;7;10;0;17
2801;Gintarėlis;PAPŪGĖLĖS;74116167225;Taip;0;0;1;1
2802;Gintarėlis;PAPŪGĖLĖS;45279808861;Taip;0;7;0;7
2803;Gintarėlis;PAPŪGĖLĖS;58108486480;Taip;0;2;0;2
2804;Gintarėlis;PAPŪGĖLĖS;53696873596;Taip;7;1;1;9
2805;Gintarėlis;PAPŪGĖLĖS;7610677403;Taip;6;1;0;7
2806;Gintarėlis;PAPŪGĖLĖS;43183534908;Taip;6;0;1;7
2807;Gintarėlis;PAPŪGĖLĖS;2529363136;Taip;5;0;1;6
2808;Gintarėlis;PAPŪGĖLĖS;1943647795;Taip;0;20;0;20
2809;Gintarėlis;PAPŪGĖLĖS;6541323688;Taip;7;7;0;14
2810;Gintarėlis;PAPŪGĖLĖS;10771368524;Taip;4;0;0;4
2811;Gintarėlis;PAPŪGĖLĖS;61739452519;Taip;4;0;0;4
2812;Gintarėlis;SPINDULIUKAI;96694096944;Taip;2;5;0;7
2813;Gintarėlis;SPINDULIUKAI;88552701503;Taip;0;1;0;1
2814;Gintarėlis;SPINDULIUKAI;58118782421;Taip;0;2;0;2
2815;Gintarėlis;SPINDULIUKAI;33863655816;Taip;0;2;0;2
2816;Gintarėlis;SPINDULIUKAI;11384063236;Taip;0;5;0;5
2817;Gintarėlis;SPINDULIUKAI;99077732058;Taip;0;1;0;1
2818;Gintarėlis;SPINDULIUKAI;8112379741;Taip;0;2;5;7
2819;Gintarėlis;SPINDULIUKAI;37848651606;Taip;9;2;0;11
2820;Gintarėlis;SPINDULIUKAI;56701557907;Ne;14;0;0;14
2821;Gintarėlis;SPINDULIUKAI;77140073438;Taip;6;0;0;6
2822;Gintarėlis;SPINDULIUKAI;29392171144;Taip;4;7;0;11
2823;Gintarėlis;SPINDULIUKAI;92436759875;Taip;10;1;0;11
2824;Gintarėlis;SPINDULIUKAI;1360843628;Taip;0;0;2;2
2825;Gintarėlis;SPINDULIUKAI;6452806962;Taip;8;2;1;11
2826;Gintarėlis;SPINDULIUKAI;63037561278;Taip;0;1;5;6
2827;Gintarėlis;SPINDULIUKAI;92996401082;Taip;0;2;1;3
2828;Gintarėlis;SPINDULIUKAI;77591601744;Taip;0;3;2;5
2829;Gintarėlis;SPINDULIUKAI;19506557567;Ne;5;0;0;5
2830;Gintarėlis;SPINDULIUKAI;24915581271;Taip;0;14;0;14
2831;Gintarėlis;SPINDULIUKAI;1076400051;Taip;0;8;0;8
2832;Gintarėlis;LAŠIUKAI;6893183889;Taip;4;1;1;6
2833;Gintarėlis;LAŠIUKAI;5880091191;Taip;4;1;1;6
2834;Gintarėlis;LAŠIUKAI;9584956349;Taip;12;0;0;12
2835;Gintarėlis;LAŠIUKAI;94354056029;Taip;10;0;1;11
2836;Gintarėlis;LAŠIUKAI;78359050717;Taip;14;0;0;14
2837;Gintarėlis;LAŠIUKAI;1002155392;Taip;10;0;0;10
2838;Gintarėlis;LAŠIUKAI;96416364735;Taip;1;0;0;1
2839;Gintarėlis;LAŠIUKAI;3504738389;Taip;11;0;0;11
2840;Gintarėlis;LAŠIUKAI;9130659549;Taip;10;0;1;11
2841;Gintarėlis;LAŠIUKAI;1809511815;Taip;0;0;6;6
2842;Gintarėlis;LAŠIUKAI;4660854883;Taip;5;0;0;5
2843;Gintarėlis;LAŠIUKAI;3799412062;Taip;9;0;0;9
2844;Gintarėlis;LAŠIUKAI;25210675029;Taip;10;0;0;10
2845;Gintarėlis;LAŠIUKAI;7192722296;Taip;15;0;0;15
2846;Gintarėlis;LAŠIUKAI;5024727902;Taip;0;5;0;5
2847;Gintarėlis;LAŠIUKAI;9040480798;Taip;10;1;0;11
2848;Gintarėlis;LAŠIUKAI;7644607132;Taip;12;0;0;12
2849;Gintarėlis;LAŠIUKAI;2088008759;Taip;19;0;1;20
2850;Gintarėlis;GAIDŽIUKAI;61360761151;Taip;0;6;0;6
2851;Gintarėlis;GAIDŽIUKAI;1230510614;Taip;5;0;0;5
2852;Gintarėlis;GAIDŽIUKAI;12332079305;Taip;10;0;0;10
2853;Gintarėlis;GAIDŽIUKAI;8518137062;Taip;8;1;0;9
2854;Gintarėlis;GAIDŽIUKAI;29645999843;Taip;3;4;0;7
2855;Gintarėlis;GAIDŽIUKAI;2099549218;Taip;11;1;0;12
2856;Gintarėlis;GAIDŽIUKAI;28514742083;Taip;0;7;0;7
2857;Gintarėlis;GAIDŽIUKAI;86948612054;Taip;0;7;0;7
2858;Gintarėlis;GAIDŽIUKAI;45480802894;Taip;0;2;0;2
2859;Gintarėlis;GAIDŽIUKAI;1539226211;Taip;10;5;0;15
2860;Gintarėlis;GAIDŽIUKAI;2043878016;Taip;4;1;0;5
2861;Gintarėlis;GAIDŽIUKAI;90891401453;Taip;0;2;0;2
2862;Gintarėlis;GAIDŽIUKAI;1770479969;Taip;5;7;0;12
2863;Gintarėlis;GAIDŽIUKAI;29331294396;Taip;10;8;0;18
2864;Gintarėlis;GAIDŽIUKAI;1799002086;Taip;5;3;0;8
2865;Gintarėlis;GAIDŽIUKAI;33714823189;Taip;5;0;0;5
2866;Gintarėlis;GAIDŽIUKAI;33786299764;Taip;0;7;0;7
2867;Gintarėlis;GAIDŽIUKAI;84375225995;Taip;5;5;0;10
2868;Gintarėlis;GAIDŽIUKAI;53971205498;Taip;0;2;0;2
2869;Gintarėlis;GAIDŽIUKAI;1441282039;Taip;6;1;0;7
2870;Gintarėlis;GAIDŽIUKAI;5835437020;Taip;5;1;0;6
2871;Gintarėlis;MEŠKUČIAI;46036221870;Taip;10;5;0;15
2872;Gintarėlis;MEŠKUČIAI;72954464555;Taip;10;0;0;10
2873;Gintarėlis;MEŠKUČIAI;74741949593;Taip;4;0;0;4
2874;Gintarėlis;MEŠKUČIAI;1684735692;Taip;5;0;0;5
2875;Gintarėlis;MEŠKUČIAI;5988536057;Taip;5;4;0;9
2876;Gintarėlis;MEŠKUČIAI;92253181137;Taip;0;2;2;4
2877;Gintarėlis;MEŠKUČIAI;37758004138;Taip;0;1;0;1
2878;Gintarėlis;MEŠKUČIAI;89600903751;Taip;0;2;0;2
2879;Gintarėlis;MEŠKUČIAI;26403359331;Taip;12;0;0;12
2880;Gintarėlis;MEŠKUČIAI;33678587696;Taip;0;8;0;8
2881;Gintarėlis;MEŠKUČIAI;77834528801;Taip;0;13;0;13
2882;Gintarėlis;MEŠKUČIAI;47309634627;Taip;0;2;0;2
2883;Gintarėlis;MEŠKUČIAI;49921116417;Taip;0;4;0;4
2884;Gintarėlis;MEŠKUČIAI;85312459968;Taip;0;1;0;1
2885;Gintarėlis;MEŠKUČIAI;49473761753;Taip;0;2;0;2
2886;Gintarėlis;MEŠKUČIAI;94996622631;Taip;5;3;0;8
2887;Gintarėlis;MEŠKUČIAI;89450049559;Taip;3;4;0;7
2888;Gintarėlis;MEŠKUČIAI;6242733673;Taip;9;2;0;11
2889;Gintarėlis;MEŠKUČIAI;48793702146;Taip;0;1;0;1
2890;Gintarėlis;MEŠKUČIAI;49079274803;Taip;0;1;0;1
2891;Gintarėlis;MEŠKUČIAI;16507384915;Taip;0;1;1;2
2892;Gintarėlis;MEŠKUČIAI;58918505824;Taip;0;2;0;2
2893;Gintarėlis;MEŠKUČIAI;40605918843;Ne;0;1;5;6
2894;Gintarėlis;DRUGELIAI;2127877544;Taip;20;0;0;20
2895;Gintarėlis;DRUGELIAI;14840692502;Taip;0;3;9;12
2896;Gintarėlis;DRUGELIAI;1462949250;Taip;0;20;0;20
2897;Gintarėlis;DRUGELIAI;9737200226;Taip;8;0;0;8
2898;Gintarėlis;DRUGELIAI;6655809299;Taip;8;0;0;8
2899;Gintarėlis;DRUGELIAI;2614258442;Taip;5;5;0;10
2900;Gintarėlis;DRUGELIAI;1452402931;Taip;6;1;0;7
2901;Gintarėlis;DRUGELIAI;4217329880;Taip;0;4;1;5
2902;Gintarėlis;DRUGELIAI;1759217543;Taip;11;3;0;14
2903;Gintarėlis;DRUGELIAI;7571352126;Taip;10;3;0;13
2904;Gintarėlis;DRUGELIAI;50896429585;Taip;0;1;0;1
2905;Gintarėlis;DRUGELIAI;1042222561;Taip;11;3;0;14
2906;Gintarėlis;DRUGELIAI;1331684725;Ne;3;4;0;7
2907;Gintarėlis;DRUGELIAI;9687974376;Taip;7;2;0;9
2908;Gintarėlis;DRUGELIAI;8704248985;Taip;8;3;0;11
2909;Gintarėlis;DRUGELIAI;9382662838;Taip;12;0;0;12
2910;Gintarėlis;DRUGELIAI;6655645997;Taip;14;2;2;18
2911;Gintarėlis;DRUGELIAI;6080108998;Taip;14;2;2;18
2912;Gintarėlis;DRUGELIAI;7449437199;Taip;0;1;0;1
2913;Gintarėlis;DRUGELIAI;4076421692;Taip;0;2;0;2
2914;Gintarėlis;DRUGELIAI;2016067859;Taip;10;0;1;11
2915;Gintarėlis;DRUGELIAI;5355691986;Taip;0;2;0;2
2916;Gintarėlis;KAČIUKAI;5451653510;Taip;1;0;0;1
2917;Gintarėlis;KAČIUKAI;9903314418;Taip;0;1;1;2
2918;Gintarėlis;KAČIUKAI;63243392161;Taip;0;5;0;5
2919;Gintarėlis;KAČIUKAI;37612987791;Taip;4;2;0;6
2920;Gintarėlis;KAČIUKAI;26259581924;Taip;0;7;0;7
2921;Gintarėlis;KAČIUKAI;70787488885;Taip;3;5;0;8
2922;Gintarėlis;KAČIUKAI;31365533022;Ne;0;1;0;1
2923;Gintarėlis;KAČIUKAI;1159773367;Taip;1;0;0;1
2924;Gintarėlis;KAČIUKAI;1124481108;Ne;0;1;0;1
2925;Gintarėlis;KAČIUKAI;1827699755;Taip;6;0;1;7
2926;Gintarėlis;KAČIUKAI;54145290842;Taip;0;20;0;20
2927;Gintarėlis;KAČIUKAI;19813827223;Taip;8;1;0;9
2928;Gintarėlis;KAČIUKAI;98684742007;Taip;0;20;0;20
2929;Gintarėlis;KAČIUKAI;2000986290;Taip;0;12;0;12
2930;Gintarėlis;KAČIUKAI;6421537455;Taip;4;16;0;20
2931;Gintarėlis;KAČIUKAI;1595816431;Taip;0;0;2;2
2932;Gintarėlis;KAČIUKAI;30446888177;Taip;14;0;1;15
2933;Gintarėlis;KAČIUKAI;63221497564;Taip;0;10;0;10
2934;Gintarėlis;KAČIUKAI;81135362098;Taip;0;5;0;5
2935;Gintarėlis;KAČIUKAI;58701768194;Taip;0;5;0;5
2936;Gintarėlis;KAČIUKAI;29480359781;Taip;12;0;1;13
2937;Gintarėlis;KIŠKUČIAI;8665467175;Taip;20;0;0;20
2938;Gintarėlis;KIŠKUČIAI;14981744375;Taip;20;0;0;20
2939;Gintarėlis;KIŠKUČIAI;83754732536;Taip;9;5;0;14
2940;Gintarėlis;KIŠKUČIAI;89051269756;Taip;4;2;1;7
2941;Gintarėlis;KIŠKUČIAI;1642627920;Taip;17;0;0;17
2942;Gintarėlis;KIŠKUČIAI;1593455162;Taip;0;6;0;6
2943;Gintarėlis;KIŠKUČIAI;2043405414;Taip;5;0;0;5
2944;Gintarėlis;KIŠKUČIAI;3828845515;Taip;0;12;0;12
2945;Gintarėlis;KIŠKUČIAI;1069395570;Taip;11;3;0;14
2946;Gintarėlis;KIŠKUČIAI;19402011412;Taip;0;5;0;5
2947;Gintarėlis;KIŠKUČIAI;96211766919;Taip;0;5;0;5
2948;Gintarėlis;KIŠKUČIAI;78697777550;Taip;10;0;0;10
2949;Gintarėlis;KIŠKUČIAI;85557344192;Taip;11;2;0;13
2950;Gintarėlis;KIŠKUČIAI;2970527490;Taip;14;0;0;14
2951;Gintarėlis;KIŠKUČIAI;4279681763;Taip;8;0;0;8
2952;Gintarėlis;KIŠKUČIAI;1868431609;Taip;5;2;10;17
2953;Gintarėlis;KIŠKUČIAI;2032900352;Taip;6;0;0;6
2954;Gintarėlis;KIŠKUČIAI;3292572563;Taip;0;8;0;8
2955;Gintarėlis;KIŠKUČIAI;1543013649;Taip;16;0;0;16
2956;Gintarėlis;KIŠKUČIAI;24774460882;Taip;0;20;0;20
2957;Gintarėlis;KIŠKUČIAI;1028456578;Taip;2;0;0;2
2958;Gintarėlis;VYTURIUKAI;1553747935;Taip;8;3;0;11
2959;Gintarėlis;VYTURIUKAI;4902086873;Taip;7;0;0;7
2960;Gintarėlis;VYTURIUKAI;56124970238;Taip;0;1;0;1
2961;Gintarėlis;VYTURIUKAI;34606130829;Taip;0;1;0;1
2962;Gintarėlis;VYTURIUKAI;18715625324;Taip;19;0;0;19
2963;Gintarėlis;VYTURIUKAI;9740239182;Taip;0;8;0;8
2964;Gintarėlis;VYTURIUKAI;2036488789;Taip;15;0;0;15
2965;Gintarėlis;VYTURIUKAI;8405210216;Taip;14;0;0;14
2966;Gintarėlis;VYTURIUKAI;2721386855;Taip;0;0;1;1
2967;Gintarėlis;BORUŽĖLĖS;4971574875;Taip;0;3;0;3
2968;Gintarėlis;BORUŽĖLĖS;6277010268;Taip;9;0;0;9
2969;Gintarėlis;BORUŽĖLĖS;1771868868;Taip;5;9;0;14
2970;Gintarėlis;BORUŽĖLĖS;39372328122;Taip;0;6;0;6
2971;Gintarėlis;BORUŽĖLĖS;25451522701;Taip;3;2;0;5
2972;Gintarėlis;BORUŽĖLĖS;90216120878;Taip;0;16;0;16
2973;Gintarėlis;BORUŽĖLĖS;1929900615;Taip;5;3;0;8
2974;Gintarėlis;BORUŽĖLĖS;82344200095;Taip;0;2;0;2
2975;Gintarėlis;BORUŽĖLĖS;1168158494;Taip;0;1;1;2
2976;Gintarėlis;BORUŽĖLĖS;9255623049;Taip;9;7;0;16
2977;Gintarėlis;BORUŽĖLĖS;88451515187;Taip;0;2;0;2
2978;Gintarėlis;BORUŽĖLĖS;7703150488;Taip;5;0;0;5
2979;Gintarėlis;BORUŽĖLĖS;2145479870;Taip;0;1;0;1
2980;Gintarėlis;BORUŽĖLĖS;49506158711;Taip;5;2;0;7
2981;Gintarėlis;BORUŽĖLĖS;30066476338;Taip;0;2;0;2
2982;Gintarėlis;BORUŽĖLĖS;10001742134;Taip;0;1;0;1
2983;Gintarėlis;BORUŽĖLĖS;63146841406;Taip;0;20;0;20
2984;Gintarėlis;BORUŽĖLĖS;30334064319;Taip;1;2;0;3
2985;Gintarėlis;BORUŽĖLĖS;6426075546;Taip;5;0;0;5
2986;Gintarėlis;BORUŽĖLĖS;91798408335;Taip;0;17;0;17
2987;Gintarėlis;BORUŽĖLĖS;25684002087;Taip;0;5;0;5
2988;Gintarėlis;EŽIUKAI;1793785936;Taip;7;0;0;7
2989;Gintarėlis;EŽIUKAI;5464804183;Taip;3;0;0;3
2990;Gintarėlis;EŽIUKAI;96812991513;Taip;10;1;0;11
2991;Gintarėlis;EŽIUKAI;27890184523;Taip;0;6;0;6
2992;Gintarėlis;EŽIUKAI;1841482183;Taip;0;0;2;2
2993;Gintarėlis;EŽIUKAI;8074941282;Taip;0;1;0;1
2994;Gintarėlis;EŽIUKAI;2040989572;Taip;5;1;0;6
2995;Gintarėlis;EŽIUKAI;18008015227;Taip;0;1;0;1
2996;Gintarėlis;EŽIUKAI;1312688961;Taip;5;0;5;10
2997;Gintarėlis;EŽIUKAI;1672037617;Taip;0;6;1;7
2998;Gintarėlis;EŽIUKAI;51418692259;Taip;0;1;2;3
2999;Gintarėlis;EŽIUKAI;1398810524;Taip;11;3;0;14
3000;Gintarėlis;EŽIUKAI;74295947670;Taip;0;1;0;1
3001;Gintarėlis;EŽIUKAI;52644122529;Taip;0;4;0;4
3002;Gintarėlis;EŽIUKAI;2732338838;Taip;0;1;1;2
3003;Gintarėlis;EŽIUKAI;7053099543;Taip;5;1;0;6
3004;Gintarėlis;EŽIUKAI;56834651967;Taip;11;9;0;20
3005;Gintarėlis;EŽIUKAI;9705808868;Taip;0;0;2;2
3006;Gintarėlis;EŽIUKAI;13416505188;Taip;13;0;0;13
3007;Gintarėlis;EŽIUKAI;36350623756;Taip;13;0;1;14
3008;Gintarėlis;EŽIUKAI;96404879029;Taip;7;4;0;11
3009;Gintarėlis;VIŠČIUKAI;7494884360;Taip;0;8;0;8
3010;Gintarėlis;VIŠČIUKAI;5783939567;Taip;5;0;6;11
3011;Gintarėlis;VIŠČIUKAI;8064521864;Taip;10;0;0;10
3012;Gintarėlis;VIŠČIUKAI;8913652291;Taip;11;0;2;13
3013;Gintarėlis;VIŠČIUKAI;1033624080;Taip;10;0;8;18
3014;Gintarėlis;VIŠČIUKAI;2919700367;Taip;16;0;0;16
3015;Gintarėlis;VIŠČIUKAI;1768789948;Taip;11;0;0;11
3016;Gintarėlis;VIŠČIUKAI;2235045173;Taip;9;0;0;9
3017;Gintarėlis;VIŠČIUKAI;9494521554;Taip;5;10;0;15
3018;Gintarėlis;VIŠČIUKAI;7147842224;Taip;0;0;7;7
3019;Gintarėlis;VIŠČIUKAI;7674351459;Taip;0;3;0;3
3020;Gintarėlis;VIŠČIUKAI;2485750596;Taip;16;1;0;17
3021;Gintarėlis;VIŠČIUKAI;2595566032;Taip;0;2;0;2
3022;Gintarėlis;VIŠČIUKAI;9141438560;Taip;0;3;0;3
3023;Gintarėlis;VIŠČIUKAI;9648982613;Taip;14;0;0;14
3024;Gintarėlis;VIŠČIUKAI;6292664833;Taip;6;0;6;12
3025;Gintarėlis;"SAULĖS ZUIKUČIAI";8287685690;Taip;0;4;0;4
3026;Gintarėlis;"SAULĖS ZUIKUČIAI";6914904213;Taip;5;2;0;7
3027;Gintarėlis;"SAULĖS ZUIKUČIAI";1696337909;Taip;5;2;0;7
3028;Gintarėlis;"SAULĖS ZUIKUČIAI";1778573935;Taip;0;1;0;1
3029;Gintarėlis;"SAULĖS ZUIKUČIAI";5796729245;Taip;5;0;0;5
3030;Gintarėlis;"SAULĖS ZUIKUČIAI";9915887420;Taip;5;0;0;5
3031;Gintarėlis;"SAULĖS ZUIKUČIAI";3398936974;Taip;10;0;1;11
3032;Gintarėlis;"SAULĖS ZUIKUČIAI";5153948767;Taip;20;0;0;20
3033;Gintarėlis;"SAULĖS ZUIKUČIAI";9675201979;Taip;20;0;0;20
3034;Gintarėlis;"SAULĖS ZUIKUČIAI";7971810025;Taip;5;0;0;5
3035;Gintarėlis;"SAULĖS ZUIKUČIAI";2814569415;Taip;0;0;6;6
3036;Gintarėlis;"SAULĖS ZUIKUČIAI";6862629244;Taip;20;0;0;20
3037;Gintarėlis;"SAULĖS ZUIKUČIAI";9279399214;Taip;0;1;0;1
3038;Gintarėlis;"SAULĖS ZUIKUČIAI";8000297636;Taip;5;0;15;20
3039;Gintarėlis;"SAULĖS ZUIKUČIAI";6142819210;Taip;0;0;8;8
3040;Gintarėlis;"SAULĖS ZUIKUČIAI";3359584322;Taip;0;20;0;20
3041;Giraitė;Aviliukas;67009533810;Taip;6;2;0;8
3042;Giraitė;Aviliukas;62525988158;Taip;16;1;0;17
3043;Giraitė;Aviliukas;68804588518;Taip;0;17;0;17
3044;Giraitė;Aviliukas;809734624;Taip;0;5;0;5
3045;Giraitė;Aviliukas;44396075745;Taip;0;8;0;8
3046;Giraitė;Aviliukas;42330865487;Taip;0;1;0;1
3047;Giraitė;Aviliukas;1139666539;Ne;14;0;0;14
3048;Giraitė;Aviliukas;39627499338;Taip;0;1;0;1
3049;Giraitė;Aviliukas;67108509429;Taip;0;4;0;4
3050;Giraitė;Aviliukas;86412433313;Taip;4;0;0;4
3051;Giraitė;Aviliukas;10778161174;Taip;0;6;0;6
3052;Giraitė;Aviliukas;6449275481;Taip;0;0;1;1
3053;Giraitė;Aviliukas;37348466498;Taip;0;1;3;4
3054;Giraitė;Aviliukas;45633008605;Taip;0;0;1;1
3055;Giraitė;Aviliukas;24903085449;Taip;5;7;0;12
3056;Giraitė;Aviliukas;7868564343;Taip;9;2;0;11
3057;Giraitė;LapiukaI;42953220489;Taip;5;3;0;8
3058;Giraitė;LapiukaI;1285310492;Taip;5;1;0;6
3059;Giraitė;LapiukaI;1533533163;Taip;2;0;0;2
3060;Giraitė;LapiukaI;17883856522;Taip;0;1;0;1
3061;Giraitė;LapiukaI;1965752607;Taip;1;0;7;8
3062;Giraitė;LapiukaI;79459838218;Taip;1;6;1;8
3063;Giraitė;LapiukaI;1690407683;Taip;10;0;0;10
3064;Giraitė;LapiukaI;94357968497;Taip;6;1;0;7
3065;Giraitė;LapiukaI;87139343254;Taip;0;5;0;5
3066;Giraitė;LapiukaI;1146337878;Taip;0;0;9;9
3067;Giraitė;LapiukaI;1424661991;Taip;0;0;1;1
3068;Giraitė;LapiukaI;9710265790;Taip;7;2;0;9
3069;Giraitė;LapiukaI;26202357668;Taip;0;7;0;7
3070;Giraitė;LapiukaI;9493194946;Taip;3;2;1;6
3071;Giraitė;LapiukaI;89948210310;Taip;0;5;0;5
3072;Giraitė;LapiukaI;8986196352;Taip;16;0;4;20
3073;Giraitė;Voveriukai;83995022535;Taip;0;1;1;2
3074;Giraitė;Voveriukai;62684217934;Taip;6;0;0;6
3075;Giraitė;Voveriukai;70629522964;Taip;0;1;4;5
3076;Giraitė;Voveriukai;10070775660;Taip;0;4;0;4
3077;Giraitė;Voveriukai;68502311448;Taip;0;4;1;5
3078;Giraitė;Voveriukai;34413917793;Taip;0;4;0;4
3079;Giraitė;Voveriukai;1458304464;Taip;0;5;0;5
3080;Giraitė;Voveriukai;48623826572;Taip;5;0;0;5
3081;Giraitė;Voveriukai;482311593;Taip;20;0;0;20
3082;Giraitė;Voveriukai;10108398683;Taip;10;0;0;10
3083;Giraitė;Voveriukai;19218675078;Ne;0;0;2;2
3084;Giraitė;Voveriukai;61477798910;Taip;0;0;2;2
3085;Giraitė;Voveriukai;20082610200;Taip;1;4;1;6
3086;Giraitė;Voveriukai;98106730833;Taip;0;4;3;7
3087;Giraitė;Voveriukai;2107606245;Taip;0;2;0;2
3088;Giraitė;Voveriukai;2816941652;Taip;0;1;0;1
3089;Giraitė;Voveriukai;1313395982;Taip;15;0;2;17
3090;Giraitė;Voveriukai;5824936903;Taip;0;2;0;2
3091;Giraitė;Voveriukai;70668076883;Taip;0;6;0;6
3092;Giraitė;Grybukai;82326314822;Taip;0;0;3;3
3093;Giraitė;Grybukai;65817530256;Ne;0;2;0;2
3094;Giraitė;Grybukai;64804371570;Taip;1;1;0;2
3095;Giraitė;Grybukai;44781582045;Taip;0;3;0;3
3096;Giraitė;Grybukai;54865651920;Taip;1;0;2;3
3097;Giraitė;Grybukai;2088558056;Taip;5;0;2;7
3098;Giraitė;Grybukai;47716066947;Taip;0;4;0;4
3099;Giraitė;Grybukai;61885066766;Taip;5;0;0;5
3100;Giraitė;Grybukai;61377720550;Taip;0;0;2;2
3101;Giraitė;Grybukai;70833551710;Taip;1;0;2;3
3102;Giraitė;Grybukai;98893791966;Taip;0;2;1;3
3103;Giraitė;Grybukai;90085776538;Taip;6;0;0;6
3104;Giraitė;Grybukai;38156994332;Taip;5;5;0;10
3105;Giraitė;Grybukai;1791880914;Taip;0;0;4;4
3106;Giraitė;Grybukai;17033130522;Taip;2;0;0;2
3107;Giraitė;Grybukai;47131903191;Taip;10;2;0;12
3108;Giraitė;Grybukai;16962877902;Taip;0;4;1;5
3109;Giraitė;Grybukai;1878433552;Taip;6;0;0;6
3110;Giraitė;Grybukai;43596280059;Taip;0;1;0;1
3111;Giraitė;Grybukai;1354740688;Ne;1;0;0;1
3112;Giraitė;Riešutėliai;3683700626;Taip;13;1;0;14
3113;Giraitė;Riešutėliai;8596389737;Taip;3;0;1;4
3114;Giraitė;Riešutėliai;5167002022;Taip;8;0;2;10
3115;Giraitė;Riešutėliai;2425354598;Taip;6;0;0;6
3116;Giraitė;Riešutėliai;9495968363;Taip;19;0;0;19
3117;Giraitė;Riešutėliai;1253151830;Taip;14;1;0;15
3118;Giraitė;Riešutėliai;4336519836;Taip;10;0;0;10
3119;Giraitė;Riešutėliai;9026736929;Taip;5;0;1;6
3120;Giraitė;Riešutėliai;9882372025;Taip;5;0;0;5
3121;Giraitė;Riešutėliai;5721669627;Taip;0;0;3;3
3122;Giraitė;Riešutėliai;5029839281;Ne;0;12;0;12
3123;Giraitė;Riešutėliai;23319979302;Taip;8;0;0;8
3124;Giraitė;Riešutėliai;4785524898;Taip;4;1;0;5
3125;Giraitė;Riešutėliai;8869728241;Taip;1;0;0;1
3126;Giraitė;Riešutėliai;4839351300;Taip;17;0;1;18
3127;Giraitė;Riešutėliai;1817075429;Taip;11;0;0;11
3128;Giraitė;Riešutėliai;6836412890;Taip;9;0;0;9
3129;Giraitė;Riešutėliai;9224845723;Taip;19;0;0;19
3130;Giraitė;Riešutėliai;4687228561;Taip;10;1;3;14
3131;Giraitė;Riešutėliai;9652807467;Taip;15;0;0;15
3132;Giraitė;Meškiukai;27501094616;Taip;9;2;0;11
3133;Giraitė;Meškiukai;2513312448;Taip;20;0;0;20
3134;Giraitė;Meškiukai;5367392810;Taip;6;6;0;12
3135;Giraitė;Meškiukai;1608876140;Taip;0;5;5;10
3136;Giraitė;Meškiukai;5461837332;Taip;0;8;0;8
3137;Giraitė;Meškiukai;1355594003;Taip;0;5;0;5
3138;Giraitė;Meškiukai;1560868105;Taip;16;4;0;20
3139;Giraitė;Meškiukai;1050699551;Taip;20;0;0;20
3140;Giraitė;Meškiukai;1876815077;Taip;0;1;0;1
3141;Giraitė;Meškiukai;1063628206;Taip;8;0;0;8
3142;Giraitė;Meškiukai;1318214394;Taip;1;0;0;1
3143;Giraitė;Meškiukai;1846118720;Taip;3;4;0;7
3144;Giraitė;Meškiukai;9195735923;Taip;6;0;0;6
3145;Giraitė;Meškiukai;65251975467;Taip;5;0;0;5
3146;Giraitė;Meškiukai;1704154980;Taip;11;9;0;20
3147;Giraitė;Meškiukai;1819657811;Taip;5;0;0;5
3148;Giraitė;Meškiukai;1512384599;Taip;9;0;0;9
3149;Giraitė;Meškiukai;2571892050;Taip;18;0;0;18
3150;Giraitė;Meškiukai;5544613599;Taip;13;0;0;13
3151;Giraitė;Meškiukai;6156715234;Taip;10;0;0;10
3152;Giraitė;Meškiukai;1594965200;Taip;20;0;0;20
3153;Giraitė;Meškiukai;9723242940;Taip;15;0;0;15
3154;Giraitė;Meškiukai;5726182600;Taip;15;0;0;15
3155;Giraitė;Meškiukai;1772790396;Taip;12;0;0;12
3156;Giraitė;Uogelės;99494458394;Taip;9;3;0;12
3157;Giraitė;Uogelės;1447893912;Taip;0;1;0;1
3158;Giraitė;Uogelės;49193108666;Ne;0;3;0;3
3159;Giraitė;Uogelės;31110630088;Taip;0;0;1;1
3160;Giraitė;Uogelės;1312761239;Taip;18;0;0;18
3161;Giraitė;Uogelės;43475840493;Taip;0;2;0;2
3162;Giraitė;Uogelės;30804922053;Taip;7;9;0;16
3163;Giraitė;Uogelės;2083472940;Taip;19;0;0;19
3164;Giraitė;Uogelės;99146206772;Taip;2;0;0;2
3165;Giraitė;Uogelės;5378240128;Taip;0;7;0;7
3166;Giraitė;Uogelės;40696452801;Taip;8;1;0;9
3167;Giraitė;Uogelės;43468579365;Taip;2;0;0;2
3168;Giraitė;Uogelės;74256775397;Taip;20;0;0;20
3169;Giraitė;Uogelės;65392345188;Taip;5;0;0;5
3170;Giraitė;Uogelės;7779733510;Taip;14;0;0;14
3171;Giraitė;Uogelės;1110792632;Taip;6;0;0;6
3172;Giraitė;Šaltinėlis;83173577451;Taip;0;6;0;6
3173;Giraitė;Šaltinėlis;89112366792;Taip;3;1;1;5
3174;Giraitė;Šaltinėlis;29823126743;Ne;0;1;0;1
3175;Giraitė;Šaltinėlis;85943562009;Taip;0;1;0;1
3176;Giraitė;Šaltinėlis;23695629099;Taip;0;2;1;3
3177;Giraitė;Šaltinėlis;29419658963;Taip;9;1;0;10
3178;Giraitė;Šaltinėlis;57289703755;Taip;3;0;1;4
3179;Giraitė;Šaltinėlis;23443952589;Taip;0;10;2;12
3180;Giraitė;Šaltinėlis;75752125046;Taip;0;4;0;4
3181;Giraitė;Šaltinėlis;13537474624;Taip;0;9;0;9
3182;Giraitė;Šaltinėlis;5106092595;Taip;3;1;1;5
3183;Giraitė;Šaltinėlis;18070708999;Taip;0;2;0;2
3184;Giraitė;Šaltinėlis;83199904684;Taip;0;2;0;2
3185;Giraitė;Šaltinėlis;72098612565;Taip;5;0;0;5
3186;Giraitė;Šaltinėlis;55816174362;Taip;0;6;0;6
3187;Giraitė;Šaltinėlis;3592590159;Taip;0;2;0;2
3188;Giraitė;Šaltinėlis;25319015890;Taip;11;1;0;12
3189;Giraitė;Boružėlės;5438716880;Taip;15;1;0;16
3190;Giraitė;Boružėlės;4055450300;Taip;13;0;0;13
3191;Giraitė;Boružėlės;4387282125;Taip;15;1;0;16
3192;Giraitė;Boružėlės;7354834895;Taip;6;0;0;6
3193;Giraitė;Boružėlės;4822168634;Taip;5;0;1;6
3194;Giraitė;Boružėlės;6963656869;Taip;8;0;0;8
3195;Giraitė;Boružėlės;2088867630;Taip;9;0;0;9
3196;Giraitė;Boružėlės;3875214088;Taip;11;0;0;11
3197;Giraitė;Boružėlės;7441871219;Taip;3;0;0;3
3198;Giraitė;Boružėlės;7481895278;Taip;14;0;0;14
3199;Giraitė;Boružėlės;3607198556;Taip;5;0;0;5
3200;Giraitė;Boružėlės;1945918102;Taip;9;0;0;9
3201;Giraitė;Boružėlės;2699984170;Taip;14;2;0;16
3202;Giraitė;Boružėlės;6265908751;Taip;4;0;1;5
3203;Giraitė;Boružėlės;5202562049;Taip;9;0;0;9
3204;Giraitė;Gandriukai;69883334049;Taip;13;0;0;13
3205;Giraitė;Gandriukai;1025627643;Taip;2;0;0;2
3206;Giraitė;Gandriukai;26032013284;Taip;5;1;0;6
3207;Giraitė;Gandriukai;36650870278;Taip;11;0;0;11
3208;Giraitė;Gandriukai;82915040164;Taip;3;1;0;4
3209;Giraitė;Gandriukai;64357457379;Taip;0;9;0;9
3210;Giraitė;Gandriukai;1238299747;Taip;16;0;0;16
3211;Giraitė;Gandriukai;1054132082;Taip;9;0;0;9
3212;Giraitė;Gandriukai;5081903157;Taip;16;1;0;17
3213;Giraitė;Gandriukai;5759367884;Taip;15;2;0;17
3214;Giraitė;Gandriukai;1111614295;Taip;4;12;0;16
3215;Giraitė;ŽVIRBLIUKAI;4444292550;Taip;0;0;2;2
3216;Giraitė;ŽVIRBLIUKAI;77765768952;Taip;14;2;0;16
3217;Giraitė;ŽVIRBLIUKAI;56380808064;Taip;9;3;0;12
3218;Giraitė;ŽVIRBLIUKAI;1181578380;Taip;14;0;6;20
3219;Giraitė;ŽVIRBLIUKAI;1730588815;Taip;0;6;0;6
3220;Giraitė;ŽVIRBLIUKAI;1547711379;Taip;6;0;0;6
3221;Giraitė;ŽVIRBLIUKAI;1641872824;Taip;19;0;0;19
3222;Giraitė;ŽVIRBLIUKAI;1234136698;Taip;5;0;1;6
3223;Giraitė;ŽVIRBLIUKAI;2065944230;Taip;10;0;0;10
3224;Giraitė;ŽVIRBLIUKAI;1435017557;Taip;7;0;0;7
3225;Giraitė;ŽVIRBLIUKAI;1149254911;Taip;0;3;0;3
3226;Giraitė;ŽVIRBLIUKAI;1284187551;Taip;11;0;0;11
3227;Giraitė;ŽVIRBLIUKAI;3628448974;Taip;5;5;0;10
3228;Giraitė;ŽVIRBLIUKAI;8020051188;Taip;8;0;2;10
3229;Giraitė;Kiškeliai;4076402180;Taip;9;3;0;12
3230;Giraitė;Kiškeliai;5902161665;Taip;7;3;0;10
3231;Giraitė;Kiškeliai;7551981095;Taip;13;0;0;13
3232;Giraitė;Kiškeliai;5532639133;Taip;2;0;3;5
3233;Giraitė;Kiškeliai;4296449093;Taip;17;0;0;17
3234;Giraitė;Kiškeliai;1974159110;Taip;5;3;0;8
3235;Giraitė;Kiškeliai;4009092043;Taip;7;5;0;12
3236;Giraitė;Kiškeliai;7919088987;Taip;12;0;0;12
3237;Giraitė;Kiškeliai;8376809208;Taip;7;5;0;12
3238;Giraitė;Kiškeliai;5616242311;Taip;0;1;1;2
3239;Giraitė;Kiškeliai;9728453316;Taip;4;0;0;4
3240;Giraitė;Kiškeliai;4272999339;Taip;10;0;0;10
3241;Giraitė;Kiškeliai;4955786826;Taip;0;3;0;3
3242;Gudrutis;Gandriukų;38591847769;Taip;0;4;0;4
3243;Gudrutis;Gandriukų;33123804925;Taip;5;0;1;6
3244;Gudrutis;Gandriukų;21999129886;Taip;0;14;0;14
3245;Gudrutis;Gandriukų;69437346100;Taip;0;9;0;9
3246;Gudrutis;Gandriukų;11324963268;Taip;0;0;1;1
3247;Gudrutis;Gandriukų;71306450171;Taip;13;0;1;14
3248;Gudrutis;Gandriukų;74606626459;Taip;8;1;0;9
3249;Gudrutis;Gandriukų;85886111222;Taip;5;0;1;6
3250;Gudrutis;Gandriukų;1261390117;Taip;15;0;0;15
3251;Gudrutis;Gandriukų;15665148606;Taip;15;0;0;15
3252;Gudrutis;Gandriukų;1013150817;Taip;0;9;3;12
3253;Gudrutis;Gandriukų;1174040508;Taip;5;5;0;10
3254;Gudrutis;Gandriukų;14626533681;Taip;5;6;0;11
3255;Gudrutis;Gandriukų;13755502342;Taip;9;1;0;10
3256;Gudrutis;Gandriukų;1436950588;Taip;13;0;0;13
3257;Gudrutis;Gandriukų;35401545938;Taip;6;0;0;6
3258;Gudrutis;Gandriukų;3363640861;Taip;5;1;0;6
3259;Gudrutis;Gandriukų;70107420346;Taip;9;0;0;9
3260;Gudrutis;Gandriukų;62735575539;Taip;15;0;0;15
3261;Gudrutis;Gandriukų;6824283429;Taip;0;6;0;6
3262;Gudrutis;"Saulės zuikučių";2453989647;Taip;0;0;1;1
3263;Gudrutis;"Saulės zuikučių";1434565790;Taip;7;0;0;7
3264;Gudrutis;"Saulės zuikučių";1238607523;Taip;9;0;0;9
3265;Gudrutis;"Saulės zuikučių";1204945185;Taip;0;10;0;10
3266;Gudrutis;"Saulės zuikučių";1389133303;Taip;0;5;0;5
3267;Gudrutis;"Saulės zuikučių";77776725399;Taip;0;1;0;1
3268;Gudrutis;"Saulės zuikučių";21494647270;Taip;0;4;0;4
3269;Gudrutis;"Saulės zuikučių";87981934125;Taip;8;0;1;9
3270;Gudrutis;"Saulės zuikučių";1998630017;Taip;6;1;0;7
3271;Gudrutis;"Saulės zuikučių";1823786522;Taip;1;5;0;6
3272;Gudrutis;"Saulės zuikučių";1618442704;Taip;1;2;4;7
3273;Gudrutis;"Saulės zuikučių";1592255250;Taip;11;0;0;11
3274;Gudrutis;"Saulės zuikučių";8085295588;Taip;0;0;1;1
3275;Gudrutis;"Saulės zuikučių";74605225026;Taip;7;0;0;7
3276;Gudrutis;"Saulės zuikučių";4392872175;Taip;0;7;3;10
3277;Gudrutis;"Saulės zuikučių";11383212272;Taip;15;4;0;19
3278;Gudrutis;"Saulės zuikučių";1156575830;Taip;0;8;0;8
3279;Gudrutis;"Saulės zuikučių";1490739175;Taip;5;0;8;13
3280;Gudrutis;"Saulės zuikučių";8128313792;Taip;10;0;0;10
3281;Gudrutis;"Saulės zuikučių";8768627605;Taip;8;1;1;10
3282;Gudrutis;"Saulės zuikučių";18320321051;Taip;14;0;1;15
3283;Gudrutis;Pelėdžiukų;2012092629;Taip;0;0;11;11
3284;Gudrutis;Pelėdžiukų;28075147728;Taip;0;0;7;7
3285;Gudrutis;Pelėdžiukų;21178331458;Taip;5;0;1;6
3286;Gudrutis;Pelėdžiukų;46232665673;Taip;10;0;3;13
3287;Gudrutis;Pelėdžiukų;18813895572;Taip;1;7;0;8
3288;Gudrutis;Pelėdžiukų;14779917423;Taip;0;20;0;20
3289;Gudrutis;Pelėdžiukų;2579697941;Taip;8;0;0;8
3290;Gudrutis;Pelėdžiukų;54019097027;Taip;3;10;3;16
3291;Gudrutis;Pelėdžiukų;79189562476;Ne;5;9;0;14
3292;Gudrutis;Pelėdžiukų;77718940253;Taip;0;9;0;9
3293;Gudrutis;Pelėdžiukų;3970404528;Taip;7;0;0;7
3294;Gudrutis;Pelėdžiukų;98473509715;Taip;0;6;0;6
3295;Gudrutis;Pelėdžiukų;1049398501;Taip;0;0;1;1
3296;Gudrutis;Pelėdžiukų;1427882103;Taip;4;0;0;4
3297;Gudrutis;Pelėdžiukų;16404432728;Taip;5;0;3;8
3298;Gudrutis;Pelėdžiukų;1027391188;Taip;0;1;0;1
3299;Gudrutis;Pelėdžiukų;81252457503;Taip;7;2;0;9
3300;Gudrutis;Pelėdžiukų;1340947103;Taip;20;0;0;20
3301;Gudrutis;Pelėdžiukų;7632549677;Ne;9;0;1;10
3302;Gudrutis;Pelėdžiukų;1464768624;Taip;5;0;1;6
3303;Gudrutis;BITUČIŲ;4125420913;Taip;0;4;2;6
3304;Gudrutis;BITUČIŲ;35630338758;Taip;0;5;0;5
3305;Gudrutis;BITUČIŲ;13495334557;Taip;8;4;0;12
3306;Gudrutis;BITUČIŲ;29816980468;Taip;0;5;0;5
3307;Gudrutis;BITUČIŲ;59378091248;Taip;0;10;2;12
3308;Gudrutis;BITUČIŲ;26020212688;Taip;0;1;6;7
3309;Gudrutis;BITUČIŲ;84586752341;Taip;9;0;0;9
3310;Gudrutis;BITUČIŲ;47141496535;Taip;0;0;1;1
3311;Gudrutis;BITUČIŲ;1264146375;Taip;2;7;2;11
3312;Gudrutis;BITUČIŲ;93833325038;Taip;0;1;0;1
3313;Gudrutis;BITUČIŲ;7838753258;Taip;0;1;0;1
3314;Gudrutis;BITUČIŲ;83200430763;Taip;0;2;0;2
3315;Gudrutis;BITUČIŲ;1042589663;Taip;0;10;0;10
3316;Gudrutis;BITUČIŲ;41945603137;Taip;14;2;0;16
3317;Gudrutis;BITUČIŲ;58999949883;Taip;5;5;0;10
3318;Gudrutis;BITUČIŲ;90567524206;Taip;10;0;0;10
3319;Gudrutis;BITUČIŲ;65712774270;Taip;11;0;1;12
3320;Gudrutis;BITUČIŲ;61452187923;Taip;9;0;0;9
3321;Gudrutis;BITUČIŲ;44451036504;Taip;0;1;0;1
3322;Gudrutis;BITUČIŲ;30787734143;Taip;0;1;1;2
3323;Gudrutis;BITUČIŲ;36492561410;Taip;5;0;0;5
3324;Gudrutis;Boružėlių;6747372184;Taip;0;0;5;5
3325;Gudrutis;Boružėlių;3888849808;Taip;0;20;0;20
3326;Gudrutis;Boružėlių;1190408818;Taip;0;0;10;10
3327;Gudrutis;Boružėlių;2431077357;Taip;10;1;0;11
3328;Gudrutis;Boružėlių;4193661251;Taip;10;0;1;11
3329;Gudrutis;Boružėlių;7116979528;Taip;10;0;0;10
3330;Gudrutis;Boružėlių;1991658503;Taip;0;0;1;1
3331;Gudrutis;Boružėlių;3363824185;Taip;5;0;1;6
3332;Gudrutis;Boružėlių;1936327172;Taip;7;0;0;7
3333;Gudrutis;Boružėlių;3359028602;Taip;16;0;0;16
3334;Gudrutis;Boružėlių;1693306014;Taip;0;10;0;10
3335;Gudrutis;Boružėlių;6443631536;Taip;8;1;0;9
3336;Gudrutis;Boružėlių;9797417587;Taip;0;4;0;4
3337;Gudrutis;Boružėlių;9042793284;Taip;0;10;3;13
3338;Gudrutis;Boružėlių;4945755164;Taip;19;1;0;20
3339;Gudrutis;Boružėlių;2074151024;Taip;9;0;1;10
3340;Gudrutis;Boružėlių;1445657342;Taip;0;6;0;6
3341;Gudrutis;Boružėlių;5574287734;Taip;7;0;2;9
3342;Gudrutis;Boružėlių;9841172472;Taip;16;0;0;16
3343;Gudrutis;Boružėlių;2865995680;Taip;0;6;0;6
3344;Gudrutis;Drugeliai;2487363252;Ne;8;0;0;8
3345;Gudrutis;Drugeliai;5580618896;Taip;10;0;0;10
3346;Gudrutis;Drugeliai;7871991275;Taip;10;0;0;10
3347;Gudrutis;Drugeliai;4612995336;Taip;6;6;0;12
3348;Gudrutis;Drugeliai;2197278086;Taip;9;0;0;9
3349;Gudrutis;Drugeliai;6530101961;Taip;18;0;0;18
3350;Gudrutis;Drugeliai;6731806925;Taip;11;0;0;11
3351;Gudrutis;Drugeliai;9701111916;Taip;5;0;4;9
3352;Gudrutis;Drugeliai;1228190677;Taip;11;0;0;11
3353;Gudrutis;Drugeliai;6198012431;Taip;6;4;0;10
3354;Gudrutis;Drugeliai;3646335609;Taip;9;0;1;10
3355;Gudrutis;Drugeliai;3625838131;Taip;11;0;0;11
3356;Gudrutis;Drugeliai;5097101097;Taip;5;1;0;6
3357;Gudrutis;Drugeliai;2337493193;Taip;0;16;0;16
3358;Gudrutis;Drugeliai;2764843216;Taip;2;0;0;2
3359;Gudrutis;Drugeliai;7955353991;Taip;11;0;0;11
3360;Jurginėlis;Ąžuoliukai;8217773164;Taip;13;0;0;13
3361;Jurginėlis;Ąžuoliukai;29155768493;Taip;18;0;1;19
3362;Jurginėlis;Ąžuoliukai;1591501789;Taip;0;11;0;11
3363;Jurginėlis;Ąžuoliukai;75192831969;Taip;0;5;0;5
3364;Jurginėlis;Ąžuoliukai;67578476769;Taip;6;4;0;10
3365;Jurginėlis;Ąžuoliukai;10095155757;Taip;6;3;0;9
3366;Jurginėlis;Ąžuoliukai;64641268493;Taip;8;0;0;8
3367;Jurginėlis;Ąžuoliukai;13085086595;Taip;8;2;0;10
3368;Jurginėlis;Ąžuoliukai;7798931951;Taip;0;16;0;16
3369;Jurginėlis;Ąžuoliukai;92559573466;Taip;13;5;0;18
3370;Jurginėlis;Ąžuoliukai;29601247012;Taip;0;1;0;1
3371;Jurginėlis;Ąžuoliukai;56382554421;Taip;11;3;0;14
3372;Jurginėlis;Ąžuoliukai;75958769515;Taip;6;4;0;10
3373;Jurginėlis;Ąžuoliukai;59618430487;Taip;10;7;0;17
3374;Jurginėlis;Ąžuoliukai;51856181602;Taip;0;4;0;4
3375;Jurginėlis;Ąžuoliukai;64852957209;Taip;14;5;0;19
3376;Jurginėlis;Ąžuoliukai;23049094719;Taip;0;11;0;11
3377;Jurginėlis;Ąžuoliukai;72190891827;Taip;6;0;0;6
3378;Jurginėlis;Ąžuoliukai;1742217696;Taip;15;0;0;15
3379;Jurginėlis;Ąžuoliukai;8423424896;Taip;0;10;0;10
3380;Jurginėlis;Ąžuoliukai;52105378503;Taip;6;0;0;6
3381;Jurginėlis;Žiogeliai;1421681717;Taip;10;0;4;14
3382;Jurginėlis;Žiogeliai;64524305038;Taip;10;3;0;13
3383;Jurginėlis;Žiogeliai;60988201430;Taip;6;2;0;8
3384;Jurginėlis;Žiogeliai;55253928424;Taip;2;1;1;4
3385;Jurginėlis;Žiogeliai;50470137888;Taip;0;0;7;7
3386;Jurginėlis;Žiogeliai;85888481045;Taip;3;0;0;3
3387;Jurginėlis;Žiogeliai;96017651718;Taip;5;5;0;10
3388;Jurginėlis;Žiogeliai;92688596347;Taip;0;12;0;12
3389;Jurginėlis;Žiogeliai;84691244839;Taip;0;6;0;6
3390;Jurginėlis;Žiogeliai;87566883270;Taip;0;7;0;7
3391;Jurginėlis;Žiogeliai;1175198086;Taip;0;4;0;4
3392;Jurginėlis;Žiogeliai;8149405217;Taip;2;1;0;3
3393;Jurginėlis;Žiogeliai;1058274970;Taip;10;0;3;13
3394;Jurginėlis;Žiogeliai;53924769958;Taip;10;0;0;10
3395;Jurginėlis;Žiogeliai;53783266582;Taip;9;2;0;11
3396;Jurginėlis;Žiogeliai;93055778306;Taip;6;6;0;12
3397;Jurginėlis;Žiogeliai;24615714793;Taip;14;1;0;15
3398;Jurginėlis;Žiogeliai;90786336005;Taip;7;0;0;7
3399;Jurginėlis;Žiogeliai;1191021311;Taip;6;0;5;11
3400;Jurginėlis;Pelėdžiukų;49181526821;Taip;0;1;0;1
3401;Jurginėlis;Pelėdžiukų;35653034443;Taip;8;0;0;8
3402;Jurginėlis;Pelėdžiukų;59935106302;Taip;0;11;0;11
3403;Jurginėlis;Pelėdžiukų;91317327949;Taip;0;0;3;3
3404;Jurginėlis;Pelėdžiukų;52877525045;Taip;19;0;1;20
3405;Jurginėlis;Pelėdžiukų;36829106143;Taip;11;0;0;11
3406;Jurginėlis;Pelėdžiukų;97726131559;Taip;1;0;0;1
3407;Jurginėlis;Pelėdžiukų;45200409204;Taip;9;0;0;9
3408;Jurginėlis;Pelėdžiukų;2544904907;Taip;20;0;0;20
3409;Jurginėlis;Pelėdžiukų;8414893303;Taip;7;1;0;8
3410;Jurginėlis;Pelėdžiukų;70733592257;Taip;13;0;0;13
3411;Jurginėlis;Pelėdžiukų;7449558199;Taip;10;0;1;11
3412;Jurginėlis;Pelėdžiukų;54494144846;Taip;15;1;0;16
3413;Jurginėlis;Pelėdžiukų;6072633581;Taip;14;5;0;19
3414;Jurginėlis;Pelėdžiukų;57340494605;Taip;17;0;0;17
3415;Jurginėlis;Pelėdžiukų;18273043496;Taip;7;1;0;8
3416;Jurginėlis;Pelėdžiukų;91909797332;Taip;7;1;0;8
3417;Jurginėlis;Pelėdžiukų;7278855565;Taip;11;0;0;11
3418;Jurginėlis;Pelėdžiukų;1295024976;Taip;1;7;3;11
3419;Jurginėlis;Pelėdžiukų;85293469079;Taip;20;0;0;20
3420;Jurginėlis;Boružėlių;74357497654;Taip;5;0;0;5
3421;Jurginėlis;Boružėlių;63355660135;Taip;0;4;0;4
3422;Jurginėlis;Boružėlių;64840404890;Taip;3;1;0;4
3423;Jurginėlis;Boružėlių;39360122004;Taip;0;0;4;4
3424;Jurginėlis;Boružėlių;82216478040;Ne;0;12;0;12
3425;Jurginėlis;Boružėlių;86967421380;Taip;0;9;0;9
3426;Jurginėlis;Boružėlių;10360871447;Taip;8;2;0;10
3427;Jurginėlis;Boružėlių;81519067874;Taip;0;6;0;6
3428;Jurginėlis;Boružėlių;2588167364;Taip;7;0;0;7
3429;Jurginėlis;Boružėlių;88889021693;Taip;6;5;0;11
3430;Jurginėlis;Boružėlių;74738988946;Taip;0;1;0;1
3431;Jurginėlis;Boružėlių;26247261025;Taip;0;2;3;5
3432;Jurginėlis;Boružėlių;12869519580;Taip;0;1;0;1
3433;Jurginėlis;Boružėlių;65042659099;Taip;0;2;0;2
3434;Jurginėlis;Boružėlių;32999311928;Taip;14;0;0;14
3435;Jurginėlis;Boružėlių;53414286952;Taip;12;2;0;14
3436;Jurginėlis;Boružėlių;17134738202;Taip;0;2;0;2
3437;Jurginėlis;Boružėlių;38238082314;Taip;0;13;0;13
3438;Jurginėlis;Boružėlių;11327131918;Taip;0;2;0;2
3439;Jurginėlis;Boružėlių;19813742281;Taip;2;4;0;6
3440;Jurginėlis;Boružėlių;1167229378;Taip;7;0;0;7
3441;Jurginėlis;Boružėlių;96095068634;Taip;0;5;0;5
3442;Jurginėlis;Bitučių;41492483889;Taip;0;11;0;11
3443;Jurginėlis;Bitučių;47471788525;Ne;0;1;8;9
3444;Jurginėlis;Bitučių;9063688205;Ne;0;4;0;4
3445;Jurginėlis;Bitučių;3788255853;Taip;14;0;0;14
3446;Jurginėlis;Bitučių;82962903099;Taip;0;8;0;8
3447;Jurginėlis;Bitučių;90707023246;Taip;6;0;0;6
3448;Jurginėlis;Bitučių;32667255865;Taip;2;1;2;5
3449;Jurginėlis;Bitučių;25564914064;Taip;0;6;0;6
3450;Jurginėlis;Bitučių;20339209794;Taip;0;10;0;10
3451;Jurginėlis;Bitučių;84958379689;Taip;5;7;0;12
3452;Jurginėlis;Bitučių;86820360373;Taip;14;0;0;14
3453;Jurginėlis;Bitučių;50656028856;Taip;9;6;0;15
3454;Jurginėlis;Bitučių;45937957629;Taip;6;1;0;7
3455;Jurginėlis;Bitučių;10179464570;Taip;0;4;0;4
3456;Jurginėlis;Bitučių;87615798332;Taip;14;0;1;15
3457;Jurginėlis;Bitučių;56127406092;Taip;6;0;0;6
3458;Jurginėlis;Bitučių;36215389575;Taip;0;0;3;3
3459;Jurginėlis;Bitučių;14158658573;Taip;9;0;0;9
3460;Jurginėlis;Bitučių;57002585818;Taip;11;1;0;12
3461;Jurginėlis;Bitučių;1196957598;Taip;10;4;0;14
3462;Jurginėlis;Bitučių;1698001579;Taip;4;0;1;5
3463;Jurginėlis;Skruzdeliukų;92602685294;Taip;0;1;0;1
3464;Jurginėlis;Skruzdeliukų;1710682615;Taip;0;0;4;4
3465;Jurginėlis;Skruzdeliukų;1485725580;Taip;8;0;0;8
3466;Jurginėlis;Skruzdeliukų;20527253593;Taip;0;2;0;2
3467;Jurginėlis;Skruzdeliukų;51685299187;Ne;5;1;0;6
3468;Jurginėlis;Skruzdeliukų;1881790340;Taip;0;9;0;9
3469;Jurginėlis;Skruzdeliukų;31143311410;Taip;12;1;0;13
3470;Jurginėlis;Skruzdeliukų;94107758268;Taip;11;1;0;12
3471;Jurginėlis;Skruzdeliukų;77480957625;Taip;8;0;0;8
3472;Jurginėlis;Skruzdeliukų;68109772993;Taip;20;0;0;20
3473;Jurginėlis;Skruzdeliukų;1329203545;Taip;0;2;0;2
3474;Jurginėlis;Skruzdeliukų;86427848578;Taip;0;2;0;2
3475;Jurginėlis;Skruzdeliukų;81064432153;Taip;9;1;0;10
3476;Jurginėlis;Skruzdeliukų;12659496203;Taip;0;0;5;5
3477;Jurginėlis;Skruzdeliukų;1828295769;Taip;0;1;0;1
3478;Jurginėlis;Skruzdeliukų;17286700686;Ne;7;0;0;7
3479;Jurginėlis;Skruzdeliukų;1506649972;Taip;0;1;0;1
3480;Jurginėlis;Drugelių;1758862051;Taip;0;1;0;1
3481;Jurginėlis;Drugelių;9589394406;Taip;3;0;4;7
3482;Jurginėlis;Drugelių;47243459592;Taip;20;0;0;20
3483;Jurginėlis;Drugelių;8972814655;Taip;16;0;0;16
3484;Jurginėlis;Drugelių;8784076886;Taip;8;0;0;8
3485;Jurginėlis;Drugelių;7753784918;Taip;0;0;13;13
3486;Jurginėlis;Drugelių;1829089083;Taip;13;0;0;13
3487;Jurginėlis;Drugelių;6111863896;Taip;5;0;3;8
3488;Jurginėlis;Drugelių;8338173095;Taip;8;0;0;8
3489;Jurginėlis;Drugelių;3068120316;Taip;19;0;0;19
3490;Jurginėlis;Drugelių;1361108271;Taip;0;0;1;1
3491;Jurginėlis;Drugelių;4852619394;Taip;14;0;2;16
3492;Jurginėlis;Drugelių;1563317396;Taip;0;3;0;3
3493;Jurginėlis;Drugelių;1701720412;Taip;8;0;2;10
3494;Jurginėlis;Drugelių;8920304044;Taip;3;4;4;11
3495;Jurginėlis;Drugelių;1954364886;Taip;17;0;0;17
3496;Jurginėlis;Drugelių;1467200002;Taip;9;0;0;9
3497;Jurginėlis;Drugelių;1974388885;Taip;11;0;0;11
3498;Jurginėlis;Drugelių;2171115974;Taip;6;0;0;6
3499;Jurginėlis;Drugelių;3027573572;Taip;0;3;7;10
3500;Jurginėlis;Drugelių;4851923549;Taip;0;0;2;2
3501;Jurginėlis;Žibučių;4806248290;Taip;5;6;0;11
3502;Jurginėlis;Žibučių;2624313807;Taip;20;0;0;20
3503;Jurginėlis;Žibučių;1983924909;Taip;5;1;0;6
3504;Jurginėlis;Žibučių;1547101731;Taip;12;2;0;14
3505;Jurginėlis;Žibučių;2639125463;Taip;14;0;0;14
3506;Jurginėlis;Žibučių;2535601005;Taip;16;0;0;16
3507;Jurginėlis;Žibučių;7297672386;Taip;10;0;0;10
3508;Jurginėlis;Žibučių;5242359650;Taip;5;8;0;13
3509;Jurginėlis;Žibučių;903039398;Taip;6;1;0;7
3510;Jurginėlis;Žibučių;1175441410;Taip;6;4;0;10
3511;Jurginėlis;Žibučių;1586599624;Taip;5;0;0;5
3512;Jurginėlis;Žibučių;1343532870;Taip;5;6;0;11
3513;Jurginėlis;Žibučių;1102466152;Taip;0;6;0;6
3514;Jurginėlis;Žibučių;5892180334;Taip;20;0;0;20
3515;Jurginėlis;Žibučių;1759218238;Taip;2;0;0;2
3516;Jurginėlis;Žibučių;3708774681;Taip;12;2;0;14
3517;Jurginėlis;Žibučių;7928799065;Taip;12;0;0;12
3518;Jurginėlis;Žibučių;9646318532;Taip;0;1;0;1
3519;Jurginėlis;Žibučių;1082593212;Taip;5;0;0;5
3520;Jurginėlis;Žibučių;8144038013;Taip;11;1;0;12
3521;Jurginėlis;Žibučių;1787311340;Taip;9;8;0;17
3522;Jurginėlis;Žibučių;6413324051;Taip;20;0;0;20
3523;Jurginėlis;Zuikučių;6217229672;Taip;0;20;0;20
3524;Jurginėlis;Zuikučių;1762685527;Taip;5;5;0;10
3525;Jurginėlis;Zuikučių;1649208522;Taip;5;0;0;5
3526;Jurginėlis;Zuikučių;8084970770;Taip;20;0;0;20
3527;Jurginėlis;Zuikučių;87991288027;Taip;16;0;0;16
3528;Jurginėlis;Zuikučių;1400142372;Taip;9;1;0;10
3529;Jurginėlis;Zuikučių;1416995981;Taip;15;0;0;15
3530;Jurginėlis;Zuikučių;1656300401;Taip;9;0;0;9
3531;Jurginėlis;Zuikučių;1759031589;Taip;8;5;0;13
3532;Jurginėlis;Zuikučių;1945098580;Taip;7;0;5;12
3533;Jurginėlis;Zuikučių;1409480187;Taip;6;0;0;6
3534;Jurginėlis;Zuikučių;1780106633;Taip;9;1;0;10
3535;Jurginėlis;Zuikučių;2106937059;Taip;6;5;0;11
3536;Jurginėlis;Zuikučių;1535907893;Ne;0;9;0;9
3537;Jurginėlis;Zuikučių;8793129805;Taip;0;9;0;9
3538;Jurginėlis;Zuikučių;74303787465;Taip;11;3;0;14
3539;Jurginėlis;Zuikučių;60128913543;Taip;9;2;0;11
3540;Jurginėlis;Zuikučių;9320841905;Taip;5;6;0;11
3541;Jurginėlis;Zuikučių;7293372539;Taip;10;0;0;10
3542;Jurginėlis;Viščiukų;1656335765;Taip;16;0;0;16
3543;Jurginėlis;Viščiukų;6729212950;Taip;15;0;0;15
3544;Jurginėlis;Viščiukų;4827340942;Taip;14;0;0;14
3545;Jurginėlis;Viščiukų;6806704355;Taip;9;0;0;9
3546;Jurginėlis;Viščiukų;7990015623;Taip;0;2;5;7
3547;Jurginėlis;Viščiukų;3699180485;Taip;8;4;0;12
3548;Jurginėlis;Viščiukų;9882919290;Taip;1;0;0;1
3549;Jurginėlis;Viščiukų;2548920722;Taip;6;0;1;7
3550;Jurginėlis;Viščiukų;4536086996;Taip;3;0;0;3
3551;Jurginėlis;Viščiukų;7229961310;Taip;7;0;0;7
3552;Jurginėlis;Viščiukų;4231659246;Taip;0;11;0;11
3553;Jurginėlis;Viščiukų;3284464951;Taip;5;6;0;11
3554;Jurginėlis;Viščiukų;5921714669;Taip;12;7;0;19
3555;Jurginėlis;Viščiukų;4158502752;Taip;20;0;0;20
3556;Jurginėlis;Viščiukų;1335152703;Taip;20;0;0;20
3557;Jurginėlis;Viščiukų;4463258777;Taip;11;0;0;11
3558;Jurginėlis;Meškiukų;8443412187;Taip;0;0;1;1
3559;Jurginėlis;Meškiukų;4292932046;Taip;13;1;0;14
3560;Jurginėlis;Meškiukų;2221708420;Taip;4;6;0;10
3561;Jurginėlis;Meškiukų;5984893389;Taip;11;8;0;19
3562;Jurginėlis;Meškiukų;3079495897;Taip;11;0;4;15
3563;Jurginėlis;Meškiukų;1455749921;Taip;17;7;0;24
3564;Jurginėlis;Meškiukų;9946892497;Taip;14;0;10;24
3565;Jurginėlis;Meškiukų;2417314519;Taip;16;0;3;19
3566;Jurginėlis;Meškiukų;6968528293;Taip;10;6;0;16
3567;Jurginėlis;Meškiukų;9507571301;Taip;15;0;0;15
3568;Jurginėlis;Meškiukų;8779807396;Taip;8;0;3;11
3569;Jurginėlis;Meškiukų;8161347781;Taip;4;14;0;18
3570;Jurginėlis;Meškiukų;4967548277;Taip;20;4;0;24
3571;Jurginėlis;Meškiukų;2925253653;Taip;7;0;1;8
3572;Jurginėlis;Meškiukų;1340689348;Taip;8;13;0;21
3573;Jurginėlis;Meškiukų;6181547354;Taip;24;0;0;24
3574;Jurginėlis;Meškiukų;4113264904;Taip;21;0;0;21
3575;Jurginėlis;Gandriukų;7419836868;Taip;8;0;0;8
3576;Jurginėlis;Gandriukų;51603579121;Ne;0;10;0;10
3577;Jurginėlis;Gandriukų;87444065733;Taip;0;9;0;9
3578;Jurginėlis;Gandriukų;2179884441;Taip;0;16;0;16
3579;Jurginėlis;Gandriukų;2264351097;Taip;10;0;0;10
3580;Jurginėlis;Gandriukų;78496894090;Taip;10;1;2;13
3581;Jurginėlis;Gandriukų;99523320519;Taip;5;0;0;5
3582;Jurginėlis;Gandriukų;1498351759;Taip;0;0;9;9
3583;Jurginėlis;Gandriukų;1159550277;Taip;0;3;0;3
3584;Jurginėlis;Gandriukų;75383941896;Taip;5;1;0;6
3585;Jurginėlis;Gandriukų;1508705709;Taip;0;12;0;12
3586;Jurginėlis;Gandriukų;1773100970;Taip;0;1;11;12
3587;Jurginėlis;Gandriukų;1500087367;Taip;0;1;11;12
3588;Jurginėlis;Gandriukų;43368987046;Taip;11;1;0;12
3589;Jurginėlis;Gandriukų;6707289955;Taip;5;0;0;5
3590;Jurginėlis;Gandriukų;1927843089;Taip;4;0;0;4
3591;Jurginėlis;Gandriukų;8178112926;Taip;20;0;0;20
3592;Jurginėlis;Gandriukų;6475508583;Taip;10;0;8;18
3593;Jurginėlis;Gandriukų;91517951071;Taip;5;0;1;6
3594;Jurginėlis;Gandriukų;9714764714;Taip;9;0;2;11
3595;Jurginėlis;Gandriukų;5756997642;Taip;20;0;0;20
3596;Karusėlė;PAGRANDUKAS;3660843696;Taip;13;2;0;15
3597;Karusėlė;PAGRANDUKAS;9344514262;Taip;13;1;0;14
3598;Karusėlė;PAGRANDUKAS;1412890120;Taip;5;10;0;15
3599;Karusėlė;PAGRANDUKAS;8967704928;Taip;20;0;0;20
3600;Karusėlė;PAGRANDUKAS;5132581245;Taip;7;0;0;7
3601;Karusėlė;PAGRANDUKAS;2160071272;Taip;9;0;0;9
3602;Karusėlė;PAGRANDUKAS;9996567374;Taip;0;4;0;4
3603;Karusėlė;PAGRANDUKAS;9462242426;Taip;7;0;0;7
3604;Karusėlė;PAGRANDUKAS;2412418335;Taip;7;0;0;7
3605;Karusėlė;PAGRANDUKAS;8678437720;Taip;0;0;2;2
3606;Karusėlė;PAGRANDUKAS;6826455161;Taip;0;3;0;3
3607;Karusėlė;PAGRANDUKAS;5695697634;Taip;0;0;1;1
3608;Karusėlė;PAGRANDUKAS;8127218866;Taip;11;0;1;12
3609;Karusėlė;PAGRANDUKAS;6062361348;Taip;10;0;0;10
3610;Karusėlė;PAGRANDUKAS;3620722907;Taip;15;0;0;15
3611;Karusėlė;PAGRANDUKAS;7013765804;Taip;20;0;0;20
3612;Karusėlė;NYKŠTUKAS;1560316431;Taip;0;3;0;3
3613;Karusėlė;NYKŠTUKAS;82963400142;Taip;7;1;0;8
3614;Karusėlė;NYKŠTUKAS;1567290218;Taip;0;7;0;7
3615;Karusėlė;NYKŠTUKAS;77290004668;Taip;1;0;1;2
3616;Karusėlė;NYKŠTUKAS;64652121316;Taip;3;0;0;3
3617;Karusėlė;NYKŠTUKAS;1250530261;Taip;20;0;0;20
3618;Karusėlė;NYKŠTUKAS;4568159355;Taip;20;0;0;20
3619;Karusėlė;NYKŠTUKAS;1397009220;Taip;7;6;0;13
3620;Karusėlė;NYKŠTUKAS;2064301292;Taip;10;0;0;10
3621;Karusėlė;NYKŠTUKAS;96150256487;Taip;11;0;0;11
3622;Karusėlė;NYKŠTUKAS;1680275369;Taip;7;0;1;8
3623;Karusėlė;NYKŠTUKAS;17728195505;Taip;7;0;0;7
3624;Karusėlė;NYKŠTUKAS;1534689679;Taip;10;0;1;11
3625;Karusėlė;NYKŠTUKAS;1226371512;Taip;11;0;2;13
3626;Karusėlė;NYKŠTUKAS;45634061915;Taip;0;6;0;6
3627;Karusėlė;NYKŠTUKAS;68739693482;Taip;7;0;0;7
3628;Karusėlė;NYKŠTUKAS;9377426384;Taip;1;3;0;4
3629;Karusėlė;NYKŠTUKAS;1311631554;Ne;6;0;2;8
3630;Karusėlė;NYKŠTUKAS;5481354767;Taip;12;0;1;13
3631;Karusėlė;NYKŠTUKAS;1798723081;Ne;6;0;1;7
3632;Karusėlė;NYKŠTUKAS;8419242504;Taip;6;0;2;8
3633;Karusėlė;BITUTĖ;34233236889;Taip;10;5;0;15
3634;Karusėlė;BITUTĖ;59360129103;Taip;14;1;0;15
3635;Karusėlė;BITUTĖ;73632076815;Taip;5;6;0;11
3636;Karusėlė;BITUTĖ;79818913523;Taip;12;2;0;14
3637;Karusėlė;BITUTĖ;70640710377;Taip;9;0;0;9
3638;Karusėlė;BITUTĖ;49030870029;Taip;5;2;0;7
3639;Karusėlė;BITUTĖ;3136722375;Taip;14;2;0;16
3640;Karusėlė;BITUTĖ;61949196545;Ne;11;0;0;11
3641;Karusėlė;BITUTĖ;92696158075;Taip;4;5;0;9
3642;Karusėlė;BITUTĖ;53518197256;Taip;8;5;0;13
3643;Karusėlė;BITUTĖ;32652681132;Taip;3;5;0;8
3644;Karusėlė;BITUTĖ;12592642929;Taip;0;2;0;2
3645;Karusėlė;BITUTĖ;50671265678;Taip;2;3;0;5
3646;Karusėlė;BITUTĖ;93257316270;Taip;1;2;0;3
3647;Karusėlė;BITUTĖ;5205096259;Taip;6;3;0;9
3648;Karusėlė;BITUTĖ;75225376723;Taip;0;4;0;4
3649;Karusėlė;BITUTĖ;57323585520;Taip;5;2;0;7
3650;Karusėlė;BITUTĖ;14967055322;Ne;10;5;0;15
3651;Karusėlė;BITUTĖ;2582494071;Taip;0;9;0;9
3652;Karusėlė;BITUTĖ;28039124654;Taip;11;2;0;13
3653;Karusėlė;BITUTĖ;13158075075;Taip;0;4;0;4
3654;Karusėlė;BITUTĖ;92236920191;Taip;11;1;0;12
3655;Karusėlė;BITUTĖ;8302185030;Taip;9;0;1;10
3656;Karusėlė;BITUTĖ;58784706592;Taip;2;2;0;4
3657;Karusėlė;BITUTĖ;8079425267;Taip;1;14;0;15
3658;Karusėlė;BITUTĖ;1688616471;Taip;10;0;0;10
3659;Karusėlė;BITUTĖ;85881177597;Taip;0;3;0;3
3660;Karusėlė;BORUŽĖLĖ;1705790474;Taip;13;0;0;13
3661;Karusėlė;BORUŽĖLĖ;8608177987;Taip;6;0;0;6
3662;Karusėlė;BORUŽĖLĖ;4890393582;Taip;12;2;0;14
3663;Karusėlė;BORUŽĖLĖ;1311907441;Taip;16;0;0;16
3664;Karusėlė;BORUŽĖLĖ;1593728369;Taip;15;1;0;16
3665;Karusėlė;BORUŽĖLĖ;6313010762;Taip;2;0;0;2
3666;Karusėlė;BORUŽĖLĖ;5859827168;Taip;0;3;0;3
3667;Karusėlė;BORUŽĖLĖ;37349219339;Taip;7;4;0;11
3668;Karusėlė;BORUŽĖLĖ;49110267692;Taip;20;0;0;20
3669;Karusėlė;BORUŽĖLĖ;1809033214;Taip;9;0;0;9
3670;Karusėlė;BORUŽĖLĖ;9065247151;Taip;0;0;17;17
3671;Karusėlė;BORUŽĖLĖ;6811862463;Taip;7;5;0;12
3672;Karusėlė;BORUŽĖLĖ;5471989295;Taip;15;0;0;15
3673;Karusėlė;BORUŽĖLĖ;9753876554;Taip;14;0;0;14
3674;Karusėlė;BORUŽĖLĖ;1204919995;Taip;20;0;0;20
3675;Karusėlė;BORUŽĖLĖ;8717484092;Taip;20;0;0;20
3676;Karusėlė;BORUŽĖLĖ;5351690991;Taip;5;0;0;5
3677;Karusėlė;BORUŽĖLĖ;1994682683;Taip;9;1;0;10
3678;Karusėlė;BORUŽĖLĖ;5632697184;Taip;10;0;0;10
3679;Karusėlė;UOGELĖ;3053539045;Taip;6;4;0;10
3680;Karusėlė;UOGELĖ;9992989896;Taip;4;7;0;11
3681;Karusėlė;UOGELĖ;2084276906;Taip;1;19;0;20
3682;Karusėlė;UOGELĖ;1098106063;Taip;0;4;0;4
3683;Karusėlė;UOGELĖ;8665314366;Taip;5;9;0;14
3684;Karusėlė;UOGELĖ;5651238035;Taip;3;3;0;6
3685;Karusėlė;UOGELĖ;4121668687;Taip;9;3;0;12
3686;Karusėlė;UOGELĖ;8316147204;Taip;8;5;0;13
3687;Karusėlė;UOGELĖ;5504719953;Taip;8;7;0;15
3688;Karusėlė;UOGELĖ;5919009583;Taip;12;7;0;19
3689;Karusėlė;UOGELĖ;4199597984;Taip;9;3;0;12
3690;Karusėlė;UOGELĖ;2383023280;Taip;12;4;0;16
3691;Karusėlė;UOGELĖ;1575408822;Taip;20;0;0;20
3692;Karusėlė;UOGELĖ;7908136147;Taip;11;1;0;12
3693;Karusėlė;UOGELĖ;3917113787;Taip;6;3;0;9
3694;Karusėlė;UOGELĖ;4068106379;Taip;0;2;0;2
3695;Karusėlė;UOGELĖ;1428516421;Taip;2;8;0;10
3696;Karusėlė;UOGELĖ;4638918427;Taip;3;0;1;4
3697;Karusėlė;UOGELĖ;3615957761;Taip;6;11;0;17
3698;Karusėlė;UOGELĖ;3514026443;Taip;10;3;0;13
3699;Karusėlė;GINTARĖLIS;75574841532;Taip;5;0;0;5
3700;Karusėlė;GINTARĖLIS;89669425763;Taip;9;2;0;11
3701;Karusėlė;GINTARĖLIS;1058129883;Taip;5;0;0;5
3702;Karusėlė;GINTARĖLIS;1625704473;Taip;10;5;0;15
3703;Karusėlė;GINTARĖLIS;5267055924;Taip;9;0;0;9
3704;Karusėlė;GINTARĖLIS;17254955427;Taip;5;6;0;11
3705;Karusėlė;GINTARĖLIS;1467237683;Taip;10;0;0;10
3706;Karusėlė;GINTARĖLIS;33935704865;Taip;12;5;0;17
3707;Karusėlė;GINTARĖLIS;92286460424;Taip;18;0;0;18
3708;Karusėlė;GINTARĖLIS;80377577910;Taip;12;5;0;17
3709;Karusėlė;GINTARĖLIS;7794899167;Taip;11;1;0;12
3710;Karusėlė;GINTARĖLIS;1302846796;Taip;11;4;0;15
3711;Karusėlė;GINTARĖLIS;6181109173;Taip;0;3;2;5
3712;Karusėlė;GINTARĖLIS;65387251381;Taip;0;6;0;6
3713;Karusėlė;GINTARĖLIS;90635580825;Taip;4;1;1;6
3714;Karusėlė;GINTARĖLIS;93635113154;Taip;14;0;0;14
3715;Karusėlė;GINTARĖLIS;2386140324;Taip;0;13;0;13
3716;Karusėlė;GINTARĖLIS;90731574209;Taip;10;0;0;10
3717;Karusėlė;GINTARĖLIS;77007130834;Taip;9;0;0;9
3718;Karusėlė;GINTARĖLIS;1248828581;Taip;5;15;0;20
3719;Karusėlė;GINTARĖLIS;6596029324;Taip;8;0;0;8
3720;Karusėlė;GINTARĖLIS;1477282992;Taip;0;11;0;11
3721;Karusėlė;GINTARĖLIS;1487641646;Taip;0;1;0;1
3722;Karusėlė;SAULUTĖ;1705251019;Taip;6;4;0;10
3723;Karusėlė;SAULUTĖ;64855471225;Taip;10;6;0;16
3724;Karusėlė;SAULUTĖ;45701480267;Taip;10;0;0;10
3725;Karusėlė;SAULUTĖ;35910852843;Taip;14;1;0;15
3726;Karusėlė;SAULUTĖ;1198992954;Taip;5;0;0;5
3727;Karusėlė;SAULUTĖ;1223992311;Taip;0;4;0;4
3728;Karusėlė;SAULUTĖ;6702329224;Taip;20;0;0;20
3729;Karusėlė;SAULUTĖ;1239411995;Taip;0;1;0;1
3730;Karusėlė;SAULUTĖ;10539595272;Taip;14;0;0;14
3731;Karusėlė;SAULUTĖ;52452661421;Taip;16;0;0;16
3732;Karusėlė;SAULUTĖ;54723578928;Taip;0;1;2;3
3733;Karusėlė;SAULUTĖ;2606829789;Ne;2;2;0;4
3734;Karusėlė;SAULUTĖ;91676265927;Taip;2;7;0;9
3735;Karusėlė;SAULUTĖ;39088931809;Taip;13;0;0;13
3736;Karusėlė;SAULUTĖ;63044693440;Taip;9;0;0;9
3737;Karusėlė;SAULUTĖ;23662916408;Taip;0;13;0;13
3738;Karusėlė;SAULUTĖ;99462674291;Taip;8;0;2;10
3739;Karusėlė;SAULUTĖ;59790578013;Taip;14;0;0;14
3740;Karusėlė;SAULUTĖ;2025180617;Taip;0;4;0;4
3741;Karusėlė;SAULUTĖ;7977835762;Taip;0;7;3;10
3742;Karusėlė;SAULUTĖ;1273810363;Taip;8;1;0;9
3743;Karusėlė;SAULUTĖ;25328680614;Taip;18;0;0;18
3744;Karusėlė;SAULUTĖ;2038274137;Taip;10;0;0;10
3745;Karusėlė;TIGRIUKAS;1277422207;Taip;5;8;0;13
3746;Karusėlė;TIGRIUKAS;1982126099;Taip;14;0;0;14
3747;Karusėlė;TIGRIUKAS;1799128848;Taip;5;0;0;5
3748;Karusėlė;TIGRIUKAS;1292576152;Taip;14;0;0;14
3749;Karusėlė;TIGRIUKAS;95430039864;Taip;11;0;0;11
3750;Karusėlė;TIGRIUKAS;68279619421;Taip;15;0;0;15
3751;Karusėlė;TIGRIUKAS;86870088150;Taip;6;3;0;9
3752;Karusėlė;TIGRIUKAS;25581881402;Taip;10;6;0;16
3753;Karusėlė;TIGRIUKAS;60785707116;Taip;6;2;0;8
3754;Karusėlė;TIGRIUKAS;18831943978;Taip;3;0;0;3
3755;Karusėlė;TIGRIUKAS;1253277950;Taip;0;0;1;1
3756;Karusėlė;TIGRIUKAS;19906965254;Taip;0;0;1;1
3757;Karusėlė;TIGRIUKAS;1817869518;Taip;15;0;0;15
3758;Karusėlė;TIGRIUKAS;1193711193;Taip;17;1;0;18
3759;Karusėlė;TIGRIUKAS;1773362652;Taip;5;1;0;6
3760;Karusėlė;TIGRIUKAS;3752570475;Taip;16;0;0;16
3761;Karusėlė;TIGRIUKAS;1305485683;Taip;0;4;0;4
3762;Karusėlė;TIGRIUKAS;8881750322;Taip;0;1;0;1
3763;Karusėlė;TIGRIUKAS;8946147763;Taip;7;0;0;7
3764;Karusėlė;TIGRIUKAS;4426462711;Taip;18;0;0;18
3765;Karusėlė;TIGRIUKAS;3960354989;Taip;15;0;0;15
3766;Karusėlė;TIGRIUKAS;1947403400;Taip;5;1;0;6
3767;Karusėlė;TIGRIUKAS;2036366726;Taip;5;0;0;5
3768;Karusėlė;VAIVORYKŠTĖ;27840592998;Taip;3;9;0;12
3769;Karusėlė;VAIVORYKŠTĖ;1979913722;Taip;0;6;0;6
3770;Karusėlė;VAIVORYKŠTĖ;89727334417;Taip;15;3;0;18
3771;Karusėlė;VAIVORYKŠTĖ;88371238657;Taip;1;0;6;7
3772;Karusėlė;VAIVORYKŠTĖ;21474974272;Taip;0;1;2;3
3773;Karusėlė;VAIVORYKŠTĖ;1629901230;Taip;6;0;0;6
3774;Karusėlė;VAIVORYKŠTĖ;2092642601;Taip;4;3;0;7
3775;Karusėlė;VAIVORYKŠTĖ;2083974132;Taip;5;6;0;11
3776;Karusėlė;VAIVORYKŠTĖ;1097025436;Taip;5;4;0;9
3777;Karusėlė;VAIVORYKŠTĖ;1945164524;Taip;0;7;0;7
3778;Karusėlė;VAIVORYKŠTĖ;1915396083;Taip;0;1;0;1
3779;Karusėlė;VAIVORYKŠTĖ;1094853107;Taip;6;6;0;12
3780;Karusėlė;VAIVORYKŠTĖ;40499469616;Taip;19;0;0;19
3781;Karusėlė;VAIVORYKŠTĖ;26373120499;Taip;3;0;0;3
3782;Karusėlė;VAIVORYKŠTĖ;78971949838;Taip;20;0;0;20
3783;Karusėlė;VAIVORYKŠTĖ;25859211954;Taip;9;0;0;9
3784;Karusėlė;VAIVORYKŠTĖ;47751458940;Taip;3;0;0;3
3785;Karusėlė;VAIVORYKŠTĖ;68537797465;Taip;6;9;0;15
3786;Karusėlė;VAIVORYKŠTĖ;50904986408;Taip;1;0;0;1
3787;Karusėlė;VAIVORYKŠTĖ;11336671763;Taip;10;8;0;18
3788;Karusėlė;VAIVORYKŠTĖ;9482894921;Taip;2;7;0;9
3789;Karusėlė;"AUKSINĖ ŽUVELĖ";77212719456;Taip;6;5;0;11
3790;Karusėlė;"AUKSINĖ ŽUVELĖ";1414085818;Taip;0;7;0;7
3791;Karusėlė;"AUKSINĖ ŽUVELĖ";4888730297;Taip;0;8;0;8
3792;Karusėlė;"AUKSINĖ ŽUVELĖ";1048086957;Taip;6;1;0;7
3793;Karusėlė;"AUKSINĖ ŽUVELĖ";1709733062;Taip;20;0;0;20
3794;Karusėlė;"AUKSINĖ ŽUVELĖ";26710882757;Taip;0;9;0;9
3795;Karusėlė;"AUKSINĖ ŽUVELĖ";47542882134;Taip;1;0;0;1
3796;Karusėlė;"AUKSINĖ ŽUVELĖ";6580115367;Taip;0;9;0;9
3797;Karusėlė;"AUKSINĖ ŽUVELĖ";27958836709;Taip;0;5;0;5
3798;Karusėlė;"AUKSINĖ ŽUVELĖ";76108591835;Taip;0;8;0;8
3799;Karusėlė;"AUKSINĖ ŽUVELĖ";30839035183;Taip;5;1;0;6
3800;Karusėlė;"AUKSINĖ ŽUVELĖ";23369021638;Taip;0;1;0;1
3801;Karusėlė;"AUKSINĖ ŽUVELĖ";2216383015;Taip;0;2;0;2
3802;Karusėlė;"AUKSINĖ ŽUVELĖ";58031363722;Taip;8;2;0;10
3803;Karusėlė;"AUKSINĖ ŽUVELĖ";41390857064;Taip;12;0;0;12
3804;Karusėlė;"AUKSINĖ ŽUVELĖ";1462103488;Taip;9;3;0;12
3805;Karusėlė;"AUKSINĖ ŽUVELĖ";2038901113;Taip;0;2;0;2
3806;Karusėlė;"AUKSINĖ ŽUVELĖ";1948979039;Taip;3;2;0;5
3807;Karusėlė;"AUKSINĖ ŽUVELĖ";6737041892;Taip;0;3;0;3
3808;Karusėlė;"AUKSINĖ ŽUVELĖ";1982350605;Taip;9;3;0;12
3809;Karusėlė;"AUKSINĖ ŽUVELĖ";4878805177;Taip;2;0;0;2
3810;Karusėlė;RAMUNĖ;5951045233;Taip;19;0;0;19
3811;Karusėlė;RAMUNĖ;9868386182;Taip;17;0;0;17
3812;Karusėlė;RAMUNĖ;2381566229;Taip;14;0;0;14
3813;Karusėlė;RAMUNĖ;2215367063;Taip;20;0;0;20
3814;Karusėlė;RAMUNĖ;6495631086;Taip;5;0;0;5
3815;Karusėlė;RAMUNĖ;1698478530;Taip;10;0;0;10
3816;Karusėlė;RAMUNĖ;5146709341;Taip;8;0;0;8
3817;Karusėlė;RAMUNĖ;8331985564;Taip;9;0;0;9
3818;Karusėlė;RAMUNĖ;5803808409;Taip;0;5;0;5
3819;Karusėlė;RAMUNĖ;5855430678;Taip;0;5;0;5
3820;Karusėlė;RAMUNĖ;9400171357;Taip;6;11;0;17
3821;Karusėlė;RAMUNĖ;5766390337;Taip;20;0;0;20
3822;Karusėlė;RAMUNĖ;8987444198;Taip;4;0;0;4
3823;Karusėlė;RAMUNĖ;6413701823;Taip;4;0;0;4
3824;Karusėlė;RAMUNĖ;2007411601;Taip;19;0;0;19
3825;Kaštonas;NYKŠTUKAI;41926955433;Taip;0;7;0;7
3826;Kaštonas;NYKŠTUKAI;81834426663;Taip;14;1;0;15
3827;Kaštonas;NYKŠTUKAI;1626798162;Taip;8;7;0;15
3828;Kaštonas;NYKŠTUKAI;46191613797;Taip;0;16;0;16
3829;Kaštonas;NYKŠTUKAI;76576870173;Taip;5;9;0;14
3830;Kaštonas;NYKŠTUKAI;1023364928;Taip;7;1;0;8
3831;Kaštonas;NYKŠTUKAI;1186956315;Taip;0;4;0;4
3832;Kaštonas;NYKŠTUKAI;1931800904;Taip;0;1;0;1
3833;Kaštonas;NYKŠTUKAI;1781481896;Taip;0;2;0;2
3834;Kaštonas;NYKŠTUKAI;9287426151;Taip;0;4;0;4
3835;Kaštonas;NYKŠTUKAI;6560054869;Taip;0;14;0;14
3836;Kaštonas;NYKŠTUKAI;9168456496;Taip;5;0;0;5
3837;Kaštonas;NYKŠTUKAI;3059036526;Taip;0;16;0;16
3838;Kaštonas;NYKŠTUKAI;8990194475;Taip;11;2;0;13
3839;Kaštonas;NYKŠTUKAI;9702914628;Taip;0;7;0;7
3840;Kaštonas;NYKŠTUKAI;41221846403;Taip;0;1;0;1
3841;Kaštonas;NYKŠTUKAI;3773227028;Taip;14;0;0;14
3842;Kaštonas;DRUGELIAI;25534865569;Ne;0;2;0;2
3843;Kaštonas;DRUGELIAI;10295996551;Taip;7;0;0;7
3844;Kaštonas;DRUGELIAI;91745369760;Ne;0;7;0;7
3845;Kaštonas;DRUGELIAI;78786250725;Taip;5;4;0;9
3846;Kaštonas;DRUGELIAI;7641793210;Taip;5;10;0;15
3847;Kaštonas;DRUGELIAI;46419017842;Taip;10;0;0;10
3848;Kaštonas;DRUGELIAI;59413506728;Taip;0;3;0;3
3849;Kaštonas;DRUGELIAI;29029841983;Taip;0;1;0;1
3850;Kaštonas;DRUGELIAI;3987211207;Taip;0;4;0;4
3851;Kaštonas;DRUGELIAI;1641976468;Ne;0;14;0;14
3852;Kaštonas;DRUGELIAI;2825343274;Taip;11;1;0;12
3853;Kaštonas;DRUGELIAI;54580238237;Taip;0;5;0;5
3854;Kaštonas;DRUGELIAI;8748600333;Taip;0;1;0;1
3855;Kaštonas;DRUGELIAI;87941682538;Taip;10;0;0;10
3856;Kaštonas;DRUGELIAI;17123843027;Taip;0;2;0;2
3857;Kaštonas;DRUGELIAI;1364683665;Taip;0;0;1;1
3858;Kaštonas;DRUGELIAI;75540345287;Taip;0;9;0;9
3859;Kaštonas;DRUGELIAI;23319023639;Taip;0;1;0;1
3860;Kaštonas;DRUGELIAI;16395082273;Taip;0;2;0;2
3861;Kaštonas;DRUGELIAI;7229267783;Taip;0;1;0;1
3862;Kaštonas;DRUGELIAI;2120469277;Taip;9;0;0;9
3863;Kaštonas;DRUGELIAI;61557505110;Taip;5;0;0;5
3864;Kaštonas;KIŠKUČIAI;1859126564;Taip;0;20;0;20
3865;Kaštonas;KIŠKUČIAI;57362664278;Taip;0;8;0;8
3866;Kaštonas;KIŠKUČIAI;4449017708;Ne;0;9;0;9
3867;Kaštonas;KIŠKUČIAI;2539596633;Taip;3;6;0;9
3868;Kaštonas;KIŠKUČIAI;3638565578;Taip;0;3;0;3
3869;Kaštonas;KIŠKUČIAI;5153948802;Taip;14;3;0;17
3870;Kaštonas;KIŠKUČIAI;4956177048;Taip;14;6;0;20
3871;Kaštonas;KIŠKUČIAI;2165890763;Taip;0;16;0;16
3872;Kaštonas;KIŠKUČIAI;5610113641;Taip;0;8;0;8
3873;Kaštonas;KIŠKUČIAI;2797443202;Taip;8;4;0;12
3874;Kaštonas;KIŠKUČIAI;3039980710;Taip;0;1;0;1
3875;Kaštonas;KIŠKUČIAI;3507672150;Taip;5;2;0;7
3876;Kaštonas;KIŠKUČIAI;3131712783;Taip;5;3;0;8
3877;Kaštonas;KIŠKUČIAI;1747580231;Ne;14;0;0;14
3878;Kaštonas;KIŠKUČIAI;1826015013;Taip;0;2;0;2
3879;Kaštonas;KIŠKUČIAI;7553024183;Taip;0;5;0;5
3880;Kaštonas;KIŠKUČIAI;5630659056;Taip;7;0;0;7
3881;Kaštonas;KIŠKUČIAI;8151333699;Taip;0;1;0;1
3882;Kaštonas;KIŠKUČIAI;2007064959;Taip;0;15;0;15
3883;Kaštonas;KIŠKUČIAI;7841179083;Taip;5;15;0;20
3884;Kaštonas;KIŠKUČIAI;3649329598;Taip;0;13;0;13
3885;Kaštonas;KIŠKUČIAI;8906976150;Taip;13;2;0;15
3886;Kaštonas;KIŠKUČIAI;7508357392;Taip;8;0;0;8
3887;Kaštonas;BITUTĖS;51558463647;Taip;0;2;0;2
3888;Kaštonas;BITUTĖS;8377601628;Ne;6;1;0;7
3889;Kaštonas;BITUTĖS;2062489205;Taip;0;4;0;4
3890;Kaštonas;BITUTĖS;78535860714;Taip;0;13;0;13
3891;Kaštonas;BITUTĖS;2146285017;Taip;11;2;0;13
3892;Kaštonas;BITUTĖS;98526928421;Taip;0;9;0;9
3893;Kaštonas;BITUTĖS;52212151760;Taip;7;0;0;7
3894;Kaštonas;BITUTĖS;1292350264;Taip;0;7;0;7
3895;Kaštonas;BITUTĖS;3967999408;Taip;3;1;0;4
3896;Kaštonas;BITUTĖS;1380861719;Taip;0;3;0;3
3897;Kaštonas;BITUTĖS;18542160352;Taip;20;0;0;20
3898;Kaštonas;BITUTĖS;1162926887;Taip;17;0;0;17
3899;Kaštonas;BITUTĖS;1459614385;Taip;8;10;0;18
3900;Kaštonas;BITUTĖS;9167719015;Taip;14;2;0;16
3901;Kaštonas;BITUTĖS;4250816034;Taip;0;9;0;9
3902;Kaštonas;BITUTĖS;2801321116;Taip;0;2;0;2
3903;Kaštonas;BITUTĖS;9967553882;Taip;0;10;0;10
3904;Kaštonas;BITUTĖS;27082059521;Taip;11;0;0;11
3905;Kaštonas;BITUTĖS;1465714333;Taip;0;4;0;4
3906;Kaštonas;BITUTĖS;1252815477;Taip;0;16;0;16
3907;Kaštonas;BITUTĖS;7557437205;Taip;0;1;0;1
3908;Kaštonas;BITUTĖS;92533370070;Taip;8;4;0;12
3909;Kaštonas;BITUTĖS;9215070593;Taip;0;10;0;10
3910;Kaštonas;BITUTĖS;6511223066;Taip;0;2;0;2
3911;Kaštonas;BITUTĖS;2504312724;Taip;5;4;0;9
3912;Kaštonas;MEŠKIUKAI;13105582649;Taip;0;17;0;17
3913;Kaštonas;MEŠKIUKAI;1420929477;Taip;11;7;0;18
3914;Kaštonas;MEŠKIUKAI;2764004779;Taip;5;1;0;6
3915;Kaštonas;MEŠKIUKAI;94748215851;Taip;5;12;0;17
3916;Kaštonas;MEŠKIUKAI;66717201099;Taip;14;2;0;16
3917;Kaštonas;MEŠKIUKAI;12358360731;Taip;6;4;0;10
3918;Kaštonas;MEŠKIUKAI;97106889191;Taip;10;7;0;17
3919;Kaštonas;MEŠKIUKAI;8042807487;Taip;0;3;0;3
3920;Kaštonas;MEŠKIUKAI;2711819539;Taip;8;4;0;12
3921;Kaštonas;MEŠKIUKAI;1294879767;Taip;5;5;0;10
3922;Kaštonas;MEŠKIUKAI;1367704050;Taip;19;0;0;19
3923;Kaštonas;MEŠKIUKAI;5722934228;Taip;0;7;0;7
3924;Kaštonas;MEŠKIUKAI;89221382880;Taip;6;5;0;11
3925;Kaštonas;MEŠKIUKAI;65960895249;Taip;5;0;0;5
3926;Kaštonas;MEŠKIUKAI;69883785412;Taip;0;5;0;5
3927;Kaštonas;MEŠKIUKAI;1049699735;Taip;14;2;0;16
3928;Kaštonas;MEŠKIUKAI;1385352925;Taip;0;3;0;3
3929;Kaštonas;MEŠKIUKAI;5557487532;Taip;4;0;0;4
3930;Kaštonas;MEŠKIUKAI;2760501432;Ne;7;3;0;10
3931;Kaštonas;MEŠKIUKAI;70838449788;Ne;0;6;0;6
3932;Kaštonas;MEŠKIUKAI;1249299633;Taip;0;2;0;2
3933;Kaštonas;MEŠKIUKAI;1196590128;Taip;20;0;0;20
3934;Kaštonas;BORUŽĖLĖS;6967725663;Taip;0;15;0;15
3935;Kaštonas;BORUŽĖLĖS;5478395437;Taip;8;0;0;8
3936;Kaštonas;BORUŽĖLĖS;6606094891;Taip;8;1;0;9
3937;Kaštonas;BORUŽĖLĖS;1364391105;Taip;8;1;0;9
3938;Kaštonas;BORUŽĖLĖS;2125410714;Taip;8;0;0;8
3939;Kaštonas;BORUŽĖLĖS;7956422880;Taip;0;19;0;19
3940;Kaštonas;BORUŽĖLĖS;8564586014;Taip;8;2;0;10
3941;Kaštonas;BORUŽĖLĖS;5328263421;Taip;12;5;0;17
3942;Kaštonas;BORUŽĖLĖS;3961661158;Taip;8;1;0;9
3943;Kaštonas;BORUŽĖLĖS;6251564828;Taip;5;4;0;9
3944;Kaštonas;BORUŽĖLĖS;7291448857;Taip;12;0;0;12
3945;Kaštonas;BORUŽĖLĖS;3105500733;Taip;12;0;0;12
3946;Kaštonas;BORUŽĖLĖS;6175014441;Taip;0;17;0;17
3947;Kaštonas;BORUŽĖLĖS;4450146424;Taip;0;12;0;12
3948;Kaštonas;BORUŽĖLĖS;5548875714;Taip;7;0;0;7
3949;Kaštonas;BORUŽĖLĖS;3333990952;Taip;7;0;0;7
3950;Kaštonas;BORUŽĖLĖS;8166925991;Taip;0;11;0;11
3951;Krivūlė;SPINDULIUKAI;59978148537;Taip;5;3;1;9
3952;Krivūlė;SPINDULIUKAI;55356606791;Taip;14;0;0;14
3953;Krivūlė;SPINDULIUKAI;10728010124;Taip;5;0;0;5
3954;Krivūlė;SPINDULIUKAI;45328749559;Taip;7;0;0;7
3955;Krivūlė;SPINDULIUKAI;88714209343;Taip;0;0;12;12
3956;Krivūlė;SPINDULIUKAI;50715118246;Taip;8;1;0;9
3957;Krivūlė;SPINDULIUKAI;43180342657;Taip;5;0;1;6
3958;Krivūlė;SPINDULIUKAI;78895964424;Taip;0;5;5;10
3959;Krivūlė;SPINDULIUKAI;9864428506;Taip;8;0;0;8
3960;Krivūlė;SPINDULIUKAI;58431942;Taip;0;6;5;11
3961;Krivūlė;SPINDULIUKAI;48514609257;Taip;5;0;2;7
3962;Krivūlė;SPINDULIUKAI;49698343392;Taip;4;2;0;6
3963;Krivūlė;SPINDULIUKAI;1361647836;Taip;6;0;1;7
3964;Krivūlė;SPINDULIUKAI;3157698386;Taip;7;0;0;7
3965;Krivūlė;SPINDULIUKAI;91823213506;Taip;0;0;20;20
3966;Krivūlė;SPINDULIUKAI;26046598666;Taip;10;0;4;14
3967;Krivūlė;SPINDULIUKAI;52632731467;Taip;12;6;0;18
3968;Krivūlė;SPINDULIUKAI;1443815293;Taip;8;0;1;9
3969;Krivūlė;SPINDULIUKAI;1980001276;Taip;10;0;0;10
3970;Krivūlė;SPINDULIUKAI;14824959974;Taip;5;4;0;9
3971;Krivūlė;BORUŽĖLĖS;4969782237;Taip;9;0;2;11
3972;Krivūlė;BORUŽĖLĖS;4845515196;Taip;1;0;7;8
3973;Krivūlė;BORUŽĖLĖS;5676562063;Taip;10;0;1;11
3974;Krivūlė;BORUŽĖLĖS;6935969502;Taip;10;0;1;11
3975;Krivūlė;BORUŽĖLĖS;4972360440;Taip;14;0;0;14
3976;Krivūlė;BORUŽĖLĖS;7318064702;Taip;5;2;0;7
3977;Krivūlė;BORUŽĖLĖS;3912620138;Taip;0;0;4;4
3978;Krivūlė;BORUŽĖLĖS;3246787504;Taip;6;0;1;7
3979;Krivūlė;BORUŽĖLĖS;5531566792;Taip;9;0;0;9
3980;Krivūlė;BORUŽĖLĖS;2386053480;Taip;12;0;5;17
3981;Krivūlė;BORUŽĖLĖS;8586287004;Taip;10;0;1;11
3982;Krivūlė;BORUŽĖLĖS;4540069843;Taip;14;0;5;19
3983;Krivūlė;BORUŽĖLĖS;4297876008;Taip;0;13;0;13
3984;Krivūlė;BORUŽĖLĖS;2138125571;Taip;12;2;5;19
3985;Krivūlė;BORUŽĖLĖS;4257468922;Taip;11;0;1;12
3986;Krivūlė;BORUŽĖLĖS;4177660973;Taip;5;6;0;11
3987;Krivūlė;BORUŽĖLĖS;2517785727;Taip;15;0;0;15
3988;Krivūlė;BORUŽĖLĖS;2711010212;Taip;0;19;0;19
3989;Krivūlė;BORUŽĖLĖS;4025821636;Taip;14;0;0;14
3990;Krivūlė;DRUGELIŲ;23648162135;Taip;11;0;0;11
3991;Krivūlė;DRUGELIŲ;1061891147;Taip;0;5;2;7
3992;Krivūlė;DRUGELIŲ;61141298766;Taip;1;1;1;3
3993;Krivūlė;DRUGELIŲ;3203271448;Taip;11;0;0;11
3994;Krivūlė;DRUGELIŲ;56163922565;Taip;10;2;0;12
3995;Krivūlė;DRUGELIŲ;29375281615;Taip;0;7;0;7
3996;Krivūlė;DRUGELIŲ;29880105166;Taip;14;0;0;14
3997;Krivūlė;DRUGELIŲ;10583191450;Taip;0;0;2;2
3998;Krivūlė;DRUGELIŲ;13434120023;Taip;5;5;0;10
3999;Krivūlė;DRUGELIŲ;60140618216;Taip;0;1;0;1
4000;Krivūlė;DRUGELIŲ;5825154729;Taip;0;0;2;2
4001;Krivūlė;DRUGELIŲ;54700834388;Taip;12;0;1;13
4002;Krivūlė;DRUGELIŲ;1465116151;Taip;0;2;0;2
4003;Krivūlė;DRUGELIŲ;1091759903;Taip;10;0;1;11
4004;Krivūlė;DRUGELIŲ;21718245739;Taip;0;4;2;6
4005;Krivūlė;DRUGELIŲ;97176703854;Taip;0;2;0;2
4006;Krivūlė;DRUGELIŲ;3594180341;Ne;0;0;1;1
4007;Krivūlė;"BITUTĖS (VALDOFRO)";4205061357;Taip;5;0;2;7
4008;Krivūlė;"BITUTĖS (VALDOFRO)";73736799724;Taip;0;3;1;4
4009;Krivūlė;"BITUTĖS (VALDOFRO)";60958909807;Taip;0;4;1;5
4010;Krivūlė;"BITUTĖS (VALDOFRO)";66552145067;Taip;5;9;0;14
4011;Krivūlė;"BITUTĖS (VALDOFRO)";66555601736;Taip;0;4;8;12
4012;Krivūlė;"BITUTĖS (VALDOFRO)";99074500749;Taip;0;4;8;12
4013;Krivūlė;"BITUTĖS (VALDOFRO)";46337826378;Taip;0;4;0;4
4014;Krivūlė;"BITUTĖS (VALDOFRO)";98620856056;Taip;5;6;0;11
4015;Krivūlė;"BITUTĖS (VALDOFRO)";97075230746;Taip;5;4;0;9
4016;Krivūlė;"BITUTĖS (VALDOFRO)";91939517475;Taip;0;0;1;1
4017;Krivūlė;"BITUTĖS (VALDOFRO)";97859012083;Taip;0;4;5;9
4018;Krivūlė;"BITUTĖS (VALDOFRO)";37704437957;Taip;11;0;1;12
4019;Krivūlė;"BITUTĖS (VALDOFRO)";2425023811;Taip;10;0;0;10
4020;Krivūlė;"BITUTĖS (VALDOFRO)";4838666934;Taip;0;0;1;1
4021;Krivūlė;"BITUTĖS (VALDOFRO)";3994278221;Taip;4;0;1;5
4022;Krivūlė;"BITUTĖS (VALDOFRO)";3868507751;Taip;0;1;0;1
4023;Krivūlė;"BITUTĖS (VALDOFRO)";18486357195;Taip;0;4;0;4
4024;Krivūlė;"BITUTĖS (VALDOFRO)";7789248863;Taip;6;0;0;6
4025;Krivūlė;EŽIUKAI;10433396718;Taip;7;0;1;8
4026;Krivūlė;EŽIUKAI;80991786508;Taip;5;4;2;11
4027;Krivūlė;EŽIUKAI;2302809484;Taip;7;0;3;10
4028;Krivūlė;EŽIUKAI;44741515819;Taip;7;0;0;7
4029;Krivūlė;EŽIUKAI;2099607493;Taip;16;0;1;17
4030;Krivūlė;EŽIUKAI;1989923269;Taip;1;0;2;3
4031;Krivūlė;EŽIUKAI;1290759541;Taip;8;4;7;19
4032;Krivūlė;EŽIUKAI;28308524979;Taip;16;0;0;16
4033;Krivūlė;EŽIUKAI;1590383390;Taip;8;0;0;8
4034;Krivūlė;EŽIUKAI;1699961817;Taip;0;1;1;2
4035;Krivūlė;EŽIUKAI;96319752378;Taip;20;0;0;20
4036;Krivūlė;EŽIUKAI;66981981114;Taip;0;0;8;8
4037;Krivūlė;EŽIUKAI;50967415904;Taip;0;0;2;2
4038;Krivūlė;EŽIUKAI;1265788772;Taip;6;0;4;10
4039;Krivūlė;EŽIUKAI;1113101710;Taip;0;20;0;20
4040;Krivūlė;EŽIUKAI;8463621294;Taip;7;0;0;7
4041;Krivūlė;EŽIUKAI;86659723162;Taip;6;0;0;6
4042;Krivūlė;EŽIUKAI;2125078552;Taip;0;0;14;14
4043;Krivūlė;EŽIUKAI;2903062788;Ne;0;0;1;1
4044;Krivūlė;EŽIUKAI;81401012140;Taip;6;0;4;10
4045;Krivūlė;NYKŠTUKAI;37502093836;Taip;20;0;0;20
4046;Krivūlė;NYKŠTUKAI;83840444975;Taip;20;0;0;20
4047;Krivūlė;NYKŠTUKAI;1769984489;Taip;10;1;0;11
4048;Krivūlė;NYKŠTUKAI;9267414141;Taip;11;0;0;11
4049;Krivūlė;NYKŠTUKAI;19674882649;Taip;12;0;1;13
4050;Krivūlė;NYKŠTUKAI;701438210;Taip;13;0;1;14
4051;Krivūlė;NYKŠTUKAI;1657452686;Taip;18;0;0;18
4052;Krivūlė;NYKŠTUKAI;73760357378;Taip;6;0;1;7
4053;Krivūlė;NYKŠTUKAI;3015266398;Taip;0;0;9;9
4054;Krivūlė;NYKŠTUKAI;7873123757;Taip;5;5;0;10
4055;Krivūlė;NYKŠTUKAI;97398901468;Taip;12;0;0;12
4056;Krivūlė;NYKŠTUKAI;10005041572;Taip;10;0;0;10
4057;Krivūlė;NYKŠTUKAI;1515185307;Taip;0;4;1;5
4058;Krivūlė;NYKŠTUKAI;1217856292;Taip;16;0;0;16
4059;Krivūlė;NYKŠTUKAI;3064591570;Taip;2;0;3;5
4060;Krivūlė;NYKŠTUKAI;7922515745;Taip;17;0;0;17
4061;Krivūlė;NYKŠTUKAI;9311270695;Taip;5;0;0;5
4062;Krivūlė;NYKŠTUKAI;6861483854;Taip;6;0;1;7
4063;Krivūlė;NYKŠTUKAI;1283858948;Taip;11;0;0;11
4064;Krivūlė;NYKŠTUKAI;7052198958;Taip;14;0;0;14
4065;Krivūlė;NYKŠTUKAI;5818988913;Taip;11;0;0;11
4066;Kodėlčiukas;Saulutės;42540143229;Taip;0;4;0;4
4067;Kodėlčiukas;Saulutės;79090323340;Taip;0;4;0;4
4068;Kodėlčiukas;Saulutės;5922075420;Taip;0;0;2;2
4069;Kodėlčiukas;Saulutės;82725509126;Taip;0;2;0;2
4070;Kodėlčiukas;Saulutės;1905426469;Taip;6;2;2;10
4071;Kodėlčiukas;Saulutės;79742559803;Taip;0;1;0;1
4072;Kodėlčiukas;Saulutės;68236236113;Taip;0;6;0;6
4073;Kodėlčiukas;Saulutės;62309098505;Taip;0;7;0;7
4074;Kodėlčiukas;Saulutės;14611425618;Taip;2;6;0;8
4075;Kodėlčiukas;Saulutės;49784617790;Taip;0;4;0;4
4076;Kodėlčiukas;Saulutės;43335982030;Taip;9;0;0;9
4077;Kodėlčiukas;Saulutės;49731697380;Taip;5;0;0;5
4078;Kodėlčiukas;Saulutės;23065888472;Taip;1;9;0;10
4079;Kodėlčiukas;Saulutės;1730913401;Taip;9;3;1;13
4080;Kodėlčiukas;Saulutės;98738524708;Taip;0;4;0;4
4081;Kodėlčiukas;Saulutės;66109277013;Taip;0;4;0;4
4082;Kodėlčiukas;Saulutės;30952731344;Taip;5;0;0;5
4083;Kodėlčiukas;Saulutės;45910018746;Taip;0;3;0;3
4084;Kodėlčiukas;Saulutės;1608321100;Taip;1;0;0;1
4085;Kodėlčiukas;Saulutės;24024963204;Taip;0;0;1;1
4086;Kodėlčiukas;Saulutės;1290630625;Taip;0;4;1;5
4087;Kodėlčiukas;Saulutės;9323563664;Taip;0;0;1;1
4088;Kodėlčiukas;Nežiniukai;49317624340;Taip;19;0;0;19
4089;Kodėlčiukas;Nežiniukai;41477530966;Taip;0;9;0;9
4090;Kodėlčiukas;Nežiniukai;69860272843;Taip;0;7;0;7
4091;Kodėlčiukas;Nežiniukai;52040715568;Taip;0;14;0;14
4092;Kodėlčiukas;Nežiniukai;37852137155;Taip;5;0;1;6
4093;Kodėlčiukas;Nežiniukai;86134523927;Taip;0;0;6;6
4094;Kodėlčiukas;Nežiniukai;27110279093;Taip;14;0;1;15
4095;Kodėlčiukas;Nežiniukai;47677246360;Taip;8;0;0;8
4096;Kodėlčiukas;Nežiniukai;46307870009;Taip;15;1;1;17
4097;Kodėlčiukas;Nežiniukai;33432780322;Taip;14;1;0;15
4098;Kodėlčiukas;Nežiniukai;96270550335;Taip;0;5;0;5
4099;Kodėlčiukas;Nežiniukai;98476858512;Taip;0;1;0;1
4100;Kodėlčiukas;Nežiniukai;50234358109;Taip;4;0;0;4
4101;Kodėlčiukas;Nežiniukai;53066448447;Taip;0;6;0;6
4102;Kodėlčiukas;Nežiniukai;30874603769;Taip;0;0;12;12
4103;Kodėlčiukas;Nežiniukai;50411894014;Ne;0;0;4;4
4104;Kodėlčiukas;Nežiniukai;93698504377;Taip;11;0;2;13
4105;Kodėlčiukas;Nežiniukai;1518135854;Ne;0;0;6;6
4106;Kodėlčiukas;Nežiniukai;41664027247;Taip;0;0;2;2
4107;Kodėlčiukas;Nežiniukai;35779814505;Taip;5;4;0;9
4108;Kodėlčiukas;Nežiniukai;1614088526;Taip;5;0;1;6
4109;Kodėlčiukas;Nežiniukai;1347742983;Taip;0;1;1;2
4110;Kodėlčiukas;Nežiniukai;1951603132;Taip;4;0;0;4
4111;Kodėlčiukas;Nežiniukai;15211280060;Taip;10;0;2;12
4112;Kodėlčiukas;Gintarėliai;58406224468;Taip;11;0;0;11
4113;Kodėlčiukas;Gintarėliai;1485012710;Taip;0;2;0;2
4114;Kodėlčiukas;Gintarėliai;5520128823;Taip;0;0;4;4
4115;Kodėlčiukas;Gintarėliai;2062878300;Taip;15;0;0;15
4116;Kodėlčiukas;Gintarėliai;20084022099;Taip;13;0;0;13
4117;Kodėlčiukas;Gintarėliai;1950934087;Taip;6;0;1;7
4118;Kodėlčiukas;Gintarėliai;9686497547;Taip;3;0;0;3
4119;Kodėlčiukas;Gintarėliai;4884104023;Taip;9;0;1;10
4120;Kodėlčiukas;Gintarėliai;1632458573;Taip;7;0;1;8
4121;Kodėlčiukas;Gintarėliai;9332136116;Taip;15;0;0;15
4122;Kodėlčiukas;Gintarėliai;4944791330;Taip;10;0;1;11
4123;Kodėlčiukas;Gintarėliai;8219424737;Taip;14;0;0;14
4124;Kodėlčiukas;Gintarėliai;4849314647;Taip;0;0;1;1
4125;Kodėlčiukas;Gintarėliai;5202375085;Taip;6;0;0;6
4126;Kodėlčiukas;Gintarėliai;1923835699;Taip;0;0;3;3
4127;Kodėlčiukas;Gintarėliai;3758606327;Taip;18;0;0;18
4128;Kodėlčiukas;Gintarėliai;8647609373;Taip;20;0;0;20
4129;Kodėlčiukas;Gintarėliai;4738357524;Taip;5;0;0;5
4130;Kodėlčiukas;Gintarėliai;8075591032;Taip;11;0;0;11
4131;Kodėlčiukas;Gintarėliai;8873629130;Taip;14;0;0;14
4132;Kodėlčiukas;Gintarėliai;2765869141;Taip;0;0;6;6
4133;Kodėlčiukas;Šnekučiai;1844016431;Taip;15;0;0;15
4134;Kodėlčiukas;Šnekučiai;1550915654;Taip;7;0;0;7
4135;Kodėlčiukas;Šnekučiai;1935757837;Taip;8;6;0;14
4136;Kodėlčiukas;Šnekučiai;41123326737;Taip;5;0;0;5
4137;Kodėlčiukas;Šnekučiai;8114859362;Taip;11;0;2;13
4138;Kodėlčiukas;Šnekučiai;1666743304;Taip;5;0;1;6
4139;Kodėlčiukas;Šnekučiai;1432342305;Taip;6;0;2;8
4140;Kodėlčiukas;Šnekučiai;1584936719;Taip;14;0;0;14
4141;Kodėlčiukas;Šnekučiai;9178209049;Taip;14;0;0;14
4142;Kodėlčiukas;Šnekučiai;5988863934;Taip;7;6;0;13
4143;Kodėlčiukas;Šnekučiai;2742365461;Taip;1;9;0;10
4144;Kodėlčiukas;Šnekučiai;76164689333;Taip;7;0;1;8
4145;Kodėlčiukas;Šnekučiai;5386820408;Taip;0;1;0;1
4146;Kodėlčiukas;Šnekučiai;6194726931;Taip;14;0;2;16
4147;Kodėlčiukas;Šnekučiai;6327741830;Taip;8;8;4;20
4148;Kodėlčiukas;Šnekučiai;5782600824;Taip;11;0;1;12
4149;Kodėlčiukas;Šnekučiai;7074381835;Taip;14;0;3;17
4150;Kodėlčiukas;Šnekučiai;7757494295;Taip;15;0;0;15
4151;Kodėlčiukas;Šnekučiai;5827455834;Taip;10;1;0;11
4152;Kodėlčiukas;Šnekučiai;2988674717;Taip;15;0;0;15
4153;Kodėlčiukas;Pabiručiai;2108297221;Taip;0;0;1;1
4154;Kodėlčiukas;Pabiručiai;81633973264;Taip;0;0;1;1
4155;Kodėlčiukas;Pabiručiai;51185323645;Taip;0;1;5;6
4156;Kodėlčiukas;Pabiručiai;48423906431;Taip;0;0;1;1
4157;Kodėlčiukas;Pabiručiai;87708953660;Taip;0;1;3;4
4158;Kodėlčiukas;Pabiručiai;53418429595;Taip;0;1;0;1
4159;Kodėlčiukas;Pabiručiai;88106769076;Taip;16;0;0;16
4160;Kodėlčiukas;Pabiručiai;62762045244;Taip;0;5;1;6
4161;Kodėlčiukas;Pabiručiai;5333383758;Taip;0;5;0;5
4162;Kodėlčiukas;Pabiručiai;63558518927;Taip;0;0;5;5
4163;Kodėlčiukas;Pabiručiai;6878848127;Taip;0;0;1;1
4164;Kodėlčiukas;Pabiručiai;78294320340;Taip;0;3;0;3
4165;Kodėlčiukas;Pabiručiai;94058317569;Taip;0;0;6;6
4166;Kodėlčiukas;Pabiručiai;77935011738;Taip;0;2;0;2
4167;Kodėlčiukas;Pabiručiai;2315513519;Taip;1;0;1;2
4168;Kodėlčiukas;Pabiručiai;1833960742;Taip;0;8;0;8
4169;Kodėlčiukas;Pabiručiai;5421835194;Taip;10;1;0;11
4170;Kodėlčiukas;Pabiručiai;60728060670;Taip;0;2;0;2
4171;Kodėlčiukas;Smalsučiai;83992508203;Taip;0;4;0;4
4172;Kodėlčiukas;Smalsučiai;67642708813;Taip;8;0;0;8
4173;Kodėlčiukas;Smalsučiai;20612460521;Taip;0;1;1;2
4174;Kodėlčiukas;Smalsučiai;36383021317;Ne;8;3;0;11
4175;Kodėlčiukas;Smalsučiai;67870841376;Taip;0;0;1;1
4176;Kodėlčiukas;Smalsučiai;9551387327;Taip;4;0;0;4
4177;Kodėlčiukas;Smalsučiai;12032780110;Taip;0;0;4;4
4178;Kodėlčiukas;Smalsučiai;14856898838;Taip;7;4;1;12
4179;Kodėlčiukas;Smalsučiai;4126338806;Taip;2;5;1;8
4180;Kodėlčiukas;Smalsučiai;96798716829;Taip;0;8;0;8
4181;Kodėlčiukas;Smalsučiai;30131221448;Taip;2;0;1;3
4182;Kodėlčiukas;Smalsučiai;84863948327;Taip;14;0;0;14
4183;Kodėlčiukas;Smalsučiai;85578471272;Taip;5;0;4;9
4184;Kodėlčiukas;Smalsučiai;74068673680;Taip;2;2;0;4
4185;Kodėlčiukas;Smalsučiai;70047045302;Ne;9;2;0;11
4186;Kodėlčiukas;Smalsučiai;83002620619;Taip;0;6;0;6
4187;Kodėlčiukas;Smalsučiai;39818301789;Taip;5;8;0;13
4188;Kodėlčiukas;Smalsučiai;83838177418;Taip;0;2;0;2
4189;Kodėlčiukas;Smalsučiai;32715685481;Taip;8;0;1;9
4190;Kodėlčiukas;Smalsučiai;90639838215;Taip;0;8;0;8
4191;Kodėlčiukas;Smalsučiai;35263905371;Taip;0;5;0;5
4192;Kodėlčiukas;Smalsučiai;76998539095;Taip;5;4;1;10
4193;Kodėlčiukas;Smalsučiai;10616561892;Taip;3;0;2;5
4194;Kodėlčiukas;Giliukai;26010333641;Taip;1;0;1;2
4195;Kodėlčiukas;Giliukai;90443995599;Taip;7;2;0;9
4196;Kodėlčiukas;Giliukai;1782784297;Taip;8;7;0;15
4197;Kodėlčiukas;Giliukai;97902789189;Taip;0;0;2;2
4198;Kodėlčiukas;Giliukai;99164081259;Taip;1;1;1;3
4199;Kodėlčiukas;Giliukai;93684599166;Taip;0;1;1;2
4200;Kodėlčiukas;Giliukai;88371652763;Taip;0;4;0;4
4201;Kodėlčiukas;Giliukai;80767435810;Taip;6;1;0;7
4202;Kodėlčiukas;Giliukai;62063291384;Taip;5;1;2;8
4203;Kodėlčiukas;Giliukai;1825630143;Taip;15;0;5;20
4204;Kodėlčiukas;Giliukai;11130172902;Taip;5;0;2;7
4205;Kodėlčiukas;Giliukai;29830674331;Taip;0;2;1;3
4206;Kodėlčiukas;Giliukai;1330761392;Taip;1;0;2;3
4207;Kodėlčiukas;Giliukai;24138056567;Taip;5;0;0;5
4208;Kodėlčiukas;Giliukai;84905680496;Taip;0;4;0;4
4209;Kodėlčiukas;Giliukai;58893099621;Taip;0;0;6;6
4210;Kodėlčiukas;Giliukai;2637712514;Taip;7;0;0;7
4211;Kodėlčiukas;Giliukai;1354133871;Taip;0;0;7;7
4212;Kodėlčiukas;Giliukai;45393129631;Taip;15;0;0;15
4213;Kodėlčiukas;Giliukai;47667750562;Taip;10;0;0;10
4214;Kodėlčiukas;Giliukai;8204069897;Taip;19;0;0;19
4215;Kodėlčiukas;Giliukai;1938753417;Taip;3;0;1;4
4216;Kodėlčiukas;Giliukai;29319461634;Taip;0;2;0;2
4217;Kodėlčiukas;Gudručiai;20467065338;Taip;10;0;2;12
4218;Kodėlčiukas;Gudručiai;44431255380;Taip;0;0;7;7
4219;Kodėlčiukas;Gudručiai;32318234528;Taip;1;0;2;3
4220;Kodėlčiukas;Gudručiai;9315712284;Taip;12;0;0;12
4221;Kodėlčiukas;Gudručiai;93275059990;Taip;0;8;0;8
4222;Kodėlčiukas;Gudručiai;18557158044;Taip;0;0;5;5
4223;Kodėlčiukas;Gudručiai;3542081571;Taip;0;0;9;9
4224;Kodėlčiukas;Gudručiai;84450296241;Taip;0;4;0;4
4225;Kodėlčiukas;Gudručiai;1234971388;Taip;0;4;0;4
4226;Kodėlčiukas;Gudručiai;1048653620;Taip;10;0;1;11
4227;Kodėlčiukas;Gudručiai;1202105251;Taip;0;1;4;5
4228;Kodėlčiukas;Gudručiai;1662717348;Taip;9;0;1;10
4229;Kodėlčiukas;Gudručiai;1978279511;Taip;6;0;0;6
4230;Kodėlčiukas;Gudručiai;1251970125;Taip;10;0;0;10
4231;Kodėlčiukas;Gudručiai;6186365121;Taip;0;1;0;1
4232;Kodėlčiukas;Gudručiai;70940790491;Taip;8;0;3;11
4233;Kodėlčiukas;Gudručiai;6168432879;Taip;5;3;0;8
4234;Kodėlčiukas;Gudručiai;1106092960;Taip;4;1;1;6
4235;Kodėlčiukas;Gudručiai;8393750817;Taip;0;0;5;5
4236;Kodėlčiukas;Gudručiai;2061169442;Taip;0;0;4;4
4237;Kodėlčiukas;Gudručiai;1115828736;Taip;3;1;0;4
4238;Kodėlčiukas;Gudručiai;1723716524;Taip;10;1;0;11
4239;Kodėlčiukas;Gudručiai;87784905691;Taip;0;2;0;2
4240;Kodėlčiukas;Žirniukai;1645680526;Taip;7;0;0;7
4241;Kodėlčiukas;Žirniukai;7327247516;Taip;7;0;0;7
4242;Kodėlčiukas;Žirniukai;1725624698;Taip;13;1;0;14
4243;Kodėlčiukas;Žirniukai;6517880481;Taip;7;0;0;7
4244;Kodėlčiukas;Žirniukai;3385551650;Taip;10;0;1;11
4245;Kodėlčiukas;Žirniukai;7080578299;Taip;9;0;3;12
4246;Kodėlčiukas;Žirniukai;9865803714;Taip;16;0;4;20
4247;Kodėlčiukas;Žirniukai;2464972409;Taip;14;0;2;16
4248;Kodėlčiukas;Žirniukai;7116594055;Taip;4;0;4;8
4249;Kodėlčiukas;Žirniukai;8393893311;Taip;0;0;8;8
4250;Kodėlčiukas;Žirniukai;8890987483;Taip;6;0;0;6
4251;Kodėlčiukas;Žirniukai;7509476161;Taip;6;4;0;10
4252;Kodėlčiukas;Žirniukai;4687333060;Taip;11;1;0;12
4253;Kodėlčiukas;Žirniukai;1491160730;Taip;4;0;0;4
4254;Kodėlčiukas;Žirniukai;2216791610;Taip;10;0;0;10
4255;Kodėlčiukas;Katinėliai;6248137523;Taip;0;0;4;4
4256;Kodėlčiukas;Katinėliai;1233880820;Taip;13;0;2;15
4257;Kodėlčiukas;Katinėliai;5443377251;Taip;10;0;0;10
4258;Kodėlčiukas;Katinėliai;6045564826;Taip;20;0;0;20
4259;Kodėlčiukas;Katinėliai;7282579315;Taip;4;0;2;6
4260;Kodėlčiukas;Katinėliai;6905424567;Taip;10;0;0;10
4261;Kodėlčiukas;Katinėliai;3150006441;Taip;10;0;0;10
4262;Kodėlčiukas;Katinėliai;7626940433;Taip;6;3;0;9
4263;Kodėlčiukas;Katinėliai;9803206596;Taip;19;0;1;20
4264;Kodėlčiukas;Katinėliai;4917910801;Taip;12;1;0;13
4265;Kodėlčiukas;Katinėliai;1699358514;Taip;9;5;1;15
4266;Kodėlčiukas;Katinėliai;3473981974;Taip;15;0;0;15
4267;Kodėlčiukas;Katinėliai;4038168647;Taip;14;0;5;19
4268;Kodėlčiukas;Katinėliai;8378295683;Taip;0;10;0;10
4269;Kodėlčiukas;Katinėliai;6000831611;Taip;5;0;1;6
4270;Kodėlčiukas;Nykštukai;7246243975;Taip;15;0;0;15
4271;Kodėlčiukas;Nykštukai;1906128091;Taip;11;1;1;13
4272;Kodėlčiukas;Nykštukai;8879977943;Taip;0;18;0;18
4273;Kodėlčiukas;Nykštukai;8140940288;Taip;9;6;1;16
4274;Kodėlčiukas;Nykštukai;2929946390;Taip;8;5;0;13
4275;Kodėlčiukas;Nykštukai;9528997865;Taip;10;6;0;16
4276;Kodėlčiukas;Nykštukai;3782714343;Taip;0;0;3;3
4277;Kodėlčiukas;Nykštukai;1600501494;Taip;7;0;0;7
4278;Kodėlčiukas;Nykštukai;9460792167;Taip;3;0;2;5
4279;Kodėlčiukas;Nykštukai;1256650715;Taip;14;0;5;19
4280;Kodėlčiukas;Nykštukai;4818678923;Taip;20;0;0;20
4281;Kodėlčiukas;Nykštukai;8302606312;Taip;5;0;1;6
4282;Kodėlčiukas;Nykštukai;1919722425;Taip;0;0;1;1
4283;Kodėlčiukas;Nykštukai;1218904283;Taip;7;0;0;7
4284;Kodėlčiukas;Nykštukai;3880019350;Taip;7;0;3;10
4285;Kodėlčiukas;Nykštukai;7630180473;Taip;16;0;3;19
4286;Kodėlčiukas;Nykštukai;9589692031;Taip;20;0;0;20
4287;Kodėlčiukas;Nykštukai;7324303899;Taip;3;0;1;4
4288;Kodėlčiukas;Nykštukai;2593524511;Taip;19;0;0;19
4289;Kodėlčiukas;Nykštukai;9794875862;Taip;5;0;2;7
4290;Kodėlčiukas;Nykštukai;1052656432;Taip;0;1;0;1
4291;Klevelis;Gėlytės;61178149504;Taip;0;4;0;4
4292;Klevelis;Gėlytės;1907412546;Taip;7;0;0;7
4293;Klevelis;Gėlytės;65540816272;Taip;0;6;0;6
4294;Klevelis;Gėlytės;8756257605;Taip;20;0;0;20
4295;Klevelis;Gėlytės;3101947555;Taip;14;2;0;16
4296;Klevelis;Gėlytės;32438253753;Taip;8;0;0;8
4297;Klevelis;Gėlytės;40799074112;Taip;5;1;0;6
4298;Klevelis;Gėlytės;68457250471;Taip;11;2;0;13
4299;Klevelis;Gėlytės;1024982577;Ne;10;3;0;13
4300;Klevelis;Gėlytės;7309676894;Taip;0;8;0;8
4301;Klevelis;Gėlytės;1942666372;Taip;16;2;0;18
4302;Klevelis;Gėlytės;50441219517;Taip;0;4;0;4
4303;Klevelis;Gėlytės;8154620920;Ne;0;14;0;14
4304;Klevelis;Gėlytės;5075314234;Taip;3;0;0;3
4305;Klevelis;Gėlytės;1509272327;Taip;1;2;0;3
4306;Klevelis;Paukšteliai;1606294984;Taip;4;13;0;17
4307;Klevelis;Paukšteliai;1953918266;Taip;2;10;0;12
4308;Klevelis;Paukšteliai;1685710938;Taip;7;4;0;11
4309;Klevelis;Paukšteliai;1757321892;Taip;5;0;0;5
4310;Klevelis;Paukšteliai;88565114332;Taip;10;0;0;10
4311;Klevelis;Paukšteliai;4400576631;Taip;4;0;0;4
4312;Klevelis;Paukšteliai;7506522045;Taip;15;0;0;15
4313;Klevelis;Paukšteliai;8155136607;Ne;0;2;0;2
4314;Klevelis;Paukšteliai;2043650571;Taip;6;0;0;6
4315;Klevelis;Paukšteliai;6172016747;Taip;7;0;0;7
4316;Klevelis;Paukšteliai;23520576240;Taip;0;6;0;6
4317;Klevelis;Paukšteliai;1161906832;Taip;7;0;0;7
4318;Klevelis;Paukšteliai;3408705916;Taip;2;0;0;2
4319;Klevelis;Paukšteliai;2555810841;Taip;11;0;0;11
4320;Klevelis;Paukšteliai;5024289280;Taip;6;0;0;6
4321;Klevelis;Paukšteliai;9689230151;Taip;13;0;0;13
4322;Klevelis;Paukšteliai;3437712794;Taip;11;0;0;11
4323;Klevelis;Paukšteliai;2744433344;Taip;12;0;1;13
4324;Klevelis;Paukšteliai;5354831337;Ne;18;0;0;18
4325;Klevelis;Paukšteliai;1851385706;Taip;11;1;0;12
4326;Klevelis;Paukšteliai;2078069088;Taip;3;9;0;12
4327;Klevelis;Spindulėliai;8957321461;Taip;1;3;0;4
4328;Klevelis;Spindulėliai;72505352951;Ne;0;9;0;9
4329;Klevelis;Spindulėliai;36733972781;Ne;0;9;0;9
4330;Klevelis;Spindulėliai;1929138590;Taip;0;0;3;3
4331;Klevelis;Spindulėliai;71637673796;Taip;0;2;0;2
4332;Klevelis;Spindulėliai;49983865253;Taip;0;9;0;9
4333;Klevelis;Spindulėliai;85910214189;Taip;0;6;0;6
4334;Klevelis;Spindulėliai;27776527268;Ne;0;1;0;1
4335;Klevelis;Spindulėliai;1299222411;Taip;5;14;0;19
4336;Klevelis;Spindulėliai;2041814549;Taip;0;0;3;3
4337;Klevelis;Spindulėliai;30473769754;Taip;0;0;1;1
4338;Klevelis;Spindulėliai;1608781752;Taip;14;1;0;15
4339;Klevelis;Spindulėliai;32063805512;Taip;0;11;0;11
4340;Klevelis;Spindulėliai;5786557195;Taip;3;0;1;4
4341;Klevelis;Spindulėliai;1980755137;Taip;5;0;0;5
4342;Klevelis;Spindulėliai;8246422485;Taip;8;0;0;8
4343;Klevelis;Spindulėliai;58302265771;Taip;11;0;0;11
4344;Klevelis;Spindulėliai;4733970252;Taip;0;0;2;2
4345;Klevelis;Spindulėliai;1141466643;Taip;13;1;0;14
4346;Klevelis;Spindulėliai;9125827523;Taip;7;3;0;10
4347;Klevelis;Spindulėliai;3397741232;Taip;0;6;0;6
4348;Klevelis;Spindulėliai;1520846063;Taip;8;0;0;8
4349;Klevelis;Spindulėliai;3201144750;Taip;0;13;0;13
4350;Klevelis;BORUŽĖLĖS;8195584468;Taip;0;7;0;7
4351;Klevelis;BORUŽĖLĖS;8357021249;Taip;0;0;1;1
4352;Klevelis;BORUŽĖLĖS;2200408537;Taip;0;3;0;3
4353;Klevelis;BORUŽĖLĖS;3873345138;Ne;19;0;0;19
4354;Klevelis;BORUŽĖLĖS;1020095914;Taip;17;0;0;17
4355;Klevelis;BORUŽĖLĖS;1749117711;Taip;20;0;0;20
4356;Klevelis;BORUŽĖLĖS;5402403433;Taip;5;4;1;10
4357;Klevelis;BORUŽĖLĖS;4424095457;Taip;9;0;0;9
4358;Klevelis;BORUŽĖLĖS;2207041148;Taip;20;0;0;20
4359;Klevelis;BORUŽĖLĖS;9291855374;Taip;10;0;0;10
4360;Klevelis;BORUŽĖLĖS;7855598075;Taip;20;0;0;20
4361;Klevelis;BORUŽĖLĖS;2031118410;Taip;7;4;0;11
4362;Klevelis;BORUŽĖLĖS;5705915729;Taip;9;0;0;9
4363;Klevelis;BORUŽĖLĖS;6488139414;Taip;20;0;0;20
4364;Klevelis;BORUŽĖLĖS;7115198351;Taip;13;0;0;13
4365;Klevelis;BORUŽĖLĖS;7559183263;Taip;0;8;0;8
4366;Kurpaitė;Viščiukų;2827617670;Taip;16;0;0;16
4367;Kurpaitė;Viščiukų;4168882748;Taip;9;6;0;15
4368;Kurpaitė;Viščiukų;9062514113;Taip;5;1;0;6
4369;Kurpaitė;Viščiukų;9200404698;Taip;0;4;0;4
4370;Kurpaitė;Viščiukų;7546409044;Taip;20;0;0;20
4371;Kurpaitė;Viščiukų;3502355847;Taip;8;0;0;8
4372;Kurpaitė;Viščiukų;4592795281;Taip;20;0;0;20
4373;Kurpaitė;Viščiukų;4964063637;Taip;10;0;0;10
4374;Kurpaitė;Viščiukų;5609161523;Taip;7;0;0;7
4375;Kurpaitė;Viščiukų;9480290430;Taip;5;0;0;5
4376;Kurpaitė;Viščiukų;8868415451;Taip;11;0;0;11
4377;Kurpaitė;Viščiukų;9655585527;Taip;5;4;0;9
4378;Kurpaitė;Viščiukų;4684525618;Taip;5;15;0;20
4379;Kurpaitė;Viščiukų;3634641300;Taip;10;0;0;10
4380;Kurpaitė;Viščiukų;9915241987;Taip;9;0;0;9
4381;Kurpaitė;Viščiukų;9529949992;Taip;0;0;20;20
4382;Kurpaitė;Viščiukų;4602268315;Taip;7;6;0;13
4383;Kurpaitė;Gėlyčių;9435979008;Taip;2;0;0;2
4384;Kurpaitė;Gėlyčių;7431793716;Taip;0;20;0;20
4385;Kurpaitė;Gėlyčių;72710210157;Taip;5;8;0;13
4386;Kurpaitė;Gėlyčių;24410351286;Taip;0;16;0;16
4387;Kurpaitė;Gėlyčių;2359555461;Taip;11;0;0;11
4388;Kurpaitė;Gėlyčių;1505783589;Taip;0;14;0;14
4389;Kurpaitė;Gėlyčių;7249931704;Taip;10;3;0;13
4390;Kurpaitė;Gėlyčių;3102257512;Taip;0;12;0;12
4391;Kurpaitė;Gėlyčių;58127430940;Taip;0;6;0;6
4392;Kurpaitė;Gėlyčių;1606617694;Taip;0;13;0;13
4393;Kurpaitė;Gėlyčių;1660650556;Taip;2;12;0;14
4394;Kurpaitė;Gėlyčių;1151128660;Taip;5;1;0;6
4395;Kurpaitė;Gėlyčių;1457318954;Taip;0;1;0;1
4396;Kurpaitė;Gėlyčių;2116580903;Taip;0;14;0;14
4397;Kurpaitė;Gėlyčių;65434834152;Taip;7;0;0;7
4398;Kurpaitė;Gėlyčių;9063294667;Taip;0;5;0;5
4399;Kurpaitė;Drugelių;49970457589;Taip;0;6;0;6
4400;Kurpaitė;Drugelių;62959992605;Taip;0;13;0;13
4401;Kurpaitė;Drugelių;38605683298;Taip;0;4;0;4
4402;Kurpaitė;Drugelių;5394176979;Taip;5;6;0;11
4403;Kurpaitė;Drugelių;5442955475;Taip;9;0;0;9
4404;Kurpaitė;Drugelių;31201788860;Taip;11;1;0;12
4405;Kurpaitė;Drugelių;65418822653;Taip;0;14;0;14
4406;Kurpaitė;Drugelių;66920939967;Taip;0;11;0;11
4407;Kurpaitė;Drugelių;1730735673;Taip;0;4;0;4
4408;Kurpaitė;Drugelių;52852801754;Taip;2;1;0;3
4409;Kurpaitė;Drugelių;43247754405;Taip;9;6;0;15
4410;Kurpaitė;Drugelių;1236147310;Taip;10;0;0;10
4411;Kurpaitė;Drugelių;54840686231;Taip;0;2;0;2
4412;Kurpaitė;Drugelių;48526842780;Taip;0;2;0;2
4413;Kurpaitė;Drugelių;61993267223;Taip;0;7;0;7
4414;Kurpaitė;Drugelių;1641562196;Taip;6;0;0;6
4415;Kurpaitė;Drugelių;2200676656;Taip;5;1;0;6
4416;Kurpaitė;Drugelių;71716344368;Taip;0;6;0;6
4417;Kurpaitė;Drugelių;48538300542;Taip;7;9;0;16
4418;Kurpaitė;Drugelių;85698687930;Taip;7;4;0;11
4419;Kurpaitė;Drugelių;6826856088;Taip;2;0;0;2
4420;Kurpaitė;Drugelių;51115562424;Taip;11;4;0;15
4421;Kurpaitė;Pelyčių;9919068986;Taip;0;14;0;14
4422;Kurpaitė;Pelyčių;54413485607;Taip;0;9;0;9
4423;Kurpaitė;Pelyčių;41686757437;Taip;0;8;0;8
4424;Kurpaitė;Pelyčių;32817744462;Taip;11;3;0;14
4425;Kurpaitė;Pelyčių;1993159901;Taip;0;11;0;11
4426;Kurpaitė;Pelyčių;32746331924;Taip;9;4;0;13
4427;Kurpaitė;Pelyčių;31034408890;Taip;0;6;0;6
4428;Kurpaitė;Pelyčių;42531654257;Taip;0;4;0;4
4429;Kurpaitė;Pelyčių;42230129130;Taip;0;11;0;11
4430;Kurpaitė;Pelyčių;28569380108;Taip;0;13;0;13
4431;Kurpaitė;Pelyčių;52350974867;Taip;5;4;0;9
4432;Kurpaitė;Pelyčių;86497821794;Taip;13;0;0;13
4433;Kurpaitė;Pelyčių;14193840490;Taip;6;1;0;7
4434;Kurpaitė;Pelyčių;34995551069;Taip;7;4;0;11
4435;Kurpaitė;Pelyčių;71783740325;Taip;0;4;0;4
4436;Kurpaitė;Pelyčių;1136113867;Taip;0;15;0;15
4437;Kurpaitė;Pelyčių;1936055251;Taip;10;0;0;10
4438;Kurpaitė;Pelyčių;3697560973;Taip;0;4;6;10
4439;Kurpaitė;Pelyčių;5902371603;Taip;5;8;0;13
4440;Kūlverstukas;Saulutės;1816105412;Taip;0;6;0;6
4441;Kūlverstukas;Saulutės;1471794813;Taip;15;0;2;17
4442;Kūlverstukas;Saulutės;4028937969;Taip;0;10;10;20
4443;Kūlverstukas;Saulutės;1109035765;Taip;8;0;0;8
4444;Kūlverstukas;Saulutės;1570383265;Taip;0;4;0;4
4445;Kūlverstukas;Saulutės;46862868133;Taip;8;0;0;8
4446;Kūlverstukas;Saulutės;3737085009;Taip;0;3;0;3
4447;Kūlverstukas;Saulutės;49788909084;Taip;5;4;3;12
4448;Kūlverstukas;Saulutės;1009117653;Taip;8;0;0;8
4449;Kūlverstukas;Saulutės;8362459952;Taip;13;0;1;14
4450;Kūlverstukas;Saulutės;74829986958;Taip;15;0;2;17
4451;Kūlverstukas;Saulutės;22294704115;Taip;0;0;1;1
4452;Kūlverstukas;Saulutės;47399326083;Taip;3;0;1;4
4453;Kūlverstukas;Saulutės;21138396996;Taip;0;1;4;5
4454;Kūlverstukas;Saulutės;2072009099;Taip;15;0;0;15
4455;Kūlverstukas;Saulutės;1000393691;Taip;0;0;6;6
4456;Kūlverstukas;Saulutės;2135571148;Taip;0;3;1;4
4457;Kūlverstukas;Saulutės;1987591278;Taip;20;0;0;20
4458;Kūlverstukas;Saulutės;1396533792;Taip;5;0;15;20
4459;Kūlverstukas;Peledžiukai;52190958426;Taip;0;2;0;2
4460;Kūlverstukas;Peledžiukai;1399479148;Taip;5;1;0;6
4461;Kūlverstukas;Peledžiukai;85330859485;Taip;0;2;0;2
4462;Kūlverstukas;Peledžiukai;2179050825;Taip;3;3;0;6
4463;Kūlverstukas;Peledžiukai;81294065628;Taip;13;0;0;13
4464;Kūlverstukas;Peledžiukai;66857330884;Taip;5;4;0;9
4465;Kūlverstukas;Peledžiukai;89965851223;Ne;10;0;1;11
4466;Kūlverstukas;Peledžiukai;80342796585;Taip;0;5;0;5
4467;Kūlverstukas;Peledžiukai;55515614021;Taip;1;4;0;5
4468;Kūlverstukas;Peledžiukai;61916609121;Taip;1;0;0;1
4469;Kūlverstukas;Peledžiukai;1260193245;Taip;18;0;0;18
4470;Kūlverstukas;Peledžiukai;29398080266;Taip;0;1;0;1
4471;Kūlverstukas;Peledžiukai;10716234461;Taip;6;0;0;6
4472;Kūlverstukas;Peledžiukai;69472316532;Taip;6;0;0;6
4473;Kūlverstukas;Peledžiukai;9856560184;Taip;0;2;0;2
4474;Kūlverstukas;Peledžiukai;89179106633;Ne;3;3;0;6
4475;Kūlverstukas;Gelytės;1226883894;Taip;10;3;0;13
4476;Kūlverstukas;Gelytės;37991935289;Taip;4;4;0;8
4477;Kūlverstukas;Gelytės;2716194746;Taip;0;20;0;20
4478;Kūlverstukas;Gelytės;7440474403;Taip;11;0;1;12
4479;Kūlverstukas;Gelytės;3991821717;Taip;11;0;0;11
4480;Kūlverstukas;Gelytės;5488011852;Taip;3;0;4;7
4481;Kūlverstukas;Gelytės;3937419139;Taip;1;4;0;5
4482;Kūlverstukas;Gelytės;8092104136;Taip;10;0;7;17
4483;Kūlverstukas;Gelytės;7480593611;Ne;6;0;0;6
4484;Kūlverstukas;Gelytės;1699783763;Taip;0;7;0;7
4485;Kūlverstukas;Gelytės;1240006602;Taip;8;0;0;8
4486;Kūlverstukas;Gelytės;3162189859;Taip;1;0;6;7
4487;Kūlverstukas;Gelytės;5372936730;Taip;0;0;2;2
4488;Kūlverstukas;Gelytės;7359354944;Taip;11;0;0;11
4489;Kūlverstukas;Gelytės;8243342948;Taip;8;0;0;8
4490;Kūlverstukas;Gelytės;1452422691;Taip;7;0;0;7
4491;Kūlverstukas;Bitutės;3270176280;Taip;9;4;0;13
4492;Kūlverstukas;Bitutės;1932066021;Taip;4;0;2;6
4493;Kūlverstukas;Bitutės;4073233921;Taip;4;0;3;7
4494;Kūlverstukas;Bitutės;9427388681;Taip;0;8;0;8
4495;Kūlverstukas;Bitutės;8853848991;Taip;7;0;0;7
4496;Kūlverstukas;Bitutės;4285624305;Taip;20;0;0;20
4497;Kūlverstukas;Bitutės;5103259175;Taip;15;0;0;15
4498;Kūlverstukas;Bitutės;9167460438;Taip;11;0;2;13
4499;Kūlverstukas;Bitutės;2087570702;Taip;0;0;4;4
4500;Kūlverstukas;Bitutės;5488852698;Taip;7;0;0;7
4501;Kūlverstukas;Bitutės;2419847093;Taip;0;0;1;1
4502;Kūlverstukas;Bitutės;1898905623;Taip;20;0;0;20
4503;Kūlverstukas;Bitutės;3069047204;Taip;1;0;6;7
4504;Kūlverstukas;Bitutės;2169480822;Taip;0;0;5;5
4505;Lakštingala;Saulutės;33332213331;Taip;0;7;0;7
4506;Lakštingala;Saulutės;35681729219;Ne;0;7;0;7
4507;Lakštingala;Saulutės;1416434491;Taip;10;2;0;12
4508;Lakštingala;Saulutės;17738218138;Taip;9;0;0;9
4509;Lakštingala;Saulutės;23753553201;Taip;0;3;0;3
4510;Lakštingala;Saulutės;31706572403;Taip;3;5;0;8
4511;Lakštingala;Saulutės;53652623242;Taip;4;2;0;6
4512;Lakštingala;Saulutės;51200162218;Taip;0;0;3;3
4513;Lakštingala;Saulutės;22211300772;Taip;0;0;3;3
4514;Lakštingala;Saulutės;18470272487;Taip;0;2;0;2
4515;Lakštingala;Saulutės;25804940619;Taip;0;6;0;6
4516;Lakštingala;Saulutės;42865585801;Taip;5;0;0;5
4517;Lakštingala;Saulutės;30224525177;Taip;0;2;0;2
4518;Lakštingala;Saulutės;1914662837;Taip;1;2;0;3
4519;Lakštingala;Saulutės;18798639428;Taip;0;14;0;14
4520;Lakštingala;Saulutės;87760794641;Taip;0;6;0;6
4521;Lakštingala;Saulutės;87223860105;Ne;0;7;0;7
4522;Lakštingala;Saulutės;1451425863;Taip;0;6;0;6
4523;Lakštingala;Saulutės;75435214041;Taip;13;0;0;13
4524;Lakštingala;Saulutės;78156519200;Taip;5;5;0;10
4525;Lakštingala;Saulutės;58644572893;Ne;0;6;0;6
4526;Lakštingala;Nykštukai;45850246980;Taip;0;4;0;4
4527;Lakštingala;Nykštukai;74001349345;Taip;0;7;0;7
4528;Lakštingala;Nykštukai;51586922715;Taip;5;5;0;10
4529;Lakštingala;Nykštukai;31221126819;Taip;11;0;0;11
4530;Lakštingala;Nykštukai;95489864230;Taip;0;10;0;10
4531;Lakštingala;Nykštukai;10653315095;Ne;0;3;0;3
4532;Lakštingala;Nykštukai;96792864646;Taip;13;0;0;13
4533;Lakštingala;Nykštukai;43151626858;Taip;0;10;0;10
4534;Lakštingala;Nykštukai;79652151224;Ne;0;8;0;8
4535;Lakštingala;Nykštukai;5692087454;Taip;0;10;0;10
4536;Lakštingala;Nykštukai;780078103;Taip;0;5;0;5
4537;Lakštingala;Nykštukai;68037499606;Taip;0;2;0;2
4538;Lakštingala;Nykštukai;93222430249;Taip;0;3;1;4
4539;Lakštingala;Nykštukai;89747320378;Taip;6;6;0;12
4540;Lakštingala;Nykštukai;79583726414;Taip;5;13;0;18
4541;Lakštingala;Nykštukai;2430795418;Taip;0;7;0;7
4542;Lakštingala;Nykštukai;40682764019;Taip;0;5;0;5
4543;Lakštingala;Nykštukai;62866040506;Taip;0;4;0;4
4544;Lakštingala;Nykštukai;98717827320;Taip;1;9;0;10
4545;Lakštingala;Nykštukai;57836156450;Taip;5;7;0;12
4546;Lakštingala;Nykštukai;50868279016;Taip;0;7;0;7
4547;Lakštingala;Nykštukai;3426133948;Taip;0;17;0;17
4548;Lakštingala;Nykštukai;37722153251;Taip;9;6;0;15
4549;Lakštingala;Bitutės;81628046226;Taip;0;5;0;5
4550;Lakštingala;Bitutės;63360792078;Taip;5;15;0;20
4551;Lakštingala;Bitutės;84925543738;Taip;0;2;0;2
4552;Lakštingala;Bitutės;88634927621;Taip;0;7;0;7
4553;Lakštingala;Bitutės;58670695979;Taip;0;4;0;4
4554;Lakštingala;Bitutės;1208496587;Taip;2;0;0;2
4555;Lakštingala;Bitutės;1478103633;Taip;4;0;0;4
4556;Lakštingala;Bitutės;93943807471;Taip;6;3;0;9
4557;Lakštingala;Bitutės;5460505229;Taip;3;5;0;8
4558;Lakštingala;Bitutės;43764846549;Taip;0;2;0;2
4559;Lakštingala;Bitutės;59776948588;Taip;0;1;2;3
4560;Lakštingala;Bitutės;7179277612;Taip;0;8;0;8
4561;Lakštingala;Bitutės;85722261846;Taip;0;5;0;5
4562;Lakštingala;Bitutės;1484725137;Taip;0;1;0;1
4563;Lakštingala;Bitutės;90557374701;Taip;2;7;0;9
4564;Lakštingala;Bitutės;70253545165;Taip;0;16;0;16
4565;Lakštingala;Bitutės;49381287243;Taip;0;9;0;9
4566;Lakštingala;Bitutės;96502788115;Taip;5;7;0;12
4567;Lakštingala;Bitutės;20671216208;Taip;0;1;3;4
4568;Lakštingala;Bitutės;3544861594;Taip;0;11;0;11
4569;Lakštingala;Bitutės;75081412082;Taip;0;6;0;6
4570;Lakštingala;Pūkeliai;91158318909;Taip;0;3;0;3
4571;Lakštingala;Pūkeliai;9610324086;Taip;0;0;1;1
4572;Lakštingala;Pūkeliai;95149875628;Taip;0;4;0;4
4573;Lakštingala;Pūkeliai;72834597919;Taip;0;4;0;4
4574;Lakštingala;Pūkeliai;46426227002;Taip;3;0;1;4
4575;Lakštingala;Pūkeliai;1646500057;Taip;0;1;0;1
4576;Lakštingala;Pūkeliai;82319560992;Taip;0;12;0;12
4577;Lakštingala;Pūkeliai;14826956710;Taip;18;0;0;18
4578;Lakštingala;Pūkeliai;7860949054;Taip;0;2;0;2
4579;Lakštingala;Pūkeliai;1056248263;Taip;0;0;2;2
4580;Lakštingala;Pūkeliai;92129853333;Taip;0;0;1;1
4581;Lakštingala;Pūkeliai;19356167631;Taip;0;6;0;6
4582;Lakštingala;Pūkeliai;56646163756;Taip;13;0;0;13
4583;Lakštingala;Pūkeliai;33431377093;Taip;0;1;2;3
4584;Lakštingala;Pūkeliai;63698553352;Taip;0;1;0;1
4585;Lakštingala;Pūkeliai;16039738423;Taip;1;0;0;1
4586;Lakštingala;Pūkeliai;45199150020;Taip;9;5;0;14
4587;Lakštingala;Pūkeliai;24905526995;Taip;0;0;2;2
4588;Lakštingala;Pūkeliai;2106666739;Taip;13;0;1;14
4589;Lakštingala;Aitvariukai;36990696663;Taip;0;5;0;5
4590;Lakštingala;Aitvariukai;99780001413;Taip;20;0;0;20
4591;Lakštingala;Aitvariukai;20201679407;Taip;0;2;0;2
4592;Lakštingala;Aitvariukai;7857821609;Taip;0;1;0;1
4593;Lakštingala;Aitvariukai;68405766745;Taip;5;0;1;6
4594;Lakštingala;Aitvariukai;8946285512;Ne;0;8;0;8
4595;Lakštingala;Aitvariukai;19833280319;Taip;9;1;0;10
4596;Lakštingala;Aitvariukai;2088394089;Taip;4;0;0;4
4597;Lakštingala;Aitvariukai;15819827141;Taip;0;17;0;17
4598;Lakštingala;Aitvariukai;61122948431;Ne;7;2;0;9
4599;Lakštingala;Aitvariukai;84766974984;Taip;0;5;0;5
4600;Lakštingala;Aitvariukai;70041878575;Taip;0;2;0;2
4601;Lakštingala;Aitvariukai;69176146563;Taip;0;1;0;1
4602;Lakštingala;Aitvariukai;53444347656;Taip;0;1;0;1
4603;Lakštingala;Aitvariukai;8781225219;Taip;0;8;0;8
4604;Lakštingala;Aitvariukai;86429853759;Taip;0;6;0;6
4605;Lakštingala;Aitvariukai;78648398334;Taip;0;5;0;5
4606;Lakštingala;Boružiukai;9795993812;Taip;0;2;1;3
4607;Lakštingala;Boružiukai;3280380015;Taip;0;1;0;1
4608;Lakštingala;Boružiukai;43313173294;Taip;15;0;0;15
4609;Lakštingala;Boružiukai;9004336424;Taip;8;0;3;11
4610;Lakštingala;Boružiukai;8820053026;Taip;1;1;0;2
4611;Lakštingala;Boružiukai;8873445262;Taip;7;0;0;7
4612;Lakštingala;Boružiukai;4811759034;Taip;10;1;0;11
4613;Lakštingala;Boružiukai;1898853302;Taip;1;1;0;2
4614;Lakštingala;Boružiukai;7443563000;Taip;6;0;0;6
4615;Lakštingala;Boružiukai;2792618575;Taip;0;10;0;10
4616;Lakštingala;Boružiukai;55720630870;Taip;10;0;1;11
4617;Lakštingala;Boružiukai;4766547534;Taip;7;0;0;7
4618;Lakštingala;Boružiukai;4818524423;Taip;7;0;0;7
4619;Lakštingala;Boružiukai;1444534032;Taip;0;2;1;3
4620;Lakštingala;Boružiukai;9724531753;Taip;8;0;0;8
4621;Lakštingala;"KIŠKUČIAI (SAV.)";64992551832;Taip;0;4;0;4
4622;Lakštingala;"KIŠKUČIAI (SAV.)";1169891428;Taip;10;0;0;10
4623;Lakštingala;"KIŠKUČIAI (SAV.)";63039806752;Taip;5;0;0;5
4624;Lakštingala;"KIŠKUČIAI (SAV.)";1409132656;Taip;11;1;0;12
4625;Lakštingala;"KIŠKUČIAI (SAV.)";1236087612;Taip;11;1;0;12
4626;Lakštingala;"KIŠKUČIAI (SAV.)";80762133625;Taip;9;0;0;9
4627;Lakštingala;"KIŠKUČIAI (SAV.)";1128658722;Taip;4;0;0;4
4628;Lakštingala;"KIŠKUČIAI (SAV.)";9862985913;Taip;11;0;0;11
4629;Lakštingala;"KIŠKUČIAI (SAV.)";77712279907;Taip;0;6;0;6
4630;Lakštingala;"KIŠKUČIAI (SAV.)";8645237294;Taip;10;0;0;10
4631;Lakštingala;"KIŠKUČIAI (SAV.)";2083229761;Taip;0;2;0;2
4632;Lakštingala;"KIŠKUČIAI (SAV.)";1538315501;Taip;0;7;2;9
4633;Lakštingala;"KIŠKUČIAI (SAV.)";40853872375;Taip;0;2;0;2
4634;Lakštingala;"KIŠKUČIAI (SAV.)";1663637599;Taip;20;0;0;20
4635;Lakštingala;"KIŠKUČIAI (SAV.)";1716046309;Taip;2;2;1;5
4636;Lakštingala;"KIŠKUČIAI (SAV.)";3660645944;Taip;5;7;0;12
4637;Lakštingala;"KIŠKUČIAI (SAV.)";7038977283;Taip;11;0;0;11
4638;Lakštingala;"KIŠKUČIAI (SAV.)";80142440362;Taip;0;2;4;6
4639;Lakštingala;"KIŠKUČIAI (SAV.)";7623300327;Taip;5;12;0;17
4640;Lakštingala;"KIŠKUČIAI (SAV.)";2241000661;Taip;5;12;0;17
4641;Lakštingala;Žiogeliai;2104150466;Taip;13;0;0;13
4642;Lakštingala;Žiogeliai;9395512638;Taip;7;0;3;10
4643;Lakštingala;Žiogeliai;9689911725;Taip;5;1;0;6
4644;Lakštingala;Žiogeliai;8705627810;Taip;0;2;0;2
4645;Lakštingala;Žiogeliai;1832608585;Taip;11;0;1;12
4646;Lakštingala;Žiogeliai;9958821769;Taip;10;0;0;10
4647;Lakštingala;Žiogeliai;7953724873;Taip;5;6;0;11
4648;Lakštingala;Žiogeliai;9800992468;Taip;0;0;1;1
4649;Lakštingala;Žiogeliai;1411121466;Taip;0;2;0;2
4650;Lakštingala;Žiogeliai;8944088082;Taip;0;2;0;2
4651;Lakštingala;Žiogeliai;70798601578;Taip;0;9;0;9
4652;Lakštingala;Žiogeliai;1736130324;Taip;11;0;0;11
4653;Lakštingala;Žiogeliai;2039579203;Taip;11;0;0;11
4654;Lakštingala;Žiogeliai;6576202365;Taip;1;6;0;7
4655;Lakštingala;Žiogeliai;89044575245;Taip;0;0;17;17
4656;Lakštingala;Žiogeliai;7900597697;Taip;11;0;0;11
4657;Lakštingala;Žiogeliai;8016552114;Taip;5;4;0;9
4658;Lakštingala;SPINDULIUKAI;19003276281;Taip;15;0;0;15
4659;Lakštingala;SPINDULIUKAI;31911078405;Taip;15;0;0;15
4660;Lakštingala;SPINDULIUKAI;601001178;Taip;11;0;0;11
4661;Lakštingala;SPINDULIUKAI;1263184555;Taip;0;6;6;12
4662;Lakštingala;SPINDULIUKAI;42012300013;Taip;0;1;6;7
4663;Lakštingala;SPINDULIUKAI;2002196654;Taip;10;0;0;10
4664;Lakštingala;SPINDULIUKAI;58847206918;Taip;9;0;3;12
4665;Lakštingala;SPINDULIUKAI;5033145687;Taip;0;9;0;9
4666;Lakštingala;SPINDULIUKAI;26288159700;Taip;10;9;0;19
4667;Lakštingala;SPINDULIUKAI;11399672681;Taip;14;0;0;14
4668;Lakštingala;SPINDULIUKAI;95832669291;Taip;4;4;0;8
4669;Lakštingala;SPINDULIUKAI;4183492894;Taip;0;1;5;6
4670;Lakštingala;SPINDULIUKAI;65408046990;Taip;14;0;0;14
4671;Lakštingala;SPINDULIUKAI;48160996499;Taip;9;0;0;9
4672;Lakštingala;SPINDULIUKAI;70748679017;Taip;0;4;1;5
4673;Lakštingala;SPINDULIUKAI;37897965773;Taip;9;0;0;9
4674;Lakštingala;SPINDULIUKAI;4770775472;Taip;0;6;0;6
4675;Lakštingala;SPINDULIUKAI;8838078447;Taip;0;1;0;1
4676;Lakštingala;SPINDULIUKAI;7448175606;Taip;13;2;0;15
4677;Lakštingala;Pėledžiukai;98609129644;Taip;0;11;0;11
4678;Lakštingala;Pėledžiukai;2635399411;Taip;0;1;0;1
4679;Lakštingala;Pėledžiukai;7325183642;Taip;0;1;3;4
4680;Lakštingala;Pėledžiukai;21094902562;Taip;0;2;0;2
4681;Lakštingala;Pėledžiukai;1271455798;Taip;2;1;0;3
4682;Lakštingala;Pėledžiukai;1868573076;Taip;12;2;1;15
4683;Lakštingala;Pėledžiukai;14410791110;Taip;3;1;0;4
4684;Lakštingala;Pėledžiukai;30840899725;Taip;0;4;0;4
4685;Lakštingala;Pėledžiukai;1676655778;Taip;2;0;0;2
4686;Lakštingala;Pėledžiukai;15430318196;Taip;0;0;18;18
4687;Lakštingala;Pėledžiukai;9381815353;Taip;0;8;1;9
4688;Lakštingala;Pėledžiukai;25449089230;Taip;0;4;0;4
4689;Lakštingala;Pėledžiukai;36367286465;Taip;0;1;0;1
4690;Lakštingala;Pėledžiukai;91671174585;Taip;5;15;0;20
4691;Lakštingala;Pėledžiukai;1347480198;Taip;0;2;0;2
4692;Lakštingala;Pėledžiukai;88947243829;Taip;5;1;0;6
4693;Lakštingala;Pėledžiukai;6329787217;Taip;0;2;5;7
4694;Lakštingala;Pėledžiukai;58056130761;Taip;0;6;0;6
4695;Lakštingala;Pėledžiukai;1310400524;Taip;2;2;3;7
4696;Lakštingala;Pėledžiukai;2013216779;Taip;0;2;0;2
4697;Lakštingala;Pėledžiukai;8890852891;Taip;0;2;2;4
4698;Lakštingala;Pėledžiukai;9998322501;Taip;4;1;12;17
4699;Lakštingala;Katinėliai;9774836470;Taip;8;10;0;18
4700;Lakštingala;Katinėliai;7929034243;Taip;14;0;0;14
4701;Lakštingala;Katinėliai;8171357606;Taip;0;15;0;15
4702;Lakštingala;Katinėliai;6780591792;Taip;19;0;0;19
4703;Lakštingala;Katinėliai;9431217584;Taip;0;0;13;13
4704;Lakštingala;Katinėliai;2962846236;Taip;0;0;20;20
4705;Lakštingala;Katinėliai;3109623760;Taip;20;0;0;20
4706;Lakštingala;Katinėliai;3811230983;Taip;0;0;4;4
4707;Lakštingala;Katinėliai;6908873466;Taip;0;5;0;5
4708;Lakštingala;Katinėliai;5854794141;Taip;5;1;0;6
4709;Lakštingala;Katinėliai;8422745100;Taip;0;0;18;18
4710;Lakštingala;Katinėliai;5598711072;Taip;15;0;0;15
4711;Lakštingala;Katinėliai;1958696382;Taip;0;0;16;16
4712;Lakštingala;Katinėliai;2022621678;Taip;0;0;15;15
4713;Lakštingala;Katinėliai;4542992319;Taip;0;0;3;3
4714;Lakštingala;Katinėliai;5537018556;Taip;7;2;0;9
4715;Lakštingala;Katinėliai;2593030897;Taip;7;0;0;7
4716;Lakštingala;Katinėliai;8529259340;Taip;0;0;8;8
4717;Lakštingala;Deimantėliai;4032030375;Taip;0;15;0;15
4718;Lakštingala;Deimantėliai;1655202909;Taip;10;5;0;15
4719;Lakštingala;Deimantėliai;8284565948;Taip;15;0;0;15
4720;Lakštingala;Deimantėliai;1648466517;Taip;3;0;0;3
4721;Lakštingala;Deimantėliai;3993759015;Taip;20;0;0;20
4722;Lakštingala;Deimantėliai;3568151046;Taip;17;0;0;17
4723;Lakštingala;Deimantėliai;9725851433;Taip;9;0;0;9
4724;Lakštingala;Deimantėliai;4700135106;Taip;13;0;0;13
4725;Lakštingala;Deimantėliai;1863034132;Taip;20;0;0;20
4726;Lakštingala;Deimantėliai;9879064676;Taip;16;0;0;16
4727;Lakštingala;Deimantėliai;2423651716;Taip;0;3;0;3
4728;Lakštingala;Deimantėliai;3369263112;Taip;20;0;0;20
4729;Lakštingala;Deimantėliai;9489982241;Taip;10;0;0;10
4730;Lakštingala;Deimantėliai;3724324861;Taip;20;0;0;20
4731;Lakštingala;Deimantėliai;2652305131;Taip;14;0;0;14
4732;Lakštingala;Deimantėliai;6332498461;Taip;17;0;0;17
4733;Lakštingala;Deimantėliai;9375002191;Taip;5;4;2;11
4734;Lakštingala;Deimantėliai;2941128360;Taip;10;0;0;10
4735;Lakštingala;Deimantėliai;9912622093;Taip;17;0;0;17
4736;Lašelis;VIŠČIUKAI;86191407652;Taip;0;4;0;4
4737;Lašelis;VIŠČIUKAI;8873895533;Taip;11;0;0;11
4738;Lašelis;VIŠČIUKAI;58391864442;Taip;9;0;0;9
4739;Lašelis;VIŠČIUKAI;175310584;Taip;5;3;0;8
4740;Lašelis;VIŠČIUKAI;10694830733;Ne;0;11;5;16
4741;Lašelis;VIŠČIUKAI;4320017329;Taip;0;10;0;10
4742;Lašelis;VIŠČIUKAI;1132803162;Taip;9;7;0;16
4743;Lašelis;VIŠČIUKAI;14934740494;Ne;8;0;0;8
4744;Lašelis;VIŠČIUKAI;8332516807;Taip;9;0;0;9
4745;Lašelis;VIŠČIUKAI;1584708183;Taip;6;4;0;10
4746;Lašelis;VIŠČIUKAI;1282991939;Taip;3;2;0;5
4747;Lašelis;VIŠČIUKAI;60394164372;Taip;12;0;0;12
4748;Lašelis;VIŠČIUKAI;713862923;Taip;14;0;1;15
4749;Lašelis;VIŠČIUKAI;82073061357;Taip;1;2;0;3
4750;Lašelis;VIŠČIUKAI;4277113412;Ne;6;0;7;13
4751;Lašelis;VIŠČIUKAI;7349722463;Taip;10;9;0;19
4752;Lašelis;VIŠČIUKAI;2429224297;Taip;0;8;0;8
4753;Lašelis;VIŠČIUKAI;1383759549;Taip;16;0;2;18
4754;Lašelis;VIŠČIUKAI;2118500745;Taip;7;0;2;9
4755;Lašelis;VIŠČIUKAI;5437008837;Taip;11;0;0;11
4756;Lašelis;VIŠČIUKAI;1171647193;Taip;9;0;1;10
4757;Lašelis;ŠYPSENA;9391594216;Taip;5;6;0;11
4758;Lašelis;ŠYPSENA;65174922062;Taip;7;5;0;12
4759;Lašelis;ŠYPSENA;6977000987;Taip;3;2;0;5
4760;Lašelis;ŠYPSENA;4599789649;Taip;13;1;0;14
4761;Lašelis;ŠYPSENA;6136792125;Taip;10;0;0;10
4762;Lašelis;ŠYPSENA;6090290046;Taip;12;0;0;12
4763;Lašelis;ŠYPSENA;1417989409;Taip;0;2;0;2
4764;Lašelis;ŠYPSENA;1193336600;Taip;6;6;0;12
4765;Lašelis;ŠYPSENA;1268330178;Taip;11;0;3;14
4766;Lašelis;ŠYPSENA;1739797553;Taip;0;2;0;2
4767;Lašelis;ŠYPSENA;1578956182;Taip;0;8;0;8
4768;Lašelis;ŠYPSENA;2113295854;Taip;0;0;3;3
4769;Lašelis;ŠYPSENA;2500332755;Taip;10;0;0;10
4770;Lašelis;ŠYPSENA;1953392509;Taip;10;0;0;10
4771;Lašelis;ŠYPSENA;1343084840;Taip;0;1;0;1
4772;Lašelis;ŠYPSENA;7471332824;Taip;4;6;0;10
4773;Lašelis;ŠYPSENA;4062516422;Taip;0;3;0;3
4774;Lašelis;ŠYPSENA;6492909546;Taip;0;7;0;7
4775;Lašelis;ŠYPSENA;8324581018;Ne;11;0;1;12
4776;Lašelis;ŠYPSENA;3741905080;Taip;8;0;5;13
4777;Lašelis;NYKŠTUKAI;1614647892;Taip;0;0;4;4
4778;Lašelis;NYKŠTUKAI;8181369424;Taip;5;0;0;5
4779;Lašelis;NYKŠTUKAI;1534313851;Ne;0;9;0;9
4780;Lašelis;NYKŠTUKAI;1099685342;Taip;0;11;0;11
4781;Lašelis;NYKŠTUKAI;1917927039;Taip;0;11;0;11
4782;Lašelis;NYKŠTUKAI;3447120578;Taip;6;0;14;20
4783;Lašelis;NYKŠTUKAI;1833121579;Taip;8;0;0;8
4784;Lašelis;NYKŠTUKAI;1635550414;Taip;0;15;0;15
4785;Lašelis;NYKŠTUKAI;7047619741;Taip;14;0;0;14
4786;Lašelis;NYKŠTUKAI;85641710509;Taip;19;0;0;19
4787;Lašelis;NYKŠTUKAI;1742951527;Taip;0;0;2;2
4788;Lašelis;NYKŠTUKAI;28071639285;Taip;9;0;0;9
4789;Lašelis;NYKŠTUKAI;87745170593;Taip;0;4;1;5
4790;Lašelis;NYKŠTUKAI;37726695989;Taip;0;11;0;11
4791;Lašelis;NYKŠTUKAI;75224154074;Taip;10;5;0;15
4792;Lašelis;NYKŠTUKAI;29417065142;Taip;0;7;0;7
4793;Lašelis;NYKŠTUKAI;1711262987;Taip;3;0;0;3
4794;Lašelis;NYKŠTUKAI;73391370015;Taip;0;8;0;8
4795;Lašelis;SAULUTĖ;71550135640;Ne;7;3;0;10
4796;Lašelis;SAULUTĖ;17105970545;Taip;0;1;0;1
4797;Lašelis;SAULUTĖ;28319122501;Taip;16;2;0;18
4798;Lašelis;SAULUTĖ;18905952587;Taip;0;6;0;6
4799;Lašelis;SAULUTĖ;39887519960;Taip;9;0;0;9
4800;Lašelis;SAULUTĖ;52081356883;Taip;3;0;0;3
4801;Lašelis;SAULUTĖ;3071193513;Taip;0;1;0;1
4802;Lašelis;SAULUTĖ;19712015840;Taip;0;9;0;9
4803;Lašelis;SAULUTĖ;72661430712;Taip;0;11;0;11
4804;Lašelis;SAULUTĖ;94756490716;Taip;7;1;0;8
4805;Lašelis;SAULUTĖ;39661215923;Taip;0;3;0;3
4806;Lašelis;SAULUTĖ;29635578653;Taip;0;1;0;1
4807;Lašelis;SAULUTĖ;36907557289;Ne;5;1;0;6
4808;Lašelis;SAULUTĖ;92897887533;Ne;5;3;0;8
4809;Lašelis;SAULUTĖ;85978955807;Taip;0;10;0;10
4810;Lašelis;SAULUTĖ;20798875600;Ne;0;7;0;7
4811;Lašelis;SAULUTĖ;3505668718;Taip;0;5;0;5
4812;Lašelis;SAULUTĖ;72124622387;Taip;14;2;0;16
4813;Lašelis;BORUŽĖLĖS;7351939034;Taip;5;0;0;5
4814;Lašelis;BORUŽĖLĖS;1085400709;Taip;0;9;0;9
4815;Lašelis;BORUŽĖLĖS;7998812497;Taip;14;1;0;15
4816;Lašelis;BORUŽĖLĖS;2912232814;Taip;18;0;0;18
4817;Lašelis;BORUŽĖLĖS;6127747445;Taip;0;4;0;4
4818;Lašelis;BORUŽĖLĖS;1777442316;Taip;7;0;0;7
4819;Lašelis;BORUŽĖLĖS;6553762186;Taip;7;6;0;13
4820;Lašelis;BORUŽĖLĖS;3867799187;Taip;9;3;0;12
4821;Lašelis;BORUŽĖLĖS;3982877012;Taip;9;0;1;10
4822;Lašelis;BORUŽĖLĖS;6669130831;Taip;13;0;0;13
4823;Lašelis;BORUŽĖLĖS;5556821953;Taip;9;4;0;13
4824;Lašelis;BORUŽĖLĖS;1646912457;Taip;8;2;0;10
4825;Lašelis;BORUŽĖLĖS;1886540733;Taip;11;0;0;11
4826;Lašelis;BORUŽĖLĖS;4151582358;Taip;6;4;0;10
4827;Lašelis;BORUŽĖLĖS;7802622810;Taip;12;0;0;12
4828;Lašelis;SKRUZDELIUKAI;3297005183;Taip;0;0;4;4
4829;Lašelis;SKRUZDELIUKAI;8318512396;Taip;6;5;0;11
4830;Lašelis;SKRUZDELIUKAI;1244168190;Taip;0;13;0;13
4831;Lašelis;SKRUZDELIUKAI;2034007263;Taip;10;0;1;11
4832;Lašelis;SKRUZDELIUKAI;7367305924;Taip;13;0;3;16
4833;Lašelis;SKRUZDELIUKAI;7657786815;Taip;17;0;0;17
4834;Lašelis;SKRUZDELIUKAI;7107685761;Taip;3;1;0;4
4835;Lašelis;SKRUZDELIUKAI;3495676199;Taip;11;0;0;11
4836;Lašelis;SKRUZDELIUKAI;3843163586;Taip;15;0;0;15
4837;Lašelis;SKRUZDELIUKAI;6304391719;Taip;9;1;0;10
4838;Lašelis;SKRUZDELIUKAI;1085950130;Taip;5;1;0;6
4839;Lazdynėlis;BITUTĖS;60885596690;Ne;8;0;1;9
4840;Lazdynėlis;BITUTĖS;75400333117;Taip;9;4;0;13
4841;Lazdynėlis;BITUTĖS;55695017411;Taip;9;8;1;18
4842;Lazdynėlis;BITUTĖS;50788636961;Taip;0;20;0;20
4843;Lazdynėlis;BITUTĖS;28176922691;Taip;0;6;0;6
4844;Lazdynėlis;BITUTĖS;48328518819;Taip;9;0;0;9
4845;Lazdynėlis;BITUTĖS;90734124818;Taip;5;0;0;5
4846;Lazdynėlis;BITUTĖS;83140388277;Taip;9;0;0;9
4847;Lazdynėlis;BITUTĖS;69220585579;Taip;5;2;5;12
4848;Lazdynėlis;BITUTĖS;79847018203;Taip;12;0;0;12
4849;Lazdynėlis;BITUTĖS;76733730112;Taip;16;0;0;16
4850;Lazdynėlis;BITUTĖS;93770511704;Taip;17;0;0;17
4851;Lazdynėlis;BITUTĖS;95546662727;Taip;9;5;1;15
4852;Lazdynėlis;BITUTĖS;82313332357;Taip;0;20;0;20
4853;Lazdynėlis;BITUTĖS;57393413722;Taip;0;7;1;8
4854;Lazdynėlis;BITUTĖS;28670815274;Taip;8;3;0;11
4855;Lazdynėlis;BITUTĖS;57891137452;Taip;8;0;1;9
4856;Lazdynėlis;BITUTĖS;14797154110;Taip;0;0;2;2
4857;Lazdynėlis;BITUTĖS;58991424753;Taip;12;4;0;16
4858;Lazdynėlis;BITUTĖS;8954195210;Taip;13;2;0;15
4859;Lazdynėlis;BITUTĖS;49407698116;Taip;19;0;0;19
4860;Lazdynėlis;BITUTĖS;8012374474;Taip;0;1;0;1
4861;Lazdynėlis;BITUTĖS;8245694943;Taip;6;3;0;9
4862;Lazdynėlis;BITUTĖS;99629193401;Taip;7;0;2;9
4863;Lazdynėlis;BITUTĖS;57522150425;Taip;4;7;0;11
4864;Lazdynėlis;EŽIUKAI;5068598385;Taip;0;1;0;1
4865;Lazdynėlis;EŽIUKAI;2491872016;Taip;0;1;0;1
4866;Lazdynėlis;EŽIUKAI;1593314326;Taip;11;0;2;13
4867;Lazdynėlis;EŽIUKAI;2041709821;Taip;0;20;0;20
4868;Lazdynėlis;EŽIUKAI;32856469893;Taip;6;2;0;8
4869;Lazdynėlis;EŽIUKAI;6542840562;Taip;5;0;2;7
4870;Lazdynėlis;EŽIUKAI;8975341347;Taip;7;0;2;9
4871;Lazdynėlis;EŽIUKAI;5301460250;Taip;9;0;0;9
4872;Lazdynėlis;EŽIUKAI;1265404063;Taip;20;0;0;20
4873;Lazdynėlis;EŽIUKAI;83586382037;Taip;0;4;0;4
4874;Lazdynėlis;EŽIUKAI;10727984477;Taip;0;0;1;1
4875;Lazdynėlis;EŽIUKAI;9081770664;Taip;16;0;0;16
4876;Lazdynėlis;EŽIUKAI;1479568714;Taip;8;0;1;9
4877;Lazdynėlis;EŽIUKAI;8271766964;Taip;0;10;0;10
4878;Lazdynėlis;EŽIUKAI;9668839027;Taip;0;3;0;3
4879;Lazdynėlis;EŽIUKAI;2740122426;Taip;0;20;0;20
4880;Lazdynėlis;EŽIUKAI;47861078891;Taip;9;0;2;11
4881;Lazdynėlis;EŽIUKAI;2841262230;Taip;20;0;0;20
4882;Lazdynėlis;EŽIUKAI;7499322078;Taip;0;1;0;1
4883;Lazdynėlis;EŽIUKAI;48860174942;Taip;0;5;0;5
4884;Lazdynėlis;EŽIUKAI;92889991874;Taip;0;4;0;4
4885;Lazdynėlis;EŽIUKAI;65806780298;Taip;20;0;0;20
4886;Lazdynėlis;BORUŽIUKAI;2168516394;Taip;8;1;0;9
4887;Lazdynėlis;BORUŽIUKAI;4961149717;Taip;7;0;0;7
4888;Lazdynėlis;BORUŽIUKAI;99475014554;Taip;8;2;0;10
4889;Lazdynėlis;BORUŽIUKAI;6156638726;Taip;0;4;0;4
4890;Lazdynėlis;BORUŽIUKAI;1321841783;Taip;6;0;0;6
4891;Lazdynėlis;BORUŽIUKAI;1055608079;Taip;3;1;0;4
4892;Lazdynėlis;BORUŽIUKAI;9570299877;Taip;0;20;0;20
4893;Lazdynėlis;BORUŽIUKAI;1715738053;Taip;0;1;0;1
4894;Lazdynėlis;BORUŽIUKAI;50390821034;Taip;8;4;0;12
4895;Lazdynėlis;BORUŽIUKAI;2112064241;Taip;19;0;0;19
4896;Lazdynėlis;BORUŽIUKAI;86740660262;Taip;0;3;0;3
4897;Lazdynėlis;BORUŽIUKAI;1207280684;Taip;0;5;0;5
4898;Lazdynėlis;BORUŽIUKAI;57448939020;Taip;9;9;0;18
4899;Lazdynėlis;BORUŽIUKAI;1789237348;Taip;10;5;0;15
4900;Lazdynėlis;BORUŽIUKAI;2007361692;Taip;2;1;0;3
4901;Lazdynėlis;BORUŽIUKAI;2105998927;Taip;0;4;0;4
4902;Lazdynėlis;BORUŽIUKAI;29288665418;Taip;11;9;0;20
4903;Lazdynėlis;BORUŽIUKAI;11379612306;Taip;4;9;0;13
4904;Lazdynėlis;BORUŽIUKAI;1650738939;Taip;7;0;0;7
4905;Lazdynėlis;BORUŽIUKAI;7237629135;Taip;14;0;0;14
4906;Lazdynėlis;BORUŽIUKAI;3863927885;Taip;16;0;0;16
4907;Lazdynėlis;BORUŽIUKAI;8945282683;Taip;1;2;0;3
4908;Lazdynėlis;BORUŽIUKAI;5838945434;Taip;0;6;0;6
4909;Lazdynėlis;BORUŽIUKAI;6230420677;Taip;0;3;0;3
4910;Lazdynėlis;KAČIUKAI;3603045321;Taip;0;1;0;1
4911;Lazdynėlis;KAČIUKAI;58490612549;Taip;9;0;0;9
4912;Lazdynėlis;KAČIUKAI;43267615847;Taip;5;4;0;9
4913;Lazdynėlis;KAČIUKAI;59588430935;Taip;10;1;0;11
4914;Lazdynėlis;KAČIUKAI;66134107213;Taip;14;1;0;15
4915;Lazdynėlis;KAČIUKAI;32336340968;Taip;10;0;0;10
4916;Lazdynėlis;KAČIUKAI;23011537816;Taip;9;0;0;9
4917;Lazdynėlis;KAČIUKAI;61642550142;Ne;7;1;0;8
4918;Lazdynėlis;KAČIUKAI;83123063983;Taip;4;0;0;4
4919;Lazdynėlis;KAČIUKAI;67819115627;Taip;6;0;0;6
4920;Lazdynėlis;KAČIUKAI;52949287680;Taip;0;5;6;11
4921;Lazdynėlis;KAČIUKAI;97795271362;Taip;6;4;7;17
4922;Lazdynėlis;KAČIUKAI;55167939220;Taip;6;0;0;6
4923;Lazdynėlis;KAČIUKAI;56747379453;Taip;0;2;1;3
4924;Lazdynėlis;KAČIUKAI;1634936961;Taip;20;0;0;20
4925;Lazdynėlis;KAČIUKAI;65438421685;Taip;6;1;0;7
4926;Lazdynėlis;KAČIUKAI;52528629956;Taip;12;0;0;12
4927;Lazdynėlis;KAČIUKAI;79445476316;Taip;6;1;0;7
4928;Lazdynėlis;KAČIUKAI;5638072847;Taip;0;14;0;14
4929;Lazdynėlis;KAČIUKAI;78302777769;Taip;3;5;4;12
4930;Lazdynėlis;KAČIUKAI;87419458418;Taip;0;5;5;10
4931;Lazdynėlis;KAČIUKAI;85340642919;Taip;19;0;0;19
4932;Lazdynėlis;KAČIUKAI;77950321376;Taip;6;1;0;7
4933;Lazdynėlis;KAČIUKAI;20331444858;Taip;7;0;0;7
4934;Lazdynėlis;KAČIUKAI;7981495545;Taip;11;9;0;20
4935;Lazdynėlis;KAČIUKAI;62600252729;Ne;5;4;0;9
4936;Lazdynėlis;VOVERIUKAI;4425724586;Taip;10;6;0;16
4937;Lazdynėlis;VOVERIUKAI;4928593615;Taip;5;0;0;5
4938;Lazdynėlis;VOVERIUKAI;6684940385;Taip;19;0;0;19
4939;Lazdynėlis;VOVERIUKAI;9187681789;Taip;18;0;0;18
4940;Lazdynėlis;VOVERIUKAI;6307407620;Taip;0;1;0;1
4941;Lazdynėlis;VOVERIUKAI;14427234202;Taip;14;0;0;14
4942;Lazdynėlis;VOVERIUKAI;1107441074;Taip;10;1;0;11
4943;Lazdynėlis;VOVERIUKAI;25596458181;Taip;0;20;0;20
4944;Lazdynėlis;VOVERIUKAI;18498032472;Taip;4;0;1;5
4945;Lazdynėlis;VOVERIUKAI;158059657;Taip;0;0;2;2
4946;Lazdynėlis;VOVERIUKAI;1852865534;Taip;19;0;0;19
4947;Lazdynėlis;VOVERIUKAI;7789345652;Taip;4;4;0;8
4948;Lazdynėlis;VOVERIUKAI;3902772678;Taip;5;4;0;9
4949;Lazdynėlis;VOVERIUKAI;8822378464;Taip;19;0;0;19
4950;Lazdynėlis;VOVERIUKAI;6863715428;Taip;0;1;3;4
4951;Lazdynėlis;VOVERIUKAI;1386686123;Taip;6;0;0;6
4952;Lazdynėlis;VOVERIUKAI;2587142646;Taip;7;0;2;9
4953;Lazdynėlis;VOVERIUKAI;2603427970;Taip;20;0;0;20
4954;Lazdynėlis;VOVERIUKAI;2441835588;Taip;1;0;3;4
4955;Lazdynėlis;VOVERIUKAI;3043350186;Taip;10;0;0;10
4956;Lazdynėlis;VOVERIUKAI;44510351979;Taip;0;0;19;19
4957;Lazdynėlis;VOVERIUKAI;6762216509;Taip;4;10;0;14
4958;Lazdynėlis;VOVERIUKAI;7965433882;Taip;0;1;0;1
4959;Lazdynėlis;VOVERIUKAI;1424382629;Taip;10;0;1;11
4960;Lazdynėlis;RIEŠUTĖLIAI;82893485399;Taip;0;9;0;9
4961;Lazdynėlis;RIEŠUTĖLIAI;53141612488;Taip;0;4;0;4
4962;Lazdynėlis;RIEŠUTĖLIAI;81489861336;Taip;8;0;0;8
4963;Lazdynėlis;RIEŠUTĖLIAI;11830560488;Taip;5;0;0;5
4964;Lazdynėlis;RIEŠUTĖLIAI;24433496244;Taip;15;1;0;16
4965;Lazdynėlis;RIEŠUTĖLIAI;99158632198;Taip;0;5;0;5
4966;Lazdynėlis;RIEŠUTĖLIAI;4510916643;Taip;9;0;0;9
4967;Lazdynėlis;RIEŠUTĖLIAI;91895608057;Taip;9;0;0;9
4968;Lazdynėlis;RIEŠUTĖLIAI;95091154108;Taip;9;0;0;9
4969;Lazdynėlis;RIEŠUTĖLIAI;95539787778;Taip;0;10;0;10
4970;Lazdynėlis;RIEŠUTĖLIAI;3000783343;Taip;8;0;0;8
4971;Lazdynėlis;RIEŠUTĖLIAI;75017112973;Taip;0;1;1;2
4972;Lazdynėlis;RIEŠUTĖLIAI;66392058189;Taip;0;5;0;5
4973;Lazdynėlis;RIEŠUTĖLIAI;1166968513;Taip;5;0;0;5
4974;Lazdynėlis;RIEŠUTĖLIAI;93311489447;Taip;0;14;0;14
4975;Lazdynėlis;RIEŠUTĖLIAI;3980826951;Taip;5;4;0;9
4976;Lazdynėlis;RIEŠUTĖLIAI;8338944978;Taip;11;0;0;11
4977;Lazdynėlis;RIEŠUTĖLIAI;1712263816;Taip;0;2;0;2
4978;Lazdynėlis;RIEŠUTĖLIAI;98624254124;Taip;0;4;0;4
4979;Lazdynėlis;RIEŠUTĖLIAI;1213657708;Taip;12;0;0;12
4980;Lazdynėlis;RIEŠUTĖLIAI;1169424024;Taip;11;0;0;11
4981;Lazdynėlis;RIEŠUTĖLIAI;1257093165;Taip;4;3;0;7
4982;Lazdynėlis;RIEŠUTĖLIAI;58985240094;Taip;0;12;0;12
4983;Lazdynėlis;RIEŠUTĖLIAI;7044338769;Taip;1;0;0;1
4984;Lazdynėlis;ANČIUKAI;5888646355;Taip;6;0;5;11
4985;Lazdynėlis;ANČIUKAI;4758605343;Taip;10;0;0;10
4986;Lazdynėlis;ANČIUKAI;4842228703;Taip;6;0;0;6
4987;Lazdynėlis;ANČIUKAI;8295967906;Taip;0;0;2;2
4988;Lazdynėlis;ANČIUKAI;7076664657;Taip;0;0;1;1
4989;Lazdynėlis;ANČIUKAI;7864896721;Taip;0;0;1;1
4990;Lazdynėlis;ANČIUKAI;8435203145;Taip;20;0;0;20
4991;Lazdynėlis;ANČIUKAI;4779025603;Taip;0;0;16;16
4992;Lazdynėlis;ANČIUKAI;79583491543;Taip;0;8;0;8
4993;Lazdynėlis;ANČIUKAI;1878157118;Taip;0;0;2;2
4994;Lazdynėlis;ANČIUKAI;2998606948;Taip;0;20;0;20
4995;Lazdynėlis;ANČIUKAI;9886856760;Taip;0;20;0;20
4996;Lazdynėlis;ANČIUKAI;3062408541;Taip;0;10;0;10
4997;Lazdynėlis;ANČIUKAI;7941793866;Taip;19;0;0;19
4998;Lazdynėlis;ANČIUKAI;3667994076;Taip;0;20;0;20
4999;Lazdynėlis;ANČIUKAI;6762312809;Taip;0;11;2;13
5000;Lazdynėlis;ANČIUKAI;9881554733;Taip;3;3;0;6
5001;Lazdynėlis;ANČIUKAI;7242681767;Taip;6;1;0;7
5002;Lazdynėlis;ANČIUKAI;5796381191;Taip;0;20;0;20
5003;Lazdynėlis;ANČIUKAI;5708643953;Taip;5;0;0;5
5004;Lazdynėlis;GUDRUČIAI;46106429615;Taip;6;2;0;8
5005;Lazdynėlis;GUDRUČIAI;11183641643;Taip;4;1;2;7
5006;Lazdynėlis;GUDRUČIAI;1543682603;Taip;3;4;0;7
5007;Lazdynėlis;GUDRUČIAI;6079498859;Ne;5;5;0;10
5008;Lazdynėlis;GUDRUČIAI;96599967318;Taip;19;0;0;19
5009;Lazdynėlis;GUDRUČIAI;16456265624;Taip;4;5;0;9
5010;Lazdynėlis;GUDRUČIAI;92885300680;Ne;0;20;0;20
5011;Lazdynėlis;GUDRUČIAI;44974714364;Taip;15;0;0;15
5012;Lazdynėlis;GUDRUČIAI;57304690488;Taip;4;0;0;4
5013;Lazdynėlis;GUDRUČIAI;57619129301;Taip;5;2;0;7
5014;Lazdynėlis;GUDRUČIAI;64086512959;Taip;0;2;0;2
5015;Lazdynėlis;GUDRUČIAI;56719158862;Taip;7;1;0;8
5016;Lazdynėlis;GUDRUČIAI;76657029807;Taip;6;1;0;7
5017;Lazdynėlis;GUDRUČIAI;41094911675;Taip;4;4;0;8
5018;Lazdynėlis;GUDRUČIAI;70505428445;Taip;2;4;0;6
5019;Lazdynėlis;GUDRUČIAI;1349582895;Taip;5;1;3;9
5020;Lazdynėlis;GUDRUČIAI;47140772153;Taip;6;0;1;7
5021;Lazdynėlis;GUDRUČIAI;34657435789;Taip;8;2;0;10
5022;Lazdynėlis;GUDRUČIAI;62863155757;Taip;7;4;0;11
5023;Lazdynėlis;GUDRUČIAI;34619798427;Taip;7;6;0;13
5024;Lazdynėlis;GUDRUČIAI;1909075641;Taip;7;0;6;13
5025;Lazdynėlis;GUDRUČIAI;2496563388;Taip;6;4;0;10
5026;Lazdynėlis;GUDRUČIAI;8704566189;Taip;6;1;0;7
5027;Lazdynėlis;GUDRUČIAI;41929529092;Taip;0;5;1;6
5028;Lazdynėlis;MEŠKIUKAI;2013752858;Taip;6;4;0;10
5029;Lazdynėlis;MEŠKIUKAI;2586187455;Taip;10;4;0;14
5030;Lazdynėlis;MEŠKIUKAI;6038907328;Taip;0;8;0;8
5031;Lazdynėlis;MEŠKIUKAI;2802505435;Taip;2;0;3;5
5032;Lazdynėlis;MEŠKIUKAI;2032759165;Taip;11;0;0;11
5033;Lazdynėlis;MEŠKIUKAI;4142277927;Taip;13;2;0;15
5034;Lazdynėlis;MEŠKIUKAI;2044188250;Taip;0;20;0;20
5035;Lazdynėlis;MEŠKIUKAI;1450181711;Taip;10;0;0;10
5036;Lazdynėlis;MEŠKIUKAI;7911328294;Taip;14;0;0;14
5037;Lazdynėlis;MEŠKIUKAI;9761942869;Taip;0;20;0;20
5038;Lazdynėlis;MEŠKIUKAI;6557165567;Taip;20;0;0;20
5039;Lazdynėlis;MEŠKIUKAI;5557752248;Taip;0;20;0;20
5040;Lazdynėlis;MEŠKIUKAI;4545757725;Taip;0;20;0;20
5041;Lazdynėlis;MEŠKIUKAI;8159928299;Taip;4;0;0;4
5042;Lazdynėlis;MEŠKIUKAI;5030400578;Taip;0;4;0;4
5043;Lazdynėlis;MEŠKIUKAI;1574847460;Taip;0;20;0;20
5044;Lazdynėlis;MEŠKIUKAI;4462819848;Taip;6;1;0;7
5045;Lazdynėlis;MEŠKIUKAI;1748260780;Taip;0;20;0;20
5046;Lazdynėlis;MEŠKIUKAI;8008332680;Taip;5;0;0;5
5047;Lazdynėlis;MEŠKIUKAI;4826167852;Taip;0;20;0;20
5048;Linelis;Giliukai;85241351404;Ne;7;0;0;7
5049;Linelis;Giliukai;18406137746;Taip;9;0;0;9
5050;Linelis;Giliukai;29074930927;Taip;8;2;6;16
5051;Linelis;Giliukai;1539102468;Taip;12;0;2;14
5052;Linelis;Giliukai;79543604124;Taip;0;0;16;16
5053;Linelis;Giliukai;5903547677;Taip;9;0;0;9
5054;Linelis;Giliukai;3300710386;Taip;9;0;1;10
5055;Linelis;Giliukai;1505058152;Taip;20;0;0;20
5056;Linelis;Giliukai;92658776822;Taip;0;7;0;7
5057;Linelis;Giliukai;4644771654;Taip;9;5;2;16
5058;Linelis;Giliukai;11026646292;Taip;0;0;8;8
5059;Linelis;Giliukai;94514045159;Taip;3;0;4;7
5060;Linelis;Giliukai;68089107580;Taip;6;0;0;6
5061;Linelis;Giliukai;18847368957;Taip;20;0;0;20
5062;Linelis;Giliukai;1646521870;Taip;0;0;12;12
5063;Linelis;Giliukai;1270931913;Taip;14;0;0;14
5064;Linelis;Giliukai;1237521453;Taip;9;0;1;10
5065;Linelis;Giliukai;53442382594;Taip;14;0;1;15
5066;Linelis;Giliukai;87947273588;Taip;5;1;0;6
5067;Linelis;Giliukai;93959783827;Taip;0;0;6;6
5068;Linelis;Giliukai;1270843542;Taip;0;0;5;5
5069;Linelis;Giliukai;1159267747;Taip;9;3;0;12
5070;Linelis;Daigiukai;4738909947;Taip;6;0;0;6
5071;Linelis;Daigiukai;6385439136;Taip;0;2;2;4
5072;Linelis;Daigiukai;1552829080;Taip;0;2;2;4
5073;Linelis;Daigiukai;4253571334;Taip;8;0;0;8
5074;Linelis;Daigiukai;4126444564;Taip;0;0;20;20
5075;Linelis;Daigiukai;3158789663;Taip;9;0;0;9
5076;Linelis;Daigiukai;8837847094;Taip;3;0;7;10
5077;Linelis;Daigiukai;3189188757;Taip;10;0;10;20
5078;Linelis;Daigiukai;1351957198;Taip;19;0;0;19
5079;Linelis;Daigiukai;7881263225;Taip;7;0;0;7
5080;Linelis;Daigiukai;3682550072;Taip;0;1;0;1
5081;Linelis;Daigiukai;2857645329;Taip;15;0;0;15
5082;Linelis;Daigiukai;8654487151;Taip;0;0;3;3
5083;Linelis;Daigiukai;9920959446;Taip;10;0;0;10
5084;Linelis;Daigiukai;6160295507;Taip;0;0;10;10
5085;Linelis;Daigiukai;6374352500;Taip;5;0;1;6
5086;Markučiai;Žirniukų;13358445982;Taip;0;2;1;3
5087;Markučiai;Žirniukų;4934200922;Taip;0;3;0;3
5088;Markučiai;Žirniukų;89393452327;Taip;5;0;6;11
5089;Markučiai;Žirniukų;9506953554;Taip;0;12;2;14
5090;Markučiai;Žirniukų;61354140820;Taip;0;4;0;4
5091;Markučiai;Žirniukų;86073430849;Taip;7;4;1;12
5092;Markučiai;Žirniukų;23712199138;Taip;7;1;0;8
5093;Markučiai;Žirniukų;59514770545;Taip;13;0;0;13
5094;Markučiai;Žirniukų;68178936347;Taip;13;1;0;14
5095;Markučiai;Žirniukų;95776655287;Taip;1;0;0;1
5096;Markučiai;Žirniukų;47122307518;Taip;0;0;2;2
5097;Markučiai;Žirniukų;1193600084;Taip;5;2;0;7
5098;Markučiai;Žirniukų;9326053563;Taip;10;0;0;10
5099;Markučiai;Žirniukų;3498150320;Taip;8;0;0;8
5100;Markučiai;Žirniukų;1813116125;Taip;5;3;0;8
5101;Markučiai;Žirniukų;1150675918;Taip;12;0;0;12
5102;Markučiai;Žirniukų;95347461846;Taip;0;12;0;12
5103;Markučiai;Žirniukų;1962169822;Taip;9;1;0;10
5104;Markučiai;Žirniukų;4511936094;Taip;13;0;0;13
5105;Markučiai;Nykštukų;46647877230;Taip;5;3;0;8
5106;Markučiai;Nykštukų;37101160556;Taip;5;0;2;7
5107;Markučiai;Nykštukų;1473258832;Taip;10;1;0;11
5108;Markučiai;Nykštukų;92394309416;Taip;0;0;1;1
5109;Markučiai;Nykštukų;5026941590;Taip;6;0;0;6
5110;Markučiai;Nykštukų;81140027425;Taip;0;0;5;5
5111;Markučiai;Nykštukų;6915912992;Taip;0;0;1;1
5112;Markučiai;Nykštukų;52920975294;Taip;10;0;0;10
5113;Markučiai;Nykštukų;88304161598;Taip;4;11;0;15
5114;Markučiai;Nykštukų;7578995182;Taip;3;11;0;14
5115;Markučiai;Nykštukų;1464123752;Taip;12;0;0;12
5116;Markučiai;Nykštukų;6639579832;Taip;9;1;4;14
5117;Markučiai;Nykštukų;9985442003;Taip;12;3;0;15
5118;Markučiai;Nykštukų;1507368475;Taip;2;0;2;4
5119;Markučiai;Nykštukų;1817367317;Taip;0;1;0;1
5120;Markučiai;Pelėdžiukų;1586644788;Taip;1;5;3;9
5121;Markučiai;Pelėdžiukų;2539130198;Taip;11;0;0;11
5122;Markučiai;Pelėdžiukų;66953564222;Taip;0;5;1;6
5123;Markučiai;Pelėdžiukų;6430378111;Taip;10;0;0;10
5124;Markučiai;Pelėdžiukų;40039975519;Taip;5;1;0;6
5125;Markučiai;Pelėdžiukų;47402355544;Taip;0;7;0;7
5126;Markučiai;Pelėdžiukų;62012358431;Taip;14;0;0;14
5127;Markučiai;Pelėdžiukų;35937680002;Taip;19;0;0;19
5128;Markučiai;Pelėdžiukų;80867943870;Taip;1;2;0;3
5129;Markučiai;Pelėdžiukų;86596936099;Taip;5;9;0;14
5130;Markučiai;Pelėdžiukų;29403750068;Taip;20;0;0;20
5131;Markučiai;Pelėdžiukų;37310130818;Taip;0;9;0;9
5132;Markučiai;Pelėdžiukų;52599782800;Taip;0;12;0;12
5133;Markučiai;Pelėdžiukų;1482031262;Taip;5;17;0;22
5134;Markučiai;Pelėdžiukų;95026191001;Taip;4;6;3;13
5135;Markučiai;Pelėdžiukų;28059558537;Taip;10;9;0;19
5136;Markučiai;Pelėdžiukų;4938918595;Taip;15;0;0;15
5137;Markučiai;Pelėdžiukų;54616789785;Taip;8;0;0;8
5138;Markučiai;Pelėdžiukų;981774400;Taip;11;0;1;12
5139;Markučiai;Pelėdžiukų;1155718131;Taip;8;9;0;17
5140;Markučiai;Pelėdžiukų;18563720509;Taip;5;9;0;14
5141;Markučiai;Boružėlių;9059302464;Taip;0;0;16;16
5142;Markučiai;Boružėlių;9220749889;Taip;10;0;0;10
5143;Markučiai;Boružėlių;2962530721;Taip;4;0;2;6
5144;Markučiai;Boružėlių;6574037877;Taip;11;0;0;11
5145;Markučiai;Boružėlių;5752762229;Taip;7;1;0;8
5146;Markučiai;Boružėlių;4383421917;Taip;0;4;0;4
5147;Markučiai;Boružėlių;9789274040;Taip;9;2;2;13
5148;Markučiai;Boružėlių;1146968021;Taip;4;0;0;4
5149;Markučiai;Boružėlių;1171899107;Taip;9;0;0;9
5150;Markučiai;Boružėlių;8092642447;Taip;7;0;2;9
5151;Markučiai;Boružėlių;8078777204;Taip;16;0;0;16
5152;Markučiai;Boružėlių;8605357678;Taip;4;0;1;5
5153;Markučiai;Boružėlių;3755794133;Taip;11;1;4;16
5154;Markučiai;Boružėlių;8244065962;Taip;11;0;0;11
5155;Markučiai;Boružėlių;5902165968;Taip;5;0;0;5
5156;Markučiai;Bitučių;4653663237;Taip;17;0;0;17
5157;Markučiai;Bitučių;1720541082;Taip;4;0;0;4
5158;Markučiai;Bitučių;9518247571;Taip;8;0;4;12
5159;Markučiai;Bitučių;4836298058;Taip;0;0;5;5
5160;Markučiai;Bitučių;9027071539;Taip;4;0;0;4
5161;Markučiai;Bitučių;8748794886;Taip;0;0;8;8
5162;Markučiai;Bitučių;5727655114;Taip;7;0;2;9
5163;Markučiai;Bitučių;6740434675;Taip;16;0;0;16
5164;Markučiai;Bitučių;6707310242;Taip;12;0;0;12
5165;Markučiai;Bitučių;2256262371;Taip;11;6;1;18
5166;Markučiai;Bitučių;7387460586;Taip;0;4;0;4
5167;Markučiai;Bitučių;8950442843;Taip;5;2;1;8
5168;Markučiai;Bitučių;6260010822;Taip;20;0;0;20
5169;Markučiai;Drugelių;2851424931;Taip;7;0;0;7
5170;Markučiai;Drugelių;1719927769;Taip;0;0;4;4
5171;Markučiai;Drugelių;1411292558;Taip;3;0;2;5
5172;Markučiai;Drugelių;63211076619;Taip;9;0;4;13
5173;Markučiai;Drugelių;2608111078;Taip;8;0;1;9
5174;Markučiai;Drugelių;9428254633;Taip;8;0;1;9
5175;Markučiai;Drugelių;61666612833;Taip;0;1;2;3
5176;Markučiai;Drugelių;20261053601;Taip;0;1;1;2
5177;Markučiai;Drugelių;4573605085;Taip;13;0;0;13
5178;Markučiai;Drugelių;19415636420;Taip;0;0;4;4
5179;Markučiai;Drugelių;24315961901;Taip;10;0;1;11
5180;Markučiai;Drugelių;45698891062;Taip;0;11;2;13
5181;Markučiai;Drugelių;22197471483;Taip;10;0;1;11
5182;Markučiai;Drugelių;9028932081;Taip;0;17;0;17
5183;Markučiai;Drugelių;9019827941;Taip;10;0;3;13
5184;Markučiai;Drugelių;11203825718;Taip;0;0;1;1
5185;Markučiai;Drugelių;7538681006;Taip;0;10;4;14
5186;Markučiai;Drugelių;7194049189;Taip;7;0;4;11
5187;Markučiai;Drugelių;23081602011;Taip;0;0;12;12
5188;Markučiai;Skruzdėliukų;1471334430;Taip;0;0;2;2
5189;Markučiai;Skruzdėliukų;9825799013;Ne;10;2;0;12
5190;Markučiai;Skruzdėliukų;8803226424;Taip;8;0;1;9
5191;Markučiai;Skruzdėliukų;20702694553;Taip;6;6;0;12
5192;Markučiai;Skruzdėliukų;55093673733;Taip;2;1;0;3
5193;Markučiai;Skruzdėliukų;39971140989;Taip;11;0;0;11
5194;Markučiai;Skruzdėliukų;54732351634;Taip;0;0;6;6
5195;Markučiai;Skruzdėliukų;1631270056;Taip;0;2;0;2
5196;Markučiai;Skruzdėliukų;1419433247;Taip;15;1;0;16
5197;Markučiai;Skruzdėliukų;1089500743;Taip;0;9;5;14
5198;Markučiai;Skruzdėliukų;2939795063;Taip;10;9;1;20
5199;Markučiai;Skruzdėliukų;9285037135;Taip;6;0;2;8
5200;Markučiai;Skruzdėliukų;1699369138;Taip;5;0;8;13
5201;Markučiai;Skruzdėliukų;1881218133;Taip;5;0;1;6
5202;Markučiai;Skruzdėliukų;1200278823;Taip;9;0;6;15
5203;Markučiai;Skruzdėliukų;8863238710;Taip;20;0;0;20
5204;Markučiai;Skruzdėliukų;68193563408;Taip;9;2;0;11
5205;Markučiai;Skruzdėliukų;92854605649;Taip;8;0;1;9
5206;Markučiai;Skruzdėliukų;7114409929;Taip;8;0;1;9
5207;Markučiai;Skruzdėliukų;1529531638;Taip;5;0;0;5
5208;Markučiai;ZUIKUČIŲ;82320812575;Taip;20;0;0;20
5209;Markučiai;ZUIKUČIŲ;4861535057;Taip;9;0;0;9
5210;Markučiai;ZUIKUČIŲ;1482203905;Taip;10;0;0;10
5211;Markučiai;ZUIKUČIŲ;2045207175;Taip;5;5;1;11
5212;Markučiai;ZUIKUČIŲ;11751635395;Taip;12;3;0;15
5213;Markučiai;ZUIKUČIŲ;1184908076;Taip;3;10;1;14
5214;Markučiai;ZUIKUČIŲ;7729045227;Taip;11;0;0;11
5215;Markučiai;ZUIKUČIŲ;8061880631;Taip;9;0;0;9
5216;Markučiai;ZUIKUČIŲ;1392582514;Taip;10;1;0;11
5217;Markučiai;ZUIKUČIŲ;7691410556;Taip;14;0;0;14
5218;Markučiai;ZUIKUČIŲ;7969520467;Taip;17;0;0;17
5219;Markučiai;ZUIKUČIŲ;6453095915;Taip;8;0;0;8
5220;Markučiai;ZUIKUČIŲ;6808291628;Taip;5;6;0;11
5221;Markučiai;ZUIKUČIŲ;5387571295;Taip;12;0;1;13
5222;Markučiai;ZUIKUČIŲ;3794643964;Taip;3;4;0;7
5223;Markučiai;ZUIKUČIŲ;91228262895;Taip;0;0;14;14
5224;Markučiai;ZUIKUČIŲ;7481923902;Taip;0;0;5;5
5225;Markučiai;ZUIKUČIŲ;1025406111;Taip;6;11;0;17
5226;Markučiai;ZUIKUČIŲ;5749873170;Taip;10;0;0;10
5227;Markučiai;ZUIKUČIŲ;9581578352;Taip;15;0;0;15
5228;Markučiai;ŽIOGELIŲ;5099997904;Taip;11;0;1;12
5229;Markučiai;ŽIOGELIŲ;3163226803;Taip;12;0;1;13
5230;Markučiai;ŽIOGELIŲ;1244026489;Taip;16;0;0;16
5231;Markučiai;ŽIOGELIŲ;76025616287;Taip;0;0;2;2
5232;Markučiai;ŽIOGELIŲ;1323922187;Taip;13;1;0;14
5233;Markučiai;ŽIOGELIŲ;54892037118;Taip;3;0;6;9
5234;Markučiai;ŽIOGELIŲ;1549653580;Taip;9;3;0;12
5235;Markučiai;ŽIOGELIŲ;1054802708;Taip;13;0;0;13
5236;Markučiai;ŽIOGELIŲ;67074776419;Taip;1;4;0;5
5237;Markučiai;ŽIOGELIŲ;1007919702;Taip;0;5;2;7
5238;Markučiai;ŽIOGELIŲ;1923521405;Taip;5;0;1;6
5239;Markučiai;ŽIOGELIŲ;1164386108;Taip;5;0;1;6
5240;Markučiai;ŽIOGELIŲ;7850311496;Taip;10;4;1;15
5241;Markučiai;ŽIOGELIŲ;2169583290;Taip;3;9;0;12
5242;Markučiai;ŽIOGELIŲ;3340385503;Taip;11;0;2;13
5243;Markučiai;ŽIOGELIŲ;4152184290;Taip;9;0;0;9
5244;Markučiai;ŽIOGELIŲ;1742944578;Taip;0;0;2;2
5245;Markučiai;Ežiukių;1827829954;Taip;5;0;1;6
5246;Markučiai;Ežiukių;4925856706;Taip;0;5;0;5
5247;Markučiai;Ežiukių;6570638672;Taip;7;6;0;13
5248;Markučiai;Ežiukių;3771563320;Taip;12;0;0;12
5249;Markučiai;Ežiukių;1648283497;Taip;14;0;0;14
5250;Markučiai;Ežiukių;4186684938;Taip;15;0;0;15
5251;Markučiai;Ežiukių;5975331223;Taip;0;2;0;2
5252;Markučiai;Ežiukių;2687320408;Taip;6;1;0;7
5253;Markučiai;Ežiukių;1309122110;Taip;7;1;0;8
5254;Markučiai;Ežiukių;9295954145;Taip;7;1;1;9
5255;Markučiai;Ežiukių;8990923872;Taip;13;0;0;13
5256;Markučiai;Ežiukių;2738553283;Taip;19;1;0;20
5257;Markučiai;Ežiukių;3386071459;Taip;1;0;7;8
5258;Markučiai;Ežiukių;7255617408;Taip;11;6;0;17
5259;Markučiai;Ežiukių;5246980173;Taip;9;0;1;10
5260;Markučiai;Ežiukių;1599633295;Taip;6;14;0;20
5261;Markučiai;Ežiukių;6308368050;Taip;13;0;0;13
5262;Markučiai;Ežiukių;4249158803;Taip;6;4;0;10
5263;Markučiai;Ežiukių;5958705106;Taip;20;0;0;20
5264;Markučiai;Ežiukių;3282845685;Taip;0;0;2;2
5265;Mažylis;"2 DARŽELIO GR.";5063094678;Taip;12;0;2;14
5266;Mažylis;"2 DARŽELIO GR.";3860760654;Taip;12;0;2;14
5267;Mažylis;"2 DARŽELIO GR.";9608529135;Taip;0;0;2;2
5268;Mažylis;"2 DARŽELIO GR.";8899463988;Taip;4;0;1;5
5269;Mažylis;"2 DARŽELIO GR.";9411559447;Taip;17;0;0;17
5270;Mažylis;"2 DARŽELIO GR.";45148418456;Taip;14;0;1;15
5271;Mažylis;"2 DARŽELIO GR.";4252408251;Taip;10;0;0;10
5272;Mažylis;"2 DARŽELIO GR.";38277640135;Taip;0;4;5;9
5273;Mažylis;"2 DARŽELIO GR.";1514640197;Taip;0;0;8;8
5274;Mažylis;"2 DARŽELIO GR.";6851169340;Taip;0;0;2;2
5275;Mažylis;"2 DARŽELIO GR.";4486742281;Taip;0;0;5;5
5276;Mažylis;"2 DARŽELIO GR.";79181926145;Taip;5;0;3;8
5277;Mažylis;"2 DARŽELIO GR.";6920129837;Taip;0;0;7;7
5278;Mažylis;"2 DARŽELIO GR.";1663347167;Taip;20;0;0;20
5279;Mažylis;"2 DARŽELIO GR.";1460572347;Taip;1;0;0;1
5280;Mažylis;"2 DARŽELIO GR.";7416381505;Taip;14;0;0;14
5281;Mažylis;"2 DARŽELIO GR.";3217527771;Taip;10;0;1;11
5282;Mažylis;"2 DARŽELIO GR.";1002832487;Taip;0;0;8;8
5283;Mažylis;"2 DARŽELIO GR.";6134051712;Taip;0;0;1;1
5284;Mažylis;"2 DARŽELIO GR.";8352202912;Taip;5;0;1;6
5285;Mažylis;"4 PRIEŠMOKYKLINĖ GR.";70526651195;Taip;0;9;5;14
5286;Mažylis;"4 PRIEŠMOKYKLINĖ GR.";6302092043;Taip;0;0;1;1
5287;Mažylis;"4 PRIEŠMOKYKLINĖ GR.";66861078627;Ne;0;0;7;7
5288;Mažylis;"4 PRIEŠMOKYKLINĖ GR.";28914540415;Taip;0;0;2;2
5289;Mažylis;"4 PRIEŠMOKYKLINĖ GR.";57677251463;Taip;0;0;20;20
5290;Mažylis;"4 PRIEŠMOKYKLINĖ GR.";12947127475;Taip;14;0;0;14
5291;Mažylis;"4 PRIEŠMOKYKLINĖ GR.";69106809499;Ne;0;0;7;7
5292;Mažylis;"4 PRIEŠMOKYKLINĖ GR.";5439091390;Taip;13;0;0;13
5293;Mažylis;"4 PRIEŠMOKYKLINĖ GR.";36779005815;Taip;0;0;1;1
5294;Mažylis;"4 PRIEŠMOKYKLINĖ GR.";79482905001;Taip;0;0;1;1
5295;Mažylis;"4 PRIEŠMOKYKLINĖ GR.";87616420119;Taip;0;0;3;3
5296;Mažylis;"4 PRIEŠMOKYKLINĖ GR.";33743124122;Taip;0;0;4;4
5297;Mažylis;"4 PRIEŠMOKYKLINĖ GR.";40329007615;Ne;5;0;0;5
5298;Mažylis;"4 PRIEŠMOKYKLINĖ GR.";1102106521;Taip;0;0;17;17
5299;Mažylis;"4 PRIEŠMOKYKLINĖ GR.";54844605291;Taip;0;0;6;6
5300;Mažylis;"4 PRIEŠMOKYKLINĖ GR.";26981897418;Taip;0;10;0;10
5301;Mažylis;"4 PRIEŠMOKYKLINĖ GR.";52616512471;Taip;0;0;1;1
5302;Mažylis;"4 PRIEŠMOKYKLINĖ GR.";53780435826;Taip;5;0;2;7
5303;Mažylis;"4 PRIEŠMOKYKLINĖ GR.";89877442445;Taip;0;0;6;6
5304;Mažylis;"4 PRIEŠMOKYKLINĖ GR.";5984612355;Taip;0;4;1;5
5305;Mažylis;"5 DARŽ.GR.";7774469604;Taip;0;0;2;2
5306;Mažylis;"5 DARŽ.GR.";71577274183;Taip;0;0;1;1
5307;Mažylis;"5 DARŽ.GR.";1692808423;Taip;0;0;8;8
5308;Mažylis;"5 DARŽ.GR.";76814348181;Taip;0;0;1;1
5309;Mažylis;"5 DARŽ.GR.";18640177395;Taip;4;1;0;5
5310;Mažylis;"5 DARŽ.GR.";37676161966;Taip;0;0;5;5
5311;Mažylis;"5 DARŽ.GR.";91436869919;Taip;0;0;5;5
5312;Mažylis;"5 DARŽ.GR.";74056314359;Taip;0;0;4;4
5313;Mažylis;"5 DARŽ.GR.";36307201422;Taip;0;4;4;8
5314;Mažylis;"5 DARŽ.GR.";9958976870;Taip;0;4;1;5
5315;Mažylis;"5 DARŽ.GR.";56438009944;Taip;0;6;0;6
5316;Mažylis;"5 DARŽ.GR.";11471986928;Taip;0;0;1;1
5317;Mažylis;"5 DARŽ.GR.";87637767247;Taip;0;0;3;3
5318;Mažylis;"5 DARŽ.GR.";1391395429;Taip;0;0;6;6
5319;Mažylis;"5 DARŽ.GR.";43986953632;Taip;0;3;0;3
5320;Mažylis;"5 DARŽ.GR.";8439933210;Taip;0;9;1;10
5321;Mažylis;"5 DARŽ.GR.";3436690709;Taip;11;0;0;11
5322;Mažylis;"5 DARŽ.GR.";8318476578;Taip;18;0;0;18
5323;Mažylis;"3 DARŽELIO GR.";98057700570;Taip;0;0;1;1
5324;Mažylis;"3 DARŽELIO GR.";1643460270;Taip;0;0;2;2
5325;Mažylis;"3 DARŽELIO GR.";24303144913;Taip;15;0;0;15
5326;Mažylis;"3 DARŽELIO GR.";69238700097;Taip;0;3;0;3
5327;Mažylis;"3 DARŽELIO GR.";50868656860;Taip;19;0;0;19
5328;Mažylis;"3 DARŽELIO GR.";13841546358;Taip;0;3;0;3
5329;Mažylis;"3 DARŽELIO GR.";1370723211;Taip;20;0;0;20
5330;Mažylis;"3 DARŽELIO GR.";2070067356;Ne;10;0;1;11
5331;Mažylis;"3 DARŽELIO GR.";81907805809;Taip;0;0;4;4
5332;Mažylis;"3 DARŽELIO GR.";1999937720;Taip;6;3;3;12
5333;Mažylis;"3 DARŽELIO GR.";98251642256;Taip;7;0;0;7
5334;Mažylis;"3 DARŽELIO GR.";90336289067;Taip;8;0;4;12
5335;Mažylis;"3 DARŽELIO GR.";46239142395;Taip;3;5;0;8
5336;Mažylis;"3 DARŽELIO GR.";1021183555;Taip;4;5;0;9
5337;Mažylis;"3 DARŽELIO GR.";1910064549;Taip;8;0;0;8
5338;Mažylis;"3 DARŽELIO GR.";86823456557;Taip;6;0;0;6
5339;Mažylis;"3 DARŽELIO GR.";2520667095;Taip;4;0;2;6
5340;Mažylis;"3 DARŽELIO GR.";2299288258;Taip;20;0;0;20
5341;Mažylis;"3 DARŽELIO GR.";5479496104;Taip;3;2;1;6
5342;Mažylis;"3 DARŽELIO GR.";1520251270;Taip;4;0;0;4
5343;Mažylis;"3 DARŽELIO GR.";5271395545;Taip;0;2;1;3
5344;Mažylis;"6 DARŽELIO GR.";1023886258;Taip;0;0;3;3
5345;Mažylis;"6 DARŽELIO GR.";2249845212;Taip;12;0;0;12
5346;Mažylis;"6 DARŽELIO GR.";38333694019;Taip;0;0;5;5
5347;Mažylis;"6 DARŽELIO GR.";68630915872;Taip;0;0;4;4
5348;Mažylis;"6 DARŽELIO GR.";37552673590;Taip;6;0;0;6
5349;Mažylis;"6 DARŽELIO GR.";44917962136;Taip;5;4;0;9
5350;Mažylis;"6 DARŽELIO GR.";34677678888;Ne;0;11;0;11
5351;Mažylis;"6 DARŽELIO GR.";88409362086;Taip;10;0;0;10
5352;Mažylis;"6 DARŽELIO GR.";99612915803;Taip;0;0;4;4
5353;Mažylis;"6 DARŽELIO GR.";96882209197;Taip;10;0;0;10
5354;Mažylis;"6 DARŽELIO GR.";10093289570;Ne;11;0;1;12
5355;Mažylis;"6 DARŽELIO GR.";71414598607;Taip;0;0;4;4
5356;Mažylis;"6 DARŽELIO GR.";67697608754;Taip;0;4;1;5
5357;Mažylis;"6 DARŽELIO GR.";4899739075;Taip;14;0;0;14
5358;Mažylis;"6 DARŽELIO GR.";1418120714;Taip;8;0;0;8
5359;Mažylis;"6 DARŽELIO GR.";1381948803;Taip;14;0;1;15
5360;Mažylis;"6 DARŽELIO GR.";2379352639;Taip;3;0;4;7
5361;Mažylis;"6 DARŽELIO GR.";94128544096;Taip;3;1;0;4
5362;Mažylis;"6 DARŽELIO GR.";33428832459;Taip;0;0;3;3
5363;Mažylis;"1 NAUJA (LOPŠELIS)";6854350717;Taip;3;0;7;10
5364;Mažylis;"1 NAUJA (LOPŠELIS)";5870983755;Taip;0;0;5;5
5365;Mažylis;"1 NAUJA (LOPŠELIS)";2979849055;Taip;14;0;1;15
5366;Mažylis;"1 NAUJA (LOPŠELIS)";4503734408;Taip;17;0;0;17
5367;Mažylis;"1 NAUJA (LOPŠELIS)";6162880220;Taip;11;0;0;11
5368;Mažylis;"1 NAUJA (LOPŠELIS)";9362249595;Taip;19;0;0;19
5369;Mažylis;"1 NAUJA (LOPŠELIS)";1077493584;Taip;0;0;1;1
5370;Mažylis;"1 NAUJA (LOPŠELIS)";4798415786;Taip;3;2;0;5
5371;Mažylis;"1 NAUJA (LOPŠELIS)";2656290898;Taip;0;0;7;7
5372;Mažylis;"1 NAUJA (LOPŠELIS)";7185347381;Taip;5;0;0;5
5373;Mažylis;"1 NAUJA (LOPŠELIS)";4280547746;Taip;6;0;2;8
5374;Mažylis;"1 NAUJA (LOPŠELIS)";9447747294;Taip;6;0;0;6
5375;Mažylis;"1 NAUJA (LOPŠELIS)";2126108232;Taip;5;0;0;5
5376;Medynėlis;BITUTĖS;1721728772;Taip;0;1;1;2
5377;Medynėlis;BITUTĖS;51942577095;Taip;0;4;0;4
5378;Medynėlis;BITUTĖS;42543506690;Taip;3;3;1;7
5379;Medynėlis;BITUTĖS;57858019710;Taip;10;4;0;14
5380;Medynėlis;BITUTĖS;78341557395;Taip;0;5;2;7
5381;Medynėlis;BITUTĖS;70950123240;Taip;0;0;1;1
5382;Medynėlis;BITUTĖS;38838111813;Taip;9;8;0;17
5383;Medynėlis;BITUTĖS;1641742927;Ne;0;2;2;4
5384;Medynėlis;BITUTĖS;5202479867;Taip;6;0;1;7
5385;Medynėlis;BITUTĖS;83599369692;Taip;5;7;0;12
5386;Medynėlis;BITUTĖS;72334464245;Taip;0;1;0;1
5387;Medynėlis;BITUTĖS;54282609151;Taip;5;3;0;8
5388;Medynėlis;BITUTĖS;44971270687;Taip;5;0;1;6
5389;Medynėlis;BITUTĖS;39476010274;Taip;19;0;0;19
5390;Medynėlis;BITUTĖS;7522506857;Taip;0;4;0;4
5391;Medynėlis;BITUTĖS;2055140361;Taip;10;10;0;20
5392;Medynėlis;BITUTĖS;1663988144;Taip;0;3;0;3
5393;Medynėlis;BITUTĖS;3684709853;Taip;3;1;0;4
5394;Medynėlis;BITUTĖS;65852278020;Taip;0;4;0;4
5395;Medynėlis;BITUTĖS;34879998108;Taip;0;6;0;6
5396;Medynėlis;DRUGELIAI;29673282359;Taip;0;2;0;2
5397;Medynėlis;DRUGELIAI;119345675;Ne;2;0;0;2
5398;Medynėlis;DRUGELIAI;56207399170;Taip;10;0;0;10
5399;Medynėlis;DRUGELIAI;77267420461;Taip;16;0;0;16
5400;Medynėlis;DRUGELIAI;64020246327;Taip;0;1;0;1
5401;Medynėlis;DRUGELIAI;82368415455;Taip;5;0;0;5
5402;Medynėlis;DRUGELIAI;69233446672;Taip;0;1;0;1
5403;Medynėlis;DRUGELIAI;96133788423;Taip;14;0;0;14
5404;Medynėlis;DRUGELIAI;1673034349;Taip;5;2;1;8
5405;Medynėlis;DRUGELIAI;98839852579;Taip;0;4;1;5
5406;Medynėlis;DRUGELIAI;22845549109;Taip;4;1;0;5
5407;Medynėlis;DRUGELIAI;20592655649;Taip;0;0;3;3
5408;Medynėlis;DRUGELIAI;64603154583;Taip;5;0;3;8
5409;Medynėlis;DRUGELIAI;27434992072;Taip;5;0;0;5
5410;Medynėlis;DRUGELIAI;4567518841;Taip;0;4;0;4
5411;Medynėlis;DRUGELIAI;68940537831;Taip;0;2;0;2
5412;Medynėlis;DRUGELIAI;75083011184;Taip;9;8;0;17
5413;Medynėlis;DRUGELIAI;5748498291;Ne;3;0;0;3
5414;Medynėlis;DRUGELIAI;55276812676;Taip;6;0;0;6
5415;Medynėlis;DRUGELIAI;76282032727;Taip;11;1;0;12
5416;Medynėlis;DRUGELIAI;97943522374;Taip;1;0;0;1
5417;Medynėlis;DRUGELIAI;1864572888;Taip;0;4;0;4
5418;Medynėlis;DRUGELIAI;1828684971;Taip;12;0;0;12
5419;Medynėlis;DRUGELIAI;30399789674;Taip;19;0;0;19
5420;Medynėlis;SKRUZDĖLIUKAI;4024866819;Taip;10;7;0;17
5421;Medynėlis;SKRUZDĖLIUKAI;2418225089;Taip;2;1;0;3
5422;Medynėlis;SKRUZDĖLIUKAI;9413309043;Taip;0;0;1;1
5423;Medynėlis;SKRUZDĖLIUKAI;6594928740;Taip;1;10;0;11
5424;Medynėlis;SKRUZDĖLIUKAI;4581683292;Taip;18;1;0;19
5425;Medynėlis;SKRUZDĖLIUKAI;9009316740;Taip;5;0;7;12
5426;Medynėlis;SKRUZDĖLIUKAI;1795479738;Taip;14;3;0;17
5427;Medynėlis;SKRUZDĖLIUKAI;5530782065;Taip;5;0;0;5
5428;Medynėlis;SKRUZDĖLIUKAI;5269927048;Taip;0;0;1;1
5429;Medynėlis;SKRUZDĖLIUKAI;2427349194;Taip;5;0;0;5
5430;Medynėlis;SKRUZDĖLIUKAI;8948133343;Taip;0;2;0;2
5431;Medynėlis;SKRUZDĖLIUKAI;7244497661;Taip;7;0;1;8
5432;Medynėlis;SKRUZDĖLIUKAI;5995034919;Taip;13;0;0;13
5433;Medynėlis;SKRUZDĖLIUKAI;8775219704;Taip;0;1;0;1
5434;Medynėlis;SKRUZDĖLIUKAI;1658457155;Taip;0;1;2;3
5435;Medynėlis;SKRUZDĖLIUKAI;33981260502;Taip;17;0;0;17
5436;Medynėlis;SKRUZDĖLIUKAI;3773215372;Taip;20;0;0;20
5437;Medynėlis;VOVERIUKAI;2834559432;Taip;0;0;2;2
5438;Medynėlis;VOVERIUKAI;2310200034;Taip;2;0;1;3
5439;Medynėlis;VOVERIUKAI;90556319090;Taip;4;0;3;7
5440;Medynėlis;VOVERIUKAI;6999562417;Taip;10;6;0;16
5441;Medynėlis;VOVERIUKAI;5586407412;Taip;0;0;1;1
5442;Medynėlis;VOVERIUKAI;7108619017;Taip;6;10;0;16
5443;Medynėlis;VOVERIUKAI;8441104709;Taip;0;0;1;1
5444;Medynėlis;VOVERIUKAI;1820113382;Taip;12;3;0;15
5445;Medynėlis;VOVERIUKAI;9304002459;Taip;9;0;0;9
5446;Medynėlis;VOVERIUKAI;5982453884;Taip;5;1;1;7
5447;Medynėlis;VOVERIUKAI;1173510831;Taip;20;0;0;20
5448;Medynėlis;VOVERIUKAI;6406459222;Taip;15;1;0;16
5449;Medynėlis;VOVERIUKAI;2335108073;Taip;11;0;1;12
5450;Medynėlis;VOVERIUKAI;4985243068;Taip;10;0;4;14
5451;Medynėlis;VOVERIUKAI;2057309788;Taip;6;0;0;6
5452;Medynėlis;VOVERIUKAI;9073514151;Taip;8;3;0;11
5453;Medynėlis;VOVERIUKAI;4238860287;Taip;10;0;0;10
5454;Medynėlis;VOVERIUKAI;1750775033;Taip;17;0;0;17
5455;Medynėlis;VOVERIUKAI;9800678364;Taip;13;0;4;17
5456;Medynėlis;VOVERIUKAI;1237589979;Taip;20;0;0;20
5457;Medynėlis;MEŠKIUKAI;1434648803;Taip;15;0;1;16
5458;Medynėlis;MEŠKIUKAI;1975763240;Taip;9;0;5;14
5459;Medynėlis;MEŠKIUKAI;5347745655;Taip;5;14;0;19
5460;Medynėlis;MEŠKIUKAI;1781906016;Taip;0;6;0;6
5461;Medynėlis;MEŠKIUKAI;91658912153;Taip;1;0;5;6
5462;Medynėlis;MEŠKIUKAI;1269734734;Taip;0;4;0;4
5463;Medynėlis;MEŠKIUKAI;46445461622;Taip;12;1;0;13
5464;Medynėlis;MEŠKIUKAI;7226012217;Taip;17;0;0;17
5465;Medynėlis;MEŠKIUKAI;5007624930;Taip;13;0;0;13
5466;Medynėlis;MEŠKIUKAI;9476336240;Taip;17;0;0;17
5467;Medynėlis;MEŠKIUKAI;8629622922;Taip;0;2;3;5
5468;Medynėlis;MEŠKIUKAI;1479759021;Taip;6;2;1;9
5469;Medynėlis;MEŠKIUKAI;2389345601;Taip;0;5;4;9
5470;Medynėlis;MEŠKIUKAI;1635649525;Taip;8;0;0;8
5471;Medynėlis;MEŠKIUKAI;6479758789;Taip;8;0;0;8
5472;Medynėlis;MEŠKIUKAI;12287981032;Taip;10;0;0;10
5473;Medynėlis;MEŠKIUKAI;12812096047;Taip;0;0;2;2
5474;Medynėlis;MEŠKIUKAI;2326848026;Taip;0;5;0;5
5475;Medynėlis;MEŠKIUKAI;5924711043;Taip;5;0;0;5
5476;Medynėlis;MEŠKIUKAI;8143370943;Taip;0;0;2;2
5477;Medynėlis;MEŠKIUKAI;32683798983;Taip;5;0;0;5
5478;Medynėlis;MEŠKIUKAI;99799126572;Ne;11;1;0;12
5479;Medynėlis;PELĖDŽIUKAI;1379827887;Taip;16;4;0;20
5480;Medynėlis;PELĖDŽIUKAI;1829338208;Taip;0;2;0;2
5481;Medynėlis;PELĖDŽIUKAI;88240380945;Taip;8;0;0;8
5482;Medynėlis;PELĖDŽIUKAI;1129265551;Taip;11;0;0;11
5483;Medynėlis;PELĖDŽIUKAI;76668029492;Taip;17;0;0;17
5484;Medynėlis;PELĖDŽIUKAI;1080058205;Taip;19;0;0;19
5485;Medynėlis;PELĖDŽIUKAI;38759466139;Taip;9;0;0;9
5486;Medynėlis;PELĖDŽIUKAI;1968892466;Taip;6;9;0;15
5487;Medynėlis;PELĖDŽIUKAI;1194247621;Taip;0;7;0;7
5488;Medynėlis;PELĖDŽIUKAI;1590889839;Taip;5;7;0;12
5489;Medynėlis;PELĖDŽIUKAI;1755767517;Taip;10;1;1;12
5490;Medynėlis;PELĖDŽIUKAI;37435525923;Taip;12;0;0;12
5491;Medynėlis;PELĖDŽIUKAI;1415208530;Taip;18;0;0;18
5492;Medynėlis;PELĖDŽIUKAI;7804751416;Taip;17;1;0;18
5493;Medynėlis;PELĖDŽIUKAI;6182500688;Taip;0;7;0;7
5494;Medynėlis;PELĖDŽIUKAI;2831484614;Taip;10;0;0;10
5495;Medynėlis;PELĖDŽIUKAI;8122944228;Taip;6;4;7;17
5496;Medynėlis;PELĖDŽIUKAI;15047814683;Taip;8;0;0;8
5497;Medynėlis;PELĖDŽIUKAI;1937403950;Ne;9;0;0;9
5498;Medynėlis;PELĖDŽIUKAI;53914093216;Taip;19;0;0;19
5499;Medynėlis;BORUŽIUKAI;52437462417;Taip;10;0;0;10
5500;Medynėlis;BORUŽIUKAI;1657676226;Taip;7;2;0;9
5501;Medynėlis;BORUŽIUKAI;80165108645;Taip;5;0;0;5
5502;Medynėlis;BORUŽIUKAI;51192496113;Taip;3;0;0;3
5503;Medynėlis;BORUŽIUKAI;1314163134;Taip;5;1;0;6
5504;Medynėlis;BORUŽIUKAI;1010025777;Taip;10;4;0;14
5505;Medynėlis;BORUŽIUKAI;96544597673;Taip;5;7;0;12
5506;Medynėlis;BORUŽIUKAI;79786316561;Taip;10;1;0;11
5507;Medynėlis;BORUŽIUKAI;88550635466;Taip;0;6;0;6
5508;Medynėlis;BORUŽIUKAI;1693185124;Taip;0;8;0;8
5509;Medynėlis;BORUŽIUKAI;1563329598;Taip;14;2;0;16
5510;Medynėlis;BORUŽIUKAI;1611512841;Taip;7;2;0;9
5511;Medynėlis;BORUŽIUKAI;55848491611;Taip;10;0;0;10
5512;Medynėlis;BORUŽIUKAI;7061506238;Taip;5;0;0;5
5513;Medynėlis;BORUŽIUKAI;1192592678;Ne;20;0;0;20
5514;Medynėlis;BORUŽIUKAI;12150004702;Taip;14;1;0;15
5515;Medynėlis;BORUŽIUKAI;7628899696;Taip;15;4;0;19
5516;Medynėlis;BORUŽIUKAI;2044676215;Taip;0;1;0;1
5517;Medynėlis;BORUŽIUKAI;48636516521;Taip;0;2;0;2
5518;Medynėlis;EŽIUKAI;1409464952;Taip;3;2;0;5
5519;Medynėlis;EŽIUKAI;3398294520;Taip;8;0;0;8
5520;Medynėlis;EŽIUKAI;2026582294;Taip;8;4;0;12
5521;Medynėlis;EŽIUKAI;1437000615;Taip;0;11;0;11
5522;Medynėlis;EŽIUKAI;1995078812;Taip;4;0;0;4
5523;Medynėlis;EŽIUKAI;1208227740;Taip;9;1;0;10
5524;Medynėlis;EŽIUKAI;1569413876;Taip;16;0;0;16
5525;Medynėlis;EŽIUKAI;82365840630;Taip;6;1;0;7
5526;Medynėlis;EŽIUKAI;3165639252;Taip;1;0;2;3
5527;Medynėlis;EŽIUKAI;1882919126;Taip;6;8;0;14
5528;Medynėlis;EŽIUKAI;1472082682;Taip;9;1;0;10
5529;Medynėlis;EŽIUKAI;50558260808;Taip;0;3;0;3
5530;Medynėlis;EŽIUKAI;61158254770;Taip;10;3;0;13
5531;Medynėlis;EŽIUKAI;1216195798;Taip;0;8;0;8
5532;Medynėlis;EŽIUKAI;2406561273;Taip;5;0;0;5
5533;Medynėlis;EŽIUKAI;3225662051;Taip;0;1;0;1
5534;Medynėlis;EŽIUKAI;1915791061;Taip;14;0;0;14
5535;Medynėlis;ZUIKUČIAI;6706028300;Taip;0;0;1;1
5536;Medynėlis;ZUIKUČIAI;6955467123;Taip;12;0;1;13
5537;Medynėlis;ZUIKUČIAI;5785463517;Taip;14;1;0;15
5538;Medynėlis;ZUIKUČIAI;9184868565;Taip;20;0;0;20
5539;Medynėlis;ZUIKUČIAI;1621499650;Taip;0;4;0;4
5540;Medynėlis;ZUIKUČIAI;4222917765;Taip;6;4;0;10
5541;Medynėlis;ZUIKUČIAI;4323515017;Taip;0;0;1;1
5542;Medynėlis;ZUIKUČIAI;9866431097;Taip;17;0;0;17
5543;Medynėlis;ZUIKUČIAI;5571641847;Taip;14;0;0;14
5544;Medynėlis;ZUIKUČIAI;6681155625;Taip;20;0;0;20
5545;Medynėlis;ZUIKUČIAI;6073797962;Taip;17;0;0;17
5546;Medynėlis;ZUIKUČIAI;1901805808;Taip;19;0;0;19
5547;Medynėlis;ZUIKUČIAI;5784691118;Taip;19;0;0;19
5548;Medynėlis;KAČIUKAI;7740591575;Taip;8;1;0;9
5549;Medynėlis;KAČIUKAI;4100792567;Taip;6;0;2;8
5550;Medynėlis;KAČIUKAI;2086963376;Taip;5;0;0;5
5551;Medynėlis;KAČIUKAI;1587899391;Taip;19;0;0;19
5552;Medynėlis;KAČIUKAI;1056744101;Taip;16;1;3;20
5553;Medynėlis;KAČIUKAI;7455041214;Taip;0;1;1;2
5554;Medynėlis;KAČIUKAI;5267128750;Taip;15;0;0;15
5555;Medynėlis;KAČIUKAI;3554823424;Taip;10;0;0;10
5556;Medynėlis;KAČIUKAI;7272017225;Taip;5;1;0;6
5557;Medynėlis;KAČIUKAI;4092824377;Taip;13;3;0;16
5558;Medynėlis;KAČIUKAI;6826790492;Taip;6;1;1;8
5559;Medynėlis;KAČIUKAI;4488439037;Taip;19;0;1;20
5560;Medynėlis;KAČIUKAI;6101613567;Taip;5;0;0;5
5561;Medynėlis;KAČIUKAI;2234994999;Taip;0;1;0;1
5562;Medynėlis;PELIUKAI;9314893329;Taip;7;0;0;7
5563;Medynėlis;PELIUKAI;9764215406;Taip;1;4;0;5
5564;Medynėlis;PELIUKAI;3787172254;Taip;0;0;7;7
5565;Medynėlis;PELIUKAI;5051773825;Taip;13;0;0;13
5566;Medynėlis;PELIUKAI;1525185037;Taip;0;0;8;8
5567;Medynėlis;PELIUKAI;6218943275;Taip;3;0;3;6
5568;Medynėlis;PELIUKAI;1406029765;Taip;0;3;0;3
5569;Medynėlis;PELIUKAI;1162859552;Taip;14;1;0;15
5570;Medynėlis;PELIUKAI;6032067904;Taip;5;0;0;5
5571;Medynėlis;PELIUKAI;7232396755;Taip;0;0;6;6
5572;Medynėlis;PELIUKAI;9919108302;Taip;12;0;0;12
5573;Medynėlis;PELIUKAI;1463263793;Taip;6;6;0;12
5574;Medynėlis;PELIUKAI;1333848517;Taip;7;0;0;7
5575;Medynėlis;PELIUKAI;3270413614;Taip;2;4;0;6
5576;Medynėlis;PELIUKAI;5532880670;Taip;4;0;0;4
5577;Medynėlis;PELIUKAI;7651663404;Taip;0;1;0;1
5578;Medynėlis;PELIUKAI;5446430319;Taip;11;0;1;12
5579;Medynėlis;PELIUKAI;8271170887;Taip;6;0;0;6
5580;Medynėlis;PELIUKAI;4315717555;Taip;9;0;4;13
5581;Molinukas;NYKŠTUKAI;70883949824;Taip;0;6;7;13
5582;Molinukas;NYKŠTUKAI;25562159395;Taip;13;3;0;16
5583;Molinukas;NYKŠTUKAI;60898158225;Taip;13;0;0;13
5584;Molinukas;NYKŠTUKAI;51421193001;Taip;0;9;0;9
5585;Molinukas;NYKŠTUKAI;65954418475;Taip;9;0;11;20
5586;Molinukas;NYKŠTUKAI;25761685637;Taip;0;7;0;7
5587;Molinukas;NYKŠTUKAI;25402100091;Taip;0;0;2;2
5588;Molinukas;NYKŠTUKAI;19007912410;Taip;0;2;0;2
5589;Molinukas;NYKŠTUKAI;62719013867;Taip;5;0;3;8
5590;Molinukas;NYKŠTUKAI;41890709428;Taip;5;0;2;7
5591;Molinukas;NYKŠTUKAI;74040038141;Taip;11;0;2;13
5592;Molinukas;NYKŠTUKAI;96140904528;Taip;0;15;0;15
5593;Molinukas;NYKŠTUKAI;24664585525;Taip;0;1;0;1
5594;Molinukas;NYKŠTUKAI;96366441416;Taip;0;0;3;3
5595;Molinukas;NYKŠTUKAI;94725766823;Taip;10;6;0;16
5596;Molinukas;NYKŠTUKAI;15309143797;Taip;2;0;0;2
5597;Molinukas;NYKŠTUKAI;48613608109;Taip;5;1;0;6
5598;Molinukas;NYKŠTUKAI;52577977910;Ne;5;4;0;9
5599;Molinukas;NYKŠTUKAI;46887752521;Taip;10;4;1;15
5600;Molinukas;NYKŠTUKAI;81952213381;Taip;0;3;0;3
5601;Molinukas;NYKŠTUKAI;60386582602;Taip;0;1;0;1
5602;Molinukas;NYKŠTUKAI;1388074160;Taip;0;4;0;4
5603;Molinukas;NYKŠTUKAI;78355703743;Ne;14;0;0;14
5604;Molinukas;NYKŠTUKAI;21462500359;Ne;1;0;1;2
5605;Molinukas;NYKŠTUKAI;10647191823;Taip;1;11;0;12
5606;Molinukas;NYKŠTUKAI;95409535650;Taip;0;1;1;2
5607;Molinukas;NYKŠTUKAI;6155259547;Taip;7;1;0;8
5608;Molinukas;NYKŠTUKAI;11787953136;Taip;12;5;0;17
5609;Molinukas;NYKŠTUKAI;81983716075;Taip;11;1;0;12
5610;Molinukas;ZUIKUČIŲ;1469884686;Taip;7;0;0;7
5611;Molinukas;ZUIKUČIŲ;5387818175;Taip;8;0;1;9
5612;Molinukas;ZUIKUČIŲ;1138255845;Taip;0;0;3;3
5613;Molinukas;ZUIKUČIŲ;6326031969;Taip;20;0;0;20
5614;Molinukas;ZUIKUČIŲ;7398075402;Taip;0;2;0;2
5615;Molinukas;ZUIKUČIŲ;1185903576;Taip;11;0;0;11
5616;Molinukas;ZUIKUČIŲ;7377137582;Taip;3;0;3;6
5617;Molinukas;ZUIKUČIŲ;4534279257;Taip;15;0;0;15
5618;Molinukas;ZUIKUČIŲ;8688180482;Taip;14;0;0;14
5619;Molinukas;ZUIKUČIŲ;3917187380;Taip;5;0;0;5
5620;Molinukas;ZUIKUČIŲ;1686122652;Taip;14;0;0;14
5621;Molinukas;ZUIKUČIŲ;2324578741;Taip;5;0;2;7
5622;Molinukas;ZUIKUČIŲ;4918181437;Taip;8;0;5;13
5623;Molinukas;ZUIKUČIŲ;3497266382;Taip;19;0;0;19
5624;Molinukas;ZUIKUČIŲ;8604288346;Taip;10;0;9;19
5625;Molinukas;ZUIKUČIŲ;8297662673;Taip;17;0;0;17
5626;Molinukas;ZUIKUČIŲ;1856269656;Taip;0;6;9;15
5627;Molinukas;ZUIKUČIŲ;6636118069;Taip;0;11;0;11
5628;Molinukas;ZUIKUČIŲ;8525796051;Taip;5;15;0;20
5629;Molinukas;ZUIKUČIŲ;2774371800;Taip;10;5;4;19
5630;Molinukas;ZUIKUČIŲ;8913137310;Ne;0;2;2;4
5631;Molinukas;ZUIKUČIŲ;8416644024;Taip;2;0;12;14
5632;Molinukas;SRAIGIUKŲ;5116921885;Taip;11;0;3;14
5633;Molinukas;SRAIGIUKŲ;97437953544;Taip;5;6;0;11
5634;Molinukas;SRAIGIUKŲ;11734886433;Taip;5;4;0;9
5635;Molinukas;SRAIGIUKŲ;91328196871;Taip;12;0;0;12
5636;Molinukas;SRAIGIUKŲ;66414602983;Taip;4;0;9;13
5637;Molinukas;SRAIGIUKŲ;26935664306;Taip;0;2;0;2
5638;Molinukas;SRAIGIUKŲ;9379961926;Taip;5;1;0;6
5639;Molinukas;SRAIGIUKŲ;93194233755;Taip;5;0;0;5
5640;Molinukas;SRAIGIUKŲ;43690886471;Taip;10;2;3;15
5641;Molinukas;SRAIGIUKŲ;62433691448;Taip;0;4;0;4
5642;Molinukas;SRAIGIUKŲ;94522698417;Ne;11;0;0;11
5643;Molinukas;SRAIGIUKŲ;311898127;Taip;5;0;1;6
5644;Molinukas;SRAIGIUKŲ;36167191615;Taip;0;1;6;7
5645;Molinukas;SRAIGIUKŲ;58796578218;Taip;3;4;0;7
5646;Molinukas;SRAIGIUKŲ;93991392425;Taip;11;0;2;13
5647;Molinukas;SRAIGIUKŲ;28860932985;Taip;0;2;0;2
5648;Molinukas;SRAIGIUKŲ;8013554298;Taip;3;6;1;10
5649;Molinukas;SRAIGIUKŲ;71842515853;Taip;0;5;2;7
5650;Molinukas;SRAIGIUKŲ;9854008152;Taip;17;0;0;17
5651;Molinukas;SRAIGIUKŲ;42123897177;Taip;11;0;0;11
5652;Molinukas;SRAIGIUKŲ;11340728166;Taip;8;1;0;9
5653;Molinukas;SRAIGIUKŲ;4659400698;Taip;0;13;1;14
5654;Molinukas;SRAIGIUKŲ;21801124679;Ne;0;5;3;8
5655;Molinukas;SRAIGIUKŲ;5258874882;Taip;5;5;0;10
5656;Molinukas;SRAIGIUKŲ;3000090536;Taip;10;0;2;12
5657;Molinukas;VOVERIUKAI;99537506556;Taip;10;0;1;11
5658;Molinukas;VOVERIUKAI;49733379099;Taip;0;14;0;14
5659;Molinukas;VOVERIUKAI;7991320348;Taip;0;5;0;5
5660;Molinukas;VOVERIUKAI;1293862946;Taip;11;1;0;12
5661;Molinukas;VOVERIUKAI;1816951665;Taip;7;0;0;7
5662;Molinukas;VOVERIUKAI;8674220663;Taip;11;4;0;15
5663;Molinukas;VOVERIUKAI;1151672597;Taip;15;1;1;17
5664;Molinukas;VOVERIUKAI;13856993048;Taip;11;0;4;15
5665;Molinukas;VOVERIUKAI;41153045448;Taip;9;0;0;9
5666;Molinukas;VOVERIUKAI;43651915331;Taip;9;2;9;20
5667;Molinukas;VOVERIUKAI;12208955611;Taip;5;3;1;9
5668;Molinukas;VOVERIUKAI;91913856999;Taip;10;0;2;12
5669;Molinukas;VOVERIUKAI;1241069188;Taip;0;1;0;1
5670;Molinukas;VOVERIUKAI;44399175317;Taip;14;5;0;19
5671;Molinukas;VOVERIUKAI;10482714545;Taip;12;8;0;20
5672;Molinukas;VOVERIUKAI;1880434477;Taip;5;0;2;7
5673;Molinukas;VOVERIUKAI;54948831792;Taip;11;5;2;18
5674;Molinukas;VOVERIUKAI;45801826827;Taip;5;6;1;12
5675;Molinukas;VOVERIUKAI;1018558040;Taip;8;1;2;11
5676;Molinukas;VOVERIUKAI;93528667925;Taip;12;0;2;14
5677;Molinukas;VOVERIUKAI;1538778372;Taip;7;0;1;8
5678;Molinukas;VOVERIUKAI;1167405137;Taip;4;0;3;7
5679;Molinukas;VOVERIUKAI;2048642721;Taip;10;0;1;11
5680;Molinukas;VOVERIUKAI;2041132581;Taip;5;7;1;13
5681;Molinukas;VOVERIUKAI;2931616290;Taip;14;0;0;14
5682;Molinukas;VOVERIUKAI;7987658567;Ne;0;2;2;4
5683;Molinukas;ŽVIRBLIUKŲ;3103270131;Taip;9;0;1;10
5684;Molinukas;ŽVIRBLIUKŲ;6353165459;Taip;10;0;0;10
5685;Molinukas;ŽVIRBLIUKŲ;5876669121;Taip;11;0;0;11
5686;Molinukas;ŽVIRBLIUKŲ;3030169626;Taip;12;0;2;14
5687;Molinukas;ŽVIRBLIUKŲ;6087698882;Taip;13;0;2;15
5688;Molinukas;ŽVIRBLIUKŲ;6832647220;Taip;13;0;0;13
5689;Molinukas;ŽVIRBLIUKŲ;2211909678;Taip;14;0;0;14
5690;Molinukas;ŽVIRBLIUKŲ;4950808381;Taip;12;1;0;13
5691;Molinukas;ŽVIRBLIUKŲ;7623051674;Taip;20;0;0;20
5692;Molinukas;ŽVIRBLIUKŲ;6795839380;Taip;6;0;0;6
5693;Molinukas;ŽVIRBLIUKŲ;2348120316;Taip;10;0;2;12
5694;Molinukas;ŽVIRBLIUKŲ;8053608348;Taip;10;0;3;13
5695;Molinukas;ŽVIRBLIUKŲ;8446233414;Taip;14;0;6;20
5696;Molinukas;ŽVIRBLIUKŲ;6014990150;Taip;17;0;0;17
5697;Molinukas;KAČIUKŲ;1651650182;Taip;5;6;0;11
5698;Molinukas;KAČIUKŲ;7602239077;Taip;10;0;0;10
5699;Molinukas;KAČIUKŲ;7134802574;Taip;4;0;2;6
5700;Molinukas;KAČIUKŲ;8260101075;Taip;4;0;2;6
5701;Molinukas;KAČIUKŲ;5685582215;Taip;10;1;7;18
5702;Molinukas;KAČIUKŲ;9448910819;Taip;10;0;1;11
5703;Molinukas;KAČIUKŲ;3469196411;Taip;4;6;1;11
5704;Molinukas;KAČIUKŲ;1849018608;Taip;0;2;0;2
5705;Molinukas;KAČIUKŲ;4171978721;Taip;13;0;7;20
5706;Molinukas;KAČIUKŲ;5580968328;Taip;16;0;0;16
5707;Molinukas;KAČIUKŲ;9413396859;Taip;5;1;5;11
5708;Molinukas;KAČIUKŲ;4896935150;Taip;14;0;0;14
5709;Molinukas;KAČIUKŲ;2286586693;Taip;18;0;0;18
5710;Molinukas;KAČIUKŲ;8536615996;Taip;8;1;0;9
5711;Molinukas;KAČIUKŲ;6898958282;Taip;7;0;1;8
5712;Naminukas;Drugeliai;46165828687;Taip;14;1;0;15
5713;Naminukas;Drugeliai;2126348084;Taip;19;0;0;19
5714;Naminukas;Drugeliai;1462439902;Taip;0;0;4;4
5715;Naminukas;Drugeliai;85754834119;Taip;0;1;0;1
5716;Naminukas;Drugeliai;91504585368;Taip;8;5;0;13
5717;Naminukas;Drugeliai;1315517694;Taip;17;0;0;17
5718;Naminukas;Drugeliai;93286140513;Taip;8;0;3;11
5719;Naminukas;Drugeliai;10134368426;Taip;0;12;0;12
5720;Naminukas;Drugeliai;2126839560;Taip;4;4;0;8
5721;Naminukas;Drugeliai;1355495217;Taip;5;0;5;10
5722;Naminukas;Drugeliai;7291023483;Taip;0;3;0;3
5723;Naminukas;Drugeliai;27189261329;Taip;0;9;0;9
5724;Naminukas;Drugeliai;50807508081;Taip;0;2;0;2
5725;Naminukas;Drugeliai;34296400556;Taip;6;1;0;7
5726;Naminukas;Drugeliai;19432091931;Taip;4;1;0;5
5727;Naminukas;Drugeliai;90672353258;Taip;7;1;0;8
5728;Naminukas;Drugeliai;15608850480;Taip;0;0;2;2
5729;Naminukas;Drugeliai;8716638124;Taip;4;2;0;6
5730;Naminukas;Drugeliai;2967647412;Taip;0;8;0;8
5731;Naminukas;Drugeliai;5817578784;Taip;4;0;1;5
5732;Naminukas;Drugeliai;5822184150;Taip;0;0;6;6
5733;Naminukas;Drugeliai;7440490894;Taip;5;6;0;11
5734;Naminukas;Bitutės;8012095082;Taip;20;0;0;20
5735;Naminukas;Bitutės;53746114607;Taip;10;1;0;11
5736;Naminukas;Bitutės;9541388086;Taip;0;1;1;2
5737;Naminukas;Bitutės;4419568254;Taip;11;5;0;16
5738;Naminukas;Bitutės;1956749138;Taip;14;1;0;15
5739;Naminukas;Bitutės;6503569633;Taip;6;0;7;13
5740;Naminukas;Bitutės;3192885665;Taip;0;4;9;13
5741;Naminukas;Bitutės;9530232649;Taip;18;0;0;18
5742;Naminukas;Bitutės;8131328042;Taip;5;8;0;13
5743;Naminukas;Bitutės;2769848640;Taip;0;0;3;3
5744;Naminukas;Bitutės;7176287699;Taip;10;0;9;19
5745;Naminukas;Bitutės;7888950723;Taip;5;0;0;5
5746;Naminukas;Bitutės;1710002948;Taip;9;8;0;17
5747;Naminukas;Bitutės;5610993611;Taip;10;0;1;11
5748;Naminukas;Bitutės;3994190066;Taip;5;2;0;7
5749;Naminukas;Bitutės;6526207235;Taip;5;6;0;11
5750;Naminukas;Bitutės;9600303816;Taip;6;1;0;7
5751;Naminukas;Bitutės;5244682030;Taip;6;1;0;7
5752;Naminukas;Bitutės;5195078101;Taip;5;0;0;5
5753;Naminukas;Bitutės;9501202207;Taip;0;14;5;19
5754;Naminukas;Paukšteliai;92882855386;Taip;0;1;0;1
5755;Naminukas;Paukšteliai;37525846039;Taip;0;4;2;6
5756;Naminukas;Paukšteliai;2126182508;Taip;9;2;0;11
5757;Naminukas;Paukšteliai;3603079488;Taip;0;0;4;4
5758;Naminukas;Paukšteliai;1870907311;Taip;2;5;1;8
5759;Naminukas;Paukšteliai;69952843049;Taip;3;1;1;5
5760;Naminukas;Paukšteliai;59473696226;Taip;5;0;0;5
5761;Naminukas;Paukšteliai;1946057668;Taip;10;0;1;11
5762;Naminukas;Paukšteliai;1063718923;Taip;3;0;1;4
5763;Naminukas;Paukšteliai;1647625489;Taip;5;0;0;5
5764;Naminukas;Paukšteliai;93648945843;Taip;8;0;1;9
5765;Naminukas;Paukšteliai;34168788672;Taip;5;5;0;10
5766;Naminukas;Paukšteliai;1893485577;Taip;13;0;0;13
5767;Naminukas;Paukšteliai;1863885754;Taip;10;4;2;16
5768;Naminukas;Paukšteliai;2100371376;Taip;3;0;0;3
5769;Naminukas;Paukšteliai;1439033627;Taip;11;1;1;13
5770;Naminukas;Paukšteliai;1973581463;Taip;2;0;18;20
5771;Naminukas;Paukšteliai;15748906161;Taip;0;0;1;1
5772;Naminukas;Paukšteliai;70836957729;Taip;5;8;0;13
5773;Naminukas;Paukšteliai;79166535343;Taip;1;6;0;7
5774;Naminukas;"NYKŠTUKAI ";1509433995;Taip;0;0;2;2
5775;Naminukas;"NYKŠTUKAI ";59020433000;Taip;0;1;0;1
5776;Naminukas;"NYKŠTUKAI ";2544422668;Taip;0;6;0;6
5777;Naminukas;"NYKŠTUKAI ";3029310084;Taip;5;0;1;6
5778;Naminukas;"NYKŠTUKAI ";16946991001;Taip;12;0;0;12
5779;Naminukas;"NYKŠTUKAI ";7632725551;Taip;0;7;0;7
5780;Naminukas;"NYKŠTUKAI ";46665774314;Taip;5;7;0;12
5781;Naminukas;"NYKŠTUKAI ";1490712871;Taip;5;0;0;5
5782;Naminukas;"NYKŠTUKAI ";1252481328;Taip;13;1;0;14
5783;Naminukas;"NYKŠTUKAI ";5918430817;Taip;4;3;0;7
5784;Naminukas;"NYKŠTUKAI ";1499464511;Taip;5;8;1;14
5785;Naminukas;"NYKŠTUKAI ";9321656855;Taip;0;4;0;4
5786;Naminukas;"NYKŠTUKAI ";4515242836;Taip;5;4;0;9
5787;Naminukas;"NYKŠTUKAI ";3826149605;Taip;0;2;0;2
5788;Naminukas;"NYKŠTUKAI ";6501046678;Taip;5;0;1;6
5789;Naminukas;"NYKŠTUKAI ";6029194403;Taip;9;2;0;11
5790;Naminukas;"NYKŠTUKAI ";70281612245;Taip;5;0;0;5
5791;Naminukas;"NYKŠTUKAI ";10563508139;Taip;5;1;0;6
5792;Naminukas;"NYKŠTUKAI ";90045007984;Taip;6;13;0;19
5793;Naminukas;"NYKŠTUKAI ";74291965804;Taip;5;0;0;5
5794;Neries;DEBESĖLIŲ;8573169074;Taip;0;19;0;19
5795;Neries;DEBESĖLIŲ;2085901811;Taip;11;0;0;11
5796;Neries;DEBESĖLIŲ;70177841044;Taip;0;1;0;1
5797;Neries;DEBESĖLIŲ;66348813404;Taip;3;5;0;8
5798;Neries;DEBESĖLIŲ;97670123581;Taip;9;4;0;13
5799;Neries;DEBESĖLIŲ;78475531620;Taip;20;0;0;20
5800;Neries;DEBESĖLIŲ;58447815495;Taip;0;1;0;1
5801;Neries;DEBESĖLIŲ;1908377973;Taip;0;6;0;6
5802;Neries;DEBESĖLIŲ;1139288486;Taip;0;15;0;15
5803;Neries;DEBESĖLIŲ;6449369298;Taip;0;3;0;3
5804;Neries;DEBESĖLIŲ;6378297641;Taip;0;8;0;8
5805;Neries;DEBESĖLIŲ;2531690903;Taip;0;0;1;1
5806;Neries;DEBESĖLIŲ;1117389814;Taip;5;0;0;5
5807;Neries;DEBESĖLIŲ;25015347703;Taip;0;18;0;18
5808;Neries;PUMPURĖLIŲ;4058545269;Taip;5;2;1;8
5809;Neries;PUMPURĖLIŲ;40762091796;Taip;0;9;0;9
5810;Neries;PUMPURĖLIŲ;5189351158;Taip;0;1;0;1
5811;Neries;PUMPURĖLIŲ;42514000113;Taip;4;5;0;9
5812;Neries;PUMPURĖLIŲ;4112888398;Taip;11;0;0;11
5813;Neries;PUMPURĖLIŲ;1300411811;Taip;0;16;1;17
5814;Neries;PUMPURĖLIŲ;1355661922;Taip;4;4;0;8
5815;Neries;PUMPURĖLIŲ;1414837177;Taip;10;0;0;10
5816;Neries;PUMPURĖLIŲ;2003536788;Taip;8;5;0;13
5817;Neries;PUMPURĖLIŲ;14071513289;Taip;3;3;0;6
5818;Neries;PUMPURĖLIŲ;7332285452;Taip;5;14;0;19
5819;Neries;PUMPURĖLIŲ;2823401633;Taip;13;0;0;13
5820;Neries;PUMPURĖLIŲ;1666616466;Taip;0;0;1;1
5821;Neries;PUMPURĖLIŲ;5283566263;Ne;17;0;0;17
5822;Nykštukas;SMAGURIAI;46457925178;Taip;5;4;0;9
5823;Nykštukas;SMAGURIAI;67215878528;Taip;0;7;0;7
5824;Nykštukas;SMAGURIAI;279882740;Taip;9;1;0;10
5825;Nykštukas;SMAGURIAI;40791169410;Taip;0;2;0;2
5826;Nykštukas;SMAGURIAI;45998334166;Taip;6;5;0;11
5827;Nykštukas;SMAGURIAI;22907267392;Taip;5;4;0;9
5828;Nykštukas;SMAGURIAI;25467677674;Ne;8;1;0;9
5829;Nykštukas;SMAGURIAI;49403159088;Taip;0;7;0;7
5830;Nykštukas;SMAGURIAI;40507821302;Taip;3;1;0;4
5831;Nykštukas;SMAGURIAI;65431970524;Taip;0;3;1;4
5832;Nykštukas;SMAGURIAI;86774266699;Taip;3;1;2;6
5833;Nykštukas;SMAGURIAI;73015157334;Taip;0;11;0;11
5834;Nykštukas;SMAGURIAI;94379087811;Taip;0;6;0;6
5835;Nykštukas;SMAGURIAI;57158850838;Taip;1;3;0;4
5836;Nykštukas;SMAGURIAI;87788435945;Taip;0;1;0;1
5837;Nykštukas;SMAGURIAI;74269403579;Taip;17;3;0;20
5838;Nykštukas;SMAGURIAI;5270008748;Taip;11;1;0;12
5839;Nykštukas;SMAGURIAI;40765421180;Taip;0;5;0;5
5840;Nykštukas;SMAGURIAI;44921552171;Taip;0;14;0;14
5841;Nykštukas;SMAGURIAI;21793281327;Taip;0;2;0;2
5842;Nykštukas;SMAGURIAI;42662848704;Taip;0;4;0;4
5843;Nykštukas;SMAGURIAI;21894285952;Taip;0;4;0;4
5844;Nykštukas;SMAGURIAI;51839683425;Taip;0;9;0;9
5845;Nykštukas;SMAGURIAI;18018106215;Taip;0;5;0;5
5846;Nykštukas;SMALSIUKAI;60979950727;Taip;5;2;0;7
5847;Nykštukas;SMALSIUKAI;59343371023;Taip;0;6;4;10
5848;Nykštukas;SMALSIUKAI;43810892974;Taip;10;1;0;11
5849;Nykštukas;SMALSIUKAI;66105021371;Taip;0;2;0;2
5850;Nykštukas;SMALSIUKAI;62768852397;Taip;5;5;0;10
5851;Nykštukas;SMALSIUKAI;47375659986;Taip;10;6;0;16
5852;Nykštukas;SMALSIUKAI;38098661273;Taip;6;2;0;8
5853;Nykštukas;SMALSIUKAI;87609458114;Taip;0;1;1;2
5854;Nykštukas;SMALSIUKAI;26952411744;Ne;10;4;0;14
5855;Nykštukas;SMALSIUKAI;28276934404;Taip;0;7;2;9
5856;Nykštukas;SMALSIUKAI;79340379786;Taip;19;0;0;19
5857;Nykštukas;SMALSIUKAI;74234678869;Taip;0;8;0;8
5858;Nykštukas;SMALSIUKAI;51448568141;Taip;16;0;0;16
5859;Nykštukas;SMALSIUKAI;4909057583;Taip;8;1;0;9
5860;Nykštukas;SMALSIUKAI;50854821473;Taip;0;1;1;2
5861;Nykštukas;SMALSIUKAI;1213461702;Taip;6;0;0;6
5862;Nykštukas;SMALSIUKAI;50160103840;Taip;5;0;0;5
5863;Nykštukas;SMALSIUKAI;26248363243;Taip;5;1;0;6
5864;Nykštukas;SMALSIUKAI;57664247691;Taip;10;4;0;14
5865;Nykštukas;SMALSIUKAI;7598045357;Taip;0;3;0;3
5866;Nykštukas;SMALSIUKAI;2018631335;Taip;0;4;2;6
5867;Nykštukas;SMALSIUKAI;21048892728;Taip;7;0;0;7
5868;Nykštukas;SMALSIUKAI;9506999469;Taip;7;0;0;7
5869;Nykštukas;AITVARIUKAI;1144228064;Taip;19;0;0;19
5870;Nykštukas;AITVARIUKAI;6787279403;Taip;0;11;0;11
5871;Nykštukas;AITVARIUKAI;3808695428;Taip;6;0;0;6
5872;Nykštukas;AITVARIUKAI;2002197530;Taip;11;0;0;11
5873;Nykštukas;AITVARIUKAI;2113361929;Taip;16;0;0;16
5874;Nykštukas;AITVARIUKAI;1555891900;Taip;0;1;0;1
5875;Nykštukas;AITVARIUKAI;4256675710;Taip;13;3;0;16
5876;Nykštukas;AITVARIUKAI;1209871301;Taip;15;0;0;15
5877;Nykštukas;AITVARIUKAI;93527297465;Taip;20;0;0;20
5878;Nykštukas;AITVARIUKAI;1642172676;Taip;0;5;0;5
5879;Nykštukas;AITVARIUKAI;1603960759;Taip;14;0;0;14
5880;Nykštukas;AITVARIUKAI;4487291454;Taip;4;0;0;4
5881;Nykštukas;AITVARIUKAI;6274009442;Taip;4;4;0;8
5882;Nykštukas;AITVARIUKAI;5356005675;Taip;10;7;0;17
5883;Nykštukas;AITVARIUKAI;1760718866;Taip;0;1;5;6
5884;Nykštukas;AITVARIUKAI;9229795383;Taip;0;8;0;8
5885;Nykštukas;AITVARIUKAI;3479582264;Taip;0;3;0;3
5886;Nykštukas;AITVARIUKAI;1643843455;Taip;14;0;0;14
5887;Nykštukas;AITVARIUKAI;5421090978;Taip;10;3;0;13
5888;Nykštukas;AITVARIUKAI;1965559069;Taip;0;3;0;3
5889;Nykštukas;AITVARIUKAI;6480026426;Taip;0;8;0;8
5890;Nykštukas;DAINORĖLIAI;1505896987;Taip;0;3;2;5
5891;Nykštukas;DAINORĖLIAI;1070086244;Taip;10;1;0;11
5892;Nykštukas;DAINORĖLIAI;6105521992;Taip;5;7;0;12
5893;Nykštukas;DAINORĖLIAI;67968815055;Taip;9;6;0;15
5894;Nykštukas;DAINORĖLIAI;8027860617;Taip;0;4;2;6
5895;Nykštukas;DAINORĖLIAI;7498721887;Taip;5;1;0;6
5896;Nykštukas;DAINORĖLIAI;7660848578;Taip;3;0;0;3
5897;Nykštukas;DAINORĖLIAI;2284266953;Taip;6;0;1;7
5898;Nykštukas;DAINORĖLIAI;4720226790;Taip;0;12;0;12
5899;Nykštukas;DAINORĖLIAI;9778271272;Taip;12;0;0;12
5900;Nykštukas;DAINORĖLIAI;7150793310;Taip;20;0;0;20
5901;Nykštukas;DAINORĖLIAI;7584220414;Taip;0;6;0;6
5902;Nykštukas;DAINORĖLIAI;8323439041;Taip;10;0;1;11
5903;Nykštukas;DAINORĖLIAI;7615678714;Taip;13;1;0;14
5904;Nykštukas;DAINORĖLIAI;9567571526;Taip;15;0;0;15
5905;Nykštukas;DAINORĖLIAI;3970413055;Taip;11;1;0;12
5906;Nykštukas;DAINORĖLIAI;2657373608;Taip;0;3;0;3
5907;Nykštukas;DAINORĖLIAI;1755944368;Taip;2;13;0;15
5908;Nykštukas;DAINORĖLIAI;8781148130;Taip;1;11;0;12
5909;Nykštukas;DAINORĖLIAI;3904901392;Taip;14;1;0;15
5910;Nykštukas;POKŠTUKAI;3600328638;Taip;0;4;0;4
5911;Nykštukas;POKŠTUKAI;55774090623;Taip;0;4;0;4
5912;Nykštukas;POKŠTUKAI;76331610722;Taip;11;3;0;14
5913;Nykštukas;POKŠTUKAI;93975876383;Taip;11;4;0;15
5914;Nykštukas;POKŠTUKAI;97061337677;Taip;5;4;0;9
5915;Nykštukas;POKŠTUKAI;61522787793;Taip;5;5;0;10
5916;Nykštukas;POKŠTUKAI;57257040004;Taip;0;2;0;2
5917;Nykštukas;POKŠTUKAI;71341878371;Taip;9;0;0;9
5918;Nykštukas;POKŠTUKAI;26881921240;Ne;5;1;0;6
5919;Nykštukas;POKŠTUKAI;89891993226;Taip;5;2;0;7
5920;Nykštukas;POKŠTUKAI;76160042626;Taip;5;0;0;5
5921;Nykštukas;POKŠTUKAI;47502587491;Taip;5;10;0;15
5922;Nykštukas;POKŠTUKAI;89192783223;Taip;6;3;0;9
5923;Nykštukas;POKŠTUKAI;35147793572;Taip;0;2;0;2
5924;Nykštukas;POKŠTUKAI;47936707754;Taip;0;7;0;7
5925;Nykštukas;POKŠTUKAI;26063170580;Taip;0;5;0;5
5926;Nykštukas;POKŠTUKAI;16702608956;Taip;4;0;0;4
5927;Nykštukas;POKŠTUKAI;85166768951;Taip;0;2;0;2
5928;Nykštukas;KODĖLČIUKAI;6260667325;Taip;0;6;0;6
5929;Nykštukas;KODĖLČIUKAI;48573020040;Taip;20;0;0;20
5930;Nykštukas;KODĖLČIUKAI;58256421511;Taip;0;1;0;1
5931;Nykštukas;KODĖLČIUKAI;2082842190;Taip;5;8;0;13
5932;Nykštukas;KODĖLČIUKAI;68620632362;Taip;7;4;0;11
5933;Nykštukas;KODĖLČIUKAI;10417553044;Taip;0;3;0;3
5934;Nykštukas;KODĖLČIUKAI;26966643974;Taip;5;5;0;10
5935;Nykštukas;KODĖLČIUKAI;16477177174;Taip;5;5;0;10
5936;Nykštukas;KODĖLČIUKAI;55476689493;Taip;0;7;0;7
5937;Nykštukas;KODĖLČIUKAI;32089764813;Taip;5;1;0;6
5938;Nykštukas;KODĖLČIUKAI;86515707900;Taip;5;2;0;7
5939;Nykštukas;KODĖLČIUKAI;44948458322;Taip;0;2;0;2
5940;Nykštukas;KODĖLČIUKAI;17699507209;Taip;0;4;0;4
5941;Nykštukas;KODĖLČIUKAI;16511008060;Taip;0;1;0;1
5942;Nykštukas;KODĖLČIUKAI;3027861392;Taip;0;5;0;5
5943;Nykštukas;KODĖLČIUKAI;189969762;Taip;0;4;0;4
5944;Nykštukas;KODĖLČIUKAI;46532492743;Taip;5;5;1;11
5945;Nykštukas;KODĖLČIUKAI;36547972390;Taip;5;1;0;6
5946;Nykštukas;KODĖLČIUKAI;61302078210;Taip;0;11;0;11
5947;Nykštukas;KODĖLČIUKAI;98067007304;Taip;0;1;0;1
5948;Nykštukas;KODĖLČIUKAI;50111679676;Ne;0;3;0;3
5949;Nykštukas;KODĖLČIUKAI;4168838641;Taip;4;1;1;6
5950;Nykštukas;KODĖLČIUKAI;24395259826;Taip;0;4;0;4
5951;Nykštukas;PASAKORIAI;84548941865;Taip;0;4;0;4
5952;Nykštukas;PASAKORIAI;27650304509;Taip;0;10;0;10
5953;Nykštukas;PASAKORIAI;1754697121;Taip;0;3;0;3
5954;Nykštukas;PASAKORIAI;86393328886;Taip;0;1;0;1
5955;Nykštukas;PASAKORIAI;67433137766;Taip;0;4;0;4
5956;Nykštukas;PASAKORIAI;12777395170;Taip;0;9;0;9
5957;Nykštukas;PASAKORIAI;59971592045;Taip;5;5;0;10
5958;Nykštukas;PASAKORIAI;1412282356;Taip;0;3;0;3
5959;Nykštukas;PASAKORIAI;1312775821;Taip;6;1;0;7
5960;Nykštukas;PASAKORIAI;67209958343;Taip;0;12;0;12
5961;Nykštukas;PASAKORIAI;40012664626;Taip;0;2;0;2
5962;Nykštukas;PASAKORIAI;2106464061;Taip;0;3;0;3
5963;Nykštukas;PASAKORIAI;368045639;Taip;0;2;0;2
5964;Nykštukas;PASAKORIAI;53994799769;Taip;0;1;0;1
5965;Nykštukas;PASAKORIAI;1967445943;Taip;2;2;0;4
5966;Nykštukas;PASAKORIAI;88757197161;Taip;0;10;0;10
5967;Nykštukas;PASAKORIAI;301318033;Taip;0;17;0;17
5968;Nykštukas;PASAKORIAI;25431679881;Taip;10;1;1;12
5969;Nykštukas;PASAKORIAI;22318910984;Taip;0;1;1;2
5970;Nykštukas;PASAKORIAI;6154158870;Taip;14;0;0;14
5971;Nykštukas;PASAKORIAI;9728270999;Taip;6;4;0;10
5972;Nykštukas;PASAKORIAI;45917705129;Taip;7;0;0;7
5973;Nykštukas;PASAKORIAI;5185856324;Taip;10;2;0;12
5974;Nykštukas;GUDRUČIAI;90969634936;Taip;6;0;0;6
5975;Nykštukas;GUDRUČIAI;1572666795;Taip;10;2;0;12
5976;Nykštukas;GUDRUČIAI;66071060125;Taip;11;0;0;11
5977;Nykštukas;GUDRUČIAI;23684742279;Taip;4;0;0;4
5978;Nykštukas;GUDRUČIAI;84800943947;Taip;0;1;0;1
5979;Nykštukas;GUDRUČIAI;30508998297;Taip;16;2;0;18
5980;Nykštukas;GUDRUČIAI;25097193002;Taip;0;1;0;1
5981;Nykštukas;GUDRUČIAI;1448977214;Taip;14;0;0;14
5982;Nykštukas;GUDRUČIAI;2109799405;Taip;0;2;0;2
5983;Nykštukas;GUDRUČIAI;83322635443;Taip;5;0;0;5
5984;Nykštukas;GUDRUČIAI;9041364129;Taip;0;4;0;4
5985;Nykštukas;GUDRUČIAI;48718365302;Taip;11;0;0;11
5986;Nykštukas;GUDRUČIAI;40386182073;Taip;10;0;0;10
5987;Nykštukas;GUDRUČIAI;54607001703;Taip;5;3;0;8
5988;Nykštukas;GUDRUČIAI;7356168681;Taip;0;0;6;6
5989;Nykštukas;GUDRUČIAI;27701482167;Taip;9;0;0;9
5990;Nykštukas;GUDRUČIAI;26154640888;Taip;20;0;0;20
5991;Nykštukas;GUDRUČIAI;92898851752;Taip;11;4;0;15
5992;Nykštukas;GUDRUČIAI;85663477778;Taip;0;2;0;2
5993;Nykštukas;GUDRUČIAI;52614843907;Taip;14;0;0;14
5994;Nykštukas;GUDRUČIAI;7325852578;Taip;10;0;0;10
5995;Nykštukas;GUDRUČIAI;1055246536;Taip;11;0;0;11
5996;Nykštukas;NAMINUKAI;99161787513;Taip;10;4;0;14
5997;Nykštukas;NAMINUKAI;69041011010;Taip;10;4;0;14
5998;Nykštukas;NAMINUKAI;1856534241;Taip;7;0;2;9
5999;Nykštukas;NAMINUKAI;34930388032;Ne;0;1;0;1
6000;Nykštukas;NAMINUKAI;1178437485;Taip;0;11;0;11
6001;Nykštukas;NAMINUKAI;1608057875;Taip;0;5;0;5
6002;Nykštukas;NAMINUKAI;1994080785;Taip;0;0;9;9
6003;Nykštukas;NAMINUKAI;37253009284;Taip;5;1;0;6
6004;Nykštukas;NAMINUKAI;1630706629;Ne;3;0;1;4
6005;Nykštukas;NAMINUKAI;1350373348;Taip;0;4;0;4
6006;Nykštukas;NAMINUKAI;27896604498;Taip;0;8;0;8
6007;Nykštukas;NAMINUKAI;7322548781;Taip;5;3;1;9
6008;Nykštukas;NAMINUKAI;7836485289;Taip;3;0;1;4
6009;Nykštukas;NAMINUKAI;1186114115;Taip;17;0;0;17
6010;Nykštukas;NAMINUKAI;30762220262;Taip;5;0;0;5
6011;Nykštukas;NAMINUKAI;9184265280;Taip;6;0;0;6
6012;Nykštukas;NAMINUKAI;1687759661;Taip;9;0;0;9
6013;Nykštukas;NAMINUKAI;30020977675;Ne;0;10;0;10
6014;Nykštukas;NAMINUKAI;86582838748;Taip;9;3;0;12
6015;Nykštukas;NAMINUKAI;49056338161;Taip;0;4;0;4
6016;Nykštukas;KŪLVERSTUKAI;4331906712;Taip;14;0;0;14
6017;Nykštukas;KŪLVERSTUKAI;8948554271;Taip;0;5;0;5
6018;Nykštukas;KŪLVERSTUKAI;6112448299;Taip;0;1;0;1
6019;Nykštukas;KŪLVERSTUKAI;2696384135;Taip;4;0;0;4
6020;Nykštukas;KŪLVERSTUKAI;4040123876;Taip;7;6;0;13
6021;Nykštukas;KŪLVERSTUKAI;1930357859;Taip;0;2;0;2
6022;Nykštukas;KŪLVERSTUKAI;2205400512;Taip;16;1;0;17
6023;Nykštukas;KŪLVERSTUKAI;9779645295;Taip;6;0;0;6
6024;Nykštukas;KŪLVERSTUKAI;4612171029;Taip;17;0;0;17
6025;Nykštukas;KŪLVERSTUKAI;3120577264;Taip;0;19;0;19
6026;Nykštukas;KŪLVERSTUKAI;6958596223;Taip;11;1;0;12
6027;Nykštukas;KŪLVERSTUKAI;3273579005;Taip;0;0;3;3
6028;Nykštukas;KŪLVERSTUKAI;5121027981;Taip;9;0;0;9
6029;Nykštukas;KŪLVERSTUKAI;3002966681;Taip;0;5;0;5
6030;Nykštukas;KŪLVERSTUKAI;3985610575;Taip;11;0;0;11
6031;Nykštukas;TREPSIUKAI;5190754451;Taip;0;2;0;2
6032;Nykštukas;TREPSIUKAI;8120626738;Taip;0;6;0;6
6033;Nykštukas;TREPSIUKAI;4795301170;Taip;5;6;0;11
6034;Nykštukas;TREPSIUKAI;4949895196;Taip;0;0;1;1
6035;Nykštukas;TREPSIUKAI;9713859038;Taip;20;0;0;20
6036;Nykštukas;TREPSIUKAI;4830484167;Taip;8;0;0;8
6037;Nykštukas;TREPSIUKAI;2661110617;Taip;16;0;0;16
6038;Nykštukas;TREPSIUKAI;1707956308;Taip;16;0;0;16
6039;Nykštukas;TREPSIUKAI;8310484267;Taip;3;0;0;3
6040;Nykštukas;TREPSIUKAI;9326131725;Taip;14;0;0;14
6041;Nykštukas;TREPSIUKAI;9842748132;Taip;14;0;0;14
6042;Nykštukas;TREPSIUKAI;4771072061;Taip;18;0;0;18
6043;Nykštukas;TREPSIUKAI;1902253981;Taip;16;1;0;17
6044;Nykštukas;TREPSIUKAI;6139988523;Taip;6;0;0;6
6045;Nykštukas;TREPSIUKAI;2826079911;Taip;9;0;0;9
6046;Nykštukas;TREPSIUKAI;8635571067;Taip;3;0;0;3
6047;Nykštukas;TREPSIUKAI;7954996421;Taip;9;7;0;16
6048;Ozas;Smalsučiai;9227939420;Taip;1;3;0;4
6049;Ozas;Smalsučiai;7917100888;Taip;7;1;0;8
6050;Ozas;Smalsučiai;87218067796;Taip;0;2;0;2
6051;Ozas;Smalsučiai;4397034031;Taip;0;5;0;5
6052;Ozas;Smalsučiai;1974320330;Taip;4;2;1;7
6053;Ozas;Smalsučiai;1173284700;Taip;3;0;2;5
6054;Ozas;Smalsučiai;67987032400;Taip;14;0;0;14
6055;Ozas;Smalsučiai;71695973592;Taip;0;2;0;2
6056;Ozas;Smalsučiai;57069047630;Taip;6;1;0;7
6057;Ozas;Smalsučiai;3326395879;Taip;10;0;0;10
6058;Ozas;Smalsučiai;5150746885;Taip;0;7;0;7
6059;Ozas;Smalsučiai;9595277597;Taip;0;3;0;3
6060;Ozas;Smalsučiai;1893257809;Taip;11;0;0;11
6061;Ozas;Smalsučiai;6540803077;Taip;10;0;0;10
6062;Ozas;Smalsučiai;8072802467;Taip;7;0;0;7
6063;Ozas;Smalsučiai;1248092034;Ne;0;4;0;4
6064;Ozas;Smalsučiai;43381497677;Taip;4;6;0;10
6065;Ozas;Smalsučiai;7351651916;Taip;6;0;0;6
6066;Ozas;Smalsučiai;3286170280;Taip;0;1;1;2
6067;Ozas;Smalsučiai;9521048381;Taip;16;4;0;20
6068;Ozas;Smalsučiai;2053832360;Taip;10;0;1;11
6069;Ozas;Drugeliai;1655808777;Taip;0;3;0;3
6070;Ozas;Drugeliai;7802699257;Taip;9;5;1;15
6071;Ozas;Drugeliai;8176840834;Taip;0;15;1;16
6072;Ozas;Drugeliai;6668470892;Taip;8;0;0;8
6073;Ozas;Drugeliai;2302999759;Taip;9;0;0;9
6074;Ozas;Drugeliai;8088330187;Taip;14;0;0;14
6075;Ozas;Drugeliai;9073973849;Taip;16;0;0;16
6076;Ozas;Drugeliai;9322806566;Taip;20;0;0;20
6077;Ozas;Drugeliai;2676747542;Taip;10;2;1;13
6078;Ozas;Drugeliai;2812687451;Taip;11;0;0;11
6079;Ozas;Drugeliai;8289643065;Taip;13;0;0;13
6080;Ozas;Drugeliai;9987863302;Taip;14;0;2;16
6081;Ozas;Drugeliai;5503766544;Taip;5;4;0;9
6082;Ozas;Drugeliai;2980799420;Taip;20;0;0;20
6083;Ozas;Drugeliai;4935698806;Taip;6;7;0;13
6084;Ozas;Drugeliai;1793692289;Taip;8;0;0;8
6085;Ozas;Drugeliai;8318380547;Taip;0;9;0;9
6086;Ozas;Drugeliai;4884054504;Taip;12;0;0;12
6087;Ozas;Drugeliai;2825614921;Taip;16;0;0;16
6088;Ozas;Drugeliai;43660054250;Taip;0;20;0;20
6089;Ozas;Boružėlės;1375643969;Ne;6;0;1;7
6090;Ozas;Boružėlės;63852147122;Taip;0;1;0;1
6091;Ozas;Boružėlės;8190314087;Taip;19;0;0;19
6092;Ozas;Boružėlės;3803998816;Taip;6;4;0;10
6093;Ozas;Boružėlės;1212358423;Taip;20;0;0;20
6094;Ozas;Boružėlės;7615907271;Taip;13;0;0;13
6095;Ozas;Boružėlės;1560342499;Taip;8;2;0;10
6096;Ozas;Boružėlės;8529654920;Taip;0;0;2;2
6097;Ozas;Boružėlės;60194872867;Taip;8;0;0;8
6098;Ozas;Boružėlės;2527574646;Taip;0;12;0;12
6099;Ozas;Boružėlės;9773251894;Taip;0;0;4;4
6100;Ozas;Boružėlės;36523514229;Taip;0;7;0;7
6101;Ozas;Boružėlės;1367050160;Taip;4;0;0;4
6102;Ozas;Boružėlės;68364031736;Taip;0;5;0;5
6103;Ozas;Boružėlės;2678629892;Taip;0;0;10;10
6104;Ozas;Boružėlės;1109113859;Ne;5;0;5;10
6105;Ozas;Boružėlės;1826499734;Taip;14;0;2;16
6106;Ozas;Boružėlės;6432357144;Taip;20;0;0;20
6107;Ozas;Boružėlės;1498656201;Taip;16;2;0;18
6108;Ozas;Boružėlės;8979747150;Taip;20;0;0;20
6109;Ozas;Boružėlės;1217496635;Taip;16;0;1;17
6110;Ozas;Boružėlės;1682529482;Taip;10;0;2;12
6111;Ozas;Žiogeliai;89211493110;Taip;4;9;0;13
6112;Ozas;Žiogeliai;51572539013;Ne;0;1;0;1
6113;Ozas;Žiogeliai;84527270114;Taip;0;1;1;2
6114;Ozas;Žiogeliai;52850058303;Taip;4;9;0;13
6115;Ozas;Žiogeliai;71334912565;Taip;0;10;0;10
6116;Ozas;Žiogeliai;58157410967;Taip;0;1;0;1
6117;Ozas;Žiogeliai;54246199303;Taip;0;6;0;6
6118;Ozas;Žiogeliai;34439403991;Taip;0;7;0;7
6119;Ozas;Žiogeliai;89415254787;Taip;0;5;0;5
6120;Ozas;Žiogeliai;4757239107;Taip;0;15;0;15
6121;Ozas;Žiogeliai;1763449085;Taip;5;9;0;14
6122;Ozas;Žiogeliai;79201129646;Taip;5;9;0;14
6123;Ozas;Žiogeliai;33802611373;Taip;6;8;0;14
6124;Ozas;Žiogeliai;26147218825;Taip;0;10;1;11
6125;Ozas;Žiogeliai;4396409015;Taip;0;7;0;7
6126;Ozas;Žiogeliai;16202534864;Ne;3;5;0;8
6127;Ozas;Žiogeliai;47247380242;Ne;0;10;0;10
6128;Ozas;Žiogeliai;49875201400;Taip;0;6;0;6
6129;Ozas;Žiogeliai;44852155196;Taip;0;4;4;8
6130;Ozas;Žiogeliai;15053930619;Taip;0;3;0;3
6131;Ozas;Žiogeliai;42846343820;Taip;0;9;0;9
6132;Ozas;Bitutės;72570693905;Taip;0;3;0;3
6133;Ozas;Bitutės;26114981770;Taip;0;8;1;9
6134;Ozas;Bitutės;49220695182;Taip;9;5;0;14
6135;Ozas;Bitutės;97985936709;Taip;9;1;0;10
6136;Ozas;Bitutės;96089833744;Taip;7;0;0;7
6137;Ozas;Bitutės;91462990629;Taip;0;2;0;2
6138;Ozas;Bitutės;99554644089;Taip;0;10;0;10
6139;Ozas;Bitutės;25241271456;Taip;2;6;6;14
6140;Ozas;Bitutės;21436609394;Ne;0;7;0;7
6141;Ozas;Bitutės;1806690419;Taip;0;4;0;4
6142;Ozas;Bitutės;20806414515;Taip;0;4;1;5
6143;Ozas;Bitutės;73127608271;Taip;3;8;0;11
6144;Ozas;Bitutės;14182351781;Taip;0;7;1;8
6145;Ozas;Bitutės;89886182151;Taip;8;4;0;12
6146;Ozas;Bitutės;55341521797;Taip;0;4;1;5
6147;Ozas;Bitutės;1352632856;Taip;0;11;0;11
6148;Ozas;Bitutės;11088024064;Taip;0;6;0;6
6149;Ozas;Bitutės;37636521897;Taip;6;2;0;8
6150;Ozas;Bitutės;9120194842;Taip;0;7;1;8
6151;Ozas;Bitutės;2110892014;Taip;10;9;0;19
6152;Ozas;Bitutės;39931003216;Taip;6;3;0;9
6153;Ozas;Aitvarėliai;1653285671;Taip;17;1;0;18
6154;Ozas;Aitvarėliai;65979490151;Taip;0;0;2;2
6155;Ozas;Aitvarėliai;36897118363;Taip;0;1;0;1
6156;Ozas;Aitvarėliai;25660709486;Taip;20;0;0;20
6157;Ozas;Aitvarėliai;87500216376;Taip;5;2;0;7
6158;Ozas;Aitvarėliai;62542133064;Taip;0;4;0;4
6159;Ozas;Aitvarėliai;77935174855;Taip;6;0;0;6
6160;Ozas;Aitvarėliai;74709964983;Taip;0;2;0;2
6161;Ozas;Aitvarėliai;31810796132;Taip;0;2;0;2
6162;Ozas;Aitvarėliai;49556201469;Taip;0;9;0;9
6163;Ozas;Aitvarėliai;3222282556;Taip;1;0;4;5
6164;Ozas;Aitvarėliai;46679332069;Taip;0;6;0;6
6165;Ozas;Aitvarėliai;1556404162;Taip;3;5;3;11
6166;Ozas;Aitvarėliai;20944134865;Taip;4;6;0;10
6167;Ozas;Aitvarėliai;2087307495;Taip;0;4;1;5
6168;Ozas;Aitvarėliai;99211100553;Taip;13;0;0;13
6169;Ozas;Aitvarėliai;56927777775;Taip;5;8;2;15
6170;Ozas;Aitvarėliai;84378491220;Taip;0;6;1;7
6171;Ozas;Aitvarėliai;71286685759;Taip;0;9;0;9
6172;Ozas;Aitvarėliai;1182573257;Taip;9;2;0;11
6173;Ozas;Voveraitės;89115682092;Taip;3;4;0;7
6174;Ozas;Voveraitės;97875471586;Taip;1;5;1;7
6175;Ozas;Voveraitės;42030629149;Taip;0;7;4;11
6176;Ozas;Voveraitės;8817179462;Taip;9;0;0;9
6177;Ozas;Voveraitės;87683044622;Taip;20;0;0;20
6178;Ozas;Voveraitės;88443183082;Taip;16;0;0;16
6179;Ozas;Voveraitės;94576453630;Taip;13;0;0;13
6180;Ozas;Voveraitės;26834809068;Taip;0;3;0;3
6181;Ozas;Voveraitės;88508505247;Taip;14;1;0;15
6182;Ozas;Voveraitės;47574756201;Taip;0;5;0;5
6183;Ozas;Voveraitės;24088059514;Taip;20;0;0;20
6184;Ozas;Voveraitės;29411948493;Taip;0;5;2;7
6185;Ozas;Voveraitės;27655773887;Taip;1;5;0;6
6186;Ozas;Voveraitės;62608717700;Taip;11;0;0;11
6187;Ozas;Voveraitės;88837027397;Taip;11;0;0;11
6188;Ozas;Voveraitės;46431348128;Taip;0;2;2;4
6189;Ozas;Voveraitės;66463185196;Taip;3;5;0;8
6190;Ozas;Voveraitės;93882562685;Taip;5;4;0;9
6191;Ozas;Voveraitės;37505558259;Taip;0;1;0;1
6192;Ozas;Voveraitės;90020306864;Taip;0;1;0;1
6193;Ozas;Voveraitės;34723844399;Taip;0;6;2;8
6194;Ozas;Voveraitės;16101439010;Taip;0;0;8;8
6195;Ozas;Voveraitės;5637273299;Taip;14;0;1;15
6196;Ozas;Voveraitės;1637437696;Taip;14;0;1;15
6197;Ozas;Kodelčiukai;2808066733;Taip;18;1;0;19
6198;Ozas;Kodelčiukai;71351371644;Taip;7;0;0;7
6199;Ozas;Kodelčiukai;13077342836;Taip;14;1;0;15
6200;Ozas;Kodelčiukai;1746778441;Taip;11;0;0;11
6201;Ozas;Kodelčiukai;1110232715;Taip;10;6;0;16
6202;Ozas;Kodelčiukai;28273919775;Taip;14;0;0;14
6203;Ozas;Kodelčiukai;88618151766;Taip;0;11;0;11
6204;Ozas;Kodelčiukai;3637786952;Taip;5;5;0;10
6205;Ozas;Kodelčiukai;39003781970;Taip;18;0;0;18
6206;Ozas;Kodelčiukai;1243205832;Taip;15;0;0;15
6207;Ozas;Kodelčiukai;1235925750;Taip;6;5;0;11
6208;Ozas;Kodelčiukai;69756875821;Taip;3;5;0;8
6209;Ozas;Kodelčiukai;19065860134;Taip;3;5;0;8
6210;Ozas;Kodelčiukai;91774614891;Taip;11;0;0;11
6211;Ozas;Kodelčiukai;19284606277;Taip;7;2;0;9
6212;Ozas;Kodelčiukai;1230455881;Taip;20;0;0;20
6213;Ozas;Kodelčiukai;9664748034;Taip;8;0;0;8
6214;Ozas;Kodelčiukai;1684454071;Taip;17;0;0;17
6215;Ozas;Kodelčiukai;1008366446;Taip;20;0;0;20
6216;Ozas;Kodelčiukai;1995302672;Taip;0;4;0;4
6217;Ozas;Kodelčiukai;1288477637;Taip;7;0;0;7
6218;Ozas;Kodelčiukai;82373453244;Taip;9;2;0;11
6219;Ozas;Kodelčiukai;94673981368;Taip;11;0;0;11
6220;Ozas;Pelėdžiukai;1462541264;Taip;13;1;0;14
6221;Ozas;Pelėdžiukai;3439351594;Taip;0;16;0;16
6222;Ozas;Pelėdžiukai;60743195418;Taip;14;0;0;14
6223;Ozas;Pelėdžiukai;64778552590;Taip;0;4;1;5
6224;Ozas;Pelėdžiukai;1755283948;Taip;13;0;0;13
6225;Ozas;Pelėdžiukai;35346948351;Taip;5;0;0;5
6226;Ozas;Pelėdžiukai;13375413701;Taip;0;5;0;5
6227;Ozas;Pelėdžiukai;16523707810;Taip;0;3;1;4
6228;Ozas;Pelėdžiukai;47291376629;Taip;5;9;0;14
6229;Ozas;Pelėdžiukai;34330362446;Taip;20;0;0;20
6230;Ozas;Pelėdžiukai;2140385280;Taip;11;0;0;11
6231;Ozas;Pelėdžiukai;1450257399;Taip;16;0;0;16
6232;Ozas;Pelėdžiukai;88159158596;Taip;4;0;1;5
6233;Ozas;Pelėdžiukai;56346624523;Taip;0;4;1;5
6234;Ozas;Pelėdžiukai;4765249675;Taip;5;0;0;5
6235;Ozas;Pelėdžiukai;1814400303;Taip;19;0;0;19
6236;Ozas;Pelėdžiukai;1889249743;Taip;0;3;1;4
6237;Ozas;Pelėdžiukai;1099026003;Taip;19;0;0;19
6238;Ozas;Pelėdžiukai;15885510365;Taip;6;0;1;7
6239;Ozas;Pelėdžiukai;2058548464;Taip;10;0;0;10
6240;Ozas;Pelėdžiukai;4590847831;Taip;0;0;4;4
6241;Ozas;Pelėdžiukai;1910114048;Taip;0;0;7;7
6242;Ozas;"Kačiukai ";75077443996;Taip;0;6;0;6
6243;Ozas;"Kačiukai ";95179927759;Taip;20;0;0;20
6244;Ozas;"Kačiukai ";4075968205;Taip;0;0;20;20
6245;Ozas;"Kačiukai ";6618249243;Taip;7;4;1;12
6246;Ozas;"Kačiukai ";1151213934;Taip;10;0;0;10
6247;Ozas;"Kačiukai ";2114612776;Taip;8;0;1;9
6248;Ozas;"Kačiukai ";60155732637;Taip;0;7;0;7
6249;Ozas;"Kačiukai ";37159754070;Taip;0;9;9;18
6250;Ozas;"Kačiukai ";61398533877;Taip;10;0;1;11
6251;Ozas;"Kačiukai ";1580501935;Taip;11;0;0;11
6252;Ozas;"Kačiukai ";1210902341;Taip;14;0;0;14
6253;Ozas;"Kačiukai ";1848619053;Taip;0;0;12;12
6254;Ozas;"Kačiukai ";1316758924;Taip;0;0;13;13
6255;Ozas;"Kačiukai ";2018398634;Taip;7;3;5;15
6256;Ozas;"Kačiukai ";84277015523;Taip;10;0;1;11
6257;Ozas;"Kačiukai ";1822377180;Taip;8;0;6;14
6258;Ozas;"Kačiukai ";1551028882;Taip;12;0;0;12
6259;Ozas;"Kačiukai ";14760258125;Taip;16;0;0;16
6260;Ozas;"Kačiukai ";4400619617;Taip;0;0;5;5
6261;Ozas;"Kačiukai ";9345447142;Taip;11;0;4;15
6262;Ozas;"Kačiukai ";1681367373;Taip;0;14;0;14
6263;Ozas;"Kačiukai ";8248732706;Taip;12;0;2;14
6264;Ozas;Ančiukų;9392526836;Taip;1;0;0;1
6265;Ozas;Ančiukų;3631049449;Taip;6;0;0;6
6266;Ozas;Ančiukų;3255382007;Taip;5;10;0;15
6267;Ozas;Ančiukų;1837947633;Taip;14;0;0;14
6268;Ozas;Ančiukų;5850824864;Taip;8;6;0;14
6269;Ozas;Ančiukų;4966355020;Taip;11;0;0;11
6270;Ozas;Ančiukų;1562277866;Taip;20;0;0;20
6271;Ozas;Ančiukų;2991511872;Taip;16;0;1;17
6272;Ozas;Ančiukų;6257625501;Taip;20;0;0;20
6273;Ozas;Ančiukų;7402290524;Taip;14;1;0;15
6274;Ozas;Ančiukų;4571583671;Taip;6;5;1;12
6275;Ozas;Ančiukų;5682027094;Taip;20;0;0;20
6276;Ozas;Ančiukų;6053885086;Taip;20;0;0;20
6277;Ozas;Ančiukų;6950802941;Taip;20;0;0;20
6278;Ozas;Ančiukų;3770045761;Taip;0;1;3;4
6279;Ozas;Ančiukų;6499549095;Taip;5;3;3;11
6280;Ozas;Ančiukų;9324647606;Taip;14;2;0;16
6281;Ozas;Ančiukų;7978092840;Taip;16;0;0;16
6282;Ozas;Nykškukų;3329391600;Taip;6;4;0;10
6283;Ozas;Nykškukų;2352118061;Taip;11;0;0;11
6284;Ozas;Nykškukų;7499756171;Taip;2;13;0;15
6285;Ozas;Nykškukų;7018190169;Taip;8;1;0;9
6286;Ozas;Nykškukų;4254601638;Taip;5;0;0;5
6287;Ozas;Nykškukų;2705294874;Taip;4;0;0;4
6288;Ozas;Nykškukų;4227555342;Taip;16;0;0;16
6289;Ozas;Nykškukų;4220780257;Taip;14;1;0;15
6290;Ozas;Nykškukų;2773182934;Taip;5;0;5;10
6291;Ozas;Nykškukų;5102704846;Taip;4;5;0;9
6292;Ozas;Nykškukų;5642468671;Taip;17;0;0;17
6293;Ozas;Nykškukų;7494307084;Taip;10;0;0;10
6294;Ozas;Nykškukų;1475005204;Taip;6;0;0;6
6295;Ozas;Nykškukų;4583818638;Taip;5;0;0;5
6296;Ozas;Nykškukų;2369544599;Taip;0;3;0;3
6297;Ozas;Nykškukų;4207160323;Taip;3;1;0;4
6298;Ozas;Nykškukų;8416839037;Taip;0;7;0;7
6299;Ozas;Nykškukų;4699369567;Taip;7;2;0;9
6300;Ozas;Nykškukų;1161776624;Taip;11;1;0;12
6301;Pabiručiai;Voveriukų;82866592801;Taip;14;1;0;15
6302;Pabiručiai;Voveriukų;59605903606;Taip;0;6;0;6
6303;Pabiručiai;Voveriukų;36884058806;Taip;0;3;0;3
6304;Pabiručiai;Voveriukų;1798480819;Taip;12;3;0;15
6305;Pabiručiai;Voveriukų;57797244989;Taip;0;6;0;6
6306;Pabiručiai;Voveriukų;48017416657;Taip;0;5;4;9
6307;Pabiručiai;Voveriukų;36265846400;Taip;9;3;0;12
6308;Pabiručiai;Voveriukų;95846629190;Taip;0;12;0;12
6309;Pabiručiai;Voveriukų;5059523668;Taip;0;7;0;7
6310;Pabiručiai;Voveriukų;92007951082;Taip;0;3;0;3
6311;Pabiručiai;Voveriukų;55956922916;Taip;0;8;0;8
6312;Pabiručiai;Voveriukų;7487052362;Taip;0;4;0;4
6313;Pabiručiai;Voveriukų;81393745800;Ne;0;5;0;5
6314;Pabiručiai;Voveriukų;9492402983;Taip;0;2;0;2
6315;Pabiručiai;Voveriukų;44352248446;Ne;0;3;0;3
6316;Pabiručiai;Voveriukų;6160308400;Taip;0;6;0;6
6317;Pabiručiai;Boružiukų;1303589700;Taip;0;5;0;5
6318;Pabiručiai;Boružiukų;22866929836;Taip;0;5;0;5
6319;Pabiručiai;Boružiukų;47314536610;Taip;9;3;0;12
6320;Pabiručiai;Boružiukų;39499870735;Taip;0;7;0;7
6321;Pabiručiai;Boružiukų;82164704789;Taip;0;4;0;4
6322;Pabiručiai;Boružiukų;32325675784;Taip;0;3;0;3
6323;Pabiručiai;Boružiukų;93509618214;Taip;0;8;0;8
6324;Pabiručiai;Boružiukų;57792326027;Taip;0;5;0;5
6325;Pabiručiai;Boružiukų;91293202710;Taip;0;6;0;6
6326;Pabiručiai;Boružiukų;27052463521;Taip;0;6;0;6
6327;Pabiručiai;Boružiukų;59616111036;Taip;13;0;0;13
6328;Pabiručiai;Boružiukų;2284041402;Taip;11;0;0;11
6329;Pabiručiai;Boružiukų;67295377190;Taip;0;10;0;10
6330;Pabiručiai;Boružiukų;61547104192;Taip;0;3;0;3
6331;Pabiručiai;Boružiukų;97165250663;Taip;0;5;0;5
6332;Pabiručiai;Boružiukų;38492844225;Taip;0;8;0;8
6333;Pabiručiai;Boružiukų;3959937657;Taip;3;1;0;4
6334;Pabiručiai;Boružiukų;51516019654;Taip;10;0;0;10
6335;Pabiručiai;Boružiukų;37884558736;Taip;0;6;0;6
6336;Pabiručiai;Boružiukų;74823092402;Ne;0;12;0;12
6337;Pabiručiai;Boružiukų;32339177392;Taip;0;9;0;9
6338;Pabiručiai;Katinėlių;1670938208;Taip;0;0;2;2
6339;Pabiručiai;Katinėlių;1224986101;Taip;0;0;17;17
6340;Pabiručiai;Katinėlių;3756365293;Taip;5;0;0;5
6341;Pabiručiai;Katinėlių;6283372742;Taip;8;0;0;8
6342;Pabiručiai;Katinėlių;1749155319;Ne;4;6;1;11
6343;Pabiručiai;Katinėlių;34883375155;Taip;5;10;0;15
6344;Pabiručiai;Katinėlių;58112415466;Taip;15;4;0;19
6345;Pabiručiai;Katinėlių;42877891797;Taip;0;1;0;1
6346;Pabiručiai;Katinėlių;6285940478;Taip;15;3;0;18
6347;Pabiručiai;Katinėlių;8284711578;Taip;5;0;6;11
6348;Pabiručiai;Katinėlių;8710389714;Taip;5;5;0;10
6349;Pabiručiai;Katinėlių;4501176225;Taip;0;10;0;10
6350;Pabiručiai;Katinėlių;8503177793;Taip;10;0;1;11
6351;Pabiručiai;Katinėlių;95695057362;Taip;19;0;0;19
6352;Pabiručiai;Katinėlių;4339607826;Taip;0;17;0;17
6353;Pabiručiai;Katinėlių;2572570925;Taip;10;0;1;11
6354;Pabiručiai;Katinėlių;6994301415;Taip;14;0;0;14
6355;Pabiručiai;Katinėlių;4205107384;Taip;9;0;0;9
6356;Pabiručiai;Žiogelių;3272576627;Taip;11;0;0;11
6357;Pabiručiai;Žiogelių;5522447437;Taip;6;0;0;6
6358;Pabiručiai;Žiogelių;7974345478;Taip;8;2;0;10
6359;Pabiručiai;Žiogelių;8367889753;Taip;0;11;0;11
6360;Pabiručiai;Žiogelių;8421025940;Taip;3;0;0;3
6361;Pabiručiai;Žiogelių;3028063887;Taip;0;7;0;7
6362;Pabiručiai;Žiogelių;1642658060;Taip;14;2;0;16
6363;Pabiručiai;Žiogelių;3206962828;Taip;0;0;1;1
6364;Pabiručiai;Žiogelių;3355875364;Taip;6;3;0;9
6365;Pabiručiai;Žiogelių;7085036701;Taip;0;10;0;10
6366;Pabiručiai;Žiogelių;8736658575;Taip;16;0;0;16
6367;Pabiručiai;Žiogelių;1311650644;Taip;10;0;0;10
6368;Pabiručiai;Žiogelių;5480714322;Taip;9;0;0;9
6369;Pabiručiai;Žiogelių;3585198013;Taip;0;12;0;12
6370;Pabiručiai;Žiogelių;2356833740;Taip;5;0;2;7
6371;Pabiručiai;Žiogelių;5311762824;Taip;5;7;0;12
6372;Pabiručiai;Žiogelių;1587905929;Taip;16;0;0;16
6373;Pabiručiai;Žiogelių;5761888906;Taip;0;1;0;1
6374;Pabiručiai;Žiogelių;4667769378;Taip;0;13;0;13
6375;Pabiručiai;Smalsiukai;77665506359;Taip;0;4;0;4
6376;Pabiručiai;Smalsiukai;33576823599;Taip;0;8;0;8
6377;Pabiručiai;Smalsiukai;25404048436;Taip;0;1;0;1
6378;Pabiručiai;Smalsiukai;99245902550;Ne;0;4;0;4
6379;Pabiručiai;Smalsiukai;72030186300;Taip;0;7;0;7
6380;Pabiručiai;Smalsiukai;1461544209;Taip;5;0;0;5
6381;Pabiručiai;Smalsiukai;1749795353;Taip;10;5;0;15
6382;Pabiručiai;Smalsiukai;83758151778;Ne;0;4;0;4
6383;Pabiručiai;Smalsiukai;46891762701;Taip;6;5;0;11
6384;Pabiručiai;Smalsiukai;88469372129;Taip;5;1;0;6
6385;Pabiručiai;Smalsiukai;1052844376;Taip;5;0;0;5
6386;Pabiručiai;Smalsiukai;55812858767;Taip;0;5;0;5
6387;Pabiručiai;Smalsiukai;97516241743;Taip;0;0;2;2
6388;Pabiručiai;Smalsiukai;37299891873;Taip;13;0;0;13
6389;Pabiručiai;Smalsiukai;99612002248;Taip;0;2;1;3
6390;Pabiručiai;Smalsiukai;67029008630;Taip;5;8;0;13
6391;Pabiručiai;Smalsiukai;84458450123;Taip;0;2;0;2
6392;Pabiručiai;Kiškučiai;23334247840;Taip;0;10;0;10
6393;Pabiručiai;Kiškučiai;78055744911;Taip;7;1;0;8
6394;Pabiručiai;Kiškučiai;9756328087;Ne;0;14;0;14
6395;Pabiručiai;Kiškučiai;16153916925;Taip;0;7;0;7
6396;Pabiručiai;Kiškučiai;69948274186;Taip;0;1;0;1
6397;Pabiručiai;Kiškučiai;62817645726;Taip;0;8;0;8
6398;Pabiručiai;Kiškučiai;2117594123;Taip;0;7;0;7
6399;Pabiručiai;Kiškučiai;25986912111;Taip;0;3;0;3
6400;Pabiručiai;Kiškučiai;99405892035;Taip;0;10;0;10
6401;Pabiručiai;Kiškučiai;31043795418;Taip;0;7;0;7
6402;Pabiručiai;Kiškučiai;1189209435;Taip;7;2;0;9
6403;Pabiručiai;Kiškučiai;58410416452;Taip;19;0;0;19
6404;Pabiručiai;Kiškučiai;1457799587;Taip;0;8;0;8
6405;Pabiručiai;Kiškučiai;93595653770;Taip;10;1;0;11
6406;Pabiručiai;Kiškučiai;72090235276;Taip;12;2;0;14
6407;Pabiručiai;Kiškučiai;4463663862;Taip;6;2;0;8
6408;Pabiručiai;Kiškučiai;1780827082;Taip;0;5;0;5
6409;Pabiručiai;Kiškučiai;3767061583;Taip;0;12;0;12
6410;Pabiručiai;Kiškučiai;37991862437;Taip;4;10;0;14
6411;Pabiručiai;Kiškučiai;5327687404;Taip;20;0;0;20
6412;Pabiručiai;"Pėledžiukai ";7457099536;Taip;17;0;0;17
6413;Pabiručiai;"Pėledžiukai ";77273870334;Taip;11;0;0;11
6414;Pabiručiai;"Pėledžiukai ";80756439543;Taip;3;0;0;3
6415;Pabiručiai;"Pėledžiukai ";75098378597;Taip;0;6;0;6
6416;Pabiručiai;"Pėledžiukai ";40295012430;Taip;1;1;0;2
6417;Pabiručiai;"Pėledžiukai ";90849312010;Taip;19;0;0;19
6418;Pabiručiai;"Pėledžiukai ";6112244077;Taip;2;1;0;3
6419;Pabiručiai;"Pėledžiukai ";18356992277;Taip;0;12;0;12
6420;Pabiručiai;"Pėledžiukai ";55197056543;Taip;5;0;0;5
6421;Pabiručiai;"Pėledžiukai ";42627202407;Taip;0;4;0;4
6422;Pabiručiai;"Pėledžiukai ";28121667845;Taip;3;2;0;5
6423;Pabiručiai;"Pėledžiukai ";1474411801;Taip;1;1;0;2
6424;Pabiručiai;"Pėledžiukai ";1591342751;Taip;0;11;0;11
6425;Pabiručiai;"Pėledžiukai ";1701727758;Taip;3;0;0;3
6426;Pabiručiai;"Pėledžiukai ";1078387167;Taip;2;3;0;5
6427;Pabiručiai;"Pėledžiukai ";3733576400;Taip;6;6;0;12
6428;Pabiručiai;"Pėledžiukai ";4568554097;Taip;0;2;0;2
6429;Pabiručiai;"Pėledžiukai ";34215100257;Taip;3;4;0;7
6430;Pabiručiai;"Pėledžiukai ";26940925728;Taip;2;5;0;7
6431;Pabiručiai;"Pėledžiukai ";2944433375;Taip;9;5;0;14
6432;Pabiručiai;"Kodelčiūkai ";1819457592;Taip;0;3;0;3
6433;Pabiručiai;"Kodelčiūkai ";38142737487;Taip;0;6;0;6
6434;Pabiručiai;"Kodelčiūkai ";1177208864;Taip;4;0;5;9
6435;Pabiručiai;"Kodelčiūkai ";62923769489;Taip;10;7;0;17
6436;Pabiručiai;"Kodelčiūkai ";65267728282;Taip;6;0;0;6
6437;Pabiručiai;"Kodelčiūkai ";81307674221;Taip;6;0;0;6
6438;Pabiručiai;"Kodelčiūkai ";15948930587;Taip;5;2;0;7
6439;Pabiručiai;"Kodelčiūkai ";6696186733;Taip;9;0;0;9
6440;Pabiručiai;"Kodelčiūkai ";78798062773;Taip;3;6;0;9
6441;Pabiručiai;"Kodelčiūkai ";66085180057;Ne;0;8;0;8
6442;Pabiručiai;"Kodelčiūkai ";7468072633;Ne;7;3;0;10
6443;Pabiručiai;"Kodelčiūkai ";1901455947;Taip;0;0;2;2
6444;Pabiručiai;"Kodelčiūkai ";1718014001;Taip;1;9;0;10
6445;Pabiručiai;"Kodelčiūkai ";2143676810;Taip;6;1;0;7
6446;Pabiručiai;"Kodelčiūkai ";1029743585;Taip;5;4;0;9
6447;Pabiručiai;"Kodelčiūkai ";1236499374;Taip;0;13;0;13
6448;Pabiručiai;"Kodelčiūkai ";8344476830;Taip;0;6;0;6
6449;Pabiručiai;"Peliukų ";4301904533;Taip;5;3;0;8
6450;Pabiručiai;"Peliukų ";3096466200;Taip;8;0;0;8
6451;Pabiručiai;"Peliukų ";7524993271;Taip;0;0;1;1
6452;Pabiručiai;"Peliukų ";5708597471;Taip;5;2;0;7
6453;Pabiručiai;"Peliukų ";8106446562;Taip;5;6;0;11
6454;Pabiručiai;"Peliukų ";7046122545;Taip;5;0;1;6
6455;Pabiručiai;"Peliukų ";1673473814;Taip;0;2;0;2
6456;Pabiručiai;"Peliukų ";6401188653;Taip;9;0;0;9
6457;Pabiručiai;"Peliukų ";5686769648;Taip;0;11;0;11
6458;Pabiručiai;"Peliukų ";8175565139;Taip;1;0;0;1
6459;Pabiručiai;"Peliukų ";7737045952;Taip;20;0;0;20
6460;Pabiručiai;"Peliukų ";4006783343;Taip;0;1;0;1
6461;Pabiručiai;"Peliukų ";7073230645;Taip;0;0;2;2
6462;Pabiručiai;"Peliukų ";1344711015;Taip;16;0;0;16
6463;Pabiručiai;"Viščiukų ";2349337471;Taip;5;0;0;5
6464;Pabiručiai;"Viščiukų ";9468698553;Taip;10;0;0;10
6465;Pabiručiai;"Viščiukų ";4040533883;Taip;18;0;0;18
6466;Pabiručiai;"Viščiukų ";9356327400;Taip;9;0;0;9
6467;Pabiručiai;"Viščiukų ";8236964683;Taip;7;3;0;10
6468;Pabiručiai;"Viščiukų ";7066037017;Taip;5;1;0;6
6469;Pabiručiai;"Viščiukų ";7090116276;Taip;12;2;3;17
6470;Pabiručiai;"Viščiukų ";4069564285;Taip;5;9;0;14
6471;Pabiručiai;"Viščiukų ";5232678556;Taip;3;0;0;3
6472;Pabiručiai;"Viščiukų ";2514312233;Taip;0;11;0;11
6473;Pabiručiai;"Viščiukų ";7606274875;Taip;0;11;0;11
6474;Pabiručiai;"Viščiukų ";8897462614;Taip;0;6;0;6
6475;Pabiručiai;"Viščiukų ";7278334800;Taip;16;0;0;16
6476;Pabiručiai;"Viščiukų ";7846758352;Taip;0;0;4;4
6477;Pabiručiai;"Viščiukų ";1663953648;Taip;0;9;0;9
6478;Pabiručiai;"Drugelių ";6251432968;Taip;5;0;0;5
6479;Pabiručiai;"Drugelių ";1671027282;Taip;18;1;0;19
6480;Pabiručiai;"Drugelių ";3151360288;Taip;0;1;0;1
6481;Pabiručiai;"Drugelių ";1028312285;Taip;4;0;0;4
6482;Pabiručiai;"Drugelių ";2446697763;Taip;9;0;0;9
6483;Pabiručiai;"Drugelių ";1498738549;Taip;7;0;0;7
6484;Pabiručiai;"Drugelių ";4312364951;Taip;14;0;0;14
6485;Pabiručiai;"Drugelių ";4462744848;Taip;9;8;0;17
6486;Pabiručiai;"Drugelių ";1240057541;Taip;0;13;0;13
6487;Pabiručiai;"Drugelių ";3759350345;Taip;14;1;0;15
6488;Pabiručiai;"Drugelių ";1582754284;Taip;5;0;2;7
6489;Pabiručiai;"Drugelių ";4813206044;Taip;9;4;0;13
6490;Pabiručiai;"Drugelių ";7572077461;Taip;17;0;0;17
6491;Pagrandukas;Saulytės;56985738094;Taip;0;8;0;8
6492;Pagrandukas;Saulytės;73747309137;Taip;0;1;0;1
6493;Pagrandukas;Saulytės;81225644879;Taip;0;3;0;3
6494;Pagrandukas;Saulytės;90141915028;Taip;0;15;0;15
6495;Pagrandukas;Saulytės;73094500140;Taip;0;2;0;2
6496;Pagrandukas;Saulytės;25042144265;Taip;12;1;0;13
6497;Pagrandukas;Saulytės;92496791690;Taip;0;8;0;8
6498;Pagrandukas;Saulytės;8490035231;Taip;0;15;0;15
6499;Pagrandukas;Saulytės;17860708643;Taip;0;1;0;1
6500;Pagrandukas;Saulytės;10275994267;Taip;0;6;0;6
6501;Pagrandukas;Saulytės;53442283517;Taip;11;0;0;11
6502;Pagrandukas;Saulytės;85893187794;Taip;0;6;0;6
6503;Pagrandukas;Saulytės;1735088719;Taip;9;6;0;15
6504;Pagrandukas;Saulytės;2240690677;Taip;11;2;0;13
6505;Pagrandukas;Saulytės;23836053268;Taip;0;19;0;19
6506;Pagrandukas;Saulytės;82076379343;Taip;0;9;0;9
6507;Pagrandukas;Saulytės;90244057040;Taip;0;20;0;20
6508;Pagrandukas;Saulytės;5179694773;Taip;0;5;0;5
6509;Pagrandukas;Saulytės;1432860651;Taip;6;4;0;10
6510;Pagrandukas;Saulytės;4550081974;Taip;0;12;0;12
6511;Pagrandukas;Zuikučiai;13992515800;Taip;6;0;0;6
6512;Pagrandukas;Zuikučiai;27121246153;Taip;6;0;0;6
6513;Pagrandukas;Zuikučiai;61698205530;Taip;6;0;0;6
6514;Pagrandukas;Zuikučiai;65443026043;Taip;11;5;0;16
6515;Pagrandukas;Zuikučiai;45339513408;Taip;2;1;0;3
6516;Pagrandukas;Zuikučiai;52079380668;Taip;0;4;0;4
6517;Pagrandukas;Zuikučiai;8268544829;Taip;0;5;0;5
6518;Pagrandukas;Zuikučiai;37941723547;Taip;0;2;0;2
6519;Pagrandukas;Zuikučiai;58398098970;Taip;5;0;0;5
6520;Pagrandukas;Zuikučiai;44541642222;Taip;1;2;0;3
6521;Pagrandukas;Zuikučiai;68051228918;Taip;5;0;0;5
6522;Pagrandukas;Zuikučiai;641267897;Taip;10;5;0;15
6523;Pagrandukas;Zuikučiai;99150983585;Taip;0;14;0;14
6524;Pagrandukas;Zuikučiai;43720624711;Taip;4;10;0;14
6525;Pagrandukas;Zuikučiai;1350949224;Taip;0;1;0;1
6526;Pagrandukas;Zuikučiai;49574848652;Taip;0;4;0;4
6527;Pagrandukas;Zuikučiai;18049426774;Taip;2;4;0;6
6528;Pagrandukas;Boružėlių;3888408459;Taip;7;1;1;9
6529;Pagrandukas;Boružėlių;3398225200;Taip;0;6;0;6
6530;Pagrandukas;Boružėlių;5752454925;Taip;0;0;13;13
6531;Pagrandukas;Boružėlių;3587941684;Taip;9;0;0;9
6532;Pagrandukas;Boružėlių;5946007985;Taip;5;4;3;12
6533;Pagrandukas;Boružėlių;7770852445;Taip;0;4;6;10
6534;Pagrandukas;Boružėlių;6304701617;Taip;8;1;0;9
6535;Pagrandukas;Boružėlių;3953844737;Taip;0;4;0;4
6536;Pagrandukas;Boružėlių;7271589727;Taip;6;3;0;9
6537;Pagrandukas;Boružėlių;7064391685;Taip;6;0;0;6
6538;Pagrandukas;Boružėlių;5640182548;Taip;6;2;0;8
6539;Pagrandukas;Boružėlių;1403569615;Taip;7;0;0;7
6540;Pagrandukas;Boružėlių;1998073387;Taip;0;1;1;2
6541;Pagrandukas;Boružėlių;5511396314;Taip;11;5;0;16
6542;Pagrandukas;Bitutės;95949044544;Taip;0;4;1;5
6543;Pagrandukas;Bitutės;22146063631;Taip;0;14;0;14
6544;Pagrandukas;Bitutės;1844631218;Taip;0;5;14;19
6545;Pagrandukas;Bitutės;1479570204;Taip;0;1;7;8
6546;Pagrandukas;Bitutės;1505620688;Taip;0;3;8;11
6547;Pagrandukas;Bitutės;1654566158;Taip;4;2;0;6
6548;Pagrandukas;Bitutės;41904915714;Taip;4;0;0;4
6549;Pagrandukas;Bitutės;44029972943;Taip;11;0;0;11
6550;Pagrandukas;Bitutės;47836927832;Taip;0;1;0;1
6551;Pagrandukas;Bitutės;1707429884;Taip;0;2;2;4
6552;Pagrandukas;Bitutės;91591094393;Taip;0;4;3;7
6553;Pagrandukas;Bitutės;6585880191;Taip;3;1;0;4
6554;Pagrandukas;Bitutės;8891887553;Taip;0;0;4;4
6555;Pagrandukas;Bitutės;1503479321;Taip;0;4;6;10
6556;Pagrandukas;Bitutės;9313380552;Taip;0;4;3;7
6557;Pagrandukas;Bitutės;51982253355;Taip;10;8;0;18
6558;Pagrandukas;Bitutės;6044667668;Taip;5;0;2;7
6559;Pagrandukas;Bitutės;3227066520;Taip;0;4;8;12
6560;Pagrandukas;Bitutės;1813676320;Taip;0;0;7;7
6561;Pagrandukas;Pelėdžiukai;82163714693;Taip;0;4;0;4
6562;Pagrandukas;Pelėdžiukai;1590309916;Taip;6;2;0;8
6563;Pagrandukas;Pelėdžiukai;1964310988;Taip;6;2;0;8
6564;Pagrandukas;Pelėdžiukai;44044284874;Taip;0;7;0;7
6565;Pagrandukas;Pelėdžiukai;33750135077;Taip;3;1;0;4
6566;Pagrandukas;Pelėdžiukai;2066377478;Taip;4;5;0;9
6567;Pagrandukas;Pelėdžiukai;1189453012;Taip;0;10;0;10
6568;Pagrandukas;Pelėdžiukai;43539883053;Taip;5;1;0;6
6569;Pagrandukas;Pelėdžiukai;6364473206;Taip;6;0;0;6
6570;Pagrandukas;Pelėdžiukai;33909593470;Taip;6;1;0;7
6571;Pagrandukas;Pelėdžiukai;2068155037;Taip;0;0;13;13
6572;Pagrandukas;Pelėdžiukai;7751376696;Taip;5;0;0;5
6573;Pagrandukas;Pelėdžiukai;5818020587;Taip;9;1;0;10
6574;Pagrandukas;Pelėdžiukai;21544489661;Taip;10;1;0;11
6575;Pagrandukas;Pelėdžiukai;93036151205;Taip;0;2;5;7
6576;Pagrandukas;Pelėdžiukai;1232460221;Taip;13;0;0;13
6577;Pagrandukas;Pelėdžiukai;7611916563;Taip;0;2;0;2
6578;Pagrandukas;Pelėdžiukai;57471531440;Taip;0;12;0;12
6579;Pagrandukas;Žvaigždutė;1904462840;Taip;0;1;0;1
6580;Pagrandukas;Žvaigždutė;9329518124;Taip;4;2;0;6
6581;Pagrandukas;Žvaigždutė;75080308291;Taip;0;16;0;16
6582;Pagrandukas;Žvaigždutė;7876029445;Taip;0;9;0;9
6583;Pagrandukas;Žvaigždutė;1313716840;Taip;0;13;0;13
6584;Pagrandukas;Žvaigždutė;14043704729;Taip;0;6;0;6
6585;Pagrandukas;Žvaigždutė;51692261484;Taip;12;1;0;13
6586;Pagrandukas;Žvaigždutė;35830862363;Taip;9;1;0;10
6587;Pagrandukas;Žvaigždutė;2923517578;Taip;0;10;0;10
6588;Pagrandukas;Žvaigždutė;4724383814;Taip;7;0;0;7
6589;Pagrandukas;Žvaigždutė;7782678159;Taip;0;9;0;9
6590;Pagrandukas;Žvaigždutė;8879549409;Taip;0;15;0;15
6591;Pagrandukas;Žvaigždutė;6299298199;Taip;0;10;0;10
6592;Pagrandukas;Žvaigždutė;7543795007;Taip;0;7;0;7
6593;Pagrandukas;Žvaigždutė;3860781857;Taip;6;9;0;15
6594;Pagrandukas;Žvaigždutė;24287759126;Taip;6;0;0;6
6595;Pagrandukas;Žvaigždutė;9522269582;Taip;0;15;0;15
6596;Pagrandukas;Žvaigždutė;2461803626;Taip;6;0;1;7
6597;Pakalnutė;Pagrandukai;22735454739;Taip;7;4;3;14
6598;Pakalnutė;Pagrandukai;1621947670;Taip;5;1;5;11
6599;Pakalnutė;Pagrandukai;2930341121;Taip;0;1;0;1
6600;Pakalnutė;Pagrandukai;18927141423;Taip;0;4;1;5
6601;Pakalnutė;Pagrandukai;70476217309;Ne;5;4;1;10
6602;Pakalnutė;Pagrandukai;39181323005;Taip;0;1;0;1
6603;Pakalnutė;Pagrandukai;83425301719;Taip;14;0;0;14
6604;Pakalnutė;Pagrandukai;46144634381;Taip;4;1;0;5
6605;Pakalnutė;Pagrandukai;85764245101;Taip;0;6;0;6
6606;Pakalnutė;Pagrandukai;6551713953;Taip;0;5;2;7
6607;Pakalnutė;Pagrandukai;57463392902;Taip;0;2;0;2
6608;Pakalnutė;Pagrandukai;97346486902;Taip;12;0;0;12
6609;Pakalnutė;Pagrandukai;24840895951;Taip;9;0;0;9
6610;Pakalnutė;Pagrandukai;89329905839;Taip;0;1;0;1
6611;Pakalnutė;Pagrandukai;58670351468;Taip;5;0;0;5
6612;Pakalnutė;Pagrandukai;7535589010;Taip;15;0;0;15
6613;Pakalnutė;Pagrandukai;1210432627;Taip;6;2;0;8
6614;Pakalnutė;Pagrandukai;34357752735;Taip;2;0;0;2
6615;Pakalnutė;Pagrandukai;28398386463;Taip;15;0;0;15
6616;Pakalnutė;"Pelėdžiukų ";39708333436;Taip;0;2;1;3
6617;Pakalnutė;"Pelėdžiukų ";1478348672;Taip;0;5;0;5
6618;Pakalnutė;"Pelėdžiukų ";82985105104;Taip;9;1;0;10
6619;Pakalnutė;"Pelėdžiukų ";88746368414;Taip;0;0;3;3
6620;Pakalnutė;"Pelėdžiukų ";77988376736;Taip;20;0;0;20
6621;Pakalnutė;"Pelėdžiukų ";26491667009;Taip;0;6;0;6
6622;Pakalnutė;"Pelėdžiukų ";77242242918;Taip;0;0;3;3
6623;Pakalnutė;"Pelėdžiukų ";37321817270;Taip;10;0;0;10
6624;Pakalnutė;"Pelėdžiukų ";42969128937;Taip;0;0;1;1
6625;Pakalnutė;"Pelėdžiukų ";16841777805;Taip;0;0;1;1
6626;Pakalnutė;"Pelėdžiukų ";1970792910;Taip;0;0;4;4
6627;Pakalnutė;"Pelėdžiukų ";1101880932;Taip;0;13;0;13
6628;Pakalnutė;"Pelėdžiukų ";2304898969;Taip;3;6;1;10
6629;Pakalnutė;"Pelėdžiukų ";12785798739;Taip;6;4;0;10
6630;Pakalnutė;"Pelėdžiukų ";9626872763;Taip;6;1;2;9
6631;Pakalnutė;"Pelėdžiukų ";65265804867;Taip;0;0;2;2
6632;Pakalnutė;"Pelėdžiukų ";24118925398;Taip;0;9;0;9
6633;Pakalnutė;Ežiukai;72729647117;Taip;0;11;0;11
6634;Pakalnutė;Ežiukai;64242664158;Taip;0;4;0;4
6635;Pakalnutė;Ežiukai;56277347819;Taip;2;5;0;7
6636;Pakalnutė;Ežiukai;48593837984;Taip;6;0;0;6
6637;Pakalnutė;Ežiukai;26038172396;Taip;0;0;1;1
6638;Pakalnutė;Ežiukai;82408964876;Taip;5;5;0;10
6639;Pakalnutė;Ežiukai;60227035402;Taip;0;0;1;1
6640;Pakalnutė;Ežiukai;68936094010;Ne;17;0;0;17
6641;Pakalnutė;Ežiukai;70837391829;Taip;5;0;0;5
6642;Pakalnutė;Ežiukai;49066311903;Taip;10;1;0;11
6643;Pakalnutė;Ežiukai;613434268;Taip;4;0;0;4
6644;Pakalnutė;Ežiukai;78371539346;Ne;0;7;0;7
6645;Pakalnutė;Ežiukai;71254042639;Taip;0;3;0;3
6646;Pakalnutė;Ežiukai;91448223847;Taip;20;0;0;20
6647;Pakalnutė;Ežiukai;7696792543;Taip;0;1;0;1
6648;Pakalnutė;Ežiukai;1936371007;Taip;0;0;5;5
6649;Pakalnutė;Skruzdėliukų;58775427990;Taip;5;0;0;5
6650;Pakalnutė;Skruzdėliukų;35416453763;Taip;0;2;0;2
6651;Pakalnutė;Skruzdėliukų;90799416844;Taip;3;3;0;6
6652;Pakalnutė;Skruzdėliukų;89370519379;Taip;5;0;0;5
6653;Pakalnutė;Skruzdėliukų;89875639056;Taip;0;5;0;5
6654;Pakalnutė;Skruzdėliukų;49248816221;Taip;0;1;0;1
6655;Pakalnutė;Skruzdėliukų;7171281063;Taip;6;1;0;7
6656;Pakalnutė;Skruzdėliukų;99475837756;Taip;9;0;0;9
6657;Pakalnutė;Skruzdėliukų;79722445374;Taip;0;2;0;2
6658;Pakalnutė;Skruzdėliukų;58650103614;Taip;0;13;0;13
6659;Pakalnutė;Skruzdėliukų;73006298922;Taip;0;4;0;4
6660;Pakalnutė;Skruzdėliukų;1785760365;Taip;0;1;0;1
6661;Pakalnutė;Skruzdėliukų;42536262678;Taip;6;5;0;11
6662;Pakalnutė;Skruzdėliukų;16888957248;Taip;0;4;0;4
6663;Pakalnutė;Bitučių;2993145079;Taip;9;0;1;10
6664;Pakalnutė;Bitučių;8461220770;Taip;0;3;0;3
6665;Pakalnutė;Bitučių;2367683002;Taip;17;0;0;17
6666;Pakalnutė;Bitučių;2765220889;Taip;3;9;0;12
6667;Pakalnutė;Bitučių;9445909071;Taip;1;5;0;6
6668;Pakalnutė;Bitučių;5532458706;Taip;20;0;0;20
6669;Pakalnutė;Bitučių;5355198213;Taip;11;0;2;13
6670;Pakalnutė;Bitučių;7526989580;Taip;7;0;0;7
6671;Pakalnutė;Bitučių;5941955322;Taip;7;0;0;7
6672;Pakalnutė;Bitučių;3306334576;Taip;13;0;0;13
6673;Pakalnutė;Bitučių;2095540372;Taip;10;3;0;13
6674;Pakalnutė;Bitučių;5342592825;Taip;9;1;0;10
6675;Pakalnutė;Bitučių;2932205226;Taip;10;0;0;10
6676;Pakalnutė;Bitučių;1238121406;Taip;8;2;0;10
6677;Pakalnutė;Bitučių;6117542654;Taip;10;5;0;15
6678;Pakalnutė;Bitučių;5464143742;Taip;4;9;0;13
6679;Pakalnutė;Bitučių;2714905466;Taip;0;8;0;8
6680;Pakalnutė;Bitučių;6351193702;Taip;11;0;0;11
6681;Pakalnutė;Bitučių;2070744110;Taip;9;0;0;9
6682;Pakalnutė;Boružiukų;5120176374;Taip;11;0;0;11
6683;Pakalnutė;Boružiukų;9256219647;Taip;13;0;0;13
6684;Pakalnutė;Boružiukų;6798939288;Taip;0;2;2;4
6685;Pakalnutė;Boružiukų;7357431226;Taip;20;0;0;20
6686;Pakalnutė;Boružiukų;4934095931;Taip;6;0;0;6
6687;Pakalnutė;Boružiukų;5039000154;Taip;5;2;0;7
6688;Pakalnutė;Boružiukų;7853479591;Taip;20;0;0;20
6689;Pakalnutė;Boružiukų;6575909478;Taip;0;0;4;4
6690;Pakalnutė;Boružiukų;3583094831;Taip;11;0;0;11
6691;Pakalnutė;Boružiukų;4033813807;Taip;4;0;0;4
6692;Pakalnutė;Boružiukų;2040992265;Taip;6;0;1;7
6693;Pakalnutė;Boružiukų;7503936754;Taip;11;0;1;12
6694;Pakalnutė;Boružiukų;9382160515;Taip;10;0;0;10
6695;Pakalnutė;Boružiukų;2835611316;Taip;16;0;0;16
6696;Pakalnutė;Boružiukų;5134342817;Taip;11;0;2;13
6697;Pakalnutė;Meškiukų;1602013811;Taip;0;10;0;10
6698;Pakalnutė;Meškiukų;41008813511;Ne;8;0;0;8
6699;Pakalnutė;Meškiukų;83174865018;Taip;0;4;0;4
6700;Pakalnutė;Meškiukų;53011933771;Taip;2;0;1;3
6701;Pakalnutė;Meškiukų;1655551042;Taip;7;3;0;10
6702;Pakalnutė;Meškiukų;40117721972;Taip;9;0;0;9
6703;Pakalnutė;Meškiukų;64706392096;Taip;20;0;0;20
6704;Pakalnutė;Meškiukų;1411083263;Taip;11;3;1;15
6705;Pakalnutė;Meškiukų;2202341545;Taip;12;0;6;18
6706;Pakalnutė;Meškiukų;7180617984;Taip;4;0;0;4
6707;Pakalnutė;Meškiukų;9355380341;Taip;10;1;1;12
6708;Pakalnutė;Meškiukų;7324846434;Taip;10;0;0;10
6709;Pakalnutė;Meškiukų;9001185744;Taip;0;0;5;5
6710;Pakalnutė;Nykštukai;6769352325;Taip;0;11;0;11
6711;Pakalnutė;Nykštukai;1202301707;Taip;12;0;0;12
6712;Pakalnutė;Nykštukai;72137985328;Taip;7;1;1;9
6713;Pakalnutė;Nykštukai;11183301096;Taip;8;2;0;10
6714;Pakalnutė;Nykštukai;19773872429;Taip;10;0;0;10
6715;Pakalnutė;Nykštukai;85900847069;Taip;4;4;3;11
6716;Pakalnutė;Nykštukai;16651154416;Taip;12;0;0;12
6717;Pakalnutė;Nykštukai;7452656662;Taip;13;1;0;14
6718;Pakalnutė;Nykštukai;7389600659;Taip;1;3;0;4
6719;Pakalnutė;Nykštukai;5309195407;Taip;4;7;0;11
6720;Pakalnutė;Nykštukai;1849396954;Taip;10;0;3;13
6721;Pakalnutė;Nykštukai;81963663668;Taip;1;3;0;4
6722;Pakalnutė;Nykštukai;76382908561;Taip;5;0;0;5
6723;Pakalnutė;Nykštukai;99344331316;Taip;11;0;0;11
6724;Pakalnutė;Nykštukai;33667858388;Taip;3;9;0;12
6725;Pakalnutė;Nykštukai;2815093249;Taip;3;11;0;14
6726;Pakalnutė;Nykštukai;1372722843;Taip;13;0;0;13
6727;Pakalnutė;Nykštukai;2051737273;Taip;12;0;0;12
6728;Pakalnutė;Nykštukai;61712002384;Taip;8;5;0;13
6729;Pakalnutė;Nykštukai;2946347383;Taip;0;7;1;8
6730;Pakalnutė;"Zuikučių ";1198230323;Taip;0;1;0;1
6731;Pakalnutė;"Zuikučių ";3609982613;Taip;13;0;0;13
6732;Pakalnutė;"Zuikučių ";5958653847;Taip;0;1;1;2
6733;Pakalnutė;"Zuikučių ";8513260520;Taip;12;0;0;12
6734;Pakalnutė;"Zuikučių ";2159430356;Taip;0;7;0;7
6735;Pakalnutė;"Zuikučių ";1147843795;Taip;14;0;0;14
6736;Pakalnutė;"Zuikučių ";6879558965;Taip;9;0;0;9
6737;Pakalnutė;"Zuikučių ";3555822605;Taip;12;0;1;13
6738;Pakalnutė;"Zuikučių ";7563201788;Taip;0;1;0;1
6739;Pakalnutė;"Zuikučių ";1583462733;Taip;0;3;0;3
6740;Pakalnutė;"Zuikučių ";6377564215;Taip;5;0;0;5
6741;Pakalnutė;"Zuikučių ";3306670221;Taip;0;0;4;4
6742;Pakalnutė;"Zuikučių ";1159312512;Taip;6;3;0;9
6743;Pakalnutė;"Zuikučių ";6549217377;Taip;11;0;2;13
6744;Pakalnutė;"Zuikučių ";1610847242;Taip;0;7;0;7
6745;Pakalnutė;"Zuikučių ";8813262660;Taip;14;2;0;16
6746;Pakalnutė;"Zuikučių ";5102345686;Taip;0;1;3;4
6747;Pakalnutė;"Zuikučių ";7949588551;Taip;7;0;2;9
6748;Pakalnutė;"Drugelių ";4046820545;Taip;0;1;0;1
6749;Pakalnutė;"Drugelių ";5973972464;Taip;9;0;1;10
6750;Pakalnutė;"Drugelių ";3035056391;Taip;0;10;0;10
6751;Pakalnutė;"Drugelių ";4742424647;Taip;5;1;3;9
6752;Pakalnutė;"Drugelių ";2075865543;Taip;5;0;0;5
6753;Pakalnutė;"Drugelių ";9562957603;Taip;5;5;1;11
6754;Pakalnutė;"Drugelių ";5435336235;Taip;16;0;0;16
6755;Pakalnutė;"Drugelių ";2050880681;Taip;9;0;0;9
6756;Pakalnutė;"Drugelių ";4514642887;Taip;8;1;0;9
6757;Pakalnutė;"Drugelių ";9274456755;Taip;0;3;0;3
6758;Pakalnutė;"Drugelių ";2721810040;Taip;0;0;14;14
6759;Pakalnutė;"Drugelių ";80818670065;Taip;12;0;0;12
6760;Pakalnutė;"Drugelių ";2049079012;Taip;6;5;0;11
6761;Pakalnutė;"Drugelių ";4681267749;Taip;16;0;0;16
6762;Pakalnutė;"Drugelių ";85356812538;Taip;3;0;0;3
6763;Pakalnutė;"Drugelių ";6771510589;Taip;0;0;7;7
6764;Pakalnutė;"Drugelių ";18503890312;Taip;8;2;0;10
6765;Panerių;Rūtelė;81949147104;Taip;10;0;2;12
6766;Panerių;Rūtelė;21661667266;Taip;9;0;11;20
6767;Panerių;Rūtelė;1429591387;Taip;0;0;3;3
6768;Panerių;Rūtelė;14092687895;Taip;0;0;2;2
6769;Panerių;Rūtelė;8498616733;Taip;0;5;15;20
6770;Panerių;Rūtelė;85473262607;Taip;0;0;1;1
6771;Panerių;Rūtelė;7324873912;Taip;9;0;6;15
6772;Panerių;Rūtelė;8388744329;Taip;8;0;6;14
6773;Panerių;Rūtelė;2348627375;Taip;12;0;0;12
6774;Panerių;Rūtelė;3349776899;Taip;0;13;5;18
6775;Panerių;Rūtelė;68313730462;Taip;0;0;2;2
6776;Panerių;Rūtelė;84672957234;Taip;5;5;0;10
6777;Panerių;Rūtelė;60738239005;Taip;11;0;0;11
6778;Panerių;Rūtelė;10051044012;Taip;0;3;0;3
6779;Panerių;Rūtelė;1017100748;Taip;0;6;0;6
6780;Panerių;Rūtelė;68231938043;Taip;0;0;1;1
6781;Panerių;Rūtelė;24072345175;Taip;2;0;0;2
6782;Panerių;Rūtelė;78838685571;Taip;0;0;8;8
6783;Panerių;Rūtelė;53384267657;Taip;0;5;0;5
6784;Panerių;Rūtelė;1558843252;Taip;5;0;2;7
6785;Panerių;Rūtelė;8666159951;Taip;2;0;8;10
6786;Panerių;Rūtelė;39185053006;Taip;10;3;0;13
6787;Panerių;Gėlytės;1894521927;Taip;5;0;0;5
6788;Panerių;Gėlytės;75034220223;Taip;20;0;0;20
6789;Panerių;Gėlytės;1386277428;Taip;5;2;0;7
6790;Panerių;Gėlytės;2069150261;Taip;19;0;0;19
6791;Panerių;Gėlytės;5109850366;Taip;11;2;0;13
6792;Panerių;Gėlytės;9268558715;Taip;20;0;0;20
6793;Panerių;Gėlytės;9004468035;Taip;0;0;1;1
6794;Panerių;Gėlytės;18963190527;Taip;0;0;4;4
6795;Panerių;Gėlytės;1423148023;Taip;2;0;0;2
6796;Panerių;Gėlytės;8149880453;Taip;7;0;5;12
6797;Panerių;Gėlytės;6227583229;Taip;15;0;5;20
6798;Panerių;Gėlytės;3843500717;Taip;15;0;0;15
6799;Panerių;Gėlytės;9639587601;Taip;6;1;0;7
6800;Panerių;Gėlytės;2786775879;Taip;0;11;0;11
6801;Panerių;Gėlytės;7337663549;Taip;6;0;5;11
6802;Panerių;Gėlytės;4103412131;Taip;0;0;7;7
6803;Panerių;Gėlytės;7903272014;Taip;0;19;0;19
6804;Panerių;Gėlytės;3631150576;Taip;11;0;0;11
6805;Panerių;Gėlytės;5001921323;Taip;5;0;0;5
6806;Panerių;Boružė;7805429137;Taip;4;0;0;4
6807;Panerių;Boružė;8299189235;Taip;20;0;0;20
6808;Panerių;Boružė;3438863665;Taip;1;0;0;1
6809;Panerių;Boružė;9268618414;Taip;0;0;7;7
6810;Panerių;Boružė;6908487075;Taip;0;0;12;12
6811;Panerių;Boružė;2571561865;Taip;0;12;0;12
6812;Panerių;Boružė;6411372006;Taip;10;5;3;18
6813;Panerių;Boružė;1419817211;Taip;20;0;0;20
6814;Panerių;Boružė;9188471756;Taip;5;0;0;5
6815;Panerių;Boružė;4023257875;Taip;0;7;6;13
6816;Panerių;Boružė;4689913361;Taip;0;3;0;3
6817;Panerių;Boružė;8693113275;Taip;17;0;0;17
6818;Panerių;Boružė;8771264170;Ne;7;0;0;7
6819;Panerių;Boružė;6182126113;Ne;0;0;5;5
6820;Papartis;ZUIKUČIAI;1065234123;Taip;7;0;1;8
6821;Papartis;ZUIKUČIAI;1219140467;Taip;6;0;0;6
6822;Papartis;ZUIKUČIAI;1260151691;Taip;9;0;0;9
6823;Papartis;ZUIKUČIAI;2412700197;Taip;9;0;0;9
6824;Papartis;ZUIKUČIAI;1554777403;Taip;0;1;0;1
6825;Papartis;ZUIKUČIAI;7703070601;Taip;0;3;0;3
6826;Papartis;ZUIKUČIAI;7902130389;Taip;2;1;0;3
6827;Papartis;ZUIKUČIAI;4992305227;Taip;6;6;0;12
6828;Papartis;ZUIKUČIAI;4346817695;Taip;5;0;2;7
6829;Papartis;ZUIKUČIAI;2447926422;Taip;0;10;0;10
6830;Papartis;ZUIKUČIAI;3182457453;Taip;18;0;0;18
6831;Papartis;ZUIKUČIAI;3275123842;Taip;9;1;0;10
6832;Papartis;ZUIKUČIAI;8190458132;Taip;0;4;0;4
6833;Papartis;ZUIKUČIAI;8952917454;Taip;2;1;0;3
6834;Papartis;ZUIKUČIAI;5410369044;Taip;20;0;0;20
6835;Papartis;ZUIKUČIAI;6126912448;Taip;11;0;0;11
6836;Papartis;ZUIKUČIAI;5675537250;Taip;15;0;0;15
6837;Papartis;ZUIKUČIAI;3221250267;Taip;3;0;1;4
6838;Papartis;ZUIKUČIAI;5846324441;Taip;20;0;0;20
6839;Papartis;ZUIKUČIAI;1065128993;Taip;10;2;0;12
6840;Papartis;ZUIKUČIAI;3895487270;Taip;9;1;0;10
6841;Papartis;DRUGELIAI;4508053349;Taip;9;0;0;9
6842;Papartis;DRUGELIAI;7387281720;Taip;0;3;0;3
6843;Papartis;DRUGELIAI;2778629398;Taip;20;0;0;20
6844;Papartis;DRUGELIAI;3475745012;Taip;20;0;0;20
6845;Papartis;DRUGELIAI;2535412635;Taip;3;0;0;3
6846;Papartis;DRUGELIAI;6797687614;Taip;0;6;2;8
6847;Papartis;DRUGELIAI;7606939822;Taip;0;11;0;11
6848;Papartis;DRUGELIAI;9719465384;Taip;14;0;0;14
6849;Papartis;DRUGELIAI;5265293240;Taip;14;1;0;15
6850;Papartis;DRUGELIAI;7590170146;Taip;0;11;0;11
6851;Papartis;DRUGELIAI;9134335737;Taip;14;1;0;15
6852;Papartis;DRUGELIAI;1836914270;Taip;12;0;0;12
6853;Papartis;DRUGELIAI;4935694347;Taip;17;0;0;17
6854;Papartis;DRUGELIAI;1672028156;Taip;8;1;0;9
6855;Papartis;DRUGELIAI;4634683589;Ne;0;7;0;7
6856;Papartis;DRUGELIAI;3107106078;Taip;13;0;0;13
6857;Papartis;DRUGELIAI;1205854439;Taip;13;0;0;13
6858;Papartis;DRUGELIAI;7067369268;Taip;11;0;2;13
6859;Papartis;DRUGELIAI;6746279237;Taip;20;0;0;20
6860;Papartis;ŽVIRBLIUKAI;50932429867;Taip;0;9;0;9
6861;Papartis;ŽVIRBLIUKAI;76557621397;Taip;0;4;3;7
6862;Papartis;ŽVIRBLIUKAI;25395258852;Taip;2;4;2;8
6863;Papartis;ŽVIRBLIUKAI;43479692818;Taip;0;1;0;1
6864;Papartis;ŽVIRBLIUKAI;38687595335;Taip;0;1;0;1
6865;Papartis;ŽVIRBLIUKAI;2572865390;Taip;8;4;4;16
6866;Papartis;ŽVIRBLIUKAI;42525320308;Taip;0;0;1;1
6867;Papartis;ŽVIRBLIUKAI;36753788655;Taip;10;5;1;16
6868;Papartis;ŽVIRBLIUKAI;75872164784;Taip;0;4;4;8
6869;Papartis;ŽVIRBLIUKAI;97003005429;Taip;2;4;2;8
6870;Papartis;ŽVIRBLIUKAI;2328716782;Taip;0;4;0;4
6871;Papartis;ŽVIRBLIUKAI;46090386686;Taip;20;0;0;20
6872;Papartis;ŽVIRBLIUKAI;42363051383;Taip;10;4;0;14
6873;Papartis;ŽVIRBLIUKAI;44727915152;Taip;0;1;0;1
6874;Papartis;ŽVIRBLIUKAI;60618694149;Taip;0;3;0;3
6875;Papartis;ŽVIRBLIUKAI;60803503066;Taip;0;6;0;6
6876;Papartis;ŽVIRBLIUKAI;66084413148;Taip;10;4;3;17
6877;Papartis;ŽVIRBLIUKAI;54923526939;Taip;0;4;3;7
6878;Papartis;ŽVIRBLIUKAI;65887563163;Ne;2;0;0;2
6879;Papartis;ŽVIRBLIUKAI;95325725936;Taip;9;4;0;13
6880;Papartis;ŽVIRBLIUKAI;6896883671;Taip;2;4;0;6
6881;Papartis;ŽVIRBLIUKAI;1712122097;Taip;8;2;0;10
6882;Papartis;PELĖDŽIUKAI;31558670598;Taip;2;4;0;6
6883;Papartis;PELĖDŽIUKAI;17727499036;Taip;0;6;0;6
6884;Papartis;PELĖDŽIUKAI;33710012877;Taip;0;4;1;5
6885;Papartis;PELĖDŽIUKAI;3150874256;Taip;0;7;0;7
6886;Papartis;PELĖDŽIUKAI;37962640982;Taip;5;0;0;5
6887;Papartis;PELĖDŽIUKAI;5610352010;Taip;0;3;0;3
6888;Papartis;PELĖDŽIUKAI;97048061562;Taip;9;2;0;11
6889;Papartis;PELĖDŽIUKAI;14737302670;Taip;0;11;0;11
6890;Papartis;PELĖDŽIUKAI;77941154397;Taip;0;1;5;6
6891;Papartis;PELĖDŽIUKAI;10942624686;Taip;0;0;20;20
6892;Papartis;PELĖDŽIUKAI;2759394795;Taip;0;12;0;12
6893;Papartis;PELĖDŽIUKAI;62851879822;Taip;0;1;0;1
6894;Papartis;PELĖDŽIUKAI;75595469519;Taip;14;0;0;14
6895;Papartis;PELĖDŽIUKAI;50230057955;Taip;0;4;0;4
6896;Papartis;PELĖDŽIUKAI;98845059554;Taip;0;6;0;6
6897;Papartis;PELĖDŽIUKAI;14077470090;Taip;9;3;0;12
6898;Papartis;PELĖDŽIUKAI;7603023091;Ne;0;9;0;9
6899;Papartis;PELĖDŽIUKAI;72201740881;Taip;11;4;3;18
6900;Papartis;PELĖDŽIUKAI;87817163360;Taip;0;3;1;4
6901;Papartis;PELĖDŽIUKAI;89808286532;Taip;6;6;0;12
6902;Papartis;PELĖDŽIUKAI;4351158000;Taip;0;4;0;4
6903;Papartis;SAULUTĖS;42803013754;Taip;9;0;0;9
6904;Papartis;SAULUTĖS;2022533158;Taip;11;0;0;11
6905;Papartis;SAULUTĖS;1237889393;Taip;10;4;0;14
6906;Papartis;SAULUTĖS;1246604915;Taip;5;9;0;14
6907;Papartis;SAULUTĖS;48182233276;Taip;1;7;0;8
6908;Papartis;SAULUTĖS;23218268605;Ne;5;0;0;5
6909;Papartis;SAULUTĖS;18124337938;Taip;5;7;0;12
6910;Papartis;SAULUTĖS;22443998204;Taip;0;1;0;1
6911;Papartis;SAULUTĖS;30982681803;Taip;5;6;0;11
6912;Papartis;SAULUTĖS;95139517078;Taip;5;7;0;12
6913;Papartis;SAULUTĖS;14978429821;Taip;0;4;0;4
6914;Papartis;SAULUTĖS;55573140983;Taip;7;1;0;8
6915;Papartis;SAULUTĖS;50090482473;Taip;9;7;0;16
6916;Papartis;SAULUTĖS;10078570352;Taip;14;0;0;14
6917;Papartis;SAULUTĖS;88700503601;Taip;11;5;0;16
6918;Papartis;SAULUTĖS;21963930874;Taip;7;0;0;7
6919;Papartis;SAULUTĖS;15207322802;Taip;8;0;0;8
6920;Papartis;SAULUTĖS;2115718328;Ne;5;0;9;14
6921;Papartis;SAULUTĖS;3933829088;Taip;20;0;0;20
6922;Papartis;SAULUTĖS;67966766974;Taip;5;8;0;13
6923;Papartis;GANDRIUKAI;46076659264;Ne;9;0;0;9
6924;Papartis;GANDRIUKAI;1727771667;Taip;0;4;2;6
6925;Papartis;GANDRIUKAI;37759125130;Taip;0;20;0;20
6926;Papartis;GANDRIUKAI;20862839950;Taip;0;8;0;8
6927;Papartis;GANDRIUKAI;8564913801;Taip;14;0;0;14
6928;Papartis;GANDRIUKAI;47876153590;Taip;0;1;0;1
6929;Papartis;GANDRIUKAI;84260015363;Taip;0;5;0;5
6930;Papartis;GANDRIUKAI;67226404925;Taip;20;0;0;20
6931;Papartis;GANDRIUKAI;41330436046;Taip;5;0;0;5
6932;Papartis;GANDRIUKAI;83927324420;Taip;10;0;0;10
6933;Papartis;GANDRIUKAI;21840378271;Taip;0;2;0;2
6934;Papartis;GANDRIUKAI;93141801552;Taip;5;0;0;5
6935;Papartis;GANDRIUKAI;80455285324;Taip;0;4;0;4
6936;Papartis;GANDRIUKAI;285754903;Taip;5;5;2;12
6937;Papartis;GANDRIUKAI;51857496843;Taip;0;1;0;1
6938;Papartis;GANDRIUKAI;79080758672;Taip;0;5;0;5
6939;Papartis;GANDRIUKAI;18164175829;Taip;2;3;0;5
6940;Papartis;GANDRIUKAI;10026323228;Taip;0;4;16;20
6941;Papartis;GANDRIUKAI;1045629158;Taip;0;4;0;4
6942;Papartis;GANDRIUKAI;8593823543;Taip;5;3;0;8
6943;Papartis;AITVARELIAI;4139884005;Taip;8;1;0;9
6944;Papartis;AITVARELIAI;77686722867;Taip;5;5;0;10
6945;Papartis;AITVARELIAI;2146286089;Taip;12;0;0;12
6946;Papartis;AITVARELIAI;1876543445;Taip;0;3;0;3
6947;Papartis;AITVARELIAI;19544040390;Taip;10;0;0;10
6948;Papartis;AITVARELIAI;19852567505;Taip;10;0;0;10
6949;Papartis;AITVARELIAI;32352993438;Taip;20;0;0;20
6950;Papartis;AITVARELIAI;67237428983;Taip;0;0;1;1
6951;Papartis;AITVARELIAI;89486863055;Taip;9;3;0;12
6952;Papartis;AITVARELIAI;87519747220;Taip;0;0;11;11
6953;Papartis;AITVARELIAI;93468721158;Taip;0;4;0;4
6954;Papartis;AITVARELIAI;87353511647;Taip;14;0;0;14
6955;Papartis;AITVARELIAI;25990216006;Taip;4;0;0;4
6956;Papartis;AITVARELIAI;26912851152;Taip;17;0;0;17
6957;Papartis;AITVARELIAI;60706816641;Taip;0;5;1;6
6958;Papartis;AITVARELIAI;1973027294;Taip;5;7;0;12
6959;Papartis;AITVARELIAI;1403114386;Taip;9;0;0;9
6960;Papartis;SMALSUČIAI;72182866449;Taip;10;4;0;14
6961;Papartis;SMALSUČIAI;3287617252;Taip;0;1;0;1
6962;Papartis;SMALSUČIAI;4823666725;Taip;0;1;0;1
6963;Papartis;SMALSUČIAI;1406820323;Taip;0;13;0;13
6964;Papartis;SMALSUČIAI;2092191603;Taip;5;2;0;7
6965;Papartis;SMALSUČIAI;10659508171;Taip;7;1;1;9
6966;Papartis;SMALSUČIAI;2067304804;Taip;0;4;0;4
6967;Papartis;SMALSUČIAI;88418552221;Taip;2;1;0;3
6968;Papartis;SMALSUČIAI;51899025231;Taip;1;2;0;3
6969;Papartis;SMALSUČIAI;74972133115;Taip;4;0;1;5
6970;Papartis;SMALSUČIAI;1322826573;Taip;1;1;1;3
6971;Papartis;SMALSUČIAI;1527263538;Taip;1;1;1;3
6972;Papartis;SMALSUČIAI;88722771438;Taip;9;1;1;11
6973;Papartis;SMALSUČIAI;4216398263;Taip;12;0;0;12
6974;Papartis;SMALSUČIAI;89525856173;Taip;0;1;0;1
6975;Papartis;SMALSUČIAI;82454730189;Taip;3;0;0;3
6976;Papartis;SMALSUČIAI;74734443304;Taip;14;1;0;15
6977;Papartis;SMALSUČIAI;63087155760;Taip;6;1;5;12
6978;Papartis;SMALSUČIAI;26193472997;Taip;3;1;1;5
6979;Papartis;SMALSUČIAI;68478260102;Ne;0;1;0;1
6980;Papartis;"ŽIRNIUKAI ";44833872631;Taip;20;0;0;20
6981;Papartis;"ŽIRNIUKAI ";1944730492;Taip;0;4;5;9
6982;Papartis;"ŽIRNIUKAI ";1271303103;Taip;10;0;10;20
6983;Papartis;"ŽIRNIUKAI ";7845277151;Taip;8;2;0;10
6984;Papartis;"ŽIRNIUKAI ";30041894006;Taip;8;0;0;8
6985;Papartis;"ŽIRNIUKAI ";3630377970;Taip;16;4;0;20
6986;Papartis;"ŽIRNIUKAI ";38896771062;Taip;16;0;0;16
6987;Papartis;"ŽIRNIUKAI ";86735273559;Taip;5;7;0;12
6988;Papartis;"ŽIRNIUKAI ";29789530287;Taip;0;2;0;2
6989;Papartis;"ŽIRNIUKAI ";22570313128;Taip;5;1;3;9
6990;Papartis;"ŽIRNIUKAI ";51588027659;Taip;7;3;0;10
6991;Papartis;"ŽIRNIUKAI ";1703232380;Taip;0;1;0;1
6992;Papartis;"ŽIRNIUKAI ";64345875780;Ne;6;2;0;8
6993;Papartis;"ŽIRNIUKAI ";2598688561;Taip;2;0;6;8
6994;Papartis;"ŽIRNIUKAI ";53040207725;Taip;0;10;2;12
6995;Papartis;"ŽIRNIUKAI ";3991709974;Taip;5;4;0;9
6996;Papartis;"ŽIRNIUKAI ";3367009621;Taip;11;0;0;11
6997;Papartis;"ŽIRNIUKAI ";7102350653;Taip;1;1;0;2
6998;Papartis;"ŽIRNIUKAI ";3408756311;Taip;7;5;0;12
6999;Papartis;BORUŽĖLĖS;3320524073;Taip;8;1;0;9
7000;Papartis;BORUŽĖLĖS;9384670351;Taip;10;2;0;12
7001;Papartis;BORUŽĖLĖS;1974159967;Taip;10;0;0;10
7002;Papartis;BORUŽĖLĖS;5732853976;Taip;5;0;3;8
7003;Papartis;BORUŽĖLĖS;8891856856;Taip;11;0;0;11
7004;Papartis;BORUŽĖLĖS;8532558577;Taip;6;0;0;6
7005;Papartis;BORUŽĖLĖS;9968072478;Taip;11;0;2;13
7006;Papartis;BORUŽĖLĖS;1916222143;Taip;11;2;0;13
7007;Papartis;BORUŽĖLĖS;2215846642;Taip;14;0;0;14
7008;Papartis;BORUŽĖLĖS;9704930584;Taip;7;2;0;9
7009;Papartis;BORUŽĖLĖS;7859096984;Taip;5;3;0;8
7010;Papartis;BORUŽĖLĖS;7252265838;Taip;5;4;0;9
7011;Papartis;BORUŽĖLĖS;9072635586;Taip;8;0;3;11
7012;Papartis;BORUŽĖLĖS;9804863902;Taip;10;4;0;14
7013;Papartis;VARPELIAI;9502229005;Taip;18;0;0;18
7014;Papartis;VARPELIAI;4203241118;Taip;5;5;3;13
7015;Papartis;VARPELIAI;4570512336;Taip;0;0;2;2
7016;Papartis;VARPELIAI;3324647852;Taip;5;2;2;9
7017;Papartis;VARPELIAI;5652560002;Taip;11;0;0;11
7018;Papartis;VARPELIAI;6949120693;Taip;10;0;0;10
7019;Papartis;VARPELIAI;6794076631;Taip;6;1;0;7
7020;Papartis;VARPELIAI;1596721999;Taip;13;5;2;20
7021;Papartis;VARPELIAI;4806652727;Taip;5;4;1;10
7022;Papartis;VARPELIAI;9939850340;Taip;5;2;0;7
7023;Papartis;VARPELIAI;8932290803;Taip;3;0;1;4
7024;Papartis;VARPELIAI;7803854703;Taip;8;1;0;9
7025;Papartis;VARPELIAI;5218101579;Taip;8;0;1;9
7026;Papartis;VARPELIAI;5608868738;Ne;0;1;0;1
7027;Papartis;NYKŠTUKAI;94692743993;Taip;11;0;0;11
7028;Papartis;NYKŠTUKAI;28903744662;Taip;5;4;0;9
7029;Papartis;NYKŠTUKAI;49067272346;Taip;0;1;0;1
7030;Papartis;NYKŠTUKAI;1683639252;Taip;0;3;1;4
7031;Papartis;NYKŠTUKAI;86974446702;Taip;2;5;0;7
7032;Papartis;NYKŠTUKAI;18677892477;Taip;0;3;0;3
7033;Papartis;NYKŠTUKAI;2414727436;Taip;10;4;1;15
7034;Papartis;NYKŠTUKAI;1787027071;Taip;5;3;0;8
7035;Papartis;NYKŠTUKAI;1957969359;Taip;5;3;0;8
7036;Papartis;NYKŠTUKAI;1699776923;Taip;8;2;0;10
7037;Papartis;NYKŠTUKAI;1691817767;Taip;4;2;0;6
7038;Papartis;NYKŠTUKAI;35385266110;Taip;0;9;0;9
7039;Papartis;NYKŠTUKAI;1201154176;Ne;0;7;7;14
7040;Papartis;NYKŠTUKAI;7308118576;Taip;5;0;4;9
7041;Papartis;NYKŠTUKAI;45289621684;Taip;0;7;0;7
7042;Papartis;NYKŠTUKAI;3264373480;Taip;1;0;0;1
7043;Papartis;NYKŠTUKAI;29324405170;Taip;0;3;0;3
7044;Pasagėlė;SMALSUČIŲ;29755294214;Taip;5;0;0;5
7045;Pasagėlė;SMALSUČIŲ;63657801249;Taip;12;0;0;12
7046;Pasagėlė;SMALSUČIŲ;2077383621;Taip;6;6;0;12
7047;Pasagėlė;SMALSUČIŲ;2096927238;Taip;10;0;0;10
7048;Pasagėlė;SMALSUČIŲ;2096035763;Taip;9;0;0;9
7049;Pasagėlė;SMALSUČIŲ;6687699907;Taip;7;4;0;11
7050;Pasagėlė;SMALSUČIŲ;27151485531;Taip;12;0;0;12
7051;Pasagėlė;SMALSUČIŲ;1616662586;Taip;0;0;8;8
7052;Pasagėlė;SMALSUČIŲ;1180183091;Taip;8;2;0;10
7053;Pasagėlė;SMALSUČIŲ;8285580095;Taip;0;0;20;20
7054;Pasagėlė;SMALSUČIŲ;8218872969;Taip;5;0;7;12
7055;Pasagėlė;SMALSUČIŲ;8301904575;Taip;9;0;0;9
7056;Pasagėlė;SMALSUČIŲ;1587218379;Taip;10;0;0;10
7057;Pasagėlė;SMALSUČIŲ;80775017833;Taip;9;0;0;9
7058;Pasagėlė;SMALSUČIŲ;76285364171;Taip;0;0;2;2
7059;Pasagėlė;SMALSUČIŲ;49106308532;Taip;0;6;0;6
7060;Pasagėlė;SMALSUČIŲ;1974755599;Taip;0;1;2;3
7061;Pasagėlė;SMALSUČIŲ;6543038595;Taip;0;8;0;8
7062;Pasagėlė;GUDRUČIŲ;75037090183;Ne;0;6;14;20
7063;Pasagėlė;GUDRUČIŲ;1768000089;Taip;6;0;1;7
7064;Pasagėlė;GUDRUČIŲ;84330734709;Taip;4;0;2;6
7065;Pasagėlė;GUDRUČIŲ;80908835303;Taip;3;4;0;7
7066;Pasagėlė;GUDRUČIŲ;2137489054;Taip;0;1;8;9
7067;Pasagėlė;GUDRUČIŲ;5228878677;Taip;11;0;0;11
7068;Pasagėlė;GUDRUČIŲ;1040850911;Taip;9;0;0;9
7069;Pasagėlė;GUDRUČIŲ;1215400980;Taip;7;0;1;8
7070;Pasagėlė;GUDRUČIŲ;1054424694;Taip;4;0;0;4
7071;Pasagėlė;GUDRUČIŲ;6011034443;Taip;0;2;1;3
7072;Pasagėlė;GUDRUČIŲ;3254801126;Taip;6;0;0;6
7073;Pasagėlė;GUDRUČIŲ;1511098546;Taip;5;2;0;7
7074;Pasagėlė;GUDRUČIŲ;54694832614;Taip;10;0;1;11
7075;Pasagėlė;GUDRUČIŲ;8428101374;Taip;5;0;0;5
7076;Pasagėlė;GUDRUČIŲ;60492768809;Taip;0;4;2;6
7077;Pasagėlė;GUDRUČIŲ;64636489181;Taip;12;0;0;12
7078;Pasagėlė;GUDRUČIŲ;69892632522;Taip;14;0;0;14
7079;Pasagėlė;GUDRUČIŲ;1600378710;Taip;8;1;0;9
7080;Pasagėlė;PABIRUČIŲ;1113026818;Taip;4;0;0;4
7081;Pasagėlė;PABIRUČIŲ;8301938009;Taip;4;0;1;5
7082;Pasagėlė;PABIRUČIŲ;16591459661;Taip;0;0;1;1
7083;Pasagėlė;PABIRUČIŲ;20999997254;Taip;0;6;4;10
7084;Pasagėlė;PABIRUČIŲ;4668155071;Taip;0;0;5;5
7085;Pasagėlė;PABIRUČIŲ;9388057389;Taip;5;0;1;6
7086;Pasagėlė;PABIRUČIŲ;20743334216;Taip;0;0;2;2
7087;Pasagėlė;PABIRUČIŲ;1371753067;Taip;5;0;0;5
7088;Pasagėlė;PABIRUČIŲ;9801268758;Taip;5;0;0;5
7089;Pasagėlė;PABIRUČIŲ;3405470634;Taip;5;0;0;5
7090;Pasagėlė;PABIRUČIŲ;55527703561;Taip;11;0;0;11
7091;Pasagėlė;PABIRUČIŲ;38355661182;Taip;0;0;2;2
7092;Pasagėlė;PABIRUČIŲ;3583848327;Taip;16;0;0;16
7093;Pasagėlė;PABIRUČIŲ;5040657332;Taip;7;9;0;16
7094;Pasagėlė;PABIRUČIŲ;3924127476;Taip;8;7;0;15
7095;Pasagėlė;PABIRUČIŲ;2769668641;Taip;7;0;4;11
7096;Pasagėlė;PABIRUČIŲ;4261133734;Taip;1;0;8;9
7097;Pasagėlė;PABIRUČIŲ;3576157355;Taip;0;6;6;12
7098;Pasagėlė;PABIRUČIŲ;6429160371;Taip;9;0;2;11
7099;Pasaka;Drugelių;94297031036;Taip;0;1;4;5
7100;Pasaka;Drugelių;13636850029;Taip;0;0;1;1
7101;Pasaka;Drugelių;6029722606;Taip;10;0;0;10
7102;Pasaka;Drugelių;1182329854;Taip;0;1;2;3
7103;Pasaka;Drugelių;28436567147;Taip;0;1;8;9
7104;Pasaka;Drugelių;23870813014;Taip;0;1;3;4
7105;Pasaka;Drugelių;9176679994;Taip;5;1;3;9
7106;Pasaka;Drugelių;39078157321;Taip;0;5;7;12
7107;Pasaka;Drugelių;39551214597;Taip;11;0;0;11
7108;Pasaka;Drugelių;12737037014;Taip;5;4;0;9
7109;Pasaka;Drugelių;93787399452;Taip;0;1;0;1
7110;Pasaka;Drugelių;35974582480;Taip;0;1;7;8
7111;Pasaka;Drugelių;27093500070;Taip;0;7;7;14
7112;Pasaka;Drugelių;33026273567;Taip;5;1;0;6
7113;Pasaka;Drugelių;28874215183;Taip;11;0;1;12
7114;Pasaka;Drugelių;70534119238;Taip;15;0;0;15
7115;Pasaka;Drugelių;63580854012;Taip;16;0;0;16
7116;Pasaka;Nykštukų;71026394541;Taip;14;0;0;14
7117;Pasaka;Nykštukų;93130495054;Taip;8;0;0;8
7118;Pasaka;Nykštukų;57075224058;Taip;0;2;0;2
7119;Pasaka;Nykštukų;2063660647;Taip;5;0;0;5
7120;Pasaka;Nykštukų;18135410695;Taip;20;0;0;20
7121;Pasaka;Nykštukų;37149227316;Taip;0;2;1;3
7122;Pasaka;Nykštukų;44488699090;Taip;6;2;0;8
7123;Pasaka;Nykštukų;1386420328;Taip;0;0;4;4
7124;Pasaka;Nykštukų;27770796692;Taip;10;0;0;10
7125;Pasaka;Nykštukų;5459272292;Taip;0;2;2;4
7126;Pasaka;Nykštukų;5665758011;Taip;3;0;0;3
7127;Pasaka;Nykštukų;1237568934;Taip;3;1;0;4
7128;Pasaka;Nykštukų;91546084785;Taip;0;2;5;7
7129;Pasaka;Nykštukų;7040953491;Taip;15;0;0;15
7130;Pasaka;Nykštukų;1333499160;Taip;11;1;0;12
7131;Pasaka;Nykštukų;66315088164;Taip;2;2;1;5
7132;Pasaka;Nykštukų;3088081091;Taip;0;2;0;2
7133;Pasaka;Nykštukų;6893044575;Taip;2;0;0;2
7134;Pasaka;Nykštukų;4071643754;Taip;2;0;0;2
7135;Pasaka;Montesori;22952446246;Taip;9;0;1;10
7136;Pasaka;Montesori;4130774501;Taip;11;0;0;11
7137;Pasaka;Montesori;93485300003;Taip;10;1;0;11
7138;Pasaka;Montesori;67492634520;Taip;12;0;0;12
7139;Pasaka;Montesori;56974315820;Taip;20;0;0;20
7140;Pasaka;Montesori;31094198532;Taip;0;4;0;4
7141;Pasaka;Montesori;65118883315;Taip;16;0;0;16
7142;Pasaka;Montesori;50242777961;Taip;3;6;0;9
7143;Pasaka;Montesori;88392698583;Taip;20;0;0;20
7144;Pasaka;Montesori;49914586879;Taip;5;0;0;5
7145;Pasaka;Montesori;17561742498;Taip;10;0;1;11
7146;Pasaka;Montesori;47000824102;Taip;0;4;1;5
7147;Pasaka;Montesori;42973327518;Taip;6;0;0;6
7148;Pasaka;Montesori;31880975983;Taip;10;0;1;11
7149;Pasaka;Montesori;90472847444;Taip;1;4;1;6
7150;Pasaka;Montesori;17311912868;Taip;5;4;0;9
7151;Pasaka;Montesori;69250064506;Taip;5;0;5;10
7152;Pasaka;Montesori;81598865451;Taip;13;0;0;13
7153;Pasaka;Montesori;1564467627;Taip;6;2;0;8
7154;Pasaka;Montesori;7016077429;Taip;0;2;5;7
7155;Pasaka;Montesori;39319539842;Taip;12;0;0;12
7156;Pasaka;Montesori;16974081144;Taip;20;0;0;20
7157;Pasaka;Montesori;1514381003;Taip;16;0;0;16
7158;Pasaka;Montesori;93994995081;Taip;14;0;0;14
7159;Pasaka;Montesori;1961712475;Taip;5;1;0;6
7160;Pasaka;Montesori;5812041166;Taip;7;0;0;7
7161;Pasaka;Montesori;4305485747;Taip;6;0;0;6
7162;Pasaka;Žirniukų;17931259433;Taip;0;0;2;2
7163;Pasaka;Žirniukų;9722435751;Taip;5;1;0;6
7164;Pasaka;Žirniukų;7648503006;Taip;0;0;12;12
7165;Pasaka;Žirniukų;2697014098;Taip;5;0;0;5
7166;Pasaka;Žirniukų;73703706115;Taip;17;0;0;17
7167;Pasaka;Žirniukų;2018620389;Taip;7;0;0;7
7168;Pasaka;Žirniukų;6441884677;Taip;11;0;0;11
7169;Pasaka;Žirniukų;5651452381;Taip;14;0;0;14
7170;Pasaka;Žirniukų;1720511696;Taip;8;0;1;9
7171;Pasaka;Žirniukų;1836826810;Taip;10;0;0;10
7172;Pasaka;Žirniukų;1826743229;Taip;0;0;4;4
7173;Pasaka;Žirniukų;9560190761;Taip;0;0;4;4
7174;Pasaka;Žirniukų;7286419663;Taip;2;0;4;6
7175;Pasaka;Žirniukų;2788679885;Taip;10;2;0;12
7176;Pasaka;Žirniukų;6378803142;Taip;14;0;1;15
7177;Pasaka;Žirniukų;7441310161;Taip;14;0;1;15
7178;Pasaka;Žirniukų;1565873178;Taip;0;2;9;11
7179;Pasaka;Žirniukų;7445696309;Taip;0;2;0;2
7180;Pasaka;Žirniukų;2400455036;Taip;8;0;1;9
7181;Pasaka;Žirniukų;79170702319;Taip;6;0;3;9
7182;Pasaka;"Voveriukų ";15051078156;Taip;0;2;0;2
7183;Pasaka;"Voveriukų ";50319234551;Taip;8;0;3;11
7184;Pasaka;"Voveriukų ";15500820772;Taip;13;0;0;13
7185;Pasaka;"Voveriukų ";12951124853;Taip;5;14;0;19
7186;Pasaka;"Voveriukų ";53523660848;Taip;0;2;0;2
7187;Pasaka;"Voveriukų ";89376142045;Taip;5;6;2;13
7188;Pasaka;"Voveriukų ";1188769609;Taip;5;0;0;5
7189;Pasaka;"Voveriukų ";13944030346;Taip;5;2;0;7
7190;Pasaka;"Voveriukų ";52135673503;Taip;7;0;0;7
7191;Pasaka;"Voveriukų ";59491538033;Taip;0;2;0;2
7192;Pasaka;"Voveriukų ";20358771509;Taip;5;1;0;6
7193;Pasaka;"Voveriukų ";94514447596;Taip;0;6;0;6
7194;Pasaka;"Voveriukų ";35718732394;Taip;15;4;0;19
7195;Pasaka;"Voveriukų ";71316589358;Taip;9;0;0;9
7196;Pasaka;"Voveriukų ";4344243194;Taip;12;2;0;14
7197;Pasaka;"Voveriukų ";8122815158;Taip;0;5;1;6
7198;Pasaka;"Voveriukų ";1719236931;Taip;0;0;3;3
7199;Pasaka;"Voveriukų ";1257775317;Taip;5;1;0;6
7200;Pasaka;"Voveriukų ";1268530885;Taip;10;0;1;11
7201;Pasaka;"VALDOFRO 12";7865658875;Taip;5;5;0;10
7202;Pasaka;"VALDOFRO 12";2141354232;Taip;10;4;0;14
7203;Pasaka;"VALDOFRO 12";4271029223;Taip;9;0;0;9
7204;Pasaka;"VALDOFRO 12";49627576872;Taip;10;1;2;13
7205;Pasaka;"VALDOFRO 12";75591036061;Taip;0;1;1;2
7206;Pasaka;"VALDOFRO 12";8042135600;Taip;0;4;1;5
7207;Pasaka;"VALDOFRO 12";20521208273;Taip;5;3;2;10
7208;Pasaka;"VALDOFRO 12";73057603223;Taip;6;0;0;6
7209;Pasaka;"VALDOFRO 12";95288167171;Taip;10;4;0;14
7210;Pasaka;"VALDOFRO 12";40698629247;Taip;6;0;1;7
7211;Pasaka;"VALDOFRO 12";72287065055;Ne;7;0;0;7
7212;Pasaka;"VALDOFRO 12";77282670444;Taip;10;0;1;11
7213;Pasaka;"VALDOFRO 12";22557231904;Taip;0;6;5;11
7214;Pasaka;"VALDOFRO 12";3367120837;Taip;3;0;8;11
7215;Pasaka;"VALDOFRO 12";7010681103;Taip;4;8;0;12
7216;Pasaka;"VALDOFRO 12";1155273197;Taip;3;8;1;12
7217;Pasaka;"VALDOFRO 12";56766427323;Taip;5;0;0;5
7218;Pasaka;"VALDOFRO 12";4680456848;Taip;2;4;0;6
7219;Pasaka;"VALDOFRO 12";5141156728;Taip;10;0;1;11
7220;Pasaka;"VALDORFO 2";34612155918;Taip;0;5;5;10
7221;Pasaka;"VALDORFO 2";48295303497;Taip;1;4;0;5
7222;Pasaka;"VALDORFO 2";1397972532;Taip;0;0;5;5
7223;Pasaka;"VALDORFO 2";27035873367;Taip;0;0;6;6
7224;Pasaka;"VALDORFO 2";27496232796;Taip;0;7;1;8
7225;Pasaka;"VALDORFO 2";95494862542;Taip;14;0;0;14
7226;Pasaka;"VALDORFO 2";25283698668;Taip;0;4;2;6
7227;Pasaka;"VALDORFO 2";42294285713;Taip;0;1;0;1
7228;Pasaka;"VALDORFO 2";50030735612;Taip;0;1;0;1
7229;Pasaka;"VALDORFO 2";80814715752;Taip;0;4;0;4
7230;Pasaka;"VALDORFO 2";15760212135;Taip;0;2;0;2
7231;Pasaka;"VALDORFO 2";61077353229;Taip;0;2;1;3
7232;Pasaka;"VALDORFO 2";2077818693;Taip;0;1;2;3
7233;Pasaka;"VALDORFO 2";1741935840;Taip;7;0;7;14
7234;Pasaka;"VALDORFO 2";77904202630;Taip;0;4;0;4
7235;Pasaka;"VALDORFO 2";4752117533;Taip;0;0;1;1
7236;Pasaka;"VALDORFO 2";7432241898;Taip;0;4;2;6
7237;Pasaka;"VALDORFO 2";10616073718;Taip;0;6;0;6
7238;Pasaka;"VALDORFO 2";8590385693;Taip;2;0;0;2
7239;Pasaka;Gudručiai;39815814046;Taip;0;0;1;1
7240;Pasaka;Gudručiai;92877021972;Taip;0;2;0;2
7241;Pasaka;Gudručiai;81610725511;Taip;5;0;0;5
7242;Pasaka;Gudručiai;48750144608;Taip;0;1;0;1
7243;Pasaka;Gudručiai;30111718221;Taip;0;0;1;1
7244;Pasaka;Gudručiai;1291936607;Taip;0;3;0;3
7245;Pasaka;Gudručiai;49342277188;Taip;11;1;0;12
7246;Pasaka;Gudručiai;79187482503;Taip;7;1;3;11
7247;Pasaka;Gudručiai;36316289275;Taip;0;5;1;6
7248;Pasaka;Gudručiai;55650091777;Taip;0;4;0;4
7249;Pasaka;Gudručiai;74752546806;Taip;0;6;0;6
7250;Pasaka;Gudručiai;21863319299;Taip;0;4;0;4
7251;Pasaka;Gudručiai;65228168263;Taip;0;0;2;2
7252;Pasaka;Gudručiai;15867940757;Taip;0;19;0;19
7253;Pasaka;Gudručiai;91855873214;Taip;0;5;2;7
7254;Pasaka;Gudručiai;35413730712;Taip;0;1;0;1
7255;Pasaka;Gudručiai;19883430399;Taip;0;0;1;1
7256;Pasaka;Gudručiai;46628468146;Taip;0;1;0;1
7257;Pasaka;Gudručiai;1117608861;Taip;11;0;0;11
7258;Pasaka;Bitelių;76899232405;Taip;0;5;0;5
7259;Pasaka;Bitelių;8821776109;Taip;0;2;1;3
7260;Pasaka;Bitelių;45184972933;Taip;4;0;0;4
7261;Pasaka;Bitelių;29836649248;Taip;11;0;0;11
7262;Pasaka;Bitelių;76560015870;Taip;6;0;2;8
7263;Pasaka;Bitelių;78517147252;Taip;10;2;0;12
7264;Pasaka;Bitelių;45850914548;Taip;0;15;0;15
7265;Pasaka;Bitelių;55254934245;Taip;0;5;0;5
7266;Pasaka;Bitelių;4895994309;Taip;0;0;1;1
7267;Pasaka;Bitelių;64143651711;Taip;2;0;1;3
7268;Pasaka;Bitelių;96080851386;Taip;1;1;0;2
7269;Pasaka;Bitelių;62051806386;Taip;5;5;0;10
7270;Pasaka;Bitelių;80567536745;Taip;0;2;1;3
7271;Pasaka;Bitelių;52667398476;Taip;5;0;0;5
7272;Pasaka;Bitelių;53151161817;Taip;10;1;0;11
7273;Pasaka;Bitelių;97012371435;Taip;0;15;0;15
7274;Pasaka;Bitelių;40182594961;Taip;0;1;1;2
7275;Pasaka;Bitelių;14080980324;Taip;14;0;0;14
7276;Pasaka;Bitelių;17537343699;Taip;10;10;0;20
7277;Pasaka;Bitelių;72878659455;Taip;0;4;0;4
7278;Pasaka;Bitelių;91499940063;Taip;0;1;0;1
7279;Pasaka;"Pabiručių ";6868519179;Taip;0;0;2;2
7280;Pasaka;"Pabiručių ";5351364328;Taip;0;0;19;19
7281;Pasaka;"Pabiručių ";4635912654;Taip;0;0;19;19
7282;Pasaka;"Pabiručių ";8132829016;Taip;5;0;4;9
7283;Pasaka;"Pabiručių ";8651165520;Taip;5;0;4;9
7284;Pasaka;"Pabiručių ";5371046207;Taip;6;0;4;10
7285;Pasaka;"Pabiručių ";4137222204;Taip;5;0;1;6
7286;Pasaka;"Pabiručių ";7103485358;Taip;3;0;0;3
7287;Pasaka;"Pabiručių ";7248640367;Taip;9;4;0;13
7288;Pasaka;"Pabiručių ";8277245475;Taip;0;0;1;1
7289;Pasaka;"Pabiručių ";5723970763;Taip;20;0;0;20
7290;Pasaka;"Pabiručių ";9136521759;Taip;11;0;0;11
7291;Pasaka;"Pabiručių ";8119086492;Taip;19;0;0;19
7292;Pasaka;Šnekučių;31896116591;Taip;10;0;1;11
7293;Pasaka;Šnekučių;36716138833;Taip;6;0;0;6
7294;Pasaka;Šnekučių;49626651411;Taip;10;0;0;10
7295;Pasaka;Šnekučių;9549799936;Taip;15;0;0;15
7296;Pasaka;Šnekučių;34897359060;Taip;9;0;0;9
7297;Pasaka;Šnekučių;52912333520;Taip;2;0;4;6
7298;Pasaka;Šnekučių;49520139946;Taip;17;0;0;17
7299;Pasaka;Šnekučių;8744626237;Taip;0;0;1;1
7300;Pasaka;Šnekučių;9973758979;Taip;7;0;0;7
7301;Pasaka;Šnekučių;1693530160;Taip;10;0;1;11
7302;Pasaka;Šnekučių;62303770229;Taip;2;0;2;4
7303;Pasaka;Šnekučių;23132755276;Taip;5;1;5;11
7304;Pasaka;Šnekučių;7082166681;Taip;17;0;0;17
7305;Pasaka;Šnekučių;8615661704;Taip;0;2;0;2
7306;Pasaka;Šnekučių;4178679491;Taip;0;2;0;2
7307;Pasaka;Šnekučių;56983167265;Taip;0;0;11;11
7308;Pasaka;Šnekučių;5021568651;Taip;11;0;0;11
7309;Pasaka;Šnekučių;50456063454;Taip;10;0;0;10
7310;Pasaka;Šnekučių;10055061537;Taip;11;0;3;14
7311;Pasaka;Šnekučių;51500606207;Taip;13;0;1;14
7312;Paslaptis;Priešmokyklinė;62476103195;Taip;7;6;2;15
7313;Paslaptis;Priešmokyklinė;8052295537;Taip;0;1;0;1
7314;Paslaptis;Priešmokyklinė;9611990012;Taip;9;0;0;9
7315;Paslaptis;Priešmokyklinė;50274794824;Taip;20;0;0;20
7316;Paslaptis;Priešmokyklinė;26977991466;Taip;0;1;0;1
7317;Paslaptis;Priešmokyklinė;61247199871;Taip;11;0;0;11
7318;Paslaptis;Priešmokyklinė;16224875313;Taip;17;0;2;19
7319;Paslaptis;Priešmokyklinė;68726419200;Taip;0;1;4;5
7320;Paslaptis;Priešmokyklinė;60268283772;Taip;9;1;0;10
7321;Paslaptis;Priešmokyklinė;1828914082;Taip;14;1;0;15
7322;Paslaptis;Priešmokyklinė;1259942408;Taip;0;8;3;11
7323;Paslaptis;Priešmokyklinė;1667818122;Taip;9;3;1;13
7324;Paslaptis;Priešmokyklinė;1128775055;Taip;20;0;0;20
7325;Paslaptis;Priešmokyklinė;36229769543;Taip;5;0;0;5
7326;Paslaptis;Priešmokyklinė;87862241593;Taip;0;9;1;10
7327;Paslaptis;Priešmokyklinė;1677007836;Taip;9;0;0;9
7328;Paslaptis;Priešmokyklinė;1982955007;Ne;9;0;0;9
7329;Paslaptis;Priešmokyklinė;1273662366;Taip;2;3;0;5
7330;Paslaptis;Priešmokyklinė;99228588629;Taip;16;1;0;17
7331;Paslaptis;Priešmokyklinė;57773958059;Taip;7;3;1;11
7332;Paslaptis;Priešmokyklinė;73547132372;Taip;9;0;0;9
7333;Paslaptis;Priešmokyklinė;69704103686;Taip;15;1;0;16
7334;Paslaptis;Priešmokyklinė;18629473292;Taip;15;0;1;16
7335;Paslaptis;Priešmokyklinė;1445974659;Taip;9;0;0;9
7336;Paslaptis;Priešmokyklinė;2578713065;Ne;0;15;5;20
7337;Paslaptis;"Darželio mišraus amžiaus grupė";8522925854;Taip;11;3;0;14
7338;Paslaptis;"Darželio mišraus amžiaus grupė";1868248793;Taip;0;9;0;9
7339;Paslaptis;"Darželio mišraus amžiaus grupė";1950287365;Taip;13;0;0;13
7340;Paslaptis;"Darželio mišraus amžiaus grupė";1530380043;Taip;6;1;0;7
7341;Paslaptis;"Darželio mišraus amžiaus grupė";1938288335;Taip;6;1;0;7
7342;Paslaptis;"Darželio mišraus amžiaus grupė";1127602652;Taip;9;0;0;9
7343;Paslaptis;"Darželio mišraus amžiaus grupė";40283689721;Taip;5;5;0;10
7344;Paslaptis;"Darželio mišraus amžiaus grupė";4731417201;Taip;13;0;0;13
7345;Paslaptis;"Darželio mišraus amžiaus grupė";3461773781;Taip;14;1;0;15
7346;Paslaptis;"Darželio mišraus amžiaus grupė";5790420711;Taip;4;0;0;4
7347;Paslaptis;"Darželio mišraus amžiaus grupė";2256130191;Taip;1;0;0;1
7348;Paslaptis;"Darželio mišraus amžiaus grupė";1610171462;Taip;1;0;0;1
7349;Paslaptis;"Darželio mišraus amžiaus grupė";1195616749;Taip;4;1;5;10
7350;Paslaptis;"Darželio mišraus amžiaus grupė";4674623065;Taip;0;1;0;1
7351;Paslaptis;"Darželio mišraus amžiaus grupė";6375966771;Taip;9;3;0;12
7352;Paslaptis;"Darželio mišraus amžiaus grupė";2474900044;Taip;3;0;0;3
7353;Paslaptis;"Darželio mišraus amžiaus grupė";3170216428;Taip;5;0;0;5
7354;Paslaptis;"Darželio mišraus amžiaus grupė";3093280943;Taip;6;0;0;6
7355;Paslaptis;"Darželio mišraus amžiaus grupė";9559318660;Taip;0;1;0;1
7356;Paslaptis;"Darželio mišraus amžiaus grupė";2705751628;Taip;6;0;0;6
7357;Paslaptis;"Darželio mišraus amžiaus grupė";8280740387;Taip;15;0;0;15
7358;Paslaptis;"Darželio mišraus amžiaus grupė";2891547963;Taip;11;1;0;12
7359;Paslaptis;"Darželio mišraus amžiaus grupė";3415869190;Taip;9;1;0;10
7360;Paslaptis;"Darželio mišraus amžiaus grupė";1983773762;Taip;5;1;5;11
7361;Paslaptis;"Darželio mišraus amžiaus grupė";5557019619;Taip;7;1;1;9
7362;Paslaptis;"Darželio mišraus amžiaus grupė";1782398974;Taip;9;0;0;9
7363;Paslaptis;"Darželio mišraus amžiaus grupė";4109288950;Taip;5;0;1;6
7364;Paslaptis;"Darželio mišraus amžiaus grupė";8083478190;Taip;7;0;2;9
7365;Paslaptis;"Darželio mišraus amžiaus grupė";2089780119;Taip;11;2;0;13
7366;Paslaptis;"NAUJA (LOPŠELIS)";2879752620;Taip;5;1;1;7
7367;Paslaptis;"NAUJA (LOPŠELIS)";2693910134;Taip;9;0;0;9
7368;Paslaptis;"NAUJA (LOPŠELIS)";8239855620;Taip;9;0;0;9
7369;Paslaptis;"NAUJA (LOPŠELIS)";1033910097;Taip;8;0;0;8
7370;Paslaptis;"NAUJA (LOPŠELIS)";5206529350;Taip;11;0;0;11
7371;Paslaptis;"NAUJA (LOPŠELIS)";5852939221;Taip;7;0;0;7
7372;Paslaptis;"NAUJA (LOPŠELIS)";5456011928;Taip;9;3;0;12
7373;Paslaptis;"NAUJA (LOPŠELIS)";8895770223;Taip;12;0;0;12
7374;Paslaptis;"NAUJA (LOPŠELIS)";5756338103;Taip;13;1;0;14
7375;Paslaptis;"NAUJA (LOPŠELIS)";6131831325;Taip;16;1;0;17
7376;Paslaptis;"NAUJA (LOPŠELIS)";5886364670;Taip;6;0;1;7
7377;Paslaptis;"NAUJA (LOPŠELIS)";7579781779;Taip;6;0;0;6
7378;Paslaptis;"NAUJA (LOPŠELIS)";3844066232;Taip;11;3;0;14
7379;Paslaptis;"NAUJA (LOPŠELIS)";3243226933;Taip;1;0;1;2
7380;Paslaptis;"NAUJA (LOPŠELIS)";3104525540;Taip;20;0;0;20
7381;Paslaptis;"NAUJA (LOPŠELIS)";8146824196;Taip;7;0;1;8
7382;Paslaptis;"NAUJA (LOPŠELIS)";3398729758;Taip;11;0;0;11
7383;Paslaptis;"NAUJA (LOPŠELIS)";2675089401;Taip;12;0;1;13
7384;Pasakaitė;Vieversėlių;70802215290;Taip;0;11;0;11
7385;Pasakaitė;Vieversėlių;82272856075;Taip;0;1;0;1
7386;Pasakaitė;Vieversėlių;23103636206;Taip;9;1;0;10
7387;Pasakaitė;Vieversėlių;48421643700;Taip;0;1;0;1
7388;Pasakaitė;Vieversėlių;94906317709;Taip;9;5;0;14
7389;Pasakaitė;Vieversėlių;41359431347;Taip;13;0;0;13
7390;Pasakaitė;Vieversėlių;725988513;Taip;0;1;0;1
7391;Pasakaitė;Vieversėlių;62372417041;Taip;6;0;0;6
7392;Pasakaitė;Vieversėlių;91751201397;Taip;0;0;9;9
7393;Pasakaitė;Vieversėlių;6909280007;Taip;9;0;0;9
7394;Pasakaitė;Vieversėlių;35147041377;Taip;10;0;0;10
7395;Pasakaitė;Vieversėlių;1631919806;Taip;10;0;1;11
7396;Pasakaitė;Vieversėlių;1696228992;Taip;10;0;1;11
7397;Pasakaitė;Vieversėlių;47661428412;Taip;6;8;0;14
7398;Pasakaitė;Vieversėlių;18419655194;Taip;0;3;2;5
7399;Pasakaitė;Vieversėlių;91109909258;Taip;0;3;0;3
7400;Pasakaitė;Vieversėlių;1917342472;Ne;8;1;0;9
7401;Pasakaitė;Vieversėlių;39926553926;Taip;0;12;0;12
7402;Pasakaitė;Vieversėlių;1139554564;Taip;10;8;0;18
7403;Pasakaitė;Spindulėlių;52127092749;Taip;7;4;3;14
7404;Pasakaitė;Spindulėlių;72232008007;Taip;9;0;5;14
7405;Pasakaitė;Spindulėlių;58071607976;Taip;3;5;7;15
7406;Pasakaitė;Spindulėlių;20667371334;Taip;0;19;0;19
7407;Pasakaitė;Spindulėlių;21284070194;Taip;5;8;2;15
7408;Pasakaitė;Spindulėlių;74253024682;Taip;10;9;1;20
7409;Pasakaitė;Spindulėlių;15644259897;Taip;4;0;0;4
7410;Pasakaitė;Spindulėlių;13787417933;Taip;8;0;0;8
7411;Pasakaitė;Spindulėlių;88951595986;Ne;9;2;0;11
7412;Pasakaitė;Spindulėlių;21872672491;Taip;10;10;0;20
7413;Pasakaitė;Spindulėlių;45451715428;Taip;5;0;0;5
7414;Pasakaitė;Spindulėlių;1381307997;Taip;0;13;0;13
7415;Pasakaitė;Spindulėlių;75361056418;Taip;8;0;0;8
7416;Pasakaitė;Spindulėlių;99890448836;Taip;5;1;1;7
7417;Pasakaitė;Spindulėlių;4680949976;Taip;11;1;0;12
7418;Pasakaitė;Spindulėlių;3734935229;Taip;19;0;0;19
7419;Pasakaitė;Spindulėlių;2523842161;Taip;8;0;0;8
7420;Pasakaitė;Spindulėlių;4267488049;Taip;5;9;3;17
7421;Pasakaitė;Spindulėlių;1523034176;Taip;11;0;0;11
7422;Pasakaitė;Spindulėlių;7152349570;Taip;10;3;0;13
7423;Pasakaitė;Pasagėlių;3165658822;Taip;6;10;0;16
7424;Pasakaitė;Pasagėlių;61230317080;Taip;0;6;0;6
7425;Pasakaitė;Pasagėlių;1740419218;Taip;10;9;0;19
7426;Pasakaitė;Pasagėlių;5378855541;Taip;18;0;1;19
7427;Pasakaitė;Pasagėlių;9680682204;Taip;9;0;0;9
7428;Pasakaitė;Pasagėlių;4703375416;Taip;7;0;0;7
7429;Pasakaitė;Pasagėlių;8466086339;Taip;14;0;0;14
7430;Pasakaitė;Pasagėlių;1019010454;Taip;7;6;0;13
7431;Pasakaitė;Pasagėlių;4959175420;Taip;0;11;0;11
7432;Pasakaitė;Pasagėlių;1144813356;Taip;5;1;0;6
7433;Pasakaitė;Pasagėlių;83018133588;Taip;20;0;0;20
7434;Pasakaitė;Pasagėlių;4013900094;Taip;14;0;0;14
7435;Pasakaitė;Pasagėlių;5605619860;Taip;6;0;0;6
7436;Pasakaitė;Pasagėlių;1791015854;Taip;11;0;0;11
7437;Pasakaitė;Pasagėlių;4591161640;Ne;0;0;5;5
7438;Pasakaitė;Pasagėlių;1707428977;Taip;10;5;0;15
7439;Pasakaitė;Pasagėlių;5467179333;Taip;0;11;0;11
7440;Pasakaitė;Švyturėlių;26826144324;Taip;5;1;0;6
7441;Pasakaitė;Švyturėlių;26485770641;Taip;0;8;0;8
7442;Pasakaitė;Švyturėlių;30460033968;Taip;0;3;0;3
7443;Pasakaitė;Švyturėlių;39762990812;Taip;0;0;3;3
7444;Pasakaitė;Švyturėlių;24235494284;Taip;6;0;1;7
7445;Pasakaitė;Švyturėlių;74338375162;Taip;5;4;2;11
7446;Pasakaitė;Švyturėlių;83737263199;Taip;9;0;1;10
7447;Pasakaitė;Švyturėlių;56474981516;Taip;8;0;3;11
7448;Pasakaitė;Švyturėlių;24096031951;Taip;0;4;1;5
7449;Pasakaitė;Švyturėlių;11001677712;Taip;0;0;4;4
7450;Pasakaitė;Švyturėlių;9914689534;Taip;9;0;1;10
7451;Pasakaitė;Švyturėlių;75785125455;Taip;0;0;4;4
7452;Pasakaitė;Švyturėlių;88077831193;Taip;8;0;0;8
7453;Pasakaitė;Švyturėlių;73957497029;Taip;5;0;0;5
7454;Pasakaitė;Švyturėlių;1070409611;Taip;6;6;0;12
7455;Pasakaitė;Švyturėlių;1159523006;Taip;14;0;0;14
7456;Pasakaitė;Švyturėlių;5436985035;Taip;8;1;0;9
7457;Pasakaitė;Švyturėlių;1627102470;Taip;10;0;0;10
7458;Pasakaitė;Švyturėlių;4008826950;Taip;10;7;0;17
7459;Pasakaitė;Švyturėlių;32235101944;Taip;5;0;0;5
7460;Pasakaitė;Kodėlčiukų;82138492327;Taip;5;3;0;8
7461;Pasakaitė;Kodėlčiukų;94317654094;Taip;0;4;0;4
7462;Pasakaitė;Kodėlčiukų;1121139222;Ne;0;0;14;14
7463;Pasakaitė;Kodėlčiukų;2017823264;Taip;4;0;0;4
7464;Pasakaitė;Kodėlčiukų;72093762601;Taip;6;0;1;7
7465;Pasakaitė;Kodėlčiukų;11006810461;Taip;17;0;0;17
7466;Pasakaitė;Kodėlčiukų;1553678838;Taip;13;0;0;13
7467;Pasakaitė;Kodėlčiukų;1854100959;Taip;0;0;2;2
7468;Pasakaitė;Kodėlčiukų;22071058323;Taip;16;4;0;20
7469;Pasakaitė;Kodėlčiukų;93907096625;Taip;8;0;0;8
7470;Pasakaitė;Kodėlčiukų;6839399035;Taip;0;0;3;3
7471;Pasakaitė;Kodėlčiukų;1809383469;Taip;0;1;0;1
7472;Pasakaitė;Kodėlčiukų;2742595829;Taip;10;0;0;10
7473;Pasakaitė;Kodėlčiukų;1592521766;Taip;0;0;6;6
7474;Pasakaitė;Kodėlčiukų;6983619733;Taip;6;0;0;6
7475;Pasakaitė;Kodėlčiukų;5313360864;Taip;4;0;0;4
7476;Pasakaitė;Kodėlčiukų;9506178305;Taip;13;0;1;14
7477;Pasakaitė;Gudručių;85389647155;Taip;12;1;0;13
7478;Pasakaitė;Gudručių;89807086522;Taip;11;1;1;13
7479;Pasakaitė;Gudručių;25228014112;Taip;0;2;6;8
7480;Pasakaitė;Gudručių;61088864114;Taip;5;1;1;7
7481;Pasakaitė;Gudručių;31076632547;Taip;0;8;0;8
7482;Pasakaitė;Gudručių;29112724120;Taip;0;2;0;2
7483;Pasakaitė;Gudručių;1175881877;Ne;9;0;2;11
7484;Pasakaitė;Gudručių;96876687235;Taip;0;4;9;13
7485;Pasakaitė;Gudručių;76810884215;Taip;0;3;1;4
7486;Pasakaitė;Gudručių;89036969556;Taip;9;0;1;10
7487;Pasakaitė;Gudručių;44876121501;Taip;0;0;3;3
7488;Pasakaitė;Gudručių;28194608955;Taip;0;5;0;5
7489;Pasakaitė;Gudručių;68762624079;Taip;0;4;1;5
7490;Pasakaitė;Gudručių;36916241082;Ne;3;1;0;4
7491;Pasakaitė;Gudručių;62505201993;Taip;10;0;0;10
7492;Pasakaitė;Gudručių;64811535115;Taip;11;1;2;14
7493;Pasakaitė;Gudručių;13548717757;Taip;0;3;0;3
7494;Pasakaitė;Gudručių;38485750316;Taip;3;4;0;7
7495;Pasakaitė;Gudručių;80929303402;Taip;0;7;0;7
7496;Pasakaitė;Gudručių;31971771240;Taip;15;0;0;15
7497;Pasakaitė;Gudručių;81509638417;Ne;0;4;7;11
7498;Pasakaitė;Gudručių;2031899743;Taip;0;8;0;8
7499;Pasakaitė;Čiulbonėlių;18107086294;Taip;0;12;0;12
7500;Pasakaitė;Čiulbonėlių;5414310905;Taip;5;1;0;6
7501;Pasakaitė;Čiulbonėlių;81406378986;Taip;5;4;0;9
7502;Pasakaitė;Čiulbonėlių;61216378563;Taip;8;0;0;8
7503;Pasakaitė;Čiulbonėlių;52612577074;Taip;16;4;0;20
7504;Pasakaitė;Čiulbonėlių;55594674308;Taip;6;0;0;6
7505;Pasakaitė;Čiulbonėlių;4889157048;Taip;0;0;1;1
7506;Pasakaitė;Čiulbonėlių;1827896757;Taip;3;0;1;4
7507;Pasakaitė;Čiulbonėlių;61297377425;Ne;0;20;0;20
7508;Pasakaitė;Čiulbonėlių;20868624857;Taip;0;1;3;4
7509;Pasakaitė;Čiulbonėlių;55779894463;Taip;0;1;0;1
7510;Pasakaitė;Čiulbonėlių;90096913388;Taip;0;7;0;7
7511;Pasakaitė;Čiulbonėlių;26218072375;Taip;8;7;2;17
7512;Pasakaitė;Čiulbonėlių;98801528286;Taip;10;0;0;10
7513;Pasakaitė;Čiulbonėlių;52200664190;Taip;0;0;11;11
7514;Pasakaitė;Čiulbonėlių;1135448504;Taip;0;3;8;11
7515;Pasakaitė;Čiulbonėlių;1801321757;Taip;0;3;0;3
7516;Pasakaitė;"Verpstelių ";12092268542;Taip;6;2;0;8
7517;Pasakaitė;"Verpstelių ";62677241195;Taip;0;6;2;8
7518;Pasakaitė;"Verpstelių ";600641021;Taip;4;7;0;11
7519;Pasakaitė;"Verpstelių ";26031226748;Taip;5;4;0;9
7520;Pasakaitė;"Verpstelių ";1407277414;Taip;0;0;5;5
7521;Pasakaitė;"Verpstelių ";17218793370;Taip;1;15;4;20
7522;Pasakaitė;"Verpstelių ";33418184802;Taip;0;0;6;6
7523;Pasakaitė;"Verpstelių ";46873849992;Taip;7;2;0;9
7524;Pasakaitė;"Verpstelių ";96648719544;Taip;0;11;0;11
7525;Pasakaitė;"Verpstelių ";82475369612;Taip;0;5;0;5
7526;Pasakaitė;"Verpstelių ";51040024089;Taip;15;0;0;15
7527;Pasakaitė;"Verpstelių ";88885227604;Taip;0;8;0;8
7528;Pasakaitė;"Verpstelių ";5954676615;Taip;0;0;3;3
7529;Pasakaitė;"Verpstelių ";1270179754;Taip;6;0;0;6
7530;Pasakaitė;"Verpstelių ";2210519019;Taip;11;0;0;11
7531;Pasakaitė;"Verpstelių ";18105216772;Taip;0;3;0;3
7532;Pasakaitė;"Verpstelių ";50537059387;Taip;0;0;7;7
7533;Pasakaitė;"Verpstelių ";29699532850;Taip;6;7;0;13
7534;Pasakaitė;Smalsučiai;7685647972;Taip;10;0;3;13
7535;Pasakaitė;Smalsučiai;7963057831;Taip;7;0;0;7
7536;Pasakaitė;Smalsučiai;7020773169;Taip;20;0;0;20
7537;Pasakaitė;Smalsučiai;5948958906;Taip;5;0;1;6
7538;Pasakaitė;Smalsučiai;3231283338;Taip;10;1;0;11
7539;Pasakaitė;Smalsučiai;5455278072;Taip;9;0;0;9
7540;Pasakaitė;Smalsučiai;9543991684;Taip;8;1;0;9
7541;Pasakaitė;Smalsučiai;3778906698;Taip;7;12;0;19
7542;Pasakaitė;Smalsučiai;3541877287;Taip;9;0;1;10
7543;Pasakaitė;Smalsučiai;3680596008;Taip;13;0;0;13
7544;Pasakaitė;Smalsučiai;5628746801;Taip;8;1;1;10
7545;Pasakaitė;Smalsučiai;4882856664;Taip;0;0;3;3
7546;Pasakaitė;Smalsučiai;8315840473;Taip;5;5;0;10
7547;Pasakaitė;Smalsučiai;5953162958;Taip;9;0;0;9
7548;Pasakaitė;Smalsučiai;3579498202;Taip;6;5;0;11
7549;Pasakaitė;Smalsučiai;1060914693;Taip;7;0;0;7
7550;Pasakaitė;"Čiauškučiai ";3606601644;Taip;14;1;0;15
7551;Pasakaitė;"Čiauškučiai ";6714500298;Taip;0;16;0;16
7552;Pasakaitė;"Čiauškučiai ";8578521969;Taip;14;0;0;14
7553;Pasakaitė;"Čiauškučiai ";7526264241;Taip;0;6;0;6
7554;Pasakaitė;"Čiauškučiai ";9166649594;Taip;6;0;0;6
7555;Pasakaitė;"Čiauškučiai ";8390366303;Taip;8;0;0;8
7556;Pasakaitė;"Čiauškučiai ";2751828639;Taip;10;0;0;10
7557;Pasakaitė;"Čiauškučiai ";8463220257;Taip;8;0;1;9
7558;Pasakaitė;"Čiauškučiai ";7761162338;Taip;14;0;0;14
7559;Pasakaitė;"Čiauškučiai ";8223662339;Taip;12;0;0;12
7560;Pasakaitė;"Čiauškučiai ";9018830962;Taip;12;0;0;12
7561;Pasakaitė;"Čiauškučiai ";7790937149;Taip;11;0;0;11
7562;Pasakaitė;"Čiauškučiai ";3400305768;Taip;8;0;0;8
7563;Pasakaitė;"Čiauškučiai ";8469043564;Taip;6;0;1;7
7564;Pasakaitė;Pabiručiai;1827070201;Taip;11;1;0;12
7565;Pasakaitė;Pabiručiai;1879865535;Taip;5;0;1;6
7566;Pasakaitė;Pabiručiai;9175612991;Taip;11;0;1;12
7567;Pasakaitė;Pabiručiai;26714845001;Taip;17;0;0;17
7568;Pasakaitė;Pabiručiai;46891856500;Taip;18;0;0;18
7569;Pasakaitė;Pabiručiai;3397132786;Taip;0;12;2;14
7570;Pasakaitė;Pabiručiai;1769070351;Taip;14;0;0;14
7571;Pasakaitė;Pabiručiai;49117693773;Taip;12;0;1;13
7572;Pasakaitė;Pabiručiai;1320898756;Taip;0;5;13;18
7573;Pasakaitė;Pabiručiai;1027136050;Taip;10;0;0;10
7574;Pasakaitė;Pabiručiai;1198248619;Taip;0;6;0;6
7575;Pasakaitė;Pabiručiai;1595057434;Taip;9;3;0;12
7576;Pasakaitė;Pabiručiai;1032113089;Taip;4;0;4;8
7577;Pasakaitė;Pabiručiai;21252086256;Taip;10;5;0;15
7578;Pasakaitė;Pabiručiai;6134483994;Taip;14;4;0;18
7579;Pasakaitė;Pabiručiai;1673576868;Taip;0;12;5;17
7580;Pasakaitė;Pabiručiai;2017275984;Taip;9;0;0;9
7581;Pasakaitė;Pabiručiai;27702516199;Taip;0;0;10;10
7582;Pasakaitė;Pabiručiai;6346678827;Ne;0;0;15;15
7583;Pelenė;Varpelis;69242277342;Taip;0;3;0;3
7584;Pelenė;Varpelis;59921559091;Taip;0;0;1;1
7585;Pelenė;Varpelis;54232015265;Taip;5;2;0;7
7586;Pelenė;Varpelis;62426432001;Taip;0;4;3;7
7587;Pelenė;Varpelis;2029929226;Taip;8;1;0;9
7588;Pelenė;Varpelis;8311474428;Taip;5;11;0;16
7589;Pelenė;Varpelis;8189960936;Taip;3;6;1;10
7590;Pelenė;Varpelis;37922275946;Taip;0;9;0;9
7591;Pelenė;Varpelis;62172213063;Taip;6;1;0;7
7592;Pelenė;Varpelis;93009343319;Taip;3;0;0;3
7593;Pelenė;Varpelis;72752022712;Taip;0;16;0;16
7594;Pelenė;Varpelis;22762248459;Taip;8;1;0;9
7595;Pelenė;Varpelis;70438374608;Taip;0;12;0;12
7596;Pelenė;Varpelis;17746532458;Taip;0;4;0;4
7597;Pelenė;Varpelis;6533433685;Taip;0;11;0;11
7598;Pelenė;Varpelis;59795549508;Taip;0;7;0;7
7599;Pelenė;Varpelis;1072148409;Taip;0;0;5;5
7600;Pelenė;Varpelis;83359560510;Taip;0;4;0;4
7601;Pelenė;Saulutės;99521206531;Taip;0;7;0;7
7602;Pelenė;Saulutės;59732999282;Taip;8;0;0;8
7603;Pelenė;Saulutės;99849461351;Taip;0;3;0;3
7604;Pelenė;Saulutės;4233272418;Taip;12;0;0;12
7605;Pelenė;Saulutės;55808304356;Taip;6;0;0;6
7606;Pelenė;Saulutės;12170216844;Taip;0;5;0;5
7607;Pelenė;Saulutės;1321060587;Taip;5;0;3;8
7608;Pelenė;Saulutės;11671895181;Taip;3;0;0;3
7609;Pelenė;Saulutės;24547508796;Ne;8;0;0;8
7610;Pelenė;Saulutės;91433727359;Taip;0;5;0;5
7611;Pelenė;Saulutės;89623266364;Taip;6;0;1;7
7612;Pelenė;Saulutės;72216942887;Taip;0;3;0;3
7613;Pelenė;Saulutės;55937499558;Taip;4;0;0;4
7614;Pelenė;Saulutės;96121315210;Taip;6;0;0;6
7615;Pelenė;Saulutės;78085706850;Taip;5;4;0;9
7616;Pelenė;Saulutės;11924441656;Taip;0;15;0;15
7617;Pelenė;Saulutės;15949989455;Ne;14;4;0;18
7618;Pelenė;Saulutės;53044546376;Taip;9;1;0;10
7619;Pelenė;Saulutės;98221995571;Taip;6;1;4;11
7620;Pelenė;Saulutės;2115021063;Taip;7;5;1;13
7621;Pelenė;Raktelis;85051053863;Taip;5;0;14;19
7622;Pelenė;Raktelis;1356029457;Taip;18;0;0;18
7623;Pelenė;Raktelis;32577488307;Taip;0;6;2;8
7624;Pelenė;Raktelis;3245982902;Taip;10;0;0;10
7625;Pelenė;Raktelis;25108428891;Taip;0;0;1;1
7626;Pelenė;Raktelis;32716320977;Taip;5;2;0;7
7627;Pelenė;Raktelis;1733433768;Taip;3;0;1;4
7628;Pelenė;Raktelis;29587640966;Taip;0;7;0;7
7629;Pelenė;Raktelis;55350714718;Taip;0;0;1;1
7630;Pelenė;Raktelis;62615483649;Taip;0;5;5;10
7631;Pelenė;Raktelis;87207607315;Taip;0;0;1;1
7632;Pelenė;Raktelis;70335326964;Taip;0;2;0;2
7633;Pelenė;Raktelis;1045206373;Taip;0;1;1;2
7634;Pelenė;Raktelis;120966603;Taip;10;3;0;13
7635;Pelenė;Raktelis;534670514;Taip;5;0;0;5
7636;Pelenė;Žvaigždutės;55160554683;Taip;0;0;1;1
7637;Pelenė;Žvaigždutės;33028103211;Taip;7;0;1;8
7638;Pelenė;Žvaigždutės;45687410331;Taip;10;3;0;13
7639;Pelenė;Žvaigždutės;8483195434;Taip;0;8;0;8
7640;Pelenė;Žvaigždutės;66474157416;Taip;9;0;1;10
7641;Pelenė;Žvaigždutės;1793514226;Taip;14;6;0;20
7642;Pelenė;Žvaigždutės;55747365118;Taip;7;0;0;7
7643;Pelenė;Žvaigždutės;12400151337;Taip;10;0;0;10
7644;Pelenė;Žvaigždutės;77504082241;Taip;0;10;0;10
7645;Pelenė;Žvaigždutės;93234992958;Taip;5;0;2;7
7646;Pelenė;Žvaigždutės;2393068606;Taip;9;2;0;11
7647;Pelenė;Žvaigždutės;62544766703;Taip;10;4;0;14
7648;Pelenė;Žvaigždutės;14791621417;Taip;9;0;0;9
7649;Pelenė;Žvaigždutės;43686344645;Ne;0;5;0;5
7650;Pelenė;Žvaigždutės;39850314417;Taip;5;0;1;6
7651;Pelenė;Žvaigždutės;71274664713;Taip;8;0;0;8
7652;Pelenė;Žvaigždutės;1542958753;Taip;10;0;1;11
7653;Pelenė;Žvaigždutės;1846536895;Taip;0;14;0;14
7654;Pelenė;Žvaigždutės;1516249890;Taip;5;5;0;10
7655;Pelenė;Žvaigždutės;2147596414;Taip;4;0;0;4
7656;Pelenė;Žvaigždutės;1908166570;Taip;8;0;3;11
7657;Pelenė;Žvaigždutės;1157718969;Taip;15;0;0;15
7658;Pelenė;Žvaigždutės;1599336930;Taip;10;0;2;12
7659;Pelenė;Žvaigždutės;1283843474;Taip;5;1;1;7
7660;Pelenė;Nykštukas;35657264407;Ne;0;0;2;2
7661;Pelenė;Nykštukas;3299454566;Taip;6;0;0;6
7662;Pelenė;Nykštukas;1931857547;Taip;9;0;0;9
7663;Pelenė;Nykštukas;3465518545;Taip;8;0;4;12
7664;Pelenė;Nykštukas;4386060612;Ne;4;0;0;4
7665;Pelenė;Nykštukas;1568123491;Taip;5;0;0;5
7666;Pelenė;Nykštukas;1418000665;Taip;19;0;0;19
7667;Pelenė;Nykštukas;1038583766;Taip;17;0;0;17
7668;Pelenė;Nykštukas;1127657620;Taip;4;5;0;9
7669;Pelenė;Nykštukas;42431378466;Taip;0;7;0;7
7670;Pelenė;Nykštukas;1183026351;Taip;6;0;0;6
7671;Pelenė;Nykštukas;28622286194;Taip;7;0;0;7
7672;Pelenė;Nykštukas;2072863178;Taip;3;2;0;5
7673;Pelenė;Nykštukas;1050272821;Taip;0;8;0;8
7674;Pelenė;Nykštukas;45589326259;Ne;0;0;2;2
7675;Pelenė;Nykštukas;26010775076;Taip;4;3;0;7
7676;Pelenė;Nykštukas;14200374671;Taip;9;1;1;11
7677;Pelenė;Nykštukas;89920419797;Taip;6;2;0;8
7678;Pelenė;Žirniukai;59244146880;Taip;13;1;0;14
7679;Pelenė;Žirniukai;96840961754;Taip;3;6;0;9
7680;Pelenė;Žirniukai;52690820;Taip;5;0;5;10
7681;Pelenė;Žirniukai;43987538343;Taip;11;0;0;11
7682;Pelenė;Žirniukai;1710249888;Taip;8;2;0;10
7683;Pelenė;Žirniukai;78648474464;Taip;16;0;0;16
7684;Pelenė;Žirniukai;86063417321;Taip;0;0;1;1
7685;Pelenė;Žirniukai;61012202440;Taip;0;15;0;15
7686;Pelenė;Žirniukai;4178071578;Taip;0;7;0;7
7687;Pelenė;Žirniukai;45410683361;Taip;8;0;0;8
7688;Pelenė;Žirniukai;34765342495;Taip;0;5;0;5
7689;Pelenė;Žirniukai;5804848640;Taip;5;0;0;5
7690;Pelenė;Žirniukai;8813044848;Taip;4;0;0;4
7691;Pelenė;Žirniukai;1305335939;Taip;0;0;1;1
7692;Pelenė;Žirniukai;1807037374;Taip;14;0;2;16
7693;Pelenė;Žirniukai;6559830470;Taip;0;0;2;2
7694;Pelenė;Žirniukai;62484999314;Taip;16;0;0;16
7695;Pelenė;Žirniukai;1289416312;Taip;0;0;1;1
7696;Pelenė;Žirniukai;33009702783;Taip;3;0;1;4
7697;Pelenė;Žirniukai;1774912517;Taip;12;0;0;12
7698;Pelenė;Žirniukai;6937587856;Taip;5;3;0;8
7699;Pelenė;Lašeliai;1483843416;Taip;0;20;0;20
7700;Pelenė;Lašeliai;2677995903;Taip;10;0;0;10
7701;Pelenė;Lašeliai;6181604926;Taip;0;0;1;1
7702;Pelenė;Lašeliai;2092775878;Taip;0;6;0;6
7703;Pelenė;Lašeliai;10457480694;Taip;9;0;0;9
7704;Pelenė;Lašeliai;9584503078;Taip;11;0;0;11
7705;Pelenė;Lašeliai;7589978427;Taip;0;2;0;2
7706;Pelenė;Lašeliai;8721423900;Taip;11;9;0;20
7707;Pelenė;Lašeliai;3189305906;Taip;0;14;0;14
7708;Pelenė;Lašeliai;7351477901;Taip;6;0;1;7
7709;Pelenė;Lašeliai;8607110629;Taip;5;6;0;11
7710;Pelenė;Lašeliai;7144616734;Taip;9;0;0;9
7711;Pelenė;Lašeliai;8770771520;Taip;6;0;0;6
7712;Pelenė;Lašeliai;1750366978;Taip;0;9;0;9
7713;Pelenė;Lašeliai;8675348688;Taip;0;1;2;3
7714;Pelenė;Lašeliai;1217505164;Taip;11;0;0;11
7715;Pelenė;Lašeliai;7836778389;Taip;0;9;0;9
7716;Pelenė;Lašeliai;1978481168;Taip;7;0;0;7
7717;Pelenė;Lašeliai;3596386480;Taip;0;16;0;16
7718;Pelenė;Lašeliai;7254981715;Ne;0;12;0;12
7719;Pelenė;Lašeliai;6021833025;Taip;5;11;0;16
7720;Pelenė;Lašeliai;7469266085;Taip;9;11;0;20
7721;Pelenė;Lašeliai;3296147024;Taip;0;6;0;6
7722;Pelenė;Grūdelis;88349051367;Taip;0;9;0;9
7723;Pelenė;Grūdelis;38804968295;Taip;2;2;0;4
7724;Pelenė;Grūdelis;83979485459;Taip;3;1;0;4
7725;Pelenė;Grūdelis;27608464415;Ne;3;6;0;9
7726;Pelenė;Grūdelis;60203121022;Taip;10;2;0;12
7727;Pelenė;Grūdelis;71212019568;Taip;5;2;0;7
7728;Pelenė;Grūdelis;86862048784;Taip;3;3;0;6
7729;Pelenė;Grūdelis;8945972016;Taip;0;12;0;12
7730;Pelenė;Grūdelis;98433445604;Taip;10;3;0;13
7731;Pelenė;Grūdelis;52681956071;Taip;1;0;0;1
7732;Pelenė;Grūdelis;67780482788;Taip;0;2;0;2
7733;Pelenė;Grūdelis;96734246902;Taip;7;2;1;10
7734;Pelenė;Grūdelis;45985345611;Taip;9;6;0;15
7735;Pelenė;Grūdelis;23859597260;Taip;3;4;0;7
7736;Pelenė;Grūdelis;28035546865;Taip;0;6;2;8
7737;Pelenė;Grūdelis;44154428944;Taip;4;0;1;5
7738;Pelenė;Grūdelis;67249286878;Taip;5;12;0;17
7739;Pelenė;Grūdelis;34209230034;Taip;4;0;1;5
7740;Pelenė;Grūdelis;82762950191;Taip;8;0;0;8
7741;Pelenė;Grūdelis;12965686122;Taip;0;2;0;2
7742;Pelenė;Braškytė;5325176433;Taip;5;5;0;10
7743;Pelenė;Braškytė;7205437280;Taip;15;0;0;15
7744;Pelenė;Braškytė;9009271610;Taip;0;3;0;3
7745;Pelenė;Braškytė;8916634408;Taip;2;0;1;3
7746;Pelenė;Braškytė;4546285993;Taip;7;0;4;11
7747;Pelenė;Braškytė;3238807604;Taip;0;4;2;6
7748;Pelenė;Braškytė;5063098703;Taip;9;0;0;9
7749;Pelenė;Braškytė;5780697554;Taip;7;0;1;8
7750;Pelenė;Braškytė;6707167720;Taip;0;5;5;10
7751;Pelenė;Braškytė;8466974910;Taip;3;0;0;3
7752;Pelenė;Braškytė;7880284433;Taip;16;0;0;16
7753;Pelenė;Braškytė;9621197758;Taip;0;7;0;7
7754;Pelenė;Braškytė;9195113444;Taip;2;4;0;6
7755;Pelenė;Braškytė;4541391191;Taip;8;0;2;10
7756;Pelenė;Braškytė;6375060159;Taip;6;11;0;17
7757;Pelenė;Braškytė;9218868317;Taip;9;0;0;9
7758;Pelenė;Boružėlės;4624325473;Taip;0;16;0;16
7759;Pelenė;Boružėlės;1336431888;Taip;0;6;0;6
7760;Pelenė;Boružėlės;1533938659;Ne;10;0;6;16
7761;Pelenė;Boružėlės;1114786936;Taip;5;0;0;5
7762;Pelenė;Boružėlės;8404317146;Taip;10;0;1;11
7763;Pelenė;Boružėlės;1781704945;Taip;6;0;0;6
7764;Pelenė;Boružėlės;1140030742;Taip;10;2;0;12
7765;Pelenė;Boružėlės;3497915398;Taip;0;12;0;12
7766;Pelenė;Boružėlės;2154553741;Taip;11;1;0;12
7767;Pelenė;Boružėlės;8598498275;Taip;0;13;0;13
7768;Pelenė;Boružėlės;69721118552;Taip;13;0;0;13
7769;Pelenė;Boružėlės;39705461573;Taip;20;0;0;20
7770;Pelenė;Boružėlės;5356756237;Taip;0;0;1;1
7771;Pelenė;Boružėlės;3131930907;Taip;7;0;0;7
7772;Pelenė;Boružėlės;7172604045;Taip;11;0;1;12
7773;Pelenė;Boružėlės;1067737206;Taip;8;6;0;14
7774;Pelenė;Boružėlės;1775717256;Taip;9;0;0;9
7775;Pelenė;Boružėlės;7587887488;Taip;8;3;0;11
7776;Pelenė;Boružėlės;6459145539;Taip;6;0;1;7
7777;Pelenė;Boružėlės;3419051414;Taip;10;0;1;11
7778;Pelenė;Boružėlės;6632188229;Taip;5;15;0;20
7779;Pelenė;Boružėlės;8716395810;Taip;11;0;0;11
7780;Pelenė;Boružėlės;6191899254;Taip;5;0;0;5
7781;Pelenė;Saldainiukai;2737277656;Taip;15;0;0;15
7782;Pelenė;Saldainiukai;7164790060;Taip;3;1;1;5
7783;Pelenė;Saldainiukai;2647876561;Taip;14;0;0;14
7784;Pelenė;Saldainiukai;8194354176;Taip;5;0;0;5
7785;Pelenė;Saldainiukai;2322908067;Taip;0;20;0;20
7786;Pelenė;Saldainiukai;8239650471;Taip;7;0;0;7
7787;Pelenė;Saldainiukai;3174009848;Taip;6;0;0;6
7788;Pelenė;Saldainiukai;6524101295;Taip;9;0;0;9
7789;Pelenė;Saldainiukai;4376033711;Taip;16;0;0;16
7790;Pelenė;Saldainiukai;6894978459;Taip;11;4;0;15
7791;Pelenė;Saldainiukai;6481466282;Taip;8;0;0;8
7792;Pipiras;EŽIUKAI;12489971559;Taip;5;2;0;7
7793;Pipiras;EŽIUKAI;56241147614;Taip;0;1;0;1
7794;Pipiras;EŽIUKAI;1112327896;Taip;5;4;0;9
7795;Pipiras;EŽIUKAI;24106575180;Taip;20;0;0;20
7796;Pipiras;EŽIUKAI;52968399382;Taip;0;5;0;5
7797;Pipiras;EŽIUKAI;38894447952;Taip;10;5;0;15
7798;Pipiras;EŽIUKAI;24414917430;Taip;0;13;0;13
7799;Pipiras;EŽIUKAI;71881026465;Taip;0;1;2;3
7800;Pipiras;EŽIUKAI;32958963027;Taip;12;0;0;12
7801;Pipiras;EŽIUKAI;95904922548;Taip;11;2;0;13
7802;Pipiras;EŽIUKAI;55466909230;Taip;9;0;4;13
7803;Pipiras;EŽIUKAI;77307352546;Taip;5;4;0;9
7804;Pipiras;EŽIUKAI;53468621826;Taip;9;0;0;9
7805;Pipiras;EŽIUKAI;93498963556;Taip;0;9;0;9
7806;Pipiras;EŽIUKAI;9858798452;Taip;0;1;0;1
7807;Pipiras;EŽIUKAI;22190236403;Taip;0;4;0;4
7808;Pipiras;EŽIUKAI;1213972436;Taip;8;0;0;8
7809;Pipiras;EŽIUKAI;4564046164;Taip;20;0;0;20
7810;Pipiras;EŽIUKAI;35225328018;Taip;0;2;0;2
7811;Pipiras;EŽIUKAI;1129409620;Taip;0;6;0;6
7812;Pipiras;BITUTĖS;20034839935;Taip;0;2;0;2
7813;Pipiras;BITUTĖS;75607109924;Taip;0;1;0;1
7814;Pipiras;BITUTĖS;35376853030;Taip;0;6;0;6
7815;Pipiras;BITUTĖS;96219330294;Taip;0;12;0;12
7816;Pipiras;BITUTĖS;77699420684;Taip;0;11;0;11
7817;Pipiras;BITUTĖS;17828188095;Taip;4;0;0;4
7818;Pipiras;BITUTĖS;61581422755;Taip;10;9;0;19
7819;Pipiras;BITUTĖS;9503515806;Taip;0;11;0;11
7820;Pipiras;BITUTĖS;75297843018;Taip;0;2;0;2
7821;Pipiras;BITUTĖS;81094360294;Taip;6;0;0;6
7822;Pipiras;BITUTĖS;64050236851;Taip;0;4;0;4
7823;Pipiras;BITUTĖS;35448366688;Ne;6;0;0;6
7824;Pipiras;BITUTĖS;89245567171;Taip;0;6;0;6
7825;Pipiras;BITUTĖS;43522302268;Taip;0;4;0;4
7826;Pipiras;BITUTĖS;7501158031;Taip;0;19;0;19
7827;Pipiras;BITUTĖS;35777468660;Taip;4;5;0;9
7828;Pipiras;BITUTĖS;8797825745;Taip;0;6;0;6
7829;Pipiras;BITUTĖS;74448139833;Taip;5;1;0;6
7830;Pipiras;BITUTĖS;66532279326;Taip;0;1;0;1
7831;Pipiras;BITUTĖS;7724903510;Taip;0;3;5;8
7832;Pipiras;NYKŠTUKAI;60655521743;Taip;0;2;0;2
7833;Pipiras;NYKŠTUKAI;45471590000;Taip;3;0;0;3
7834;Pipiras;NYKŠTUKAI;5849366642;Taip;3;2;0;5
7835;Pipiras;NYKŠTUKAI;15927602783;Taip;0;5;0;5
7836;Pipiras;NYKŠTUKAI;56791669968;Taip;0;4;0;4
7837;Pipiras;NYKŠTUKAI;25458692863;Taip;9;1;0;10
7838;Pipiras;NYKŠTUKAI;41412423426;Taip;0;1;0;1
7839;Pipiras;NYKŠTUKAI;32061333461;Taip;0;11;0;11
7840;Pipiras;NYKŠTUKAI;12906419175;Taip;0;12;0;12
7841;Pipiras;NYKŠTUKAI;63803090607;Taip;9;1;0;10
7842;Pipiras;NYKŠTUKAI;72634292284;Taip;9;0;0;9
7843;Pipiras;NYKŠTUKAI;10825133339;Taip;0;2;0;2
7844;Pipiras;NYKŠTUKAI;86812470693;Taip;0;2;0;2
7845;Pipiras;NYKŠTUKAI;66182015590;Taip;0;7;0;7
7846;Pipiras;NYKŠTUKAI;11746912226;Taip;0;5;0;5
7847;Pipiras;NYKŠTUKAI;1017413300;Taip;0;1;0;1
7848;Pipiras;NYKŠTUKAI;1626782165;Taip;0;9;0;9
7849;Pipiras;NYKŠTUKAI;1813200223;Taip;0;8;0;8
7850;Pipiras;PELĖDŽIUKAI;6694920607;Taip;5;4;0;9
7851;Pipiras;PELĖDŽIUKAI;3325511140;Taip;5;4;0;9
7852;Pipiras;PELĖDŽIUKAI;3341850450;Taip;9;0;0;9
7853;Pipiras;PELĖDŽIUKAI;7870521230;Taip;11;0;0;11
7854;Pipiras;PELĖDŽIUKAI;5778300856;Taip;0;8;0;8
7855;Pipiras;PELĖDŽIUKAI;3888552150;Taip;0;1;0;1
7856;Pipiras;PELĖDŽIUKAI;7026118693;Taip;0;6;0;6
7857;Pipiras;PELĖDŽIUKAI;1391682850;Taip;0;6;0;6
7858;Pipiras;PELĖDŽIUKAI;87924002679;Taip;20;0;0;20
7859;Pipiras;PELĖDŽIUKAI;6136423200;Taip;16;0;0;16
7860;Pipiras;PELĖDŽIUKAI;6805620664;Taip;9;0;0;9
7861;Pipiras;PELĖDŽIUKAI;7912217889;Taip;16;0;0;16
7862;Pipiras;PELĖDŽIUKAI;5502001191;Taip;8;0;0;8
7863;Pipiras;PELĖDŽIUKAI;9275905384;Taip;12;0;0;12
7864;Pipiras;PELĖDŽIUKAI;4496076326;Taip;6;0;1;7
7865;Pipiras;PELĖDŽIUKAI;3141822820;Taip;12;2;0;14
7866;Pipiras;PELĖDŽIUKAI;4456861303;Taip;4;0;0;4
7867;Pipiras;PELĖDŽIUKAI;2044498561;Taip;20;0;0;20
7868;Pipiras;PELĖDŽIUKAI;3357866319;Taip;9;1;0;10
7869;Pipiras;DRUGELIAI;41585818819;Taip;16;0;0;16
7870;Pipiras;DRUGELIAI;5577759167;Taip;16;1;0;17
7871;Pipiras;DRUGELIAI;7799786844;Taip;9;0;0;9
7872;Pipiras;DRUGELIAI;2345034928;Taip;15;0;0;15
7873;Pipiras;DRUGELIAI;5014457985;Taip;14;6;0;20
7874;Pipiras;DRUGELIAI;1904376366;Taip;0;10;0;10
7875;Pipiras;DRUGELIAI;1128674099;Taip;3;2;0;5
7876;Pipiras;DRUGELIAI;3422170541;Taip;0;7;0;7
7877;Pipiras;DRUGELIAI;1391958633;Taip;3;4;0;7
7878;Pipiras;DRUGELIAI;3622164823;Taip;1;1;0;2
7879;Pipiras;DRUGELIAI;3008358842;Taip;14;5;0;19
7880;Pipiras;DRUGELIAI;2024777430;Taip;9;3;0;12
7881;Pipiras;DRUGELIAI;4959823035;Taip;5;1;0;6
7882;Pipiras;DRUGELIAI;6339186940;Taip;0;6;0;6
7883;Pipiras;DRUGELIAI;3314276870;Taip;0;2;7;9
7884;Pipiras;DRUGELIAI;5637557921;Taip;5;0;0;5
7885;Pipiras;DRUGELIAI;1050430252;Taip;13;0;0;13
7886;Pipiras;GĖLYTĖS;48059975861;Taip;1;1;0;2
7887;Pipiras;GĖLYTĖS;81335131932;Taip;0;6;0;6
7888;Pipiras;GĖLYTĖS;23377947863;Taip;0;15;0;15
7889;Pipiras;GĖLYTĖS;87831792882;Taip;9;0;0;9
7890;Pipiras;GĖLYTĖS;1417855241;Taip;5;7;0;12
7891;Pipiras;GĖLYTĖS;1791226869;Taip;0;20;0;20
7892;Pipiras;GĖLYTĖS;1077104941;Taip;6;0;0;6
7893;Pipiras;GĖLYTĖS;60652954862;Taip;0;4;0;4
7894;Pipiras;GĖLYTĖS;27808576289;Taip;0;8;0;8
7895;Pipiras;GĖLYTĖS;5114553619;Taip;0;6;0;6
7896;Pipiras;GĖLYTĖS;1780531222;Taip;6;0;0;6
7897;Pipiras;GĖLYTĖS;18211174874;Taip;4;10;0;14
7898;Pipiras;GĖLYTĖS;4246712256;Taip;0;7;0;7
7899;Pipiras;GĖLYTĖS;25000181631;Taip;0;5;0;5
7900;Pipiras;GĖLYTĖS;2473644942;Taip;0;16;0;16
7901;Pipiras;GĖLYTĖS;1650661825;Taip;0;5;0;5
7902;Pipiras;GĖLYTĖS;56822466210;Taip;2;2;0;4
7903;Pipiras;GĖLYTĖS;23663823688;Taip;0;13;0;13
7904;Pipiras;GĖLYTĖS;6481320053;Ne;0;8;0;8
7905;Pipiras;BORUŽĖLĖS;54633757340;Taip;10;5;0;15
7906;Pipiras;BORUŽĖLĖS;68636458010;Taip;0;2;0;2
7907;Pipiras;BORUŽĖLĖS;20456702162;Taip;10;0;0;10
7908;Pipiras;BORUŽĖLĖS;57459408180;Taip;0;16;0;16
7909;Pipiras;BORUŽĖLĖS;7354253729;Taip;0;9;0;9
7910;Pipiras;BORUŽĖLĖS;99551392640;Taip;0;1;0;1
7911;Pipiras;BORUŽĖLĖS;9423015002;Taip;0;12;0;12
7912;Pipiras;BORUŽĖLĖS;68235713574;Taip;4;0;0;4
7913;Pipiras;BORUŽĖLĖS;63605758339;Taip;15;0;0;15
7914;Pipiras;BORUŽĖLĖS;23794561369;Taip;0;9;0;9
7915;Pipiras;BORUŽĖLĖS;46165404909;Taip;0;12;0;12
7916;Pipiras;BORUŽĖLĖS;92764472620;Taip;15;0;0;15
7917;Pipiras;BORUŽĖLĖS;6804964469;Taip;10;0;0;10
7918;Pipiras;BORUŽĖLĖS;81817710888;Taip;0;6;0;6
7919;Pipiras;BORUŽĖLĖS;7448924569;Taip;12;1;0;13
7920;Pipiras;BORUŽĖLĖS;1676986127;Taip;0;1;0;1
7921;Pipiras;BORUŽĖLĖS;1334584865;Taip;10;0;0;10
7922;Pipiras;BORUŽĖLĖS;9673674008;Taip;5;0;0;5
7923;Pipiras;BORUŽĖLĖS;1657721144;Taip;7;0;0;7
7924;Pipiras;BORUŽĖLĖS;6766596656;Taip;0;2;1;3
7925;Pipiras;SKRUZDĖLIUKAI;76840668343;Taip;20;0;0;20
7926;Pipiras;SKRUZDĖLIUKAI;1975780209;Taip;3;2;0;5
7927;Pipiras;SKRUZDĖLIUKAI;50739918812;Ne;5;9;0;14
7928;Pipiras;SKRUZDĖLIUKAI;75153377410;Taip;0;11;0;11
7929;Pipiras;SKRUZDĖLIUKAI;53426269440;Taip;6;1;0;7
7930;Pipiras;SKRUZDĖLIUKAI;7196519583;Taip;0;11;0;11
7931;Pipiras;SKRUZDĖLIUKAI;53180156021;Taip;0;2;0;2
7932;Pipiras;SKRUZDĖLIUKAI;96711811784;Taip;0;18;0;18
7933;Pipiras;SKRUZDĖLIUKAI;85339674885;Taip;0;13;0;13
7934;Pipiras;SKRUZDĖLIUKAI;61166497338;Taip;0;1;0;1
7935;Pipiras;SKRUZDĖLIUKAI;90202583208;Taip;0;9;0;9
7936;Pipiras;SKRUZDĖLIUKAI;84791674090;Ne;0;7;0;7
7937;Pipiras;SKRUZDĖLIUKAI;49361002482;Taip;0;2;0;2
7938;Pipiras;SKRUZDĖLIUKAI;53377928276;Taip;0;6;0;6
7939;Pipiras;SKRUZDĖLIUKAI;57731282074;Taip;0;1;0;1
7940;Pipiras;SKRUZDĖLIUKAI;1450882528;Taip;20;0;0;20
7941;Pipiras;SKRUZDĖLIUKAI;65132324180;Taip;0;6;0;6
7942;Pipiras;SKRUZDĖLIUKAI;1469877916;Taip;0;8;0;8
7943;Pipiras;SKRUZDĖLIUKAI;71790101454;Taip;0;12;0;12
7944;Pipiras;SKRUZDĖLIUKAI;73564428514;Ne;0;9;0;9
7945;Pipiras;ŽVIRBLIUKŲ;80046621658;Taip;20;0;0;20
7946;Pipiras;ŽVIRBLIUKŲ;1232620336;Taip;17;0;0;17
7947;Pipiras;ŽVIRBLIUKŲ;1549121029;Taip;0;2;0;2
7948;Pipiras;ŽVIRBLIUKŲ;37087220885;Taip;0;2;0;2
7949;Pipiras;ŽVIRBLIUKŲ;1700856741;Taip;10;1;0;11
7950;Pipiras;ŽVIRBLIUKŲ;1319863476;Taip;0;11;0;11
7951;Pipiras;ŽVIRBLIUKŲ;1757192919;Taip;8;3;0;11
7952;Pipiras;ŽVIRBLIUKŲ;1417086043;Taip;0;5;0;5
7953;Pipiras;ŽVIRBLIUKŲ;1441590033;Taip;11;2;0;13
7954;Pipiras;ŽVIRBLIUKŲ;3370047940;Taip;15;0;0;15
7955;Pipiras;ŽVIRBLIUKŲ;1008228932;Taip;0;1;0;1
7956;Pipiras;ŽVIRBLIUKŲ;2030665851;Taip;14;0;0;14
7957;Pipiras;ŽVIRBLIUKŲ;1182415963;Taip;0;8;0;8
7958;Pipiras;ŽVIRBLIUKŲ;8657924258;Taip;0;10;0;10
7959;Pipiras;ŽVIRBLIUKŲ;10750695428;Taip;4;12;0;16
7960;Pipiras;ŽVIRBLIUKŲ;66816368717;Taip;2;8;0;10
7961;Pipiras;ŽVIRBLIUKŲ;1799335356;Ne;13;4;0;17
7962;Pipiras;ŽVIRBLIUKŲ;3247709788;Taip;0;13;0;13
7963;Pipiras;ZUIKUČIŲ;7161727352;Taip;0;6;0;6
7964;Pipiras;ZUIKUČIŲ;5225533488;Taip;10;1;0;11
7965;Pipiras;ZUIKUČIŲ;5622119207;Taip;0;8;0;8
7966;Pipiras;ZUIKUČIŲ;2016718354;Taip;0;1;0;1
7967;Pipiras;ZUIKUČIŲ;9157870634;Taip;0;1;0;1
7968;Pipiras;ZUIKUČIŲ;4017042461;Taip;5;0;0;5
7969;Pipiras;ZUIKUČIŲ;4177166475;Taip;14;1;0;15
7970;Pipiras;ZUIKUČIŲ;6792777396;Taip;14;4;0;18
7971;Pipiras;ZUIKUČIŲ;5845498558;Taip;0;19;0;19
7972;Pipiras;ZUIKUČIŲ;1784839485;Taip;14;0;0;14
7973;Pipiras;ZUIKUČIŲ;5141447649;Taip;19;0;0;19
7974;Pipiras;ZUIKUČIŲ;3775916247;Taip;0;9;0;9
7975;Pipiras;ZUIKUČIŲ;5908707752;Taip;16;0;0;16
7976;Pipiras;ZUIKUČIŲ;8422419380;Taip;5;0;0;5
7977;Pipiras;ZUIKUČIŲ;3882437376;Taip;0;4;0;4
7978;Pipiras;VARLIUKŲ;6363349541;Taip;0;1;0;1
7979;Pipiras;VARLIUKŲ;6340323302;Taip;0;3;0;3
7980;Pipiras;VARLIUKŲ;4266424785;Taip;11;5;0;16
7981;Pipiras;VARLIUKŲ;6748400056;Taip;3;0;0;3
7982;Pipiras;VARLIUKŲ;2315614501;Taip;3;5;0;8
7983;Pipiras;VARLIUKŲ;5422547144;Taip;0;20;0;20
7984;Pipiras;VARLIUKŲ;3421769229;Taip;14;1;0;15
7985;Pipiras;VARLIUKŲ;5445858240;Taip;5;1;0;6
7986;Pipiras;VARLIUKŲ;1242260242;Taip;14;2;0;16
7987;Pipiras;VARLIUKŲ;6685567970;Taip;15;1;0;16
7988;Pipiras;VARLIUKŲ;8520454289;Taip;9;0;0;9
7989;Pipiras;VARLIUKŲ;7969837759;Taip;0;16;0;16
7990;Pipiras;VARLIUKŲ;4426479971;Taip;12;0;0;12
7991;Pipiras;VARLIUKŲ;2267192782;Taip;5;7;0;12
7992;Pipiras;ŽIOGELIŲ;2096009051;Taip;20;0;0;20
7993;Pipiras;ŽIOGELIŲ;71283505646;Taip;5;1;0;6
7994;Pipiras;ŽIOGELIŲ;1485565125;Taip;5;1;0;6
7995;Pipiras;ŽIOGELIŲ;2061168407;Taip;11;0;0;11
7996;Pipiras;ŽIOGELIŲ;2030170020;Taip;8;1;0;9
7997;Pipiras;ŽIOGELIŲ;2637950013;Taip;20;0;0;20
7998;Pipiras;ŽIOGELIŲ;3652741639;Taip;20;0;0;20
7999;Pipiras;ŽIOGELIŲ;1415741097;Taip;13;0;0;13
8000;Pipiras;ŽIOGELIŲ;1658491279;Taip;9;0;0;9
8001;Pipiras;ŽIOGELIŲ;1082396096;Taip;10;2;0;12
8002;Pipiras;ŽIOGELIŲ;1324680675;Taip;5;0;0;5
8003;Pipiras;ŽIOGELIŲ;6794437566;Taip;14;2;0;16
8004;Pipiras;ŽIOGELIŲ;1371141047;Taip;5;1;0;6
8005;Pipiras;ŽIOGELIŲ;1420510354;Taip;5;0;0;5
8006;Pipiras;ŽIOGELIŲ;1293250996;Taip;4;4;0;8
8007;Pipiras;ŽIOGELIŲ;1751427121;Taip;5;1;0;6
8008;Pipiras;ŽIOGELIŲ;1114377378;Taip;10;2;0;12
8009;Pipiras;ŽIOGELIŲ;1694848410;Taip;6;0;0;6
8010;Pipiras;ŽIOGELIŲ;8088285579;Ne;0;8;0;8
8011;Pipiras;ŽIOGELIŲ;1949087858;Taip;13;1;0;14
8012;"Prie pasakų parko";"ZUIKUČIŲ (SPEC.)";1783727978;Taip;0;0;1;1
8013;"Prie pasakų parko";"ZUIKUČIŲ (SPEC.)";2058795331;Taip;8;0;0;8
8014;"Prie pasakų parko";"ZUIKUČIŲ (SPEC.)";1079827182;Taip;3;0;1;4
8015;"Prie pasakų parko";"ZUIKUČIŲ (SPEC.)";1057427744;Ne;0;0;1;1
8016;"Prie pasakų parko";"ZUIKUČIŲ (SPEC.)";4574965127;Ne;7;0;4;11
8017;"Prie pasakų parko";"ZUIKUČIŲ (SPEC.)";8949507250;Taip;3;0;3;6
8018;"Prie pasakų parko";"ZUIKUČIŲ (SPEC.)";18652266729;Taip;0;0;1;1
8019;"Prie pasakų parko";"ZUIKUČIŲ (SPEC.)";3397410463;Ne;7;0;4;11
8020;"Prie pasakų parko";PAUKŠČIUKŲ;5982019255;Taip;5;0;0;5
8021;"Prie pasakų parko";PAUKŠČIUKŲ;2160440145;Taip;8;1;0;9
8022;"Prie pasakų parko";PAUKŠČIUKŲ;6992830082;Taip;5;0;1;6
8023;"Prie pasakų parko";PAUKŠČIUKŲ;2216634402;Taip;4;0;3;7
8024;"Prie pasakų parko";PAUKŠČIUKŲ;1278065349;Taip;20;0;0;20
8025;"Prie pasakų parko";PAUKŠČIUKŲ;3356307067;Taip;13;0;0;13
8026;"Prie pasakų parko";PAUKŠČIUKŲ;8215830508;Ne;20;0;0;20
8027;"Prie pasakų parko";PAUKŠČIUKŲ;8318567916;Taip;6;0;0;6
8028;"Prie pasakų parko";PAUKŠČIUKŲ;8189217660;Taip;9;10;0;19
8029;"Prie pasakų parko";PAUKŠČIUKŲ;2741301903;Taip;14;2;0;16
8030;"Prie pasakų parko";PAUKŠČIUKŲ;4181676762;Taip;0;4;0;4
8031;"Prie pasakų parko";PAUKŠČIUKŲ;1482803930;Taip;9;0;3;12
8032;"Prie pasakų parko";PAUKŠČIUKŲ;9926991259;Taip;8;3;0;11
8033;"Prie pasakų parko";PAUKŠČIUKŲ;8574432191;Taip;5;2;0;7
8034;"Prie pasakų parko";"LINKSMOJI ŠEIMYNĖLĖ (SPEC)";3023913956;Ne;20;0;0;20
8035;"Prie pasakų parko";"LINKSMOJI ŠEIMYNĖLĖ (SPEC)";29561378525;Taip;20;0;0;20
8036;"Prie pasakų parko";"LINKSMOJI ŠEIMYNĖLĖ (SPEC)";7375940325;Taip;10;0;0;10
8037;"Prie pasakų parko";"LINKSMOJI ŠEIMYNĖLĖ (SPEC)";7186554262;Taip;13;0;0;13
8038;"Prie pasakų parko";"LINKSMOJI ŠEIMYNĖLĖ (SPEC)";6339321027;Taip;8;0;1;9
8039;"Prie pasakų parko";"LINKSMOJI ŠEIMYNĖLĖ (SPEC)";1007988202;Ne;0;3;1;4
8040;"Prie pasakų parko";"LINKSMOJI ŠEIMYNĖLĖ (SPEC)";50713289266;Taip;4;0;0;4
8041;"Prie pasakų parko";"LINKSMOJI ŠEIMYNĖLĖ (SPEC)";1327847558;Taip;16;0;0;16
8042;"Prie pasakų parko";NYKŠTUKŲ;41410871117;Taip;10;0;1;11
8043;"Prie pasakų parko";NYKŠTUKŲ;18733824395;Taip;0;4;0;4
8044;"Prie pasakų parko";NYKŠTUKŲ;79438946697;Taip;16;0;0;16
8045;"Prie pasakų parko";NYKŠTUKŲ;21605684303;Taip;5;0;1;6
8046;"Prie pasakų parko";NYKŠTUKŲ;72936036464;Taip;7;0;0;7
8047;"Prie pasakų parko";NYKŠTUKŲ;9384410578;Taip;0;0;5;5
8048;"Prie pasakų parko";NYKŠTUKŲ;7235277422;Taip;5;3;4;12
8049;"Prie pasakų parko";NYKŠTUKŲ;6577763037;Taip;2;3;0;5
8050;"Prie pasakų parko";NYKŠTUKŲ;6027613840;Taip;0;4;0;4
8051;"Prie pasakų parko";NYKŠTUKŲ;4657371068;Taip;10;0;1;11
8052;"Prie pasakų parko";NYKŠTUKŲ;70510594589;Taip;0;0;2;2
8053;"Prie pasakų parko";NYKŠTUKŲ;1634442815;Taip;10;3;0;13
8054;"Prie pasakų parko";LAŠELIŲ;1168637823;Taip;0;0;3;3
8055;"Prie pasakų parko";LAŠELIŲ;2106160177;Taip;7;11;0;18
8056;"Prie pasakų parko";LAŠELIŲ;15531434904;Taip;0;6;0;6
8057;"Prie pasakų parko";LAŠELIŲ;62268017779;Taip;11;0;0;11
8058;"Prie pasakų parko";LAŠELIŲ;37693490595;Taip;5;0;0;5
8059;"Prie pasakų parko";LAŠELIŲ;1414828294;Taip;0;8;0;8
8060;"Prie pasakų parko";LAŠELIŲ;98216786643;Taip;9;0;2;11
8061;"Prie pasakų parko";LAŠELIŲ;488285764;Taip;0;0;3;3
8062;"Prie pasakų parko";LAŠELIŲ;41495895397;Taip;0;8;0;8
8063;"Prie pasakų parko";LAŠELIŲ;80772711351;Taip;5;0;0;5
8064;"Prie pasakų parko";LAŠELIŲ;17947580061;Taip;4;0;0;4
8065;"Prie pasakų parko";"KAČIUKAI (SPEC)";5049934191;Ne;0;0;2;2
8066;"Prie pasakų parko";"KAČIUKAI (SPEC)";47641041054;Taip;14;0;0;14
8067;"Prie pasakų parko";"KAČIUKAI (SPEC)";67103811533;Ne;0;0;1;1
8068;"Prie pasakų parko";"KAČIUKAI (SPEC)";4241426494;Ne;6;0;4;10
8069;"Prie pasakų parko";"ŽVAIGŽDUTĖS  (SPEC)";2224744461;Taip;10;0;2;12
8070;"Prie pasakų parko";"ŽVAIGŽDUTĖS  (SPEC)";39511689145;Taip;0;0;2;2
8071;"Prie pasakų parko";"ŽVAIGŽDUTĖS  (SPEC)";11759638207;Taip;7;0;1;8
8072;"Prie pasakų parko";"ŽVAIGŽDUTĖS  (SPEC)";3045247119;Taip;9;0;4;13
8073;"Prie pasakų parko";"ŽVAIGŽDUTĖS  (SPEC)";28449237128;Taip;0;0;8;8
8074;"Prie pasakų parko";"ŽVAIGŽDUTĖS  (SPEC)";7341054382;Ne;20;0;0;20
8075;"Prie pasakų parko";"ŽVAIGŽDUTĖS  (SPEC)";1118596267;Taip;11;0;0;11
8076;"Prie pasakų parko";"ŽVAIGŽDUTĖS  (SPEC)";66048881669;Taip;8;0;0;8
8077;"Prie pasakų parko";"ŽVAIGŽDUTĖS  (SPEC)";89327404290;Taip;9;0;3;12
8078;"Prie pasakų parko";"ANČIUKAI (SPEC)";47396396133;Taip;4;0;1;5
8079;"Prie pasakų parko";"ANČIUKAI (SPEC)";4908579339;Taip;12;0;0;12
8080;"Prie pasakų parko";"ANČIUKAI (SPEC)";2241142980;Taip;0;0;3;3
8081;"Prie pasakų parko";"ANČIUKAI (SPEC)";1730134670;Ne;5;0;1;6
8082;"Prie pasakų parko";"ANČIUKAI (SPEC)";78012776060;Taip;0;0;7;7
8083;"Prie pasakų parko";"ANČIUKAI (SPEC)";1658448860;Taip;0;0;4;4
8084;"Prie pasakų parko";"ANČIUKAI (SPEC)";78634860827;Taip;7;6;4;17
8085;"Prie pasakų parko";"ANČIUKAI (SPEC)";7710346116;Ne;8;0;0;8
8086;"Prie pasakų parko";TIGRIUKAI;1425859956;Taip;6;0;0;6
8087;"Prie pasakų parko";TIGRIUKAI;4427448272;Taip;20;0;0;20
8088;"Prie pasakų parko";TIGRIUKAI;2601881804;Taip;0;6;0;6
8089;"Prie pasakų parko";TIGRIUKAI;34800098950;Taip;9;0;0;9
8090;"Prie pasakų parko";TIGRIUKAI;1275460051;Taip;14;0;1;15
8091;"Prie pasakų parko";TIGRIUKAI;1400892707;Taip;10;0;4;14
8092;"Prie pasakų parko";TIGRIUKAI;4365489653;Taip;0;3;0;3
8093;"Prie pasakų parko";TIGRIUKAI;6273733995;Taip;0;14;0;14
8094;"Prie pasakų parko";TIGRIUKAI;1204812495;Taip;0;4;0;4
8095;"Prie pasakų parko";TIGRIUKAI;5699852944;Taip;6;0;0;6
8096;"Prie pasakų parko";TIGRIUKAI;2877310618;Taip;0;0;1;1
8097;"Prie pasakų parko";TIGRIUKAI;5001661462;Taip;6;0;0;6
8098;"Prie pasakų parko";TIGRIUKAI;7628603262;Taip;0;0;1;1
8099;"Prie pasakų parko";TIGRIUKAI;65825430797;Taip;10;3;0;13
8100;"Prie pasakų parko";TIGRIUKAI;4900757614;Taip;5;0;0;5
8101;"Prie pasakų parko";TIGRIUKAI;8205731591;Taip;0;0;3;3
8102;"Prie pasakų parko";TIGRIUKAI;8474308320;Ne;20;0;0;20
8103;"Prie pasakų parko";"EŽIUKŲ (SPEC)";8323172347;Taip;0;0;1;1
8104;"Prie pasakų parko";"EŽIUKŲ (SPEC)";2820889357;Ne;0;0;2;2
8105;"Prie pasakų parko";"EŽIUKŲ (SPEC)";1549137154;Taip;10;0;2;12
8106;"Prie pasakų parko";"EŽIUKŲ (SPEC)";7545372781;Ne;9;0;0;9
8107;"Prie pasakų parko";"EŽIUKŲ (SPEC)";29445903073;Taip;1;3;0;4
8108;"Prie pasakų parko";"EŽIUKŲ (SPEC)";2133790263;Ne;5;4;0;9
8109;"Prie pasakų parko";"EŽIUKŲ (SPEC)";8849417734;Taip;0;0;3;3
8110;"Prie pasakų parko";"EŽIUKŲ (SPEC)";9190379838;Taip;0;0;4;4
8111;"Prie pasakų parko";"EŽIUKŲ (SPEC)";7327208141;Ne;8;0;6;14
8112;"Prie pasakų parko";"BORUŽIUKŲ (SPEC)";2080597774;Taip;5;0;0;5
8113;"Prie pasakų parko";"BORUŽIUKŲ (SPEC)";28574450739;Taip;9;0;0;9
8114;"Prie pasakų parko";"BORUŽIUKŲ (SPEC)";8817950372;Taip;0;15;0;15
8115;"Prie pasakų parko";"BORUŽIUKŲ (SPEC)";4203385836;Taip;6;9;0;15
8116;"Prie pasakų parko";"BORUŽIUKŲ (SPEC)";92307951922;Taip;1;1;0;2
8117;"Prie pasakų parko";SAULYTĖS;1543331408;Taip;0;0;4;4
8118;"Prie pasakų parko";SAULYTĖS;1369637618;Taip;1;0;0;1
8119;"Prie pasakų parko";SAULYTĖS;4501408366;Taip;10;0;1;11
8120;"Prie pasakų parko";SAULYTĖS;4874244790;Taip;11;0;5;16
8121;"Prie pasakų parko";SAULYTĖS;8182873487;Taip;0;3;0;3
8122;"Prie pasakų parko";SAULYTĖS;1610362831;Ne;11;6;0;17
8123;"Prie pasakų parko";SAULYTĖS;2548712970;Taip;0;0;5;5
8124;"Prie pasakų parko";SAULYTĖS;78516912418;Taip;9;0;2;11
8125;"Prie pasakų parko";SAULYTĖS;5593546668;Taip;0;6;0;6
8126;"Prie pasakų parko";SAULYTĖS;6361878877;Taip;18;0;0;18
8127;"Prie pasakų parko";SAULYTĖS;4443834766;Taip;6;0;4;10
8128;"Prie pasakų parko";SAULYTĖS;3453119286;Taip;0;0;3;3
8129;"Prie pasakų parko";SAULYTĖS;5169736542;Ne;5;0;5;10
8130;"Prie pasakų parko";SAULYTĖS;4332682721;Ne;7;0;6;13
8131;"Prie pasakų parko";SAULYTĖS;5494350183;Taip;0;0;1;1
8132;"Prie pasakų parko";SAULYTĖS;6250397070;Taip;10;10;0;20
8133;Pumpurėlis;RAMUNĖLIŲ;61297074638;Taip;0;8;0;8
8134;Pumpurėlis;RAMUNĖLIŲ;87813594933;Taip;0;13;0;13
8135;Pumpurėlis;RAMUNĖLIŲ;7015779224;Taip;6;6;0;12
8136;Pumpurėlis;RAMUNĖLIŲ;24681852477;Taip;0;3;0;3
8137;Pumpurėlis;RAMUNĖLIŲ;27361939846;Taip;0;9;0;9
8138;Pumpurėlis;RAMUNĖLIŲ;72455192748;Taip;5;0;0;5
8139;Pumpurėlis;RAMUNĖLIŲ;20093100251;Taip;8;1;0;9
8140;Pumpurėlis;RAMUNĖLIŲ;66672997420;Taip;0;5;0;5
8141;Pumpurėlis;RAMUNĖLIŲ;15096075268;Taip;0;1;0;1
8142;Pumpurėlis;RAMUNĖLIŲ;1685401053;Taip;0;4;0;4
8143;Pumpurėlis;RAMUNĖLIŲ;33847164571;Taip;0;0;2;2
8144;Pumpurėlis;RAMUNĖLIŲ;2671657094;Taip;0;4;2;6
8145;Pumpurėlis;RAMUNĖLIŲ;91612536967;Taip;5;1;0;6
8146;Pumpurėlis;RAMUNĖLIŲ;45279361421;Taip;0;0;4;4
8147;Pumpurėlis;RAMUNĖLIŲ;16656067942;Taip;6;3;0;9
8148;Pumpurėlis;RAMUNĖLIŲ;9041599264;Taip;14;4;1;19
8149;Pumpurėlis;RAMUNĖLIŲ;1021043951;Taip;14;1;0;15
8150;Pumpurėlis;RAMUNĖLIŲ;1524688901;Taip;11;5;0;16
8151;Pumpurėlis;RAMUNĖLIŲ;1366801299;Taip;11;5;0;16
8152;Pumpurėlis;RAMUNĖLIŲ;1631951556;Taip;2;2;0;4
8153;Pumpurėlis;RAMUNĖLIŲ;1085633311;Taip;0;4;0;4
8154;Pumpurėlis;RAMUNĖLIŲ;6215273976;Taip;0;11;0;11
8155;Pumpurėlis;VARPELIŲ;97145389284;Taip;9;0;1;10
8156;Pumpurėlis;VARPELIŲ;70522541316;Taip;5;14;0;19
8157;Pumpurėlis;VARPELIŲ;465606233;Taip;8;1;0;9
8158;Pumpurėlis;VARPELIŲ;93964052608;Taip;0;1;0;1
8159;Pumpurėlis;VARPELIŲ;11052382671;Taip;0;11;0;11
8160;Pumpurėlis;VARPELIŲ;28759758744;Taip;0;0;3;3
8161;Pumpurėlis;VARPELIŲ;77110003421;Taip;0;4;2;6
8162;Pumpurėlis;VARPELIŲ;47596248180;Taip;0;6;0;6
8163;Pumpurėlis;VARPELIŲ;46386981131;Taip;0;4;0;4
8164;Pumpurėlis;VARPELIŲ;49176440282;Ne;0;13;0;13
8165;Pumpurėlis;VARPELIŲ;40808677022;Taip;0;8;0;8
8166;Pumpurėlis;VARPELIŲ;36645787745;Taip;0;5;11;16
8167;Pumpurėlis;VARPELIŲ;5901659879;Taip;8;0;0;8
8168;Pumpurėlis;VARPELIŲ;56351492623;Taip;4;5;4;13
8169;Pumpurėlis;VARPELIŲ;57426850391;Taip;4;1;0;5
8170;Pumpurėlis;VARPELIŲ;15256433275;Taip;14;2;0;16
8171;Pumpurėlis;VARPELIŲ;89695456583;Taip;10;3;0;13
8172;Pumpurėlis;VARPELIŲ;1544903261;Ne;0;20;0;20
8173;Pumpurėlis;VARPELIŲ;1945407792;Taip;6;6;0;12
8174;Pumpurėlis;VARPELIŲ;1645287832;Taip;1;3;6;10
8175;Pumpurėlis;VARPELIŲ;6025998706;Taip;1;1;3;5
8176;Pumpurėlis;DRUGELIŲ;25029630023;Taip;9;0;0;9
8177;Pumpurėlis;DRUGELIŲ;1230058211;Taip;0;9;0;9
8178;Pumpurėlis;DRUGELIŲ;1225377038;Taip;8;0;1;9
8179;Pumpurėlis;DRUGELIŲ;1053338730;Taip;12;0;2;14
8180;Pumpurėlis;DRUGELIŲ;1261919194;Taip;4;0;0;4
8181;Pumpurėlis;DRUGELIŲ;1397924008;Taip;10;0;0;10
8182;Pumpurėlis;DRUGELIŲ;6230500803;Taip;9;4;0;13
8183;Pumpurėlis;DRUGELIŲ;2129779614;Taip;0;4;0;4
8184;Pumpurėlis;DRUGELIŲ;2102427499;Taip;0;17;0;17
8185;Pumpurėlis;DRUGELIŲ;9724549899;Taip;8;0;0;8
8186;Pumpurėlis;DRUGELIŲ;9317495169;Taip;0;8;0;8
8187;Pumpurėlis;DRUGELIŲ;8262886949;Taip;5;1;0;6
8188;Pumpurėlis;DRUGELIŲ;6535398274;Taip;15;0;0;15
8189;Pumpurėlis;DRUGELIŲ;9078991043;Taip;17;0;0;17
8190;Pumpurėlis;DRUGELIŲ;9733380187;Taip;13;0;0;13
8191;Pumpurėlis;DRUGELIŲ;83388662869;Taip;0;11;0;11
8192;Pumpurėlis;DRUGELIŲ;7123915287;Taip;7;0;0;7
8193;Pumpurėlis;DRUGELIŲ;1690424790;Taip;8;1;0;9
8194;Pumpurėlis;DRUGELIŲ;4192641015;Taip;3;0;0;3
8195;Pumpurėlis;DRUGELIŲ;7519369167;Taip;3;0;0;3
8196;Pumpurėlis;DRUGELIŲ;1248017244;Taip;9;1;2;12
8197;Pumpurėlis;DRUGELIŲ;6395230524;Taip;11;0;1;12
8198;Pumpurėlis;KODĖLČIUKŲ;5984878126;Taip;9;4;0;13
8199;Pumpurėlis;KODĖLČIUKŲ;18928851032;Taip;8;0;0;8
8200;Pumpurėlis;KODĖLČIUKŲ;9224879966;Taip;0;9;0;9
8201;Pumpurėlis;KODĖLČIUKŲ;1188314397;Taip;2;1;0;3
8202;Pumpurėlis;KODĖLČIUKŲ;2468796972;Taip;5;4;0;9
8203;Pumpurėlis;KODĖLČIUKŲ;8830261792;Taip;11;0;0;11
8204;Pumpurėlis;KODĖLČIUKŲ;9583257172;Taip;9;1;0;10
8205;Pumpurėlis;KODĖLČIUKŲ;9138883172;Taip;3;3;0;6
8206;Pumpurėlis;KODĖLČIUKŲ;7533555059;Taip;11;6;0;17
8207;Pumpurėlis;KODĖLČIUKŲ;6669327226;Taip;0;4;0;4
8208;Pumpurėlis;KODĖLČIUKŲ;13952236905;Taip;10;4;1;15
8209;Pumpurėlis;KODĖLČIUKŲ;87061817106;Taip;9;1;0;10
8210;Pumpurėlis;KODĖLČIUKŲ;30267173981;Taip;5;0;0;5
8211;Pumpurėlis;KODĖLČIUKŲ;1835168438;Taip;2;1;0;3
8212;Pumpurėlis;KODĖLČIUKŲ;5615260965;Taip;6;3;0;9
8213;Pumpurėlis;KODĖLČIUKŲ;4344595328;Taip;0;9;0;9
8214;Pumpurėlis;KODĖLČIUKŲ;3298821054;Taip;7;0;0;7
8215;Pumpurėlis;KODĖLČIUKŲ;8806961007;Taip;7;0;0;7
8216;Pumpurėlis;KODĖLČIUKŲ;9439363363;Taip;18;0;0;18
8217;Pumpurėlis;KODĖLČIUKŲ;5964953923;Taip;10;1;1;12
8218;Pumpurėlis;KODĖLČIUKŲ;1492810528;Taip;13;0;0;13
8219;Pumpurėlis;LINELIS;84077240969;Taip;0;1;0;1
8220;Pumpurėlis;LINELIS;1320618070;Taip;14;0;0;14
8221;Pumpurėlis;LINELIS;42874947682;Taip;10;0;0;10
8222;Pumpurėlis;LINELIS;90214423899;Taip;12;0;0;12
8223;Pumpurėlis;LINELIS;79993170267;Taip;11;0;0;11
8224;Pumpurėlis;LINELIS;79842160701;Taip;8;1;0;9
8225;Pumpurėlis;LINELIS;98941059894;Taip;0;1;0;1
8226;Pumpurėlis;LINELIS;22232669189;Taip;10;0;0;10
8227;Pumpurėlis;LINELIS;65556407758;Taip;14;2;0;16
8228;Pumpurėlis;LINELIS;50662453283;Taip;0;11;0;11
8229;Pumpurėlis;LINELIS;5626656132;Taip;9;0;0;9
8230;Pumpurėlis;LINELIS;8088505202;Taip;0;1;0;1
8231;Pumpurėlis;LINELIS;39148007125;Taip;0;7;0;7
8232;Pumpurėlis;LINELIS;8916669921;Taip;0;5;0;5
8233;Pumpurėlis;LINELIS;44429937857;Taip;0;1;0;1
8234;Pumpurėlis;LINELIS;79813871981;Taip;10;1;0;11
8235;Pumpurėlis;LINELIS;86581864351;Taip;5;2;0;7
8236;Pumpurėlis;LINELIS;24135602993;Taip;5;2;0;7
8237;Pumpurėlis;LINELIS;74357094385;Taip;10;0;0;10
8238;Pumpurėlis;LINELIS;99841176399;Taip;0;4;0;4
8239;Pumpurėlis;LINELIS;1890693598;Taip;8;0;0;8
8240;Pumpurėlis;LINELIS;57455327823;Taip;0;6;0;6
8241;Pumpurėlis;LINELIS;5956784613;Taip;20;0;0;20
8242;Pumpurėlis;SAULUTĖS;73683690800;Taip;0;1;2;3
8243;Pumpurėlis;SAULUTĖS;50393587861;Taip;14;0;0;14
8244;Pumpurėlis;SAULUTĖS;45898175544;Taip;0;18;0;18
8245;Pumpurėlis;SAULUTĖS;49696660115;Taip;0;10;0;10
8246;Pumpurėlis;SAULUTĖS;24927191443;Taip;4;2;0;6
8247;Pumpurėlis;SAULUTĖS;82272797732;Taip;0;1;0;1
8248;Pumpurėlis;SAULUTĖS;76081690528;Taip;0;5;0;5
8249;Pumpurėlis;SAULUTĖS;76467622234;Taip;0;5;0;5
8250;Pumpurėlis;SAULUTĖS;89004303712;Taip;0;2;0;2
8251;Pumpurėlis;SAULUTĖS;32946314312;Taip;0;0;1;1
8252;Pumpurėlis;SAULUTĖS;50292067501;Taip;10;6;0;16
8253;Pumpurėlis;SAULUTĖS;91231481674;Taip;10;0;0;10
8254;Pumpurėlis;SAULUTĖS;77106733982;Taip;9;0;0;9
8255;Pumpurėlis;SAULUTĖS;25796704653;Taip;0;1;0;1
8256;Pumpurėlis;SAULUTĖS;73862556514;Ne;20;0;0;20
8257;Pumpurėlis;SAULUTĖS;96528992638;Taip;6;1;0;7
8258;Pumpurėlis;SAULUTĖS;86392525702;Taip;12;0;0;12
8259;Pumpurėlis;SAULUTĖS;2129522323;Taip;5;4;0;9
8260;Pumpurėlis;BITUTĖS;2028515310;Taip;3;4;0;7
8261;Pumpurėlis;BITUTĖS;44982629856;Taip;0;8;0;8
8262;Pumpurėlis;BITUTĖS;1333429949;Taip;7;0;0;7
8263;Pumpurėlis;BITUTĖS;8747439652;Taip;7;0;0;7
8264;Pumpurėlis;BITUTĖS;92238719397;Taip;8;3;0;11
8265;Pumpurėlis;BITUTĖS;1400057487;Taip;5;0;1;6
8266;Pumpurėlis;BITUTĖS;1274293175;Taip;0;13;1;14
8267;Pumpurėlis;BITUTĖS;93809482039;Taip;0;1;1;2
8268;Pumpurėlis;BITUTĖS;7786926187;Taip;10;1;0;11
8269;Pumpurėlis;BITUTĖS;74144468541;Taip;7;4;0;11
8270;Pumpurėlis;BITUTĖS;1640573725;Taip;8;1;0;9
8271;Pumpurėlis;BITUTĖS;1473237607;Taip;10;3;0;13
8272;Pumpurėlis;BITUTĖS;71979455611;Taip;6;6;0;12
8273;Pumpurėlis;BITUTĖS;1001114367;Taip;11;0;0;11
8274;Pumpurėlis;BITUTĖS;26859673794;Taip;13;2;0;15
8275;Pumpurėlis;BITUTĖS;72719147901;Taip;7;0;0;7
8276;Pumpurėlis;BITUTĖS;1527144198;Taip;3;4;0;7
8277;Pumpurėlis;BITUTĖS;57949968899;Taip;2;0;3;5
8278;Pumpurėlis;BITUTĖS;1298302188;Taip;0;0;1;1
8279;Pumpurėlis;BITUTĖS;1255753542;Taip;16;0;0;16
8280;Pumpurėlis;DOBILIUKAI;1273831078;Taip;0;6;0;6
8281;Pumpurėlis;DOBILIUKAI;1264017142;Taip;12;0;0;12
8282;Pumpurėlis;DOBILIUKAI;98061041685;Taip;8;1;0;9
8283;Pumpurėlis;DOBILIUKAI;1439043505;Taip;8;0;0;8
8284;Pumpurėlis;DOBILIUKAI;1287902351;Taip;8;0;0;8
8285;Pumpurėlis;DOBILIUKAI;13358453137;Taip;10;0;0;10
8286;Pumpurėlis;DOBILIUKAI;1209654095;Taip;9;0;0;9
8287;Pumpurėlis;DOBILIUKAI;40267078306;Taip;10;0;1;11
8288;Pumpurėlis;DOBILIUKAI;51793437519;Taip;14;0;0;14
8289;Pumpurėlis;DOBILIUKAI;1319664504;Taip;13;0;0;13
8290;Pumpurėlis;DOBILIUKAI;1921332565;Taip;9;0;0;9
8291;Pumpurėlis;DOBILIUKAI;1055683170;Taip;6;3;0;9
8292;Pumpurėlis;DOBILIUKAI;1620037477;Taip;0;4;0;4
8293;Pumpurėlis;DOBILIUKAI;1307929787;Taip;5;0;0;5
8294;Pumpurėlis;DOBILIUKAI;1511761574;Taip;0;9;0;9
8295;Pumpurėlis;DOBILIUKAI;1346602122;Taip;6;3;0;9
8296;Pumpurėlis;DOBILIUKAI;88732170322;Taip;5;2;1;8
8297;Pumpurėlis;DOBILIUKAI;1469189392;Taip;20;0;0;20
8298;Pumpurėlis;DOBILIUKAI;94636926281;Taip;5;0;0;5
8299;Pumpurėlis;DOBILIUKAI;1027125361;Taip;9;4;0;13
8300;Pumpurėlis;DOBILIUKAI;77346378580;Taip;4;0;0;4
8301;Pumpurėlis;PUPYČIŲ;9612924972;Taip;13;0;0;13
8302;Pumpurėlis;PUPYČIŲ;9884099545;Taip;13;0;0;13
8303;Pumpurėlis;PUPYČIŲ;8258560345;Taip;0;0;17;17
8304;Pumpurėlis;PUPYČIŲ;1687770779;Taip;9;0;1;10
8305;Pumpurėlis;PUPYČIŲ;5196733185;Taip;1;10;0;11
8306;Pumpurėlis;PUPYČIŲ;2668855786;Taip;20;0;0;20
8307;Pumpurėlis;PUPYČIŲ;4928495108;Taip;0;4;0;4
8308;Pumpurėlis;PUPYČIŲ;8886730333;Taip;20;0;0;20
8309;Pumpurėlis;PUPYČIŲ;5438584331;Taip;8;0;0;8
8310;Pumpurėlis;PUPYČIŲ;7160091629;Taip;6;7;0;13
8311;Pumpurėlis;PUPYČIŲ;3893768713;Taip;0;8;0;8
8312;Pumpurėlis;PUPYČIŲ;3101133244;Taip;13;0;1;14
8313;Pumpurėlis;PUPYČIŲ;4508966729;Taip;14;0;0;14
8314;Pumpurėlis;PUPYČIŲ;4451898302;Taip;6;0;1;7
8315;Pumpurėlis;PUPYČIŲ;5023658988;Taip;0;2;0;2
8316;Pumpurėlis;PUPYČIŲ;9552913910;Taip;2;0;3;5
8317;Pumpurėlis;ŽIRNIUKŲ;4985045047;Taip;10;0;0;10
8318;Pumpurėlis;ŽIRNIUKŲ;7610949816;Taip;3;0;0;3
8319;Pumpurėlis;ŽIRNIUKŲ;6977710645;Taip;19;0;0;19
8320;Pumpurėlis;ŽIRNIUKŲ;9431295796;Taip;0;10;2;12
8321;Pumpurėlis;ŽIRNIUKŲ;1395380236;Taip;10;0;3;13
8322;Pumpurėlis;ŽIRNIUKŲ;9424449290;Taip;0;14;0;14
8323;Pumpurėlis;ŽIRNIUKŲ;6955168163;Taip;7;0;0;7
8324;Pumpurėlis;ŽIRNIUKŲ;7229289985;Taip;0;12;0;12
8325;Pumpurėlis;ŽIRNIUKŲ;1674341906;Taip;0;15;0;15
8326;Pumpurėlis;ŽIRNIUKŲ;5663147778;Taip;14;0;0;14
8327;Pumpurėlis;ŽIRNIUKŲ;7559071945;Taip;11;0;0;11
8328;Pumpurėlis;ŽIRNIUKŲ;8373105196;Taip;14;0;0;14
8329;Pumpurėlis;ŽIRNIUKŲ;6165833101;Taip;4;0;1;5
8330;Pumpurėlis;ŽIRNIUKŲ;9726028397;Taip;5;10;0;15
8331;Pumpurėlis;ŽIRNIUKŲ;5171198109;Taip;5;3;0;8
8332;Pumpurėlis;ŽIRNIUKŲ;2969734731;Taip;12;0;0;12
8333;Pumpurėlis;BORUŽĖLIŲ;49767198843;Taip;8;0;0;8
8334;Pumpurėlis;BORUŽĖLIŲ;42611228425;Taip;5;0;2;7
8335;Pumpurėlis;BORUŽĖLIŲ;68035717481;Taip;10;0;0;10
8336;Pumpurėlis;BORUŽĖLIŲ;1594436797;Taip;8;1;0;9
8337;Pumpurėlis;BORUŽĖLIŲ;1568701327;Taip;5;0;3;8
8338;Pumpurėlis;BORUŽĖLIŲ;1842097360;Taip;0;0;3;3
8339;Pumpurėlis;BORUŽĖLIŲ;82659096039;Taip;6;3;0;9
8340;Pumpurėlis;BORUŽĖLIŲ;1098875585;Taip;1;1;4;6
8341;Pumpurėlis;BORUŽĖLIŲ;1034745510;Taip;8;0;0;8
8342;Pumpurėlis;BORUŽĖLIŲ;5364345261;Taip;0;7;0;7
8343;Pumpurėlis;BORUŽĖLIŲ;1617303626;Taip;10;0;0;10
8344;Pumpurėlis;BORUŽĖLIŲ;1306102772;Taip;5;2;1;8
8345;Pumpurėlis;BORUŽĖLIŲ;1436627913;Taip;1;7;0;8
8346;Pumpurėlis;BORUŽĖLIŲ;2345116167;Taip;8;1;0;9
8347;Pumpurėlis;BORUŽĖLIŲ;63610860077;Taip;14;0;0;14
8348;Pumpurėlis;BORUŽĖLIŲ;1257222112;Taip;6;0;4;10
8349;Pumpurėlis;BORUŽĖLIŲ;1508245418;Taip;4;0;0;4
8350;Pumpurėlis;BORUŽĖLIŲ;81595634697;Taip;20;0;0;20
8351;Pumpurėlis;BORUŽĖLIŲ;1061975374;Taip;0;9;0;9
8352;Puriena;Ančiukų;90765300922;Taip;3;2;1;6
8353;Puriena;Ančiukų;54803470430;Taip;0;2;0;2
8354;Puriena;Ančiukų;27321768851;Taip;5;2;0;7
8355;Puriena;Ančiukų;17378740941;Taip;0;0;6;6
8356;Puriena;Ančiukų;58363113692;Taip;6;4;0;10
8357;Puriena;Ančiukų;78566741895;Taip;14;0;0;14
8358;Puriena;Ančiukų;69902514699;Taip;14;0;0;14
8359;Puriena;Ančiukų;54723251890;Taip;2;2;0;4
8360;Puriena;Ančiukų;54181308247;Taip;0;10;0;10
8361;Puriena;Ančiukų;76491901304;Taip;0;2;0;2
8362;Puriena;Ančiukų;86174474927;Taip;12;0;0;12
8363;Puriena;Ančiukų;85013789582;Taip;0;5;0;5
8364;Puriena;Ančiukų;93516016900;Taip;1;2;0;3
8365;Puriena;Ančiukų;61259599767;Taip;6;5;0;11
8366;Puriena;Ančiukų;84757305442;Taip;9;0;4;13
8367;Puriena;Ančiukų;50171510736;Taip;0;1;0;1
8368;Puriena;Ančiukų;48507270084;Taip;14;0;0;14
8369;Puriena;Ančiukų;88268169404;Taip;5;0;0;5
8370;Puriena;Ančiukų;1394510964;Taip;0;6;0;6
8371;Puriena;Drugeliai;7337038503;Taip;20;0;0;20
8372;Puriena;Drugeliai;47316276655;Taip;13;1;0;14
8373;Puriena;Drugeliai;48468411549;Taip;11;0;0;11
8374;Puriena;Drugeliai;20286870431;Taip;9;11;0;20
8375;Puriena;Drugeliai;63196502622;Taip;16;0;0;16
8376;Puriena;Drugeliai;11497629767;Taip;12;0;0;12
8377;Puriena;Drugeliai;2146036332;Taip;15;0;0;15
8378;Puriena;Drugeliai;1142929858;Taip;8;12;0;20
8379;Puriena;Drugeliai;1443945321;Taip;3;0;2;5
8380;Puriena;Drugeliai;1703078658;Taip;9;1;0;10
8381;Puriena;Drugeliai;2083071198;Taip;14;0;0;14
8382;Puriena;Drugeliai;8213725698;Taip;20;0;0;20
8383;Puriena;Drugeliai;2378865002;Taip;15;0;0;15
8384;Puriena;Drugeliai;5891404983;Taip;14;0;0;14
8385;Puriena;Drugeliai;9239618299;Taip;0;14;0;14
8386;Puriena;Drugeliai;2089174669;Taip;9;0;0;9
8387;Puriena;Drugeliai;2131343339;Taip;4;1;0;5
8388;Puriena;Drugeliai;1748337587;Taip;0;11;0;11
8389;Puriena;Drugeliai;8618298134;Taip;17;0;0;17
8390;Puriena;Drugeliai;8707076857;Taip;11;0;0;11
8391;Puriena;Drugeliai;1820719083;Taip;9;0;0;9
8392;Puriena;Drugeliai;4394023057;Taip;8;5;0;13
8393;Puriena;Pelėdžiukai;11431481909;Taip;8;5;0;13
8394;Puriena;Pelėdžiukai;53451774513;Taip;0;9;0;9
8395;Puriena;Pelėdžiukai;12499791115;Taip;3;2;0;5
8396;Puriena;Pelėdžiukai;54048579160;Taip;3;5;0;8
8397;Puriena;Pelėdžiukai;43490363874;Taip;5;2;0;7
8398;Puriena;Pelėdžiukai;34689084311;Taip;5;1;0;6
8399;Puriena;Pelėdžiukai;21611180390;Taip;5;7;0;12
8400;Puriena;Pelėdžiukai;15016729899;Taip;11;2;0;13
8401;Puriena;Pelėdžiukai;11677252767;Taip;0;1;0;1
8402;Puriena;Pelėdžiukai;16437608299;Taip;7;7;0;14
8403;Puriena;Pelėdžiukai;69494886505;Taip;5;4;0;9
8404;Puriena;Pelėdžiukai;95972862152;Taip;6;1;0;7
8405;Puriena;Pelėdžiukai;51874022935;Taip;0;8;0;8
8406;Puriena;Pelėdžiukai;58791977007;Taip;8;1;0;9
8407;Puriena;Pelėdžiukai;53286108187;Taip;8;1;0;9
8408;Puriena;Pelėdžiukai;81806945761;Taip;5;9;0;14
8409;Puriena;Pelėdžiukai;43963341624;Ne;2;4;0;6
8410;Puriena;Pelėdžiukai;26040866189;Taip;5;3;0;8
8411;Puriena;Pelėdžiukai;90508354565;Taip;13;0;0;13
8412;Puriena;Pelėdžiukai;95822432988;Taip;7;1;0;8
8413;Puriena;Pelėdžiukai;45627148409;Taip;0;10;0;10
8414;Puriena;Pelėdžiukai;2011809589;Taip;11;1;0;12
8415;Puriena;Voveriukai;23746358787;Taip;8;2;0;10
8416;Puriena;Voveriukai;6285846517;Taip;0;5;0;5
8417;Puriena;Voveriukai;5501308683;Taip;13;0;0;13
8418;Puriena;Voveriukai;92604925140;Taip;9;0;0;9
8419;Puriena;Voveriukai;1263637124;Taip;4;0;0;4
8420;Puriena;Voveriukai;1290933817;Taip;3;2;3;8
8421;Puriena;Voveriukai;7429832136;Taip;11;1;0;12
8422;Puriena;Voveriukai;2663832596;Taip;0;4;0;4
8423;Puriena;Voveriukai;2203259310;Taip;4;0;0;4
8424;Puriena;Voveriukai;40573980976;Taip;0;12;0;12
8425;Puriena;Voveriukai;1381379515;Taip;10;2;0;12
8426;Puriena;Voveriukai;6057477307;Taip;10;1;0;11
8427;Puriena;Voveriukai;1290962809;Taip;0;12;2;14
8428;Puriena;Voveriukai;11242620566;Taip;10;0;0;10
8429;Puriena;Voveriukai;9139110598;Taip;5;5;0;10
8430;Puriena;Voveriukai;9106525954;Taip;20;0;0;20
8431;Puriena;Voveriukai;5999564879;Taip;9;1;4;14
8432;Puriena;Voveriukai;6053657231;Taip;7;0;0;7
8433;Puriena;Voveriukai;9146447088;Taip;0;20;0;20
8434;Puriena;Voveriukai;8478901457;Taip;11;0;0;11
8435;Puriena;Bitučių;77708842205;Taip;0;4;0;4
8436;Puriena;Bitučių;67031288256;Taip;20;0;0;20
8437;Puriena;Bitučių;84484585930;Taip;6;0;0;6
8438;Puriena;Bitučių;11169417266;Ne;0;8;0;8
8439;Puriena;Bitučių;45287018563;Taip;4;0;0;4
8440;Puriena;Bitučių;3538587188;Taip;0;4;0;4
8441;Puriena;Bitučių;17841197680;Taip;0;5;0;5
8442;Puriena;Bitučių;25813179990;Taip;0;0;12;12
8443;Puriena;Bitučių;33307762315;Taip;0;0;3;3
8444;Puriena;Bitučių;65319170607;Taip;2;1;0;3
8445;Puriena;Bitučių;55441324338;Taip;0;1;0;1
8446;Puriena;Bitučių;10701053444;Taip;4;1;0;5
8447;Puriena;Bitučių;10530139834;Taip;15;0;0;15
8448;Puriena;Bitučių;85386780648;Taip;0;2;0;2
8449;Puriena;Bitučių;38994996491;Taip;0;6;0;6
8450;Puriena;Bitučių;65910898731;Taip;0;0;2;2
8451;Puriena;Bitučių;3883844676;Taip;5;2;0;7
8452;Puriena;Zylutės;29931607789;Taip;10;1;0;11
8453;Puriena;Zylutės;5920910288;Taip;14;0;0;14
8454;Puriena;Zylutės;14052847763;Taip;14;2;0;16
8455;Puriena;Zylutės;46510003255;Taip;0;20;0;20
8456;Puriena;Zylutės;64733952400;Taip;0;5;0;5
8457;Puriena;Zylutės;1993142891;Taip;20;0;0;20
8458;Puriena;Zylutės;6539425730;Ne;0;13;0;13
8459;Puriena;Zylutės;88483773966;Taip;8;1;0;9
8460;Puriena;Zylutės;61706928693;Taip;15;0;0;15
8461;Puriena;Zylutės;45128021817;Taip;15;0;0;15
8462;Puriena;Zylutės;7285127722;Taip;5;3;0;8
8463;Puriena;Zylutės;63953968050;Ne;1;4;0;5
8464;Puriena;Zylutės;50199557129;Taip;1;0;0;1
8465;Puriena;Zylutės;88595039240;Taip;10;2;0;12
8466;Puriena;Zylutės;65137815385;Taip;0;4;0;4
8467;Puriena;Zylutės;14780389529;Taip;7;0;0;7
8468;Puriena;Zylutės;54604607448;Taip;10;0;0;10
8469;Puriena;Zylutės;1994224209;Taip;0;4;0;4
8470;Puriena;Zylutės;27546501673;Taip;1;11;0;12
8471;Puriena;Meškučių;5026857195;Taip;0;2;1;3
8472;Puriena;Meškučių;88588968229;Taip;0;2;1;3
8473;Puriena;Meškučių;1758690169;Taip;9;1;0;10
8474;Puriena;Meškučių;25112307864;Taip;5;4;0;9
8475;Puriena;Meškučių;1240190350;Taip;7;1;0;8
8476;Puriena;Meškučių;19157486407;Taip;5;1;0;6
8477;Puriena;Meškučių;87523460146;Taip;5;5;0;10
8478;Puriena;Meškučių;61241768982;Taip;19;0;0;19
8479;Puriena;Meškučių;26980342372;Taip;8;0;0;8
8480;Puriena;Meškučių;4260334053;Taip;0;10;0;10
8481;Puriena;Meškučių;83821680276;Taip;10;2;0;12
8482;Puriena;Meškučių;71778035373;Taip;0;10;0;10
8483;Puriena;Meškučių;1184946421;Taip;6;1;0;7
8484;Puriena;Meškučių;61117212576;Taip;8;0;0;8
8485;Puriena;Meškučių;59193676476;Taip;12;1;0;13
8486;Puriena;Meškučių;91069175088;Taip;20;0;0;20
8487;Puriena;Meškučių;16572830524;Taip;0;1;0;1
8488;Puriena;Meškučių;18592085188;Taip;19;0;0;19
8489;Puriena;Meškučių;3327714361;Taip;10;0;3;13
8490;Puriena;Meškučių;1418776789;Taip;9;0;1;10
8491;Puriena;Nykštukų;85334594528;Taip;10;5;0;15
8492;Puriena;Nykštukų;1945542034;Taip;0;8;0;8
8493;Puriena;Nykštukų;79194353091;Taip;9;1;0;10
8494;Puriena;Nykštukų;1629458651;Taip;14;0;0;14
8495;Puriena;Nykštukų;91735621242;Taip;8;0;1;9
8496;Puriena;Nykštukų;5284316470;Taip;3;2;2;7
8497;Puriena;Nykštukų;1116529845;Taip;0;1;0;1
8498;Puriena;Nykštukų;98967026878;Taip;2;0;0;2
8499;Puriena;Nykštukų;8719239663;Taip;3;2;2;7
8500;Puriena;Nykštukų;1206969296;Taip;3;0;9;12
8501;Puriena;Nykštukų;84527348236;Ne;6;4;0;10
8502;Puriena;Nykštukų;24572685191;Taip;0;0;3;3
8503;Puriena;Nykštukų;63944407195;Taip;0;2;3;5
8504;Puriena;Nykštukų;95153406240;Taip;0;2;0;2
8505;Puriena;Nykštukų;1125102675;Taip;0;10;0;10
8506;Puriena;Nykštukų;29217326976;Taip;20;0;0;20
8507;Puriena;Nykštukų;9666714143;Taip;0;2;1;3
8508;Puriena;Nykštukų;1507059980;Taip;0;5;0;5
8509;Puriena;Ežiukai;1900570261;Taip;7;0;0;7
8510;Puriena;Ežiukai;1704296685;Taip;17;0;0;17
8511;Puriena;Ežiukai;1174355613;Taip;0;1;4;5
8512;Puriena;Ežiukai;2255508780;Taip;5;4;0;9
8513;Puriena;Ežiukai;35226601932;Taip;11;1;0;12
8514;Puriena;Ežiukai;2072874096;Taip;0;2;3;5
8515;Puriena;Ežiukai;11011727269;Taip;14;0;0;14
8516;Puriena;Ežiukai;87416314075;Taip;5;0;8;13
8517;Puriena;Ežiukai;1175577834;Taip;0;2;5;7
8518;Puriena;Ežiukai;8852985927;Taip;0;1;0;1
8519;Puriena;Ežiukai;9471669903;Taip;9;9;0;18
8520;Puriena;Ežiukai;1707413291;Taip;5;2;0;7
8521;Puriena;Ežiukai;1773431155;Taip;19;0;0;19
8522;Puriena;Ežiukai;1379084331;Taip;5;3;1;9
8523;Puriena;Ežiukai;1710087159;Taip;15;0;0;15
8524;Puriena;Ežiukai;21180207545;Taip;0;0;5;5
8525;Puriena;Ežiukai;1762395617;Taip;5;7;0;12
8526;Puriena;Ežiukai;2560477213;Taip;10;0;0;10
8527;Puriena;Ežiukai;1786569222;Taip;0;12;0;12
8528;Puriena;Ežiukai;41863686552;Taip;13;1;0;14
8529;Puriena;Ežiukai;4792538031;Taip;1;2;1;4
8530;Puriena;"Boružiukų ";3033562627;Taip;6;1;0;7
8531;Puriena;"Boružiukų ";5777076971;Taip;7;1;0;8
8532;Puriena;"Boružiukų ";5336923102;Taip;11;0;0;11
8533;Puriena;"Boružiukų ";3557013127;Taip;7;0;0;7
8534;Puriena;"Boružiukų ";7769252165;Taip;5;2;0;7
8535;Puriena;"Boružiukų ";2170025682;Taip;12;0;0;12
8536;Puriena;"Boružiukų ";1428098802;Taip;14;2;0;16
8537;Puriena;"Boružiukų ";3772941726;Taip;14;2;0;16
8538;Puriena;"Boružiukų ";4460575818;Taip;9;5;0;14
8539;Puriena;"Boružiukų ";4605662701;Taip;9;5;0;14
8540;Puriena;"Boružiukų ";8120597514;Taip;0;9;0;9
8541;Puriena;"Boružiukų ";4776745276;Taip;20;0;0;20
8542;Puriena;"Boružiukų ";6158842119;Taip;20;0;0;20
8543;Puriena;"Boružiukų ";3681811493;Taip;2;1;0;3
8544;Puriena;"Boružiukų ";4060087185;Taip;0;15;0;15
8545;Puriena;"Boružiukų ";8310231540;Taip;0;12;0;12
8546;Puriena;"Boružiukų ";1819876614;Taip;6;2;0;8
8547;Pušaitė;Kodėlčiukai;1972872969;Taip;0;20;0;20
8548;Pušaitė;Kodėlčiukai;44525744411;Taip;11;0;0;11
8549;Pušaitė;Kodėlčiukai;1434600898;Taip;20;0;0;20
8550;Pušaitė;Kodėlčiukai;10978479164;Ne;4;4;0;8
8551;Pušaitė;Kodėlčiukai;10391045958;Taip;0;1;0;1
8552;Pušaitė;Kodėlčiukai;79462284429;Taip;0;6;0;6
8553;Pušaitė;Kodėlčiukai;51875651426;Taip;0;1;4;5
8554;Pušaitė;Kodėlčiukai;35587797387;Taip;0;0;7;7
8555;Pušaitė;Kodėlčiukai;36990708512;Taip;14;0;0;14
8556;Pušaitė;Kodėlčiukai;12300222260;Taip;4;0;0;4
8557;Pušaitė;Kodėlčiukai;37480908997;Taip;0;1;0;1
8558;Pušaitė;Kodėlčiukai;81773729142;Taip;0;0;6;6
8559;Pušaitė;Kodėlčiukai;2856902024;Taip;0;20;0;20
8560;Pušaitė;Kodėlčiukai;15593642938;Taip;0;3;0;3
8561;Pušaitė;Kodėlčiukai;10955132610;Taip;0;0;3;3
8562;Pušaitė;Kodėlčiukai;7680945149;Taip;5;1;0;6
8563;Pušaitė;Kodėlčiukai;1611231114;Taip;8;0;0;8
8564;Pušaitė;Kodėlčiukai;89687717250;Taip;0;2;6;8
8565;Pušaitė;Kodėlčiukai;36677285052;Taip;0;2;0;2
8566;Pušaitė;Kodėlčiukai;3554790718;Taip;0;2;7;9
8567;Pušaitė;Kodėlčiukai;1912176781;Taip;0;9;0;9
8568;Pušaitė;Kodėlčiukai;20960105409;Taip;19;0;0;19
8569;Pušaitė;Kodėlčiukai;1444313482;Taip;6;0;0;6
8570;Pušaitė;Saulutės;1918948738;Taip;6;0;0;6
8571;Pušaitė;Saulutės;58885325641;Taip;5;0;0;5
8572;Pušaitė;Saulutės;29899199427;Taip;9;0;0;9
8573;Pušaitė;Saulutės;20174084726;Ne;0;0;8;8
8574;Pušaitė;Saulutės;36646217833;Taip;0;6;0;6
8575;Pušaitė;Saulutės;40449072854;Taip;14;0;0;14
8576;Pušaitė;Saulutės;46097491628;Taip;0;4;1;5
8577;Pušaitė;Saulutės;34210048269;Taip;5;0;0;5
8578;Pušaitė;Saulutės;2066639203;Taip;0;11;0;11
8579;Pušaitė;Saulutės;34324686486;Taip;0;2;0;2
8580;Pušaitė;Saulutės;88286687854;Taip;9;5;0;14
8581;Pušaitė;Saulutės;1302087452;Taip;14;1;0;15
8582;Pušaitė;Saulutės;12326544543;Taip;0;2;0;2
8583;Pušaitė;Saulutės;61624123734;Taip;0;9;0;9
8584;Pušaitė;Saulutės;10115195053;Taip;5;0;2;7
8585;Pušaitė;Saulutės;22491605433;Taip;0;4;0;4
8586;Pušaitė;Saulutės;81155033460;Taip;0;2;0;2
8587;Pušaitė;Saulutės;1389123203;Taip;5;0;0;5
8588;Pušaitė;Saulutės;2030939996;Taip;0;2;0;2
8589;Pušaitė;Zuikučiai;2115591523;Taip;5;0;7;12
8590;Pušaitė;Zuikučiai;8738827821;Taip;9;4;0;13
8591;Pušaitė;Zuikučiai;2181510181;Taip;0;10;2;12
8592;Pušaitė;Zuikučiai;7477429922;Taip;9;3;1;13
8593;Pušaitė;Zuikučiai;6306133416;Taip;10;0;0;10
8594;Pušaitė;Zuikučiai;2099169654;Taip;20;0;0;20
8595;Pušaitė;Zuikučiai;6355379926;Taip;9;0;1;10
8596;Pušaitė;Zuikučiai;9389544351;Taip;0;20;0;20
8597;Pušaitė;Zuikučiai;1296700534;Taip;12;4;0;16
8598;Pušaitė;Zuikučiai;51500717235;Taip;0;20;0;20
8599;Pušaitė;Zuikučiai;2125574493;Taip;2;0;0;2
8600;Pušaitė;Zuikučiai;5398532705;Taip;6;7;0;13
8601;Pušaitė;Zuikučiai;8309000712;Taip;14;2;0;16
8602;Pušaitė;Zuikučiai;4881689337;Taip;14;0;0;14
8603;Pušaitė;Zuikučiai;3718196299;Taip;4;0;0;4
8604;Pušaitė;Zuikučiai;1295203136;Taip;6;0;3;9
8605;Pušaitė;Zuikučiai;6259961070;Taip;4;0;0;4
8606;Pušaitė;Zuikučiai;2944418714;Taip;9;0;0;9
8607;Pušaitė;Zuikučiai;3813761666;Taip;19;0;1;20
8608;Pušaitė;Zuikučiai;4762094720;Taip;4;0;4;8
8609;Pušaitė;Zuikučiai;6600314608;Taip;10;0;0;10
8610;Pušaitė;Vėžliukai;33935878843;Taip;0;20;0;20
8611;Pušaitė;Vėžliukai;82156965570;Taip;0;7;0;7
8612;Pušaitė;Vėžliukai;23761715185;Taip;10;2;0;12
8613;Pušaitė;Vėžliukai;64592128211;Ne;0;7;0;7
8614;Pušaitė;Vėžliukai;1556107106;Taip;5;1;2;8
8615;Pušaitė;Vėžliukai;82231263639;Taip;0;4;2;6
8616;Pušaitė;Vėžliukai;2841816118;Taip;1;6;1;8
8617;Pušaitė;Vėžliukai;42099662246;Taip;15;5;0;20
8618;Pušaitė;Vėžliukai;18643269807;Taip;7;0;0;7
8619;Pušaitė;Vėžliukai;3633640722;Taip;9;1;0;10
8620;Pušaitė;Vėžliukai;15673961087;Taip;9;0;0;9
8621;Pušaitė;Vėžliukai;57942390119;Taip;0;4;0;4
8622;Pušaitė;Vėžliukai;54773904854;Taip;3;2;0;5
8623;Pušaitė;Vėžliukai;24065238572;Ne;10;0;2;12
8624;Pušaitė;Vėžliukai;94185131317;Taip;0;20;0;20
8625;Pušaitė;Vėžliukai;49430231849;Taip;4;9;0;13
8626;Pušaitė;Vėžliukai;87253675662;Taip;0;5;0;5
8627;Pušaitė;Vėžliukai;85087765749;Taip;0;1;0;1
8628;Pušaitė;Vėžliukai;2452682364;Taip;0;2;0;2
8629;Pušaitė;Vėžliukai;7097481136;Taip;3;4;1;8
8630;Pušaitė;"Linksmieji nykštukai";78786009806;Taip;5;6;0;11
8631;Pušaitė;"Linksmieji nykštukai";44872108751;Taip;1;0;0;1
8632;Pušaitė;"Linksmieji nykštukai";8716642556;Taip;0;20;0;20
8633;Pušaitė;"Linksmieji nykštukai";64419428816;Taip;0;5;2;7
8634;Pušaitė;"Linksmieji nykštukai";60260690155;Taip;0;6;0;6
8635;Pušaitė;"Linksmieji nykštukai";97437734501;Taip;9;1;0;10
8636;Pušaitė;"Linksmieji nykštukai";1195830679;Taip;10;0;0;10
8637;Pušaitė;"Linksmieji nykštukai";31633196136;Taip;0;1;0;1
8638;Pušaitė;"Linksmieji nykštukai";49959888584;Taip;2;2;0;4
8639;Pušaitė;"Linksmieji nykštukai";43153897720;Taip;8;1;0;9
8640;Pušaitė;"Linksmieji nykštukai";35461910180;Taip;4;1;0;5
8641;Pušaitė;"Linksmieji nykštukai";62109955821;Taip;4;4;0;8
8642;Pušaitė;"Linksmieji nykštukai";81382233334;Taip;7;2;0;9
8643;Pušaitė;"Linksmieji nykštukai";2060782612;Taip;0;3;0;3
8644;Pušaitė;"Linksmieji nykštukai";7340376218;Taip;0;1;0;1
8645;Pušaitė;"Linksmieji nykštukai";1877125294;Taip;0;4;6;10
8646;Pušaitė;"Linksmieji nykštukai";7827620759;Taip;0;2;0;2
8647;Pušaitė;"Linksmieji nykštukai";1907401304;Taip;5;9;0;14
8648;Pušaitė;"Linksmieji nykštukai";2725492842;Taip;8;4;0;12
8649;Pušaitė;"Kačiukų trobelė";1822282723;Taip;0;0;1;1
8650;Pušaitė;"Kačiukų trobelė";1665866520;Taip;0;9;6;15
8651;Pušaitė;"Kačiukų trobelė";16304995570;Taip;0;6;1;7
8652;Pušaitė;"Kačiukų trobelė";4007278281;Taip;0;2;0;2
8653;Pušaitė;"Kačiukų trobelė";48012145823;Taip;0;1;0;1
8654;Pušaitė;"Kačiukų trobelė";41913267562;Taip;0;0;1;1
8655;Pušaitė;"Kačiukų trobelė";94141517569;Taip;12;1;0;13
8656;Pušaitė;"Kačiukų trobelė";50194950518;Taip;0;3;0;3
8657;Pušaitė;"Kačiukų trobelė";39697900885;Taip;9;0;0;9
8658;Pušaitė;"Kačiukų trobelė";48452579219;Taip;0;3;0;3
8659;Pušaitė;"Kačiukų trobelė";37954589328;Taip;2;0;0;2
8660;Pušaitė;"Kačiukų trobelė";75933088658;Ne;0;3;0;3
8661;Pušaitė;"Kačiukų trobelė";96861089842;Taip;5;8;0;13
8662;Pušaitė;"Kačiukų trobelė";63041098317;Taip;0;2;0;2
8663;Pušaitė;"Kačiukų trobelė";1478137437;Ne;0;2;0;2
8664;Pušaitė;"Kačiukų trobelė";77239977929;Taip;0;0;2;2
8665;Pušaitė;"Kačiukų trobelė";9124124056;Taip;0;0;1;1
8666;Pušaitė;"Kačiukų trobelė";3996667689;Taip;0;6;1;7
8667;Pušaitė;"Kačiukų trobelė";7216538264;Taip;0;1;0;1
8668;Pušaitė;"Kačiukų trobelė";5534494766;Taip;0;20;0;20
8669;Pušaitė;"Kačiukų trobelė";5354874010;Taip;0;20;0;20
8670;Pušaitė;Ežiukai;3577616212;Taip;8;2;4;14
8671;Pušaitė;Ežiukai;2090143259;Taip;7;0;2;9
8672;Pušaitė;Ežiukai;2951618391;Taip;0;5;3;8
8673;Pušaitė;Ežiukai;9524002395;Taip;0;6;0;6
8674;Pušaitė;Ežiukai;7305350540;Taip;10;0;0;10
8675;Pušaitė;Ežiukai;1111143593;Taip;17;0;0;17
8676;Pušaitė;Ežiukai;5394378197;Taip;10;4;0;14
8677;Pušaitė;Ežiukai;15270671089;Taip;8;0;5;13
8678;Pušaitė;Ežiukai;69869396094;Taip;0;0;2;2
8679;Pušaitė;Ežiukai;1143122778;Taip;7;1;0;8
8680;Pušaitė;Ežiukai;9461292576;Taip;16;0;0;16
8681;Pušaitė;Ežiukai;5185787803;Taip;14;0;0;14
8682;Pušaitė;Ežiukai;4671293211;Taip;14;0;0;14
8683;Pušaitė;Ežiukai;4101326122;Taip;5;0;0;5
8684;Pušaitė;Ežiukai;8958364766;Taip;1;2;0;3
8685;Pušaitė;Ežiukai;2983890410;Taip;5;14;0;19
8686;Pušaitė;Ežiukai;7575143890;Taip;6;4;0;10
8687;Pušaitė;Ežiukai;7808186865;Taip;0;15;0;15
8688;Pušaitė;Ežiukai;4842783897;Taip;14;0;5;19
8689;Pušaitė;Ežiukai;5436168234;Taip;11;0;1;12
8690;Pušaitė;Ežiukai;6472169278;Taip;5;1;0;6
8691;Pušaitė;Ežiukai;8021494509;Taip;0;20;0;20
8692;Pušaitė;Ežiukai;2172342063;Taip;19;0;0;19
8693;Pušaitė;"Gudručių šalis";6470721291;Taip;4;5;0;9
8694;Pušaitė;"Gudručių šalis";24768657107;Taip;1;3;0;4
8695;Pušaitė;"Gudručių šalis";55304000825;Taip;0;4;0;4
8696;Pušaitė;"Gudručių šalis";15550007793;Taip;0;4;0;4
8697;Pušaitė;"Gudručių šalis";4386242143;Taip;12;0;0;12
8698;Pušaitė;"Gudručių šalis";9997642887;Taip;2;1;0;3
8699;Pušaitė;"Gudručių šalis";15546035138;Taip;0;7;0;7
8700;Pušaitė;"Gudručių šalis";79097991060;Taip;0;2;0;2
8701;Pušaitė;"Gudručių šalis";1275885492;Taip;0;2;0;2
8702;Pušaitė;"Gudručių šalis";40886746431;Taip;0;1;0;1
8703;Pušaitė;"Gudručių šalis";66025911973;Taip;5;7;0;12
8704;Pušaitė;"Gudručių šalis";90178990466;Taip;4;0;0;4
8705;Pušaitė;"Gudručių šalis";89985930634;Taip;18;0;0;18
8706;Pušaitė;"Gudručių šalis";4266368627;Ne;6;6;0;12
8707;Pušaitė;"Gudručių šalis";49973513385;Taip;0;4;0;4
8708;Pušaitė;"Gudručių šalis";66238819356;Taip;0;0;2;2
8709;Pušaitė;"Gudručių šalis";89212112638;Taip;0;5;0;5
8710;Pušaitė;"Gudručių šalis";11297426946;Taip;8;1;3;12
8711;Pušaitė;"Gudručių šalis";67365323950;Taip;4;0;0;4
8712;Pušaitė;"Gudručių šalis";35947321028;Taip;0;20;0;20
8713;Pušaitė;"Gudručių šalis";1459628106;Taip;0;1;0;1
8714;Pušaitė;"Gudručių šalis";87504481892;Taip;0;3;0;3
8715;Pušaitė;"Gudručių šalis";6915619931;Taip;5;6;2;13
8716;Pušaitė;"Lapučių mokyklėlė";95522616207;Taip;5;0;0;5
8717;Pušaitė;"Lapučių mokyklėlė";1108868901;Taip;0;20;0;20
8718;Pušaitė;"Lapučių mokyklėlė";1102988768;Taip;0;2;0;2
8719;Pušaitė;"Lapučių mokyklėlė";53211427399;Taip;14;0;0;14
8720;Pušaitė;"Lapučių mokyklėlė";40417586835;Taip;0;4;0;4
8721;Pušaitė;"Lapučių mokyklėlė";91960884985;Taip;13;0;0;13
8722;Pušaitė;"Lapučių mokyklėlė";60394388920;Taip;0;1;6;7
8723;Pušaitė;"Lapučių mokyklėlė";85343380637;Taip;9;0;0;9
8724;Pušaitė;"Lapučių mokyklėlė";2044213583;Taip;0;20;0;20
8725;Pušaitė;"Lapučių mokyklėlė";7408224942;Taip;4;2;0;6
8726;Pušaitė;"Lapučių mokyklėlė";1394847204;Taip;16;1;0;17
8727;Pušaitė;"Lapučių mokyklėlė";97778827111;Taip;0;5;0;5
8728;Pušaitė;"Lapučių mokyklėlė";13127077816;Taip;14;0;0;14
8729;Pušaitė;"Lapučių mokyklėlė";21992678312;Taip;14;1;0;15
8730;Pušaitė;"Lapučių mokyklėlė";6667124375;Taip;2;4;0;6
8731;Pušaitė;"Lapučių mokyklėlė";71218084687;Taip;14;1;0;15
8732;Pušaitė;"Lapučių mokyklėlė";41026183089;Taip;4;0;0;4
8733;Pušaitė;"Lapučių mokyklėlė";77082825248;Taip;2;0;0;2
8734;Pušaitė;"Lapučių mokyklėlė";1487637695;Taip;10;0;3;13
8735;Pušaitė;"Lapučių mokyklėlė";53766202712;Taip;6;1;0;7
8736;Pušaitė;"Lapučių mokyklėlė";3231637165;Taip;10;1;2;13
8737;Pušaitė;"Lapučių mokyklėlė";6542917863;Taip;0;0;5;5
8738;Pušaitė;"VOVERIUKAI ";4662871524;Taip;4;6;0;10
8739;Pušaitė;"VOVERIUKAI ";6323180798;Taip;5;0;5;10
8740;Pušaitė;"VOVERIUKAI ";5191894075;Taip;0;0;7;7
8741;Pušaitė;"VOVERIUKAI ";6180888008;Taip;8;0;3;11
8742;Pušaitė;"VOVERIUKAI ";9127444013;Taip;0;1;1;2
8743;Pušaitė;"VOVERIUKAI ";6578483902;Taip;0;10;1;11
8744;Pušaitė;"VOVERIUKAI ";3350461304;Taip;9;1;1;11
8745;Pušaitė;"VOVERIUKAI ";9313564235;Taip;13;0;1;14
8746;Pušaitė;"VOVERIUKAI ";1781601521;Taip;8;0;0;8
8747;Pušaitė;"VOVERIUKAI ";1024996364;Taip;6;3;1;10
8748;Pušaitė;"VOVERIUKAI ";4123080241;Taip;0;20;0;20
8749;Pušaitė;"VOVERIUKAI ";1161519408;Taip;0;20;0;20
8750;Pušaitė;"VOVERIUKAI ";8822285103;Taip;8;0;0;8
8751;Pušaitė;MEŠKUČIAI;7983115812;Taip;5;0;0;5
8752;Pušaitė;MEŠKUČIAI;3695016765;Taip;0;13;2;15
8753;Pušaitė;MEŠKUČIAI;3195191374;Taip;8;0;0;8
8754;Pušaitė;MEŠKUČIAI;5104111840;Taip;14;0;0;14
8755;Pušaitė;MEŠKUČIAI;1122112207;Taip;0;0;6;6
8756;Pušaitė;MEŠKUČIAI;1624587173;Taip;0;0;7;7
8757;Pušaitė;MEŠKUČIAI;5415680731;Taip;0;20;0;20
8758;Pušaitė;MEŠKUČIAI;3014180020;Taip;14;0;5;19
8759;Pušaitė;MEŠKUČIAI;4175909754;Taip;15;0;2;17
8760;Pušaitė;MEŠKUČIAI;1635528919;Taip;0;0;7;7
8761;Pušaitė;MEŠKUČIAI;3788392895;Taip;0;0;1;1
8762;Pušaitė;MEŠKUČIAI;2837439334;Taip;0;20;0;20
8763;Pušaitė;MEŠKUČIAI;7014914682;Taip;0;3;0;3
8764;Pušaitė;PELIUKAI;9265357004;Taip;0;3;0;3
8765;Pušaitė;PELIUKAI;8793102437;Taip;15;1;0;16
8766;Pušaitė;PELIUKAI;3150144924;Taip;0;6;0;6
8767;Pušaitė;PELIUKAI;9390342572;Taip;20;0;0;20
8768;Pušaitė;PELIUKAI;9056933586;Taip;16;2;0;18
8769;Pušaitė;PELIUKAI;4517181474;Taip;3;2;1;6
8770;Pušaitė;PELIUKAI;9033615485;Taip;6;0;0;6
8771;Pušaitė;PELIUKAI;4605161267;Taip;10;10;0;20
8772;Pušaitė;PELIUKAI;7520393710;Taip;1;0;0;1
8773;Pušaitė;PELIUKAI;4374232593;Taip;17;0;0;17
8774;Pušaitė;PELIUKAI;6160825713;Taip;8;1;0;9
8775;Pušaitė;PELIUKAI;7898355721;Taip;8;0;2;10
8776;Pušaitė;PELIUKAI;3698808100;Taip;11;0;0;11
8777;Pušynėlis;PUMPURĖLIAI;2048377076;Taip;9;0;0;9
8778;Pušynėlis;PUMPURĖLIAI;23816147491;Taip;0;11;0;11
8779;Pušynėlis;PUMPURĖLIAI;9665845150;Taip;10;3;0;13
8780;Pušynėlis;PUMPURĖLIAI;1817179601;Taip;15;1;0;16
8781;Pušynėlis;PUMPURĖLIAI;9466109315;Taip;4;2;0;6
8782;Pušynėlis;PUMPURĖLIAI;9192206804;Taip;0;8;0;8
8783;Pušynėlis;PUMPURĖLIAI;76597184985;Taip;0;0;3;3
8784;Pušynėlis;PUMPURĖLIAI;1284674882;Taip;6;1;0;7
8785;Pušynėlis;PUMPURĖLIAI;9039274775;Taip;13;1;0;14
8786;Pušynėlis;PUMPURĖLIAI;2012089695;Taip;9;1;0;10
8787;Pušynėlis;PUMPURĖLIAI;6077698697;Taip;2;0;2;4
8788;Pušynėlis;PUMPURĖLIAI;25261143142;Taip;15;0;0;15
8789;Pušynėlis;PUMPURĖLIAI;35538053975;Taip;0;1;0;1
8790;Pušynėlis;PUMPURĖLIAI;3510202379;Taip;15;0;2;17
8791;Pušynėlis;PUMPURĖLIAI;9154108688;Taip;15;0;0;15
8792;Pušynėlis;PUMPURĖLIAI;7046421581;Taip;14;0;0;14
8793;Pušynėlis;PUMPURĖLIAI;3037031809;Taip;5;0;0;5
8794;Pušynėlis;PUMPURĖLIAI;6716726918;Taip;8;1;0;9
8795;Pušynėlis;SAULUTĖS;1415916851;Taip;3;0;0;3
8796;Pušynėlis;SAULUTĖS;93484950406;Taip;13;0;2;15
8797;Pušynėlis;SAULUTĖS;91759717760;Taip;0;11;0;11
8798;Pušynėlis;SAULUTĖS;15555681471;Taip;0;6;3;9
8799;Pušynėlis;SAULUTĖS;51866074822;Taip;0;6;5;11
8800;Pušynėlis;SAULUTĖS;2431940444;Taip;0;2;0;2
8801;Pušynėlis;SAULUTĖS;58252435610;Taip;0;0;2;2
8802;Pušynėlis;SAULUTĖS;75716791245;Taip;0;3;0;3
8803;Pušynėlis;SAULUTĖS;40478713455;Taip;0;3;1;4
8804;Pušynėlis;SAULUTĖS;1253953853;Ne;0;11;0;11
8805;Pušynėlis;SAULUTĖS;39796631884;Taip;0;16;1;17
8806;Pušynėlis;SAULUTĖS;48050606382;Taip;0;2;0;2
8807;Pušynėlis;SAULUTĖS;79386112020;Taip;5;1;0;6
8808;Pušynėlis;SAULUTĖS;2042833795;Taip;18;0;0;18
8809;Pušynėlis;SAULUTĖS;1610449906;Taip;0;13;0;13
8810;Pušynėlis;SAULUTĖS;8920359311;Taip;9;0;0;9
8811;Pušynėlis;SAULUTĖS;51835639636;Taip;7;0;2;9
8812;Pušynėlis;SAULUTĖS;32714964224;Taip;9;0;0;9
8813;Pušynėlis;SAULUTĖS;1863758087;Taip;0;1;0;1
8814;Pušynėlis;PRIEŠMOKYKLINĖ;45205911818;Taip;20;0;0;20
8815;Pušynėlis;PRIEŠMOKYKLINĖ;62127095103;Taip;0;3;0;3
8816;Pušynėlis;PRIEŠMOKYKLINĖ;72180767422;Taip;5;0;0;5
8817;Pušynėlis;PRIEŠMOKYKLINĖ;23268964083;Taip;0;2;0;2
8818;Pušynėlis;PRIEŠMOKYKLINĖ;80673105992;Ne;0;13;0;13
8819;Pušynėlis;PRIEŠMOKYKLINĖ;1148988140;Taip;14;0;0;14
8820;Pušynėlis;PRIEŠMOKYKLINĖ;34354697329;Ne;0;4;0;4
8821;Pušynėlis;PRIEŠMOKYKLINĖ;6823339260;Taip;0;1;0;1
8822;Pušynėlis;PRIEŠMOKYKLINĖ;45123764353;Taip;0;8;0;8
8823;Pušynėlis;PRIEŠMOKYKLINĖ;23088088585;Taip;5;0;0;5
8824;Pušynėlis;PRIEŠMOKYKLINĖ;81276442183;Taip;0;6;3;9
8825;Pušynėlis;PRIEŠMOKYKLINĖ;53367560890;Taip;0;1;0;1
8826;Pušynėlis;PRIEŠMOKYKLINĖ;6577939120;Taip;8;4;0;12
8827;Pušynėlis;PRIEŠMOKYKLINĖ;21260292631;Taip;3;1;0;4
8828;Pušynėlis;PRIEŠMOKYKLINĖ;75612576422;Taip;18;0;0;18
8829;Pušynėlis;PRIEŠMOKYKLINĖ;24035278105;Taip;5;3;1;9
8830;Pušynėlis;PRIEŠMOKYKLINĖ;68201469907;Taip;5;1;0;6
8831;Pušynėlis;PRIEŠMOKYKLINĖ;61363661998;Taip;5;5;0;10
8832;Pušynėlis;PRIEŠMOKYKLINĖ;21082691040;Taip;0;2;0;2
8833;Pušynėlis;PRIEŠMOKYKLINĖ;80287782066;Taip;0;0;2;2
8834;Pušynėlis;PRIEŠMOKYKLINĖ;1224747660;Taip;11;0;0;11
8835;Pušynėlis;PRIEŠMOKYKLINĖ;1071102465;Taip;10;6;0;16
8836;Pušynėlis;LOPŠELIS;2141785580;Taip;8;2;0;10
8837;Pušynėlis;LOPŠELIS;2508640229;Taip;5;0;2;7
8838;Pušynėlis;LOPŠELIS;2793982816;Taip;0;0;3;3
8839;Pušynėlis;LOPŠELIS;1034336110;Taip;1;0;6;7
8840;Pušynėlis;LOPŠELIS;1610132076;Taip;2;5;2;9
8841;Pušynėlis;LOPŠELIS;1164201286;Taip;15;0;0;15
8842;Pušynėlis;LOPŠELIS;4920818548;Taip;0;20;0;20
8843;Pušynėlis;LOPŠELIS;5236219294;Taip;14;0;1;15
8844;Pušynėlis;LOPŠELIS;6709692748;Taip;5;4;0;9
8845;Pušynėlis;LOPŠELIS;8799095053;Taip;0;1;0;1
8846;Pušynėlis;LOPŠELIS;5318223378;Taip;16;0;0;16
8847;Pušynėlis;LOPŠELIS;4052132379;Taip;1;2;5;8
8848;Pušynėlis;LOPŠELIS;8451160808;Taip;8;0;1;9
8849;Pušynėlis;LOPŠELIS;5897839636;Taip;0;6;0;6
8850;Raktelis;LAŠIUKAI;91578547534;Taip;0;1;0;1
8851;Raktelis;LAŠIUKAI;84902670203;Taip;7;4;0;11
8852;Raktelis;LAŠIUKAI;54911112924;Taip;10;0;0;10
8853;Raktelis;LAŠIUKAI;58035524929;Taip;0;5;0;5
8854;Raktelis;LAŠIUKAI;44697037907;Ne;10;5;0;15
8855;Raktelis;LAŠIUKAI;44404187711;Taip;0;7;0;7
8856;Raktelis;LAŠIUKAI;4050296775;Taip;0;3;0;3
8857;Raktelis;LAŠIUKAI;2586639003;Ne;3;4;0;7
8858;Raktelis;LAŠIUKAI;83327989096;Taip;5;1;0;6
8859;Raktelis;LAŠIUKAI;43111419596;Taip;11;1;0;12
8860;Raktelis;LAŠIUKAI;74848273145;Taip;0;5;0;5
8861;Raktelis;LAŠIUKAI;61588160544;Taip;5;5;0;10
8862;Raktelis;LAŠIUKAI;10029133549;Ne;10;1;0;11
8863;Raktelis;LAŠIUKAI;59965096201;Taip;0;3;3;6
8864;Raktelis;LAŠIUKAI;81622959801;Taip;0;1;0;1
8865;Raktelis;LAŠIUKAI;7486620978;Taip;0;7;0;7
8866;Raktelis;LAŠIUKAI;1090555980;Taip;0;1;0;1
8867;Raktelis;LAŠIUKAI;6358826871;Taip;4;5;1;10
8868;Raktelis;LAŠIUKAI;88714718433;Taip;0;2;0;2
8869;Raktelis;LAŠIUKAI;8495930552;Taip;9;0;0;9
8870;Raktelis;LAŠIUKAI;1508479097;Taip;8;5;0;13
8871;Raktelis;LAŠIUKAI;13722490194;Taip;0;9;0;9
8872;Raktelis;BITUTĖS;61636842808;Taip;0;9;0;9
8873;Raktelis;BITUTĖS;49216690763;Taip;9;0;3;12
8874;Raktelis;BITUTĖS;68578915107;Taip;0;1;0;1
8875;Raktelis;BITUTĖS;38068336379;Taip;3;0;0;3
8876;Raktelis;BITUTĖS;67716590566;Taip;9;2;1;12
8877;Raktelis;BITUTĖS;77068762851;Taip;0;0;4;4
8878;Raktelis;BITUTĖS;83366206408;Taip;0;1;0;1
8879;Raktelis;BITUTĖS;86120193313;Taip;6;0;1;7
8880;Raktelis;BITUTĖS;1224477393;Ne;3;0;1;4
8881;Raktelis;BITUTĖS;69445577844;Taip;0;1;0;1
8882;Raktelis;BITUTĖS;93797285418;Taip;14;1;0;15
8883;Raktelis;BITUTĖS;60619347523;Taip;8;0;12;20
8884;Raktelis;BITUTĖS;71909273139;Taip;0;6;2;8
8885;Raktelis;BITUTĖS;37587869107;Taip;0;12;0;12
8886;Raktelis;BITUTĖS;1544882634;Taip;9;5;0;14
8887;Raktelis;BITUTĖS;63051817818;Taip;8;0;0;8
8888;Raktelis;BITUTĖS;78841101231;Taip;10;0;2;12
8889;Raktelis;BITUTĖS;76758476679;Taip;20;0;0;20
8890;Raktelis;BITUTĖS;5663304735;Ne;5;1;0;6
8891;Raktelis;BITUTĖS;17270742947;Taip;6;6;0;12
8892;Raktelis;BITUTĖS;5392514118;Taip;15;2;1;18
8893;Raktelis;BITUTĖS;7048022562;Taip;5;0;0;5
8894;Raktelis;BITUTĖS;9774706725;Taip;15;0;0;15
8895;Raktelis;BITUTĖS;1455550617;Taip;0;0;10;10
8896;Raktelis;BORUŽĖLĖS;8117871963;Taip;0;0;7;7
8897;Raktelis;BORUŽĖLĖS;5031703240;Taip;2;1;0;3
8898;Raktelis;BORUŽĖLĖS;95104355224;Taip;10;0;0;10
8899;Raktelis;BORUŽĖLĖS;6049420030;Ne;12;0;0;12
8900;Raktelis;BORUŽĖLĖS;9313156299;Taip;11;0;0;11
8901;Raktelis;BORUŽĖLĖS;54221331553;Taip;14;0;0;14
8902;Raktelis;BORUŽĖLĖS;2070196225;Taip;16;0;0;16
8903;Raktelis;BORUŽĖLĖS;2303286473;Taip;14;0;0;14
8904;Raktelis;BORUŽĖLĖS;1192775994;Taip;10;1;0;11
8905;Raktelis;BORUŽĖLĖS;8374755632;Taip;10;0;0;10
8906;Raktelis;BORUŽĖLĖS;3345708690;Taip;12;0;0;12
8907;Raktelis;BORUŽĖLĖS;8245310502;Taip;20;0;0;20
8908;Raktelis;BORUŽĖLĖS;7487507324;Taip;8;1;0;9
8909;Raktelis;BORUŽĖLĖS;93271260871;Taip;19;1;0;20
8910;Raktelis;BORUŽĖLĖS;6779413882;Taip;14;0;0;14
8911;Raktelis;BORUŽĖLĖS;9584164290;Taip;0;6;0;6
8912;Raktelis;BORUŽĖLĖS;2055530718;Taip;5;1;0;6
8913;Raktelis;BORUŽĖLĖS;6854111162;Taip;0;2;0;2
8914;Raktelis;BORUŽĖLĖS;5818899732;Taip;8;0;0;8
8915;Raktelis;BORUŽĖLĖS;9348898875;Taip;5;0;0;5
8916;Raktelis;BORUŽĖLĖS;9053427316;Taip;9;0;0;9
8917;Raktelis;BORUŽĖLĖS;3762141936;Taip;10;0;0;10
8918;Raktelis;BORUŽĖLĖS;3713386556;Taip;7;7;0;14
8919;Raktelis;KAČIUKAI;8579864696;Taip;11;1;1;13
8920;Raktelis;KAČIUKAI;1393351147;Taip;13;0;0;13
8921;Raktelis;KAČIUKAI;27084497916;Taip;1;0;0;1
8922;Raktelis;KAČIUKAI;1063413424;Ne;0;15;3;18
8923;Raktelis;KAČIUKAI;4449411816;Taip;19;0;0;19
8924;Raktelis;KAČIUKAI;89139880068;Taip;0;5;0;5
8925;Raktelis;KAČIUKAI;1623046697;Taip;5;0;1;6
8926;Raktelis;KAČIUKAI;1468915955;Taip;11;0;0;11
8927;Raktelis;KAČIUKAI;87211875672;Taip;9;0;0;9
8928;Raktelis;KAČIUKAI;21063882404;Taip;19;0;0;19
8929;Raktelis;KAČIUKAI;78145437124;Taip;9;0;0;9
8930;Raktelis;KAČIUKAI;2143998936;Taip;3;4;0;7
8931;Raktelis;KAČIUKAI;1957572199;Taip;10;0;0;10
8932;Raktelis;KAČIUKAI;4906678347;Taip;19;0;0;19
8933;Raktelis;KAČIUKAI;1567546511;Taip;11;4;0;15
8934;Raktelis;KAČIUKAI;86883305675;Taip;5;2;0;7
8935;Raktelis;KAČIUKAI;9380332489;Taip;5;4;0;9
8936;Raktelis;KAČIUKAI;26727657814;Taip;11;0;0;11
8937;Raktelis;KAČIUKAI;30092089456;Taip;19;0;0;19
8938;Raktelis;KAČIUKAI;50372098009;Taip;0;14;0;14
8939;Raktelis;KAČIUKAI;1378192491;Taip;0;8;0;8
8940;Raktelis;KAČIUKAI;3180109604;Taip;19;0;0;19
8941;Raktelis;KAČIUKAI;1046075234;Taip;6;0;0;6
8942;Raktelis;KAČIUKAI;1457880868;Taip;20;0;0;20
8943;Raktelis;KAČIUKAI;4071338645;Taip;19;0;0;19
8944;Raktelis;KIŠKUČIAI;7170546710;Taip;16;1;0;17
8945;Raktelis;KIŠKUČIAI;6014726741;Taip;11;1;0;12
8946;Raktelis;KIŠKUČIAI;1983808547;Taip;2;0;0;2
8947;Raktelis;KIŠKUČIAI;4905982507;Taip;11;1;0;12
8948;Raktelis;KIŠKUČIAI;6367875352;Taip;11;0;0;11
8949;Raktelis;KIŠKUČIAI;6877934219;Taip;12;0;0;12
8950;Raktelis;KIŠKUČIAI;1975411457;Taip;9;0;0;9
8951;Raktelis;KIŠKUČIAI;3661917922;Taip;9;0;0;9
8952;Raktelis;KIŠKUČIAI;6199212999;Taip;1;2;0;3
8953;Raktelis;KIŠKUČIAI;2499890317;Taip;20;0;0;20
8954;Raktelis;KIŠKUČIAI;1843086151;Taip;9;0;0;9
8955;Raktelis;KIŠKUČIAI;5405322552;Taip;15;0;0;15
8956;Raktelis;KIŠKUČIAI;6281687751;Taip;9;0;0;9
8957;Raktelis;KIŠKUČIAI;6550851582;Taip;1;6;0;7
8958;Raktelis;KIŠKUČIAI;7334310944;Taip;8;0;0;8
8959;Raktelis;KIŠKUČIAI;5492437864;Taip;7;1;0;8
8960;Raktelis;KIŠKUČIAI;9779789133;Taip;6;1;0;7
8961;Raktelis;KIŠKUČIAI;6102196040;Taip;6;1;0;7
8962;Raktelis;NYKŠTUKAI;5627179884;Taip;0;1;1;2
8963;Raktelis;NYKŠTUKAI;6608224825;Taip;12;2;0;14
8964;Raktelis;NYKŠTUKAI;9210856228;Taip;15;0;0;15
8965;Raktelis;NYKŠTUKAI;8873203690;Taip;17;0;0;17
8966;Raktelis;NYKŠTUKAI;8559758812;Taip;11;0;0;11
8967;Raktelis;NYKŠTUKAI;2219712757;Taip;12;0;0;12
8968;Raktelis;NYKŠTUKAI;8456082594;Taip;0;19;0;19
8969;Raktelis;NYKŠTUKAI;2807100092;Taip;17;0;0;17
8970;Raktelis;NYKŠTUKAI;5218387088;Taip;10;1;0;11
8971;Raktelis;NYKŠTUKAI;2753402906;Taip;14;0;0;14
8972;Raktelis;NYKŠTUKAI;9591285702;Taip;11;0;0;11
8973;Raktelis;NYKŠTUKAI;5925441742;Taip;10;0;0;10
8974;Raktelis;NYKŠTUKAI;6929358401;Taip;7;0;0;7
8975;Raktelis;NYKŠTUKAI;9593639791;Taip;17;0;0;17
8976;Raktelis;NYKŠTUKAI;4658530212;Taip;19;0;0;19
8977;Raktelis;NYKŠTUKAI;9357757604;Taip;11;3;0;14
8978;Raktelis;NYKŠTUKAI;4335378625;Taip;13;0;0;13
8979;Raktelis;NYKŠTUKAI;7973137015;Taip;20;0;0;20
8980;Raktelis;NYKŠTUKAI;7265543701;Taip;11;0;1;12
8981;Raktelis;NYKŠTUKAI;1392036584;Taip;15;0;0;15
8982;Raktelis;NYKŠTUKAI;8459980712;Taip;15;1;0;16
8983;Raktelis;PELIUKAI;5595087767;Taip;5;0;0;5
8984;Raktelis;PELIUKAI;4610536784;Taip;8;1;0;9
8985;Raktelis;PELIUKAI;3423529085;Taip;0;4;0;4
8986;Raktelis;PELIUKAI;1109105359;Taip;11;0;0;11
8987;Raktelis;PELIUKAI;8320696048;Taip;1;2;1;4
8988;Raktelis;PELIUKAI;1453677708;Taip;6;6;0;12
8989;Raktelis;PELIUKAI;3880578523;Taip;10;0;0;10
8990;Raktelis;PELIUKAI;5768653399;Taip;10;0;0;10
8991;Raktelis;PELIUKAI;4583377785;Taip;12;1;0;13
8992;Raktelis;PELIUKAI;9072312203;Taip;5;1;0;6
8993;Raktelis;PELIUKAI;6385127914;Taip;5;4;0;9
8994;Raktelis;PELIUKAI;3884068578;Taip;2;1;0;3
8995;Raktelis;PELIUKAI;1322912585;Taip;12;0;0;12
8996;Raktelis;PELIUKAI;4228614834;Taip;6;6;0;12
8997;Raktelis;PELIUKAI;4755892641;Taip;16;0;0;16
8998;Raktelis;PELIUKAI;8353427144;Taip;20;0;0;20
8999;Raktelis;PELIUKAI;5082785025;Taip;17;0;0;17
9000;Raktelis;PELIUKAI;7869495911;Taip;13;0;0;13
9001;Raktelis;PELIUKAI;9130613710;Taip;0;3;0;3
9002;Raktelis;PELIUKAI;2282754345;Taip;0;2;0;2
9003;Raktelis;PELIUKAI;8869030487;Taip;18;0;0;18
9004;Raktelis;PELIUKAI;4167194960;Taip;5;0;2;7
9005;Raktelis;AGUONOS;1453259901;Taip;0;0;4;4
9006;Raktelis;AGUONOS;66327590524;Taip;0;5;0;5
9007;Raktelis;AGUONOS;6935703343;Taip;6;5;0;11
9008;Raktelis;AGUONOS;54361317676;Taip;0;7;0;7
9009;Raktelis;AGUONOS;5430563880;Taip;5;4;0;9
9010;Raktelis;AGUONOS;25504804011;Taip;7;2;0;9
9011;Raktelis;AGUONOS;12333424396;Taip;1;4;0;5
9012;Raktelis;AGUONOS;30483797110;Taip;5;4;0;9
9013;Raktelis;AGUONOS;61367764807;Taip;8;0;0;8
9014;Raktelis;AGUONOS;24160611392;Taip;5;4;0;9
9015;Raktelis;AGUONOS;55504358470;Taip;10;3;0;13
9016;Raktelis;AGUONOS;34960672068;Taip;10;0;0;10
9017;Raktelis;AGUONOS;82549894936;Taip;14;2;0;16
9018;Raktelis;AGUONOS;874585350;Taip;5;6;3;14
9019;Raktelis;AGUONOS;79301972646;Taip;0;6;0;6
9020;Raktelis;AGUONOS;24323703041;Taip;0;1;0;1
9021;Raktelis;AGUONOS;8796557675;Taip;14;0;0;14
9022;Raktelis;AGUONOS;1820583792;Taip;20;0;0;20
9023;Raktelis;AGUONOS;5711863758;Taip;6;0;4;10
9024;Raktelis;AGUONOS;1747834520;Taip;17;0;0;17
9025;Raktelis;AGUONOS;5000264125;Taip;11;0;3;14
9026;Raktelis;AGUONOS;53034039807;Taip;13;0;0;13
9027;Raktelis;AGUONOS;5802689482;Taip;5;6;0;11
9028;Raktelis;LAPIUKŲ;8996622650;Taip;12;1;0;13
9029;Raktelis;LAPIUKŲ;51237034253;Taip;5;5;0;10
9030;Raktelis;LAPIUKŲ;1326855282;Taip;12;1;0;13
9031;Raktelis;LAPIUKŲ;45028887854;Taip;0;3;0;3
9032;Raktelis;LAPIUKŲ;92373834478;Ne;0;6;0;6
9033;Raktelis;LAPIUKŲ;68570148753;Taip;9;8;0;17
9034;Raktelis;LAPIUKŲ;53270411090;Ne;5;1;0;6
9035;Raktelis;LAPIUKŲ;10188975432;Taip;10;2;0;12
9036;Raktelis;LAPIUKŲ;15159708127;Taip;14;1;0;15
9037;Raktelis;LAPIUKŲ;95357638985;Taip;9;0;0;9
9038;Raktelis;LAPIUKŲ;25141529581;Taip;9;1;0;10
9039;Raktelis;LAPIUKŲ;43500434912;Taip;0;6;0;6
9040;Raktelis;LAPIUKŲ;9501202273;Taip;10;2;0;12
9041;Raktelis;LAPIUKŲ;98616285680;Taip;2;1;0;3
9042;Raktelis;LAPIUKŲ;67972824332;Taip;0;2;0;2
9043;Raktelis;LAPIUKŲ;54341630847;Taip;7;9;0;16
9044;Raktelis;LAPIUKŲ;1197826066;Taip;13;0;0;13
9045;Raktelis;LAPIUKŲ;5943583254;Taip;0;2;0;2
9046;Raktelis;LAPIUKŲ;4569798381;Taip;16;0;0;16
9047;Raktelis;LAPIUKŲ;1819514057;Ne;5;0;0;5
9048;Raktelis;LAPIUKŲ;67304194087;Taip;14;0;0;14
9049;Raktelis;LAPIUKŲ;15583558585;Taip;1;6;0;7
9050;Raktelis;PELĖDŽIUKAI;2985254060;Taip;9;0;2;11
9051;Raktelis;PELĖDŽIUKAI;59913848400;Taip;0;9;0;9
9052;Raktelis;PELĖDŽIUKAI;73426072972;Taip;7;1;0;8
9053;Raktelis;PELĖDŽIUKAI;23688235312;Taip;0;1;0;1
9054;Raktelis;PELĖDŽIUKAI;68390568000;Taip;11;0;0;11
9055;Raktelis;PELĖDŽIUKAI;61890775725;Taip;0;5;0;5
9056;Raktelis;PELĖDŽIUKAI;26764160130;Taip;18;0;0;18
9057;Raktelis;PELĖDŽIUKAI;58513885211;Taip;19;0;0;19
9058;Raktelis;PELĖDŽIUKAI;75507005694;Taip;0;3;0;3
9059;Raktelis;PELĖDŽIUKAI;79109699217;Taip;5;2;0;7
9060;Raktelis;PELĖDŽIUKAI;11937575740;Taip;1;5;0;6
9061;Raktelis;PELĖDŽIUKAI;34216516886;Taip;14;0;0;14
9062;Raktelis;PELĖDŽIUKAI;15685936471;Taip;14;0;0;14
9063;Raktelis;PELĖDŽIUKAI;24221829774;Taip;5;4;0;9
9064;Raktelis;PELĖDŽIUKAI;57958699478;Taip;7;2;0;9
9065;Raktelis;PELĖDŽIUKAI;46587243900;Taip;8;2;0;10
9066;Raktelis;PELĖDŽIUKAI;18646642032;Taip;5;1;0;6
9067;Raktelis;PELĖDŽIUKAI;5914986262;Taip;11;0;0;11
9068;Raktelis;PELĖDŽIUKAI;48454225305;Taip;9;4;0;13
9069;Raktelis;PELĖDŽIUKAI;32913698258;Taip;0;3;1;4
9070;Raktelis;PELĖDŽIUKAI;67378900057;Ne;5;0;2;7
9071;Raktelis;PELĖDŽIUKAI;40006848965;Taip;5;0;0;5
9072;Raktelis;PELĖDŽIUKAI;38001876942;Taip;0;13;0;13
9073;Raktelis;PELĖDŽIUKAI;67756822733;Taip;11;1;0;12
9074;Raktelis;PELĖDŽIUKAI;82492627;Taip;9;0;0;9
9075;Rasa;Nykštukai;1846631921;Taip;0;6;0;6
9076;Rasa;Nykštukai;59695217278;Taip;10;0;0;10
9077;Rasa;Nykštukai;86870992605;Taip;0;1;0;1
9078;Rasa;Nykštukai;32724807082;Taip;9;3;0;12
9079;Rasa;Nykštukai;36336738780;Taip;0;6;0;6
9080;Rasa;Nykštukai;69640669835;Taip;0;3;0;3
9081;Rasa;Nykštukai;68980971096;Taip;0;1;0;1
9082;Rasa;Nykštukai;36874827315;Taip;12;0;0;12
9083;Rasa;Nykštukai;59339333069;Taip;8;0;0;8
9084;Rasa;Nykštukai;87310376118;Taip;13;1;0;14
9085;Rasa;Nykštukai;1067614202;Taip;7;3;0;10
9086;Rasa;Nykštukai;59127440556;Taip;0;3;0;3
9087;Rasa;Nykštukai;95625598016;Taip;5;0;0;5
9088;Rasa;Nykštukai;29141190550;Taip;0;3;0;3
9089;Rasa;Nykštukai;1549153022;Taip;0;1;0;1
9090;Rasa;Nykštukai;96518910021;Taip;1;2;0;3
9091;Rasa;Nykštukai;5108279813;Taip;0;1;0;1
9092;Rasa;"Širdelė mergaičių estetinio lavinimo grupė";2133989183;Taip;0;4;0;4
9093;Rasa;"Širdelė mergaičių estetinio lavinimo grupė";91941960564;Taip;0;2;0;2
9094;Rasa;"Širdelė mergaičių estetinio lavinimo grupė";1883458628;Taip;0;4;0;4
9095;Rasa;"Širdelė mergaičių estetinio lavinimo grupė";1339376048;Taip;0;0;11;11
9096;Rasa;"Širdelė mergaičių estetinio lavinimo grupė";33479419656;Taip;0;16;0;16
9097;Rasa;"Širdelė mergaičių estetinio lavinimo grupė";3281315532;Taip;0;3;0;3
9098;Rasa;"Širdelė mergaičių estetinio lavinimo grupė";58858081077;Taip;0;6;0;6
9099;Rasa;"Širdelė mergaičių estetinio lavinimo grupė";56168039878;Taip;10;3;0;13
9100;Rasa;"Širdelė mergaičių estetinio lavinimo grupė";4601657045;Taip;13;1;0;14
9101;Rasa;"Širdelė mergaičių estetinio lavinimo grupė";2626361958;Taip;20;0;0;20
9102;Rasa;"Širdelė mergaičių estetinio lavinimo grupė";8866896989;Taip;0;14;1;15
9103;Rasa;"Širdelė mergaičių estetinio lavinimo grupė";13135367451;Taip;0;7;4;11
9104;Rasa;"Širdelė mergaičių estetinio lavinimo grupė";9648034081;Taip;0;1;0;1
9105;Rasa;"Širdelė mergaičių estetinio lavinimo grupė";5599182715;Taip;0;11;0;11
9106;Rasa;"Širdelė mergaičių estetinio lavinimo grupė";9938280570;Taip;13;1;0;14
9107;Rasa;"Širdelė mergaičių estetinio lavinimo grupė";91931863004;Taip;15;0;0;15
9108;Rasa;"Širdelė mergaičių estetinio lavinimo grupė";2132535297;Taip;5;4;0;9
9109;Rasa;"Širdelė mergaičių estetinio lavinimo grupė";23600769349;Taip;0;1;0;1
9110;Rasa;Meškiukai;8278928396;Taip;0;2;0;2
9111;Rasa;Meškiukai;8052120247;Taip;0;0;2;2
9112;Rasa;Meškiukai;1013865195;Taip;0;2;0;2
9113;Rasa;Meškiukai;2110008545;Taip;10;0;0;10
9114;Rasa;Meškiukai;63673920646;Taip;6;0;0;6
9115;Rasa;Meškiukai;4485715299;Taip;6;2;0;8
9116;Rasa;Meškiukai;52913880917;Taip;0;2;0;2
9117;Rasa;Meškiukai;6734478649;Taip;0;0;3;3
9118;Rasa;Meškiukai;5932187584;Taip;5;0;1;6
9119;Rasa;Meškiukai;5145978804;Taip;0;18;3;21
9120;Rasa;Meškiukai;8438563545;Taip;0;0;7;7
9121;Rasa;Meškiukai;6356448094;Taip;0;0;23;23
9122;Rasa;Meškiukai;2683897055;Taip;0;14;0;14
9123;Rasa;Meškiukai;4790859112;Taip;0;0;6;6
9124;Rasa;Meškiukai;7534548604;Taip;0;0;9;9
9125;Rasa;Meškiukai;5606722133;Taip;6;2;0;8
9126;Rasa;Meškiukai;7565880116;Taip;0;0;9;9
9127;Rasa;Meškiukai;7544963724;Taip;5;6;0;11
9128;Rasa;Meškiukai;3567565920;Taip;0;0;4;4
9129;Rasa;Sauliukai;68458114162;Taip;5;4;1;10
9130;Rasa;Sauliukai;42792180843;Taip;5;6;0;11
9131;Rasa;Sauliukai;34022508928;Taip;14;4;0;18
9132;Rasa;Sauliukai;12635625072;Taip;0;20;0;20
9133;Rasa;Sauliukai;18715553061;Taip;0;4;0;4
9134;Rasa;Sauliukai;30725310352;Taip;0;3;0;3
9135;Rasa;Sauliukai;37957299639;Taip;10;0;0;10
9136;Rasa;Sauliukai;2095297719;Taip;6;0;0;6
9137;Rasa;Sauliukai;84260038900;Taip;0;10;0;10
9138;Rasa;Sauliukai;8781212539;Taip;5;3;0;8
9139;Rasa;Sauliukai;92593352340;Taip;0;16;0;16
9140;Rasa;Sauliukai;41438771469;Taip;0;1;0;1
9141;Rasa;Sauliukai;2452794792;Taip;6;4;1;11
9142;Rasa;Sauliukai;79283195492;Taip;5;0;1;6
9143;Rasa;Sauliukai;51362685893;Taip;0;6;0;6
9144;Rasa;Sauliukai;9148315088;Taip;0;7;0;7
9145;Rasa;Sauliukai;89783044220;Taip;5;4;0;9
9146;Rasa;Sauliukai;69984722099;Taip;10;3;0;13
9147;Rasa;Sauliukai;1717387929;Taip;0;2;0;2
9148;Rasa;Sauliukai;35226191822;Taip;0;8;0;8
9149;Rasa;Smalsučiai;38570340276;Ne;0;6;0;6
9150;Rasa;Smalsučiai;1614333465;Taip;5;4;1;10
9151;Rasa;Smalsučiai;62152088598;Taip;0;4;0;4
9152;Rasa;Smalsučiai;47160008402;Taip;0;1;1;2
9153;Rasa;Smalsučiai;1860228984;Taip;0;1;0;1
9154;Rasa;Smalsučiai;61191043836;Taip;0;4;0;4
9155;Rasa;Smalsučiai;67603435279;Taip;0;4;7;11
9156;Rasa;Smalsučiai;18169786070;Taip;5;1;0;6
9157;Rasa;Smalsučiai;7873461118;Taip;0;4;1;5
9158;Rasa;Smalsučiai;2123727085;Taip;20;0;0;20
9159;Rasa;Smalsučiai;1011880741;Taip;5;4;0;9
9160;Rasa;Smalsučiai;1908234170;Ne;0;4;3;7
9161;Rasa;Smalsučiai;38285343302;Taip;0;4;0;4
9162;Rasa;Smalsučiai;35934308248;Taip;0;1;5;6
9163;Rasa;Smalsučiai;2100861702;Taip;0;4;3;7
9164;Rasa;Smalsučiai;1348331466;Taip;0;4;10;14
9165;Rasa;Smalsučiai;33210203210;Taip;0;6;0;6
9166;Rasa;Smalsučiai;79908276669;Taip;8;2;0;10
9167;Rasa;Smalsučiai;2639024477;Taip;0;1;3;4
9168;Rasa;Smalsučiai;27981379045;Taip;0;1;0;1
9169;Rasa;"Pelėdžiukai ";77589878141;Taip;0;0;8;8
9170;Rasa;"Pelėdžiukai ";1658948426;Taip;6;0;0;6
9171;Rasa;"Pelėdžiukai ";1803769089;Taip;10;0;1;11
9172;Rasa;"Pelėdžiukai ";1311346161;Taip;0;5;4;9
9173;Rasa;"Pelėdžiukai ";1581241275;Taip;0;5;0;5
9174;Rasa;"Pelėdžiukai ";20587484061;Taip;0;0;1;1
9175;Rasa;"Pelėdžiukai ";2121070882;Taip;0;0;6;6
9176;Rasa;"Pelėdžiukai ";1457384318;Taip;5;0;0;5
9177;Rasa;"Pelėdžiukai ";3884105235;Taip;6;4;3;13
9178;Rasa;"Pelėdžiukai ";1726266997;Taip;4;0;0;4
9179;Rasa;"Pelėdžiukai ";6704162447;Taip;4;3;1;8
9180;Rasa;"Pelėdžiukai ";7558966891;Taip;8;0;3;11
9181;Rasa;"Pelėdžiukai ";3063226692;Ne;0;9;1;10
9182;Rasa;"Pelėdžiukai ";6773004268;Taip;0;0;14;14
9183;Rasa;"Pelėdžiukai ";8953448462;Taip;5;0;0;5
9184;Rasa;"Pelėdžiukai ";5325275053;Taip;5;9;0;14
9185;Rasa;Katinėliai;69686196470;Taip;4;1;0;5
9186;Rasa;Katinėliai;18425735174;Taip;0;4;0;4
9187;Rasa;Katinėliai;52215260039;Taip;4;5;1;10
9188;Rasa;Katinėliai;3312448238;Taip;7;4;0;11
9189;Rasa;Katinėliai;6462106753;Taip;5;4;0;9
9190;Rasa;Katinėliai;51760275118;Taip;6;4;1;11
9191;Rasa;Katinėliai;97125416712;Ne;0;1;0;1
9192;Rasa;Katinėliai;19313431652;Taip;10;6;0;16
9193;Rasa;Katinėliai;67334304285;Taip;0;3;1;4
9194;Rasa;Katinėliai;1018965809;Taip;0;1;0;1
9195;Rasa;Katinėliai;1226974819;Ne;10;1;0;11
9196;Rasa;Katinėliai;7404447244;Taip;6;9;0;15
9197;Rasa;Katinėliai;74206773356;Taip;14;0;0;14
9198;Rasa;Katinėliai;6781449151;Taip;0;1;2;3
9199;Rasa;Katinėliai;88319654798;Taip;0;4;2;6
9200;Rasa;Katinėliai;95692605702;Taip;10;4;3;17
9201;Rasa;Katinėliai;33757319655;Ne;0;4;0;4
9202;Rasa;Katinėliai;45229725317;Taip;0;5;2;7
9203;Rasa;Katinėliai;1516629281;Taip;23;0;0;23
9204;Rasa;Ančiukai;7520665472;Taip;7;6;0;13
9205;Rasa;Ančiukai;7185331699;Taip;24;0;0;24
9206;Rasa;Ančiukai;1060810039;Taip;23;0;0;23
9207;Rasa;Ančiukai;2977737634;Taip;12;7;0;19
9208;Rasa;Ančiukai;9599510902;Taip;0;22;0;22
9209;Rasa;Ančiukai;7037958994;Taip;14;2;0;16
9210;Rasa;Ančiukai;9668538340;Taip;14;5;0;19
9211;Rasa;Ančiukai;4795339259;Taip;14;0;0;14
9212;Rasa;Ančiukai;3668598028;Taip;1;23;0;24
9213;Rasa;Ančiukai;6019853365;Taip;24;0;0;24
9214;Rasa;Ančiukai;4694111253;Taip;10;2;0;12
9215;Rasa;Ančiukai;6208444770;Taip;9;0;0;9
9216;Rasa;Ančiukai;3664125930;Ne;16;4;0;20
9217;Rasa;Ančiukai;7028605422;Taip;9;7;0;16
9218;Rasa;"Vyturiukai ";1210203141;Taip;0;5;0;5
9219;Rasa;"Vyturiukai ";7575833127;Taip;10;0;1;11
9220;Rasa;"Vyturiukai ";27131705540;Taip;6;2;0;8
9221;Rasa;"Vyturiukai ";1823276800;Taip;0;0;1;1
9222;Rasa;"Vyturiukai ";1651905746;Taip;0;4;0;4
9223;Rasa;"Vyturiukai ";1940633287;Taip;0;0;3;3
9224;Rasa;"Vyturiukai ";66103644564;Taip;5;0;2;7
9225;Rasa;"Vyturiukai ";73115061371;Taip;3;1;0;4
9226;Rasa;"Vyturiukai ";1049242346;Taip;9;0;12;21
9227;Rasa;"Vyturiukai ";1179402963;Taip;0;7;0;7
9228;Rasa;"Vyturiukai ";1210340955;Taip;10;2;0;12
9229;Rasa;"Vyturiukai ";83227920971;Ne;3;8;0;11
9230;Rasa;"Vyturiukai ";34934099958;Taip;0;0;1;1
9231;Rasa;"Vyturiukai ";84161884493;Taip;1;0;0;1
9232;Rasa;"Vyturiukai ";1214055260;Taip;11;4;0;15
9233;Rasa;"Vyturiukai ";50186813736;Taip;21;0;0;21
9234;Rasa;"Vyturiukai ";2041098301;Taip;0;9;0;9
9235;Rasa;"Vyturiukai ";71420694152;Ne;16;0;3;19
9236;Rasa;"Vyturiukai ";1477555365;Taip;0;13;0;13
9237;Rasa;Voveriukai;99911904705;Taip;1;5;0;6
9238;Rasa;Voveriukai;1267340581;Taip;9;0;1;10
9239;Rasa;Voveriukai;1558712079;Taip;6;6;0;12
9240;Rasa;Voveriukai;25918582395;Ne;11;0;0;11
9241;Rasa;Voveriukai;9890493148;Taip;12;0;2;14
9242;Rasa;Voveriukai;79439306932;Taip;0;9;0;9
9243;Rasa;Voveriukai;1728275988;Taip;11;0;1;12
9244;Rasa;Voveriukai;13286984288;Taip;24;0;0;24
9245;Rasa;Voveriukai;74744565967;Taip;5;0;2;7
9246;Rasa;Voveriukai;1452467682;Taip;0;1;0;1
9247;Rasa;Voveriukai;67288516242;Taip;0;16;0;16
9248;Rasa;Voveriukai;2879767810;Taip;0;6;0;6
9249;Rasa;Voveriukai;2158444381;Taip;5;2;0;7
9250;Rasa;"DRUGELIAI ";4847544355;Taip;6;4;2;12
9251;Rasa;"DRUGELIAI ";9847597133;Taip;5;2;0;7
9252;Rasa;"DRUGELIAI ";1386880644;Taip;1;0;5;6
9253;Rasa;"DRUGELIAI ";1223962374;Taip;0;5;0;5
9254;Rasa;"DRUGELIAI ";1336291828;Taip;1;11;0;12
9255;Rasa;"DRUGELIAI ";3200377629;Taip;14;0;0;14
9256;Rasa;"DRUGELIAI ";3979273111;Taip;0;4;0;4
9257;Rasa;"DRUGELIAI ";5176175108;Taip;19;0;4;23
9258;Rasa;"DRUGELIAI ";5363748728;Taip;5;0;2;7
9259;Rasa;"DRUGELIAI ";7004232909;Taip;8;0;2;10
9260;Rasa;"DRUGELIAI ";9723040721;Taip;24;0;0;24
9261;Rasa;"DRUGELIAI ";7228037580;Taip;7;12;0;19
9262;Rasa;"DRUGELIAI ";5861229664;Taip;24;0;0;24
9263;Rasa;"DRUGELIAI ";2540124793;Taip;4;0;3;7
9264;Rasa;"DRUGELIAI ";2093263887;Taip;3;0;0;3
9265;Rasa;Zuikučiai;1916783052;Taip;10;4;0;14
9266;Rasa;Zuikučiai;4554377449;Taip;0;9;0;9
9267;Rasa;Zuikučiai;2137321989;Taip;0;13;0;13
9268;Rasa;Zuikučiai;1432856662;Taip;20;0;0;20
9269;Rasa;Zuikučiai;1993471951;Taip;14;0;0;14
9270;Rasa;Zuikučiai;1860462451;Taip;22;0;0;22
9271;Rasa;Zuikučiai;42609897431;Taip;0;7;0;7
9272;Rasa;Zuikučiai;55374082940;Taip;0;20;0;20
9273;Rasa;Zuikučiai;2114613635;Taip;13;0;0;13
9274;Rasa;Zuikučiai;56016538926;Taip;0;0;2;2
9275;Rasa;Zuikučiai;7397794681;Taip;15;0;0;15
9276;Rasa;Zuikučiai;7657119471;Taip;14;2;0;16
9277;Rasa;Zuikučiai;13297122928;Taip;20;4;0;24
9278;Rasa;Zuikučiai;6795591746;Taip;14;6;0;20
9279;Rasa;Zuikučiai;6108187043;Taip;10;1;0;11
9280;Rasa;Zuikučiai;1560278351;Taip;0;1;4;5
9281;Rasa;Zuikučiai;1004116597;Taip;0;7;0;7
9282;Rasa;Zuikučiai;1690518970;Taip;0;1;3;4
9283;Rasa;Zuikučiai;1131418692;Taip;0;9;0;9
9284;Riešutėlis;Viščiukų;1782544949;Taip;0;10;6;16
9285;Riešutėlis;Viščiukų;91799192513;Taip;0;2;0;2
9286;Riešutėlis;Viščiukų;50427986973;Taip;15;1;1;17
9287;Riešutėlis;Viščiukų;28855582790;Taip;5;4;0;9
9288;Riešutėlis;Viščiukų;2131349938;Taip;8;7;0;15
9289;Riešutėlis;Viščiukų;41275727334;Taip;17;0;0;17
9290;Riešutėlis;Viščiukų;98456292572;Taip;0;5;0;5
9291;Riešutėlis;Viščiukų;63919369801;Taip;9;0;0;9
9292;Riešutėlis;Viščiukų;85564700996;Taip;4;5;0;9
9293;Riešutėlis;Viščiukų;2146831972;Taip;2;1;0;3
9294;Riešutėlis;Viščiukų;61571638960;Taip;13;0;1;14
9295;Riešutėlis;Viščiukų;8857939937;Taip;9;0;0;9
9296;Riešutėlis;Viščiukų;1957794151;Taip;10;5;0;15
9297;Riešutėlis;Viščiukų;5520818573;Taip;5;5;0;10
9298;Riešutėlis;Viščiukų;1743324657;Taip;14;1;0;15
9299;Riešutėlis;Viščiukų;1792212841;Taip;14;3;0;17
9300;Riešutėlis;Viščiukų;1930481567;Taip;5;0;0;5
9301;Riešutėlis;Viščiukų;86455801201;Taip;0;1;1;2
9302;Riešutėlis;Viščiukų;93958381534;Taip;0;1;0;1
9303;Riešutėlis;Viščiukų;1532275496;Taip;5;0;5;10
9304;Riešutėlis;Viščiukų;4311016578;Taip;6;0;14;20
9305;Riešutėlis;Viščiukų;2201158918;Taip;0;0;5;5
9306;Riešutėlis;Viščiukų;4229384438;Taip;14;0;0;14
9307;Riešutėlis;"Riešutėliai ";8077135868;Taip;20;0;0;20
9308;Riešutėlis;"Riešutėliai ";84116863778;Taip;5;2;0;7
9309;Riešutėlis;"Riešutėliai ";1077680441;Taip;11;0;0;11
9310;Riešutėlis;"Riešutėliai ";1430255154;Taip;0;11;0;11
9311;Riešutėlis;"Riešutėliai ";90082848356;Taip;9;1;0;10
9312;Riešutėlis;"Riešutėliai ";6097581240;Taip;3;0;1;4
9313;Riešutėlis;"Riešutėliai ";55620350407;Taip;1;1;0;2
9314;Riešutėlis;"Riešutėliai ";57437627642;Ne;5;0;0;5
9315;Riešutėlis;"Riešutėliai ";2035669978;Taip;5;5;0;10
9316;Riešutėlis;"Riešutėliai ";1105598415;Taip;6;0;0;6
9317;Riešutėlis;"Riešutėliai ";11913461630;Taip;0;1;2;3
9318;Riešutėlis;"Riešutėliai ";1674871670;Taip;9;2;0;11
9319;Riešutėlis;"Riešutėliai ";1853283967;Taip;11;0;1;12
9320;Riešutėlis;"Riešutėliai ";49061075792;Taip;1;4;0;5
9321;Riešutėlis;"Riešutėliai ";1532633795;Taip;10;0;0;10
9322;Riešutėlis;"Riešutėliai ";6855553238;Taip;3;0;1;4
9323;Riešutėlis;"Riešutėliai ";1858221034;Ne;5;0;1;6
9324;Riešutėlis;"Riešutėliai ";3806836220;Taip;0;4;5;9
9325;Riešutėlis;"Riešutėliai ";16308059025;Taip;14;0;0;14
9326;Riešutėlis;"Riešutėliai ";9023304543;Taip;10;0;0;10
9327;Riešutėlis;"Riešutėliai ";1941869661;Taip;0;1;0;1
9328;Riešutėlis;Ežiukai;68367330775;Taip;3;0;0;3
9329;Riešutėlis;Ežiukai;8407612029;Taip;0;2;0;2
9330;Riešutėlis;Ežiukai;83564208896;Taip;0;3;0;3
9331;Riešutėlis;Ežiukai;45372107189;Taip;0;0;2;2
9332;Riešutėlis;Ežiukai;1659653711;Taip;20;0;0;20
9333;Riešutėlis;Ežiukai;20330297586;Taip;0;1;0;1
9334;Riešutėlis;Ežiukai;52227650850;Taip;0;5;0;5
9335;Riešutėlis;Ežiukai;96819764408;Taip;3;0;0;3
9336;Riešutėlis;Ežiukai;66558189779;Taip;0;10;0;10
9337;Riešutėlis;Ežiukai;62003857623;Taip;0;1;0;1
9338;Riešutėlis;Ežiukai;23972193661;Taip;3;2;0;5
9339;Riešutėlis;Ežiukai;54820388507;Taip;5;6;0;11
9340;Riešutėlis;Ežiukai;32134152672;Taip;0;6;0;6
9341;Riešutėlis;Ežiukai;1579325190;Taip;0;2;1;3
9342;Riešutėlis;Ežiukai;57828137061;Taip;6;6;0;12
9343;Riešutėlis;Ežiukai;48055109138;Taip;0;3;0;3
9344;Riešutėlis;Ežiukai;59086252488;Taip;5;3;0;8
9345;Riešutėlis;Ežiukai;9485880468;Taip;5;0;0;5
9346;Riešutėlis;Ežiukai;3626122579;Taip;0;0;4;4
9347;Riešutėlis;Ežiukai;2378768167;Taip;12;1;0;13
9348;Riešutėlis;Ežiukai;1320515966;Taip;10;0;3;13
9349;Riešutėlis;Pelėdžiukai;89573913251;Taip;12;2;0;14
9350;Riešutėlis;Pelėdžiukai;6303767779;Taip;8;0;1;9
9351;Riešutėlis;Pelėdžiukai;7198434243;Taip;7;0;1;8
9352;Riešutėlis;Pelėdžiukai;8018914251;Taip;0;2;1;3
9353;Riešutėlis;Pelėdžiukai;1457008581;Taip;0;0;1;1
9354;Riešutėlis;Pelėdžiukai;8012201566;Taip;15;0;0;15
9355;Riešutėlis;Pelėdžiukai;8751571852;Taip;10;0;2;12
9356;Riešutėlis;Pelėdžiukai;5479780116;Taip;9;0;0;9
9357;Riešutėlis;Pelėdžiukai;7225365172;Taip;1;1;1;3
9358;Riešutėlis;Pelėdžiukai;9839084885;Taip;10;0;0;10
9359;Riešutėlis;Pelėdžiukai;6928558714;Taip;5;0;0;5
9360;Riešutėlis;Pelėdžiukai;9040123535;Taip;0;1;0;1
9361;Riešutėlis;Pelėdžiukai;6405116059;Taip;0;0;4;4
9362;Riešutėlis;Pelėdžiukai;5995176001;Taip;0;3;0;3
9363;Riešutėlis;Pelėdžiukai;2430518637;Taip;7;0;0;7
9364;Riešutėlis;Pelėdžiukai;3970874098;Taip;1;0;0;1
9365;Riešutėlis;Pelėdžiukai;4451419273;Taip;11;0;1;12
9366;Riešutėlis;Pelėdžiukai;1638021880;Taip;0;0;4;4
9367;Riešutėlis;Pelėdžiukai;4581184004;Taip;9;0;0;9
9368;Riešutėlis;Pelėdžiukai;5598052531;Taip;6;0;0;6
9369;Riešutėlis;Pelėdžiukai;5282039544;Ne;8;0;0;8
9370;Riešutėlis;Meškiukai;1485215618;Taip;0;1;0;1
9371;Riešutėlis;Meškiukai;54091928168;Taip;6;1;0;7
9372;Riešutėlis;Meškiukai;35918917950;Taip;20;0;0;20
9373;Riešutėlis;Meškiukai;74152896785;Ne;5;0;0;5
9374;Riešutėlis;Meškiukai;14272401750;Taip;16;0;0;16
9375;Riešutėlis;Meškiukai;37951030398;Taip;12;0;0;12
9376;Riešutėlis;Meškiukai;61160276176;Taip;19;0;0;19
9377;Riešutėlis;Meškiukai;75116205075;Taip;14;1;0;15
9378;Riešutėlis;Meškiukai;50016291414;Taip;10;0;1;11
9379;Riešutėlis;Meškiukai;76883335437;Taip;9;0;1;10
9380;Riešutėlis;Meškiukai;82203033052;Taip;4;1;0;5
9381;Riešutėlis;Meškiukai;30351563466;Taip;3;1;0;4
9382;Riešutėlis;Meškiukai;54175641919;Taip;6;0;0;6
9383;Riešutėlis;Meškiukai;86230171561;Taip;0;2;0;2
9384;Riešutėlis;Meškiukai;7435155136;Taip;5;1;0;6
9385;Riešutėlis;Meškiukai;12005650217;Taip;0;5;0;5
9386;Riešutėlis;Meškiukai;14480798602;Taip;9;0;0;9
9387;Riešutėlis;Meškiukai;17419936511;Taip;5;4;0;9
9388;Riešutėlis;Meškiukai;6201042890;Taip;5;2;0;7
9389;Riešutėlis;Meškiukai;2815239542;Taip;20;0;0;20
9390;Riešutėlis;Meškiukai;8927730307;Taip;8;1;1;10
9391;Riešutėlis;Meškiukai;3722925159;Taip;20;0;0;20
9392;Riešutėlis;Kiškučiai;90088217854;Taip;8;6;1;15
9393;Riešutėlis;Kiškučiai;49061132665;Taip;5;1;0;6
9394;Riešutėlis;Kiškučiai;60941759790;Taip;0;2;0;2
9395;Riešutėlis;Kiškučiai;92159110899;Taip;20;0;0;20
9396;Riešutėlis;Kiškučiai;1623455993;Taip;0;0;3;3
9397;Riešutėlis;Kiškučiai;4464545735;Taip;11;0;0;11
9398;Riešutėlis;Kiškučiai;96066602684;Taip;20;0;0;20
9399;Riešutėlis;Kiškučiai;55715445788;Taip;10;4;1;15
9400;Riešutėlis;Kiškučiai;1747328573;Taip;10;4;1;15
9401;Riešutėlis;Kiškučiai;1250209796;Taip;0;17;2;19
9402;Riešutėlis;Kiškučiai;1526573984;Taip;11;0;1;12
9403;Riešutėlis;Kiškučiai;50338275044;Taip;0;2;0;2
9404;Riešutėlis;Kiškučiai;18310744085;Taip;0;5;0;5
9405;Riešutėlis;Kiškučiai;1748738558;Taip;0;1;0;1
9406;Riešutėlis;Kiškučiai;93192056557;Taip;14;0;1;15
9407;Riešutėlis;Kiškučiai;2973908247;Taip;0;0;2;2
9408;Riešutėlis;Kiškučiai;9205961122;Taip;2;0;0;2
9409;Riešutėlis;Kiškučiai;2163433983;Taip;10;0;0;10
9410;Riešutėlis;Kiškučiai;4916885450;Taip;7;13;0;20
9411;Riešutėlis;Kiškučiai;8864100655;Taip;6;0;0;6
9412;Riešutėlis;Kiškučiai;6149891188;Taip;5;0;0;5
9413;Riešutėlis;Voveriukų;6130980726;Taip;5;5;0;10
9414;Riešutėlis;Voveriukų;6500567162;Taip;15;1;0;16
9415;Riešutėlis;Voveriukų;2034456215;Taip;14;0;0;14
9416;Riešutėlis;Voveriukų;9081486438;Taip;2;4;0;6
9417;Riešutėlis;Voveriukų;1212829190;Taip;14;0;0;14
9418;Riešutėlis;Voveriukų;59279444190;Taip;0;2;0;2
9419;Riešutėlis;Voveriukų;31417468379;Taip;20;0;0;20
9420;Riešutėlis;Voveriukų;1065105725;Taip;6;0;0;6
9421;Riešutėlis;Voveriukų;36176126840;Taip;0;3;0;3
9422;Riešutėlis;Voveriukų;26053212952;Taip;0;2;0;2
9423;Riešutėlis;Voveriukų;51840071269;Taip;0;2;0;2
9424;Riešutėlis;Voveriukų;70549617521;Taip;0;2;0;2
9425;Riešutėlis;Voveriukų;36161702165;Taip;16;0;0;16
9426;Riešutėlis;Voveriukų;46444683383;Taip;1;2;0;3
9427;Riešutėlis;Voveriukų;2163248156;Taip;7;5;0;12
9428;Riešutėlis;Voveriukų;43038393551;Taip;1;0;0;1
9429;Riešutėlis;Voveriukų;56426084480;Taip;6;5;0;11
9430;Riešutėlis;Voveriukų;65629075580;Taip;5;6;0;11
9431;Riešutėlis;Voveriukų;50971787753;Taip;0;1;0;1
9432;Riešutėlis;Voveriukų;89384403521;Taip;0;12;0;12
9433;Riešutėlis;Voveriukų;64736615832;Taip;6;2;0;8
9434;Riešutėlis;Voveriukų;29751938918;Taip;20;0;0;20
9435;Riešutėlis;Saulutės;9198963882;Taip;0;4;0;4
9436;Riešutėlis;Saulutės;2111280879;Taip;0;6;0;6
9437;Riešutėlis;Saulutės;1190403952;Taip;0;1;0;1
9438;Riešutėlis;Saulutės;1160573638;Taip;0;10;0;10
9439;Riešutėlis;Saulutės;1056034480;Taip;18;0;0;18
9440;Riešutėlis;Saulutės;1136025173;Taip;0;8;12;20
9441;Riešutėlis;Saulutės;2097580659;Taip;11;0;0;11
9442;Riešutėlis;Saulutės;2112179980;Taip;20;0;0;20
9443;Riešutėlis;Saulutės;2851186469;Taip;0;1;0;1
9444;Riešutėlis;Saulutės;7207507008;Taip;0;1;0;1
9445;Riešutėlis;Saulutės;8749505821;Taip;0;5;0;5
9446;Riešutėlis;Saulutės;1169051233;Taip;6;0;0;6
9447;Riešutėlis;Saulutės;1091941952;Taip;0;5;0;5
9448;Riešutėlis;Saulutės;24776322315;Taip;5;1;1;7
9449;Riešutėlis;Saulutės;7912773569;Taip;5;1;0;6
9450;Riešutėlis;Saulutės;2655848313;Taip;0;3;1;4
9451;Riešutėlis;Saulutės;4898775561;Taip;0;4;0;4
9452;Riešutėlis;Saulutės;6402032861;Taip;8;0;1;9
9453;Riešutėlis;Saulutės;5717194707;Taip;0;2;0;2
9454;Riešutėlis;Saulutės;5537309549;Taip;0;1;0;1
9455;Riešutėlis;Saulutės;8271632629;Taip;5;2;0;7
9456;Riešutėlis;"Boruželės ";16561622902;Taip;16;0;0;16
9457;Riešutėlis;"Boruželės ";56117509354;Taip;9;5;1;15
9458;Riešutėlis;"Boruželės ";1936519033;Taip;20;0;0;20
9459;Riešutėlis;"Boruželės ";2611705234;Taip;1;1;0;2
9460;Riešutėlis;"Boruželės ";4131218911;Taip;11;0;0;11
9461;Riešutėlis;"Boruželės ";1455509576;Taip;1;1;0;2
9462;Riešutėlis;"Boruželės ";4701887030;Taip;0;1;0;1
9463;Riešutėlis;"Boruželės ";3577669231;Taip;11;1;0;12
9464;Riešutėlis;"Boruželės ";9670912357;Taip;13;0;0;13
9465;Riešutėlis;"Boruželės ";26781529460;Taip;10;0;0;10
9466;Riešutėlis;"Boruželės ";5097410462;Taip;1;0;0;1
9467;Riešutėlis;"Boruželės ";4344185375;Taip;4;2;0;6
9468;Riešutėlis;"Boruželės ";8936419431;Taip;5;5;0;10
9469;Riešutėlis;"Boruželės ";4041498684;Taip;5;4;0;9
9470;Riešutėlis;"Boruželės ";8087180983;Taip;0;20;0;20
9471;Riešutėlis;"Boruželės ";4276034784;Taip;10;0;0;10
9472;Riešutėlis;"Boruželės ";2566084613;Taip;0;10;0;10
9473;Riešutėlis;"Boruželės ";1640383686;Taip;14;0;0;14
9474;Riešutėlis;"Boruželės ";3851000866;Taip;11;0;2;13
9475;Riešutėlis;"Boruželės ";1623681835;Taip;4;0;0;4
9476;Riešutėlis;"Bitutės ";1000408690;Taip;6;0;3;9
9477;Riešutėlis;"Bitutės ";3149710709;Taip;5;0;0;5
9478;Riešutėlis;"Bitutės ";1918857028;Taip;4;1;0;5
9479;Riešutėlis;"Bitutės ";1686215195;Taip;0;1;0;1
9480;Riešutėlis;"Bitutės ";54011982803;Taip;0;4;0;4
9481;Riešutėlis;"Bitutės ";4366097328;Taip;11;2;0;13
9482;Riešutėlis;"Bitutės ";2395648260;Taip;0;12;0;12
9483;Riešutėlis;"Bitutės ";4480906648;Taip;16;1;0;17
9484;Riešutėlis;"Bitutės ";86647499063;Taip;5;0;1;6
9485;Riešutėlis;"Bitutės ";4188823834;Taip;15;0;0;15
9486;Riešutėlis;"Bitutės ";59796628656;Taip;0;2;0;2
9487;Riešutėlis;"Bitutės ";6852846350;Taip;17;0;0;17
9488;Riešutėlis;"Bitutės ";91430094368;Taip;0;4;0;4
9489;Riešutėlis;"Bitutės ";4897379979;Taip;0;0;1;1
9490;Riešutėlis;"Bitutės ";65873300738;Taip;5;4;0;9
9491;Riešutėlis;"Bitutės ";8313605541;Taip;12;0;0;12
9492;Riešutėlis;"Bitutės ";1921241349;Taip;11;0;0;11
9493;Riešutėlis;Drugelių;8266735624;Taip;0;3;0;3
9494;Riešutėlis;Drugelių;4776231497;Taip;0;3;0;3
9495;Riešutėlis;Drugelių;5753609922;Taip;18;0;0;18
9496;Riešutėlis;Drugelių;8578903763;Taip;14;1;0;15
9497;Riešutėlis;Drugelių;3975091711;Taip;7;0;0;7
9498;Riešutėlis;Drugelių;6194259707;Taip;11;0;0;11
9499;Riešutėlis;Drugelių;7769079730;Taip;0;2;1;3
9500;Riešutėlis;Drugelių;5811657782;Taip;10;0;0;10
9501;Riešutėlis;Drugelių;4221375847;Taip;0;20;0;20
9502;Riešutėlis;Drugelių;1075842434;Taip;15;0;0;15
9503;Riešutėlis;Drugelių;8016820352;Taip;15;0;0;15
9504;Riešutėlis;Drugelių;4994368504;Taip;5;0;0;5
9505;Riešutėlis;Drugelių;1942944625;Taip;0;1;0;1
9506;Riešutėlis;Drugelių;8845709386;Taip;19;0;0;19
9507;Riešutėlis;Drugelių;8128352818;Taip;10;0;0;10
9508;Riešutėlis;Drugelių;8352146446;Taip;0;0;1;1
9509;Riešutėlis;Drugelių;8180618419;Taip;13;0;0;13
9510;Riešutėlis;Drugelių;3920525584;Taip;10;0;0;10
9511;Riešutėlis;Drugelių;5412882446;Taip;20;0;0;20
9512;Riešutėlis;Drugelių;8020533200;Taip;12;1;0;13
9513;Ramunėlė;SAULUTĖS;19664665864;Ne;0;18;0;18
9514;Ramunėlė;SAULUTĖS;80319760551;Taip;5;5;0;10
9515;Ramunėlė;SAULUTĖS;37338389480;Taip;10;8;0;18
9516;Ramunėlė;SAULUTĖS;72681762872;Taip;0;5;0;5
9517;Ramunėlė;SAULUTĖS;7736649569;Taip;0;4;0;4
9518;Ramunėlė;SAULUTĖS;43737882488;Taip;0;7;0;7
9519;Ramunėlė;SAULUTĖS;16577268434;Taip;0;3;0;3
9520;Ramunėlė;SAULUTĖS;44016905818;Taip;3;3;0;6
9521;Ramunėlė;SAULUTĖS;19784681244;Taip;0;18;0;18
9522;Ramunėlė;SAULUTĖS;99807372989;Taip;0;13;0;13
9523;Ramunėlė;SAULUTĖS;3599929268;Taip;0;6;0;6
9524;Ramunėlė;SAULUTĖS;9266024764;Taip;0;7;0;7
9525;Ramunėlė;SAULUTĖS;85972695257;Taip;0;8;0;8
9526;Ramunėlė;SAULUTĖS;94707638226;Taip;0;4;0;4
9527;Ramunėlė;SAULUTĖS;69367849602;Taip;0;9;0;9
9528;Ramunėlė;SAULUTĖS;97944093065;Taip;0;2;0;2
9529;Ramunėlė;SAULUTĖS;27163734018;Taip;10;7;0;17
9530;Ramunėlė;SAULUTĖS;1712780584;Taip;0;6;0;6
9531;Ramunėlė;SAULUTĖS;2089805114;Taip;8;0;0;8
9532;Ramunėlė;SAULUTĖS;1079295964;Taip;9;2;1;12
9533;Ramunėlė;SAULUTĖS;26568396284;Taip;9;2;0;11
9534;Ramunėlė;SAULUTĖS;1982905923;Taip;6;2;3;11
9535;Ramunėlė;SAULUTĖS;9918328799;Taip;5;2;0;7
9536;Ramunėlė;ŽIBUTĖ;8943746426;Taip;5;1;0;6
9537;Ramunėlė;ŽIBUTĖ;57697488265;Taip;0;18;0;18
9538;Ramunėlė;ŽIBUTĖ;4103951942;Taip;0;6;0;6
9539;Ramunėlė;ŽIBUTĖ;37227575121;Taip;0;0;2;2
9540;Ramunėlė;ŽIBUTĖ;21178777924;Taip;0;1;0;1
9541;Ramunėlė;ŽIBUTĖ;9615607625;Taip;5;5;0;10
9542;Ramunėlė;ŽIBUTĖ;24395304267;Taip;14;3;0;17
9543;Ramunėlė;ŽIBUTĖ;41210974793;Taip;0;0;6;6
9544;Ramunėlė;ŽIBUTĖ;71451001033;Taip;0;5;0;5
9545;Ramunėlė;ŽIBUTĖ;6126971384;Taip;1;2;0;3
9546;Ramunėlė;ŽIBUTĖ;78632810141;Taip;20;0;0;20
9547;Ramunėlė;ŽIBUTĖ;8826277893;Taip;0;11;0;11
9548;Ramunėlė;ŽIBUTĖ;573414969;Taip;4;1;0;5
9549;Ramunėlė;ŽIBUTĖ;2069380818;Taip;0;0;1;1
9550;Ramunėlė;ŽIBUTĖ;1686559920;Taip;0;8;0;8
9551;Ramunėlė;ŽIBUTĖ;2127262855;Taip;5;6;0;11
9552;Ramunėlė;ŽIBUTĖ;1383896021;Taip;0;2;1;3
9553;Ramunėlė;ŽIBUTĖ;1898089064;Taip;8;7;0;15
9554;Ramunėlė;ŽIBUTĖ;1575204445;Taip;5;0;0;5
9555;Ramunėlė;ŽIBUTĖ;1511271386;Taip;0;13;0;13
9556;Ramunėlė;ŽIBUTĖ;1845973626;Taip;0;1;0;1
9557;Ramunėlė;ŽIBUTĖ;1177226887;Taip;0;2;3;5
9558;Ramunėlė;ŽIRNIUKAI;99821576722;Taip;4;7;0;11
9559;Ramunėlė;ŽIRNIUKAI;50481250500;Taip;0;6;1;7
9560;Ramunėlė;ŽIRNIUKAI;94856703262;Taip;0;7;0;7
9561;Ramunėlė;ŽIRNIUKAI;63588041951;Taip;0;6;0;6
9562;Ramunėlė;ŽIRNIUKAI;65453540817;Taip;0;6;0;6
9563;Ramunėlė;ŽIRNIUKAI;42260677623;Taip;0;15;0;15
9564;Ramunėlė;ŽIRNIUKAI;6024704965;Taip;0;9;0;9
9565;Ramunėlė;ŽIRNIUKAI;26794018418;Taip;0;8;0;8
9566;Ramunėlė;ŽIRNIUKAI;91420704570;Taip;6;4;0;10
9567;Ramunėlė;ŽIRNIUKAI;32944616981;Taip;0;9;0;9
9568;Ramunėlė;ŽIRNIUKAI;26023476423;Taip;0;8;0;8
9569;Ramunėlė;ŽIRNIUKAI;31363181264;Taip;12;2;2;16
9570;Ramunėlė;ŽIRNIUKAI;74094856940;Ne;0;8;0;8
9571;Ramunėlė;ŽIRNIUKAI;84737816930;Taip;19;0;0;19
9572;Ramunėlė;ŽIRNIUKAI;46655439401;Taip;0;10;0;10
9573;Ramunėlė;ŽIRNIUKAI;49072154718;Taip;0;8;0;8
9574;Ramunėlė;ŽIRNIUKAI;81555246386;Taip;0;2;0;2
9575;Ramunėlė;ŽIRNIUKAI;68236739228;Taip;0;4;0;4
9576;Ramunėlė;ŽIRNIUKAI;64011542531;Taip;14;0;0;14
9577;Ramunėlė;ŽIRNIUKAI;74958543608;Taip;0;0;2;2
9578;Ramunėlė;ŽIRNIUKAI;19570213314;Taip;15;3;0;18
9579;Ramunėlė;BITUTĖS;32110200138;Taip;5;0;0;5
9580;Ramunėlė;BITUTĖS;96866067694;Taip;5;11;0;16
9581;Ramunėlė;BITUTĖS;23095478847;Taip;6;4;0;10
9582;Ramunėlė;BITUTĖS;9961229084;Taip;6;2;0;8
9583;Ramunėlė;BITUTĖS;7921336790;Taip;0;8;0;8
9584;Ramunėlė;BITUTĖS;86378277613;Taip;0;7;0;7
9585;Ramunėlė;BITUTĖS;1866642357;Ne;10;2;0;12
9586;Ramunėlė;BITUTĖS;32249506035;Taip;20;0;0;20
9587;Ramunėlė;BITUTĖS;1090204906;Taip;1;0;0;1
9588;Ramunėlė;BITUTĖS;42582811243;Taip;0;3;0;3
9589;Ramunėlė;BITUTĖS;1485483496;Taip;0;11;0;11
9590;Ramunėlė;BITUTĖS;3683430430;Taip;0;13;0;13
9591;Ramunėlė;BITUTĖS;4101387438;Taip;9;0;0;9
9592;Ramunėlė;BITUTĖS;16357824257;Taip;0;14;0;14
9593;Ramunėlė;BITUTĖS;9715654332;Taip;6;0;0;6
9594;Ramunėlė;BITUTĖS;1012658900;Taip;10;10;0;20
9595;Ramunėlė;BITUTĖS;9017349382;Taip;0;6;0;6
9596;Ramunėlė;DRUGELIAI;52584057093;Taip;0;4;3;7
9597;Ramunėlė;DRUGELIAI;22249196276;Taip;3;6;1;10
9598;Ramunėlė;DRUGELIAI;99570998118;Taip;5;3;0;8
9599;Ramunėlė;DRUGELIAI;81774258556;Taip;8;0;4;12
9600;Ramunėlė;DRUGELIAI;22097349678;Taip;4;2;0;6
9601;Ramunėlė;DRUGELIAI;62716754080;Taip;9;3;0;12
9602;Ramunėlė;DRUGELIAI;14581393355;Taip;0;6;1;7
9603;Ramunėlė;DRUGELIAI;35823437202;Taip;0;5;0;5
9604;Ramunėlė;DRUGELIAI;15363368541;Taip;0;1;0;1
9605;Ramunėlė;DRUGELIAI;15310034187;Taip;2;5;0;7
9606;Ramunėlė;DRUGELIAI;25346770513;Taip;11;2;0;13
9607;Ramunėlė;DRUGELIAI;72620475723;Taip;0;4;0;4
9608;Ramunėlė;DRUGELIAI;92929314036;Taip;11;0;0;11
9609;Ramunėlė;DRUGELIAI;28838673166;Ne;13;1;0;14
9610;Ramunėlė;DRUGELIAI;1253351354;Taip;0;0;4;4
9611;Ramunėlė;DRUGELIAI;13195968349;Taip;0;7;0;7
9612;Ramunėlė;DRUGELIAI;84319432445;Taip;0;2;1;3
9613;Ramunėlė;DRUGELIAI;21608020858;Taip;14;1;0;15
9614;Ramunėlė;DRUGELIAI;1478538572;Taip;5;6;0;11
9615;Ramunėlė;DRUGELIAI;26152001976;Taip;0;3;0;3
9616;Ramunėlė;DRUGELIAI;1175561112;Taip;0;6;0;6
9617;Ramunėlė;NEUŽMIRŠTUOLĖS;19420482998;Taip;4;8;0;12
9618;Ramunėlė;NEUŽMIRŠTUOLĖS;4990982790;Taip;2;2;0;4
9619;Ramunėlė;NEUŽMIRŠTUOLĖS;9130637883;Taip;14;1;0;15
9620;Ramunėlė;NEUŽMIRŠTUOLĖS;3271832822;Taip;10;2;0;12
9621;Ramunėlė;NEUŽMIRŠTUOLĖS;3554787356;Taip;13;0;1;14
9622;Ramunėlė;NEUŽMIRŠTUOLĖS;8098492540;Taip;4;8;0;12
9623;Ramunėlė;NEUŽMIRŠTUOLĖS;6217540064;Taip;5;0;4;9
9624;Ramunėlė;NEUŽMIRŠTUOLĖS;17201639406;Taip;6;0;0;6
9625;Ramunėlė;NEUŽMIRŠTUOLĖS;3065727741;Taip;18;0;0;18
9626;Ramunėlė;NEUŽMIRŠTUOLĖS;4511376806;Taip;6;5;0;11
9627;Ramunėlė;NEUŽMIRŠTUOLĖS;9171690612;Taip;15;1;0;16
9628;Ramunėlė;NEUŽMIRŠTUOLĖS;8357049686;Taip;10;10;0;20
9629;Ramunėlė;NEUŽMIRŠTUOLĖS;6329943991;Taip;13;0;0;13
9630;Ramunėlė;NEUŽMIRŠTUOLĖS;8940763540;Taip;0;0;19;19
9631;Ramunėlė;NEUŽMIRŠTUOLĖS;8086994543;Taip;12;0;0;12
9632;Ramunėlė;NEUŽMIRŠTUOLĖS;7652421432;Taip;13;0;0;13
9633;Ramunėlė;NEUŽMIRŠTUOLĖS;5822045625;Taip;5;0;0;5
9634;Ramunėlė;NEUŽMIRŠTUOLĖS;2225787182;Taip;6;12;0;18
9635;Ramunėlė;OBUOLIUKAI;1376538015;Ne;0;5;0;5
9636;Ramunėlė;OBUOLIUKAI;1783572058;Taip;3;5;0;8
9637;Ramunėlė;OBUOLIUKAI;30907738272;Taip;2;1;0;3
9638;Ramunėlė;OBUOLIUKAI;1891454355;Taip;19;0;0;19
9639;Ramunėlė;OBUOLIUKAI;1814199950;Taip;5;1;0;6
9640;Ramunėlė;OBUOLIUKAI;1199690327;Taip;9;1;0;10
9641;Ramunėlė;OBUOLIUKAI;52168460247;Taip;7;0;0;7
9642;Ramunėlė;OBUOLIUKAI;67836032797;Taip;0;1;0;1
9643;Ramunėlė;OBUOLIUKAI;66630134164;Taip;4;0;0;4
9644;Ramunėlė;OBUOLIUKAI;1988109236;Taip;8;7;0;15
9645;Ramunėlė;OBUOLIUKAI;1083479451;Taip;5;0;0;5
9646;Ramunėlė;OBUOLIUKAI;7228065409;Taip;1;9;0;10
9647;Ramunėlė;OBUOLIUKAI;2567264851;Taip;11;0;8;19
9648;Ramunėlė;OBUOLIUKAI;9584620339;Taip;9;0;0;9
9649;Ramunėlė;OBUOLIUKAI;8402889872;Taip;5;1;0;6
9650;Ramunėlė;OBUOLIUKAI;1745170057;Taip;8;6;0;14
9651;Ramunėlė;OBUOLIUKAI;3617897977;Taip;3;0;1;4
9652;Ramunėlė;OBUOLIUKAI;8768539595;Taip;0;7;0;7
9653;Ramunėlė;OBUOLIUKAI;2055332353;Taip;5;5;0;10
9654;Ramunėlė;OBUOLIUKAI;7955507702;Taip;5;0;0;5
9655;Ramunėlė;OBUOLIUKAI;58573425792;Taip;5;0;0;5
9656;Ramunėlė;OBUOLIUKAI;6930505887;Taip;6;0;0;6
9657;Ramunėlė;SAULĖGRĄŽA;3973083939;Taip;8;1;0;9
9658;Ramunėlė;SAULĖGRĄŽA;53748116108;Taip;0;6;0;6
9659;Ramunėlė;SAULĖGRĄŽA;1028730863;Taip;8;6;0;14
9660;Ramunėlė;SAULĖGRĄŽA;1085668968;Taip;0;3;0;3
9661;Ramunėlė;SAULĖGRĄŽA;1500685962;Taip;0;4;0;4
9662;Ramunėlė;SAULĖGRĄŽA;2075485387;Taip;16;2;0;18
9663;Ramunėlė;SAULĖGRĄŽA;2036562086;Taip;4;1;0;5
9664;Ramunėlė;SAULĖGRĄŽA;85179822339;Taip;6;0;0;6
9665;Ramunėlė;SAULĖGRĄŽA;57963557951;Taip;8;3;0;11
9666;Ramunėlė;SAULĖGRĄŽA;1485876800;Taip;0;9;0;9
9667;Ramunėlė;SAULĖGRĄŽA;9924675250;Taip;4;0;0;4
9668;Ramunėlė;SAULĖGRĄŽA;1386186515;Taip;1;0;2;3
9669;Ramunėlė;SAULĖGRĄŽA;1171170929;Taip;4;0;2;6
9670;Ramunėlė;SAULĖGRĄŽA;10677635919;Taip;9;5;0;14
9671;Ramunėlė;SAULĖGRĄŽA;11512621396;Taip;14;0;1;15
9672;Ramunėlė;SAULĖGRĄŽA;1157861595;Taip;11;0;0;11
9673;Ramunėlė;SAULĖGRĄŽA;17292085814;Taip;14;4;0;18
9674;Ramunėlė;SAULĖGRĄŽA;4814208279;Taip;14;2;0;16
9675;Ramunėlė;SAULĖGRĄŽA;8254302108;Taip;0;2;0;2
9676;Ramunėlė;SAULĖGRĄŽA;1364997950;Taip;2;5;0;7
9677;Ramunėlė;SAULĖGRĄŽA;1397784717;Taip;9;0;0;9
9678;Ramunėlė;SAULĖGRĄŽA;8496322672;Taip;11;0;0;11
9679;Ramunėlė;BORUŽĖLĖS;82024687579;Taip;0;8;0;8
9680;Ramunėlė;BORUŽĖLĖS;1563618796;Taip;11;2;0;13
9681;Ramunėlė;BORUŽĖLĖS;76195144469;Taip;0;0;4;4
9682;Ramunėlė;BORUŽĖLĖS;1033548164;Taip;0;2;2;4
9683;Ramunėlė;BORUŽĖLĖS;1946639898;Taip;16;0;0;16
9684;Ramunėlė;BORUŽĖLĖS;1058243928;Taip;18;0;0;18
9685;Ramunėlė;BORUŽĖLĖS;63470398650;Taip;6;1;0;7
9686;Ramunėlė;BORUŽĖLĖS;93125217886;Taip;7;0;0;7
9687;Ramunėlė;BORUŽĖLĖS;1690224857;Taip;9;0;0;9
9688;Ramunėlė;BORUŽĖLĖS;1827657363;Taip;0;6;0;6
9689;Ramunėlė;BORUŽĖLĖS;1642082135;Taip;0;0;1;1
9690;Ramunėlė;BORUŽĖLĖS;1176835101;Taip;0;7;0;7
9691;Ramunėlė;BORUŽĖLĖS;1341351994;Taip;0;8;0;8
9692;Ramunėlė;BORUŽĖLĖS;2859202237;Taip;5;3;0;8
9693;Ramunėlė;BORUŽĖLĖS;1405532116;Taip;0;2;0;2
9694;Ramunėlė;BORUŽĖLĖS;1709795078;Taip;0;17;0;17
9695;Ramunėlė;BORUŽĖLĖS;1077068878;Taip;9;2;3;14
9696;Ramunėlė;BORUŽĖLĖS;1207455851;Taip;5;0;0;5
9697;Ramunėlė;NYKŠTUKAS;2995509132;Taip;4;3;0;7
9698;Ramunėlė;NYKŠTUKAS;3301219357;Taip;6;1;0;7
9699;Ramunėlė;NYKŠTUKAS;1800967823;Taip;0;0;4;4
9700;Ramunėlė;NYKŠTUKAS;7829765488;Taip;12;0;0;12
9701;Ramunėlė;NYKŠTUKAS;8205893352;Taip;11;0;0;11
9702;Ramunėlė;NYKŠTUKAS;4392309015;Taip;0;0;4;4
9703;Ramunėlė;NYKŠTUKAS;9984243153;Taip;10;0;0;10
9704;Ramunėlė;NYKŠTUKAS;8656417794;Taip;8;2;5;15
9705;Ramunėlė;NYKŠTUKAS;9663290607;Taip;9;0;0;9
9706;Ramunėlė;NYKŠTUKAS;2569491673;Taip;9;0;0;9
9707;Ramunėlė;NYKŠTUKAS;7902931560;Taip;7;3;0;10
9708;Ramunėlė;NYKŠTUKAS;3883411539;Taip;0;1;4;5
9709;Ramunėlė;NYKŠTUKAS;5049415445;Taip;7;0;0;7
9710;Ramunėlė;NYKŠTUKAS;5465647281;Taip;10;4;0;14
9711;Ramunėlė;NYKŠTUKAS;6809164145;Taip;7;0;1;8
9712;Ramunėlė;NYKŠTUKAS;5436185479;Taip;5;0;0;5
9713;Ramunėlė;UOGELĖ;6134554678;Taip;20;0;0;20
9714;Ramunėlė;UOGELĖ;8726443989;Taip;11;3;0;14
9715;Ramunėlė;UOGELĖ;3852734401;Taip;10;1;0;11
9716;Ramunėlė;UOGELĖ;1192743154;Taip;6;6;0;12
9717;Ramunėlė;UOGELĖ;5650659504;Taip;6;2;0;8
9718;Ramunėlė;UOGELĖ;5562960498;Taip;0;14;0;14
9719;Ramunėlė;UOGELĖ;1599595174;Taip;18;0;0;18
9720;Ramunėlė;UOGELĖ;1483391590;Taip;0;1;0;1
9721;Ramunėlė;UOGELĖ;5605444408;Taip;3;0;0;3
9722;Ramunėlė;UOGELĖ;8323020864;Taip;8;0;0;8
9723;Ramunėlė;UOGELĖ;8912978935;Taip;5;2;0;7
9724;Ramunėlė;UOGELĖ;9320573498;Taip;0;1;0;1
9725;Ramunėlė;UOGELĖ;5420360864;Taip;16;2;2;20
9726;Ramunėlė;UOGELĖ;3779769727;Taip;0;9;0;9
9727;Ramunėlė;UOGELĖ;8929122197;Taip;0;2;2;4
9728;Ramunėlė;UOGELĖ;4575123456;Taip;6;0;0;6
9729;Ramunėlė;UOGELĖ;3574886801;Taip;20;0;0;20
9730;Ramunėlė;VARPELIAI;3762539352;Taip;5;0;0;5
9731;Ramunėlė;VARPELIAI;2499280049;Taip;0;5;0;5
9732;Ramunėlė;VARPELIAI;2007790746;Taip;0;3;0;3
9733;Ramunėlė;VARPELIAI;6310921755;Taip;16;2;0;18
9734;Ramunėlė;VARPELIAI;3685786758;Taip;0;4;0;4
9735;Ramunėlė;VARPELIAI;7750405604;Taip;0;2;0;2
9736;Ramunėlė;VARPELIAI;58028743912;Taip;20;0;0;20
9737;Ramunėlė;VARPELIAI;4349250416;Taip;6;4;0;10
9738;Ramunėlė;VARPELIAI;3055294324;Taip;15;1;0;16
9739;Ramunėlė;VARPELIAI;9448369796;Taip;6;0;0;6
9740;Ramunėlė;VARPELIAI;6612728883;Taip;0;10;0;10
9741;Ramunėlė;VARPELIAI;1534723406;Taip;6;0;0;6
9742;Ramunėlė;VARPELIAI;7295041630;Taip;3;2;1;6
9743;Ramunėlė;VARPELIAI;1216101539;Taip;5;8;0;13
9744;Ramunėlė;VARPELIAI;4677819736;Taip;0;0;1;1
9745;Ramunėlė;VARPELIAI;6837072361;Taip;0;8;0;8
9746;Ramunėlė;VARPELIAI;1303053333;Taip;0;1;0;1
9747;Ramunėlė;VARPELIAI;6695672297;Taip;7;2;0;9
9748;Ramunėlė;VARPELIAI;7638038269;Taip;8;0;1;9
9749;Ramunėlė;VARPELIAI;3566074517;Taip;0;10;0;10
9750;Ramunėlė;VARPELIAI;7825538259;Taip;0;0;1;1
9751;Rūta;SMALSUČIAI;14391882157;Taip;1;0;1;2
9752;Rūta;SMALSUČIAI;18117978189;Taip;6;2;2;10
9753;Rūta;SMALSUČIAI;184041928;Taip;0;4;0;4
9754;Rūta;SMALSUČIAI;77285178781;Taip;13;0;0;13
9755;Rūta;SMALSUČIAI;45391890869;Ne;4;0;1;5
9756;Rūta;SMALSUČIAI;78953568121;Taip;10;2;0;12
9757;Rūta;SMALSUČIAI;89046897963;Taip;5;4;0;9
9758;Rūta;SMALSUČIAI;26152518052;Taip;5;9;0;14
9759;Rūta;SMALSUČIAI;68107516536;Taip;0;3;0;3
9760;Rūta;SMALSUČIAI;87692898919;Taip;19;0;0;19
9761;Rūta;SMALSUČIAI;1937805277;Taip;4;0;0;4
9762;Rūta;SMALSUČIAI;3874247966;Taip;11;3;0;14
9763;Rūta;SMALSUČIAI;1323253379;Taip;11;0;1;12
9764;Rūta;SMALSUČIAI;8604212304;Taip;9;4;0;13
9765;Rūta;SMALSUČIAI;38837808144;Taip;10;0;2;12
9766;Rūta;SMALSUČIAI;50814418724;Taip;0;8;0;8
9767;Rūta;SMALSUČIAI;1364470800;Taip;11;0;1;12
9768;Rūta;SMALSUČIAI;1996690514;Taip;0;9;0;9
9769;Rūta;SMALSUČIAI;59694891781;Taip;0;9;0;9
9770;Rūta;SMALSUČIAI;1945068716;Taip;11;0;0;11
9771;Rūta;SMALSUČIAI;83473072263;Taip;6;0;1;7
9772;Rūta;KŪLVERSTUKAI;1080628212;Taip;0;0;1;1
9773;Rūta;KŪLVERSTUKAI;1800198849;Taip;0;12;0;12
9774;Rūta;KŪLVERSTUKAI;80410156050;Taip;8;0;0;8
9775;Rūta;KŪLVERSTUKAI;1150292834;Taip;10;0;0;10
9776;Rūta;KŪLVERSTUKAI;56171468735;Taip;0;7;0;7
9777;Rūta;KŪLVERSTUKAI;88159609117;Taip;0;3;0;3
9778;Rūta;KŪLVERSTUKAI;48758751494;Taip;0;0;15;15
9779;Rūta;KŪLVERSTUKAI;2084379688;Taip;0;4;0;4
9780;Rūta;KŪLVERSTUKAI;1807332522;Taip;3;5;0;8
9781;Rūta;KŪLVERSTUKAI;1674584707;Taip;9;0;0;9
9782;Rūta;KŪLVERSTUKAI;2079429418;Taip;0;10;0;10
9783;Rūta;KŪLVERSTUKAI;1972150300;Taip;4;5;0;9
9784;Rūta;KŪLVERSTUKAI;99777522247;Taip;10;0;0;10
9785;Rūta;KŪLVERSTUKAI;50658624766;Taip;19;0;0;19
9786;Rūta;KŪLVERSTUKAI;1971925569;Taip;5;5;0;10
9787;Rūta;KŪLVERSTUKAI;56470874552;Taip;5;0;0;5
9788;Rūta;KŪLVERSTUKAI;1363296753;Taip;14;4;0;18
9789;Rūta;KŪLVERSTUKAI;17349566042;Taip;9;1;0;10
9790;Rūta;KŪLVERSTUKAI;1043614414;Taip;14;1;0;15
9791;Rūta;KŪLVERSTUKAI;1703148668;Taip;12;0;0;12
9792;Rūta;KODĖLČIUKAI;6136733410;Taip;14;0;0;14
9793;Rūta;KODĖLČIUKAI;8607455403;Taip;0;2;0;2
9794;Rūta;KODĖLČIUKAI;4168356825;Taip;10;0;0;10
9795;Rūta;KODĖLČIUKAI;1186493111;Taip;0;10;0;10
9796;Rūta;KODĖLČIUKAI;1390207547;Taip;0;3;0;3
9797;Rūta;KODĖLČIUKAI;9569447586;Taip;0;6;0;6
9798;Rūta;KODĖLČIUKAI;1579573872;Taip;0;3;0;3
9799;Rūta;KODĖLČIUKAI;32004750783;Taip;0;6;0;6
9800;Rūta;KODĖLČIUKAI;6982618655;Taip;0;6;0;6
9801;Rūta;KODĖLČIUKAI;1433704180;Taip;16;0;0;16
9802;Rūta;KODĖLČIUKAI;1671913833;Taip;0;0;2;2
9803;Rūta;KODĖLČIUKAI;4282074540;Taip;0;6;2;8
9804;Rūta;KODĖLČIUKAI;5866619097;Taip;3;10;1;14
9805;Rūta;KODĖLČIUKAI;2677062861;Taip;5;0;1;6
9806;Rūta;KODĖLČIUKAI;1415664888;Taip;0;0;8;8
9807;Rūta;KODĖLČIUKAI;4426456302;Taip;1;0;0;1
9808;Rūta;KODĖLČIUKAI;7916863933;Taip;5;0;0;5
9809;Rūta;KODĖLČIUKAI;9675482322;Taip;18;0;0;18
9810;Rūta;KODĖLČIUKAI;2912054049;Taip;0;4;0;4
9811;Rūta;BORUŽĖLĖS;1346367896;Taip;4;4;0;8
9812;Rūta;BORUŽĖLĖS;1565896222;Taip;11;1;1;13
9813;Rūta;BORUŽĖLĖS;8673942478;Taip;0;6;10;16
9814;Rūta;BORUŽĖLĖS;1092908255;Taip;8;1;1;10
9815;Rūta;BORUŽĖLĖS;1521231573;Taip;5;0;12;17
9816;Rūta;BORUŽĖLĖS;1967141665;Taip;7;0;4;11
9817;Rūta;BORUŽĖLĖS;8889388348;Taip;5;0;3;8
9818;Rūta;BORUŽĖLĖS;8704594038;Taip;0;0;1;1
9819;Rūta;BORUŽĖLĖS;3478456813;Taip;10;1;0;11
9820;Rūta;BORUŽĖLĖS;1180144866;Taip;5;5;0;10
9821;Rūta;BORUŽĖLĖS;4078957924;Taip;5;0;0;5
9822;Rūta;BORUŽĖLĖS;4363571135;Taip;10;5;0;15
9823;Rūta;BORUŽĖLĖS;4754142240;Taip;5;3;3;11
9824;Rūta;BORUŽĖLĖS;2116581815;Taip;10;0;7;17
9825;Rūta;BORUŽĖLĖS;8851591109;Taip;10;0;0;10
9826;Rūta;BORUŽĖLĖS;1336973131;Taip;0;2;0;2
9827;Rūta;BORUŽĖLĖS;7631229177;Taip;12;0;0;12
9828;Rūta;VYTURĖLIAI;1938200654;Taip;7;0;0;7
9829;Rūta;VYTURĖLIAI;31821660367;Taip;0;11;0;11
9830;Rūta;VYTURĖLIAI;14552031490;Taip;15;0;0;15
9831;Rūta;VYTURĖLIAI;46129637744;Taip;0;5;0;5
9832;Rūta;VYTURĖLIAI;24807873951;Taip;3;3;0;6
9833;Rūta;VYTURĖLIAI;86163505598;Taip;0;1;0;1
9834;Rūta;VYTURĖLIAI;89650991326;Taip;0;3;0;3
9835;Rūta;VYTURĖLIAI;86514347752;Taip;10;0;0;10
9836;Rūta;VYTURĖLIAI;8941291651;Taip;3;5;0;8
9837;Rūta;VYTURĖLIAI;92007397776;Taip;3;5;0;8
9838;Rūta;VYTURĖLIAI;92554408021;Taip;5;4;0;9
9839;Rūta;VYTURĖLIAI;27023480832;Taip;11;0;0;11
9840;Rūta;VYTURĖLIAI;87233420613;Taip;0;3;1;4
9841;Rūta;VYTURĖLIAI;90699177243;Taip;0;6;3;9
9842;Rūta;VYTURĖLIAI;70038163995;Taip;0;6;7;13
9843;Rūta;VYTURĖLIAI;56355568788;Taip;0;1;11;12
9844;Rūta;VYTURĖLIAI;21286497837;Taip;0;8;0;8
9845;Rūta;VYTURĖLIAI;74717101386;Taip;4;1;0;5
9846;Rūta;VYTURĖLIAI;67822551240;Taip;0;5;1;6
9847;Rūta;VYTURĖLIAI;18736757488;Taip;0;1;2;3
9848;Rūta;VYTURĖLIAI;8213932715;Taip;0;7;0;7
9849;Rūta;"PABIRUČIAI (LOGOPEDINĖ)";70608720189;Taip;10;0;0;10
9850;Rūta;"PABIRUČIAI (LOGOPEDINĖ)";57805651069;Taip;11;0;0;11
9851;Rūta;"PABIRUČIAI (LOGOPEDINĖ)";58313529531;Taip;16;0;0;16
9852;Rūta;"PABIRUČIAI (LOGOPEDINĖ)";97812491022;Taip;10;0;0;10
9853;Rūta;"PABIRUČIAI (LOGOPEDINĖ)";1489564914;Taip;17;1;0;18
9854;Rūta;"PABIRUČIAI (LOGOPEDINĖ)";1831410058;Taip;5;0;0;5
9855;Rūta;"PABIRUČIAI (LOGOPEDINĖ)";45484303685;Taip;11;0;0;11
9856;Rūta;GUDRUČIAI;69788516459;Taip;3;0;1;4
9857;Rūta;GUDRUČIAI;78925728976;Ne;0;0;1;1
9858;Rūta;GUDRUČIAI;44365150696;Taip;0;14;0;14
9859;Rūta;GUDRUČIAI;10957816153;Taip;0;2;0;2
9860;Rūta;GUDRUČIAI;35843737071;Taip;8;0;0;8
9861;Rūta;GUDRUČIAI;13023764979;Taip;12;0;0;12
9862;Rūta;GUDRUČIAI;4409524323;Taip;11;0;1;12
9863;Rūta;GUDRUČIAI;2033577529;Taip;0;10;0;10
9864;Rūta;GUDRUČIAI;15393327975;Taip;0;3;0;3
9865;Rūta;GUDRUČIAI;76831234529;Taip;14;0;0;14
9866;Rūta;GUDRUČIAI;24211514845;Taip;8;0;0;8
9867;Rūta;GUDRUČIAI;48213220767;Taip;1;5;2;8
9868;Rūta;GUDRUČIAI;50266063379;Ne;10;0;2;12
9869;Rūta;GUDRUČIAI;28676981495;Taip;9;1;0;10
9870;Rūta;GUDRUČIAI;81049938466;Taip;5;5;0;10
9871;Rūta;GUDRUČIAI;67740925555;Taip;5;3;0;8
9872;Rūta;GUDRUČIAI;34935546673;Taip;0;5;2;7
9873;Rūta;GUDRUČIAI;47869128534;Taip;0;5;2;7
9874;Rūta;GUDRUČIAI;28332403249;Taip;9;0;0;9
9875;Rūta;GUDRUČIAI;91072621203;Taip;0;7;0;7
9876;Rūta;GUDRUČIAI;28158130932;Taip;9;0;0;9
9877;Rūta;SEKLYTĖLĖ;73486569144;Taip;0;6;4;10
9878;Rūta;SEKLYTĖLĖ;63130007113;Taip;0;5;0;5
9879;Rūta;SEKLYTĖLĖ;36767660286;Taip;0;5;8;13
9880;Rūta;SEKLYTĖLĖ;44422869429;Taip;0;4;4;8
9881;Rūta;SEKLYTĖLĖ;74600889000;Taip;0;15;0;15
9882;Rūta;SEKLYTĖLĖ;61614584274;Taip;0;4;5;9
9883;Rūta;SEKLYTĖLĖ;91160282230;Taip;0;1;4;5
9884;Rūta;SEKLYTĖLĖ;35546560715;Taip;0;2;1;3
9885;Rūta;SEKLYTĖLĖ;7273166365;Taip;0;1;2;3
9886;Rūta;SEKLYTĖLĖ;38233380265;Taip;0;5;3;8
9887;Rūta;SEKLYTĖLĖ;28539513133;Taip;0;4;0;4
9888;Rūta;SEKLYTĖLĖ;11116950913;Taip;0;3;8;11
9889;Rūta;SEKLYTĖLĖ;32768658491;Taip;0;6;6;12
9890;Rūta;SEKLYTĖLĖ;39447933171;Taip;0;6;8;14
9891;Rūta;SEKLYTĖLĖ;52426424863;Taip;0;2;6;8
9892;Rūta;SEKLYTĖLĖ;94077980408;Taip;0;12;0;12
9893;Rūta;SEKLYTĖLĖ;9037549271;Taip;0;7;5;12
9894;Rūta;SEKLYTĖLĖ;1789959175;Taip;0;4;5;9
9895;Rūta;SEKLYTĖLĖ;5905750207;Taip;0;6;8;14
9896;Rūta;SEKLYTĖLĖ;2080471128;Taip;0;5;8;13
9897;Rūta;SEKLYTĖLĖ;1168419924;Taip;0;8;0;8
9898;Rūta;"VARPELIAI (LOGOPEDINĖ)";13743264567;Taip;0;5;0;5
9899;Rūta;"VARPELIAI (LOGOPEDINĖ)";23413166816;Taip;0;9;0;9
9900;Rūta;"VARPELIAI (LOGOPEDINĖ)";78172584064;Taip;0;4;0;4
9901;Rūta;"VARPELIAI (LOGOPEDINĖ)";97163853698;Taip;5;4;0;9
9902;Rūta;"VARPELIAI (LOGOPEDINĖ)";1617760535;Taip;8;3;1;12
9903;Rūta;KIŠKUČIŲ;4297300799;Taip;9;0;0;9
9904;Rūta;KIŠKUČIŲ;6207902435;Taip;5;5;0;10
9905;Rūta;KIŠKUČIŲ;9791861646;Taip;15;0;0;15
9906;Rūta;KIŠKUČIŲ;7434152435;Taip;4;0;3;7
9907;Rūta;KIŠKUČIŲ;8182243701;Taip;0;0;15;15
9908;Rūta;KIŠKUČIŲ;3454881685;Taip;7;0;0;7
9909;Rūta;KIŠKUČIŲ;3043164521;Taip;0;0;4;4
9910;Rūta;KIŠKUČIŲ;4293920701;Taip;5;0;0;5
9911;Rūta;KIŠKUČIŲ;1510268514;Taip;11;0;0;11
9912;Rūta;KIŠKUČIŲ;4728904136;Taip;0;15;0;15
9913;Rūta;KIŠKUČIŲ;9419809946;Taip;4;0;2;6
9914;Rūta;KIŠKUČIŲ;1811055786;Taip;4;0;2;6
9915;Rūta;KIŠKUČIŲ;2928803089;Taip;10;3;0;13
9916;Rūta;KIŠKUČIŲ;3875136625;Taip;11;0;0;11
9917;Rūta;KIŠKUČIŲ;2702537976;Taip;13;0;6;19
9918;Rūta;ŽVIRBLIUKAI;3499727608;Taip;10;4;0;14
9919;Rūta;ŽVIRBLIUKAI;9765301038;Taip;10;4;0;14
9920;Rūta;ŽVIRBLIUKAI;8277677952;Taip;15;0;0;15
9921;Rūta;ŽVIRBLIUKAI;9638495757;Taip;9;0;0;9
9922;Rūta;ŽVIRBLIUKAI;3956912957;Taip;12;0;0;12
9923;Rūta;ŽVIRBLIUKAI;3055345528;Taip;0;9;5;14
9924;Rūta;ŽVIRBLIUKAI;4423305209;Taip;14;0;2;16
9925;Rūta;ŽVIRBLIUKAI;2890569107;Taip;14;0;3;17
9926;Rūta;ŽVIRBLIUKAI;3964922552;Taip;14;0;1;15
9927;Rūta;ŽVIRBLIUKAI;1216786487;Taip;9;1;0;10
9928;Rūta;ŽVIRBLIUKAI;9736567509;Taip;0;0;5;5
9929;Rūta;ŽVIRBLIUKAI;2474991135;Taip;11;0;1;12
9930;Rūta;ŽVIRBLIUKAI;7519931138;Taip;13;0;0;13
9931;Rūta;ŽVIRBLIUKAI;9400586178;Taip;8;0;0;8
9932;Rūta;ŽVIRBLIUKAI;8395765508;Taip;10;0;1;11
9933;Rūta;SAULUTĖS;54140704807;Taip;12;0;0;12
9934;Rūta;SAULUTĖS;26830853793;Taip;9;0;0;9
9935;Rūta;SAULUTĖS;75322385068;Taip;0;3;0;3
9936;Rūta;SAULUTĖS;76518034714;Taip;6;1;0;7
9937;Rūta;SAULUTĖS;79192262053;Taip;12;0;1;13
9938;Rūta;SAULUTĖS;42791864630;Taip;15;0;0;15
9939;Rūta;SAULUTĖS;61864833085;Taip;14;0;0;14
9940;Rūta;SAULUTĖS;20967345257;Taip;7;0;0;7
9941;Rūta;SAULUTĖS;89880409419;Taip;0;0;8;8
9942;Rūta;SAULUTĖS;50734030014;Taip;9;0;0;9
9943;Rūta;SAULUTĖS;29240858006;Taip;4;4;1;9
9944;Rūta;SAULUTĖS;75730421646;Taip;0;12;0;12
9945;Rūta;SAULUTĖS;732948370;Ne;3;9;0;12
9946;Rūta;SAULUTĖS;2711671531;Taip;0;20;0;20
9947;Rūta;SAULUTĖS;29483136582;Taip;10;0;0;10
9948;Rūta;SAULUTĖS;1545183162;Taip;10;0;0;10
9949;Rūta;SAULUTĖS;5733023163;Taip;3;0;1;4
9950;Rūta;SAULUTĖS;7061384784;Taip;17;0;0;17
9951;Rūta;SAULUTĖS;9994442882;Taip;9;0;0;9
9952;Rūta;SAULUTĖS;2188905055;Taip;9;5;0;14
9953;Sadutė;Kiškučiai;38918375280;Taip;3;2;1;6
9954;Sadutė;Kiškučiai;42447771280;Taip;0;4;0;4
9955;Sadutė;Kiškučiai;62408324442;Taip;16;0;0;16
9956;Sadutė;Kiškučiai;12421864073;Ne;0;1;0;1
9957;Sadutė;Kiškučiai;3253659165;Taip;2;5;0;7
9958;Sadutė;Kiškučiai;67439547513;Taip;6;0;0;6
9959;Sadutė;Kiškučiai;98527988102;Taip;0;10;0;10
9960;Sadutė;Kiškučiai;62077575922;Taip;5;2;0;7
9961;Sadutė;Kiškučiai;75149739907;Taip;5;1;0;6
9962;Sadutė;Kiškučiai;48298497;Taip;5;0;0;5
9963;Sadutė;Kiškučiai;69988140413;Taip;0;0;2;2
9964;Sadutė;Kiškučiai;61357382189;Taip;6;0;0;6
9965;Sadutė;Kiškučiai;1433422421;Taip;0;1;8;9
9966;Sadutė;Kiškučiai;73649870571;Taip;3;14;1;18
9967;Sadutė;Kiškučiai;1092421263;Taip;4;0;0;4
9968;Sadutė;Kiškučiai;1291782232;Taip;0;0;1;1
9969;Sadutė;Kiškučiai;5586949339;Taip;6;0;0;6
9970;Sadutė;Kiškučiai;64959385010;Taip;6;3;0;9
9971;Sadutė;Kiškučiai;9883685724;Taip;0;7;0;7
9972;Sadutė;Kiškučiai;4525909977;Taip;6;0;0;6
9973;Sadutė;Kiškučiai;1533081218;Taip;5;0;1;6
9974;Sadutė;Kiškučiai;3400524440;Taip;3;0;4;7
9975;Sadutė;Boružėlės;31020557647;Taip;11;0;5;16
9976;Sadutė;Boružėlės;99171108375;Taip;0;1;1;2
9977;Sadutė;Boružėlės;30046732620;Taip;5;0;0;5
9978;Sadutė;Boružėlės;91943880567;Taip;0;0;3;3
9979;Sadutė;Boružėlės;70505797915;Taip;20;0;0;20
9980;Sadutė;Boružėlės;48817619537;Taip;0;2;0;2
9981;Sadutė;Boružėlės;76464399248;Taip;0;0;3;3
9982;Sadutė;Boružėlės;47883796567;Taip;0;4;2;6
9983;Sadutė;Boružėlės;93561298785;Taip;0;6;0;6
9984;Sadutė;Boružėlės;48327367042;Taip;0;5;14;19
9985;Sadutė;Boružėlės;4064111008;Taip;0;4;5;9
9986;Sadutė;Boružėlės;35237170892;Taip;5;6;0;11
9987;Sadutė;Boružėlės;45569403734;Taip;12;0;0;12
9988;Sadutė;Boružėlės;15950584691;Taip;0;1;0;1
9989;Sadutė;Boružėlės;38373089101;Taip;0;0;1;1
9990;Sadutė;Boružėlės;13779484979;Taip;0;0;4;4
9991;Sadutė;Boružėlės;12989960431;Taip;0;0;1;1
9992;Sadutė;Boružėlės;2414632774;Taip;8;0;1;9
9993;Sadutė;Boružėlės;16493384211;Taip;5;4;1;10
9994;Sadutė;Boružėlės;71576294118;Taip;6;0;1;7
9995;Sadutė;Boružėlės;21011440269;Taip;0;0;3;3
9996;Sadutė;Boružėlės;39222963335;Taip;11;0;0;11
9997;Sadutė;Boružėlės;4695479762;Taip;7;0;0;7
9998;Sadutė;Boružėlės;1920496059;Taip;14;1;0;15
9999;Sadutė;Bitutės;85407883222;Taip;0;6;0;6
10000;Sadutė;Bitutės;68864977379;Taip;0;2;2;4
10001;Sadutė;Bitutės;37258486995;Taip;14;0;0;14
10002;Sadutė;Bitutės;70825850509;Taip;4;1;0;5
10003;Sadutė;Bitutės;15479694222;Ne;1;0;0;1
10004;Sadutė;Bitutės;23009676870;Taip;3;1;0;4
10005;Sadutė;Bitutės;67724608574;Taip;0;1;3;4
10006;Sadutė;Bitutės;30996415525;Taip;0;3;0;3
10007;Sadutė;Bitutės;40775963018;Taip;3;0;7;10
10008;Sadutė;Bitutės;38489473571;Taip;5;9;0;14
10009;Sadutė;Bitutės;60705293244;Taip;0;1;2;3
10010;Sadutė;Bitutės;71457072146;Taip;4;5;0;9
10011;Sadutė;Bitutės;6937310439;Taip;10;2;0;12
10012;Sadutė;Bitutės;64711220209;Taip;0;0;2;2
10013;Sadutė;Bitutės;5143204888;Ne;0;6;0;6
10014;Sadutė;Bitutės;68856441792;Taip;6;0;0;6
10015;Sadutė;Bitutės;97044964113;Taip;4;0;0;4
10016;Sadutė;Bitutės;63476202833;Taip;0;7;0;7
10017;Sadutė;Bitutės;22648108782;Taip;2;3;0;5
10018;Sadutė;Bitutės;64311208989;Taip;4;5;0;9
10019;Sadutė;Bitutės;56549103934;Taip;0;0;2;2
10020;Sadutė;Bitutės;78335876444;Taip;0;0;2;2
10021;Sadutė;Bitutės;2133207259;Taip;0;0;3;3
10022;Sadutė;Bitutės;50846021514;Taip;0;4;3;7
10023;Sadutė;Drugeliai;1552350084;Taip;6;0;1;7
10024;Sadutė;Drugeliai;7910380894;Taip;1;2;0;3
10025;Sadutė;Drugeliai;2467800545;Taip;10;0;0;10
10026;Sadutė;Drugeliai;4402558234;Taip;0;4;0;4
10027;Sadutė;Drugeliai;8713575864;Taip;2;0;0;2
10028;Sadutė;Drugeliai;6994547344;Taip;0;4;0;4
10029;Sadutė;Drugeliai;1782594187;Taip;19;0;0;19
10030;Sadutė;Drugeliai;5816844295;Taip;14;0;1;15
10031;Sadutė;Drugeliai;2095914442;Taip;0;1;0;1
10032;Sadutė;Drugeliai;8803249656;Taip;20;0;0;20
10033;Sadutė;Drugeliai;4901634532;Taip;0;0;1;1
10034;Sadutė;Drugeliai;6196282159;Taip;18;0;0;18
10035;Sadutė;Drugeliai;8953107298;Taip;20;0;0;20
10036;Sadutė;Drugeliai;1735450955;Taip;0;1;0;1
10037;Sadutė;Drugeliai;2064784580;Taip;0;1;0;1
10038;Sadutė;Drugeliai;2883991326;Taip;10;0;0;10
10039;Sadutė;Pėledžiukai;50662732693;Taip;6;0;2;8
10040;Sadutė;Pėledžiukai;26761581977;Taip;6;2;0;8
10041;Sadutė;Pėledžiukai;1885941594;Taip;5;7;0;12
10042;Sadutė;Pėledžiukai;4933574100;Taip;10;0;0;10
10043;Sadutė;Pėledžiukai;6105924871;Taip;8;0;0;8
10044;Sadutė;Pėledžiukai;8870465478;Taip;20;0;0;20
10045;Sadutė;Pėledžiukai;64835095908;Taip;14;0;0;14
10046;Sadutė;Pėledžiukai;3619323573;Taip;10;5;0;15
10047;Sadutė;Pėledžiukai;14962142857;Taip;5;0;1;6
10048;Sadutė;Pėledžiukai;1594844154;Taip;6;0;0;6
10049;Sadutė;Pėledžiukai;1005751811;Taip;5;0;0;5
10050;Sadutė;Pėledžiukai;45981672295;Taip;8;0;0;8
10051;Sadutė;Pėledžiukai;5864572784;Taip;2;0;0;2
10052;Sadutė;Pėledžiukai;8667620186;Taip;0;1;0;1
10053;Sadutė;Pėledžiukai;9946417453;Taip;0;4;0;4
10054;Sadutė;Pėledžiukai;48818906299;Taip;0;0;1;1
10055;Sadutė;Pėledžiukai;1003580436;Taip;5;0;0;5
10056;Sadutė;Pėledžiukai;1190667513;Taip;14;1;0;15
10057;Sadutė;Pėledžiukai;1988169256;Taip;8;0;0;8
10058;Sadutė;Pėledžiukai;2004943639;Taip;3;4;2;9
10059;Sadutė;Kačiukų;1507052440;Taip;9;4;6;19
10060;Sadutė;Kačiukų;1903961488;Taip;5;4;0;9
10061;Sadutė;Kačiukų;2890916313;Taip;0;20;0;20
10062;Sadutė;Kačiukų;3993181500;Taip;13;0;2;15
10063;Sadutė;Kačiukų;1871236869;Taip;3;0;0;3
10064;Sadutė;Kačiukų;1759479328;Taip;0;20;0;20
10065;Sadutė;Kačiukų;8835627470;Taip;5;0;1;6
10066;Sadutė;Kačiukų;1975767401;Taip;0;0;1;1
10067;Sadutė;Kačiukų;2532626934;Taip;0;7;2;9
10068;Sadutė;Kačiukų;2466024649;Taip;6;0;0;6
10069;Sadutė;Kačiukų;6253351299;Taip;7;1;0;8
10070;Sadutė;Kačiukų;2426974464;Taip;8;2;1;11
10071;Sadutė;Kačiukų;5438448926;Taip;4;0;3;7
10072;Sadutė;Kačiukų;8974374101;Taip;0;10;0;10
10073;Sadutė;Kačiukų;9285865812;Taip;1;0;4;5
10074;Sadutė;Kačiukų;4401870028;Taip;6;0;1;7
10075;Sakalėlis;GIRINUKŲ;15886891387;Taip;13;1;0;14
10076;Sakalėlis;GIRINUKŲ;18298832212;Taip;6;5;1;12
10077;Sakalėlis;GIRINUKŲ;2124748537;Taip;5;0;4;9
10078;Sakalėlis;GIRINUKŲ;97259304899;Taip;0;2;0;2
10079;Sakalėlis;GIRINUKŲ;8952808128;Taip;5;0;2;7
10080;Sakalėlis;GIRINUKŲ;1605682818;Taip;0;7;0;7
10081;Sakalėlis;GIRINUKŲ;57477662126;Taip;0;4;0;4
10082;Sakalėlis;GIRINUKŲ;78050507580;Taip;5;10;2;17
10083;Sakalėlis;GIRINUKŲ;19456041826;Taip;20;0;0;20
10084;Sakalėlis;GIRINUKŲ;28930740067;Taip;3;2;0;5
10085;Sakalėlis;GIRINUKŲ;64656067319;Taip;11;0;0;11
10086;Sakalėlis;GIRINUKŲ;15950016412;Taip;5;3;0;8
10087;Sakalėlis;GIRINUKŲ;87950904971;Taip;11;1;0;12
10088;Sakalėlis;GIRINUKŲ;1075787529;Taip;8;4;1;13
10089;Sakalėlis;GIRINUKŲ;44702801581;Taip;14;0;1;15
10090;Sakalėlis;GIRINUKŲ;1299944831;Taip;7;0;0;7
10091;Sakalėlis;GIRINUKŲ;1421038685;Taip;13;0;0;13
10092;Sakalėlis;GIRINUKŲ;3995095832;Taip;8;0;1;9
10093;Sakalėlis;GIRINUKŲ;9634589602;Taip;19;1;0;20
10094;Sakalėlis;VYTURIUKŲ;8520589200;Taip;8;0;0;8
10095;Sakalėlis;VYTURIUKŲ;36411138178;Taip;0;2;0;2
10096;Sakalėlis;VYTURIUKŲ;7852180045;Taip;0;9;0;9
10097;Sakalėlis;VYTURIUKŲ;27291131963;Taip;0;4;0;4
10098;Sakalėlis;VYTURIUKŲ;1822130260;Taip;0;1;1;2
10099;Sakalėlis;VYTURIUKŲ;25558438129;Taip;6;0;0;6
10100;Sakalėlis;VYTURIUKŲ;33360718659;Taip;0;1;1;2
10101;Sakalėlis;VYTURIUKŲ;59440026693;Taip;0;1;0;1
10102;Sakalėlis;VYTURIUKŲ;99937511623;Taip;5;1;0;6
10103;Sakalėlis;VYTURIUKŲ;14495611614;Taip;0;1;2;3
10104;Sakalėlis;VYTURIUKŲ;32956243898;Taip;8;0;0;8
10105;Sakalėlis;VYTURIUKŲ;87806505145;Taip;10;0;0;10
10106;Sakalėlis;VYTURIUKŲ;59067963901;Taip;0;0;2;2
10107;Sakalėlis;VYTURIUKŲ;1371469574;Taip;0;14;0;14
10108;Sakalėlis;VYTURIUKŲ;52975188309;Taip;0;1;0;1
10109;Sakalėlis;VYTURIUKŲ;60351276074;Taip;0;1;1;2
10110;Sakalėlis;VYTURIUKŲ;74622921410;Taip;1;1;1;3
10111;Sakalėlis;VYTURIUKŲ;13953070987;Taip;8;4;5;17
10112;Sakalėlis;VYTURIUKŲ;12474715312;Taip;0;1;4;5
10113;Sakalėlis;VYTURIUKŲ;80747256105;Taip;14;0;0;14
10114;Sakalėlis;VYTURIUKŲ;77801416034;Taip;17;0;0;17
10115;Sakalėlis;VYTURIUKŲ;31051837141;Taip;3;0;1;4
10116;Sakalėlis;VYTURIUKŲ;12601081196;Taip;0;7;2;9
10117;Sakalėlis;DRUGELIŲ;21956747394;Taip;0;7;7;14
10118;Sakalėlis;DRUGELIŲ;98983107357;Taip;0;1;1;2
10119;Sakalėlis;DRUGELIŲ;56809646636;Taip;0;5;0;5
10120;Sakalėlis;DRUGELIŲ;25352655265;Taip;0;5;0;5
10121;Sakalėlis;DRUGELIŲ;45025342634;Taip;0;5;1;6
10122;Sakalėlis;DRUGELIŲ;56640981370;Taip;0;4;11;15
10123;Sakalėlis;DRUGELIŲ;91226844252;Taip;0;0;1;1
10124;Sakalėlis;DRUGELIŲ;86990914938;Taip;0;1;3;4
10125;Sakalėlis;DRUGELIŲ;72249916736;Taip;5;0;0;5
10126;Sakalėlis;DRUGELIŲ;76192257851;Taip;0;1;1;2
10127;Sakalėlis;DRUGELIŲ;15476097840;Taip;0;3;0;3
10128;Sakalėlis;DRUGELIŲ;2997731442;Taip;17;0;0;17
10129;Sakalėlis;DRUGELIŲ;43454117;Taip;3;5;1;9
10130;Sakalėlis;DRUGELIŲ;40651927926;Taip;0;2;3;5
10131;Sakalėlis;DRUGELIŲ;62214587998;Taip;0;1;1;2
10132;Sakalėlis;DRUGELIŲ;50107185320;Taip;7;5;0;12
10133;Sakalėlis;DRUGELIŲ;1320801494;Taip;3;4;1;8
10134;Sakalėlis;DRUGELIŲ;10560758846;Taip;0;8;2;10
10135;Sakalėlis;DRUGELIŲ;85527501724;Taip;0;8;2;10
10136;Sakalėlis;DRUGELIŲ;52603313942;Taip;0;0;2;2
10137;Sakalėlis;DRUGELIŲ;47527388407;Taip;7;4;0;11
10138;Sakalėlis;DRUGELIŲ;1194658676;Taip;14;0;0;14
10139;Sakalėlis;DRUGELIŲ;1508916735;Taip;13;0;0;13
10140;Sakalėlis;DRUGELIŲ;69625812172;Taip;0;4;0;4
10141;Sakalėlis;GENIUKŲ;58012583231;Ne;2;0;1;3
10142;Sakalėlis;GENIUKŲ;1114100138;Ne;1;4;6;11
10143;Sakalėlis;GENIUKŲ;47416622432;Taip;0;3;0;3
10144;Sakalėlis;GENIUKŲ;11803756564;Taip;0;0;5;5
10145;Sakalėlis;GENIUKŲ;57612724915;Taip;9;0;0;9
10146;Sakalėlis;GENIUKŲ;63956070819;Taip;0;1;3;4
10147;Sakalėlis;GENIUKŲ;98322175734;Taip;10;2;0;12
10148;Sakalėlis;GENIUKŲ;70569243858;Taip;0;1;3;4
10149;Sakalėlis;GENIUKŲ;87968405810;Taip;5;4;0;9
10150;Sakalėlis;GENIUKŲ;72599730052;Taip;5;4;0;9
10151;Sakalėlis;GENIUKŲ;72915270234;Taip;10;10;0;20
10152;Sakalėlis;GENIUKŲ;24174522552;Taip;0;0;1;1
10153;Sakalėlis;GENIUKŲ;87799673875;Taip;11;4;0;15
10154;Sakalėlis;GENIUKŲ;47647167225;Taip;0;0;1;1
10155;Sakalėlis;GENIUKŲ;31894397351;Taip;3;4;0;7
10156;Sakalėlis;GENIUKŲ;72289518955;Taip;4;11;0;15
10157;Sakalėlis;GENIUKŲ;13087021336;Taip;10;4;6;20
10158;Sakalėlis;GENIUKŲ;96677994919;Taip;0;6;0;6
10159;Sakalėlis;GENIUKŲ;82248904456;Taip;0;6;0;6
10160;Sakalėlis;GENIUKŲ;23722033078;Taip;11;3;0;14
10161;Sakalėlis;GENIUKŲ;78556677636;Taip;5;4;2;11
10162;Sakalėlis;GENIUKŲ;1321373130;Taip;2;3;1;6
10163;Sakalėlis;GENIUKŲ;45174515952;Taip;6;6;0;12
10164;Sakalėlis;GENIUKŲ;31151919975;Taip;0;1;0;1
10165;Sakalėlis;VOVERIUKŲ;4430763418;Taip;0;2;0;2
10166;Sakalėlis;VOVERIUKŲ;6190741162;Taip;4;0;1;5
10167;Sakalėlis;VOVERIUKŲ;1702964714;Taip;5;5;1;11
10168;Sakalėlis;VOVERIUKŲ;1839096675;Taip;5;0;5;10
10169;Sakalėlis;VOVERIUKŲ;4495453007;Taip;0;0;2;2
10170;Sakalėlis;VOVERIUKŲ;1946531018;Taip;0;0;3;3
10171;Sakalėlis;VOVERIUKŲ;1210451022;Taip;6;0;0;6
10172;Sakalėlis;VOVERIUKŲ;1912068116;Taip;3;1;0;4
10173;Sakalėlis;VOVERIUKŲ;8662137531;Taip;0;4;1;5
10174;Sakalėlis;VOVERIUKŲ;1104881142;Taip;20;0;0;20
10175;Sakalėlis;VOVERIUKŲ;3678172501;Taip;10;1;0;11
10176;Sakalėlis;VOVERIUKŲ;1133377117;Taip;2;0;1;3
10177;Sakalėlis;VOVERIUKŲ;5782214279;Taip;9;10;0;19
10178;Sakalėlis;VOVERIUKŲ;22614338778;Taip;0;0;1;1
10179;Sakalėlis;VOVERIUKŲ;34464485043;Taip;8;0;6;14
10180;Sakalėlis;VOVERIUKŲ;30987215315;Taip;0;1;2;3
10181;Sakalėlis;VOVERIUKŲ;7567476424;Taip;10;0;1;11
10182;Sakalėlis;VOVERIUKŲ;6180987643;Taip;19;0;0;19
10183;Sakalėlis;PĖLEDŽIUKŲ;1974955778;Taip;0;3;0;3
10184;Sakalėlis;PĖLEDŽIUKŲ;69254656227;Taip;14;0;0;14
10185;Sakalėlis;PĖLEDŽIUKŲ;4573623341;Taip;11;3;3;17
10186;Sakalėlis;PĖLEDŽIUKŲ;60463584826;Taip;2;0;0;2
10187;Sakalėlis;PĖLEDŽIUKŲ;1359444361;Taip;0;4;3;7
10188;Sakalėlis;PĖLEDŽIUKŲ;3781188811;Taip;0;2;2;4
10189;Sakalėlis;PĖLEDŽIUKŲ;32890764904;Taip;2;0;1;3
10190;Sakalėlis;PĖLEDŽIUKŲ;58113060986;Taip;0;0;6;6
10191;Sakalėlis;PĖLEDŽIUKŲ;89579043958;Taip;10;3;0;13
10192;Sakalėlis;PĖLEDŽIUKŲ;54902207576;Taip;0;12;0;12
10193;Sakalėlis;PĖLEDŽIUKŲ;81593611262;Taip;16;0;1;17
10194;Sakalėlis;PĖLEDŽIUKŲ;33825546706;Taip;0;4;0;4
10195;Sakalėlis;PĖLEDŽIUKŲ;1790571847;Taip;13;0;0;13
10196;Sakalėlis;PĖLEDŽIUKŲ;81361557297;Taip;4;0;10;14
10197;Sakalėlis;PĖLEDŽIUKŲ;39504139934;Taip;6;4;0;10
10198;Sakalėlis;PĖLEDŽIUKŲ;2134118895;Taip;4;0;0;4
10199;Sakalėlis;PĖLEDŽIUKŲ;67193921335;Taip;11;0;0;11
10200;Sakalėlis;PĖLEDŽIUKŲ;2055710873;Taip;0;1;1;2
10201;Sakalėlis;PĖLEDŽIUKŲ;37201848270;Taip;12;0;0;12
10202;Sakalėlis;PĖLEDŽIUKŲ;49947049847;Taip;0;0;1;1
10203;Sakalėlis;PĖLEDŽIUKŲ;36670171187;Taip;1;0;0;1
10204;Sakalėlis;PĖLEDŽIUKŲ;4364341933;Taip;2;6;0;8
10205;Sakalėlis;PĖLEDŽIUKŲ;79413947806;Taip;1;1;0;2
10206;Sakalėlis;"BITUČIŲ (LOGOPEDINĖ)";1139467130;Taip;4;1;0;5
10207;Sakalėlis;"BITUČIŲ (LOGOPEDINĖ)";4649447372;Taip;14;0;1;15
10208;Sakalėlis;"BITUČIŲ (LOGOPEDINĖ)";1219441890;Taip;5;0;0;5
10209;Sakalėlis;"BITUČIŲ (LOGOPEDINĖ)";16884257622;Taip;3;0;2;5
10210;Sakalėlis;"BITUČIŲ (LOGOPEDINĖ)";4086981816;Ne;0;0;4;4
10211;Sakalėlis;"BITUČIŲ (LOGOPEDINĖ)";4716949191;Taip;10;0;1;11
10212;Sakalėlis;"BITUČIŲ (LOGOPEDINĖ)";7241416465;Taip;10;0;0;10
10213;Sakalėlis;"BITUČIŲ (LOGOPEDINĖ)";2074868084;Taip;14;6;0;20
10214;Sakalėlis;"BITUČIŲ (LOGOPEDINĖ)";6321575268;Taip;9;0;0;9
10215;Sakalėlis;"BITUČIŲ (LOGOPEDINĖ)";9740003273;Taip;0;3;0;3
10216;Sakalėlis;"BITUČIŲ (LOGOPEDINĖ)";1384225025;Taip;17;0;0;17
10217;Sakalėlis;"BITUČIŲ (LOGOPEDINĖ)";8852001037;Taip;9;4;0;13
10218;Sakalėlis;"BORUŽIUKŲ (LOGOPEDINĖ)";68146506860;Taip;9;0;0;9
10219;Sakalėlis;"BORUŽIUKŲ (LOGOPEDINĖ)";11871226177;Taip;3;2;0;5
10220;Sakalėlis;"BORUŽIUKŲ (LOGOPEDINĖ)";32402268054;Taip;8;0;1;9
10221;Sakalėlis;"BORUŽIUKŲ (LOGOPEDINĖ)";1765370689;Taip;10;0;0;10
10222;Sakalėlis;"BORUŽIUKŲ (LOGOPEDINĖ)";70791762492;Taip;0;1;0;1
10223;Sakalėlis;"BORUŽIUKŲ (LOGOPEDINĖ)";9452901338;Taip;5;8;0;13
10224;Sakalėlis;"BORUŽIUKŲ (LOGOPEDINĖ)";76019778588;Taip;0;9;1;10
10225;Sakalėlis;"BORUŽIUKŲ (LOGOPEDINĖ)";4514546151;Taip;9;0;0;9
10226;Sakalėlis;"BORUŽIUKŲ (LOGOPEDINĖ)";50037388220;Taip;0;3;0;3
10227;Sakalėlis;MEŠKUČIŲ;1027765680;Taip;16;1;0;17
10228;Sakalėlis;MEŠKUČIŲ;3371763993;Taip;7;6;0;13
10229;Sakalėlis;MEŠKUČIŲ;4515180509;Taip;11;3;0;14
10230;Sakalėlis;MEŠKUČIŲ;2829386777;Taip;5;1;0;6
10231;Sakalėlis;MEŠKUČIŲ;8936933971;Taip;9;0;0;9
10232;Sakalėlis;MEŠKUČIŲ;9830907922;Taip;8;0;0;8
10233;Sakalėlis;MEŠKUČIŲ;96053733139;Taip;5;2;0;7
10234;Sakalėlis;MEŠKUČIŲ;1552929452;Taip;15;0;0;15
10235;Sakalėlis;MEŠKUČIŲ;1526540031;Taip;15;2;0;17
10236;Sakalėlis;MEŠKUČIŲ;7987368969;Taip;9;1;1;11
10237;Sakalėlis;MEŠKUČIŲ;8649226611;Taip;5;0;0;5
10238;Sakalėlis;MEŠKUČIŲ;4612388683;Taip;5;6;0;11
10239;Sakalėlis;MEŠKUČIŲ;4775685174;Taip;11;0;0;11
10240;Sakalėlis;MEŠKUČIŲ;4763858893;Taip;9;4;0;13
10241;Sakalėlis;MEŠKUČIŲ;5717022080;Taip;7;1;0;8
10242;Sakalėlis;MEŠKUČIŲ;7085108710;Taip;19;1;0;20
10243;Sakalėlis;MEŠKUČIŲ;69916351348;Taip;19;0;0;19
10244;Sakalėlis;MEŠKUČIŲ;7159705304;Taip;5;0;0;5
10245;Sakalėlis;MEŠKUČIŲ;3337299648;Taip;17;0;0;17
10246;Sakalėlis;MEŠKUČIŲ;81681433432;Taip;11;0;0;11
10247;Sakalėlis;MEŠKUČIŲ;2902195855;Taip;10;1;0;11
10248;Sakalėlis;MEŠKUČIŲ;6727251397;Taip;16;0;0;16
10249;Sakalėlis;KIŠKUČIŲ;5496044442;Taip;11;0;0;11
10250;Sakalėlis;KIŠKUČIŲ;2474164013;Taip;11;0;0;11
10251;Sakalėlis;KIŠKUČIŲ;5405669698;Taip;11;0;0;11
10252;Sakalėlis;KIŠKUČIŲ;9493905856;Taip;6;0;1;7
10253;Sakalėlis;KIŠKUČIŲ;3165387995;Taip;7;0;2;9
10254;Sakalėlis;KIŠKUČIŲ;6603105354;Taip;14;0;0;14
10255;Sakalėlis;KIŠKUČIŲ;3418702674;Taip;7;2;0;9
10256;Sakalėlis;KIŠKUČIŲ;3748865437;Taip;10;4;0;14
10257;Sakalėlis;KIŠKUČIŲ;8667155756;Taip;6;0;2;8
10258;Sakalėlis;KIŠKUČIŲ;6706466627;Taip;0;0;2;2
10259;Sakalėlis;KIŠKUČIŲ;4458071075;Taip;12;0;3;15
10260;Sakalėlis;KIŠKUČIŲ;4209146744;Taip;3;1;0;4
10261;Sakalėlis;KIŠKUČIŲ;2780141413;Taip;0;15;0;15
10262;Sakalėlis;KIŠKUČIŲ;4596727938;Taip;5;0;4;9
10263;Sakalėlis;KIŠKUČIŲ;3333037807;Taip;13;4;0;17
10264;Sakalėlis;KIŠKUČIŲ;6700169944;Taip;0;0;3;3
10265;Sakalėlis;KIŠKUČIŲ;8790189865;Taip;10;0;0;10
10266;Sakalėlis;SVIRPLIUKŲ;4986131090;Taip;13;0;0;13
10267;Sakalėlis;SVIRPLIUKŲ;9322351120;Taip;19;0;1;20
10268;Sakalėlis;SVIRPLIUKŲ;3680732318;Taip;11;1;0;12
10269;Sakalėlis;SVIRPLIUKŲ;4862004373;Taip;5;0;0;5
10270;Sakalėlis;SVIRPLIUKŲ;6579827280;Taip;19;0;0;19
10271;Sakalėlis;SVIRPLIUKŲ;6806170544;Taip;6;0;0;6
10272;Sakalėlis;SVIRPLIUKŲ;8381310908;Taip;10;0;0;10
10273;Sakalėlis;SVIRPLIUKŲ;5795250727;Taip;10;1;0;11
10274;Sakalėlis;SVIRPLIUKŲ;2985239904;Taip;10;4;0;14
10275;Sakalėlis;SVIRPLIUKŲ;3351218789;Taip;20;0;0;20
10276;Sakalėlis;SVIRPLIUKŲ;3927363997;Taip;3;4;0;7
10277;Sakalėlis;SVIRPLIUKŲ;9120873899;Taip;14;6;0;20
10278;Sakalėlis;SVIRPLIUKŲ;1347171934;Taip;5;0;1;6
10279;Sakalėlis;SVIRPLIUKŲ;7672947538;Taip;11;0;0;11
10280;Sakalėlis;SVIRPLIUKŲ;5233697077;Taip;3;0;0;3
10281;Sakalėlis;SVIRPLIUKŲ;2539006620;Taip;0;20;0;20
10282;Sakalėlis;SVIRPLIUKŲ;7285833058;Taip;11;0;0;11
10283;Salininkų;BORUŽIUKAI;61252066272;Taip;0;1;0;1
10284;Salininkų;BORUŽIUKAI;10179604964;Taip;12;0;0;12
10285;Salininkų;BORUŽIUKAI;69329549093;Taip;6;0;1;7
10286;Salininkų;BORUŽIUKAI;81713688097;Taip;14;0;0;14
10287;Salininkų;BORUŽIUKAI;74503311061;Taip;7;0;0;7
10288;Salininkų;BORUŽIUKAI;32201000670;Taip;0;10;0;10
10289;Salininkų;BORUŽIUKAI;93466518815;Taip;0;12;0;12
10290;Salininkų;BORUŽIUKAI;75056599725;Taip;0;9;0;9
10291;Salininkų;BORUŽIUKAI;56301286871;Taip;0;1;0;1
10292;Salininkų;BORUŽIUKAI;39675001939;Taip;5;0;0;5
10293;Salininkų;BORUŽIUKAI;16879258172;Taip;0;0;4;4
10294;Salininkų;BORUŽIUKAI;2097313917;Taip;9;4;0;13
10295;Salininkų;BORUŽIUKAI;87653480003;Taip;15;3;0;18
10296;Salininkų;BORUŽIUKAI;1614501473;Taip;8;5;0;13
10297;Salininkų;BORUŽIUKAI;1632485114;Taip;16;0;2;18
10298;Salininkų;BORUŽIUKAI;40053462731;Ne;7;8;0;15
10299;Salininkų;BORUŽIUKAI;54352547774;Taip;9;1;0;10
10300;Salininkų;BORUŽIUKAI;1364275404;Taip;5;1;0;6
10301;Salininkų;BORUŽIUKAI;77477857775;Taip;1;0;0;1
10302;Salininkų;BORUŽIUKAI;8258045565;Taip;16;0;1;17
10303;Salininkų;BORUŽIUKAI;6978618796;Taip;3;0;2;5
10304;Salininkų;BORUŽIUKAI;8897523583;Taip;9;1;0;10
10305;Salininkų;BORUŽIUKAI;1507178637;Taip;6;1;0;7
10306;Salininkų;BORUŽIUKAI;88149790626;Taip;9;4;0;13
10307;Salininkų;GĖLYTĖS;3015863723;Taip;20;0;0;20
10308;Salininkų;GĖLYTĖS;3323233525;Taip;20;0;0;20
10309;Salininkų;GĖLYTĖS;1832393272;Taip;0;1;0;1
10310;Salininkų;GĖLYTĖS;7665409499;Taip;12;0;0;12
10311;Salininkų;GĖLYTĖS;9890660815;Taip;20;0;0;20
10312;Salininkų;GĖLYTĖS;4323257798;Taip;9;1;0;10
10313;Salininkų;GĖLYTĖS;6850925495;Taip;6;0;2;8
10314;Salininkų;GĖLYTĖS;3585435095;Taip;11;0;0;11
10315;Salininkų;GĖLYTĖS;2760231414;Taip;10;0;0;10
10316;Salininkų;GĖLYTĖS;9724367035;Taip;10;0;0;10
10317;Salininkų;GĖLYTĖS;1658695150;Taip;6;0;0;6
10318;Salininkų;GĖLYTĖS;7383557807;Taip;14;3;0;17
10319;Salininkų;GĖLYTĖS;9344614003;Taip;0;6;0;6
10320;Salininkų;GĖLYTĖS;2808778763;Taip;8;10;0;18
10321;Salininkų;GĖLYTĖS;6656578271;Taip;16;0;0;16
10322;Salininkų;GĖLYTĖS;8995565864;Taip;20;0;0;20
10323;Salininkų;GĖLYTĖS;8394582546;Taip;0;6;0;6
10324;Salininkų;GĖLYTĖS;6327046935;Taip;6;5;2;13
10325;Salininkų;DRUGELIAI;1641123436;Taip;16;0;0;16
10326;Salininkų;DRUGELIAI;1910467994;Taip;5;5;0;10
10327;Salininkų;DRUGELIAI;2812554783;Taip;0;0;2;2
10328;Salininkų;DRUGELIAI;14626363996;Taip;10;0;0;10
10329;Salininkų;DRUGELIAI;1948988168;Taip;6;0;4;10
10330;Salininkų;DRUGELIAI;5434294777;Taip;0;0;3;3
10331;Salininkų;DRUGELIAI;1815368137;Taip;4;0;0;4
10332;Salininkų;DRUGELIAI;8157811781;Taip;8;5;0;13
10333;Salininkų;DRUGELIAI;48956671934;Taip;17;0;1;18
10334;Salininkų;DRUGELIAI;1963139815;Taip;2;0;2;4
10335;Salininkų;DRUGELIAI;45194646218;Taip;0;5;0;5
10336;Salininkų;DRUGELIAI;6125334614;Taip;6;3;1;10
10337;Salininkų;DRUGELIAI;15199054558;Ne;0;11;0;11
10338;Salininkų;DRUGELIAI;8081095896;Taip;11;0;0;11
10339;Salininkų;DRUGELIAI;1568780329;Taip;15;2;0;17
10340;Salininkų;DRUGELIAI;9074440999;Taip;20;0;0;20
10341;Salininkų;ŽIRNIUKAI;5063792784;Taip;1;0;2;3
10342;Salininkų;ŽIRNIUKAI;73016259669;Taip;0;3;0;3
10343;Salininkų;ŽIRNIUKAI;41023354439;Taip;5;0;0;5
10344;Salininkų;ŽIRNIUKAI;76449285846;Taip;0;7;3;10
10345;Salininkų;ŽIRNIUKAI;1355032282;Taip;0;2;0;2
10346;Salininkų;ŽIRNIUKAI;35611320012;Taip;13;1;0;14
10347;Salininkų;ŽIRNIUKAI;22167560908;Taip;0;3;0;3
10348;Salininkų;ŽIRNIUKAI;9513785510;Taip;17;0;0;17
10349;Salininkų;ŽIRNIUKAI;5689344488;Taip;4;0;2;6
10350;Salininkų;ŽIRNIUKAI;2292919406;Taip;11;5;0;16
10351;Salininkų;ŽIRNIUKAI;8683841956;Taip;3;0;0;3
10352;Salininkų;ŽIRNIUKAI;10335028421;Taip;10;0;0;10
10353;Salininkų;ŽIRNIUKAI;40392900667;Taip;11;0;0;11
10354;Salininkų;ŽIRNIUKAI;8488127476;Taip;2;0;1;3
10355;Salininkų;ŽIRNIUKAI;1723241116;Taip;9;5;1;15
10356;Salininkų;ŽIRNIUKAI;46867660097;Taip;0;7;0;7
10357;Salininkų;ŽIRNIUKAI;4269202761;Taip;11;0;5;16
10358;Salininkų;ŽIRNIUKAI;3692008687;Taip;8;8;0;16
10359;Salininkų;ŽIRNIUKAI;91859774311;Taip;10;1;0;11
10360;Salininkų;ŽIRNIUKAI;1065549119;Taip;11;0;0;11
10361;Salininkų;PAUKŠČIUKAI;1202154135;Taip;0;1;0;1
10362;Salininkų;PAUKŠČIUKAI;1489067126;Taip;0;2;0;2
10363;Salininkų;PAUKŠČIUKAI;1521333219;Taip;5;0;0;5
10364;Salininkų;PAUKŠČIUKAI;25941514634;Taip;0;1;0;1
10365;Salininkų;PAUKŠČIUKAI;23990693770;Taip;0;2;0;2
10366;Salininkų;PAUKŠČIUKAI;67593920224;Taip;0;6;0;6
10367;Salininkų;PAUKŠČIUKAI;81888649482;Taip;4;1;0;5
10368;Salininkų;PAUKŠČIUKAI;1153455356;Taip;4;2;0;6
10369;Salininkų;PAUKŠČIUKAI;1470744233;Taip;2;8;0;10
10370;Salininkų;PAUKŠČIUKAI;2031724954;Taip;0;6;0;6
10371;Salininkų;PAUKŠČIUKAI;18178857793;Taip;14;0;0;14
10372;Salininkų;PAUKŠČIUKAI;1439852031;Taip;0;17;0;17
10373;Salininkų;PAUKŠČIUKAI;20609963605;Taip;4;2;0;6
10374;Salininkų;PAUKŠČIUKAI;1918440067;Taip;4;0;0;4
10375;Salininkų;PAUKŠČIUKAI;52194170807;Taip;0;1;0;1
10376;Salininkų;PAUKŠČIUKAI;86019335524;Taip;0;1;0;1
10377;Salininkų;PAUKŠČIUKAI;1586012117;Taip;5;2;0;7
10378;Salininkų;PAUKŠČIUKAI;2415539904;Taip;0;7;0;7
10379;Salininkų;PAUKŠČIUKAI;29341671329;Taip;0;7;0;7
10380;Salininkų;PAUKŠČIUKAI;3878896109;Taip;20;0;0;20
10381;Salininkų;PAUKŠČIUKAI;16967442608;Taip;0;9;0;9
10382;Salvija;Daigelis(šatil);1517130961;Ne;10;0;0;10
10383;Salvija;Daigelis(šatil);1478775998;Taip;0;5;0;5
10384;Salvija;Daigelis(šatil);8802891478;Ne;0;14;0;14
10385;Salvija;Daigelis(šatil);24038366791;Taip;6;0;0;6
10386;Salvija;Daigelis(šatil);12326049516;Taip;5;2;0;7
10387;Salvija;Daigelis(šatil);1261005294;Taip;5;0;0;5
10388;Salvija;Daigelis(šatil);62170308628;Taip;6;5;1;12
10389;Salvija;Daigelis(šatil);3424917706;Ne;10;2;6;18
10390;Salvija;Daigelis(šatil);8725965215;Taip;10;0;0;10
10391;Salvija;Daigelis(šatil);5494438837;Taip;7;0;0;7
10392;Salvija;Daigelis(šatil);4152602039;Taip;9;0;1;10
10393;Salvija;Daigelis(šatil);7546216874;Taip;5;0;2;7
10394;Salvija;Daigelis(šatil);3856351749;Taip;0;14;1;15
10395;Salvija;Daigelis(šatil);1791922219;Taip;16;0;2;18
10396;Salvija;Daigelis(šatil);1653831148;Taip;5;2;0;7
10397;Salvija;Daigelis(šatil);8013023311;Taip;15;0;0;15
10398;Salvija;Daigelis(šatil);8023422294;Taip;10;0;5;15
10399;Salvija;Daigelis(šatil);7449993309;Taip;10;0;2;12
10400;Salvija;"Pienė (savjon)";20005587910;Taip;0;6;1;7
10401;Salvija;"Pienė (savjon)";1826525181;Taip;20;0;0;20
10402;Salvija;"Pienė (savjon)";53604559443;Taip;0;7;0;7
10403;Salvija;"Pienė (savjon)";22615390885;Taip;6;0;0;6
10404;Salvija;"Pienė (savjon)";9168718017;Taip;0;5;1;6
10405;Salvija;"Pienė (savjon)";4167467237;Taip;9;4;0;13
10406;Salvija;"Pienė (savjon)";8585265946;Taip;0;0;1;1
10407;Salvija;"Pienė (savjon)";1641242817;Taip;0;7;0;7
10408;Salvija;"Pienė (savjon)";85826762998;Taip;0;0;1;1
10409;Salvija;"Pienė (savjon)";58888784609;Taip;0;5;0;5
10410;Salvija;"Pienė (savjon)";3331501534;Taip;0;3;0;3
10411;Salvija;"Pienė (savjon)";47567003954;Taip;6;4;0;10
10412;Salvija;"Pienė (savjon)";43416476269;Taip;0;5;1;6
10413;Salvija;"Pienė (savjon)";4845744417;Taip;0;9;0;9
10414;Salvija;"Pienė (savjon)";2495133021;Taip;0;2;0;2
10415;Salvija;"Pienė (savjon)";57752478379;Taip;0;6;1;7
10416;Salvija;"Pienė (savjon)";1103379012;Taip;11;0;0;11
10417;Salvija;"Pienė (savjon)";62121799666;Taip;0;1;0;1
10418;Salvija;"Pienė (savjon)";95774147903;Taip;0;4;0;4
10419;Salvija;"Pienė (savjon)";41158937437;Taip;0;2;0;2
10420;Saulėtekis;BERŽELIS;37001834066;Taip;14;0;3;17
10421;Saulėtekis;BERŽELIS;29935189464;Taip;7;0;0;7
10422;Saulėtekis;BERŽELIS;95214907923;Taip;8;0;0;8
10423;Saulėtekis;BERŽELIS;49102885577;Taip;0;4;0;4
10424;Saulėtekis;BERŽELIS;18801492293;Taip;9;0;2;11
10425;Saulėtekis;BERŽELIS;43809213927;Taip;8;0;0;8
10426;Saulėtekis;BERŽELIS;17046444483;Taip;9;0;1;10
10427;Saulėtekis;BERŽELIS;14357681543;Taip;3;0;4;7
10428;Saulėtekis;BERŽELIS;27109020149;Taip;0;5;0;5
10429;Saulėtekis;BERŽELIS;42952333477;Taip;0;9;0;9
10430;Saulėtekis;BERŽELIS;88165168902;Taip;9;4;0;13
10431;Saulėtekis;BERŽELIS;19786161536;Taip;10;1;0;11
10432;Saulėtekis;BERŽELIS;55975992548;Taip;5;5;0;10
10433;Saulėtekis;BERŽELIS;49746307178;Taip;11;0;0;11
10434;Saulėtekis;BERŽELIS;9333073549;Taip;0;8;0;8
10435;Saulėtekis;BERŽELIS;9632257866;Taip;10;0;2;12
10436;Saulėtekis;BERŽELIS;7440287746;Taip;13;2;0;15
10437;Saulėtekis;BERŽELIS;1502304241;Ne;0;14;0;14
10438;Saulėtekis;BERŽELIS;19209281962;Taip;0;0;9;9
10439;Saulėtekis;BERŽELIS;2096996257;Taip;9;0;1;10
10440;Saulėtekis;ŠYPSENA;1720125332;Taip;5;4;0;9
10441;Saulėtekis;ŠYPSENA;9972687066;Taip;8;1;0;9
10442;Saulėtekis;ŠYPSENA;7346852524;Taip;16;0;0;16
10443;Saulėtekis;ŠYPSENA;1902333363;Taip;16;1;0;17
10444;Saulėtekis;ŠYPSENA;7893982893;Taip;0;0;1;1
10445;Saulėtekis;ŠYPSENA;7505040675;Taip;10;0;0;10
10446;Saulėtekis;ŠYPSENA;6501250875;Taip;5;0;0;5
10447;Saulėtekis;ŠYPSENA;9791926936;Taip;8;0;3;11
10448;Saulėtekis;ŠYPSENA;8620689981;Taip;9;5;0;14
10449;Saulėtekis;ŠYPSENA;8143793642;Taip;6;2;0;8
10450;Saulėtekis;ŠYPSENA;8603952810;Taip;13;0;0;13
10451;Saulėtekis;ŠYPSENA;9783450998;Taip;5;1;0;6
10452;Saulėtekis;ŠYPSENA;4909850069;Taip;17;0;0;17
10453;Saulėtekis;NYKŠTUKAI;62765692719;Taip;16;0;0;16
10454;Saulėtekis;NYKŠTUKAI;87107015716;Taip;0;6;0;6
10455;Saulėtekis;NYKŠTUKAI;81074197598;Taip;5;1;0;6
10456;Saulėtekis;NYKŠTUKAI;87539304992;Taip;0;7;0;7
10457;Saulėtekis;NYKŠTUKAI;1769434568;Taip;3;3;0;6
10458;Saulėtekis;NYKŠTUKAI;23597877284;Taip;0;4;0;4
10459;Saulėtekis;NYKŠTUKAI;36050720419;Taip;4;3;0;7
10460;Saulėtekis;NYKŠTUKAI;29734420962;Taip;20;0;0;20
10461;Saulėtekis;NYKŠTUKAI;1623791240;Taip;0;9;0;9
10462;Saulėtekis;NYKŠTUKAI;71042846070;Taip;0;5;0;5
10463;Saulėtekis;NYKŠTUKAI;9701092832;Taip;10;0;0;10
10464;Saulėtekis;NYKŠTUKAI;46936348504;Taip;0;8;0;8
10465;Saulėtekis;NYKŠTUKAI;47570401883;Taip;8;5;0;13
10466;Saulėtekis;NYKŠTUKAI;89956895058;Taip;7;0;0;7
10467;Saulėtekis;NYKŠTUKAI;90708381762;Taip;0;9;0;9
10468;Saulėtekis;NYKŠTUKAI;90484365520;Taip;0;4;0;4
10469;Saulėtekis;NYKŠTUKAI;57417558875;Taip;10;6;0;16
10470;Saulėtekis;NYKŠTUKAI;1288313734;Taip;0;3;0;3
10471;Saulėtekis;NYKŠTUKAI;9282898493;Taip;9;0;0;9
10472;Saulėtekis;NYKŠTUKAI;1656800997;Taip;15;4;0;19
10473;Saulėtekis;PAGRANDUKAS;9428709415;Taip;14;0;0;14
10474;Saulėtekis;PAGRANDUKAS;8102360466;Taip;10;2;0;12
10475;Saulėtekis;PAGRANDUKAS;2371396923;Taip;13;0;0;13
10476;Saulėtekis;PAGRANDUKAS;4152255439;Taip;15;0;0;15
10477;Saulėtekis;PAGRANDUKAS;2209156661;Taip;13;0;1;14
10478;Saulėtekis;PAGRANDUKAS;3220993253;Taip;7;0;0;7
10479;Saulėtekis;PAGRANDUKAS;5552614092;Taip;8;1;1;10
10480;Saulėtekis;PAGRANDUKAS;9497129509;Taip;18;0;0;18
10481;Saulėtekis;PAGRANDUKAS;9918219913;Taip;4;4;0;8
10482;Saulėtekis;PAGRANDUKAS;8517049464;Taip;7;7;0;14
10483;Saulėtekis;PAGRANDUKAS;7186085219;Taip;15;0;0;15
10484;Saulėtekis;PAGRANDUKAS;1020209414;Taip;8;0;0;8
10485;Saulėtekis;PAGRANDUKAS;8745921541;Taip;15;0;0;15
10486;Saulėtekis;PAGRANDUKAS;2728836108;Taip;15;2;0;17
10487;Saulėtekis;PAGRANDUKAS;8390615573;Taip;14;0;0;14
10488;Saulėtekis;PAGRANDUKAS;2698535938;Taip;10;1;0;11
10489;Saulėtekis;PAGRANDUKAS;2656659133;Taip;20;0;0;20
10490;Saulėtekis;RAMUNĖLIŲ;70948000188;Taip;0;1;0;1
10491;Saulėtekis;RAMUNĖLIŲ;1456140823;Taip;8;0;1;9
10492;Saulėtekis;RAMUNĖLIŲ;23797246535;Taip;3;1;2;6
10493;Saulėtekis;RAMUNĖLIŲ;16450627896;Taip;0;0;1;1
10494;Saulėtekis;RAMUNĖLIŲ;60662699125;Taip;10;0;0;10
10495;Saulėtekis;RAMUNĖLIŲ;77630031851;Taip;11;0;0;11
10496;Saulėtekis;RAMUNĖLIŲ;31291807930;Taip;15;3;0;18
10497;Saulėtekis;RAMUNĖLIŲ;49053923177;Taip;6;0;2;8
10498;Saulėtekis;RAMUNĖLIŲ;42485505048;Ne;0;5;0;5
10499;Saulėtekis;RAMUNĖLIŲ;86593254070;Taip;4;0;5;9
10500;Saulėtekis;RAMUNĖLIŲ;75785868657;Taip;3;1;0;4
10501;Saulėtekis;RAMUNĖLIŲ;40093795729;Taip;11;0;0;11
10502;Saulėtekis;RAMUNĖLIŲ;10524532865;Taip;0;8;0;8
10503;Saulėtekis;RAMUNĖLIŲ;80037388013;Taip;8;0;0;8
10504;Saulėtekis;RAMUNĖLIŲ;1219435678;Taip;9;3;0;12
10505;Saulėtekis;RAMUNĖLIŲ;3394231244;Taip;7;3;2;12
10506;Saulėtekis;RAMUNĖLIŲ;7544912614;Taip;0;9;0;9
10507;Saulėtekis;RAMUNĖLIŲ;1349303787;Taip;16;0;0;16
10508;Saulėtekis;RAMUNĖLIŲ;1103824875;Taip;10;0;0;10
10509;Saulėtekis;PASAKAITĖ;3458088977;Taip;0;4;0;4
10510;Saulėtekis;PASAKAITĖ;80652165734;Taip;0;2;3;5
10511;Saulėtekis;PASAKAITĖ;99932790328;Taip;8;1;1;10
10512;Saulėtekis;PASAKAITĖ;33621514262;Taip;1;2;2;5
10513;Saulėtekis;PASAKAITĖ;65869066033;Taip;6;0;0;6
10514;Saulėtekis;PASAKAITĖ;24878473562;Taip;1;19;0;20
10515;Saulėtekis;PASAKAITĖ;33485541086;Taip;0;14;0;14
10516;Saulėtekis;PASAKAITĖ;36401102768;Taip;1;13;0;14
10517;Saulėtekis;PASAKAITĖ;71579240842;Ne;0;10;0;10
10518;Saulėtekis;PASAKAITĖ;6833534993;Taip;0;1;0;1
10519;Saulėtekis;PASAKAITĖ;30101217515;Taip;0;6;0;6
10520;Saulėtekis;PASAKAITĖ;75415518904;Taip;0;14;0;14
10521;Saulėtekis;PASAKAITĖ;38524228416;Taip;0;4;0;4
10522;Saulėtekis;PASAKAITĖ;5777142934;Taip;0;6;0;6
10523;Saulėtekis;PASAKAITĖ;5068358612;Taip;2;5;0;7
10524;Saulėtekis;PASAKAITĖ;6084164103;Taip;6;0;2;8
10525;Saulėtekis;PASAKAITĖ;17692658424;Ne;0;2;0;2
10526;Saulėtekis;PASAKAITĖ;1346347454;Taip;0;0;1;1
10527;Saulėtekis;PASAKAITĖ;5930722162;Taip;20;0;0;20
10528;Saulėtekis;VARPELIAI;94326821425;Taip;9;6;0;15
10529;Saulėtekis;VARPELIAI;6984530386;Taip;0;0;1;1
10530;Saulėtekis;VARPELIAI;1339984127;Taip;0;9;0;9
10531;Saulėtekis;VARPELIAI;68563453302;Taip;6;5;0;11
10532;Saulėtekis;VARPELIAI;77901730057;Taip;0;10;0;10
10533;Saulėtekis;VARPELIAI;74713390994;Taip;9;0;1;10
10534;Saulėtekis;VARPELIAI;43127755042;Taip;5;4;0;9
10535;Saulėtekis;VARPELIAI;1335149249;Taip;0;7;0;7
10536;Saulėtekis;VARPELIAI;1108321396;Taip;0;4;0;4
10537;Saulėtekis;VARPELIAI;891603633;Taip;0;6;0;6
10538;Saulėtekis;VARPELIAI;36605502570;Taip;0;0;3;3
10539;Saulėtekis;VARPELIAI;2075281680;Taip;5;4;1;10
10540;Saulėtekis;VARPELIAI;1213567219;Taip;14;0;0;14
10541;Saulėtekis;VARPELIAI;61118132521;Taip;4;2;0;6
10542;Saulėtekis;VARPELIAI;6671771491;Taip;0;3;0;3
10543;Saulėtekis;VARPELIAI;8752857993;Taip;0;7;0;7
10544;Saulėtekis;VARPELIAI;2641849320;Ne;11;0;1;12
10545;Saulėtekis;GRŪDELIS;20794781914;Taip;6;0;6;12
10546;Saulėtekis;GRŪDELIS;9132383069;Taip;17;0;0;17
10547;Saulėtekis;GRŪDELIS;67951758325;Taip;15;0;0;15
10548;Saulėtekis;GRŪDELIS;70230805151;Taip;6;0;0;6
10549;Saulėtekis;GRŪDELIS;41775536104;Taip;15;1;0;16
10550;Saulėtekis;GRŪDELIS;12954283491;Taip;5;1;0;6
10551;Saulėtekis;GRŪDELIS;21376960952;Taip;6;2;0;8
10552;Saulėtekis;GRŪDELIS;4027823257;Taip;5;0;1;6
10553;Saulėtekis;GRŪDELIS;86804497954;Taip;19;0;0;19
10554;Saulėtekis;GRŪDELIS;1180197203;Taip;9;0;1;10
10555;Saulėtekis;GRŪDELIS;1066191639;Taip;7;1;0;8
10556;Saulėtekis;GRŪDELIS;98936544904;Taip;0;0;1;1
10557;Saulėtekis;GRŪDELIS;22570044589;Taip;6;0;0;6
10558;Saulėtekis;GRŪDELIS;1865278537;Taip;5;5;0;10
10559;Saulėtekis;GRŪDELIS;1220962473;Taip;13;5;0;18
10560;Saulėtekis;GRŪDELIS;20534872540;Taip;15;0;0;15
10561;Saulėtekis;GRŪDELIS;53906058088;Taip;6;0;1;7
10562;Saulėtekis;GRŪDELIS;1646943569;Taip;9;0;0;9
10563;Saulėtekis;GRŪDELIS;7042842046;Taip;0;0;1;1
10564;Saulėtekis;JONVABALIS;5003645081;Taip;5;3;0;8
10565;Saulėtekis;JONVABALIS;21569877958;Taip;0;4;0;4
10566;Saulėtekis;JONVABALIS;6736441901;Taip;17;0;0;17
10567;Saulėtekis;JONVABALIS;1466627555;Taip;6;3;0;9
10568;Saulėtekis;JONVABALIS;1691667254;Taip;15;0;0;15
10569;Saulėtekis;JONVABALIS;1064355395;Taip;0;9;0;9
10570;Saulėtekis;JONVABALIS;45284061866;Taip;5;0;0;5
10571;Saulėtekis;JONVABALIS;1715634399;Taip;10;2;0;12
10572;Saulėtekis;JONVABALIS;1897872021;Taip;5;2;0;7
10573;Saulėtekis;JONVABALIS;1010906684;Taip;4;0;0;4
10574;Saulėtekis;JONVABALIS;97037457833;Taip;0;9;0;9
10575;Saulėtekis;JONVABALIS;1111323783;Taip;5;5;0;10
10576;Saulėtekis;JONVABALIS;7227802003;Taip;5;0;0;5
10577;Saulėtekis;JONVABALIS;84492261206;Taip;0;4;0;4
10578;Saulėtekis;JONVABALIS;72559769416;Taip;0;1;0;1
10579;Saulėtekis;JONVABALIS;29552225924;Taip;0;11;0;11
10580;Saulėtekis;JONVABALIS;1611009868;Taip;20;0;0;20
10581;Saulėtekis;JONVABALIS;4613040294;Taip;14;0;0;14
10582;Saulėtekis;JONVABALIS;1655720839;Taip;12;1;0;13
10583;Saulėtekis;SMALSUČIAI;40877542045;Taip;4;7;0;11
10584;Saulėtekis;SMALSUČIAI;7030227903;Taip;11;0;0;11
10585;Saulėtekis;SMALSUČIAI;81118611780;Taip;4;2;0;6
10586;Saulėtekis;SMALSUČIAI;32771808648;Taip;6;1;0;7
10587;Saulėtekis;SMALSUČIAI;38762730531;Taip;5;1;0;6
10588;Saulėtekis;SMALSUČIAI;1808644850;Taip;10;6;0;16
10589;Saulėtekis;SMALSUČIAI;1642031589;Taip;6;9;0;15
10590;Saulėtekis;SMALSUČIAI;29472863931;Taip;6;5;0;11
10591;Saulėtekis;SMALSUČIAI;1568300232;Taip;18;0;0;18
10592;Saulėtekis;SMALSUČIAI;8415116580;Taip;5;1;0;6
10593;Saulėtekis;SMALSUČIAI;97771948184;Taip;13;2;0;15
10594;Saulėtekis;SMALSUČIAI;7621094096;Taip;2;4;0;6
10595;Saulėtekis;SMALSUČIAI;13451381485;Taip;10;0;0;10
10596;Saulėtekis;SMALSUČIAI;19605249139;Taip;15;0;0;15
10597;Saulėtekis;SMALSUČIAI;1619134034;Taip;12;0;0;12
10598;Saulėtekis;SMALSUČIAI;8673024996;Taip;13;0;0;13
10599;Saulėtekis;SMALSUČIAI;1456865685;Taip;0;6;0;6
10600;Saulėtekis;BITUTĖS;7766084857;Taip;14;0;0;14
10601;Saulėtekis;BITUTĖS;4537254306;Taip;0;5;0;5
10602;Saulėtekis;BITUTĖS;60462712074;Taip;8;0;0;8
10603;Saulėtekis;BITUTĖS;1699576940;Taip;0;1;0;1
10604;Saulėtekis;BITUTĖS;9945647968;Taip;8;2;0;10
10605;Saulėtekis;BITUTĖS;1962914764;Taip;6;6;0;12
10606;Saulėtekis;BITUTĖS;1481503733;Taip;20;0;0;20
10607;Saulėtekis;BITUTĖS;8302260087;Taip;1;0;1;2
10608;Saulėtekis;BITUTĖS;2593106154;Taip;1;6;0;7
10609;Saulėtekis;BITUTĖS;2813949848;Taip;7;2;0;9
10610;Saulėtekis;BITUTĖS;6643388548;Taip;8;1;0;9
10611;Saulėtekis;BITUTĖS;3058991890;Taip;0;9;0;9
10612;Saulėtekis;BITUTĖS;9983577817;Taip;6;4;0;10
10613;Saulėtekis;BITUTĖS;7986712728;Taip;5;5;0;10
10614;Saulėtekis;BITUTĖS;6087170055;Taip;6;5;0;11
10615;Saulėtekis;BITUTĖS;7027103276;Taip;6;4;0;10
10616;Saulėtekis;BITUTĖS;7758268674;Taip;6;0;0;6
10617;Saulėtekis;BITUTĖS;2077976415;Taip;5;3;2;10
10618;Saulėtekis;BITUTĖS;9605052795;Taip;0;6;0;6
10619;Saulėtekis;BITUTĖS;7075757274;Taip;11;0;2;13
10620;Saulėtekis;RIEŠUTĖLIAI;3337160930;Taip;14;0;0;14
10621;Saulėtekis;RIEŠUTĖLIAI;2021901593;Taip;0;4;0;4
10622;Saulėtekis;RIEŠUTĖLIAI;7842280836;Taip;1;3;0;4
10623;Saulėtekis;RIEŠUTĖLIAI;2407911405;Taip;0;1;0;1
10624;Saulėtekis;RIEŠUTĖLIAI;5954194843;Taip;6;2;0;8
10625;Saulėtekis;RIEŠUTĖLIAI;2238947856;Taip;6;10;0;16
10626;Saulėtekis;RIEŠUTĖLIAI;84982517658;Taip;1;5;0;6
10627;Saulėtekis;RIEŠUTĖLIAI;8231869593;Taip;11;0;0;11
10628;Saulėtekis;RIEŠUTĖLIAI;36003078842;Taip;0;6;0;6
10629;Saulėtekis;RIEŠUTĖLIAI;4663268649;Taip;6;0;0;6
10630;Saulėtekis;RIEŠUTĖLIAI;25199011812;Taip;4;0;1;5
10631;Saulėtekis;RIEŠUTĖLIAI;81153273188;Taip;0;8;0;8
10632;Saulėtekis;RIEŠUTĖLIAI;1290215067;Taip;3;0;0;3
10633;Saulėtekis;RIEŠUTĖLIAI;7051608858;Taip;2;0;0;2
10634;Saulėtekis;RIEŠUTĖLIAI;9634949452;Taip;3;0;0;3
10635;Saulėtekis;RIEŠUTĖLIAI;4338502152;Taip;0;2;0;2
10636;Saulėtekis;RIEŠUTĖLIAI;9657195627;Taip;5;7;0;12
10637;Skroblinukas;SVIRPLIUKŲ;56496090956;Ne;0;0;3;3
10638;Skroblinukas;SVIRPLIUKŲ;27948464942;Taip;0;0;7;7
10639;Skroblinukas;SVIRPLIUKŲ;92096423589;Taip;13;3;0;16
10640;Skroblinukas;SVIRPLIUKŲ;5992090518;Taip;5;2;0;7
10641;Skroblinukas;SVIRPLIUKŲ;2034869306;Taip;10;0;1;11
10642;Skroblinukas;SVIRPLIUKŲ;2020866728;Taip;0;0;3;3
10643;Skroblinukas;SVIRPLIUKŲ;1059137398;Taip;12;0;0;12
10644;Skroblinukas;SVIRPLIUKŲ;91070212533;Taip;1;10;0;11
10645;Skroblinukas;SVIRPLIUKŲ;60291417607;Taip;0;11;0;11
10646;Skroblinukas;SVIRPLIUKŲ;18955401411;Taip;0;15;2;17
10647;Skroblinukas;SVIRPLIUKŲ;31484348317;Taip;0;5;2;7
10648;Skroblinukas;SVIRPLIUKŲ;88601994922;Taip;9;7;0;16
10649;Skroblinukas;SVIRPLIUKŲ;72829437831;Taip;10;0;0;10
10650;Skroblinukas;SVIRPLIUKŲ;1364608720;Taip;0;1;0;1
10651;Skroblinukas;SVIRPLIUKŲ;31670763980;Taip;0;4;0;4
10652;Skroblinukas;SVIRPLIUKŲ;89356084678;Ne;0;2;0;2
10653;Skroblinukas;SVIRPLIUKŲ;93644867290;Ne;0;5;0;5
10654;Skroblinukas;SVIRPLIUKŲ;30925721180;Taip;0;1;3;4
10655;Skroblinukas;SVIRPLIUKŲ;87902801288;Taip;0;1;1;2
10656;Skroblinukas;SVIRPLIUKŲ;1462404838;Taip;6;5;0;11
10657;Skroblinukas;SVIRPLIUKŲ;23551272822;Taip;3;9;0;12
10658;Skroblinukas;SVIRPLIUKŲ;2105394649;Taip;9;0;2;11
10659;Skroblinukas;GANDRIUKŲ;9936253477;Taip;0;10;0;10
10660;Skroblinukas;GANDRIUKŲ;42828688990;Taip;0;4;0;4
10661;Skroblinukas;GANDRIUKŲ;11039821123;Taip;0;1;0;1
10662;Skroblinukas;GANDRIUKŲ;2574443420;Taip;0;1;0;1
10663;Skroblinukas;GANDRIUKŲ;47487985525;Taip;0;6;0;6
10664;Skroblinukas;GANDRIUKŲ;77924018810;Taip;0;4;0;4
10665;Skroblinukas;GANDRIUKŲ;21497082440;Taip;4;0;0;4
10666;Skroblinukas;GANDRIUKŲ;55187339508;Taip;12;4;0;16
10667;Skroblinukas;GANDRIUKŲ;1799813420;Taip;5;0;0;5
10668;Skroblinukas;GANDRIUKŲ;29786434898;Taip;5;14;0;19
10669;Skroblinukas;GANDRIUKŲ;1852949849;Taip;4;3;0;7
10670;Skroblinukas;GANDRIUKŲ;74443337196;Taip;12;0;0;12
10671;Skroblinukas;GANDRIUKŲ;33658383206;Taip;2;11;0;13
10672;Skroblinukas;GANDRIUKŲ;77076233947;Taip;0;6;1;7
10673;Skroblinukas;GANDRIUKŲ;28889483128;Taip;0;4;0;4
10674;Skroblinukas;GANDRIUKŲ;18613971878;Taip;0;4;2;6
10675;Skroblinukas;GANDRIUKŲ;19962514046;Taip;5;11;2;18
10676;Skroblinukas;GANDRIUKŲ;69558864958;Taip;2;10;0;12
10677;Skroblinukas;GANDRIUKŲ;68389194619;Taip;2;1;0;3
10678;Skroblinukas;GANDRIUKŲ;65724262749;Taip;7;2;0;9
10679;Skroblinukas;GANDRIUKŲ;6662751729;Ne;9;0;3;12
10680;Skroblinukas;GANDRIUKŲ;7616559972;Ne;0;5;0;5
10681;Skroblinukas;GANDRIUKŲ;3519615689;Ne;5;2;1;8
10682;Skroblinukas;VYTURIUKŲ;32625726014;Ne;5;4;0;9
10683;Skroblinukas;VYTURIUKŲ;40320573258;Taip;0;7;0;7
10684;Skroblinukas;VYTURIUKŲ;85882169908;Taip;0;9;0;9
10685;Skroblinukas;VYTURIUKŲ;98214579906;Taip;7;2;0;9
10686;Skroblinukas;VYTURIUKŲ;94897926442;Taip;0;0;9;9
10687;Skroblinukas;VYTURIUKŲ;30982591733;Taip;0;0;1;1
10688;Skroblinukas;VYTURIUKŲ;81438612530;Taip;8;0;0;8
10689;Skroblinukas;VYTURIUKŲ;778965033;Taip;0;3;0;3
10690;Skroblinukas;VYTURIUKŲ;89809217827;Taip;0;2;0;2
10691;Skroblinukas;VYTURIUKŲ;25474129751;Taip;9;0;0;9
10692;Skroblinukas;VYTURIUKŲ;9313338574;Ne;0;6;0;6
10693;Skroblinukas;VYTURIUKŲ;152535859;Taip;0;5;0;5
10694;Skroblinukas;VYTURIUKŲ;1935381164;Taip;0;4;1;5
10695;Skroblinukas;VYTURIUKŲ;24808850859;Taip;0;4;1;5
10696;Skroblinukas;VYTURIUKŲ;64034793218;Taip;0;1;1;2
10697;Skroblinukas;VYTURIUKŲ;52489636337;Taip;0;15;0;15
10698;Skroblinukas;VYTURIUKŲ;21966526141;Taip;5;4;4;13
10699;Skroblinukas;VYTURIUKŲ;55519865793;Taip;0;9;0;9
10700;Skroblinukas;VYTURIUKŲ;87202801900;Taip;0;2;0;2
10701;Skroblinukas;VYTURIUKŲ;58117699822;Ne;0;2;4;6
10702;Skroblinukas;VYTURIUKŲ;17906689562;Taip;7;2;0;9
10703;Skroblinukas;VYTURIUKŲ;84113655621;Taip;0;10;0;10
10704;Skroblinukas;VYTURIUKŲ;78319454763;Taip;0;4;4;8
10705;Skroblinukas;VYTURIUKŲ;6095946745;Taip;0;1;1;2
10706;Skroblinukas;GENIUKŲ;48655837755;Taip;3;1;0;4
10707;Skroblinukas;GENIUKŲ;1930578755;Taip;11;0;0;11
10708;Skroblinukas;GENIUKŲ;4393041946;Taip;0;0;1;1
10709;Skroblinukas;GENIUKŲ;2323980730;Taip;10;0;4;14
10710;Skroblinukas;GENIUKŲ;1325903217;Taip;11;4;0;15
10711;Skroblinukas;GENIUKŲ;8380073853;Taip;8;1;4;13
10712;Skroblinukas;GENIUKŲ;63112639332;Taip;7;1;0;8
10713;Skroblinukas;GENIUKŲ;1361836818;Ne;8;0;2;10
10714;Skroblinukas;GENIUKŲ;5766702969;Taip;15;0;1;16
10715;Skroblinukas;GENIUKŲ;1905085978;Taip;0;4;0;4
10716;Skroblinukas;GENIUKŲ;1557733803;Taip;11;0;0;11
10717;Skroblinukas;GENIUKŲ;9433465007;Taip;5;0;0;5
10718;Skroblinukas;GENIUKŲ;1395950886;Ne;11;0;0;11
10719;Skroblinukas;GENIUKŲ;9777300890;Taip;14;0;1;15
10720;Skroblinukas;GENIUKŲ;1696303051;Taip;14;0;0;14
10721;Skroblinukas;GENIUKŲ;9846569195;Taip;10;0;4;14
10722;Skroblinukas;GENIUKŲ;3746278003;Taip;20;0;0;20
10723;Skroblinukas;GENIUKŲ;4773576465;Taip;0;0;2;2
10724;Skroblinukas;GENIUKŲ;9564385215;Taip;0;14;1;15
10725;Skroblinukas;GENIUKŲ;6129591146;Taip;5;0;0;5
10726;Skroblinukas;GENIUKŲ;3128337104;Taip;9;0;1;10
10727;Skroblinukas;BITUČIŲ;1255323441;Taip;2;1;1;4
10728;Skroblinukas;BITUČIŲ;1934804499;Taip;12;0;0;12
10729;Skroblinukas;BITUČIŲ;2134821488;Taip;10;0;0;10
10730;Skroblinukas;BITUČIŲ;2071447940;Taip;4;0;3;7
10731;Skroblinukas;BITUČIŲ;1659335142;Taip;0;1;0;1
10732;Skroblinukas;BITUČIŲ;6604496585;Taip;20;0;0;20
10733;Skroblinukas;BITUČIŲ;3736883850;Taip;16;0;0;16
10734;Skroblinukas;BITUČIŲ;7191689856;Taip;0;9;0;9
10735;Skroblinukas;BITUČIŲ;8778072326;Taip;0;10;8;18
10736;Skroblinukas;BITUČIŲ;2032621707;Taip;10;0;1;11
10737;Skroblinukas;BITUČIŲ;8277152812;Taip;0;2;0;2
10738;Skroblinukas;BITUČIŲ;8374103872;Taip;0;2;0;2
10739;Skroblinukas;BITUČIŲ;8618587013;Taip;16;0;1;17
10740;Skroblinukas;BITUČIŲ;4945107862;Ne;0;0;6;6
10741;Skroblinukas;BITUČIŲ;9594078223;Taip;0;1;0;1
10742;Skroblinukas;BITUČIŲ;9075266818;Ne;0;6;0;6
10743;Skroblinukas;BITUČIŲ;1432694920;Taip;0;8;0;8
10744;Skroblinukas;BITUČIŲ;1967305501;Taip;11;0;5;16
10745;Skroblinukas;BITUČIŲ;1688990637;Taip;8;0;0;8
10746;Skroblinukas;BITUČIŲ;1957488412;Taip;5;0;1;6
10747;Skroblinukas;BITUČIŲ;1000804920;Taip;0;0;1;1
10748;Skroblinukas;BITUČIŲ;1544346282;Taip;0;8;0;8
10749;Skroblinukas;BITUČIŲ;1711568129;Taip;7;0;1;8
10750;Skroblinukas;BORUŽĖLIŲ;2706526326;Taip;9;1;1;11
10751;Skroblinukas;BORUŽĖLIŲ;9661609284;Taip;20;0;0;20
10752;Skroblinukas;BORUŽĖLIŲ;1002570367;Taip;11;0;0;11
10753;Skroblinukas;BORUŽĖLIŲ;6293879765;Taip;6;0;0;6
10754;Skroblinukas;BORUŽĖLIŲ;9725125130;Taip;3;1;0;4
10755;Skroblinukas;BORUŽĖLIŲ;9888115079;Taip;0;14;4;18
10756;Skroblinukas;BORUŽĖLIŲ;8576448571;Taip;10;0;2;12
10757;Skroblinukas;BORUŽĖLIŲ;8946940285;Taip;2;6;3;11
10758;Skroblinukas;BORUŽĖLIŲ;3290115134;Taip;12;3;0;15
10759;Skroblinukas;BORUŽĖLIŲ;9813249677;Taip;6;0;0;6
10760;Skroblinukas;BORUŽĖLIŲ;3461165182;Taip;0;0;17;17
10761;Skroblinukas;BORUŽĖLIŲ;2101748012;Taip;6;1;1;8
10762;Skroblinukas;BORUŽĖLIŲ;5915278745;Taip;5;3;0;8
10763;Skroblinukas;BORUŽĖLIŲ;6433636135;Taip;0;12;4;16
10764;Skroblinukas;BORUŽĖLIŲ;9475514959;Ne;4;1;0;5
10765;Skroblinukas;SKRUZDĖLIUKŲ;1446835893;Taip;7;9;0;16
10766;Skroblinukas;SKRUZDĖLIUKŲ;2116630768;Taip;0;3;1;4
10767;Skroblinukas;SKRUZDĖLIUKŲ;1710559060;Taip;16;0;0;16
10768;Skroblinukas;SKRUZDĖLIUKŲ;1175660577;Taip;0;5;5;10
10769;Skroblinukas;SKRUZDĖLIUKŲ;21862553841;Taip;11;8;0;19
10770;Skroblinukas;SKRUZDĖLIUKŲ;1611685585;Taip;11;8;0;19
10771;Skroblinukas;SKRUZDĖLIUKŲ;1631945330;Taip;0;0;7;7
10772;Skroblinukas;SKRUZDĖLIUKŲ;58000101216;Taip;0;0;4;4
10773;Skroblinukas;SKRUZDĖLIUKŲ;85704624097;Taip;9;0;0;9
10774;Skroblinukas;SKRUZDĖLIUKŲ;72528180087;Taip;0;1;0;1
10775;Skroblinukas;SKRUZDĖLIUKŲ;91409992058;Taip;0;0;3;3
10776;Skroblinukas;SKRUZDĖLIUKŲ;1096323930;Taip;5;1;0;6
10777;Skroblinukas;SKRUZDĖLIUKŲ;50466456602;Taip;5;2;0;7
10778;Skroblinukas;SKRUZDĖLIUKŲ;40602768192;Taip;10;0;0;10
10779;Skroblinukas;SKRUZDĖLIUKŲ;87741312158;Taip;0;2;0;2
10780;Skroblinukas;SKRUZDĖLIUKŲ;3226377926;Taip;0;0;3;3
10781;Skroblinukas;SKRUZDĖLIUKŲ;42252673755;Taip;11;1;0;12
10782;Skroblinukas;SKRUZDĖLIUKŲ;7896922448;Taip;4;2;0;6
10783;Skroblinukas;SKRUZDĖLIUKŲ;2035304515;Taip;0;8;0;8
10784;Skroblinukas;SKRUZDĖLIUKŲ;1388763405;Taip;10;0;2;12
10785;Skroblinukas;SKRUZDĖLIUKŲ;60597534140;Taip;10;0;0;10
10786;Skroblinukas;SKRUZDĖLIUKŲ;7416993749;Taip;0;2;0;2
10787;Skroblinukas;ŽVIRBLIUKŲ;9045708140;Taip;6;4;0;10
10788;Skroblinukas;ŽVIRBLIUKŲ;2197158518;Taip;0;0;3;3
10789;Skroblinukas;ŽVIRBLIUKŲ;6266609965;Taip;17;0;0;17
10790;Skroblinukas;ŽVIRBLIUKŲ;5646847921;Taip;2;0;2;4
10791;Skroblinukas;ŽVIRBLIUKŲ;6640062847;Taip;11;0;6;17
10792;Skroblinukas;ŽVIRBLIUKŲ;4560580022;Taip;0;4;0;4
10793;Skroblinukas;ŽVIRBLIUKŲ;7921251819;Taip;3;8;4;15
10794;Skroblinukas;ŽVIRBLIUKŲ;5546256869;Taip;12;0;2;14
10795;Skroblinukas;ŽVIRBLIUKŲ;9572912046;Taip;0;4;0;4
10796;Skroblinukas;ŽVIRBLIUKŲ;6235844690;Taip;0;0;1;1
10797;Skroblinukas;ŽVIRBLIUKŲ;2097758483;Taip;15;2;0;17
10798;Skroblinukas;ŽVIRBLIUKŲ;3641822841;Taip;17;3;0;20
10799;Skroblinukas;ŽVIRBLIUKŲ;9377215921;Taip;15;0;0;15
10800;Skroblinukas;ŽIOGELIŲ;5157913924;Taip;14;1;0;15
10801;Skroblinukas;ŽIOGELIŲ;9368764758;Taip;0;2;1;3
10802;Skroblinukas;ŽIOGELIŲ;3006521657;Taip;0;2;0;2
10803;Skroblinukas;ŽIOGELIŲ;3771045336;Taip;0;5;0;5
10804;Skroblinukas;ŽIOGELIŲ;6890306112;Taip;0;7;0;7
10805;Skroblinukas;ŽIOGELIŲ;9958188318;Taip;10;1;5;16
10806;Skroblinukas;ŽIOGELIŲ;9448253468;Taip;0;0;1;1
10807;Skroblinukas;ŽIOGELIŲ;9634311146;Taip;9;0;0;9
10808;Skroblinukas;ŽIOGELIŲ;5688453546;Taip;0;2;2;4
10809;Skroblinukas;ŽIOGELIŲ;6445065388;Taip;15;0;2;17
10810;Skroblinukas;ŽIOGELIŲ;4424763028;Taip;19;0;0;19
10811;Skroblinukas;ŽIOGELIŲ;9353353289;Taip;5;2;10;17
10812;Skroblinukas;ŽIOGELIŲ;5252389111;Taip;7;2;0;9
10813;Skroblinukas;ŽIOGELIŲ;2883593274;Taip;3;1;1;5
10814;Skroblinukas;ŽIOGELIŲ;1970738675;Taip;14;0;6;20
10815;Skroblinukas;STRAZDELIŲ;1054097622;Taip;8;2;0;10
10816;Skroblinukas;STRAZDELIŲ;5433647187;Taip;14;0;1;15
10817;Skroblinukas;STRAZDELIŲ;9915130747;Taip;11;8;0;19
10818;Skroblinukas;STRAZDELIŲ;1159546580;Taip;11;0;1;12
10819;Skroblinukas;STRAZDELIŲ;2310750833;Taip;0;4;7;11
10820;Skroblinukas;STRAZDELIŲ;2184711783;Taip;0;0;5;5
10821;Skroblinukas;STRAZDELIŲ;3010510262;Taip;6;1;0;7
10822;Skroblinukas;STRAZDELIŲ;6489976163;Taip;9;0;1;10
10823;Skroblinukas;STRAZDELIŲ;1669610397;Taip;0;0;1;1
10824;Skroblinukas;STRAZDELIŲ;9541682085;Taip;8;0;0;8
10825;Skroblinukas;STRAZDELIŲ;5566457656;Ne;3;0;1;4
10826;Skroblinukas;STRAZDELIŲ;4571530482;Taip;10;0;0;10
10827;Skroblinukas;DRUGELIŲ;1792672886;Taip;11;0;6;17
10828;Skroblinukas;DRUGELIŲ;1979723351;Taip;0;0;1;1
10829;Skroblinukas;DRUGELIŲ;1964529755;Taip;0;5;0;5
10830;Skroblinukas;DRUGELIŲ;86231564690;Taip;0;0;4;4
10831;Skroblinukas;DRUGELIŲ;23687553212;Taip;12;3;0;15
10832;Skroblinukas;DRUGELIŲ;4532268875;Taip;8;1;0;9
10833;Skroblinukas;DRUGELIŲ;86542450905;Taip;9;0;10;19
10834;Skroblinukas;DRUGELIŲ;54750454175;Taip;0;2;0;2
10835;Skroblinukas;DRUGELIŲ;3636028890;Taip;11;0;2;13
10836;Skroblinukas;DRUGELIŲ;2079452635;Taip;0;6;1;7
10837;Skroblinukas;DRUGELIŲ;1510927547;Taip;0;6;1;7
10838;Skroblinukas;DRUGELIŲ;2325940694;Taip;5;8;0;13
10839;Skroblinukas;DRUGELIŲ;15977832913;Taip;11;0;0;11
10840;Skroblinukas;DRUGELIŲ;5068339590;Taip;10;5;0;15
10841;Skroblinukas;DRUGELIŲ;3580045988;Taip;14;0;0;14
10842;Skroblinukas;DRUGELIŲ;1791669956;Taip;0;4;3;7
10843;Skroblinukas;DRUGELIŲ;7184817010;Taip;0;0;4;4
10844;Skroblinukas;DRUGELIŲ;1109895463;Ne;0;6;0;6
10845;Skroblinukas;DRUGELIŲ;4272941994;Taip;4;0;5;9
10846;Skroblinukas;PELĖDŽIUKŲ;5975039463;Taip;4;0;0;4
10847;Skroblinukas;PELĖDŽIUKŲ;63514584063;Taip;0;15;0;15
10848;Skroblinukas;PELĖDŽIUKŲ;1000422430;Taip;0;7;0;7
10849;Skroblinukas;PELĖDŽIUKŲ;1556675902;Taip;6;5;0;11
10850;Skroblinukas;PELĖDŽIUKŲ;7666122737;Taip;7;0;0;7
10851;Skroblinukas;PELĖDŽIUKŲ;3864043251;Taip;0;4;1;5
10852;Skroblinukas;PELĖDŽIUKŲ;1759830058;Taip;0;4;0;4
10853;Skroblinukas;PELĖDŽIUKŲ;1471842192;Taip;0;0;3;3
10854;Skroblinukas;PELĖDŽIUKŲ;1382981497;Taip;2;1;0;3
10855;Skroblinukas;PELĖDŽIUKŲ;29908502973;Taip;0;6;0;6
10856;Skroblinukas;PELĖDŽIUKŲ;1220311458;Taip;9;2;0;11
10857;Skroblinukas;PELĖDŽIUKŲ;1599112927;Taip;4;2;1;7
10858;Skroblinukas;PELĖDŽIUKŲ;95946607624;Taip;0;6;0;6
10859;Skroblinukas;PELĖDŽIUKŲ;8150037173;Taip;0;1;0;1
10860;Skroblinukas;PELĖDŽIUKŲ;1898486832;Taip;7;0;0;7
10861;Skroblinukas;PELĖDŽIUKŲ;1515227489;Taip;0;0;1;1
10862;Skroblinukas;PELĖDŽIUKŲ;76523308405;Taip;11;6;0;17
10863;Skroblinukas;PELĖDŽIUKŲ;1602978649;Taip;0;3;0;3
10864;Skroblinukas;PELĖDŽIUKŲ;1258044022;Taip;10;0;0;10
10865;Skroblinukas;PELĖDŽIUKŲ;39209870512;Taip;0;1;2;3
10866;Skroblinukas;PELĖDŽIUKŲ;4914479407;Taip;5;0;2;7
10867;Skroblinukas;PELĖDŽIUKŲ;1847074960;Taip;8;0;2;10
10868;Smalsučiai;Žibuoklės;46376560575;Taip;5;7;0;12
10869;Smalsučiai;Žibuoklės;27034024515;Ne;0;0;2;2
10870;Smalsučiai;Žibuoklės;68726523946;Taip;0;3;0;3
10871;Smalsučiai;Žibuoklės;50803234873;Taip;0;1;3;4
10872;Smalsučiai;Žibuoklės;1760728524;Taip;1;10;0;11
10873;Smalsučiai;Žibuoklės;85358131888;Taip;19;0;0;19
10874;Smalsučiai;Žibuoklės;51861969442;Taip;0;0;5;5
10875;Smalsučiai;Žibuoklės;82746324948;Ne;0;6;0;6
10876;Smalsučiai;Žibuoklės;4258713607;Taip;0;12;0;12
10877;Smalsučiai;Žibuoklės;68097436766;Taip;5;4;0;9
10878;Smalsučiai;Žibuoklės;40922293471;Taip;4;6;0;10
10879;Smalsučiai;Žibuoklės;83056178108;Taip;7;0;0;7
10880;Smalsučiai;Žibuoklės;85342418658;Taip;3;0;1;4
10881;Smalsučiai;Žibuoklės;1023262986;Taip;16;1;0;17
10882;Smalsučiai;Žibuoklės;83033796468;Taip;13;2;0;15
10883;Smalsučiai;Žibuoklės;62767756842;Taip;0;0;1;1
10884;Smalsučiai;Žibuoklės;2099765750;Taip;0;14;0;14
10885;Smalsučiai;Žibuoklės;9512217842;Taip;0;4;0;4
10886;Smalsučiai;Žibuoklės;97809921080;Taip;0;5;0;5
10887;Smalsučiai;Žibuoklės;2021640036;Taip;5;0;2;7
10888;Smalsučiai;Aitvarų;53737587501;Taip;20;0;0;20
10889;Smalsučiai;Aitvarų;67243805772;Taip;10;0;0;10
10890;Smalsučiai;Aitvarų;71839472863;Taip;0;4;0;4
10891;Smalsučiai;Aitvarų;26007606072;Taip;0;3;0;3
10892;Smalsučiai;Aitvarų;55212746834;Taip;0;2;5;7
10893;Smalsučiai;Aitvarų;97665693700;Taip;0;5;0;5
10894;Smalsučiai;Aitvarų;70181610962;Ne;0;6;0;6
10895;Smalsučiai;Aitvarų;48426272721;Taip;2;0;3;5
10896;Smalsučiai;Aitvarų;12446167265;Taip;0;4;0;4
10897;Smalsučiai;Aitvarų;76405732236;Taip;0;2;0;2
10898;Smalsučiai;Aitvarų;68897306811;Taip;0;6;0;6
10899;Smalsučiai;Aitvarų;45731306499;Taip;5;4;0;9
10900;Smalsučiai;Aitvarų;1417945043;Taip;0;10;0;10
10901;Smalsučiai;Aitvarų;5631758578;Taip;0;4;0;4
10902;Smalsučiai;Aitvarų;95501158334;Taip;5;7;2;14
10903;Smalsučiai;Aitvarų;31748074403;Taip;0;6;0;6
10904;Smalsučiai;Aitvarų;1673246147;Taip;5;5;0;10
10905;Smalsučiai;Aitvarų;62387945180;Taip;7;0;1;8
10906;Smalsučiai;Aitvarų;1095159887;Taip;5;0;0;5
10907;Smalsučiai;Aitvarų;1424532027;Taip;19;0;0;19
10908;Smalsučiai;Aitvarų;1567576834;Taip;0;2;0;2
10909;Smalsučiai;Aitvarų;1965194010;Taip;7;0;2;9
10910;Smalsučiai;Sraigiukų;4004275398;Taip;10;0;1;11
10911;Smalsučiai;Sraigiukų;18980466605;Taip;2;1;3;6
10912;Smalsučiai;Sraigiukų;2036701320;Taip;13;0;1;14
10913;Smalsučiai;Sraigiukų;1597721199;Taip;6;5;0;11
10914;Smalsučiai;Sraigiukų;36701180571;Taip;5;7;0;12
10915;Smalsučiai;Sraigiukų;1968415573;Taip;5;5;0;10
10916;Smalsučiai;Sraigiukų;8572292571;Taip;3;0;4;7
10917;Smalsučiai;Sraigiukų;92460059853;Taip;0;0;5;5
10918;Smalsučiai;Sraigiukų;8604112256;Taip;5;0;0;5
10919;Smalsučiai;Sraigiukų;68583864690;Taip;5;0;0;5
10920;Smalsučiai;Sraigiukų;1830368274;Taip;11;0;3;14
10921;Smalsučiai;Sraigiukų;92129554371;Taip;10;1;0;11
10922;Smalsučiai;Sraigiukų;4655599359;Taip;1;1;1;3
10923;Smalsučiai;Sraigiukų;28055409190;Taip;9;1;0;10
10924;Smalsučiai;Sraigiukų;1504060488;Taip;2;0;0;2
10925;Smalsučiai;Sraigiukų;2112871055;Taip;14;0;0;14
10926;Smalsučiai;Sraigiukų;1453463899;Taip;0;0;7;7
10927;Smalsučiai;Sraigiukų;7037820869;Taip;0;0;7;7
10928;Smalsučiai;Sraigiukų;7450298541;Taip;3;0;1;4
10929;Smalsučiai;Sraigiukų;3792738445;Taip;11;0;6;17
10930;Smalsučiai;Saulučių;513516143;Taip;14;0;1;15
10931;Smalsučiai;Saulučių;32382108578;Taip;8;0;3;11
10932;Smalsučiai;Saulučių;25838645404;Taip;4;0;1;5
10933;Smalsučiai;Saulučių;54610929862;Taip;6;0;8;14
10934;Smalsučiai;Saulučių;96461087926;Taip;5;6;0;11
10935;Smalsučiai;Saulučių;98196404299;Taip;8;1;0;9
10936;Smalsučiai;Saulučių;66154228179;Taip;0;0;5;5
10937;Smalsučiai;Saulučių;59594678142;Taip;11;0;0;11
10938;Smalsučiai;Saulučių;94734585174;Taip;2;1;4;7
10939;Smalsučiai;Saulučių;73783991852;Taip;5;0;0;5
10940;Smalsučiai;Saulučių;47452987441;Taip;1;0;0;1
10941;Smalsučiai;Saulučių;81834985961;Taip;5;0;5;10
10942;Smalsučiai;Saulučių;55812291804;Taip;16;1;0;17
10943;Smalsučiai;Saulučių;16418705168;Taip;0;1;0;1
10944;Smalsučiai;Saulučių;63886240982;Taip;5;0;1;6
10945;Smalsučiai;Saulučių;57622458673;Taip;0;0;6;6
10946;Smalsučiai;Saulučių;73899364649;Taip;0;6;9;15
10947;Smalsučiai;Saulučių;1575017231;Taip;1;0;0;1
10948;Smalsučiai;Saulučių;6857124432;Taip;11;0;0;11
10949;Smalsučiai;Saulučių;1653798728;Taip;5;1;0;6
10950;Smalsučiai;Viščiukų;13763655324;Taip;5;6;0;11
10951;Smalsučiai;Viščiukų;2802867649;Taip;1;4;0;5
10952;Smalsučiai;Viščiukų;66281706978;Taip;6;0;0;6
10953;Smalsučiai;Viščiukų;30592434971;Taip;5;6;0;11
10954;Smalsučiai;Viščiukų;18717627431;Taip;0;2;0;2
10955;Smalsučiai;Viščiukų;26787916874;Taip;9;0;0;9
10956;Smalsučiai;Viščiukų;63575906792;Taip;1;8;0;9
10957;Smalsučiai;Viščiukų;27727844778;Taip;0;1;0;1
10958;Smalsučiai;Viščiukų;1514166474;Taip;0;8;0;8
10959;Smalsučiai;Viščiukų;96002139110;Taip;10;2;0;12
10960;Smalsučiai;Viščiukų;1893910089;Taip;5;5;0;10
10961;Smalsučiai;Viščiukų;1786097164;Ne;8;10;0;18
10962;Smalsučiai;Viščiukų;55385713527;Taip;2;0;0;2
10963;Smalsučiai;Viščiukų;78496301809;Taip;5;1;0;6
10964;Smalsučiai;Viščiukų;92961881271;Taip;0;2;1;3
10965;Smalsučiai;Viščiukų;66603023493;Taip;6;0;0;6
10966;Smalsučiai;Viščiukų;6264082741;Taip;16;0;0;16
10967;Smalsučiai;Viščiukų;30464130912;Taip;11;0;0;11
10968;Smalsučiai;Viščiukų;4732277124;Taip;8;0;0;8
10969;Smalsučiai;Boružėlių;9426629964;Taip;2;0;0;2
10970;Smalsučiai;Boružėlių;1703679877;Taip;0;0;1;1
10971;Smalsučiai;Boružėlių;2022025913;Taip;17;0;0;17
10972;Smalsučiai;Boružėlių;2208462326;Taip;5;3;0;8
10973;Smalsučiai;Boružėlių;6643253926;Taip;0;1;0;1
10974;Smalsučiai;Boružėlių;1473016908;Taip;5;0;2;7
10975;Smalsučiai;Boružėlių;7226242747;Taip;0;0;1;1
10976;Smalsučiai;Boružėlių;6085020049;Taip;0;5;0;5
10977;Smalsučiai;Boružėlių;8340768848;Taip;15;0;0;15
10978;Smalsučiai;Boružėlių;69450514879;Taip;15;2;0;17
10979;Smalsučiai;Boružėlių;4740303929;Taip;1;1;0;2
10980;Smalsučiai;Boružėlių;4046718551;Taip;11;0;0;11
10981;Smalsučiai;Boružėlių;7364431725;Taip;12;0;0;12
10982;Smalsučiai;Boružėlių;2694575252;Taip;0;0;1;1
10983;Smalsučiai;Boružėlių;2671403814;Taip;5;0;1;6
10984;Smalsučiai;Boružėlių;2737886714;Taip;0;11;0;11
10985;Smalsučiai;Boružėlių;4858914868;Taip;5;0;0;5
10986;Smalsučiai;Zuikių;1335301931;Taip;10;1;0;11
10987;Smalsučiai;Zuikių;1154978396;Taip;5;3;1;9
10988;Smalsučiai;Zuikių;4930548597;Taip;11;1;0;12
10989;Smalsučiai;Zuikių;37584386087;Taip;3;5;0;8
10990;Smalsučiai;Zuikių;1384803468;Taip;5;0;0;5
10991;Smalsučiai;Zuikių;85935601752;Taip;0;2;0;2
10992;Smalsučiai;Zuikių;44282636010;Taip;2;0;0;2
10993;Smalsučiai;Zuikių;64619831879;Taip;0;4;0;4
10994;Smalsučiai;Zuikių;57517286591;Taip;0;0;1;1
10995;Smalsučiai;Zuikių;55334476483;Taip;0;2;1;3
10996;Smalsučiai;Zuikių;13761441573;Taip;6;4;3;13
10997;Smalsučiai;Zuikių;1445104610;Taip;10;0;0;10
10998;Smalsučiai;Zuikių;70572717101;Taip;3;1;0;4
10999;Smalsučiai;Zuikių;69940677093;Taip;0;2;2;4
11000;Smalsučiai;Zuikių;6208392231;Ne;0;16;0;16
11001;Smalsučiai;Zuikių;85617121883;Taip;4;5;0;9
11002;Smalsučiai;Zuikių;32121383319;Taip;6;9;0;15
11003;Smalsučiai;Nykštukų;2327930850;Taip;15;5;0;20
11004;Smalsučiai;Nykštukų;3787937467;Taip;0;13;0;13
11005;Smalsučiai;Nykštukų;4134975456;Taip;11;0;3;14
11006;Smalsučiai;Nykštukų;9155011285;Taip;14;6;0;20
11007;Smalsučiai;Nykštukų;9582225178;Taip;8;0;0;8
11008;Smalsučiai;Nykštukų;4566816316;Taip;5;3;0;8
11009;Smalsučiai;Nykštukų;1471941426;Taip;2;2;2;6
11010;Smalsučiai;Nykštukų;1458544456;Taip;0;6;0;6
11011;Smalsučiai;Nykštukų;4364810458;Taip;5;0;0;5
11012;Smalsučiai;Nykštukų;6469604093;Taip;8;0;0;8
11013;Smalsučiai;Nykštukų;6358800570;Taip;15;0;0;15
11014;Smalsučiai;Nykštukų;5184903287;Taip;1;0;0;1
11015;Smalsučiai;Nykštukų;7933302912;Taip;0;13;0;13
11016;Smalsučiai;Nykštukų;3757955200;Taip;20;0;0;20
11017;Smalsučiai;Nykštukų;5406430393;Taip;13;2;0;15
11018;Smalsučiai;Nykštukų;6899040199;Taip;8;0;3;11
11019;Smalsučiai;Nykštukų;9241738140;Taip;10;7;0;17
11020;Smalsučiai;Katinėlių;8259056296;Taip;14;0;0;14
11021;Smalsučiai;Katinėlių;9864518144;Taip;8;3;0;11
11022;Smalsučiai;Katinėlių;2958335372;Taip;10;4;0;14
11023;Smalsučiai;Katinėlių;7137550663;Taip;11;0;0;11
11024;Smalsučiai;Katinėlių;6090391818;Taip;11;1;2;14
11025;Smalsučiai;Katinėlių;6577214344;Taip;7;0;0;7
11026;Smalsučiai;Katinėlių;7396172351;Taip;5;0;0;5
11027;Smalsučiai;Katinėlių;8977651419;Taip;6;0;0;6
11028;Smalsučiai;Katinėlių;6406285034;Taip;6;0;0;6
11029;Smalsučiai;Katinėlių;6006832443;Taip;6;0;0;6
11030;Smalsučiai;Katinėlių;7726086066;Taip;0;1;5;6
11031;Smalsučiai;Katinėlių;8128348060;Taip;0;0;2;2
11032;Smalsučiai;Katinėlių;9637877396;Taip;16;0;0;16
11033;Smalsučiai;PELĖDŽIUKAI;8794407618;Taip;0;10;0;10
11034;Smalsučiai;PELĖDŽIUKAI;1374075909;Taip;7;2;0;9
11035;Smalsučiai;PELĖDŽIUKAI;3543889830;Taip;0;3;0;3
11036;Smalsučiai;PELĖDŽIUKAI;86106357239;Taip;6;0;0;6
11037;Smalsučiai;PELĖDŽIUKAI;67362576311;Taip;14;1;0;15
11038;Smalsučiai;PELĖDŽIUKAI;43758366827;Taip;1;1;0;2
11039;Smalsučiai;PELĖDŽIUKAI;42287520446;Taip;0;4;0;4
11040;Smalsučiai;PELĖDŽIUKAI;30890983859;Taip;6;2;0;8
11041;Smalsučiai;PELĖDŽIUKAI;72912782044;Taip;0;1;0;1
11042;Smalsučiai;PELĖDŽIUKAI;81140813811;Taip;0;1;0;1
11043;Smalsučiai;PELĖDŽIUKAI;3103358607;Taip;5;5;1;11
11044;Smalsučiai;PELĖDŽIUKAI;59084242712;Taip;5;1;0;6
11045;Smalsučiai;PELĖDŽIUKAI;22888541896;Taip;13;0;0;13
11046;Smalsučiai;PELĖDŽIUKAI;69010502468;Taip;0;5;0;5
11047;Smalsučiai;PELĖDŽIUKAI;50426509300;Taip;0;1;0;1
11048;Smalsučiai;PELĖDŽIUKAI;49495262113;Taip;10;0;0;10
11049;Smalsučiai;PELĖDŽIUKAI;98465335011;Taip;7;1;0;8
11050;Smalsučiai;Pingvinukai;99467576480;Taip;10;1;0;11
11051;Smalsučiai;Pingvinukai;5441966713;Taip;10;0;0;10
11052;Smalsučiai;Pingvinukai;8306946163;Taip;5;0;0;5
11053;Smalsučiai;Pingvinukai;1997966082;Taip;0;9;0;9
11054;Smalsučiai;Pingvinukai;4795138729;Taip;13;1;0;14
11055;Smalsučiai;Pingvinukai;2638709634;Taip;0;2;1;3
11056;Smalsučiai;Pingvinukai;6469044880;Taip;10;1;0;11
11057;Smalsučiai;Pingvinukai;1775539505;Taip;5;1;0;6
11058;Smalsučiai;Pingvinukai;1316590100;Taip;0;9;0;9
11059;Smalsučiai;Pingvinukai;2059832436;Taip;13;2;0;15
11060;Smalsučiai;Pingvinukai;8810690546;Taip;5;10;0;15
11061;Smalsučiai;Pingvinukai;4585930202;Taip;5;1;0;6
11062;Smalsučiai;Pingvinukai;9632022271;Taip;0;0;7;7
11063;Smalsučiai;Pingvinukai;1372591510;Taip;3;2;0;5
11064;Smalsučiai;Pingvinukai;8193410963;Taip;2;1;1;4
11065;Smalsučiai;Pingvinukai;3644256220;Taip;9;0;1;10
11066;Smalsučiai;Pingvinukai;6536165801;Taip;20;0;0;20
11067;Smalsučiai;Pingvinukai;4909226602;Taip;0;0;14;14
11068;Smalsučiai;Pingvinukai;2365835087;Taip;5;0;0;5
11069;Smalsučiai;Pingvinukai;5761169841;Taip;10;0;0;10
11070;Smalsučiai;Voverikų;44888860122;Taip;0;0;2;2
11071;Smalsučiai;Voverikų;7713078413;Taip;5;1;0;6
11072;Smalsučiai;Voverikų;3607226859;Taip;7;1;0;8
11073;Smalsučiai;Voverikų;22791221635;Taip;5;1;0;6
11074;Smalsučiai;Voverikų;7794541741;Taip;7;0;1;8
11075;Smalsučiai;Voverikų;1467603676;Taip;0;4;0;4
11076;Smalsučiai;Voverikų;1982046497;Taip;1;0;0;1
11077;Smalsučiai;Voverikų;1181574676;Taip;17;0;0;17
11078;Smalsučiai;Voverikų;1599488035;Taip;0;9;0;9
11079;Smalsučiai;Voverikų;6207026048;Taip;3;2;2;7
11080;Smalsučiai;Voverikų;19592364606;Taip;4;0;1;5
11081;Smalsučiai;Voverikų;1668692281;Taip;4;0;0;4
11082;Smalsučiai;Voverikų;5730866119;Taip;0;0;3;3
11083;Smalsučiai;Voverikų;1824321380;Taip;0;6;0;6
11084;Smalsučiai;Voverikų;5611487967;Taip;8;0;0;8
11085;Smalsučiai;Voverikų;4145769042;Taip;0;0;1;1
11086;Spindulėlis;SAULUTĖS;6435045068;Taip;0;1;1;2
11087;Spindulėlis;SAULUTĖS;1821231102;Taip;2;0;0;2
11088;Spindulėlis;SAULUTĖS;1514479696;Taip;20;0;0;20
11089;Spindulėlis;SAULUTĖS;27408123487;Taip;10;7;0;17
11090;Spindulėlis;SAULUTĖS;1394918021;Taip;13;0;0;13
11091;Spindulėlis;SAULUTĖS;9977569249;Taip;14;0;0;14
11092;Spindulėlis;SAULUTĖS;1180176295;Taip;7;0;0;7
11093;Spindulėlis;SAULUTĖS;1730248631;Taip;0;0;6;6
11094;Spindulėlis;SAULUTĖS;21152690883;Taip;2;1;0;3
11095;Spindulėlis;SAULUTĖS;1391226466;Taip;4;8;0;12
11096;Spindulėlis;SAULUTĖS;1694423628;Taip;6;6;0;12
11097;Spindulėlis;SAULUTĖS;1679106754;Taip;0;3;0;3
11098;Spindulėlis;SAULUTĖS;2234877411;Taip;0;0;1;1
11099;Spindulėlis;SAULUTĖS;72997461686;Taip;6;0;0;6
11100;Spindulėlis;SAULUTĖS;4353031174;Taip;13;0;0;13
11101;Spindulėlis;SAULUTĖS;1424288192;Taip;4;0;1;5
11102;Spindulėlis;SAULUTĖS;1346035733;Taip;0;1;0;1
11103;Spindulėlis;SAULUTĖS;92417802345;Taip;5;0;1;6
11104;Spindulėlis;DRUGELIAI;30036722764;Ne;0;0;20;20
11105;Spindulėlis;DRUGELIAI;19541905006;Taip;0;8;0;8
11106;Spindulėlis;DRUGELIAI;27928352319;Taip;10;4;0;14
11107;Spindulėlis;DRUGELIAI;64339072411;Taip;5;7;0;12
11108;Spindulėlis;DRUGELIAI;27520164282;Taip;0;0;1;1
11109;Spindulėlis;DRUGELIAI;1528496272;Taip;8;0;0;8
11110;Spindulėlis;DRUGELIAI;1763306358;Taip;9;5;0;14
11111;Spindulėlis;DRUGELIAI;1033202443;Taip;7;4;0;11
11112;Spindulėlis;DRUGELIAI;1939526832;Taip;6;0;8;14
11113;Spindulėlis;DRUGELIAI;2988630379;Taip;9;2;0;11
11114;Spindulėlis;DRUGELIAI;55250330957;Taip;0;3;5;8
11115;Spindulėlis;DRUGELIAI;80331157814;Taip;5;0;0;5
11116;Spindulėlis;DRUGELIAI;2137229669;Taip;0;4;0;4
11117;Spindulėlis;DRUGELIAI;60956380679;Taip;14;1;0;15
11118;Spindulėlis;DRUGELIAI;29747353664;Taip;6;0;3;9
11119;Spindulėlis;DRUGELIAI;97661389553;Taip;0;9;0;9
11120;Spindulėlis;DRUGELIAI;2131409282;Taip;1;0;2;3
11121;Spindulėlis;DRUGELIAI;9348576749;Taip;5;3;1;9
11122;Spindulėlis;DRUGELIAI;63344816879;Taip;16;0;1;17
11123;Spindulėlis;DRUGELIAI;18443825776;Taip;6;0;0;6
11124;Spindulėlis;DRUGELIAI;9145337789;Taip;0;0;9;9
11125;Spindulėlis;DRUGELIAI;96365393879;Taip;11;0;0;11
11126;Spindulėlis;DRUGELIAI;5050019035;Taip;5;3;0;8
11127;Spindulėlis;BITUTĖS;9729955786;Taip;6;4;0;10
11128;Spindulėlis;BITUTĖS;74912418250;Taip;5;0;0;5
11129;Spindulėlis;BITUTĖS;16110787934;Taip;9;4;0;13
11130;Spindulėlis;BITUTĖS;19056425785;Taip;7;6;0;13
11131;Spindulėlis;BITUTĖS;17990017515;Taip;0;3;2;5
11132;Spindulėlis;BITUTĖS;83727622058;Taip;8;0;0;8
11133;Spindulėlis;BITUTĖS;34303994728;Taip;7;0;0;7
11134;Spindulėlis;BITUTĖS;75678343003;Taip;0;4;0;4
11135;Spindulėlis;BITUTĖS;4798024997;Taip;0;16;0;16
11136;Spindulėlis;BITUTĖS;83785970474;Taip;0;5;0;5
11137;Spindulėlis;BITUTĖS;4842304821;Taip;6;5;0;11
11138;Spindulėlis;BITUTĖS;92803008887;Taip;0;1;0;1
11139;Spindulėlis;BITUTĖS;35801673097;Taip;19;0;0;19
11140;Spindulėlis;BITUTĖS;85203448043;Taip;0;1;0;1
11141;Spindulėlis;BITUTĖS;4539792030;Taip;8;0;0;8
11142;Spindulėlis;BITUTĖS;16045001090;Taip;0;2;0;2
11143;Spindulėlis;BITUTĖS;1399847362;Taip;1;0;0;1
11144;Spindulėlis;BITUTĖS;8934483022;Taip;6;5;0;11
11145;Spindulėlis;BITUTĖS;60061983557;Taip;0;5;1;6
11146;Spindulėlis;VARPELIAI;5288557629;Taip;5;7;0;12
11147;Spindulėlis;VARPELIAI;5233044803;Taip;0;7;0;7
11148;Spindulėlis;VARPELIAI;8923393066;Taip;0;0;5;5
11149;Spindulėlis;VARPELIAI;9244494109;Taip;0;0;5;5
11150;Spindulėlis;VARPELIAI;8141324449;Taip;7;0;1;8
11151;Spindulėlis;VARPELIAI;6449284856;Taip;16;0;4;20
11152;Spindulėlis;VARPELIAI;4077985773;Taip;4;5;0;9
11153;Spindulėlis;VARPELIAI;6592057292;Taip;10;0;1;11
11154;Spindulėlis;VARPELIAI;2890377876;Taip;4;0;4;8
11155;Spindulėlis;VARPELIAI;1454039572;Taip;13;0;1;14
11156;Spindulėlis;VARPELIAI;9511051386;Taip;10;0;0;10
11157;Spindulėlis;VARPELIAI;9740815635;Taip;0;0;5;5
11158;Spindulėlis;VARPELIAI;7099787230;Taip;19;0;1;20
11159;Spindulėlis;VARPELIAI;4308169582;Taip;5;0;5;10
11160;Spindulėlis;VARPELIAI;3088386659;Taip;5;0;13;18
11161;Spragtukas;NYKŠTUKAI;1756340613;Taip;9;2;0;11
11162;Spragtukas;NYKŠTUKAI;8226921630;Taip;9;4;0;13
11163;Spragtukas;NYKŠTUKAI;5236797574;Taip;0;4;0;4
11164;Spragtukas;NYKŠTUKAI;9860876807;Taip;0;4;0;4
11165;Spragtukas;NYKŠTUKAI;5633883897;Taip;7;2;0;9
11166;Spragtukas;NYKŠTUKAI;4069044269;Taip;0;6;0;6
11167;Spragtukas;NYKŠTUKAI;1771141306;Taip;0;9;0;9
11168;Spragtukas;NYKŠTUKAI;1306663967;Taip;4;7;0;11
11169;Spragtukas;NYKŠTUKAI;9965087132;Taip;8;3;0;11
11170;Spragtukas;NYKŠTUKAI;5844437769;Taip;14;0;0;14
11171;Spragtukas;NYKŠTUKAI;2946297529;Taip;9;0;0;9
11172;Spragtukas;NYKŠTUKAI;1570206034;Taip;10;0;0;10
11173;Spragtukas;NYKŠTUKAI;9754594384;Taip;6;5;0;11
11174;Spragtukas;NYKŠTUKAI;2909322678;Taip;6;3;0;9
11175;Spragtukas;SAULUTĖ;89749837388;Taip;13;0;1;14
11176;Spragtukas;SAULUTĖ;92289435393;Taip;2;0;0;2
11177;Spragtukas;SAULUTĖ;3392224465;Taip;14;0;0;14
11178;Spragtukas;SAULUTĖ;1174566363;Taip;9;1;0;10
11179;Spragtukas;SAULUTĖ;10998123453;Taip;10;4;0;14
11180;Spragtukas;SAULUTĖ;48934106998;Taip;9;1;0;10
11181;Spragtukas;SAULUTĖ;34989165939;Ne;9;0;0;9
11182;Spragtukas;SAULUTĖ;1527719937;Taip;6;0;0;6
11183;Spragtukas;SAULUTĖ;59444737813;Taip;0;5;4;9
11184;Spragtukas;SAULUTĖ;1889153590;Taip;4;0;0;4
11185;Spragtukas;SAULUTĖ;53375921406;Ne;0;1;0;1
11186;Spragtukas;SAULUTĖ;50653432030;Taip;6;0;0;6
11187;Spragtukas;SAULUTĖ;63252513820;Taip;8;0;0;8
11188;Spragtukas;SAULUTĖ;4321780080;Taip;10;1;0;11
11189;Spragtukas;SAULUTĖ;51889437335;Taip;15;3;0;18
11190;Spragtukas;SAULUTĖ;94483480424;Taip;10;4;0;14
11191;Spragtukas;SAULUTĖ;7234682005;Taip;9;1;0;10
11192;Spragtukas;SAULUTĖ;42635888133;Taip;5;5;0;10
11193;Spragtukas;SAULUTĖ;80790750169;Taip;5;1;2;8
11194;Spragtukas;SAULUTĖ;96435499947;Taip;6;0;0;6
11195;Spragtukas;SAULUTĖ;91767288727;Taip;7;1;0;8
11196;Spragtukas;SAULUTĖ;94418271961;Taip;5;4;0;9
11197;Spragtukas;SAULUTĖ;5377198769;Taip;0;1;0;1
11198;Spragtukas;SAULUTĖ;14001343134;Taip;6;0;0;6
11199;Spragtukas;SPINDULĖLIAI;23609194808;Taip;0;0;1;1
11200;Spragtukas;SPINDULĖLIAI;61759595543;Taip;3;3;0;6
11201;Spragtukas;SPINDULĖLIAI;89128154852;Taip;0;6;0;6
11202;Spragtukas;SPINDULĖLIAI;1992644726;Taip;6;1;0;7
11203;Spragtukas;SPINDULĖLIAI;78367721963;Taip;11;0;0;11
11204;Spragtukas;SPINDULĖLIAI;67682738316;Taip;0;3;0;3
11205;Spragtukas;SPINDULĖLIAI;33470312355;Taip;1;1;0;2
11206;Spragtukas;SPINDULĖLIAI;75118912674;Taip;19;0;0;19
11207;Spragtukas;SPINDULĖLIAI;18431696631;Taip;0;0;3;3
11208;Spragtukas;SPINDULĖLIAI;7036136306;Taip;0;2;1;3
11209;Spragtukas;SPINDULĖLIAI;88682218237;Taip;5;1;0;6
11210;Spragtukas;SPINDULĖLIAI;56973077439;Taip;0;2;3;5
11211;Spragtukas;SPINDULĖLIAI;19772337903;Taip;15;0;0;15
11212;Spragtukas;SPINDULĖLIAI;84255109367;Taip;9;1;0;10
11213;Spragtukas;SPINDULĖLIAI;73746856181;Taip;5;1;0;6
11214;Spragtukas;SPINDULĖLIAI;25586950966;Taip;19;0;0;19
11215;Spragtukas;SPINDULĖLIAI;64816442697;Taip;4;0;1;5
11216;Spragtukas;SPINDULĖLIAI;67746615170;Taip;0;3;0;3
11217;Spragtukas;SPINDULĖLIAI;22707134829;Taip;0;4;0;4
11218;Spragtukas;SPINDULĖLIAI;54800087274;Taip;10;0;0;10
11219;Spragtukas;SPINDULĖLIAI;60622170765;Taip;0;3;0;3
11220;Spragtukas;SPINDULĖLIAI;71104002732;Taip;5;12;0;17
11221;Spragtukas;GINTARĖLIAI;96995930924;Taip;12;0;0;12
11222;Spragtukas;GINTARĖLIAI;42746731488;Taip;0;17;0;17
11223;Spragtukas;GINTARĖLIAI;38858500522;Taip;0;2;0;2
11224;Spragtukas;GINTARĖLIAI;1437794402;Taip;9;4;0;13
11225;Spragtukas;GINTARĖLIAI;60731415960;Taip;5;9;0;14
11226;Spragtukas;GINTARĖLIAI;29398129736;Taip;5;1;0;6
11227;Spragtukas;GINTARĖLIAI;37209001618;Taip;0;1;0;1
11228;Spragtukas;GINTARĖLIAI;82498261158;Taip;0;2;0;2
11229;Spragtukas;GINTARĖLIAI;32290835176;Taip;0;11;0;11
11230;Spragtukas;GINTARĖLIAI;68059396649;Taip;0;7;0;7
11231;Spragtukas;GINTARĖLIAI;39962240237;Taip;5;0;0;5
11232;Spragtukas;GINTARĖLIAI;49941944569;Taip;0;3;0;3
11233;Spragtukas;GINTARĖLIAI;40971977434;Taip;6;0;6;12
11234;Spragtukas;GINTARĖLIAI;81928765016;Taip;7;0;0;7
11235;Spragtukas;GINTARĖLIAI;1035579583;Taip;0;5;0;5
11236;Spragtukas;GINTARĖLIAI;8554047390;Taip;13;2;0;15
11237;Spragtukas;GINTARĖLIAI;16927181370;Taip;5;9;0;14
11238;Spragtukas;ČIPOLINO;2371848091;Taip;0;14;0;14
11239;Spragtukas;ČIPOLINO;6582680700;Taip;16;2;0;18
11240;Spragtukas;ČIPOLINO;1599958343;Taip;2;3;0;5
11241;Spragtukas;ČIPOLINO;1547670082;Taip;0;5;0;5
11242;Spragtukas;ČIPOLINO;7504632314;Taip;0;1;0;1
11243;Spragtukas;ČIPOLINO;1597988501;Taip;5;0;0;5
11244;Spragtukas;ČIPOLINO;6526633051;Taip;0;3;0;3
11245;Spragtukas;ČIPOLINO;1058970799;Taip;11;3;0;14
11246;Spragtukas;ČIPOLINO;45661532130;Taip;0;6;0;6
11247;Spragtukas;ČIPOLINO;3045382299;Taip;0;5;0;5
11248;Spragtukas;ČIPOLINO;7640805299;Taip;0;4;0;4
11249;Spragtukas;ČIPOLINO;1365907314;Taip;11;5;0;16
11250;Spragtukas;ČIPOLINO;4941531443;Taip;11;5;0;16
11251;Spragtukas;ČIPOLINO;3566797064;Taip;5;3;0;8
11252;Spragtukas;ČIPOLINO;1827458781;Taip;3;4;0;7
11253;Spragtukas;ČIPOLINO;3798118695;Taip;0;19;0;19
11254;Spragtukas;ČIPOLINO;69114720307;Taip;5;0;0;5
11255;Spragtukas;ČIPOLINO;9789977863;Taip;10;0;0;10
11256;Spragtukas;BORUŽĖLĖS;2063156696;Taip;0;4;0;4
11257;Spragtukas;BORUŽĖLĖS;6729635545;Taip;13;1;0;14
11258;Spragtukas;BORUŽĖLĖS;1615068173;Taip;5;3;0;8
11259;Spragtukas;BORUŽĖLĖS;90741594830;Taip;9;0;0;9
11260;Spragtukas;BORUŽĖLĖS;87500842251;Taip;0;0;7;7
11261;Spragtukas;BORUŽĖLĖS;9962282406;Ne;9;2;0;11
11262;Spragtukas;BORUŽĖLĖS;91568484446;Taip;0;10;0;10
11263;Spragtukas;BORUŽĖLĖS;1701035826;Ne;6;2;0;8
11264;Spragtukas;BORUŽĖLĖS;4513335615;Taip;7;1;0;8
11265;Spragtukas;BORUŽĖLĖS;69086864157;Taip;11;0;0;11
11266;Spragtukas;BORUŽĖLĖS;2449454986;Taip;0;5;0;5
11267;Spragtukas;BORUŽĖLĖS;8415429693;Taip;0;15;0;15
11268;Spragtukas;DRUGELIAI;1190479265;Taip;5;0;0;5
11269;Spragtukas;DRUGELIAI;8673799897;Taip;10;1;0;11
11270;Spragtukas;DRUGELIAI;58491995121;Taip;5;0;0;5
11271;Spragtukas;DRUGELIAI;1570209659;Taip;0;2;0;2
11272;Spragtukas;DRUGELIAI;58366763944;Taip;1;0;0;1
11273;Spragtukas;DRUGELIAI;1212579682;Taip;1;0;2;3
11274;Spragtukas;DRUGELIAI;1082350468;Taip;10;0;1;11
11275;Spragtukas;DRUGELIAI;1668434690;Taip;10;0;0;10
11276;Spragtukas;DRUGELIAI;2086501624;Taip;5;0;0;5
11277;Spragtukas;DRUGELIAI;1035631190;Taip;0;9;0;9
11278;Spragtukas;DRUGELIAI;1751370218;Taip;0;0;1;1
11279;Spragtukas;DRUGELIAI;5765613911;Taip;0;1;0;1
11280;Spragtukas;DRUGELIAI;3508228828;Taip;10;0;2;12
11281;Spragtukas;DRUGELIAI;1315478099;Taip;6;1;0;7
11282;Spragtukas;DRUGELIAI;1779321635;Taip;5;0;0;5
11283;Spragtukas;DRUGELIAI;1482801139;Taip;0;0;2;2
11284;Spragtukas;DRUGELIAI;4542067558;Taip;2;0;0;2
11285;Spragtukas;DRUGELIAI;1400542296;Taip;4;0;0;4
11286;Spragtukas;DRUGELIAI;1130377645;Taip;0;3;0;3
11287;Spragtukas;DRUGELIAI;8516003036;Taip;0;2;0;2
11288;Spragtukas;DRUGELIAI;3181801668;Taip;6;1;0;7
11289;Spragtukas;DRUGELIAI;8826099483;Taip;4;0;0;4
11290;Spragtukas;GAIDELIAI;7569802487;Taip;0;2;0;2
11291;Spragtukas;GAIDELIAI;71081903240;Taip;10;2;0;12
11292;Spragtukas;GAIDELIAI;1305123801;Taip;0;2;0;2
11293;Spragtukas;GAIDELIAI;79237309377;Taip;0;2;0;2
11294;Spragtukas;GAIDELIAI;54099559107;Taip;0;4;0;4
11295;Spragtukas;GAIDELIAI;19453957982;Taip;11;1;0;12
11296;Spragtukas;GAIDELIAI;1203266608;Taip;4;0;0;4
11297;Spragtukas;GAIDELIAI;11849369985;Taip;9;1;0;10
11298;Spragtukas;GAIDELIAI;2042294168;Taip;0;3;0;3
11299;Spragtukas;GAIDELIAI;1030566027;Taip;10;0;0;10
11300;Spragtukas;GAIDELIAI;78296815539;Taip;3;3;0;6
11301;Spragtukas;GAIDELIAI;8150653485;Taip;1;7;0;8
11302;Spragtukas;GAIDELIAI;1247838976;Taip;11;1;0;12
11303;Spragtukas;GAIDELIAI;2061441977;Taip;3;0;0;3
11304;Spragtukas;GAIDELIAI;2848207417;Taip;8;0;0;8
11305;Spragtukas;GAIDELIAI;1210698072;Taip;3;0;0;3
11306;Spragtukas;GAIDELIAI;1070119148;Taip;11;4;0;15
11307;Spragtukas;GAIDELIAI;9235972927;Taip;5;1;0;6
11308;Spragtukas;ŽUVELĖS;32858776091;Taip;14;0;0;14
11309;Spragtukas;ŽUVELĖS;91794949460;Taip;11;0;0;11
11310;Spragtukas;ŽUVELĖS;2118272247;Taip;11;1;0;12
11311;Spragtukas;ŽUVELĖS;46794033116;Taip;11;1;0;12
11312;Spragtukas;ŽUVELĖS;1418494757;Taip;5;0;0;5
11313;Spragtukas;ŽUVELĖS;60980580078;Taip;10;4;0;14
11314;Spragtukas;ŽUVELĖS;82801263312;Taip;10;0;0;10
11315;Spragtukas;ŽUVELĖS;56384144331;Taip;0;5;0;5
11316;Spragtukas;ŽUVELĖS;2032107153;Taip;8;1;0;9
11317;Spragtukas;ŽUVELĖS;20279570129;Taip;8;1;0;9
11318;Spragtukas;ŽUVELĖS;19580966465;Taip;0;1;0;1
11319;Spragtukas;ŽUVELĖS;1731215395;Taip;5;1;0;6
11320;Spragtukas;ŽUVELĖS;1138975383;Taip;3;0;0;3
11321;Spragtukas;ŽUVELĖS;67679737675;Taip;0;1;1;2
11322;Spragtukas;ŽUVELĖS;1953368351;Taip;7;1;0;8
11323;Spragtukas;ŽUVELĖS;271958429;Taip;14;0;0;14
11324;Spragtukas;ŽUVELĖS;1030688447;Taip;11;0;0;11
11325;Spragtukas;ŽUVELĖS;1883944064;Taip;10;10;0;20
11326;Spragtukas;ŽUVELĖS;99915428485;Taip;6;0;0;6
11327;Spragtukas;ŽUVELĖS;41147623084;Taip;0;9;0;9
11328;Spragtukas;ŽUVELĖS;22025568463;Taip;12;0;0;12
11329;Spragtukas;ŽUVELĖS;1491147348;Taip;0;6;0;6
11330;Spragtukas;ŽUVELĖS;38120721944;Taip;0;4;0;4
11331;Spragtukas;RIEŠUTĖLIAI;8444759709;Taip;6;1;0;7
11332;Spragtukas;RIEŠUTĖLIAI;8463747761;Taip;9;1;0;10
11333;Spragtukas;RIEŠUTĖLIAI;6800727630;Taip;0;1;0;1
11334;Spragtukas;RIEŠUTĖLIAI;4131998934;Taip;4;10;0;14
11335;Spragtukas;RIEŠUTĖLIAI;1690400583;Taip;5;1;2;8
11336;Spragtukas;RIEŠUTĖLIAI;6419503965;Taip;10;2;0;12
11337;Spragtukas;RIEŠUTĖLIAI;8246512283;Taip;0;10;0;10
11338;Spragtukas;RIEŠUTĖLIAI;1627243902;Taip;15;5;0;20
11339;Spragtukas;RIEŠUTĖLIAI;1326603216;Taip;5;0;0;5
11340;Spragtukas;RIEŠUTĖLIAI;72636559695;Taip;5;0;0;5
11341;Spragtukas;RIEŠUTĖLIAI;6573750143;Taip;0;4;0;4
11342;Spragtukas;RIEŠUTĖLIAI;5306883933;Taip;5;0;0;5
11343;Spragtukas;RIEŠUTĖLIAI;3654640843;Taip;9;0;0;9
11344;Spragtukas;RIEŠUTĖLIAI;1849644444;Taip;6;0;0;6
11345;Spragtukas;RIEŠUTĖLIAI;9045185920;Taip;11;7;0;18
11346;Spragtukas;RIEŠUTĖLIAI;1800927281;Taip;11;1;0;12
11347;Spragtukas;RIEŠUTĖLIAI;1514277186;Taip;6;0;0;6
11348;Spragtukas;RIEŠUTĖLIAI;4427123314;Taip;15;0;0;15
11349;Spragtukas;RIEŠUTĖLIAI;6322121173;Taip;6;4;0;10
11350;Spragtukas;RIEŠUTĖLIAI;3113106252;Taip;0;1;0;1
11351;Spragtukas;RIEŠUTĖLIAI;9314811354;Taip;13;6;0;19
11352;Spragtukas;VIŠČIUKAI;8429135626;Taip;0;11;0;11
11353;Spragtukas;VIŠČIUKAI;2356476212;Taip;10;0;0;10
11354;Spragtukas;VIŠČIUKAI;7070881522;Taip;14;2;0;16
11355;Spragtukas;VIŠČIUKAI;8652973900;Taip;19;0;0;19
11356;Spragtukas;VIŠČIUKAI;4527798635;Taip;11;0;1;12
11357;Spragtukas;VIŠČIUKAI;3261213140;Taip;5;2;1;8
11358;Spragtukas;VIŠČIUKAI;8623311748;Taip;14;0;1;15
11359;Spragtukas;VIŠČIUKAI;2943832694;Taip;5;0;0;5
11360;Spragtukas;VIŠČIUKAI;8460527225;Taip;10;0;0;10
11361;Spragtukas;VIŠČIUKAI;8297700739;Taip;20;0;0;20
11362;Spragtukas;VIŠČIUKAI;9595221494;Taip;12;2;0;14
11363;Spragtukas;VIŠČIUKAI;6185016824;Taip;11;3;0;14
11364;Spragtukas;VIŠČIUKAI;8715073512;Taip;9;0;0;9
11365;Spragtukas;VIŠČIUKAI;6162830167;Taip;14;2;4;20
11366;Spragtukas;VIŠČIUKAI;5150028968;Taip;16;0;0;16
11367;Spragtukas;VIŠČIUKAI;5689392663;Taip;8;0;0;8
11368;Spragtukas;VIŠČIUKAI;9805841777;Taip;4;0;0;4
11369;Spragtukas;MEŠKIUKAI;4669257062;Taip;2;2;0;4
11370;Spragtukas;MEŠKIUKAI;9592271053;Taip;16;0;0;16
11371;Spragtukas;MEŠKIUKAI;3968434618;Taip;2;3;0;5
11372;Spragtukas;MEŠKIUKAI;1150727381;Taip;13;2;0;15
11373;Spragtukas;MEŠKIUKAI;9191831532;Taip;6;1;2;9
11374;Spragtukas;MEŠKIUKAI;1272075883;Taip;0;1;0;1
11375;Spragtukas;MEŠKIUKAI;6465991136;Taip;0;4;0;4
11376;Spragtukas;MEŠKIUKAI;9282940430;Taip;5;4;0;9
11377;Spragtukas;MEŠKIUKAI;6503842956;Taip;6;1;0;7
11378;Spragtukas;MEŠKIUKAI;2578400770;Taip;0;1;0;1
11379;Spragtukas;MEŠKIUKAI;3189741449;Taip;6;1;0;7
11380;Spragtukas;MEŠKIUKAI;4344537391;Taip;18;0;0;18
11381;Spragtukas;MEŠKIUKAI;6757604305;Taip;17;0;0;17
11382;Spragtukas;MEŠKIUKAI;2076126173;Taip;15;1;0;16
11383;Spragtukas;MEŠKIUKAI;7859959104;Taip;5;2;0;7
11384;Spragtukas;MEŠKIUKAI;4548945364;Taip;14;1;0;15
11385;Strazdelis;Žiogelių;59969322783;Taip;0;1;0;1
11386;Strazdelis;Žiogelių;48052363003;Taip;5;2;0;7
11387;Strazdelis;Žiogelių;12739940649;Taip;0;2;0;2
11388;Strazdelis;Žiogelių;79443961061;Taip;0;9;0;9
11389;Strazdelis;Žiogelių;81910819903;Taip;9;0;0;9
11390;Strazdelis;Žiogelių;84548133061;Taip;8;4;0;12
11391;Strazdelis;Žiogelių;4013389618;Ne;0;1;0;1
11392;Strazdelis;Žiogelių;5449465531;Taip;6;1;0;7
11393;Strazdelis;Žiogelių;57514782479;Taip;10;5;0;15
11394;Strazdelis;Žiogelių;53114476996;Taip;0;2;0;2
11395;Strazdelis;Žiogelių;50984917126;Taip;0;7;0;7
11396;Strazdelis;Žiogelių;43128715501;Taip;16;0;0;16
11397;Strazdelis;Žiogelių;1058210612;Taip;0;0;1;1
11398;Strazdelis;Žiogelių;85877157333;Taip;8;2;0;10
11399;Strazdelis;Žiogelių;2110092578;Taip;9;0;0;9
11400;Strazdelis;Žiogelių;90936509570;Taip;13;0;0;13
11401;Strazdelis;Žiogelių;64076729200;Taip;8;7;0;15
11402;Strazdelis;Žiogelių;1858519255;Taip;20;0;0;20
11403;Strazdelis;Žiogelių;20845810823;Taip;4;4;0;8
11404;Strazdelis;Žiogelių;98433672584;Taip;11;0;0;11
11405;Strazdelis;Žiogelių;2086723106;Taip;11;0;0;11
11406;Strazdelis;Žiogelių;20510560289;Taip;4;0;0;4
11407;Strazdelis;Šeimynėlės;3662217925;Taip;0;0;1;1
11408;Strazdelis;Šeimynėlės;4698566091;Taip;0;2;0;2
11409;Strazdelis;Šeimynėlės;8274897977;Taip;18;0;0;18
11410;Strazdelis;Šeimynėlės;45083023033;Taip;6;2;0;8
11411;Strazdelis;Šeimynėlės;5698472204;Taip;0;3;0;3
11412;Strazdelis;Šeimynėlės;29586826889;Taip;10;1;0;11
11413;Strazdelis;Šeimynėlės;6528024720;Taip;0;1;0;1
11414;Strazdelis;Šeimynėlės;9672736975;Taip;8;2;3;13
11415;Strazdelis;Šeimynėlės;43314069648;Taip;0;6;0;6
11416;Strazdelis;Šeimynėlės;4697537943;Taip;11;0;0;11
11417;Strazdelis;Šeimynėlės;9835716116;Taip;9;3;0;12
11418;Strazdelis;Šeimynėlės;3943578036;Taip;12;1;0;13
11419;Strazdelis;Šeimynėlės;2802486859;Taip;0;3;0;3
11420;Strazdelis;Šeimynėlės;4791752179;Taip;0;7;0;7
11421;Strazdelis;Šeimynėlės;7215063033;Taip;9;5;0;14
11422;Strazdelis;Šeimynėlės;7149827850;Taip;6;1;0;7
11423;Strazdelis;Šeimynėlės;1665134387;Taip;10;10;0;20
11424;Strazdelis;Šeimynėlės;1481671624;Taip;9;5;0;14
11425;Strazdelis;Šeimynėlės;6014213362;Taip;14;2;0;16
11426;Strazdelis;Genelio;7216768880;Taip;5;6;0;11
11427;Strazdelis;Genelio;7120717682;Taip;0;4;0;4
11428;Strazdelis;Genelio;50350281905;Taip;7;4;0;11
11429;Strazdelis;Genelio;1187534672;Taip;5;1;0;6
11430;Strazdelis;Genelio;9198429790;Taip;0;1;0;1
11431;Strazdelis;Genelio;2871673641;Taip;15;3;0;18
11432;Strazdelis;Genelio;6147183190;Taip;17;3;0;20
11433;Strazdelis;Genelio;2078150337;Taip;20;0;0;20
11434;Strazdelis;Genelio;1362428967;Taip;5;1;0;6
11435;Strazdelis;Genelio;8801420992;Taip;0;11;0;11
11436;Strazdelis;Genelio;8634815556;Taip;0;3;0;3
11437;Strazdelis;Genelio;9904719582;Taip;11;0;0;11
11438;Strazdelis;Genelio;7308925265;Taip;20;0;0;20
11439;Strazdelis;Genelio;4655931716;Taip;19;0;0;19
11440;Strazdelis;Genelio;8182994112;Taip;2;0;0;2
11441;Strazdelis;Genelio;5371939820;Taip;0;1;0;1
11442;Strazdelis;Genelio;68605763183;Taip;20;0;0;20
11443;Strazdelis;Vikruolių;58844235230;Taip;0;4;0;4
11444;Strazdelis;Vikruolių;7549142768;Ne;14;1;0;15
11445;Strazdelis;Vikruolių;62366722408;Taip;7;2;1;10
11446;Strazdelis;Vikruolių;98620402347;Taip;2;0;0;2
11447;Strazdelis;Vikruolių;79337959137;Taip;1;10;0;11
11448;Strazdelis;Vikruolių;56331124076;Taip;7;0;0;7
11449;Strazdelis;Vikruolių;14923406397;Taip;15;0;0;15
11450;Strazdelis;Vikruolių;70999059743;Taip;0;1;0;1
11451;Strazdelis;Vikruolių;33107603963;Ne;1;2;1;4
11452;Strazdelis;Vikruolių;29094108735;Taip;0;3;0;3
11453;Strazdelis;Vikruolių;1952649844;Taip;8;1;0;9
11454;Strazdelis;Vikruolių;75235370334;Taip;1;2;0;3
11455;Strazdelis;Vikruolių;42180634251;Taip;0;7;0;7
11456;Strazdelis;Vikruolių;54028832658;Taip;5;0;0;5
11457;Strazdelis;Vikruolių;30372050952;Taip;6;2;0;8
11458;Strazdelis;Vikruolių;39915650220;Ne;0;6;0;6
11459;Strazdelis;Vikruolių;3292943291;Taip;1;8;0;9
11460;Strazdelis;Vikruolių;75528880272;Taip;11;2;0;13
11461;Strazdelis;Vikruolių;97790033745;Taip;1;2;0;3
11462;Strazdelis;Vikruolių;96227697952;Taip;1;3;0;4
11463;Strazdelis;Vikruolių;83264226550;Taip;6;1;0;7
11464;Strazdelis;Vyturėlių;89976183528;Taip;7;6;0;13
11465;Strazdelis;Vyturėlių;67195412172;Taip;5;0;0;5
11466;Strazdelis;Vyturėlių;19182710913;Taip;9;0;0;9
11467;Strazdelis;Vyturėlių;52370891798;Taip;18;0;0;18
11468;Strazdelis;Vyturėlių;21075820140;Taip;15;0;0;15
11469;Strazdelis;Vyturėlių;88801862582;Taip;4;1;0;5
11470;Strazdelis;Vyturėlių;33675356631;Ne;5;0;0;5
11471;Strazdelis;Vyturėlių;95176636771;Taip;6;1;0;7
11472;Strazdelis;Vyturėlių;71377546049;Taip;7;1;0;8
11473;Strazdelis;Vyturėlių;1499287166;Taip;11;0;0;11
11474;Strazdelis;Vyturėlių;66353793576;Taip;0;3;2;5
11475;Strazdelis;Vyturėlių;38843113574;Taip;0;1;0;1
11476;Strazdelis;Vyturėlių;39525751316;Taip;5;1;0;6
11477;Strazdelis;Vyturėlių;24240557041;Taip;0;8;0;8
11478;Strazdelis;Vyturėlių;26311407354;Taip;10;0;0;10
11479;Strazdelis;Vyturėlių;60144664935;Taip;9;0;0;9
11480;Strazdelis;Vyturėlių;53302522911;Taip;3;2;0;5
11481;Strazdelis;Vyturėlių;1888068247;Taip;3;5;0;8
11482;Strazdelis;Vyturėlių;1347273712;Taip;9;3;0;12
11483;Strazdelis;Vyturėlių;1611711233;Taip;15;0;0;15
11484;Strazdelis;Vyturėlių;20384116848;Taip;16;1;0;17
11485;Strazdelis;Vyturėlių;41690491541;Taip;7;1;0;8
11486;Strazdelis;Vyturėlių;62150824334;Taip;0;1;0;1
11487;Strazdelis;Vyturėlių;3320884603;Taip;6;5;0;11
11488;Strazdelis;Varpelio;43722400626;Taip;1;6;0;7
11489;Strazdelis;Varpelio;39502125227;Taip;5;2;0;7
11490;Strazdelis;Varpelio;2502465398;Taip;1;5;0;6
11491;Strazdelis;Varpelio;83919699672;Taip;5;1;0;6
11492;Strazdelis;Varpelio;1426195737;Taip;0;12;0;12
11493;Strazdelis;Varpelio;86957187003;Taip;0;15;0;15
11494;Strazdelis;Varpelio;52211473547;Taip;0;5;0;5
11495;Strazdelis;Varpelio;98553857685;Taip;4;1;0;5
11496;Strazdelis;Varpelio;54646720821;Taip;11;0;0;11
11497;Strazdelis;Varpelio;62063592887;Taip;0;2;0;2
11498;Strazdelis;Varpelio;95260832237;Taip;7;0;0;7
11499;Strazdelis;Varpelio;47899514138;Taip;0;3;0;3
11500;Strazdelis;Varpelio;3636163418;Taip;5;0;0;5
11501;Strazdelis;Varpelio;17045991832;Taip;16;0;0;16
11502;Strazdelis;Varpelio;58143176237;Taip;5;0;0;5
11503;Strazdelis;Varpelio;58440671129;Taip;8;4;0;12
11504;Strazdelis;Varpelio;1785962711;Taip;9;2;0;11
11505;Strazdelis;Varpelio;98818869900;Taip;0;2;0;2
11506;Strazdelis;Varpelio;1535288878;Taip;1;5;0;6
11507;Strazdelis;Varpelio;49277241025;Taip;8;2;0;10
11508;Strazdelis;Varpelio;1707225898;Taip;1;8;0;9
11509;Strazdelis;Pelėdžiukų;13220421668;Taip;5;4;0;9
11510;Strazdelis;Pelėdžiukų;13625184061;Taip;5;5;0;10
11511;Strazdelis;Pelėdžiukų;73711363249;Taip;5;0;0;5
11512;Strazdelis;Pelėdžiukų;66197587093;Taip;1;4;0;5
11513;Strazdelis;Pelėdžiukų;62754553467;Taip;3;4;0;7
11514;Strazdelis;Pelėdžiukų;16453584376;Taip;14;1;0;15
11515;Strazdelis;Pelėdžiukų;72069723016;Taip;5;5;0;10
11516;Strazdelis;Pelėdžiukų;63720428545;Taip;10;9;0;19
11517;Strazdelis;Pelėdžiukų;54050062292;Taip;0;2;0;2
11518;Strazdelis;Pelėdžiukų;44566447637;Taip;0;1;0;1
11519;Strazdelis;Pelėdžiukų;64675347442;Taip;0;2;0;2
11520;Strazdelis;Pelėdžiukų;18595696353;Taip;14;0;0;14
11521;Strazdelis;Pelėdžiukų;23371576969;Ne;14;1;0;15
11522;Strazdelis;Pelėdžiukų;87689168341;Taip;0;5;0;5
11523;Strazdelis;Pelėdžiukų;23376659452;Taip;0;2;0;2
11524;Strazdelis;Pelėdžiukų;56012252629;Taip;19;0;0;19
11525;Strazdelis;Pelėdžiukų;77589342371;Taip;5;2;0;7
11526;Strazdelis;Pelėdžiukų;91962766970;Taip;0;2;0;2
11527;Strazdelis;Pelėdžiukų;52790577750;Taip;14;0;0;14
11528;Strazdelis;Pelėdžiukų;1140100663;Taip;10;0;0;10
11529;Strazdelis;Saulutės;1693309238;Taip;3;11;0;14
11530;Strazdelis;Saulutės;27177757900;Taip;5;5;0;10
11531;Strazdelis;Saulutės;40932140069;Taip;6;2;0;8
11532;Strazdelis;Saulutės;1523471662;Taip;7;12;0;19
11533;Strazdelis;Saulutės;2854642875;Taip;7;1;2;10
11534;Strazdelis;Saulutės;7578229276;Taip;3;0;0;3
11535;Strazdelis;Saulutės;8808299050;Taip;3;1;0;4
11536;Strazdelis;Saulutės;6614184499;Taip;4;1;0;5
11537;Strazdelis;Saulutės;4129957131;Taip;14;1;0;15
11538;Strazdelis;Saulutės;3425430317;Taip;13;2;0;15
11539;Strazdelis;Saulutės;5059832307;Taip;2;1;0;3
11540;Strazdelis;Saulutės;7081517417;Taip;6;5;0;11
11541;Strazdelis;Saulutės;67641340859;Taip;0;1;0;1
11542;Strazdelis;Saulutės;15298412755;Taip;5;3;0;8
11543;Strazdelis;Saulutės;12713270671;Taip;11;0;0;11
11544;Strazdelis;Saulutės;6113491562;Taip;5;0;0;5
11545;Strazdelis;Saulutės;1802092125;Taip;8;2;2;12
11546;Strazdelis;Saulutės;1391009140;Taip;10;0;0;10
11547;Strazdelis;Saulutės;6779352728;Taip;14;0;0;14
11548;Strazdelis;Saulutės;29225108934;Taip;5;8;0;13
11549;Strazdelis;Bitutės;99973904527;Taip;0;4;0;4
11550;Strazdelis;Bitutės;92799934389;Taip;0;10;0;10
11551;Strazdelis;Bitutės;9065275674;Taip;14;2;0;16
11552;Strazdelis;Bitutės;33123804487;Taip;7;2;0;9
11553;Strazdelis;Bitutės;6523307315;Taip;20;0;0;20
11554;Strazdelis;Bitutės;15920566059;Taip;0;11;0;11
11555;Strazdelis;Bitutės;18222675927;Taip;0;11;0;11
11556;Strazdelis;Bitutės;47547568043;Ne;0;4;0;4
11557;Strazdelis;Bitutės;66254701944;Taip;0;12;0;12
11558;Strazdelis;Bitutės;24001445236;Taip;0;5;0;5
11559;Strazdelis;Bitutės;96062922228;Taip;0;4;0;4
11560;Strazdelis;Bitutės;34644143572;Taip;15;0;0;15
11561;Strazdelis;Bitutės;24669852216;Taip;6;1;0;7
11562;Strazdelis;Bitutės;51702469375;Taip;0;1;0;1
11563;Strazdelis;Bitutės;1073814440;Taip;5;0;0;5
11564;Strazdelis;Bitutės;59837435595;Taip;0;15;0;15
11565;Strazdelis;Bitutės;90089166514;Taip;14;0;0;14
11566;Strazdelis;Bitutės;1847755442;Taip;6;0;0;6
11567;Strazdelis;Bitutės;7812253305;Taip;5;0;0;5
11568;Strazdelis;Bitutės;61820727992;Taip;2;1;0;3
11569;Strazdelis;Bitutės;96077591556;Taip;0;1;0;1
11570;Strazdelis;Bitutės;14459771394;Taip;0;1;0;1
11571;Strazdelis;Bitutės;2673522432;Taip;17;0;0;17
11572;Strazdelis;Mažylių;1955166372;Taip;5;0;2;7
11573;Strazdelis;Mažylių;8415383526;Taip;10;5;0;15
11574;Strazdelis;Mažylių;2963535523;Taip;11;2;0;13
11575;Strazdelis;Mažylių;6931726275;Taip;10;2;0;12
11576;Strazdelis;Mažylių;6311710825;Taip;11;0;0;11
11577;Strazdelis;Mažylių;4873707286;Taip;4;4;0;8
11578;Strazdelis;Mažylių;4076266466;Taip;20;0;0;20
11579;Strazdelis;Mažylių;2824416350;Taip;0;2;4;6
11580;Strazdelis;Mažylių;3610250359;Taip;12;8;0;20
11581;Strazdelis;Mažylių;2766970956;Taip;5;1;0;6
11582;Strazdelis;Mažylių;2580733127;Taip;10;1;0;11
11583;Strazdelis;Mažylių;2662549392;Taip;0;5;0;5
11584;Strazdelis;Mažylių;9502341478;Taip;5;2;0;7
11585;Strazdelis;Mažylių;2251157025;Taip;9;0;0;9
11586;Strazdelis;Mažylių;9401101407;Taip;0;13;0;13
11587;Strazdelis;Mažylių;6527855940;Taip;10;1;0;11
11588;Strazdelis;Pabiručių;1021364759;Taip;20;0;0;20
11589;Strazdelis;Pabiručių;5580738386;Taip;3;1;0;4
11590;Strazdelis;Pabiručių;8637386316;Taip;0;2;0;2
11591;Strazdelis;Pabiručių;8287554571;Taip;5;2;0;7
11592;Strazdelis;Pabiručių;6555803164;Taip;0;3;0;3
11593;Strazdelis;Pabiručių;1704292727;Taip;14;2;0;16
11594;Strazdelis;Pabiručių;4617237063;Taip;14;2;0;16
11595;Strazdelis;Pabiručių;3036380561;Taip;14;2;0;16
11596;Strazdelis;Pabiručių;4562530311;Taip;2;4;0;6
11597;Strazdelis;Pabiručių;4448556404;Taip;11;0;0;11
11598;Strazdelis;Pabiručių;7393083827;Taip;4;4;0;8
11599;Strazdelis;Pabiručių;1901641517;Taip;20;0;0;20
11600;Strazdelis;Pabiručių;8371999002;Taip;10;1;0;11
11601;Šermukšnėlė;MOLINUKAI;68060386099;Taip;0;0;2;2
11602;Šermukšnėlė;MOLINUKAI;28007013244;Taip;0;5;0;5
11603;Šermukšnėlė;MOLINUKAI;82928987881;Taip;0;0;3;3
11604;Šermukšnėlė;MOLINUKAI;42211665091;Taip;3;1;0;4
11605;Šermukšnėlė;MOLINUKAI;77238595800;Taip;2;1;0;3
11606;Šermukšnėlė;MOLINUKAI;87315703379;Taip;15;0;0;15
11607;Šermukšnėlė;MOLINUKAI;61809452162;Taip;8;1;0;9
11608;Šermukšnėlė;MOLINUKAI;60863269031;Taip;6;3;0;9
11609;Šermukšnėlė;MOLINUKAI;31537402750;Taip;5;0;2;7
11610;Šermukšnėlė;MOLINUKAI;28087351377;Taip;0;4;0;4
11611;Šermukšnėlė;MOLINUKAI;87587621833;Taip;7;0;0;7
11612;Šermukšnėlė;MOLINUKAI;92414041480;Taip;8;0;1;9
11613;Šermukšnėlė;MOLINUKAI;63858537394;Taip;0;5;0;5
11614;Šermukšnėlė;MOLINUKAI;39534021804;Taip;15;0;0;15
11615;Šermukšnėlė;MOLINUKAI;54312555311;Taip;9;0;0;9
11616;Šermukšnėlė;MOLINUKAI;2100740973;Taip;5;3;0;8
11617;Šermukšnėlė;MOLINUKAI;3873114056;Taip;10;0;0;10
11618;Šermukšnėlė;MOLINUKAI;1561527473;Taip;0;0;2;2
11619;Šermukšnėlė;MOLINUKAI;1738008915;Taip;5;6;0;11
11620;Šermukšnėlė;ŠIAUDINUKAI;85959255744;Taip;0;4;0;4
11621;Šermukšnėlė;ŠIAUDINUKAI;29600546074;Taip;5;2;0;7
11622;Šermukšnėlė;ŠIAUDINUKAI;61916462777;Taip;2;5;0;7
11623;Šermukšnėlė;ŠIAUDINUKAI;40455970268;Taip;0;1;0;1
11624;Šermukšnėlė;ŠIAUDINUKAI;60939430598;Taip;8;1;0;9
11625;Šermukšnėlė;ŠIAUDINUKAI;95999386401;Taip;0;7;0;7
11626;Šermukšnėlė;ŠIAUDINUKAI;26710222684;Taip;9;5;0;14
11627;Šermukšnėlė;ŠIAUDINUKAI;34526101469;Taip;0;8;0;8
11628;Šermukšnėlė;ŠIAUDINUKAI;2734502079;Taip;5;4;0;9
11629;Šermukšnėlė;ŠIAUDINUKAI;27112465050;Taip;5;5;0;10
11630;Šermukšnėlė;ŠIAUDINUKAI;33885733234;Taip;0;2;0;2
11631;Šermukšnėlė;ŠIAUDINUKAI;80780535536;Taip;0;5;0;5
11632;Šermukšnėlė;ŠIAUDINUKAI;4487587228;Taip;0;6;0;6
11633;Šermukšnėlė;ŠIAUDINUKAI;18100145020;Taip;9;5;0;14
11634;Šermukšnėlė;ŠIAUDINUKAI;63943361071;Taip;0;15;0;15
11635;Šermukšnėlė;ŠIAUDINUKAI;16859553972;Taip;0;9;0;9
11636;Šermukšnėlė;ŠIAUDINUKAI;32403224788;Taip;5;1;0;6
11637;Šermukšnėlė;ŠIAUDINUKAI;99444734331;Taip;0;0;2;2
11638;Šermukšnėlė;ŠIAUDINUKAI;3851927973;Taip;11;0;2;13
11639;Šermukšnėlė;TOŠINUKAI;8648722780;Taip;0;3;0;3
11640;Šermukšnėlė;TOŠINUKAI;10371439347;Taip;5;4;0;9
11641;Šermukšnėlė;TOŠINUKAI;53558901565;Taip;0;3;3;6
11642;Šermukšnėlė;TOŠINUKAI;5263529062;Taip;0;9;0;9
11643;Šermukšnėlė;TOŠINUKAI;70200454607;Taip;1;0;0;1
11644;Šermukšnėlė;TOŠINUKAI;91969292233;Taip;11;0;1;12
11645;Šermukšnėlė;TOŠINUKAI;1290319484;Taip;0;9;0;9
11646;Šermukšnėlė;TOŠINUKAI;1636627303;Taip;7;0;1;8
11647;Šermukšnėlė;TOŠINUKAI;1846720859;Taip;6;0;0;6
11648;Šermukšnėlė;TOŠINUKAI;51058072005;Taip;3;2;0;5
11649;Šermukšnėlė;TOŠINUKAI;2137141949;Taip;10;1;0;11
11650;Šermukšnėlė;TOŠINUKAI;1858862320;Taip;20;0;0;20
11651;Šermukšnėlė;TOŠINUKAI;1016403317;Taip;8;0;0;8
11652;Šermukšnėlė;TOŠINUKAI;42127117636;Taip;0;0;1;1
11653;Šermukšnėlė;TOŠINUKAI;2477657052;Taip;5;0;0;5
11654;Šermukšnėlė;TOŠINUKAI;85018940292;Taip;16;0;1;17
11655;Šermukšnėlė;ODINUKAI;9132691512;Taip;0;1;2;3
11656;Šermukšnėlė;ODINUKAI;33974692298;Taip;5;0;0;5
11657;Šermukšnėlė;ODINUKAI;41864110754;Taip;0;3;0;3
11658;Šermukšnėlė;ODINUKAI;33749192545;Taip;0;5;2;7
11659;Šermukšnėlė;ODINUKAI;52024313118;Taip;0;1;0;1
11660;Šermukšnėlė;ODINUKAI;56169221671;Taip;11;1;0;12
11661;Šermukšnėlė;ODINUKAI;17772742478;Taip;8;1;0;9
11662;Šermukšnėlė;ODINUKAI;74932757076;Taip;13;2;0;15
11663;Šermukšnėlė;ODINUKAI;42759782885;Taip;4;0;0;4
11664;Šermukšnėlė;ODINUKAI;29953350731;Taip;0;4;0;4
11665;Šermukšnėlė;ODINUKAI;72671813439;Taip;0;6;0;6
11666;Šermukšnėlė;ODINUKAI;87510707958;Taip;0;5;0;5
11667;Šermukšnėlė;ODINUKAI;12208634069;Taip;8;1;0;9
11668;Šermukšnėlė;ODINUKAI;54578226695;Taip;11;0;1;12
11669;Šermukšnėlė;ODINUKAI;29671788305;Taip;0;4;1;5
11670;Šermukšnėlė;ODINUKAI;89495591163;Taip;14;1;0;15
11671;Šermukšnėlė;ODINUKAI;53753895760;Taip;0;2;0;2
11672;Šermukšnėlė;ODINUKAI;1911285078;Taip;0;12;1;13
11673;Šermukšnėlė;KRIAUKLELĖS;98850511500;Taip;0;8;0;8
11674;Šermukšnėlė;KRIAUKLELĖS;26775257484;Taip;8;7;0;15
11675;Šermukšnėlė;KRIAUKLELĖS;88079185483;Taip;20;0;0;20
11676;Šermukšnėlė;KRIAUKLELĖS;80349025945;Taip;13;0;2;15
11677;Šermukšnėlė;KRIAUKLELĖS;2561033248;Taip;7;8;0;15
11678;Šermukšnėlė;KRIAUKLELĖS;48653098796;Taip;0;7;0;7
11679;Šermukšnėlė;KRIAUKLELĖS;8123096990;Taip;0;1;0;1
11680;Šermukšnėlė;KRIAUKLELĖS;82028252228;Taip;15;0;0;15
11681;Šermukšnėlė;KRIAUKLELĖS;1110375562;Taip;0;13;0;13
11682;Šermukšnėlė;KRIAUKLELĖS;23434568160;Taip;0;1;0;1
11683;Šermukšnėlė;KRIAUKLELĖS;1562494176;Taip;0;9;0;9
11684;Šermukšnėlė;KRIAUKLELĖS;3543061360;Taip;9;6;0;15
11685;Šermukšnėlė;KRIAUKLELĖS;6896990721;Taip;5;0;0;5
11686;Šermukšnėlė;KRIAUKLELĖS;7564745299;Taip;5;8;0;13
11687;Šermukšnėlė;KRIAUKLELĖS;6937555692;Taip;3;0;0;3
11688;Šermukšnėlė;KRIAUKLELĖS;9617044855;Taip;0;12;0;12
11689;Šermukšnėlė;KRIAUKLELĖS;1902848560;Taip;9;0;0;9
11690;Šermukšnėlė;VYTINUKAI;4601810772;Taip;5;6;0;11
11691;Šermukšnėlė;VYTINUKAI;97906920174;Taip;1;0;1;2
11692;Šermukšnėlė;VYTINUKAI;1523361932;Taip;0;0;2;2
11693;Šermukšnėlė;VYTINUKAI;8531953934;Taip;11;0;1;12
11694;Šermukšnėlė;VYTINUKAI;25189813939;Taip;14;0;0;14
11695;Šermukšnėlė;VYTINUKAI;33936407625;Taip;7;0;0;7
11696;Šermukšnėlė;VYTINUKAI;83123267733;Taip;1;10;0;11
11697;Šermukšnėlė;VYTINUKAI;20028832329;Taip;0;9;0;9
11698;Šermukšnėlė;VYTINUKAI;8498288021;Taip;6;4;0;10
11699;Šermukšnėlė;VYTINUKAI;5905000902;Taip;2;0;0;2
11700;Šermukšnėlė;VYTINUKAI;6291531570;Taip;5;0;0;5
11701;Šermukšnėlė;VYTINUKAI;8398961969;Taip;1;0;3;4
11702;Šermukšnėlė;VYTINUKAI;1244964311;Taip;15;0;0;15
11703;Šermukšnėlė;VYTINUKAI;83882579952;Taip;6;4;0;10
11704;Šermukšnėlė;VYTINUKAI;60840526220;Taip;6;1;1;8
11705;Šermukšnėlė;VYTINUKAI;8610668395;Taip;10;1;0;11
11706;Šermukšnėlė;VYTINUKAI;1025787925;Taip;0;3;3;6
11707;Šermukšnėlė;VYTINUKAI;1519623099;Taip;2;1;2;5
11708;Šermukšnėlė;GINTARĖLIAI;3147809450;Taip;5;0;0;5
11709;Šermukšnėlė;GINTARĖLIAI;1167696952;Taip;5;0;3;8
11710;Šermukšnėlė;GINTARĖLIAI;85062380771;Taip;14;0;0;14
11711;Šermukšnėlė;GINTARĖLIAI;35389950541;Taip;0;16;0;16
11712;Šermukšnėlė;GINTARĖLIAI;82240400954;Taip;0;5;2;7
11713;Šermukšnėlė;GINTARĖLIAI;1944687724;Taip;11;0;0;11
11714;Šermukšnėlė;GINTARĖLIAI;1013698297;Taip;11;0;0;11
11715;Šermukšnėlė;GINTARĖLIAI;2094932013;Taip;12;0;3;15
11716;Šermukšnėlė;GINTARĖLIAI;1853346049;Taip;14;0;0;14
11717;Šermukšnėlė;GINTARĖLIAI;1851549466;Taip;4;0;1;5
11718;Šermukšnėlė;GINTARĖLIAI;1521544270;Taip;0;0;1;1
11719;Šermukšnėlė;GINTARĖLIAI;3697936074;Taip;20;0;0;20
11720;Šermukšnėlė;GINTARĖLIAI;2686950289;Taip;14;1;0;15
11721;Šermukšnėlė;GINTARĖLIAI;27183547828;Taip;6;0;0;6
11722;Šermukšnėlė;GINTARĖLIAI;10728235594;Taip;10;0;4;14
11723;Šermukšnėlė;GINTARĖLIAI;42477406335;Taip;15;0;0;15
11724;Šermukšnėlė;GINTARĖLIAI;1425285365;Taip;4;4;0;8
11725;Šermukšnėlė;GINTARĖLIAI;6279210465;Taip;8;0;2;10
11726;Šermukšnėlė;AKMENUKAI;17555989996;Taip;0;5;0;5
11727;Šermukšnėlė;AKMENUKAI;60154507177;Taip;6;0;0;6
11728;Šermukšnėlė;AKMENUKAI;6987675764;Taip;6;0;3;9
11729;Šermukšnėlė;AKMENUKAI;20272898512;Taip;0;10;1;11
11730;Šermukšnėlė;AKMENUKAI;85116657402;Taip;5;0;0;5
11731;Šermukšnėlė;AKMENUKAI;6604797702;Taip;3;0;3;6
11732;Šermukšnėlė;AKMENUKAI;95089450234;Taip;12;0;1;13
11733;Šermukšnėlė;AKMENUKAI;80199267729;Taip;6;0;0;6
11734;Šermukšnėlė;AKMENUKAI;1332354208;Taip;10;0;1;11
11735;Šermukšnėlė;AKMENUKAI;1175718969;Taip;0;6;0;6
11736;Šermukšnėlė;AKMENUKAI;27139089487;Taip;0;2;0;2
11737;Šermukšnėlė;AKMENUKAI;42520543068;Taip;6;3;0;9
11738;Šermukšnėlė;AKMENUKAI;76682206033;Taip;2;0;3;5
11739;Šermukšnėlė;AKMENUKAI;42192131599;Taip;4;3;0;7
11740;Šermukšnėlė;AKMENUKAI;1756560941;Taip;6;0;4;10
11741;Šermukšnėlė;AKMENUKAI;3628734426;Taip;0;11;0;11
11742;Šermukšnėlė;AKMENUKAI;82161996761;Taip;10;0;0;10
11743;Šermukšnėlė;SIŪLINUKAI;32417473492;Taip;4;5;1;10
11744;Šermukšnėlė;SIŪLINUKAI;35508499818;Taip;1;5;1;7
11745;Šermukšnėlė;SIŪLINUKAI;1054907277;Taip;0;0;1;1
11746;Šermukšnėlė;SIŪLINUKAI;30853722796;Taip;0;5;0;5
11747;Šermukšnėlė;SIŪLINUKAI;41661711151;Taip;0;4;0;4
11748;Šermukšnėlė;SIŪLINUKAI;62420710883;Taip;0;2;5;7
11749;Šermukšnėlė;SIŪLINUKAI;87646529363;Taip;0;4;0;4
11750;Šermukšnėlė;SIŪLINUKAI;25663713043;Taip;0;5;0;5
11751;Šermukšnėlė;SIŪLINUKAI;57211490716;Taip;5;4;0;9
11752;Šermukšnėlė;SIŪLINUKAI;88123535614;Taip;2;5;0;7
11753;Šermukšnėlė;SIŪLINUKAI;61911120798;Taip;8;3;0;11
11754;Šermukšnėlė;SIŪLINUKAI;3089008915;Taip;8;3;0;11
11755;Šermukšnėlė;SIŪLINUKAI;20160146304;Taip;5;4;0;9
11756;Šermukšnėlė;SIŪLINUKAI;1912938544;Taip;11;9;0;20
11757;Šermukšnėlė;SIŪLINUKAI;1330471614;Taip;0;5;0;5
11758;Šermukšnėlė;SIŪLINUKAI;1127786451;Taip;9;5;0;14
11759;Šermukšnėlė;SIŪLINUKAI;18799838453;Taip;8;1;0;9
11760;Šermukšnėlė;SIŪLINUKAI;1891818706;Taip;10;0;0;10
11761;Šermukšnėlė;SIŪLINUKAI;78916223877;Taip;14;1;0;15
11762;Šermukšnėlė;SIŪLINUKAI;45632551657;Taip;5;5;0;10
11763;Šermukšnėlė;MEDINUKAi;2380988728;Taip;16;0;0;16
11764;Šermukšnėlė;MEDINUKAi;2529526401;Taip;8;5;3;16
11765;Šermukšnėlė;MEDINUKAi;8956573129;Taip;7;0;0;7
11766;Šermukšnėlė;MEDINUKAi;3222466449;Taip;12;5;0;17
11767;Šermukšnėlė;MEDINUKAi;5096946133;Taip;0;11;0;11
11768;Šermukšnėlė;MEDINUKAi;8279692394;Taip;20;0;0;20
11769;Šermukšnėlė;MEDINUKAi;1459253197;Taip;4;0;0;4
11770;Šermukšnėlė;MEDINUKAi;2160616078;Taip;10;0;0;10
11771;Šermukšnėlė;MEDINUKAi;78341448188;Taip;10;4;0;14
11772;Šermukšnėlė;MEDINUKAi;1661977128;Taip;6;0;5;11
11773;Šermukšnėlė;MEDINUKAi;6430627501;Taip;11;1;0;12
11774;Šermukšnėlė;MEDINUKAi;5832072195;Taip;20;0;0;20
11775;Šermukšnėlė;MEDINUKAi;9035625467;Taip;5;0;0;5
11776;Šermukšnėlė;MEDINUKAi;7038705221;Taip;8;0;4;12
11777;Šermukšnėlė;MEDINUKAi;3081548524;Taip;5;5;0;10
11778;Šermukšnėlė;SKUDURINUKAI;2176788727;Taip;17;0;0;17
11779;Šermukšnėlė;SKUDURINUKAI;3949629658;Taip;16;1;0;17
11780;Šermukšnėlė;SKUDURINUKAI;7262199284;Taip;10;5;0;15
11781;Šermukšnėlė;SKUDURINUKAI;5151843494;Taip;9;0;0;9
11782;Šermukšnėlė;SKUDURINUKAI;1148559284;Taip;10;0;3;13
11783;Šermukšnėlė;SKUDURINUKAI;3148857617;Taip;5;5;0;10
11784;Šermukšnėlė;SKUDURINUKAI;4201283154;Taip;1;0;0;1
11785;Šermukšnėlė;SKUDURINUKAI;5575518612;Taip;15;0;0;15
11786;Šermukšnėlė;SKUDURINUKAI;5733540837;Taip;14;0;0;14
11787;Šermukšnėlė;SKUDURINUKAI;5397385093;Taip;20;0;0;20
11788;Šermukšnėlė;SKUDURINUKAI;3322053946;Taip;12;3;0;15
11789;Šermukšnėlė;SKUDURINUKAI;5354978646;Taip;20;0;0;20
11790;Šermukšnėlė;SKUDURINUKAI;1882432812;Taip;14;0;0;14
11791;Šermukšnėlė;SKUDURINUKAI;5242187638;Taip;20;0;0;20
11792;Šermukšnėlė;SKUDURINUKAI;5545018656;Taip;6;0;3;9
11793;Šermukšnėlė;PAGRANDUKAI;7245206247;Taip;7;0;0;7
11794;Šermukšnėlė;PAGRANDUKAI;4569484117;Taip;0;6;0;6
11795;Šermukšnėlė;PAGRANDUKAI;5159105661;Taip;12;0;0;12
11796;Šermukšnėlė;PAGRANDUKAI;1437314920;Taip;15;1;0;16
11797;Šermukšnėlė;PAGRANDUKAI;7843128263;Taip;5;6;0;11
11798;Šermukšnėlė;PAGRANDUKAI;8407947566;Taip;0;0;3;3
11799;Šermukšnėlė;PAGRANDUKAI;2447547509;Taip;7;0;2;9
11800;Šermukšnėlė;PAGRANDUKAI;4086783761;Taip;1;0;0;1
11801;Šermukšnėlė;PAGRANDUKAI;9876533442;Taip;6;0;2;8
11802;Šermukšnėlė;PAGRANDUKAI;3513568460;Taip;10;0;1;11
11803;Šermukšnėlė;PAGRANDUKAI;8859731179;Taip;0;0;3;3
11804;Šermukšnėlė;PAGRANDUKAI;4230698872;Taip;1;0;0;1
11805;Šermukšnėlė;PAGRANDUKAI;6067298318;Taip;3;1;0;4
11806;Šypsena;NYKŠTUKAI;5985974927;Taip;16;0;0;16
11807;Šypsena;NYKŠTUKAI;4766170132;Ne;12;0;0;12
11808;Šypsena;NYKŠTUKAI;4936775366;Taip;20;0;0;20
11809;Šypsena;NYKŠTUKAI;7569495879;Taip;0;3;0;3
11810;Šypsena;NYKŠTUKAI;4635232236;Taip;0;5;0;5
11811;Šypsena;NYKŠTUKAI;4677405885;Taip;4;0;0;4
11812;Šypsena;NYKŠTUKAI;6590285866;Taip;0;2;0;2
11813;Šypsena;NYKŠTUKAI;1343249939;Taip;6;0;2;8
11814;Šypsena;NYKŠTUKAI;1387130727;Taip;14;0;1;15
11815;Šypsena;NYKŠTUKAI;3025437080;Taip;1;1;5;7
11816;Šypsena;NYKŠTUKAI;1669768648;Ne;15;0;0;15
11817;Šypsena;NYKŠTUKAI;1575413188;Taip;0;10;0;10
11818;Šypsena;NYKŠTUKAI;2005543016;Ne;0;5;0;5
11819;Šypsena;NYKŠTUKAI;6832433711;Taip;6;0;0;6
11820;Šypsena;NYKŠTUKAI;2248628927;Taip;5;4;0;9
11821;Šypsena;NYKŠTUKAI;2995753269;Taip;6;0;0;6
11822;Šypsena;NYKŠTUKAI;1796837022;Taip;7;0;2;9
11823;Šypsena;NYKŠTUKAI;7251064118;Taip;7;0;5;12
11824;Šypsena;SPINDULIUKAI;1967590536;Taip;9;4;0;13
11825;Šypsena;SPINDULIUKAI;3541189470;Taip;8;0;0;8
11826;Šypsena;SPINDULIUKAI;1659390234;Ne;1;7;0;8
11827;Šypsena;SPINDULIUKAI;1272973534;Ne;0;5;0;5
11828;Šypsena;SPINDULIUKAI;1767948457;Ne;10;0;0;10
11829;Šypsena;SPINDULIUKAI;1917246860;Ne;0;20;0;20
11830;Šypsena;SPINDULIUKAI;46569341613;Taip;15;0;0;15
11831;Šypsena;SPINDULIUKAI;42130115068;Taip;0;14;0;14
11832;Šypsena;SPINDULIUKAI;6444616846;Taip;10;0;0;10
11833;Šypsena;SPINDULIUKAI;1712017606;Ne;9;0;0;9
11834;Šypsena;SPINDULIUKAI;1996746426;Taip;12;3;0;15
11835;Šypsena;SPINDULIUKAI;4017777389;Taip;8;0;0;8
11836;Šypsena;SPINDULIUKAI;70188972463;Taip;15;2;0;17
11837;Šypsena;SPINDULIUKAI;76332370575;Taip;20;0;0;20
11838;Šypsena;SPINDULIUKAI;1906529989;Taip;3;0;0;3
11839;Šypsena;SPINDULIUKAI;2099216049;Taip;0;20;0;20
11840;Šypsena;SPINDULIUKAI;89503728819;Ne;6;2;0;8
11841;Šypsena;SPINDULIUKAI;38995939952;Taip;0;0;1;1
11842;Šypsena;SPINDULIUKAI;93678429536;Taip;0;2;0;2
11843;Šypsena;SPINDULIUKAI;8197460768;Taip;0;5;0;5
11844;Šypsena;SPINDULIUKAI;3431905515;Taip;0;17;0;17
11845;Šypsena;SPINDULIUKAI;1133113196;Ne;8;0;0;8
11846;Šypsena;SKRUZDELIUKAI;7591001646;Ne;0;10;0;10
11847;Šypsena;SKRUZDELIUKAI;17041968817;Taip;17;0;0;17
11848;Šypsena;SKRUZDELIUKAI;1369664461;Ne;9;0;0;9
11849;Šypsena;SKRUZDELIUKAI;1886141947;Taip;0;0;8;8
11850;Šypsena;SKRUZDELIUKAI;49812111803;Taip;10;0;0;10
11851;Šypsena;SKRUZDELIUKAI;1329170686;Taip;6;0;0;6
11852;Šypsena;SKRUZDELIUKAI;84526597847;Taip;0;1;0;1
11853;Šypsena;SKRUZDELIUKAI;39296351965;Taip;9;3;0;12
11854;Šypsena;SKRUZDELIUKAI;91846404526;Ne;5;7;0;12
11855;Šypsena;SKRUZDELIUKAI;47729405181;Taip;0;4;5;9
11856;Šypsena;SKRUZDELIUKAI;1972212253;Taip;1;2;3;6
11857;Šypsena;SKRUZDELIUKAI;5971488796;Taip;0;5;0;5
11858;Šypsena;SKRUZDELIUKAI;79177095462;Taip;4;0;0;4
11859;Šypsena;SKRUZDELIUKAI;39495782526;Taip;0;9;0;9
11860;Šypsena;SKRUZDELIUKAI;2117865969;Taip;5;3;0;8
11861;Šypsena;SKRUZDELIUKAI;1755934341;Taip;9;0;2;11
11862;Šypsena;SKRUZDELIUKAI;1702152247;Taip;0;14;0;14
11863;Šypsena;SKRUZDELIUKAI;2119267347;Ne;7;0;0;7
11864;Šypsena;SKRUZDELIUKAI;5680397153;Taip;0;14;4;18
11865;Šypsena;Bitutės;1917439391;Ne;0;0;4;4
11866;Šypsena;Bitutės;1720218822;Ne;6;1;0;7
11867;Šypsena;Bitutės;89119472685;Taip;0;8;0;8
11868;Šypsena;Bitutės;2040900989;Taip;0;13;0;13
11869;Šypsena;Bitutės;1872237094;Taip;7;0;1;8
11870;Šypsena;Bitutės;51099062216;Ne;8;1;0;9
11871;Šypsena;Bitutės;93544585309;Taip;0;0;7;7
11872;Šypsena;Bitutės;44505027442;Ne;0;8;0;8
11873;Šypsena;Bitutės;1505433574;Taip;5;0;2;7
11874;Šypsena;MEŠKIUKAI;1114341518;Taip;5;0;1;6
11875;Šypsena;MEŠKIUKAI;8715718525;Taip;3;0;1;4
11876;Šypsena;MEŠKIUKAI;2312828770;Taip;9;1;1;11
11877;Šypsena;MEŠKIUKAI;1422418997;Taip;6;3;0;9
11878;Šypsena;MEŠKIUKAI;7438060503;Taip;6;1;6;13
11879;Šypsena;MEŠKIUKAI;1515803985;Taip;8;2;0;10
11880;Šypsena;MEŠKIUKAI;5504570516;Taip;5;1;12;18
11881;Šypsena;MEŠKIUKAI;1063834589;Taip;5;5;0;10
11882;Šypsena;MEŠKIUKAI;1558614852;Taip;6;1;0;7
11883;Šypsena;MEŠKIUKAI;1897176871;Taip;16;0;0;16
11884;Šypsena;MEŠKIUKAI;1181590127;Taip;18;0;0;18
11885;Šypsena;MEŠKIUKAI;5834057370;Taip;8;2;0;10
11886;Šypsena;MEŠKIUKAI;5928432220;Taip;0;5;0;5
11887;Šypsena;MEŠKIUKAI;2798819321;Taip;0;5;0;5
11888;Šypsena;BORUŽĖLĖS;5611440056;Ne;10;0;0;10
11889;Šypsena;BORUŽĖLĖS;7160466766;Taip;9;1;0;10
11890;Šypsena;BORUŽĖLĖS;4038279267;Taip;10;4;0;14
11891;Šypsena;BORUŽĖLĖS;3823623458;Ne;13;1;0;14
11892;Šypsena;BORUŽĖLĖS;6713182218;Taip;19;0;0;19
11893;Šypsena;BORUŽĖLĖS;8950694484;Taip;14;0;0;14
11894;Šypsena;BORUŽĖLĖS;4344780723;Taip;6;0;8;14
11895;Šypsena;BORUŽĖLĖS;7537442618;Taip;20;0;0;20
11896;Šypsena;BORUŽĖLĖS;3968514430;Taip;10;0;0;10
11897;Šypsena;BORUŽĖLĖS;1893123775;Taip;20;0;0;20
11898;Šypsena;BORUŽĖLĖS;6237208661;Taip;9;0;6;15
11899;Šypsena;BORUŽĖLĖS;6716558946;Taip;20;0;0;20
11900;Šypsena;BORUŽĖLĖS;7519967594;Taip;9;0;1;10
11901;Šnekutis;DRUGELIŲ;70663269171;Taip;0;0;2;2
11902;Šnekutis;DRUGELIŲ;1723901018;Taip;0;5;4;9
11903;Šnekutis;DRUGELIŲ;1245722149;Taip;0;13;0;13
11904;Šnekutis;DRUGELIŲ;1355103006;Taip;4;9;5;18
11905;Šnekutis;DRUGELIŲ;2000728679;Taip;18;0;0;18
11906;Šnekutis;DRUGELIŲ;54635137954;Taip;0;8;0;8
11907;Šnekutis;DRUGELIŲ;50017415248;Taip;9;0;1;10
11908;Šnekutis;DRUGELIŲ;1956224017;Taip;15;0;0;15
11909;Šnekutis;DRUGELIŲ;2049447215;Taip;8;0;0;8
11910;Šnekutis;DRUGELIŲ;1159232792;Taip;8;0;0;8
11911;Šnekutis;DRUGELIŲ;2092637040;Taip;20;0;0;20
11912;Šnekutis;DRUGELIŲ;94289379983;Taip;13;2;0;15
11913;Šnekutis;DRUGELIŲ;50085798686;Taip;20;0;0;20
11914;Šnekutis;DRUGELIŲ;13209811505;Taip;11;0;1;12
11915;Šnekutis;DRUGELIŲ;30932565379;Taip;12;1;0;13
11916;Šnekutis;DRUGELIŲ;1836892386;Taip;0;0;1;1
11917;Šnekutis;DRUGELIŲ;5962885680;Taip;7;1;0;8
11918;Šnekutis;DRUGELIŲ;18354631454;Taip;6;0;2;8
11919;Šnekutis;DRUGELIŲ;5029631107;Taip;12;0;0;12
11920;Šnekutis;DRUGELIŲ;4104052524;Taip;3;1;0;4
11921;Šnekutis;DRUGELIŲ;46282997811;Taip;0;10;0;10
11922;Šnekutis;DRUGELIŲ;2102893949;Taip;0;0;1;1
11923;Šnekutis;Kačiukų;1156210876;Taip;4;12;0;16
11924;Šnekutis;Kačiukų;1233059816;Taip;5;6;0;11
11925;Šnekutis;Kačiukų;50433076829;Taip;0;0;8;8
11926;Šnekutis;Kačiukų;1179210615;Taip;11;2;0;13
11927;Šnekutis;Kačiukų;1023572132;Taip;5;6;0;11
11928;Šnekutis;Kačiukų;10114111509;Taip;0;2;0;2
11929;Šnekutis;Kačiukų;13211267463;Taip;0;4;4;8
11930;Šnekutis;Kačiukų;1430904579;Taip;0;0;5;5
11931;Šnekutis;Kačiukų;1881531513;Taip;0;1;0;1
11932;Šnekutis;Kačiukų;1430790285;Taip;8;0;1;9
11933;Šnekutis;Kačiukų;2027114365;Taip;0;0;1;1
11934;Šnekutis;Kačiukų;41323355319;Taip;0;4;3;7
11935;Šnekutis;Kačiukų;21847996888;Taip;7;0;0;7
11936;Šnekutis;Kačiukų;2026314698;Taip;0;3;2;5
11937;Šnekutis;Kačiukų;1498045991;Taip;10;0;0;10
11938;Šnekutis;Kačiukų;57220861535;Taip;6;0;1;7
11939;Šnekutis;Kačiukų;88609559814;Taip;0;8;0;8
11940;Šnekutis;Kačiukų;5052576808;Taip;3;0;0;3
11941;Šnekutis;Kačiukų;11446344891;Taip;3;5;0;8
11942;Šnekutis;Kačiukų;81675602998;Taip;9;0;0;9
11943;Šnekutis;Kačiukų;32806315077;Taip;1;0;5;6
11944;Šnekutis;Pėlėdžiukų;5188035949;Taip;0;12;0;12
11945;Šnekutis;Pėlėdžiukų;3068754741;Taip;0;0;2;2
11946;Šnekutis;Pėlėdžiukų;4334155280;Taip;0;0;2;2
11947;Šnekutis;Pėlėdžiukų;77534335117;Taip;16;0;1;17
11948;Šnekutis;Pėlėdžiukų;3312928478;Taip;0;0;1;1
11949;Šnekutis;Pėlėdžiukų;42697936562;Taip;14;0;0;14
11950;Šnekutis;Pėlėdžiukų;7507857415;Taip;10;0;0;10
11951;Šnekutis;Pėlėdžiukų;8866360301;Taip;0;4;0;4
11952;Šnekutis;Pėlėdžiukų;8745465796;Taip;0;20;0;20
11953;Šnekutis;Pėlėdžiukų;3170928052;Taip;8;0;0;8
11954;Šnekutis;Pėlėdžiukų;5321817615;Taip;5;0;1;6
11955;Šnekutis;Pėlėdžiukų;3578045341;Taip;9;0;0;9
11956;Šnekutis;Pėlėdžiukų;5117544317;Taip;4;0;2;6
11957;Šnekutis;Pėlėdžiukų;2446630485;Taip;0;7;0;7
11958;Šnekutis;Pėlėdžiukų;6754580614;Taip;3;0;0;3
11959;Šnekutis;Pėlėdžiukų;1507200600;Taip;0;0;2;2
11960;Šnekutis;Pėlėdžiukų;5615869149;Taip;6;2;0;8
11961;Šnekutis;Pėlėdžiukų;1329958641;Taip;0;0;1;1
11962;Šnekutis;Pėlėdžiukų;5457906245;Taip;20;0;0;20
11963;Šnekutis;Pėlėdžiukų;9511116249;Taip;5;0;0;5
11964;Šnekutis;Pėlėdžiukų;1369660223;Taip;0;0;1;1
11965;Šnekutis;Pėlėdžiukų;1682748852;Taip;0;0;2;2
11966;Šnekutis;Pėlėdžiukų;1447824885;Taip;0;2;0;2
11967;Šnekutis;Boružėlių;1818789769;Taip;7;2;0;9
11968;Šnekutis;Boružėlių;4557629310;Taip;20;0;0;20
11969;Šnekutis;Boružėlių;5711964409;Taip;4;0;14;18
11970;Šnekutis;Boružėlių;37382772659;Taip;14;0;0;14
11971;Šnekutis;Boružėlių;84241751923;Taip;7;1;0;8
11972;Šnekutis;Boružėlių;79174984189;Taip;0;0;2;2
11973;Šnekutis;Boružėlių;1666811336;Taip;9;0;0;9
11974;Šnekutis;Boružėlių;1249451765;Taip;14;2;0;16
11975;Šnekutis;Boružėlių;2080944830;Taip;0;0;7;7
11976;Šnekutis;Boružėlių;1936021189;Taip;4;0;3;7
11977;Šnekutis;Boružėlių;1985052072;Taip;6;0;2;8
11978;Šnekutis;Boružėlių;1451503127;Taip;20;0;0;20
11979;Šnekutis;Boružėlių;1738802158;Taip;0;0;1;1
11980;Šnekutis;Boružėlių;1744313172;Taip;0;1;0;1
11981;Šnekutis;Boružėlių;1620268693;Taip;1;0;19;20
11982;Šnekutis;Boružėlių;22757448235;Ne;5;4;0;9
11983;Šnekutis;Boružėlių;2259206809;Taip;0;0;2;2
11984;Šnekutis;Boružėlių;54532738133;Taip;1;8;0;9
11985;Šnekutis;Boružėlių;1370696345;Taip;6;0;0;6
11986;Šnekutis;Boružėlių;5973303255;Taip;10;0;7;17
11987;Šnekutis;Boružėlių;27150074287;Taip;19;0;0;19
11988;Šnekutis;Boružėlių;1622660874;Taip;0;0;2;2
11989;Šnekutis;Boružėlių;7514753023;Taip;0;0;2;2
11990;Šnekutis;Boružėlių;6828079735;Taip;1;4;0;5
11991;Šnekutis;Meškučių;4835202527;Taip;18;0;0;18
11992;Šnekutis;Meškučių;5052137859;Taip;0;0;1;1
11993;Šnekutis;Meškučių;2822538227;Taip;11;0;0;11
11994;Šnekutis;Meškučių;5597629090;Taip;14;0;0;14
11995;Šnekutis;Meškučių;8531521901;Taip;0;0;4;4
11996;Šnekutis;Meškučių;9670205249;Taip;5;0;0;5
11997;Šnekutis;Meškučių;6684395256;Taip;5;2;0;7
11998;Šnekutis;Meškučių;3271262071;Taip;9;0;0;9
11999;Šnekutis;Meškučių;8440160819;Taip;0;0;12;12
12000;Šnekutis;Meškučių;9862362744;Taip;13;0;1;14
12001;Šnekutis;Meškučių;8486136697;Taip;13;0;0;13
12002;Šnekutis;Meškučių;9780684867;Taip;9;10;0;19
12003;Šnekutis;Meškučių;7615716438;Taip;7;0;0;7
12004;Šnekutis;Meškučių;7622868249;Taip;15;0;0;15
12005;Šnekutis;Meškučių;3336605264;Taip;0;5;0;5
12006;Šnekutis;Viščiukų;7434438142;Taip;0;8;0;8
12007;Šnekutis;Viščiukų;9312935803;Taip;10;0;5;15
12008;Šnekutis;Viščiukų;9157136735;Taip;0;0;1;1
12009;Šnekutis;Viščiukų;7089000987;Taip;1;7;0;8
12010;Šnekutis;Viščiukų;3166309530;Taip;0;0;4;4
12011;Šnekutis;Viščiukų;5049964996;Taip;0;10;0;10
12012;Šnekutis;Viščiukų;4143844589;Taip;11;0;0;11
12013;Šnekutis;Viščiukų;3644413861;Taip;8;0;0;8
12014;Šnekutis;Viščiukų;7638626055;Taip;4;0;8;12
12015;Šnekutis;Viščiukų;4992188525;Taip;20;0;0;20
12016;Šnekutis;Viščiukų;7236658561;Taip;0;0;1;1
12017;Šnekutis;Viščiukų;6578568418;Taip;5;0;3;8
12018;Šnekutis;Viščiukų;9896249776;Taip;5;0;0;5
12019;Šnekutis;Viščiukų;9790803767;Taip;10;1;0;11
12020;Užupiukas;VYTURĖLIŲ;61670878339;Taip;5;2;0;7
12021;Užupiukas;VYTURĖLIŲ;51802714332;Taip;0;2;0;2
12022;Užupiukas;VYTURĖLIŲ;78184067796;Taip;0;1;0;1
12023;Užupiukas;VYTURĖLIŲ;31338755810;Taip;0;12;0;12
12024;Užupiukas;VYTURĖLIŲ;33629222941;Taip;0;5;0;5
12025;Užupiukas;VYTURĖLIŲ;266671806;Taip;0;2;0;2
12026;Užupiukas;VYTURĖLIŲ;29207590902;Taip;0;7;0;7
12027;Užupiukas;VYTURĖLIŲ;37684526869;Taip;0;6;0;6
12028;Užupiukas;VYTURĖLIŲ;39058613355;Taip;0;1;0;1
12029;Užupiukas;VYTURĖLIŲ;67408169039;Taip;0;3;1;4
12030;Užupiukas;VYTURĖLIŲ;77255831055;Taip;0;5;0;5
12031;Užupiukas;VYTURĖLIŲ;23371854830;Taip;0;7;1;8
12032;Užupiukas;VYTURĖLIŲ;27588257764;Taip;0;1;0;1
12033;Užupiukas;VYTURĖLIŲ;75976703580;Taip;9;1;0;10
12034;Užupiukas;VYTURĖLIŲ;3663596268;Taip;0;2;0;2
12035;Užupiukas;VYTURĖLIŲ;39079421361;Taip;0;1;0;1
12036;Užupiukas;VYTURĖLIŲ;12401560384;Taip;0;1;0;1
12037;Užupiukas;VYTURĖLIŲ;53974652901;Taip;5;2;0;7
12038;Užupiukas;VYTURĖLIŲ;44770930654;Taip;0;14;0;14
12039;Užupiukas;VYTURĖLIŲ;7060019183;Taip;5;0;0;5
12040;Užupiukas;KAČIUKŲ;68812682685;Taip;0;1;0;1
12041;Užupiukas;KAČIUKŲ;9263601354;Taip;0;4;0;4
12042;Užupiukas;KAČIUKŲ;84367190618;Taip;10;4;0;14
12043;Užupiukas;KAČIUKŲ;61560152825;Taip;0;0;1;1
12044;Užupiukas;KAČIUKŲ;12905151141;Taip;5;9;0;14
12045;Užupiukas;KAČIUKŲ;10715755079;Taip;0;4;0;4
12046;Užupiukas;KAČIUKŲ;78675007424;Taip;0;1;0;1
12047;Užupiukas;KAČIUKŲ;20407315;Taip;0;1;0;1
12048;Užupiukas;KAČIUKŲ;95445743970;Taip;5;0;0;5
12049;Užupiukas;KAČIUKŲ;42027395287;Taip;0;11;7;18
12050;Užupiukas;KAČIUKŲ;74913928694;Taip;0;5;0;5
12051;Užupiukas;KAČIUKŲ;31618737243;Taip;19;0;0;19
12052;Užupiukas;KAČIUKŲ;42772205412;Taip;5;6;0;11
12053;Užupiukas;KAČIUKŲ;7659981079;Taip;5;0;0;5
12054;Užupiukas;KAČIUKŲ;22839159539;Taip;0;14;1;15
12055;Užupiukas;KAČIUKŲ;32651983670;Taip;0;4;0;4
12056;Užupiukas;KAČIUKŲ;27226172373;Taip;5;1;3;9
12057;Užupiukas;KAČIUKŲ;30335529070;Taip;8;2;0;10
12058;Užupiukas;KAČIUKŲ;1700750771;Taip;0;6;1;7
12059;Užupiukas;KAČIUKŲ;31668159620;Ne;11;3;0;14
12060;Užupiukas;DRUGELIŲ;1772019951;Taip;10;0;0;10
12061;Užupiukas;DRUGELIŲ;9655636851;Taip;10;0;0;10
12062;Užupiukas;DRUGELIŲ;1662564735;Taip;0;0;15;15
12063;Užupiukas;DRUGELIŲ;9863097416;Taip;16;0;0;16
12064;Užupiukas;DRUGELIŲ;7298322865;Taip;20;0;0;20
12065;Užupiukas;DRUGELIŲ;7056737587;Taip;6;0;8;14
12066;Užupiukas;DRUGELIŲ;8734960045;Taip;0;20;0;20
12067;Užupiukas;DRUGELIŲ;8724566014;Taip;8;0;0;8
12068;Užupiukas;DRUGELIŲ;14139543365;Taip;6;0;0;6
12069;Užupiukas;DRUGELIŲ;1554333137;Taip;6;0;3;9
12070;Užupiukas;DRUGELIŲ;3298267311;Taip;17;0;0;17
12071;Užupiukas;DRUGELIŲ;8341598147;Taip;0;5;10;15
12072;Užupiukas;DRUGELIŲ;9782972949;Taip;14;0;0;14
12073;Užupiukas;DRUGELIŲ;3579499796;Taip;4;0;4;8
12074;Užupiukas;DRUGELIŲ;7140606152;Taip;6;0;0;6
12075;Užupiukas;DRUGELIŲ;2348243399;Taip;10;0;1;11
12076;Užupiukas;DRUGELIŲ;8870229834;Taip;14;0;5;19
12077;Užupiukas;DRUGELIŲ;1679324943;Taip;8;0;2;10
12078;Užupiukas;DRUGELIŲ;9617597828;Taip;5;0;0;5
12079;Užupiukas;DRUGELIŲ;9096157655;Ne;5;0;1;6
12080;Užupiukas;EŽIUKŲ;73657553075;Taip;10;0;0;10
12081;Užupiukas;EŽIUKŲ;1159892685;Taip;1;3;0;4
12082;Užupiukas;EŽIUKŲ;79908666651;Taip;0;6;2;8
12083;Užupiukas;EŽIUKŲ;95981297986;Taip;20;0;0;20
12084;Užupiukas;EŽIUKŲ;27438104059;Taip;5;0;0;5
12085;Užupiukas;EŽIUKŲ;94857555708;Taip;20;0;0;20
12086;Užupiukas;EŽIUKŲ;12023740118;Taip;5;0;4;9
12087;Užupiukas;EŽIUKŲ;98209952363;Taip;0;0;6;6
12088;Užupiukas;EŽIUKŲ;6442996343;Taip;5;0;0;5
12089;Užupiukas;EŽIUKŲ;9843068906;Taip;0;0;8;8
12090;Užupiukas;EŽIUKŲ;17473949362;Taip;0;6;0;6
12091;Užupiukas;EŽIUKŲ;1593878778;Taip;20;0;0;20
12092;Užupiukas;EŽIUKŲ;1535952427;Taip;0;0;15;15
12093;Užupiukas;EŽIUKŲ;1102150432;Taip;0;0;1;1
12094;Užupiukas;EŽIUKŲ;3785893846;Taip;10;0;0;10
12095;Užupiukas;EŽIUKŲ;1338561168;Taip;0;0;5;5
12096;Užupiukas;EŽIUKŲ;1891595719;Taip;0;0;1;1
12097;Užupiukas;EŽIUKŲ;2419842168;Taip;15;0;1;16
12098;Užupiukas;EŽIUKŲ;30379165882;Taip;0;6;0;6
12099;Užupiukas;EŽIUKŲ;7616817709;Taip;0;6;0;6
12100;Užupiukas;EŽIUKŲ;1850295450;Taip;0;0;2;2
12101;Užupiukas;BORUŽĖLIŲ;6828175620;Taip;4;0;1;5
12102;Užupiukas;BORUŽĖLIŲ;9791681813;Taip;11;6;0;17
12103;Užupiukas;BORUŽĖLIŲ;1503714343;Taip;0;6;0;6
12104;Užupiukas;BORUŽĖLIŲ;8313812681;Taip;11;0;1;12
12105;Užupiukas;BORUŽĖLIŲ;9932910870;Taip;0;0;20;20
12106;Užupiukas;BORUŽĖLIŲ;9906475253;Taip;0;6;14;20
12107;Užupiukas;BORUŽĖLIŲ;9677572224;Taip;3;0;0;3
12108;Užupiukas;BORUŽĖLIŲ;12787288319;Taip;6;0;1;7
12109;Užupiukas;BORUŽĖLIŲ;2445335267;Taip;17;0;0;17
12110;Užupiukas;BORUŽĖLIŲ;1108744283;Taip;0;0;1;1
12111;Užupiukas;BORUŽĖLIŲ;38066177076;Taip;4;1;0;5
12112;Užupiukas;BORUŽĖLIŲ;1514268763;Taip;0;5;0;5
12113;Užupiukas;BORUŽĖLIŲ;6526550727;Taip;11;0;0;11
12114;Užupiukas;BORUŽĖLIŲ;9735462228;Taip;6;1;1;8
12115;Užupiukas;BORUŽĖLIŲ;7555702944;Taip;8;0;0;8
12116;Užupiukas;BORUŽĖLIŲ;2307600884;Taip;0;10;7;17
12117;Užupiukas;BORUŽĖLIŲ;6073039842;Taip;9;0;2;11
12118;Užupiukas;BORUŽĖLIŲ;3038973312;Taip;9;1;2;12
12119;Užupiukas;BORUŽĖLIŲ;7861121290;Taip;5;0;1;6
12120;Užupiukas;SPINDULIUKŲ;67395713156;Taip;0;4;0;4
12121;Užupiukas;SPINDULIUKŲ;51983057814;Taip;0;4;0;4
12122;Užupiukas;SPINDULIUKŲ;86921401020;Taip;0;6;1;7
12123;Užupiukas;SPINDULIUKŲ;90438855641;Taip;0;4;1;5
12124;Užupiukas;SPINDULIUKŲ;65677644430;Taip;6;5;0;11
12125;Užupiukas;SPINDULIUKŲ;84336476482;Taip;0;9;2;11
12126;Užupiukas;SPINDULIUKŲ;80007333669;Taip;19;0;0;19
12127;Užupiukas;SPINDULIUKŲ;15724999714;Taip;0;4;0;4
12128;Užupiukas;SPINDULIUKŲ;26339684743;Taip;0;7;2;9
12129;Užupiukas;SPINDULIUKŲ;9827529278;Taip;3;2;0;5
12130;Užupiukas;SPINDULIUKŲ;90077603800;Taip;0;1;0;1
12131;Užupiukas;SPINDULIUKŲ;84075926264;Taip;6;0;0;6
12132;Užupiukas;SPINDULIUKŲ;37017020021;Taip;0;1;0;1
12133;Užupiukas;SPINDULIUKŲ;87149966445;Taip;10;0;0;10
12134;Užupiukas;SPINDULIUKŲ;26118376709;Taip;2;0;0;2
12135;Užupiukas;SPINDULIUKŲ;30335969437;Taip;0;6;1;7
12136;Užupiukas;SPINDULIUKŲ;34512830427;Taip;5;2;0;7
12137;Užupiukas;SPINDULIUKŲ;39837224579;Taip;0;4;0;4
12138;Užupiukas;SPINDULIUKŲ;4322004071;Taip;0;1;0;1
12139;Užupiukas;SPINDULIUKŲ;59095867565;Taip;0;0;1;1
12140;Užupiukas;SPINDULIUKŲ;54802123672;Taip;9;0;0;9
12141;Užupiukas;SPINDULIUKŲ;3087557445;Taip;12;0;0;12
12142;Užupiukas;ŽVIRBLIUKŲ;66976483535;Taip;0;4;0;4
12143;Užupiukas;ŽVIRBLIUKŲ;74109296784;Taip;0;1;0;1
12144;Užupiukas;ŽVIRBLIUKŲ;41589248540;Taip;0;1;0;1
12145;Užupiukas;ŽVIRBLIUKŲ;6945412270;Taip;0;9;10;19
12146;Užupiukas;ŽVIRBLIUKŲ;29120240155;Taip;0;1;0;1
12147;Užupiukas;ŽVIRBLIUKŲ;77360572295;Taip;0;4;0;4
12148;Užupiukas;ŽVIRBLIUKŲ;12930564771;Taip;5;3;2;10
12149;Užupiukas;ŽVIRBLIUKŲ;39154080649;Taip;0;8;2;10
12150;Užupiukas;ŽVIRBLIUKŲ;54388164264;Taip;5;1;0;6
12151;Užupiukas;ŽVIRBLIUKŲ;77859943014;Taip;0;4;1;5
12152;Užupiukas;ŽVIRBLIUKŲ;78093835821;Taip;0;2;1;3
12153;Užupiukas;ŽVIRBLIUKŲ;9621834194;Taip;0;3;0;3
12154;Užupiukas;ŽVIRBLIUKŲ;2261114370;Taip;0;4;5;9
12155;Užupiukas;ŽVIRBLIUKŲ;55851979501;Taip;14;4;0;18
12156;Užupiukas;ŽVIRBLIUKŲ;50633300666;Taip;0;1;1;2
12157;Užupiukas;ŽVIRBLIUKŲ;81516820215;Taip;5;3;1;9
12158;Užupiukas;ŽVIRBLIUKŲ;80569399641;Taip;0;7;1;8
12159;Užupiukas;ŽVIRBLIUKŲ;1961593235;Taip;10;4;5;19
12160;Užupiukas;ŽVIRBLIUKŲ;65914465707;Taip;0;0;1;1
12161;Užupiukas;ŽVIRBLIUKŲ;11261333632;Taip;0;8;9;17
12162;Užupiukas;ŽVIRBLIUKŲ;4310051789;Taip;19;0;0;19
12163;Užupiukas;PELĖDŽIUKŲ;94936980824;Taip;6;1;0;7
12164;Užupiukas;PELĖDŽIUKŲ;51703520898;Taip;0;2;0;2
12165;Užupiukas;PELĖDŽIUKŲ;4147741857;Taip;0;1;0;1
12166;Užupiukas;PELĖDŽIUKŲ;40697997174;Taip;0;4;0;4
12167;Užupiukas;PELĖDŽIUKŲ;6447998472;Taip;14;0;1;15
12168;Užupiukas;PELĖDŽIUKŲ;79539936850;Taip;0;4;3;7
12169;Užupiukas;PELĖDŽIUKŲ;91266096205;Taip;0;1;1;2
12170;Užupiukas;PELĖDŽIUKŲ;29433022056;Taip;10;0;0;10
12171;Užupiukas;PELĖDŽIUKŲ;61722030522;Taip;0;2;2;4
12172;Užupiukas;PELĖDŽIUKŲ;25194791061;Taip;0;0;2;2
12173;Užupiukas;PELĖDŽIUKŲ;55760273994;Taip;0;1;7;8
12174;Užupiukas;PELĖDŽIUKŲ;91904601102;Taip;0;0;1;1
12175;Užupiukas;PELĖDŽIUKŲ;29122831474;Taip;11;0;0;11
12176;Užupiukas;PELĖDŽIUKŲ;91632804337;Taip;0;3;0;3
12177;Užupiukas;PELĖDŽIUKŲ;24344329528;Taip;0;5;0;5
12178;Užupiukas;PELĖDŽIUKŲ;97373228204;Taip;0;0;1;1
12179;Užupiukas;PELĖDŽIUKŲ;43231263535;Taip;5;2;2;9
12180;Užupiukas;PELĖDŽIUKŲ;38236870957;Taip;0;4;2;6
12181;Užupiukas;PELĖDŽIUKŲ;70640896909;Taip;1;1;0;2
12182;Užupiukas;PELĖDŽIUKŲ;47039147715;Taip;5;2;1;8
12183;Užupiukas;PELĖDŽIUKŲ;41047619045;Taip;0;1;3;4
12184;Užupiukas;PELĖDŽIUKŲ;8865442531;Taip;0;0;3;3
12185;Užupiukas;PELĖDŽIUKŲ;22644512133;Taip;10;0;0;10
12186;Užupiukas;VARPELIŲ;6790700398;Taip;0;5;0;5
12187;Užupiukas;VARPELIŲ;23723147269;Taip;0;11;0;11
12188;Užupiukas;VARPELIŲ;17651645880;Taip;3;2;0;5
12189;Užupiukas;VARPELIŲ;50797530294;Taip;0;4;0;4
12190;Užupiukas;VARPELIŲ;98428714407;Taip;3;0;0;3
12191;Užupiukas;VARPELIŲ;57439594934;Taip;0;5;1;6
12192;Užupiukas;VARPELIŲ;2137620968;Taip;0;5;0;5
12193;Užupiukas;VARPELIŲ;1103878937;Taip;1;0;0;1
12194;Užupiukas;VARPELIŲ;5079596604;Taip;5;0;1;6
12195;Užupiukas;VARPELIŲ;1294561841;Taip;0;0;5;5
12196;Užupiukas;VARPELIŲ;2031306814;Taip;0;6;1;7
12197;Užupiukas;VARPELIŲ;82632886488;Taip;5;0;4;9
12198;Užupiukas;VARPELIŲ;77950386276;Taip;0;0;7;7
12199;Užupiukas;VARPELIŲ;79092366287;Taip;0;5;1;6
12200;Užupiukas;VARPELIŲ;6188599930;Taip;5;0;0;5
12201;Užupiukas;VARPELIŲ;8358242714;Taip;5;5;3;13
12202;Užupiukas;SAULUČIŲ;10681040398;Taip;0;1;0;1
12203;Užupiukas;SAULUČIŲ;55683021710;Taip;0;0;1;1
12204;Užupiukas;SAULUČIŲ;64774033504;Taip;0;0;1;1
12205;Užupiukas;SAULUČIŲ;1656658765;Taip;5;6;1;12
12206;Užupiukas;SAULUČIŲ;52047323776;Taip;9;0;2;11
12207;Užupiukas;SAULUČIŲ;25118968273;Taip;5;0;7;12
12208;Užupiukas;SAULUČIŲ;1307564992;Taip;1;0;9;10
12209;Užupiukas;SAULUČIŲ;2740412091;Taip;20;0;0;20
12210;Užupiukas;SAULUČIŲ;1577630991;Taip;7;0;10;17
12211;Užupiukas;SAULUČIŲ;1158250810;Taip;0;9;0;9
12212;Užupiukas;SAULUČIŲ;48886679788;Taip;0;6;1;7
12213;Užupiukas;SAULUČIŲ;53272114855;Taip;0;2;0;2
12214;Užupiukas;SAULUČIŲ;36820708170;Taip;0;6;1;7
12215;Užupiukas;SAULUČIŲ;52600923918;Taip;0;6;0;6
12216;Užupiukas;SAULUČIŲ;10522364665;Taip;0;4;0;4
12217;Užupiukas;SAULUČIŲ;31471265444;Taip;6;0;0;6
12218;Užupiukas;SAULUČIŲ;87017671664;Taip;0;4;10;14
12219;Užupiukas;SAULUČIŲ;15815468617;Taip;0;0;2;2
12220;Užupiukas;SAULUČIŲ;73039119839;Taip;20;0;0;20
12221;Užupiukas;SAULUČIŲ;1592276956;Taip;17;0;0;17
12222;Užupiukas;SAULUČIŲ;6467238027;Taip;5;0;0;5
12223;Užupiukas;SAULUČIŲ;57642636356;Taip;5;0;1;6
12224;Užupiukas;SAULUČIŲ;2499414724;Taip;6;0;2;8
12225;Užupiukas;LAPIUKŲ;3309195572;Taip;12;0;0;12
12226;Užupiukas;LAPIUKŲ;7563497568;Taip;0;0;2;2
12227;Užupiukas;LAPIUKŲ;2821350355;Taip;14;0;3;17
12228;Užupiukas;LAPIUKŲ;5665323444;Taip;11;0;0;11
12229;Užupiukas;LAPIUKŲ;22401995674;Taip;0;0;1;1
12230;Užupiukas;LAPIUKŲ;3774364829;Taip;0;1;2;3
12231;Užupiukas;LAPIUKŲ;6236652118;Taip;0;0;1;1
12232;Užupiukas;LAPIUKŲ;4247280316;Taip;0;0;1;1
12233;Užupiukas;LAPIUKŲ;2938276316;Taip;5;0;8;13
12234;Užupiukas;LAPIUKŲ;6478702476;Taip;0;2;2;4
12235;Užupiukas;LAPIUKŲ;4132760111;Taip;0;3;0;3
12236;Užupiukas;LAPIUKŲ;9197242545;Taip;0;0;2;2
12237;Užupiukas;LAPIUKŲ;3205769002;Taip;14;0;1;15
12238;Užupiukas;LAPIUKŲ;5498369850;Taip;5;0;0;5
12239;Užupiukas;LAPIUKŲ;4608233152;Taip;0;1;1;2
12240;Užupiukas;LAPIUKŲ;6110869303;Taip;0;0;1;1
12241;Užupiukas;NYKŠTUKŲ;3905448176;Taip;5;0;2;7
12242;Užupiukas;NYKŠTUKŲ;4710910251;Taip;1;1;5;7
12243;Užupiukas;NYKŠTUKŲ;1718518621;Taip;2;0;0;2
12244;Užupiukas;NYKŠTUKŲ;9991552624;Taip;0;6;4;10
12245;Užupiukas;NYKŠTUKŲ;3048959458;Taip;5;0;0;5
12246;Užupiukas;NYKŠTUKŲ;3080668107;Taip;9;3;1;13
12247;Užupiukas;NYKŠTUKŲ;1651249962;Taip;5;0;0;5
12248;Užupiukas;NYKŠTUKŲ;2390955083;Taip;3;0;1;4
12249;Užupiukas;NYKŠTUKŲ;1809036046;Taip;4;0;8;12
12250;Užupiukas;NYKŠTUKŲ;1100574872;Taip;19;0;0;19
12251;Užupiukas;NYKŠTUKŲ;3861173268;Taip;6;0;2;8
12252;Užupiukas;NYKŠTUKŲ;5072363435;Taip;0;0;1;1
12253;Užupiukas;NYKŠTUKŲ;9446562736;Taip;0;0;1;1
12254;Užupiukas;NYKŠTUKŲ;9813360176;Taip;0;0;2;2
12255;Užupiukas;NYKŠTUKŲ;5116564840;Taip;6;0;1;7
12256;Užupiukas;NYKŠTUKŲ;6119222293;Ne;20;0;0;20
12257;Užupiukas;NYKŠTUKŲ;2724216446;Taip;14;1;0;15
12258;Užupiukas;NYKŠTUKŲ;1684901495;Taip;17;0;0;17
12259;Vaidilutė;Žiogelis;83446186815;Taip;0;6;1;7
12260;Vaidilutė;Žiogelis;76782239392;Taip;0;0;2;2
12261;Vaidilutė;Žiogelis;51568574636;Taip;0;1;0;1
12262;Vaidilutė;Žiogelis;45619465634;Taip;0;4;1;5
12263;Vaidilutė;Žiogelis;1587658785;Taip;2;0;1;3
12264;Vaidilutė;Žiogelis;72508198771;Taip;0;5;1;6
12265;Vaidilutė;Žiogelis;36995673806;Taip;10;0;0;10
12266;Vaidilutė;Žiogelis;26144399724;Taip;5;4;0;9
12267;Vaidilutė;Žiogelis;76095903956;Taip;12;0;1;13
12268;Vaidilutė;Žiogelis;25736859991;Taip;5;0;0;5
12269;Vaidilutė;Žiogelis;93941932893;Taip;0;0;2;2
12270;Vaidilutė;Žiogelis;11736298044;Taip;0;0;1;1
12271;Vaidilutė;Žiogelis;9616432332;Taip;8;0;1;9
12272;Vaidilutė;Žiogelis;65596730863;Taip;0;1;1;2
12273;Vaidilutė;Žiogelis;69907222472;Taip;2;2;4;8
12274;Vaidilutė;Žiogelis;63465904558;Taip;0;4;0;4
12275;Vaidilutė;Žiogelis;52281826464;Taip;1;0;4;5
12276;Vaidilutė;Žiogelis;98760023673;Taip;5;0;5;10
12277;Vaidilutė;Žiogelis;1254377446;Taip;5;0;7;12
12278;Vaidilutė;Žiogelis;80628141893;Taip;5;0;7;12
12279;Vaidilutė;Rūtelė;12982620392;Taip;0;6;0;6
12280;Vaidilutė;Rūtelė;83614804593;Taip;8;0;0;8
12281;Vaidilutė;Rūtelė;95291858283;Taip;0;8;0;8
12282;Vaidilutė;Rūtelė;70241443027;Taip;4;0;0;4
12283;Vaidilutė;Rūtelė;2176694565;Taip;0;6;0;6
12284;Vaidilutė;Rūtelė;15308595647;Taip;5;6;0;11
12285;Vaidilutė;Rūtelė;36162605033;Taip;0;6;8;14
12286;Vaidilutė;Rūtelė;1347860031;Taip;3;6;0;9
12287;Vaidilutė;Rūtelė;87617273304;Taip;9;5;0;14
12288;Vaidilutė;Rūtelė;92269487538;Taip;8;0;6;14
12289;Vaidilutė;Rūtelė;57981568010;Taip;0;0;4;4
12290;Vaidilutė;Rūtelė;29245907351;Taip;0;17;0;17
12291;Vaidilutė;Rūtelė;13343473227;Taip;0;3;0;3
12292;Vaidilutė;Rūtelė;99220518506;Taip;9;6;0;15
12293;Vaidilutė;Rūtelė;8611047350;Taip;0;1;7;8
12294;Vaidilutė;Rūtelė;38331934468;Taip;0;0;2;2
12295;Vaidilutė;Rūtelė;5737042516;Taip;9;0;0;9
12296;Vaidilutė;Rūtelė;5785964650;Taip;8;2;0;10
12297;Vaidilutė;Rūtelė;7036490032;Taip;0;3;0;3
12298;Vaidilutė;Voveraitė;1993403692;Taip;6;0;0;6
12299;Vaidilutė;Voveraitė;42503303158;Taip;0;1;0;1
12300;Vaidilutė;Voveraitė;9948685221;Taip;0;1;3;4
12301;Vaidilutė;Voveraitė;9869134464;Taip;20;0;0;20
12302;Vaidilutė;Voveraitė;29153363263;Taip;11;0;0;11
12303;Vaidilutė;Voveraitė;5177060346;Taip;0;0;4;4
12304;Vaidilutė;Voveraitė;19402768340;Taip;6;3;0;9
12305;Vaidilutė;Voveraitė;4671287016;Taip;0;0;2;2
12306;Vaidilutė;Voveraitė;3600181974;Taip;4;0;0;4
12307;Vaidilutė;Voveraitė;7419525100;Taip;7;0;0;7
12308;Vaidilutė;Voveraitė;1363913645;Taip;0;1;2;3
12309;Vaidilutė;Voveraitė;5252637701;Taip;2;3;0;5
12310;Vaidilutė;Voveraitė;1320999237;Taip;5;0;2;7
12311;Vaidilutė;Voveraitė;1691407801;Taip;0;0;2;2
12312;Vaidilutė;Voveraitė;1704155743;Taip;11;2;0;13
12313;Vaidilutė;Voveraitė;1139332221;Taip;5;1;0;6
12314;Vaidilutė;Voveraitė;1297817018;Taip;6;0;0;6
12315;Vaidilutė;Voveraitė;9124975928;Taip;0;8;0;8
12316;Vaidilutė;Voveraitė;3202508790;Taip;5;0;4;9
12317;Vaidilutė;Saulutė;20442760894;Taip;0;2;3;5
12318;Vaidilutė;Saulutė;72152961395;Taip;0;1;8;9
12319;Vaidilutė;Saulutė;43033298395;Taip;5;1;0;6
12320;Vaidilutė;Saulutė;11703710695;Taip;0;1;0;1
12321;Vaidilutė;Saulutė;96226651021;Taip;0;2;0;2
12322;Vaidilutė;Saulutė;68447810501;Taip;0;4;0;4
12323;Vaidilutė;Saulutė;66561742513;Taip;0;4;3;7
12324;Vaidilutė;Saulutė;73529326579;Taip;0;0;2;2
12325;Vaidilutė;Saulutė;70212515559;Ne;0;3;3;6
12326;Vaidilutė;Saulutė;91922432702;Taip;0;2;1;3
12327;Vaidilutė;Saulutė;26069775295;Taip;0;2;5;7
12328;Vaidilutė;Saulutė;1928414100;Taip;0;1;1;2
12329;Vaidilutė;Saulutė;1477466080;Taip;0;4;4;8
12330;Vaidilutė;Saulutė;4593200817;Taip;0;4;2;6
12331;Vaidilutė;Saulutė;9994830892;Taip;0;1;1;2
12332;Vaidilutė;Žibutė;5686463470;Taip;6;1;0;7
12333;Vaidilutė;Žibutė;1430802591;Taip;14;0;0;14
12334;Vaidilutė;Žibutė;7843388119;Taip;3;5;0;8
12335;Vaidilutė;Žibutė;2041126370;Taip;4;1;0;5
12336;Vaidilutė;Žibutė;45949026707;Taip;0;2;1;3
12337;Vaidilutė;Žibutė;4259585225;Taip;0;2;1;3
12338;Vaidilutė;Žibutė;4334934114;Taip;6;1;2;9
12339;Vaidilutė;Žibutė;3152118407;Taip;11;0;0;11
12340;Vaidilutė;Žibutė;9669118189;Taip;9;1;0;10
12341;Vaidilutė;Žibutė;5203062837;Taip;15;0;0;15
12342;Vaidilutė;Žibutė;1266927367;Taip;5;9;0;14
12343;Vaidilutė;Žibutė;2941550026;Taip;7;0;0;7
12344;Vaidilutė;Žibutė;1871542885;Taip;13;0;1;14
12345;Vaidilutė;Žibutė;4362797606;Taip;1;1;0;2
12346;Vaidilutė;Žibutė;6322986820;Taip;7;1;0;8
12347;Vaidilutė;Žibutė;5620009051;Taip;6;0;0;6
12348;Vaidilutė;Žibutė;1853463568;Taip;20;0;0;20
12349;Vaidilutė;Žibutė;9556632708;Taip;9;2;0;11
12350;Vaidilutė;Žibutė;3990013866;Taip;7;0;0;7
12351;Vaidilutė;"Ąžuoliukas ";2037322108;Taip;0;2;0;2
12352;Vaidilutė;"Ąžuoliukas ";1179339231;Taip;0;2;0;2
12353;Vaidilutė;"Ąžuoliukas ";92610870394;Taip;7;4;0;11
12354;Vaidilutė;"Ąžuoliukas ";53984070163;Taip;1;7;4;12
12355;Vaidilutė;"Ąžuoliukas ";27368743235;Taip;0;1;0;1
12356;Vaidilutė;"Ąžuoliukas ";14996785673;Taip;0;4;5;9
12357;Vaidilutė;"Ąžuoliukas ";78917497586;Taip;2;0;0;2
12358;Vaidilutė;"Ąžuoliukas ";31536755228;Ne;0;3;0;3
12359;Vaidilutė;"Ąžuoliukas ";47216762092;Taip;6;3;0;9
12360;Vaidilutė;"Ąžuoliukas ";84643800952;Taip;6;1;0;7
12361;Vaidilutė;"Ąžuoliukas ";20252774403;Taip;0;6;1;7
12362;Vaidilutė;"Ąžuoliukas ";34289554601;Taip;0;2;0;2
12363;Vaidilutė;"Ąžuoliukas ";93447858384;Taip;0;1;0;1
12364;Vaidilutė;"Ąžuoliukas ";52258675795;Taip;5;3;0;8
12365;Vaidilutė;"Ąžuoliukas ";51588667084;Taip;5;4;0;9
12366;Vaidilutė;"Ąžuoliukas ";3358680107;Taip;0;2;0;2
12367;Vaidilutė;"Ąžuoliukas ";6742144586;Taip;1;3;0;4
12368;Vaidilutė;"Ąžuoliukas ";7593066460;Ne;6;2;0;8
12369;Vaidilutė;"Žemuogėlė ";57518887320;Taip;0;1;1;2
12370;Vaidilutė;"Žemuogėlė ";56696406197;Taip;0;5;0;5
12371;Vaidilutė;"Žemuogėlė ";1982165935;Taip;9;0;1;10
12372;Vaidilutė;"Žemuogėlė ";77677139178;Taip;4;0;0;4
12373;Vaidilutė;"Žemuogėlė ";14568483659;Taip;0;0;1;1
12374;Vaidilutė;"Žemuogėlė ";88260968683;Taip;0;0;2;2
12375;Vaidilutė;"Žemuogėlė ";95465325875;Taip;3;1;0;4
12376;Vaidilutė;"Žemuogėlė ";83311343448;Taip;0;0;1;1
12377;Vaidilutė;"Žemuogėlė ";68611593221;Taip;0;4;4;8
12378;Vaidilutė;"Žemuogėlė ";41921356356;Taip;0;6;0;6
12379;Vaidilutė;"Žemuogėlė ";2372340492;Taip;5;0;1;6
12380;Vaidilutė;"Žemuogėlė ";36049149219;Taip;0;0;4;4
12381;Vaidilutė;"Žemuogėlė ";5267566919;Taip;0;1;0;1
12382;Vaidilutė;"Žemuogėlė ";2089569687;Taip;1;0;0;1
12383;Vaidilutė;"Žemuogėlė ";2040610033;Taip;0;0;4;4
12384;Vaidilutė;"Žemuogėlė ";4237534907;Taip;0;6;0;6
12385;Vaidilutė;"Vyturėlis ";5821467408;Taip;9;0;0;9
12386;Vaidilutė;"Vyturėlis ";24445906930;Taip;0;1;0;1
12387;Vaidilutė;"Vyturėlis ";83944413409;Taip;2;6;0;8
12388;Vaidilutė;"Vyturėlis ";5116482125;Taip;6;2;0;8
12389;Vaidilutė;"Vyturėlis ";25654419755;Taip;0;1;1;2
12390;Vaidilutė;"Vyturėlis ";2099647381;Taip;1;1;2;4
12391;Vaidilutė;"Vyturėlis ";72248829784;Taip;0;0;4;4
12392;Vaidilutė;"Vyturėlis ";34492341585;Taip;0;6;0;6
12393;Vaidilutė;"Vyturėlis ";79694144428;Taip;2;0;0;2
12394;Vaidilutė;"Vyturėlis ";27107732357;Taip;0;5;0;5
12395;Vaidilutė;"Vyturėlis ";79964507480;Taip;5;2;0;7
12396;Vaidilutė;"Vyturėlis ";10737417556;Taip;12;8;0;20
12397;Vaidilutė;"Vyturėlis ";1416870651;Taip;4;5;0;9
12398;Vaidilutė;"Vyturėlis ";77020716708;Taip;0;0;1;1
12399;Vaidilutė;"Vyturėlis ";87401758633;Taip;19;0;0;19
12400;Vaidilutė;"Vyturėlis ";2067604305;Taip;0;19;0;19
12401;Vaidilutė;"Vyturėlis ";3220471656;Taip;7;1;0;8
12402;Vaidilutė;"Vyturėlis ";94210720777;Taip;7;0;0;7
12403;Vaidilutė;"Vyturėlis ";1315347184;Taip;5;6;1;12
12404;Vaidilutė;"Varpelis ";36556774940;Taip;0;6;3;9
12405;Vaidilutė;"Varpelis ";84723450591;Taip;5;5;0;10
12406;Vaidilutė;"Varpelis ";2852550471;Taip;3;1;0;4
12407;Vaidilutė;"Varpelis ";1047235238;Taip;7;0;0;7
12408;Vaidilutė;"Varpelis ";2033196214;Taip;0;4;0;4
12409;Vaidilutė;"Varpelis ";98968425270;Taip;3;0;2;5
12410;Vaidilutė;"Varpelis ";26241930203;Taip;0;3;1;4
12411;Vaidilutė;"Varpelis ";37901356592;Taip;7;0;2;9
12412;Vaidilutė;"Varpelis ";84467252313;Taip;16;0;0;16
12413;Vaidilutė;"Varpelis ";1564429390;Taip;6;0;0;6
12414;Vaidilutė;"Varpelis ";42328411019;Taip;7;1;0;8
12415;Vaidilutė;"Varpelis ";96794583279;Taip;3;0;4;7
12416;Vaidilutė;"Varpelis ";1974967085;Taip;13;0;0;13
12417;Vaidilutė;"Varpelis ";6758078068;Taip;9;0;2;11
12418;Vaidilutė;"Varpelis ";48928174623;Taip;8;0;2;10
12419;Vaidilutė;"Varpelis ";1556646493;Taip;6;0;1;7
12420;Vaidilutė;"Varpelis ";82558684054;Taip;6;0;3;9
12421;Vaidilutė;"Varpelis ";25071409492;Taip;1;0;3;4
12422;Vaidilutė;"Varpelis ";55183164909;Taip;0;8;0;8
12423;Vaidilutė;"Boružėlių ";8789527552;Taip;0;1;0;1
12424;Vaidilutė;"Boružėlių ";7319037375;Taip;0;4;0;4
12425;Vaidilutė;"Boružėlių ";4838951446;Taip;16;0;0;16
12426;Vaidilutė;"Boružėlių ";7494818866;Taip;0;1;0;1
12427;Vaidilutė;"Boružėlių ";5500950179;Taip;6;0;0;6
12428;Vaidilutė;"Boružėlių ";4954285515;Taip;9;8;0;17
12429;Vaidilutė;"Boružėlių ";1516903980;Taip;18;0;0;18
12430;Vaidilutė;"Boružėlių ";1140011879;Taip;3;0;0;3
12431;Vaidilutė;"Boružėlių ";9563257771;Taip;6;0;0;6
12432;Vaidilutė;"Boružėlių ";2024078532;Taip;5;0;0;5
12433;Vaidilutė;"Boružėlių ";9652684068;Taip;14;0;0;14
12434;Vaidilutė;"Malūnelis ";2763266518;Taip;6;6;1;13
12435;Vaidilutė;"Malūnelis ";6250831269;Taip;9;0;0;9
12436;Vaidilutė;"Malūnelis ";4430382895;Taip;20;0;0;20
12437;Vaidilutė;"Malūnelis ";4159072583;Taip;0;7;2;9
12438;Vaidilutė;"Malūnelis ";6701103931;Taip;14;0;0;14
12439;Vaidilutė;"Malūnelis ";5276088687;Taip;1;2;0;3
12440;Vaidilutė;"Malūnelis ";2081959307;Taip;1;0;3;4
12441;Vaidilutė;"Malūnelis ";8882402632;Taip;6;5;3;14
12442;Vaidilutė;"Malūnelis ";6037349527;Taip;9;0;1;10
12443;Vaidilutė;"Malūnelis ";3832349858;Taip;0;0;1;1
12444;Vaidilutė;"Malūnelis ";9317774960;Taip;0;4;0;4
12445;Vaidilutė;"Malūnelis ";5448014291;Taip;0;6;0;6
12446;Vaidilutė;"Malūnelis ";4280822951;Taip;11;0;0;11
12447;Vaidilutė;"Malūnelis ";5867501558;Taip;3;10;0;13
12448;Vaidilutė;"Riešutėlis ";1941081703;Taip;5;0;0;5
12449;Vaidilutė;"Riešutėlis ";87621682081;Taip;0;4;1;5
12450;Vaidilutė;"Riešutėlis ";76613866916;Taip;10;1;0;11
12451;Vaidilutė;"Riešutėlis ";1942402815;Taip;16;0;0;16
12452;Vaidilutė;"Riešutėlis ";13133501690;Taip;0;0;3;3
12453;Vaidilutė;"Riešutėlis ";8543285470;Taip;7;0;5;12
12454;Vaidilutė;"Riešutėlis ";3962268551;Taip;5;0;0;5
12455;Vaidilutė;"Riešutėlis ";19413698194;Taip;0;0;1;1
12456;Vaidilutė;"Riešutėlis ";83887347923;Taip;0;0;6;6
12457;Vaidilutė;"Riešutėlis ";69452750985;Taip;0;0;5;5
12458;Vaidilutė;"Riešutėlis ";17497609539;Taip;0;1;0;1
12459;Vaidilutė;"Riešutėlis ";38698526742;Taip;7;0;1;8
12460;Vaidilutė;"Riešutėlis ";1664595920;Taip;1;0;2;3
12461;Vaidilutė;"Riešutėlis ";1608286003;Taip;13;0;1;14
12462;Vaidilutė;"Riešutėlis ";1083096707;Taip;0;0;2;2
12463;Vaidilutė;"Riešutėlis ";2397776116;Taip;0;0;17;17
12464;Vaidilutė;"Riešutėlis ";1405802722;Taip;3;1;0;4
12465;Vaidilutė;"Riešutėlis ";67830476121;Taip;5;0;1;6
12466;Vaidilutė;"Riešutėlis ";3243266869;Taip;15;0;0;15
12467;Vandenis;ŽUVĖDRŲ;91659985965;Taip;0;1;0;1
12468;Vandenis;ŽUVĖDRŲ;52063106839;Taip;0;4;0;4
12469;Vandenis;ŽUVĖDRŲ;83799061370;Taip;0;1;0;1
12470;Vandenis;ŽUVĖDRŲ;72923438583;Taip;0;1;0;1
12471;Vandenis;ŽUVĖDRŲ;86007123;Taip;0;8;0;8
12472;Vandenis;ŽUVĖDRŲ;96459201904;Taip;9;0;0;9
12473;Vandenis;ŽUVĖDRŲ;49204161380;Taip;0;3;0;3
12474;Vandenis;ŽUVĖDRŲ;67472126318;Taip;0;1;0;1
12475;Vandenis;ŽUVĖDRŲ;32749176064;Taip;0;4;0;4
12476;Vandenis;ŽUVĖDRŲ;80186166441;Taip;0;2;3;5
12477;Vandenis;ŽUVĖDRŲ;4045401354;Taip;19;0;0;19
12478;Vandenis;ŽUVĖDRŲ;41376432095;Taip;5;3;0;8
12479;Vandenis;ŽUVĖDRŲ;85287618619;Taip;0;18;0;18
12480;Vandenis;ŽUVĖDRŲ;3639803910;Taip;0;1;0;1
12481;Vandenis;ŽUVĖDRŲ;35581230147;Taip;0;4;0;4
12482;Vandenis;ŽUVĖDRŲ;22764351701;Taip;0;2;0;2
12483;Vandenis;ŽUVĖDRŲ;92857304500;Taip;19;1;0;20
12484;Vandenis;ŽUVĖDRŲ;55952119623;Taip;0;1;0;1
12485;Vandenis;ŽUVĖDRŲ;58324898715;Taip;0;1;0;1
12486;Vandenis;ŽUVĖDRŲ;56648967396;Taip;0;6;3;9
12487;Vandenis;ŽUVĖDRŲ;48908599635;Taip;1;9;0;10
12488;Vandenis;RUONIUKŲ;2422642232;Taip;9;1;4;14
12489;Vandenis;RUONIUKŲ;1051281257;Taip;9;1;4;14
12490;Vandenis;RUONIUKŲ;7565308536;Taip;6;0;4;10
12491;Vandenis;RUONIUKŲ;9518434896;Taip;9;1;0;10
12492;Vandenis;RUONIUKŲ;2638433939;Taip;6;0;0;6
12493;Vandenis;RUONIUKŲ;1120907086;Taip;6;1;3;10
12494;Vandenis;RUONIUKŲ;1563710105;Taip;12;0;0;12
12495;Vandenis;RUONIUKŲ;7702272913;Taip;8;0;0;8
12496;Vandenis;RUONIUKŲ;6476051751;Taip;5;4;0;9
12497;Vandenis;RUONIUKŲ;9162936403;Taip;0;0;3;3
12498;Vandenis;RUONIUKŲ;4713395766;Taip;1;11;0;12
12499;Vandenis;RUONIUKŲ;6986724058;Taip;4;2;0;6
12500;Vandenis;RUONIUKŲ;7754158588;Taip;10;0;0;10
12501;Vandenis;RUONIUKŲ;9731729915;Taip;5;0;1;6
12502;Vandenis;RUONIUKŲ;9527253920;Taip;11;0;0;11
12503;Vandenis;RUONIUKŲ;8971291182;Taip;8;0;2;10
12504;Vandenis;ŽUVYČIŲ;1381872682;Taip;1;4;1;6
12505;Vandenis;ŽUVYČIŲ;46710726661;Taip;9;6;0;15
12506;Vandenis;ŽUVYČIŲ;36923046515;Taip;6;4;0;10
12507;Vandenis;ŽUVYČIŲ;73799053361;Taip;0;8;0;8
12508;Vandenis;ŽUVYČIŲ;62551219837;Taip;5;0;0;5
12509;Vandenis;ŽUVYČIŲ;18019716512;Taip;6;4;4;14
12510;Vandenis;ŽUVYČIŲ;8894986967;Taip;6;2;0;8
12511;Vandenis;ŽUVYČIŲ;11100629204;Taip;0;5;0;5
12512;Vandenis;ŽUVYČIŲ;50378723799;Taip;0;6;2;8
12513;Vandenis;ŽUVYČIŲ;50682359453;Taip;0;6;1;7
12514;Vandenis;ŽUVYČIŲ;25215508382;Taip;6;3;0;9
12515;Vandenis;ŽUVYČIŲ;50355487806;Taip;3;1;0;4
12516;Vandenis;ŽUVYČIŲ;93927825477;Taip;0;2;0;2
12517;Vandenis;ŽUVYČIŲ;32076192238;Taip;1;3;1;5
12518;Vandenis;ŽUVYČIŲ;42672846405;Taip;0;5;0;5
12519;Vandenis;ŽUVYČIŲ;48268115297;Taip;0;1;0;1
12520;Vandenis;ŽUVYČIŲ;67325111493;Taip;0;4;0;4
12521;Vandenis;ŽUVYČIŲ;888708348;Taip;0;4;0;4
12522;Vandenis;ŽUVYČIŲ;57050923237;Taip;0;5;0;5
12523;Vandenis;ŽUVYČIŲ;32078254928;Taip;0;4;0;4
12524;Vandenis;PERLIUKŲ;28286348996;Taip;10;2;0;12
12525;Vandenis;PERLIUKŲ;20458211098;Taip;4;1;0;5
12526;Vandenis;PERLIUKŲ;47333381244;Taip;11;0;0;11
12527;Vandenis;PERLIUKŲ;95498596116;Taip;8;4;0;12
12528;Vandenis;PERLIUKŲ;39662768043;Taip;12;0;0;12
12529;Vandenis;PERLIUKŲ;391453841;Taip;17;1;0;18
12530;Vandenis;PERLIUKŲ;32087433270;Taip;10;1;0;11
12531;Vandenis;PERLIUKŲ;50009330411;Taip;0;4;0;4
12532;Vandenis;PERLIUKŲ;318399174;Taip;0;7;0;7
12533;Vandenis;PERLIUKŲ;57251416305;Taip;0;1;0;1
12534;Vandenis;PERLIUKŲ;54659569326;Taip;10;0;0;10
12535;Vandenis;PERLIUKŲ;69485657846;Taip;0;2;0;2
12536;Vandenis;PERLIUKŲ;54762939917;Taip;12;0;0;12
12537;Vandenis;PERLIUKŲ;45362889638;Taip;12;1;0;13
12538;Vandenis;PERLIUKŲ;33177236893;Taip;3;4;0;7
12539;Vandenis;PERLIUKŲ;23752943243;Taip;12;0;0;12
12540;Vandenis;PERLIUKŲ;35977990277;Ne;9;11;0;20
12541;Vandenis;PERLIUKŲ;66499269949;Taip;0;2;0;2
12542;Vandenis;PERLIUKŲ;59487083886;Taip;0;2;0;2
12543;Vandenis;PERLIUKŲ;51472939588;Taip;14;0;0;14
12544;Vandenis;PERLIUKŲ;83480564066;Taip;0;2;1;3
12545;Vandenis;PERLIUKŲ;1493719754;Taip;6;2;0;8
12546;Vandenis;ANČIUKŲ;8233407105;Taip;0;7;0;7
12547;Vandenis;ANČIUKŲ;1282499654;Taip;0;7;0;7
12548;Vandenis;ANČIUKŲ;5395847317;Taip;11;0;0;11
12549;Vandenis;ANČIUKŲ;3243079651;Taip;4;0;0;4
12550;Vandenis;ANČIUKŲ;3938359901;Taip;0;4;0;4
12551;Vandenis;ANČIUKŲ;1314724267;Taip;0;1;0;1
12552;Vandenis;ANČIUKŲ;8251169901;Ne;14;2;0;16
12553;Vandenis;ANČIUKŲ;4750141780;Taip;6;2;0;8
12554;Vandenis;ANČIUKŲ;6181866272;Taip;0;8;0;8
12555;Vandenis;ANČIUKŲ;7522472652;Taip;1;0;0;1
12556;Vandenis;ANČIUKŲ;7630017843;Taip;10;0;0;10
12557;Vandenis;ANČIUKŲ;1222539247;Taip;5;4;0;9
12558;Vandenis;ANČIUKŲ;3067868099;Taip;0;3;0;3
12559;Vandenis;ANČIUKŲ;8511948282;Taip;20;0;0;20
12560;Vandenis;ANČIUKŲ;33317650043;Taip;3;2;0;5
12561;Vandenis;ANČIUKŲ;1739780612;Taip;13;0;0;13
12562;Vandenis;ANČIUKŲ;2489776665;Taip;17;0;0;17
12563;Vandenis;ANČIUKŲ;71786730314;Taip;9;1;0;10
12564;Vandenis;ANČIUKŲ;1621481561;Taip;17;0;0;17
12565;Vandenis;ANČIUKŲ;33782837791;Taip;5;2;0;7
12566;Vandenis;VĖŽLIUKŲ;39832993343;Taip;5;5;0;10
12567;Vandenis;VĖŽLIUKŲ;69715525764;Taip;4;0;0;4
12568;Vandenis;VĖŽLIUKŲ;2120420294;Taip;0;0;1;1
12569;Vandenis;VĖŽLIUKŲ;70732367996;Ne;10;1;1;12
12570;Vandenis;VĖŽLIUKŲ;88097898349;Taip;0;1;0;1
12571;Vandenis;VĖŽLIUKŲ;20843785079;Taip;4;0;0;4
12572;Vandenis;VĖŽLIUKŲ;56883076424;Taip;5;1;0;6
12573;Vandenis;VĖŽLIUKŲ;16402149104;Taip;7;0;0;7
12574;Vandenis;VĖŽLIUKŲ;17644420312;Taip;0;1;0;1
12575;Vandenis;VĖŽLIUKŲ;26057060619;Taip;6;1;0;7
12576;Vandenis;VĖŽLIUKŲ;55331810310;Taip;0;14;0;14
12577;Vandenis;VĖŽLIUKŲ;48194812760;Taip;11;4;0;15
12578;Vandenis;VĖŽLIUKŲ;84025519453;Taip;0;4;0;4
12579;Vandenis;VĖŽLIUKŲ;5363853315;Taip;0;9;7;16
12580;Vandenis;VĖŽLIUKŲ;85054617489;Taip;0;18;0;18
12581;Vandenis;VĖŽLIUKŲ;61521559336;Taip;12;0;0;12
12582;Vandenis;VĖŽLIUKŲ;87310831307;Taip;0;5;0;5
12583;Vandenis;VĖŽLIUKŲ;63629799884;Taip;1;4;0;5
12584;Vandenis;VĖŽLIUKŲ;1646554203;Taip;6;1;4;11
12585;Vandenis;VĖŽLIUKŲ;2056980868;Taip;19;0;0;19
12586;Vandenis;VĖŽLIUKŲ;92286914041;Taip;0;4;0;4
12587;Vandenis;AŠTUNKOJŲ;56729656278;Taip;0;2;0;2
12588;Vandenis;AŠTUNKOJŲ;39139875955;Taip;5;3;0;8
12589;Vandenis;AŠTUNKOJŲ;57302718152;Taip;0;5;0;5
12590;Vandenis;AŠTUNKOJŲ;6799539977;Taip;5;1;0;6
12591;Vandenis;AŠTUNKOJŲ;69980435432;Taip;0;4;0;4
12592;Vandenis;AŠTUNKOJŲ;83350314727;Taip;0;4;0;4
12593;Vandenis;AŠTUNKOJŲ;91232893198;Ne;3;1;0;4
12594;Vandenis;AŠTUNKOJŲ;56253560020;Taip;0;2;0;2
12595;Vandenis;AŠTUNKOJŲ;2576662589;Taip;0;3;0;3
12596;Vandenis;AŠTUNKOJŲ;40001674016;Ne;0;13;0;13
12597;Vandenis;AŠTUNKOJŲ;42776106653;Taip;5;0;0;5
12598;Vandenis;AŠTUNKOJŲ;66990746959;Taip;0;5;0;5
12599;Vandenis;AŠTUNKOJŲ;93109763820;Taip;0;4;0;4
12600;Vandenis;AŠTUNKOJŲ;10706508637;Taip;0;2;0;2
12601;Vandenis;AŠTUNKOJŲ;42690205977;Taip;0;10;0;10
12602;Vandenis;AŠTUNKOJŲ;37019206511;Taip;0;12;0;12
12603;Vandenis;AŠTUNKOJŲ;88415992702;Taip;9;1;0;10
12604;Vandenis;AŠTUNKOJŲ;11953155563;Taip;0;3;0;3
12605;Vandenis;GANDRIUKŲ;1455424753;Taip;19;0;0;19
12606;Vandenis;GANDRIUKŲ;6048257249;Taip;0;4;0;4
12607;Vandenis;GANDRIUKŲ;1029909269;Taip;10;5;0;15
12608;Vandenis;GANDRIUKŲ;11961797041;Taip;0;5;1;6
12609;Vandenis;GANDRIUKŲ;16608149961;Taip;0;4;0;4
12610;Vandenis;GANDRIUKŲ;80422278900;Taip;0;2;0;2
12611;Vandenis;GANDRIUKŲ;33029527496;Taip;0;5;0;5
12612;Vandenis;GANDRIUKŲ;83265714438;Taip;9;1;0;10
12613;Vandenis;GANDRIUKŲ;4633003964;Taip;8;3;0;11
12614;Vandenis;GANDRIUKŲ;89197182757;Taip;0;8;0;8
12615;Vandenis;GANDRIUKŲ;1498815019;Taip;14;0;0;14
12616;Vandenis;GANDRIUKŲ;9999045766;Taip;0;1;0;1
12617;Vandenis;GANDRIUKŲ;1397176489;Taip;0;9;0;9
12618;Vandenis;GANDRIUKŲ;54770618599;Taip;0;2;0;2
12619;Vandenis;GANDRIUKŲ;10538645159;Ne;10;2;3;15
12620;Vandenis;GANDRIUKŲ;20957822945;Taip;10;5;1;16
12621;Vandenis;GANDRIUKŲ;13943773510;Taip;11;0;0;11
12622;Vandenis;GANDRIUKŲ;47997751365;Taip;0;5;0;5
12623;Vandenis;GANDRIUKŲ;91684805923;Taip;0;2;11;13
12624;Vandenis;GANDRIUKŲ;48076017461;Taip;11;1;0;12
12625;Vandenis;ŽĄSIUKAI;80643665990;Taip;0;6;0;6
12626;Vandenis;ŽĄSIUKAI;74138671368;Taip;0;3;0;3
12627;Vandenis;ŽĄSIUKAI;25459674313;Taip;10;4;0;14
12628;Vandenis;ŽĄSIUKAI;2812520834;Taip;0;5;0;5
12629;Vandenis;ŽĄSIUKAI;1286716632;Taip;6;4;0;10
12630;Vandenis;ŽĄSIUKAI;11527007102;Taip;6;5;0;11
12631;Vandenis;ŽĄSIUKAI;1373653402;Taip;8;0;0;8
12632;Vandenis;ŽĄSIUKAI;65840410497;Taip;6;5;0;11
12633;Vandenis;ŽĄSIUKAI;53658866238;Taip;6;7;0;13
12634;Vandenis;ŽĄSIUKAI;1217508516;Taip;15;1;0;16
12635;Vandenis;ŽĄSIUKAI;55238344586;Taip;11;1;0;12
12636;Vandenis;ŽĄSIUKAI;25934798454;Taip;0;4;0;4
12637;Vandenis;ŽĄSIUKAI;2029167786;Taip;9;0;0;9
12638;Vandenis;ŽĄSIUKAI;23439586487;Taip;9;0;0;9
12639;Vandenis;ŽĄSIUKAI;78917527699;Taip;7;2;0;9
12640;Vandenis;ŽĄSIUKAI;1397125827;Taip;0;7;0;7
12641;Vandenis;ŽĄSIUKAI;46916815441;Taip;2;1;0;3
12642;Vandenis;ŽĄSIUKAI;1155423158;Taip;10;6;0;16
12643;Vandenis;ŽĄSIUKAI;7333587583;Taip;3;0;0;3
12644;Vandenis;ŽĄSIUKAI;18417531508;Taip;0;1;0;1
12645;Vandenis;PURIENŲ;2114436962;Taip;10;0;0;10
12646;Vandenis;PURIENŲ;877974909;Taip;5;2;0;7
12647;Vandenis;PURIENŲ;3823382249;Taip;0;1;0;1
12648;Vandenis;PURIENŲ;43295720034;Taip;0;6;0;6
12649;Vandenis;PURIENŲ;84636435681;Taip;7;0;0;7
12650;Vandenis;PURIENŲ;1958929302;Taip;0;3;0;3
12651;Vandenis;PURIENŲ;39973189502;Taip;5;0;0;5
12652;Vandenis;PURIENŲ;2096950367;Taip;0;2;0;2
12653;Vandenis;PURIENŲ;1633589144;Taip;13;0;0;13
12654;Vandenis;PURIENŲ;1854498462;Taip;0;2;0;2
12655;Vandenis;PURIENŲ;6673346389;Taip;11;0;0;11
12656;Vandenis;PURIENŲ;7168910452;Taip;15;0;0;15
12657;Vandenis;PURIENŲ;58997790744;Taip;5;1;0;6
12658;Vandenis;PURIENŲ;61120985165;Taip;0;2;0;2
12659;Vandenis;PURIENŲ;38137368394;Taip;7;0;0;7
12660;Vandenis;PURIENŲ;81817138188;Taip;8;0;0;8
12661;Vandenis;PURIENŲ;86947904365;Taip;1;2;0;3
12662;Vandenis;PURIENŲ;1395272045;Taip;0;4;0;4
12663;Vandenis;PURIENŲ;3740778932;Taip;0;1;0;1
12664;Vandenis;VARLIUKAI;7091356848;Taip;7;1;0;8
12665;Vandenis;VARLIUKAI;8116532445;Taip;12;0;0;12
12666;Vandenis;VARLIUKAI;7069369080;Taip;12;0;0;12
12667;Vandenis;VARLIUKAI;7924399684;Taip;3;3;0;6
12668;Vandenis;VARLIUKAI;5454049563;Taip;11;2;0;13
12669;Vandenis;VARLIUKAI;9805578141;Taip;11;2;0;13
12670;Vandenis;VARLIUKAI;8921666108;Taip;11;9;0;20
12671;Vandenis;VARLIUKAI;6011280420;Taip;20;0;0;20
12672;Vandenis;VARLIUKAI;1187395353;Taip;20;0;0;20
12673;Vandenis;VARLIUKAI;1081385111;Taip;11;0;0;11
12674;Vandenis;VARLIUKAI;9158541919;Taip;16;0;0;16
12675;Vandenis;VARLIUKAI;5959181898;Taip;16;0;0;16
12676;Vandenis;VARLIUKAI;7059385610;Taip;1;4;0;5
12677;Vandenis;VARLIUKAI;2645775090;Taip;6;1;0;7
12678;Vandenis;PINGVINAI;9994373029;Taip;11;0;0;11
12679;Vandenis;PINGVINAI;3544717790;Taip;9;1;0;10
12680;Vandenis;PINGVINAI;4085256182;Taip;1;1;0;2
12681;Vandenis;PINGVINAI;18336904438;Taip;0;1;0;1
12682;Vandenis;PINGVINAI;8689134931;Taip;0;1;0;1
12683;Vandenis;PINGVINAI;9608871155;Taip;0;1;0;1
12684;Vandenis;PINGVINAI;64711327503;Taip;10;4;0;14
12685;Vandenis;PINGVINAI;7381695975;Taip;4;1;0;5
12686;Vandenis;PINGVINAI;43933878402;Taip;0;5;0;5
12687;Vandenis;PINGVINAI;55421695186;Taip;0;2;1;3
12688;Vandenis;PINGVINAI;24217366528;Taip;9;6;0;15
12689;Vandenis;PINGVINAI;5549292096;Taip;8;3;0;11
12690;Vandenis;PINGVINAI;7408758565;Taip;1;0;0;1
12691;Vandenis;PINGVINAI;4643267945;Taip;0;8;0;8
12692;Vandenis;PINGVINAI;35673258175;Taip;6;0;2;8
12693;Vandenis;PINGVINAI;27409922803;Taip;9;0;1;10
12694;Vėjelis;Pumpurėliai;58369004570;Taip;0;1;0;1
12695;Vėjelis;Pumpurėliai;54924516732;Taip;0;5;0;5
12696;Vėjelis;Pumpurėliai;59692503363;Taip;8;0;0;8
12697;Vėjelis;Pumpurėliai;25872613643;Taip;0;0;1;1
12698;Vėjelis;Pumpurėliai;38106696628;Taip;0;11;0;11
12699;Vėjelis;Pumpurėliai;8653964270;Taip;0;3;0;3
12700;Vėjelis;Pumpurėliai;88817521596;Taip;0;2;0;2
12701;Vėjelis;Pumpurėliai;53270546031;Taip;10;0;0;10
12702;Vėjelis;Pumpurėliai;53587810020;Taip;0;1;1;2
12703;Vėjelis;Pumpurėliai;18902976827;Taip;4;1;0;5
12704;Vėjelis;Pumpurėliai;58314846835;Taip;0;11;0;11
12705;Vėjelis;Pumpurėliai;34584409245;Taip;0;7;0;7
12706;Vėjelis;Pumpurėliai;63893850632;Taip;0;2;0;2
12707;Vėjelis;Pumpurėliai;23799231345;Taip;0;7;0;7
12708;Vėjelis;Pumpurėliai;95469370742;Taip;0;1;1;2
12709;Vėjelis;Pumpurėliai;14212441124;Taip;0;2;0;2
12710;Vėjelis;Pumpurėliai;53379180843;Taip;0;4;0;4
12711;Vėjelis;Pumpurėliai;17523450164;Taip;0;2;0;2
12712;Vėjelis;Pumpurėliai;5365237487;Taip;0;1;1;2
12713;Vėjelis;Pumpurėliai;3965445196;Taip;10;1;0;11
12714;Vėjelis;Pumpurėliai;2301011427;Taip;5;2;0;7
12715;Vėjelis;Drugeliai;4746932126;Taip;5;5;0;10
12716;Vėjelis;Drugeliai;1978952781;Taip;8;0;0;8
12717;Vėjelis;Drugeliai;8353084814;Taip;0;2;0;2
12718;Vėjelis;Drugeliai;1115802837;Taip;10;0;2;12
12719;Vėjelis;Drugeliai;2416832899;Taip;4;0;0;4
12720;Vėjelis;Drugeliai;4741154518;Taip;1;0;0;1
12721;Vėjelis;Drugeliai;1494531065;Taip;3;0;0;3
12722;Vėjelis;Drugeliai;3276062426;Taip;18;0;0;18
12723;Vėjelis;Drugeliai;9298789434;Taip;11;0;1;12
12724;Vėjelis;Drugeliai;2734024890;Taip;10;2;0;12
12725;Vėjelis;Drugeliai;7981032872;Taip;0;4;0;4
12726;Vėjelis;Drugeliai;7133454882;Taip;0;7;5;12
12727;Vėjelis;Drugeliai;2000277444;Taip;4;0;2;6
12728;Vėjelis;Drugeliai;7752923796;Taip;0;0;1;1
12729;Vėjelis;Drugeliai;7594586198;Taip;5;0;0;5
12730;Vėjelis;Drugeliai;7697394469;Taip;15;0;0;15
12731;Vėjelis;Drugeliai;4066956765;Taip;10;0;0;10
12732;Vėjelis;Drugeliai;9696910320;Taip;15;0;0;15
12733;Vėjelis;Malūnėlis;63002531941;Taip;0;5;0;5
12734;Vėjelis;Malūnėlis;16498317981;Taip;0;3;0;3
12735;Vėjelis;Malūnėlis;93859592652;Taip;5;1;0;6
12736;Vėjelis;Malūnėlis;12149443904;Taip;18;0;0;18
12737;Vėjelis;Malūnėlis;69740475863;Ne;0;1;0;1
12738;Vėjelis;Malūnėlis;20148908290;Taip;2;0;2;4
12739;Vėjelis;Malūnėlis;39671245978;Taip;18;0;0;18
12740;Vėjelis;Malūnėlis;1209526192;Taip;0;2;0;2
12741;Vėjelis;Malūnėlis;58121447313;Taip;0;0;2;2
12742;Vėjelis;Malūnėlis;68958036563;Taip;3;4;0;7
12743;Vėjelis;Malūnėlis;20593684676;Taip;11;0;0;11
12744;Vėjelis;Malūnėlis;64104308245;Taip;0;1;2;3
12745;Vėjelis;Malūnėlis;14502736200;Taip;5;4;0;9
12746;Vėjelis;Malūnėlis;98024305748;Taip;0;3;0;3
12747;Vėjelis;Malūnėlis;5735207486;Taip;0;1;0;1
12748;Vėjelis;Malūnėlis;4194366404;Taip;5;6;1;12
12749;Vėjelis;Malūnėlis;1603377234;Taip;5;2;0;7
12750;Vėjelis;Malūnėlis;87555226002;Taip;0;5;0;5
12751;Vėjelis;Žvaigždutės;1295818672;Taip;1;4;0;5
12752;Vėjelis;Žvaigždutės;1612878387;Taip;11;2;0;13
12753;Vėjelis;Žvaigždutės;3485366651;Taip;0;8;0;8
12754;Vėjelis;Žvaigždutės;5139323880;Taip;20;0;0;20
12755;Vėjelis;Žvaigždutės;2363974247;Taip;12;0;0;12
12756;Vėjelis;Žvaigždutės;86337749074;Taip;14;0;0;14
12757;Vėjelis;Žvaigždutės;8379298947;Taip;12;0;0;12
12758;Vėjelis;Žvaigždutės;47986392996;Taip;12;1;0;13
12759;Vėjelis;Žvaigždutės;7610485310;Taip;0;20;0;20
12760;Vėjelis;Žvaigždutės;90647333398;Taip;14;0;0;14
12761;Vėjelis;Žvaigždutės;40744700561;Taip;0;12;0;12
12762;Vėjelis;Žvaigždutės;26328498777;Taip;5;0;0;5
12763;Vėjelis;Žvaigždutės;47143492836;Taip;5;5;0;10
12764;Vėjelis;Žvaigždutės;69341469387;Taip;5;7;0;12
12765;Vėjelis;Žvaigždutės;9190085358;Taip;10;10;0;20
12766;Vėjelis;Žvaigždutės;56520156825;Taip;6;9;0;15
12767;Vėjelis;Žvaigždutės;90103717718;Taip;1;4;0;5
12768;Vėjelis;Žvaigždutės;8949760376;Taip;10;1;0;11
12769;Vėjelis;Žvaigždutės;6002719498;Taip;0;19;0;19
12770;Vėjelis;Žvaigždutės;9000966115;Taip;0;8;0;8
12771;Vėjelis;Varpeliai;2759958482;Taip;1;5;0;6
12772;Vėjelis;Varpeliai;898039829;Taip;12;1;0;13
12773;Vėjelis;Varpeliai;58968869099;Taip;14;0;0;14
12774;Vėjelis;Varpeliai;25190615976;Taip;14;0;0;14
12775;Vėjelis;Varpeliai;19701264312;Taip;8;0;0;8
12776;Vėjelis;Varpeliai;28696711850;Taip;11;1;0;12
12777;Vėjelis;Varpeliai;47402024682;Taip;8;3;0;11
12778;Vėjelis;Varpeliai;8787363287;Taip;3;9;0;12
12779;Vėjelis;Varpeliai;90573854976;Taip;4;1;0;5
12780;Vėjelis;Varpeliai;83608030842;Taip;10;0;0;10
12781;Vėjelis;Varpeliai;53440131428;Taip;11;0;0;11
12782;Vėjelis;Varpeliai;71456994638;Taip;7;1;0;8
12783;Vėjelis;Varpeliai;14157070764;Taip;16;0;0;16
12784;Vėjelis;Varpeliai;90996312461;Taip;6;6;0;12
12785;Vėjelis;Varpeliai;86680640521;Taip;11;0;0;11
12786;Vėjelis;Varpeliai;46016776013;Taip;11;0;0;11
12787;Vėjelis;Varpeliai;1944266562;Taip;8;0;2;10
12788;Vėjelis;Varpeliai;94214534219;Taip;5;1;0;6
12789;Vėjelis;Varpeliai;89044270439;Taip;4;0;9;13
12790;Vėjelis;Varpeliai;3214710339;Taip;6;0;0;6
12791;Vėjelis;Varpeliai;80942260332;Taip;8;3;0;11
12792;Vėjelis;Varpeliai;80423879616;Taip;0;6;0;6
12793;Vėjelis;Pelėdžiukų;1563935993;Taip;9;0;0;9
12794;Vėjelis;Pelėdžiukų;1467023330;Taip;0;1;0;1
12795;Vėjelis;Pelėdžiukų;1238171728;Taip;6;0;0;6
12796;Vėjelis;Pelėdžiukų;5992665537;Taip;0;5;0;5
12797;Vėjelis;Pelėdžiukų;4024898537;Taip;11;0;0;11
12798;Vėjelis;Pelėdžiukų;24011371444;Taip;19;0;0;19
12799;Vėjelis;Pelėdžiukų;2819491961;Taip;14;0;0;14
12800;Vėjelis;Pelėdžiukų;1990674632;Taip;6;1;0;7
12801;Vėjelis;Pelėdžiukų;1783878104;Taip;0;4;0;4
12802;Vėjelis;Pelėdžiukų;55075988807;Taip;0;1;0;1
12803;Vėjelis;Pelėdžiukų;8033732937;Taip;0;1;0;1
12804;Vėjelis;Pelėdžiukų;6618114389;Taip;5;8;0;13
12805;Vėjelis;Pelėdžiukų;1510415602;Taip;9;0;2;11
12806;Vėjelis;Pelėdžiukų;2042863944;Taip;0;2;0;2
12807;Vėjelis;Pelėdžiukų;1347855869;Taip;12;0;0;12
12808;Vėjelis;Pelėdžiukų;1719502147;Taip;0;0;2;2
12809;Vėjelis;Pelėdžiukų;2128818222;Taip;0;0;4;4
12810;Vėjelis;Pelėdžiukų;4930807661;Taip;11;2;1;14
12811;Vėjelis;Pelėdžiukų;1518855620;Taip;5;4;0;9
12812;Vėjelis;Skruzdeliukų;2021887954;Taip;0;4;0;4
12813;Vėjelis;Skruzdeliukų;1267672356;Taip;5;0;0;5
12814;Vėjelis;Skruzdeliukų;90185075321;Taip;6;0;0;6
12815;Vėjelis;Skruzdeliukų;1640356242;Taip;5;3;0;8
12816;Vėjelis;Skruzdeliukų;86128256406;Taip;5;5;0;10
12817;Vėjelis;Skruzdeliukų;41268510292;Taip;13;1;0;14
12818;Vėjelis;Skruzdeliukų;57285479257;Taip;0;1;0;1
12819;Vėjelis;Skruzdeliukų;44482585723;Taip;0;3;0;3
12820;Vėjelis;Skruzdeliukų;77205958956;Taip;20;0;0;20
12821;Vėjelis;Skruzdeliukų;2718251356;Taip;0;0;10;10
12822;Vėjelis;Skruzdeliukų;1934426525;Taip;0;10;0;10
12823;Vėjelis;Skruzdeliukų;64339770365;Taip;0;12;0;12
12824;Vėjelis;Skruzdeliukų;44153389025;Taip;8;4;0;12
12825;Vėjelis;Skruzdeliukų;1284286578;Taip;13;0;0;13
12826;Vėjelis;Skruzdeliukų;1789982154;Taip;5;9;0;14
12827;Vėjelis;Skruzdeliukų;75596757609;Taip;0;0;2;2
12828;Vėjelis;Pieštukų;3255066035;Taip;17;0;0;17
12829;Vėjelis;Pieštukų;76305473353;Taip;0;6;4;10
12830;Vėjelis;Pieštukų;50124109589;Taip;0;20;0;20
12831;Vėjelis;Pieštukų;4853650350;Taip;0;10;0;10
12832;Vėjelis;Pieštukų;73287916371;Taip;0;13;0;13
12833;Vėjelis;Pieštukų;60890519853;Taip;0;4;0;4
12834;Vėjelis;Pieštukų;78490601352;Taip;12;0;0;12
12835;Vėjelis;Pieštukų;8386409466;Taip;0;0;18;18
12836;Vėjelis;Pieštukų;8938491367;Taip;8;5;0;13
12837;Vėjelis;Pieštukų;9492690970;Taip;0;6;0;6
12838;Vėjelis;Pieštukų;6386092350;Taip;10;10;0;20
12839;Vėjelis;Pieštukų;8684461171;Taip;0;10;0;10
12840;Vėjelis;Pieštukų;8973530484;Taip;9;0;1;10
12841;Vėjelis;Pieštukų;98588113289;Taip;11;0;0;11
12842;Vėjelis;Pieštukų;4067153819;Taip;0;0;3;3
12843;Vėjelis;Pieštukų;9395929106;Taip;5;9;0;14
12844;Vėjelis;Pieštukų;1205392813;Taip;0;6;0;6
12845;Vėjelis;Pieštukų;5031781196;Taip;9;0;0;9
12846;Vėjelis;Ramunėlių;5987294293;Taip;10;4;0;14
12847;Vėjelis;Ramunėlių;8047799576;Taip;15;0;0;15
12848;Vėjelis;Ramunėlių;4745262277;Taip;0;6;0;6
12849;Vėjelis;Ramunėlių;4353239658;Taip;6;0;0;6
12850;Vėjelis;Ramunėlių;7178844364;Taip;0;1;0;1
12851;Vėjelis;Ramunėlių;2164009051;Taip;11;1;0;12
12852;Vėjelis;Ramunėlių;2386927970;Taip;18;1;0;19
12853;Vėjelis;Ramunėlių;2124857941;Taip;13;2;0;15
12854;Vėjelis;Ramunėlių;6455798848;Taip;12;2;0;14
12855;Vėjelis;Ramunėlių;2999425729;Taip;20;0;0;20
12856;Vėjelis;Ramunėlių;6996900411;Taip;5;7;0;12
12857;Vėjelis;Ramunėlių;2289954824;Taip;9;1;0;10
12858;Vėjelis;Ramunėlių;1717847351;Taip;11;1;0;12
12859;Vėjelis;Ramunėlių;6777528441;Taip;0;6;0;6
12860;Vėjelis;Ramunėlių;6891260701;Taip;0;9;0;9
12861;Vėjelis;Ramunėlių;2151737048;Taip;20;0;0;20
12862;Vėjelis;Ramunėlių;7836199284;Taip;10;8;0;18
12863;Vėjelis;Nykštukai;43342043904;Taip;0;3;0;3
12864;Vėjelis;Nykštukai;22865699640;Taip;0;6;0;6
12865;Vėjelis;Nykštukai;12487059850;Taip;6;0;0;6
12866;Vėjelis;Nykštukai;20492762368;Taip;0;6;0;6
12867;Vėjelis;Nykštukai;1008705526;Taip;5;1;1;7
12868;Vėjelis;Nykštukai;1251348150;Taip;0;4;0;4
12869;Vėjelis;Nykštukai;85352317063;Taip;9;1;0;10
12870;Vėjelis;Nykštukai;41673970488;Taip;0;2;0;2
12871;Vėjelis;Nykštukai;89943712210;Taip;10;4;0;14
12872;Vėjelis;Nykštukai;64628040227;Taip;0;7;0;7
12873;Vėjelis;Nykštukai;33235320630;Taip;0;11;0;11
12874;Vėjelis;Nykštukai;29087363179;Taip;0;10;0;10
12875;Vėjelis;Nykštukai;2132492766;Taip;2;1;6;9
12876;Vėjelis;Nykštukai;8226906949;Taip;20;0;0;20
12877;Vėjelis;Nykštukai;5207473829;Taip;6;0;0;6
12878;Vėjelis;Nykštukai;4938939921;Taip;4;13;0;17
12879;Vėjelis;Nykštukai;72881976363;Taip;0;2;0;2
12880;Vėjelis;Nykštukai;78465993753;Ne;20;0;0;20
12881;Vėjelis;Nykštukai;63900641942;Taip;0;2;0;2
12882;Vėjelis;Nykštukai;14754302946;Taip;0;4;0;4
12883;Vėjelis;Nykštukai;1053502203;Ne;6;9;0;15
12884;Vėjelis;Nykštukai;47716333909;Taip;0;16;0;16
12885;Vėjelis;BITUTĖS;5902455219;Taip;0;10;0;10
12886;Vėjelis;BITUTĖS;4831426440;Taip;6;4;2;12
12887;Vėjelis;BITUTĖS;74475070018;Taip;0;5;0;5
12888;Vėjelis;BITUTĖS;5517128872;Taip;9;1;1;11
12889;Vėjelis;BITUTĖS;6724813553;Taip;11;0;0;11
12890;Vėjelis;BITUTĖS;4451119031;Taip;6;11;0;17
12891;Vėjelis;BITUTĖS;8721116918;Taip;5;0;0;5
12892;Vėjelis;BITUTĖS;1270627404;Taip;11;0;0;11
12893;Vėjelis;BITUTĖS;2575398136;Taip;11;0;0;11
12894;Vėjelis;BITUTĖS;3584347608;Taip;3;3;0;6
12895;Vėjelis;BITUTĖS;9108653045;Taip;5;0;0;5
12896;Vėjelis;BITUTĖS;5508269515;Taip;10;1;0;11
12897;Vėjelis;BITUTĖS;8998452731;Taip;13;0;0;13
12898;Vėjelis;BITUTĖS;9672929606;Taip;7;1;4;12
12899;Vėjelis;BITUTĖS;6451722893;Taip;20;0;0;20
12900;Vėjelis;BITUTĖS;5909697341;Taip;0;6;0;6
12901;Vėjelis;BITUTĖS;8668671325;Taip;11;0;0;11
12902;Vėjelis;BITUTĖS;9754373141;Taip;5;0;0;5
12903;Vėjelis;BITUTĖS;4906958328;Taip;6;0;0;6
12904;Vėjelis;Boruželės;2199680661;Taip;0;5;0;5
12905;Vėjelis;Boruželės;5325081841;Taip;0;5;0;5
12906;Vėjelis;Boruželės;5381588565;Taip;0;8;0;8
12907;Vėjelis;Boruželės;1863210064;Taip;0;8;0;8
12908;Vėjelis;Boruželės;9037622738;Taip;5;0;0;5
12909;Vėjelis;Boruželės;8553966497;Taip;3;10;0;13
12910;Vėjelis;Boruželės;1588345134;Taip;0;0;2;2
12911;Vėjelis;Boruželės;1751533938;Taip;20;0;0;20
12912;Vėjelis;Boruželės;4733227215;Taip;20;0;0;20
12913;Vėjelis;Boruželės;1429496839;Taip;5;1;0;6
12914;Vėjelis;Boruželės;1931659200;Taip;20;0;0;20
12915;Vėjelis;Boruželės;1076538028;Taip;10;0;0;10
12916;Vėjelis;Boruželės;6658178519;Taip;19;0;0;19
12917;Vėjelis;Boruželės;8666759391;Taip;5;1;0;6
12918;Vėjelis;Boruželės;3844131154;Taip;5;0;0;5
12919;Vėjelis;Boruželės;4747466651;Taip;17;0;0;17
12920;Vėjelis;Boruželės;3473416323;Taip;6;0;0;6
12921;Vėjelis;Boruželės;8141198449;Taip;0;6;0;6
12922;Vėjelis;Boruželės;8121537795;Taip;20;0;0;20
12923;Vėtrungė;Debesėlių;62501279379;Taip;19;0;0;19
12924;Vėtrungė;Debesėlių;684188851;Taip;5;0;2;7
12925;Vėtrungė;Debesėlių;1833285759;Taip;0;4;0;4
12926;Vėtrungė;Debesėlių;31644585040;Ne;9;0;0;9
12927;Vėtrungė;Debesėlių;68262180072;Taip;0;5;2;7
12928;Vėtrungė;Debesėlių;18747550179;Taip;4;0;0;4
12929;Vėtrungė;Debesėlių;63472451321;Taip;5;4;0;9
12930;Vėtrungė;Debesėlių;97059033453;Ne;10;0;4;14
12931;Vėtrungė;Debesėlių;9844783953;Taip;0;0;2;2
12932;Vėtrungė;Debesėlių;8948342560;Taip;0;0;1;1
12933;Vėtrungė;Debesėlių;30792456956;Taip;10;0;0;10
12934;Vėtrungė;Debesėlių;28780493289;Taip;10;3;0;13
12935;Vėtrungė;Debesėlių;65861118217;Taip;0;2;2;4
12936;Vėtrungė;Debesėlių;48935809458;Ne;0;7;0;7
12937;Vėtrungė;Debesėlių;92977432447;Ne;4;5;0;9
12938;Vėtrungė;Debesėlių;92266460791;Taip;5;0;1;6
12939;Vėtrungė;Debesėlių;30561569339;Ne;5;4;0;9
12940;Vėtrungė;Debesėlių;31570905515;Ne;5;4;0;9
12941;Vėtrungė;Debesėlių;4547247726;Taip;5;7;0;12
12942;Vėtrungė;Debesėlių;1918866964;Taip;15;1;0;16
12943;Vėtrungė;Debesėlių;96980344422;Taip;3;7;0;10
12944;Vėtrungė;Zuikių;8493950205;Taip;8;1;0;9
12945;Vėtrungė;Zuikių;7585075881;Taip;23;0;0;23
12946;Vėtrungė;Zuikių;4874628984;Taip;15;1;0;16
12947;Vėtrungė;Zuikių;9332362038;Taip;9;1;0;10
12948;Vėtrungė;Zuikių;9407558097;Taip;14;3;0;17
12949;Vėtrungė;Zuikių;2985829593;Taip;6;0;0;6
12950;Vėtrungė;Zuikių;4121886031;Taip;9;14;0;23
12951;Vėtrungė;Zuikių;4080895256;Taip;7;0;0;7
12952;Vėtrungė;Zuikių;7573021445;Taip;9;4;3;16
12953;Vėtrungė;Zuikių;3335047815;Taip;2;0;0;2
12954;Vėtrungė;Zuikių;8157356569;Taip;2;1;0;3
12955;Vėtrungė;Zuikių;9742099165;Taip;9;1;0;10
12956;Vėtrungė;Drugelių;98795465390;Taip;1;0;0;1
12957;Vėtrungė;Drugelių;34534856875;Ne;2;0;0;2
12958;Vėtrungė;Drugelių;1019550327;Taip;2;5;1;8
12959;Vėtrungė;Drugelių;26126038013;Taip;0;7;0;7
12960;Vėtrungė;Drugelių;40200404538;Taip;14;0;0;14
12961;Vėtrungė;Drugelių;96815788666;Taip;6;0;0;6
12962;Vėtrungė;Drugelių;72462689908;Taip;10;0;0;10
12963;Vėtrungė;Drugelių;38583821324;Ne;0;11;0;11
12964;Vėtrungė;Drugelių;42353807206;Taip;3;13;0;16
12965;Vėtrungė;Drugelių;68573318766;Ne;6;5;0;11
12966;Vėtrungė;Drugelių;76967115688;Taip;0;5;0;5
12967;Vėtrungė;Drugelių;68938242748;Taip;5;4;0;9
12968;Vėtrungė;Drugelių;93587767496;Taip;5;2;0;7
12969;Vėtrungė;Drugelių;45715910769;Taip;5;0;0;5
12970;Vėtrungė;Drugelių;1111688152;Taip;5;9;0;14
12971;Vėtrungė;Drugelių;1752676956;Taip;0;1;0;1
12972;Vėtrungė;Drugelių;1128961321;Taip;3;2;1;6
12973;Vėtrungė;Drugelių;88062307371;Taip;11;0;2;13
12974;Vėtrungė;Drugelių;99423172685;Ne;1;2;0;3
12975;Vėtrungė;Drugelių;58224525427;Taip;3;11;0;14
12976;Vėtrungė;Drugelių;1533796435;Taip;5;0;0;5
12977;Vėtrungė;Do-re-mi;6449124019;Taip;5;0;3;8
12978;Vėtrungė;Do-re-mi;3278452234;Taip;8;5;0;13
12979;Vėtrungė;Do-re-mi;9324733839;Taip;0;2;0;2
12980;Vėtrungė;Do-re-mi;2287044278;Taip;0;1;0;1
12981;Vėtrungė;Do-re-mi;2928868412;Taip;0;1;1;2
12982;Vėtrungė;Do-re-mi;2883254822;Taip;10;0;0;10
12983;Vėtrungė;Do-re-mi;3404120492;Taip;9;0;0;9
12984;Vėtrungė;Do-re-mi;9518734260;Taip;10;0;0;10
12985;Vėtrungė;Do-re-mi;7782972361;Taip;9;2;0;11
12986;Vėtrungė;Do-re-mi;7496582551;Taip;6;0;0;6
12987;Vėtrungė;Do-re-mi;5430818470;Taip;19;0;0;19
12988;Vėtrungė;Do-re-mi;1088517019;Ne;19;0;0;19
12989;Vėtrungė;Do-re-mi;7895027909;Taip;4;0;0;4
12990;Vėtrungė;Smalsučių;1024966114;Taip;12;0;4;16
12991;Vėtrungė;Smalsučių;70341931369;Ne;7;0;0;7
12992;Vėtrungė;Smalsučių;12552330015;Taip;7;5;0;12
12993;Vėtrungė;Smalsučių;43313050517;Taip;3;0;1;4
12994;Vėtrungė;Smalsučių;1096312626;Taip;0;8;0;8
12995;Vėtrungė;Smalsučių;58071867972;Taip;12;1;3;16
12996;Vėtrungė;Smalsučių;25185803642;Taip;0;3;0;3
12997;Vėtrungė;Smalsučių;8303270253;Taip;0;0;1;1
12998;Vėtrungė;Smalsučių;10642323891;Taip;0;1;0;1
12999;Vėtrungė;Smalsučių;1637718306;Taip;0;1;0;1
13000;Vėtrungė;Smalsučių;37534609024;Taip;4;0;0;4
13001;Vėtrungė;Smalsučių;18697110620;Taip;3;1;0;4
13002;Vėtrungė;Smalsučių;22272024279;Taip;0;1;0;1
13003;Vėtrungė;Smalsučių;1828688039;Taip;0;4;0;4
13004;Vėtrungė;Gudručių;39325086836;Taip;0;11;0;11
13005;Vėtrungė;Gudručių;9097027948;Taip;9;1;0;10
13006;Vėtrungė;Gudručių;37846747830;Taip;5;1;0;6
13007;Vėtrungė;Gudručių;53452204630;Taip;5;5;0;10
13008;Vėtrungė;Gudručių;63918616201;Taip;0;4;0;4
13009;Vėtrungė;Gudručių;71037045946;Taip;0;9;0;9
13010;Vėtrungė;Gudručių;50620488812;Taip;0;9;0;9
13011;Vėtrungė;Gudručių;17639791114;Taip;0;3;0;3
13012;Vėtrungė;Gudručių;45652505960;Taip;5;7;0;12
13013;Vėtrungė;Gudručių;79959834921;Ne;0;11;0;11
13014;Vėtrungė;Gudručių;72698261170;Taip;0;19;0;19
13015;Vėtrungė;Gudručių;34053590435;Ne;0;1;0;1
13016;Vėtrungė;Gudručių;74200855756;Taip;0;2;0;2
13017;Vėtrungė;Gudručių;13233957713;Ne;0;9;0;9
13018;Vėtrungė;Gudručių;29414532281;Ne;0;7;0;7
13019;Vėtrungė;Gudručių;16576620734;Ne;0;10;0;10
13020;Vėtrungė;Gudručių;1120374635;Taip;11;3;0;14
13021;Vėtrungė;Gudručių;77759679609;Taip;4;9;0;13
13022;Vėtrungė;Kodėlčių;1366458234;Taip;2;1;2;5
13023;Vėtrungė;Kodėlčių;1021458176;Taip;0;23;0;23
13024;Vėtrungė;Kodėlčių;1267104594;Taip;0;3;0;3
13025;Vėtrungė;Kodėlčių;1022530443;Taip;1;1;0;2
13026;Vėtrungė;Kodėlčių;1283685496;Taip;7;2;0;9
13027;Vėtrungė;Kodėlčių;20608668180;Taip;4;1;0;5
13028;Vėtrungė;Kodėlčių;31133574731;Taip;0;23;0;23
13029;Vėtrungė;Kodėlčių;49220186521;Taip;0;20;0;20
13030;Vėtrungė;Kodėlčių;41508942219;Taip;6;10;0;16
13031;Vėtrungė;Kodėlčių;1662123237;Taip;0;10;0;10
13032;Vėtrungė;Kodėlčių;1456877681;Taip;0;23;0;23
13033;Vėtrungė;Kodėlčių;90528749634;Taip;0;1;4;5
13034;Vėtrungė;Kodėlčių;1487142899;Taip;9;0;0;9
13035;Vėtrungė;Kodėlčių;19486911273;Taip;7;0;0;7
13036;Vėtrungė;Kodėlčių;56266349747;Taip;9;0;0;9
13037;Vėtrungė;Kodėlčių;1902101426;Taip;12;0;0;12
13038;Vėtrungė;Kodėlčių;9395706055;Taip;18;1;1;20
13039;Vėtrungė;Kodėlčių;3231167303;Taip;7;0;0;7
13040;Vėtrungė;Kodėlčių;4291687553;Taip;2;7;2;11
13041;Vėtrungė;Kodėlčių;18426639118;Taip;3;8;0;11
13042;Vėtrungė;Kodėlčių;1383686133;Taip;5;0;0;5
13043;Vėtrungė;Kodėlčių;6563805572;Taip;8;6;0;14
13044;Vėtrungė;Kodėlčių;1395153496;Taip;5;9;0;14
13045;Vėtrungė;Paukštelių;63512524250;Ne;10;0;13;23
13046;Vėtrungė;Paukštelių;5012599400;Taip;0;0;2;2
13047;Vėtrungė;Paukštelių;1769926207;Taip;6;0;0;6
13048;Vėtrungė;Paukštelių;1322617786;Taip;9;10;0;19
13049;Vėtrungė;Paukštelių;2864217098;Taip;7;1;0;8
13050;Vėtrungė;Paukštelių;7921863675;Taip;3;5;0;8
13051;Vėtrungė;Paukštelių;4091719904;Taip;15;2;0;17
13052;Vėtrungė;Paukštelių;4347810256;Taip;10;0;0;10
13053;Vėtrungė;Paukštelių;8915159672;Taip;6;4;0;10
13054;Vėtrungė;Paukštelių;2482436192;Taip;11;4;0;15
13055;Vėtrungė;Paukštelių;6732632515;Taip;23;0;0;23
13056;Vėtrungė;Paukštelių;8897558066;Taip;11;0;0;11
13057;Vėtrungė;Paukštelių;8154023892;Ne;13;0;0;13
13058;Vėtrungė;Paukštelių;3721504364;Taip;10;0;0;10
13059;Vėtrungė;Paukštelių;4115995882;Taip;8;1;0;9
13060;Vėtrungė;Paukštelių;1357603285;Taip;3;1;0;4
13061;Vėtrungė;Paukštelių;5994465833;Taip;7;1;0;8
13062;Vėtrungė;Paukštelių;8721035192;Taip;0;21;0;21
13063;Vėtrungė;Paukštelių;6964225210;Taip;5;0;1;6
13064;Vėtrungė;Viščiukų;2809555356;Taip;6;1;0;7
13065;Vėtrungė;Viščiukų;8571622921;Taip;10;6;0;16
13066;Vėtrungė;Viščiukų;3200251047;Taip;3;0;0;3
13067;Vėtrungė;Viščiukų;7749675589;Taip;5;0;0;5
13068;Vėtrungė;Viščiukų;8538678373;Taip;3;6;0;9
13069;Vėtrungė;Viščiukų;7483624989;Taip;23;0;0;23
13070;Vėtrungė;Viščiukų;5670113882;Taip;3;2;0;5
13071;Vėtrungė;Viščiukų;1808699695;Taip;4;8;0;12
13072;Vėtrungė;Viščiukų;7807708310;Taip;11;5;0;16
13073;Vėtrungė;Viščiukų;8961791293;Taip;9;6;0;15
13074;Vėtrungė;Viščiukų;4916692634;Taip;4;4;0;8
13075;Vėtrungė;Viščiukų;5217297849;Ne;4;0;0;4
13076;Vėtrungė;Viščiukų;6416245099;Ne;7;5;0;12
13077;Vėtrungė;Viščiukų;8742161467;Taip;7;3;0;10
13078;Vėtrungė;Viščiukų;7558548846;Taip;10;1;0;11
13079;Vėtrungė;Viščiukų;1007578933;Taip;10;1;0;11
13080;Vėtrungė;Nykštukų;29699317546;Taip;0;9;0;9
13081;Vėtrungė;Nykštukų;1474010989;Taip;4;15;0;19
13082;Vėtrungė;Nykštukų;47141854213;Taip;5;9;0;14
13083;Vėtrungė;Nykštukų;76708504248;Taip;2;0;1;3
13084;Vėtrungė;Nykštukų;1754493671;Ne;5;4;0;9
13085;Vėtrungė;Nykštukų;1843306606;Taip;0;2;7;9
13086;Vėtrungė;Nykštukų;5198153485;Taip;8;0;1;9
13087;Vėtrungė;Nykštukų;1630866223;Taip;0;6;0;6
13088;Vėtrungė;Nykštukų;1529226569;Taip;0;4;0;4
13089;Vėtrungė;Nykštukų;1690268842;Taip;0;6;0;6
13090;Vėtrungė;Nykštukų;1279678980;Taip;0;1;0;1
13091;Vėtrungė;Nykštukų;1370336984;Taip;0;2;0;2
13092;Vėtrungė;Nykštukų;78016704795;Taip;1;2;0;3
13093;Vėtrungė;Nykštukų;68628872682;Taip;0;0;1;1
13094;Vėtrungė;Nykštukų;54494917364;Taip;0;4;0;4
13095;Vėtrungė;Nykštukų;87686013986;Taip;0;1;0;1
13096;Vėtrungė;Nykštukų;70610257897;Taip;10;2;0;12
13097;Vėtrungė;Nykštukų;2715736596;Taip;11;5;0;16
13098;Vėtrungė;Nykštukų;1744400765;Taip;11;0;0;11
13099;Vėtrungė;Nykštukų;1360031121;Taip;6;3;0;9
13100;Vėtrungė;Nykštukų;2145081325;Taip;7;6;8;21
13101;Vėtrungė;Nykštukų;2529102855;Taip;0;3;0;3
13102;Vėtrungė;Nykštukų;1611274573;Taip;5;9;0;14
13103;Vėtrungė;Nykštukų;7792694801;Ne;10;0;1;11
13104;Vėtrungė;Meškiukų;2510763357;Taip;15;0;0;15
13105;Vėtrungė;Meškiukų;4713420194;Taip;15;0;0;15
13106;Vėtrungė;Meškiukų;2226654309;Taip;10;2;0;12
13107;Vėtrungė;Meškiukų;7270370939;Taip;9;1;1;11
13108;Vėtrungė;Meškiukų;9543456295;Taip;14;0;0;14
13109;Vėtrungė;Meškiukų;9207846866;Taip;8;0;0;8
13110;Vėtrungė;Meškiukų;9065848425;Taip;5;4;0;9
13111;Vėtrungė;Meškiukų;9491661945;Ne;9;0;1;10
13112;Vėtrungė;Meškiukų;3328447991;Taip;7;0;0;7
13113;Vėtrungė;Meškiukų;9685389270;Ne;11;5;0;16
13114;Vėtrungė;Meškiukų;9313438768;Taip;19;0;0;19
13115;Vėtrungė;Meškiukų;9070732925;Taip;6;4;0;10
13116;Vėtrungė;Meškiukų;3122948974;Taip;7;0;0;7
13117;Vėtrungė;Meškiukų;2880342138;Taip;19;0;0;19
13118;Vėtrungė;Meškiukų;2520926439;Taip;12;2;0;14
13119;Vėtrungė;Meškiukų;7704497739;Taip;7;0;0;7
13120;Vėtrungė;Meškiukų;7143997258;Taip;16;0;0;16
13121;Vėtrungė;Meškiukų;5123894802;Taip;11;2;1;14
13122;Vėtrungė;Meškiukų;4394100006;Taip;12;8;3;23
13123;Vėtrungė;Ąžuoliukų;7813907852;Taip;5;0;4;9
13124;Vėtrungė;Ąžuoliukų;2471926240;Taip;0;1;0;1
13125;Vėtrungė;Ąžuoliukų;3249689008;Taip;14;0;0;14
13126;Vėtrungė;Ąžuoliukų;7295216791;Taip;0;4;0;4
13127;Vėtrungė;Ąžuoliukų;2440001662;Taip;11;0;1;12
13128;Vėtrungė;Ąžuoliukų;1636432189;Taip;5;0;0;5
13129;Vėtrungė;Ąžuoliukų;7803736567;Taip;5;0;0;5
13130;Vėtrungė;Ąžuoliukų;1042333710;Ne;7;12;0;19
13131;Vėtrungė;Ąžuoliukų;9795630131;Taip;0;0;3;3
13132;Vėtrungė;Ąžuoliukų;7129180154;Taip;2;0;2;4
13133;Vėtrungė;Ąžuoliukų;16216365941;Taip;0;1;0;1
13134;Vėtrungė;Ąžuoliukų;6356914122;Ne;0;8;0;8
13135;Vėtrungė;Ąžuoliukų;2636219826;Taip;7;0;0;7
13136;Vėtrungė;Ąžuoliukų;1934540281;Ne;1;0;0;1
13137;Vėtrungė;Ąžuoliukų;6479094819;Taip;18;0;0;18
13138;Vėtrungė;Ąžuoliukų;5367369908;Taip;5;0;1;6
13139;Vėtrungė;Ąžuoliukų;4000379945;Taip;0;10;0;10
13140;Vėtrungė;Ąžuoliukų;1789419548;Ne;0;8;0;8
13141;Vilnelė;Lakštutė;9657350714;Taip;20;0;0;20
13142;Vilnelė;Lakštutė;1720695615;Taip;11;2;0;13
13143;Vilnelė;Lakštutė;2121071276;Taip;9;0;0;9
13144;Vilnelė;Lakštutė;6047375980;Taip;0;0;10;10
13145;Vilnelė;Lakštutė;1065422209;Taip;4;1;1;6
13146;Vilnelė;Lakštutė;1607330769;Taip;9;5;0;14
13147;Vilnelė;Lakštutė;66992481918;Taip;9;1;0;10
13148;Vilnelė;Lakštutė;85074719873;Taip;5;1;0;6
13149;Vilnelė;Lakštutė;3316451889;Taip;9;3;0;12
13150;Vilnelė;Lakštutė;8820091584;Taip;16;0;0;16
13151;Vilnelė;Lakštutė;8270866998;Taip;0;15;0;15
13152;Vilnelė;Lakštutė;2990112955;Taip;0;1;0;1
13153;Vilnelė;Lakštutė;3454141069;Taip;20;0;0;20
13154;Vilnelė;Lakštutė;9618342480;Taip;0;5;0;5
13155;Vilnelė;Lakštutė;9369955153;Taip;20;0;0;20
13156;Vilnelė;Lakštutė;2311184444;Taip;10;3;0;13
13157;Vilnelė;Lakštutė;6155522893;Taip;15;0;0;15
13158;Vilnelė;Lakštutė;6898685834;Taip;4;1;1;6
13159;Vilnelė;Lakštutė;6318246517;Taip;11;3;0;14
13160;Vilnelė;Lakštutė;7387394504;Taip;11;3;0;14
13161;Vilnelė;Vyturėlis;9643543101;Taip;3;4;0;7
13162;Vilnelė;Vyturėlis;5091272908;Taip;6;1;0;7
13163;Vilnelė;Vyturėlis;95055148560;Taip;3;1;1;5
13164;Vilnelė;Vyturėlis;2696565855;Taip;6;1;0;7
13165;Vilnelė;Vyturėlis;3009064105;Taip;10;0;0;10
13166;Vilnelė;Vyturėlis;1674551092;Taip;0;2;0;2
13167;Vilnelė;Vyturėlis;3743740372;Taip;8;0;0;8
13168;Vilnelė;Vyturėlis;2131599015;Taip;0;9;0;9
13169;Vilnelė;Vyturėlis;9460789751;Taip;10;1;0;11
13170;Vilnelė;Vyturėlis;6954102486;Taip;13;0;0;13
13171;Vilnelė;Vyturėlis;18740103706;Taip;0;1;0;1
13172;Vilnelė;Vyturėlis;7057183482;Taip;14;1;0;15
13173;Vilnelė;Vyturėlis;8725191514;Taip;6;1;0;7
13174;Vilnelė;Vyturėlis;6308015852;Taip;11;0;0;11
13175;Vilnelė;Vyturėlis;7963783957;Taip;12;0;0;12
13176;Vilnelė;Vyturėlis;1545570307;Taip;2;2;0;4
13177;Vilnelė;Vyturėlis;5540359276;Taip;0;1;0;1
13178;Vilnelė;Vyturėlis;1966090625;Taip;11;0;0;11
13179;Vilnelė;Vyturėlis;8740717061;Taip;0;3;0;3
13180;Vilnelė;Pagrandukas;47862530763;Taip;0;3;0;3
13181;Vilnelė;Pagrandukas;86632916976;Taip;0;5;4;9
13182;Vilnelė;Pagrandukas;99862516414;Taip;0;5;0;5
13183;Vilnelė;Pagrandukas;71697587760;Ne;0;1;0;1
13184;Vilnelė;Pagrandukas;15544719839;Taip;1;0;0;1
13185;Vilnelė;Pagrandukas;66846020652;Taip;0;0;2;2
13186;Vilnelė;Pagrandukas;6165517230;Taip;0;1;0;1
13187;Vilnelė;Pagrandukas;49625837016;Taip;0;0;2;2
13188;Vilnelė;Pagrandukas;2783445497;Taip;2;1;0;3
13189;Vilnelė;Pagrandukas;5818753821;Taip;0;6;0;6
13190;Vilnelė;Pagrandukas;97511728967;Taip;11;2;0;13
13191;Vilnelė;Pagrandukas;37597237480;Taip;0;6;0;6
13192;Vilnelė;Pagrandukas;68288478307;Taip;0;7;1;8
13193;Vilnelė;Pagrandukas;58925096937;Taip;0;3;0;3
13194;Vilnelė;Pagrandukas;36889106081;Taip;0;1;0;1
13195;Vilnelė;Pagrandukas;22563964459;Taip;0;2;0;2
13196;Vilnelė;Bitutė;57355144827;Taip;0;8;3;11
13197;Vilnelė;Bitutė;31456400596;Ne;0;6;0;6
13198;Vilnelė;Bitutė;98916301986;Ne;0;1;0;1
13199;Vilnelė;Bitutė;5689110144;Taip;0;4;0;4
13200;Vilnelė;Bitutė;14782861836;Taip;0;4;0;4
13201;Vilnelė;Bitutė;81251620413;Taip;0;5;0;5
13202;Vilnelė;Bitutė;1401796093;Ne;9;5;0;14
13203;Vilnelė;Bitutė;5431869792;Ne;0;4;0;4
13204;Vilnelė;Bitutė;19340293938;Taip;0;14;0;14
13205;Vilnelė;Bitutė;57150212991;Ne;0;9;0;9
13206;Vilnelė;Bitutė;79392670872;Taip;4;0;0;4
13207;Vilnelė;Bitutė;57958541549;Taip;11;0;0;11
13208;Vilnelė;Bitutė;66330140933;Taip;9;0;0;9
13209;Vilnelė;Bitutė;63559597074;Taip;0;0;12;12
13210;Vilnelė;Bitutė;69506303971;Ne;8;0;0;8
13211;Vilnelė;Bitutė;70908264075;Taip;0;6;0;6
13212;Vilnelė;Bitutė;28905654375;Taip;0;4;0;4
13213;Vilnelė;Bitutė;27320200466;Taip;0;5;0;5
13214;Vilnelė;Šaltinėlis;1783854203;Taip;4;0;0;4
13215;Vilnelė;Šaltinėlis;5013418313;Taip;17;0;0;17
13216;Vilnelė;Šaltinėlis;42835212158;Taip;0;0;1;1
13217;Vilnelė;Šaltinėlis;98028664140;Taip;0;8;0;8
13218;Vilnelė;Šaltinėlis;1255849405;Taip;7;9;0;16
13219;Vilnelė;Šaltinėlis;11430703629;Taip;3;4;0;7
13220;Vilnelė;Šaltinėlis;7292043157;Taip;3;3;0;6
13221;Vilnelė;Šaltinėlis;6327531229;Taip;0;1;8;9
13222;Vilnelė;Šaltinėlis;10345875729;Taip;5;0;0;5
13223;Vilnelė;Šaltinėlis;1572818047;Taip;8;0;0;8
13224;Vilnelė;Šaltinėlis;2130482375;Taip;5;1;0;6
13225;Vilnelė;Šaltinėlis;4480175299;Taip;7;7;0;14
13226;Vilnelė;Šaltinėlis;9058632601;Taip;10;0;0;10
13227;Vilnelė;Šaltinėlis;5932200003;Taip;11;0;0;11
13228;Vilnelė;Šaltinėlis;1507865281;Taip;3;6;0;9
13229;Vilnelė;Šaltinėlis;39494954188;Taip;7;6;0;13
13230;Vilnelė;Šaltinėlis;8615257084;Taip;9;0;0;9
13231;Vilnelė;Šaltinėlis;6146514112;Taip;0;8;0;8
13232;Vilnelė;Šaltinėlis;9016832316;Taip;8;0;0;8
13233;Vilnelė;Šaltinėlis;1281521052;Taip;20;0;0;20
13234;Vilnelė;Riešutėllis;55974182996;Taip;7;1;0;8
13235;Vilnelė;Riešutėllis;67561845041;Taip;11;0;0;11
13236;Vilnelė;Riešutėllis;85568332595;Taip;14;1;0;15
13237;Vilnelė;Riešutėllis;22516605873;Taip;5;6;0;11
13238;Vilnelė;Riešutėllis;64066480740;Taip;5;8;0;13
13239;Vilnelė;Riešutėllis;16272480270;Taip;7;1;2;10
13240;Vilnelė;Riešutėllis;1859757115;Taip;6;7;0;13
13241;Vilnelė;Riešutėllis;1450994872;Taip;0;0;8;8
13242;Vilnelė;Riešutėllis;9331404812;Taip;5;2;0;7
13243;Vilnelė;Riešutėllis;11702051319;Taip;5;0;0;5
13244;Vilnelė;Riešutėllis;41536662155;Taip;2;0;0;2
13245;Vilnelė;Riešutėllis;69413564937;Taip;3;2;0;5
13246;Vilnelė;Riešutėllis;71906228270;Taip;0;0;1;1
13247;Vilnelė;Riešutėllis;7916632244;Taip;1;0;0;1
13248;Vilnelė;Riešutėllis;20639648308;Taip;0;4;2;6
13249;Vilnelė;Riešutėllis;73658263243;Taip;15;3;0;18
13250;Vilnelė;Riešutėllis;8889469645;Taip;14;0;0;14
13251;Vilnelė;Riešutėllis;77461494667;Taip;3;4;1;8
13252;Vilnelė;Riešutėllis;1321202650;Taip;0;7;1;8
13253;Vilnelė;Nykštukas;53049214510;Taip;11;0;0;11
13254;Vilnelė;Nykštukas;1336497125;Taip;8;0;0;8
13255;Vilnelė;Nykštukas;34859308729;Taip;5;0;0;5
13256;Vilnelė;Nykštukas;32988468324;Taip;8;5;0;13
13257;Vilnelė;Nykštukas;89748262997;Taip;14;1;0;15
13258;Vilnelė;Nykštukas;87406093438;Taip;14;1;0;15
13259;Vilnelė;Nykštukas;13583637193;Taip;10;3;0;13
13260;Vilnelė;Nykštukas;23442711820;Taip;0;9;0;9
13261;Vilnelė;Nykštukas;47863474499;Taip;1;0;0;1
13262;Vilnelė;Nykštukas;13231410969;Taip;5;10;0;15
13263;Vilnelė;Nykštukas;62208863766;Taip;10;6;0;16
13264;Vilnelė;Nykštukas;36905818484;Taip;10;6;0;16
13265;Vilnelė;Nykštukas;1845336128;Taip;6;0;0;6
13266;Vilnelė;Nykštukas;87094375121;Taip;0;12;0;12
13267;Vilnelė;Nykštukas;42526993637;Taip;6;7;0;13
13268;Vilnelė;Nykštukas;15265621906;Taip;9;5;0;14
13269;Vilnelė;Nykštukas;5198859945;Taip;0;20;0;20
13270;Vilnelė;Nykštukas;2131603460;Taip;15;0;0;15
13271;Vilnelė;Nykštukas;59579013512;Taip;0;17;0;17
13272;Vilnelė;Pieštukas;1061139491;Taip;0;7;0;7
13273;Vilnelė;Pieštukas;79700582010;Taip;0;9;0;9
13274;Vilnelė;Pieštukas;60707257606;Taip;0;11;0;11
13275;Vilnelė;Pieštukas;1957418704;Taip;0;4;0;4
13276;Vilnelė;Pieštukas;96611892032;Taip;2;4;0;6
13277;Vilnelė;Pieštukas;2864763106;Taip;5;3;0;8
13278;Vilnelė;Pieštukas;10333554439;Taip;5;4;0;9
13279;Vilnelė;Pieštukas;624138880;Taip;0;1;0;1
13280;Vilnelė;Pieštukas;31701260922;Taip;0;8;0;8
13281;Vilnelė;Pieštukas;87237045379;Taip;0;4;0;4
13282;Vilnelė;Pieštukas;985960052;Taip;0;10;0;10
13283;Vilnelė;Pieštukas;90173852512;Taip;0;8;0;8
13284;Vilnelė;Pieštukas;95736417954;Taip;10;0;0;10
13285;Vilnelė;Pieštukas;53990457379;Taip;0;2;0;2
13286;Vilnelė;Pieštukas;78753442031;Taip;0;4;0;4
13287;Vilnelė;Pieštukas;1051858780;Taip;11;0;0;11
13288;Vilnelė;Pieštukas;98404616387;Taip;10;5;0;15
13289;Vilnelė;Pieštukas;2138907190;Taip;0;12;0;12
13290;Vilnelė;Pieštukas;5936699300;Taip;4;4;0;8
13291;Vilnelė;Pieštukas;77572611171;Taip;0;3;0;3
13292;Vilnelė;Voverytė;1702224809;Taip;0;0;2;2
13293;Vilnelė;Voverytė;2812680090;Taip;9;0;0;9
13294;Vilnelė;Voverytė;95852926101;Taip;0;3;0;3
13295;Vilnelė;Voverytė;1594154669;Taip;1;0;1;2
13296;Vilnelė;Voverytė;32662933313;Taip;12;0;2;14
13297;Vilnelė;Voverytė;1410511913;Taip;6;0;2;8
13298;Vilnelė;Voverytė;48926369907;Taip;0;0;5;5
13299;Vilnelė;Voverytė;13646307629;Taip;0;8;0;8
13300;Vilnelė;Voverytė;1680411448;Taip;3;1;3;7
13301;Vilnelė;Voverytė;1294194561;Taip;11;4;0;15
13302;Vilnelė;Voverytė;1111397062;Taip;0;4;1;5
13303;Vilnelė;Voverytė;54871985655;Taip;6;0;0;6
13304;Vilnelė;Voverytė;1230072125;Taip;0;0;1;1
13305;Vilnelė;Voverytė;1733279710;Taip;10;2;1;13
13306;Vilnelė;Voverytė;91933747502;Taip;0;5;0;5
13307;Vilnelė;Voverytė;1498777674;Taip;2;1;3;6
13308;Vilnelė;Voverytė;1932829642;Taip;2;0;0;2
13309;Vilnelė;Voverytė;5480363267;Taip;0;2;0;2
13310;Vilnelė;Voverytė;1422040758;Taip;15;2;0;17
13311;Vilnelė;Kodėlčiukas;85452254846;Taip;0;3;0;3
13312;Vilnelė;Kodėlčiukas;6289991945;Taip;11;0;0;11
13313;Vilnelė;Kodėlčiukas;81657018187;Taip;0;6;0;6
13314;Vilnelė;Kodėlčiukas;1448257490;Taip;15;0;0;15
13315;Vilnelė;Kodėlčiukas;69532393507;Taip;5;4;0;9
13316;Vilnelė;Kodėlčiukas;1160794222;Taip;0;7;0;7
13317;Vilnelė;Kodėlčiukas;64950604083;Taip;0;2;0;2
13318;Vilnelė;Kodėlčiukas;99580393765;Taip;7;0;0;7
13319;Vilnelė;Kodėlčiukas;36561742487;Taip;0;4;0;4
13320;Vilnelė;Kodėlčiukas;96900970284;Taip;18;0;0;18
13321;Vilnelė;Kodėlčiukas;85391221236;Taip;9;3;0;12
13322;Vilnelė;Kodėlčiukas;39412868538;Taip;12;0;0;12
13323;Vilnelė;Kodėlčiukas;67110179640;Ne;0;6;0;6
13324;Vilnelė;Kodėlčiukas;35546482171;Taip;0;2;0;2
13325;Vilnelė;Kodėlčiukas;90980722090;Taip;0;10;0;10
13326;Vilnelė;Kodėlčiukas;33652235251;Taip;0;5;0;5
13327;Vilnelė;Kodėlčiukas;32819254615;Taip;0;1;0;1
13328;Vilnelė;Kodėlčiukas;91413844614;Taip;5;2;0;7
13329;Vilnelė;Kodėlčiukas;24746064267;Taip;6;7;0;13
13330;Vilnelė;Kodėlčiukas;18238619578;Taip;14;5;0;19
13331;Vilnelė;Žirniukas;3945921490;Taip;0;17;0;17
13332;Vilnelė;Žirniukas;6798728562;Taip;8;0;0;8
13333;Vilnelė;Žirniukas;3781595939;Taip;5;7;0;12
13334;Vilnelė;Žirniukas;1580287517;Taip;11;0;0;11
13335;Vilnelė;Žirniukas;2859160609;Taip;3;0;0;3
13336;Vilnelė;Žirniukas;9879688569;Taip;0;8;0;8
13337;Vilnelė;Žirniukas;5473379559;Taip;14;3;0;17
13338;Vilnelė;Žirniukas;1462397783;Taip;0;1;6;7
13339;Vilnelė;Žirniukas;1792586468;Taip;0;7;0;7
13340;Vilnelė;Žirniukas;8086759121;Taip;14;1;0;15
13341;Vilnelė;Žirniukas;1975954784;Taip;2;0;0;2
13342;Vilnelė;Žirniukas;7199490431;Taip;9;0;0;9
13343;Vilnelė;Žirniukas;9884955712;Taip;5;2;0;7
13344;Vilnelė;Žirniukas;2479090686;Taip;0;1;0;1
13345;Vilnelė;Pipiras;7536603663;Taip;3;4;0;7
13346;Vilnelė;Pipiras;3503461211;Taip;10;10;0;20
13347;Vilnelė;Pipiras;3993826389;Taip;4;2;2;8
13348;Vilnelė;Pipiras;7388336851;Taip;4;2;0;6
13349;Vilnelė;Pipiras;8667403338;Taip;0;2;1;3
13350;Vilnelė;Pipiras;7883724600;Taip;0;2;1;3
13351;Vilnelė;Pipiras;4166351390;Taip;0;1;0;1
13352;Vilnelė;Pipiras;1351798589;Taip;0;1;0;1
13353;Vilnelė;Pipiras;9162681538;Taip;0;1;0;1
13354;Vilnelė;Pipiras;3075681823;Taip;0;1;0;1
13355;Vilnelė;Pipiras;6342242777;Taip;8;0;0;8
13356;Vilnelė;Pipiras;3843064564;Taip;7;2;0;9
13357;Vilnelė;Pipiras;7085972543;Taip;12;0;0;12
13358;Vilnelė;Pipiras;7642022439;Taip;13;0;0;13
13359;Vilnelė;Pipiras;4838684336;Taip;13;0;0;13
13360;Vėrinėlis;GAIDELIAI;4666918175;Taip;4;0;0;4
13361;Vėrinėlis;GAIDELIAI;2774618380;Taip;7;0;0;7
13362;Vėrinėlis;GAIDELIAI;5429955166;Taip;16;0;0;16
13363;Vėrinėlis;GAIDELIAI;5209398043;Taip;10;5;0;15
13364;Vėrinėlis;GAIDELIAI;1060619471;Taip;13;0;0;13
13365;Vėrinėlis;GAIDELIAI;8885866108;Taip;13;1;0;14
13366;Vėrinėlis;GAIDELIAI;8213498951;Taip;12;0;0;12
13367;Vėrinėlis;GAIDELIAI;6136232912;Taip;16;0;0;16
13368;Vėrinėlis;GAIDELIAI;6058712578;Taip;5;4;0;9
13369;Vėrinėlis;GAIDELIAI;6496291933;Taip;0;0;1;1
13370;Vėrinėlis;GAIDELIAI;1164396960;Taip;18;0;0;18
13371;Vėrinėlis;GAIDELIAI;8091400240;Taip;15;0;0;15
13372;Vėrinėlis;GAIDELIAI;8728166391;Taip;9;0;0;9
13373;Vėrinėlis;GAIDELIAI;4415030161;Taip;10;3;0;13
13374;Vėrinėlis;GAIDELIAI;8100283579;Taip;8;0;1;9
13375;Vėrinėlis;SAULUTĖ;71830611159;Taip;1;0;0;1
13376;Vėrinėlis;SAULUTĖ;6148700823;Taip;5;6;0;11
13377;Vėrinėlis;SAULUTĖ;1086306523;Ne;20;0;0;20
13378;Vėrinėlis;SAULUTĖ;11343969028;Taip;6;3;0;9
13379;Vėrinėlis;SAULUTĖ;1408704528;Taip;3;1;0;4
13380;Vėrinėlis;SAULUTĖ;1239744245;Taip;3;1;0;4
13381;Vėrinėlis;SAULUTĖ;6004379115;Taip;0;5;0;5
13382;Vėrinėlis;SAULUTĖ;39153716711;Taip;0;7;0;7
13383;Vėrinėlis;SAULUTĖ;9751494612;Taip;6;0;0;6
13384;Vėrinėlis;SAULUTĖ;1897451825;Taip;3;0;1;4
13385;Vėrinėlis;SAULUTĖ;4727265555;Taip;0;13;0;13
13386;Vėrinėlis;SAULUTĖ;1047139776;Taip;0;7;0;7
13387;Vėrinėlis;SAULUTĖ;1493604303;Taip;17;2;0;19
13388;Vėrinėlis;SAULUTĖ;5561043797;Taip;5;0;0;5
13389;Vėrinėlis;SAULUTĖ;9500715949;Taip;6;2;0;8
13390;Vėrinėlis;SAULUTĖ;1803838403;Taip;0;1;0;1
13391;Vėrinėlis;SAULUTĖ;8922728881;Taip;19;0;0;19
13392;Vėrinėlis;SAULUTĖ;9391697537;Taip;2;0;0;2
13393;Vėrinėlis;SAULUTĖ;7071043164;Taip;0;7;0;7
13394;Vėrinėlis;NYKŠTUKAI;7168682238;Taip;4;1;0;5
13395;Vėrinėlis;NYKŠTUKAI;668239862;Taip;1;4;0;5
13396;Vėrinėlis;NYKŠTUKAI;8197177876;Taip;10;5;1;16
13397;Vėrinėlis;NYKŠTUKAI;1518907235;Taip;1;7;0;8
13398;Vėrinėlis;NYKŠTUKAI;6065348004;Taip;7;0;1;8
13399;Vėrinėlis;NYKŠTUKAI;3563944204;Taip;0;0;5;5
13400;Vėrinėlis;NYKŠTUKAI;5238619411;Taip;7;0;0;7
13401;Vėrinėlis;NYKŠTUKAI;7436873997;Taip;0;9;0;9
13402;Vėrinėlis;NYKŠTUKAI;63333257753;Taip;5;4;0;9
13403;Vėrinėlis;NYKŠTUKAI;1592544116;Taip;4;0;0;4
13404;Vėrinėlis;NYKŠTUKAI;1261337457;Taip;10;4;1;15
13405;Vėrinėlis;NYKŠTUKAI;1804757495;Taip;0;0;2;2
13406;Vėrinėlis;NYKŠTUKAI;11459693163;Taip;14;0;0;14
13407;Vėrinėlis;NYKŠTUKAI;1295435839;Taip;7;2;0;9
13408;Vėrinėlis;NYKŠTUKAI;47333446450;Taip;0;0;1;1
13409;Vėrinėlis;NYKŠTUKAI;92480758419;Taip;0;0;7;7
13410;Vėrinėlis;NYKŠTUKAI;38428514086;Taip;11;0;0;11
13411;Vėrinėlis;NYKŠTUKAI;27431479888;Taip;11;0;0;11
13412;Vėrinėlis;NYKŠTUKAI;41029899086;Taip;8;0;2;10
13413;Vėrinėlis;NYKŠTUKAI;2001903188;Taip;19;0;0;19
13414;Vėrinėlis;NYKŠTUKAI;1251822610;Taip;16;0;1;17
13415;Vėrinėlis;BURATINAS;1001125426;Taip;9;2;0;11
13416;Vėrinėlis;BURATINAS;99734698213;Taip;0;9;0;9
13417;Vėrinėlis;BURATINAS;58909000723;Taip;5;7;0;12
13418;Vėrinėlis;BURATINAS;42875958735;Taip;5;6;0;11
13419;Vėrinėlis;BURATINAS;78121632796;Taip;0;2;0;2
13420;Vėrinėlis;BURATINAS;25734061057;Taip;0;3;0;3
13421;Vėrinėlis;BURATINAS;68027880109;Taip;0;1;0;1
13422;Vėrinėlis;BURATINAS;12363691267;Taip;0;6;0;6
13423;Vėrinėlis;BURATINAS;99325931907;Taip;0;4;0;4
13424;Vėrinėlis;BURATINAS;40706531692;Taip;10;5;1;16
13425;Vėrinėlis;BURATINAS;3044373634;Taip;0;0;3;3
13426;Vėrinėlis;BURATINAS;24888549934;Taip;0;2;0;2
13427;Vėrinėlis;BURATINAS;38831165210;Taip;0;11;2;13
13428;Vėrinėlis;BURATINAS;37600982027;Ne;0;4;0;4
13429;Vėrinėlis;BURATINAS;8978798314;Taip;10;1;1;12
13430;Vėrinėlis;BURATINAS;1953362884;Taip;0;0;2;2
13431;Vėrinėlis;BURATINAS;79317384797;Taip;8;3;0;11
13432;Vėrinėlis;BURATINAS;31300715730;Taip;0;0;20;20
13433;Vėrinėlis;GINTARĖLIAI;79005449877;Taip;0;2;0;2
13434;Vėrinėlis;GINTARĖLIAI;98927850113;Taip;5;1;0;6
13435;Vėrinėlis;GINTARĖLIAI;18285098778;Ne;0;4;0;4
13436;Vėrinėlis;GINTARĖLIAI;94043814995;Taip;10;4;5;19
13437;Vėrinėlis;GINTARĖLIAI;81355372884;Taip;10;3;0;13
13438;Vėrinėlis;GINTARĖLIAI;2241971642;Taip;0;6;0;6
13439;Vėrinėlis;GINTARĖLIAI;1316071049;Taip;0;1;0;1
13440;Vėrinėlis;GINTARĖLIAI;1200426264;Taip;10;0;0;10
13441;Vėrinėlis;GINTARĖLIAI;9935381405;Taip;0;5;0;5
13442;Vėrinėlis;GINTARĖLIAI;78383742417;Taip;6;0;1;7
13443;Vėrinėlis;GINTARĖLIAI;1039691410;Taip;7;7;0;14
13444;Vėrinėlis;GINTARĖLIAI;53823221730;Taip;5;3;0;8
13445;Vėrinėlis;GINTARĖLIAI;85102847167;Taip;0;4;5;9
13446;Vėrinėlis;GINTARĖLIAI;64791543104;Taip;7;2;0;9
13447;Vėrinėlis;GINTARĖLIAI;63357719105;Taip;0;10;4;14
13448;Vėrinėlis;GINTARĖLIAI;96157891711;Taip;0;4;0;4
13449;Vėrinėlis;GINTARĖLIAI;76043900105;Taip;16;1;0;17
13450;Vėrinėlis;GINTARĖLIAI;38154356317;Taip;0;3;0;3
13451;Vėrinėlis;GINTARĖLIAI;19538705090;Taip;1;7;2;10
13452;Vėrinėlis;GINTARĖLIAI;3183131197;Taip;0;11;0;11
13453;Vėrinėlis;GINTARĖLIAI;2023475725;Taip;0;4;0;4
13454;Vėrinėlis;GINTARĖLIAI;1028694005;Taip;2;4;0;6
13455;Vėrinėlis;GINTARĖLIAI;53082772522;Taip;0;1;0;1
13456;Vėrinėlis;RAMUNĖLĖS;65742227705;Taip;11;0;0;11
13457;Vėrinėlis;RAMUNĖLĖS;36051993269;Taip;11;0;0;11
13458;Vėrinėlis;RAMUNĖLĖS;71959077340;Taip;10;2;0;12
13459;Vėrinėlis;RAMUNĖLĖS;36922560017;Taip;20;0;0;20
13460;Vėrinėlis;RAMUNĖLĖS;22573601173;Taip;0;3;0;3
13461;Vėrinėlis;RAMUNĖLĖS;1540708366;Taip;0;13;0;13
13462;Vėrinėlis;RAMUNĖLĖS;7178943357;Taip;4;0;0;4
13463;Vėrinėlis;RAMUNĖLĖS;1292880457;Taip;10;0;1;11
13464;Vėrinėlis;RAMUNĖLĖS;36138794708;Taip;9;0;0;9
13465;Vėrinėlis;RAMUNĖLĖS;91754828102;Taip;0;5;0;5
13466;Vėrinėlis;RAMUNĖLĖS;41342430019;Taip;0;2;0;2
13467;Vėrinėlis;RAMUNĖLĖS;56656769188;Taip;6;4;0;10
13468;Vėrinėlis;RAMUNĖLĖS;1792855817;Taip;0;4;0;4
13469;Vėrinėlis;RAMUNĖLĖS;1979643933;Taip;0;4;0;4
13470;Vėrinėlis;RAMUNĖLĖS;1398564881;Taip;5;0;0;5
13471;Vėrinėlis;RAMUNĖLĖS;68073702260;Taip;0;0;2;2
13472;Vėrinėlis;RAMUNĖLĖS;1133491927;Taip;0;4;0;4
13473;Vėrinėlis;RAMUNĖLĖS;1268710930;Taip;5;6;0;11
13474;Vėrinėlis;RAMUNĖLĖS;1477336890;Taip;19;0;0;19
13475;Vėrinėlis;RAMUNĖLĖS;25415760747;Taip;14;0;0;14
13476;Vėrinėlis;KODELČIUKŲ;67846281580;Taip;5;1;1;7
13477;Vėrinėlis;KODELČIUKŲ;88831634291;Taip;19;0;0;19
13478;Vėrinėlis;KODELČIUKŲ;6798167004;Taip;5;6;0;11
13479;Vėrinėlis;KODELČIUKŲ;7561194911;Taip;0;6;0;6
13480;Vėrinėlis;KODELČIUKŲ;67977504520;Taip;0;7;0;7
13481;Vėrinėlis;KODELČIUKŲ;8080337820;Taip;4;5;1;10
13482;Vėrinėlis;KODELČIUKŲ;51807139150;Taip;19;0;1;20
13483;Vėrinėlis;KODELČIUKŲ;9955087519;Ne;20;0;0;20
13484;Vėrinėlis;KODELČIUKŲ;1129067900;Taip;0;4;0;4
13485;Vėrinėlis;KODELČIUKŲ;43944804765;Taip;0;10;0;10
13486;Vėrinėlis;KODELČIUKŲ;62639454640;Taip;0;7;0;7
13487;Vėrinėlis;KODELČIUKŲ;17400501595;Taip;0;15;0;15
13488;Vėrinėlis;KODELČIUKŲ;20342193231;Taip;0;4;1;5
13489;Vėrinėlis;KODELČIUKŲ;47633572816;Taip;11;1;0;12
13490;Vėrinėlis;KODELČIUKŲ;6088489477;Taip;0;3;0;3
13491;Vėrinėlis;KODELČIUKŲ;38040256220;Taip;0;8;0;8
13492;Vėrinėlis;KODELČIUKŲ;1481003777;Taip;5;1;0;6
13493;Vėrinėlis;KODELČIUKŲ;9930767796;Taip;0;14;1;15
13494;Vėrinėlis;KODELČIUKŲ;74375362661;Taip;13;4;0;17
13495;Vėrinėlis;KODELČIUKŲ;9889717756;Taip;0;1;1;2
13496;Vėrinėlis;KODELČIUKŲ;1680155836;Taip;8;0;0;8
13497;Vėrinėlis;ŽIRNIUKAI;3074835599;Taip;13;0;0;13
13498;Vėrinėlis;ŽIRNIUKAI;9798993200;Taip;11;0;0;11
13499;Vėrinėlis;ŽIRNIUKAI;4981127515;Taip;12;0;0;12
13500;Vėrinėlis;ŽIRNIUKAI;7845985650;Taip;20;0;0;20
13501;Vėrinėlis;ŽIRNIUKAI;2815770695;Taip;15;4;0;19
13502;Vėrinėlis;ŽIRNIUKAI;9604483237;Taip;10;0;1;11
13503;Vėrinėlis;ŽIRNIUKAI;9419245081;Taip;11;1;2;14
13504;Vėrinėlis;ŽIRNIUKAI;3202518504;Taip;19;0;0;19
13505;Vėrinėlis;ŽIRNIUKAI;8824435889;Taip;5;0;2;7
13506;Vėrinėlis;ŽIRNIUKAI;7237945125;Taip;0;6;5;11
13507;Vėrinėlis;ŽIRNIUKAI;5600815908;Taip;7;0;0;7
13508;Vėrinėlis;ŽIRNIUKAI;6779005350;Taip;6;0;4;10
13509;Vėrinėlis;ŽIRNIUKAI;7367485961;Taip;12;0;0;12
13510;Vėrinėlis;ŽIRNIUKAI;9340167973;Taip;20;0;0;20
13511;Vėrinėlis;ŽIRNIUKAI;1736733257;Taip;14;0;1;15
13512;Vėrinėlis;VARPELIAI;3882915774;Taip;4;9;0;13
13513;Vėrinėlis;VARPELIAI;7273090217;Taip;5;0;0;5
13514;Vėrinėlis;VARPELIAI;7233139048;Taip;9;1;0;10
13515;Vėrinėlis;VARPELIAI;3130841241;Taip;11;0;0;11
13516;Vėrinėlis;VARPELIAI;6435612222;Taip;14;0;0;14
13517;Vėrinėlis;VARPELIAI;2337883071;Taip;15;0;0;15
13518;Vėrinėlis;VARPELIAI;6913001318;Taip;5;14;0;19
13519;Vėrinėlis;VARPELIAI;4728119881;Taip;8;0;0;8
13520;Vėrinėlis;VARPELIAI;7224418233;Taip;14;6;0;20
13521;Vėrinėlis;VARPELIAI;3239370561;Taip;11;0;0;11
13522;Vėrinėlis;VARPELIAI;1894717954;Taip;11;0;2;13
13523;Vėrinėlis;VARPELIAI;3667953591;Taip;9;0;0;9
13524;Vėrinėlis;VARPELIAI;8318388772;Taip;15;0;0;15
13525;Vėrinėlis;VARPELIAI;4191386053;Taip;9;0;0;9
13526;Vėrinėlis;VARPELIAI;2633143128;Taip;6;0;2;8
13527;Vėrinėlis;BORUŽĖLĖS;54666417396;Taip;7;0;0;7
13528;Vėrinėlis;BORUŽĖLĖS;57498275265;Taip;7;6;0;13
13529;Vėrinėlis;BORUŽĖLĖS;3703886468;Taip;0;2;0;2
13530;Vėrinėlis;BORUŽĖLĖS;1170817811;Taip;10;1;0;11
13531;Vėrinėlis;BORUŽĖLĖS;1410929889;Taip;0;7;0;7
13532;Vėrinėlis;BORUŽĖLĖS;65408541019;Taip;12;3;0;15
13533;Vėrinėlis;BORUŽĖLĖS;22726982138;Taip;16;0;0;16
13534;Vėrinėlis;BORUŽĖLĖS;30611731645;Taip;8;1;0;9
13535;Vėrinėlis;BORUŽĖLĖS;39884473503;Taip;1;0;0;1
13536;Vėrinėlis;BORUŽĖLĖS;25071096491;Taip;0;12;0;12
13537;Vėrinėlis;BORUŽĖLĖS;67282950717;Taip;7;0;0;7
13538;Vėrinėlis;BORUŽĖLĖS;7431541945;Taip;4;1;0;5
13539;Vėrinėlis;BORUŽĖLĖS;90264493281;Taip;0;10;0;10
13540;Vėrinėlis;BORUŽĖLĖS;89785057363;Taip;0;20;0;20
13541;Vėrinėlis;BORUŽĖLĖS;1028568095;Taip;0;1;0;1
13542;Vėrinėlis;BORUŽĖLĖS;4789626884;Taip;10;1;2;13
13543;Vėrinėlis;BORUŽĖLĖS;90979069296;Taip;0;10;0;10
13544;Vėrinėlis;BORUŽĖLĖS;67987598880;Taip;6;6;0;12
13545;Vėrinėlis;BORUŽĖLĖS;73256255966;Taip;10;0;1;11
13546;Vėrinėlis;SVEIKUOLIAI;87606501349;Taip;1;1;0;2
13547;Vėrinėlis;SVEIKUOLIAI;8964088661;Taip;0;0;20;20
13548;Vėrinėlis;SVEIKUOLIAI;19865450007;Taip;20;0;0;20
13549;Vėrinėlis;SVEIKUOLIAI;6869951613;Taip;5;3;0;8
13550;Vėrinėlis;SVEIKUOLIAI;1865151493;Taip;0;2;0;2
13551;Vėrinėlis;SVEIKUOLIAI;1395590011;Taip;12;0;0;12
13552;Vėrinėlis;SVEIKUOLIAI;9751037428;Taip;0;8;0;8
13553;Vėrinėlis;SVEIKUOLIAI;1513856520;Taip;0;0;8;8
13554;Vėrinėlis;SVEIKUOLIAI;3562371502;Taip;5;0;0;5
13555;Vėrinėlis;SVEIKUOLIAI;4089567420;Taip;2;0;1;3
13556;Vėrinėlis;SVEIKUOLIAI;5960946826;Taip;0;1;0;1
13557;Vėrinėlis;SVEIKUOLIAI;5496928903;Taip;5;0;0;5
13558;Vėrinėlis;SVEIKUOLIAI;7865276052;Taip;0;0;2;2
13559;Vėrinėlis;SVEIKUOLIAI;7981261038;Taip;0;8;0;8
13560;Vėrinėlis;SVEIKUOLIAI;6278738058;Taip;5;0;0;5
13561;Vėrinėlis;SVEIKUOLIAI;5511584499;Taip;4;0;2;6
13562;Vėrinėlis;SVEIKUOLIAI;6644892686;Taip;6;1;0;7
13563;Vėrinėlis;SVEIKUOLIAI;4958359640;Taip;12;0;0;12
13564;Vėrinėlis;ŠIRDELĖS;8579819581;Taip;12;5;0;17
13565;Vėrinėlis;ŠIRDELĖS;2944010445;Taip;0;0;9;9
13566;Vėrinėlis;ŠIRDELĖS;8195455092;Taip;6;1;3;10
13567;Vėrinėlis;ŠIRDELĖS;96779456411;Taip;6;0;2;8
13568;Vėrinėlis;ŠIRDELĖS;7167034587;Taip;5;5;0;10
13569;Vėrinėlis;ŠIRDELĖS;5712568063;Taip;11;0;2;13
13570;Vėrinėlis;ŠIRDELĖS;3049346950;Taip;14;0;1;15
13571;Vėrinėlis;ŠIRDELĖS;7070058961;Taip;0;7;0;7
13572;Vėrinėlis;ŠIRDELĖS;7130691686;Taip;15;0;0;15
13573;Vėrinėlis;ŠIRDELĖS;8709714647;Taip;0;0;12;12
13574;Vėrinėlis;ŠIRDELĖS;3308843618;Taip;0;5;0;5
13575;Vėrinėlis;ŠIRDELĖS;85262495209;Taip;10;7;0;17
13576;Vėrinėlis;ŠIRDELĖS;4039903678;Taip;1;0;0;1
13577;Vėrinėlis;ŠIRDELĖS;9119967823;Taip;0;0;2;2
13578;Vėrinėlis;ŠIRDELĖS;1467899937;Taip;7;0;0;7
13579;Vėrinėlis;ŠIRDELĖS;42298331453;Taip;9;6;0;15
13580;Vėrinėlis;ŠIRDELĖS;54361215161;Taip;0;0;2;2
13581;Vėrinėlis;ŠIRDELĖS;1135386852;Taip;11;0;0;11
13582;Vėrinėlis;ŠIRDELĖS;1535567719;Taip;11;3;0;14
13583;Viltenė;Drugeliai;7961006993;Taip;10;0;0;10
13584;Viltenė;Drugeliai;79464006792;Taip;0;5;0;5
13585;Viltenė;Drugeliai;70813966825;Taip;1;10;0;11
13586;Viltenė;Drugeliai;1936464823;Taip;0;4;0;4
13587;Viltenė;Drugeliai;50489733849;Ne;0;3;0;3
13588;Viltenė;Drugeliai;69838945768;Ne;5;0;0;5
13589;Viltenė;Drugeliai;54422258148;Taip;0;7;0;7
13590;Viltenė;Drugeliai;4322306031;Taip;7;1;0;8
13591;Viltenė;Drugeliai;82849073169;Taip;1;3;0;4
13592;Viltenė;Drugeliai;39676814294;Ne;11;0;0;11
13593;Viltenė;Drugeliai;47885567334;Taip;0;1;0;1
13594;Viltenė;Drugeliai;45275376273;Taip;5;6;0;11
13595;Viltenė;Drugeliai;1155378470;Taip;0;1;0;1
13596;Viltenė;Drugeliai;68110722913;Taip;0;1;0;1
13597;Viltenė;Drugeliai;21489308130;Taip;14;0;0;14
13598;Viltenė;Drugeliai;16461652415;Taip;0;11;0;11
13599;Viltenė;Drugeliai;91847807834;Taip;0;2;0;2
13600;Viltenė;Drugeliai;34691221253;Taip;0;11;0;11
13601;Viltenė;Drugeliai;33159619580;Taip;13;0;0;13
13602;Viltenė;Drugeliai;4586042895;Taip;5;0;0;5
13603;Viltenė;Drugeliai;7169597620;Taip;0;4;0;4
13604;Viltenė;Drugeliai;25504337581;Taip;9;0;0;9
13605;Viltenė;Drugeliai;1739353382;Taip;5;4;0;9
13606;Viltenė;Bitučių;21665885641;Taip;4;0;0;4
13607;Viltenė;Bitučių;1747442313;Taip;5;4;0;9
13608;Viltenė;Bitučių;61093082990;Taip;8;0;0;8
13609;Viltenė;Bitučių;13157765051;Taip;5;1;0;6
13610;Viltenė;Bitučių;46245753187;Taip;7;0;0;7
13611;Viltenė;Bitučių;2046122804;Taip;0;15;0;15
13612;Viltenė;Bitučių;74464437862;Taip;8;0;0;8
13613;Viltenė;Bitučių;93664116601;Ne;0;12;0;12
13614;Viltenė;Bitučių;86055366818;Taip;4;0;0;4
13615;Viltenė;Bitučių;66587678111;Taip;14;0;0;14
13616;Viltenė;Bitučių;65252989761;Taip;0;7;0;7
13617;Viltenė;Bitučių;84451732377;Taip;0;8;0;8
13618;Viltenė;Bitučių;1702925444;Taip;6;1;0;7
13619;Viltenė;Bitučių;6006470515;Taip;0;1;0;1
13620;Viltenė;Bitučių;8985943715;Taip;10;0;0;10
13621;Viltenė;Bitučių;1798739406;Taip;0;1;0;1
13622;Viltenė;Bitučių;1656026241;Taip;2;5;0;7
13623;Viltenė;Bitučių;4554162475;Taip;0;2;0;2
13624;Viltenė;Bitučių;1291605426;Taip;12;0;0;12
13625;Viltenė;Bitučių;6322746293;Taip;0;14;0;14
13626;Viltenė;Bitučių;4334881910;Taip;0;13;0;13
13627;Viltenė;Boružėlių;97823483581;Taip;0;8;0;8
13628;Viltenė;Boružėlių;27743584566;Taip;0;1;0;1
13629;Viltenė;Boružėlių;1657346055;Taip;0;4;0;4
13630;Viltenė;Boružėlių;24165965719;Taip;4;0;0;4
13631;Viltenė;Boružėlių;67943533456;Taip;9;0;0;9
13632;Viltenė;Boružėlių;45338320216;Taip;11;0;0;11
13633;Viltenė;Boružėlių;9858448228;Taip;9;0;0;9
13634;Viltenė;Boružėlių;58371160698;Taip;0;7;0;7
13635;Viltenė;Boružėlių;50651685299;Taip;5;0;0;5
13636;Viltenė;Boružėlių;43591393680;Taip;19;0;0;19
13637;Viltenė;Boružėlių;4053036431;Taip;6;0;0;6
13638;Viltenė;Boružėlių;27950438672;Taip;0;4;0;4
13639;Viltenė;Boružėlių;73607402351;Taip;8;1;0;9
13640;Viltenė;Boružėlių;1963420643;Taip;11;2;0;13
13641;Viltenė;Boružėlių;4548358886;Taip;0;7;0;7
13642;Viltenė;Boružėlių;4361513192;Taip;0;2;0;2
13643;Viltenė;Boružėlių;1830978436;Taip;0;1;0;1
13644;Viltenė;Boružėlių;9535128551;Taip;0;20;0;20
13645;Viltenė;Gandriukų;48816849840;Taip;5;1;0;6
13646;Viltenė;Gandriukų;65109318544;Taip;5;3;0;8
13647;Viltenė;Gandriukų;64883562677;Taip;0;3;0;3
13648;Viltenė;Gandriukų;14178563941;Taip;3;0;0;3
13649;Viltenė;Gandriukų;55479966961;Taip;6;4;0;10
13650;Viltenė;Gandriukų;69267964826;Taip;0;14;0;14
13651;Viltenė;Gandriukų;54622802635;Ne;0;12;0;12
13652;Viltenė;Gandriukų;15315166069;Taip;5;2;0;7
13653;Viltenė;Gandriukų;96889901141;Taip;0;1;0;1
13654;Viltenė;Gandriukų;35607778200;Taip;0;4;2;6
13655;Viltenė;Gandriukų;11271646485;Taip;6;5;0;11
13656;Viltenė;Gandriukų;40901810557;Ne;0;3;0;3
13657;Viltenė;Gandriukų;33038163612;Taip;6;0;0;6
13658;Viltenė;Gandriukų;69157590882;Taip;7;6;0;13
13659;Viltenė;Gandriukų;2122259485;Taip;0;1;1;2
13660;Viltenė;Gandriukų;16356755996;Taip;3;1;0;4
13661;Viltenė;Gandriukų;34334946258;Taip;11;0;0;11
13662;Viltenė;Gandriukų;8975037678;Taip;0;20;0;20
13663;Viltenė;Gandriukų;50612310300;Taip;8;0;2;10
13664;Viltenė;Gandriukų;31216445971;Ne;0;8;0;8
13665;Viltenė;Gandriukų;1487205453;Taip;5;0;0;5
13666;Viltenė;Gandriukų;1898136396;Taip;0;6;0;6
13667;Viltenė;Gandriukų;86027570047;Taip;10;0;0;10
13668;Viltenė;Gandriukų;98690857297;Taip;0;9;0;9
13669;Viltenė;Aitvariukai;8367775964;Taip;2;0;0;2
13670;Viltenė;Aitvariukai;95537304111;Taip;13;2;0;15
13671;Viltenė;Aitvariukai;95502667008;Taip;0;1;1;2
13672;Viltenė;Aitvariukai;51598096361;Taip;20;0;0;20
13673;Viltenė;Aitvariukai;15218988953;Taip;0;4;0;4
13674;Viltenė;Aitvariukai;9155192250;Taip;0;15;3;18
13675;Viltenė;Aitvariukai;5304966336;Taip;0;11;0;11
13676;Viltenė;Aitvariukai;3057761137;Taip;6;6;0;12
13677;Viltenė;Aitvariukai;6160715081;Taip;8;0;6;14
13678;Viltenė;Aitvariukai;5919786939;Taip;0;3;0;3
13679;Viltenė;Aitvariukai;17844870669;Taip;0;9;0;9
13680;Viltenė;Aitvariukai;56293220882;Taip;0;1;2;3
13681;Viltenė;Aitvariukai;96366849694;Taip;0;5;0;5
13682;Viltenė;Aitvariukai;8259812812;Taip;0;1;2;3
13683;Viltenė;Aitvariukai;23233966729;Taip;0;0;2;2
13684;Viltenė;Aitvariukai;44367763042;Taip;0;0;2;2
13685;Viltenė;Aitvariukai;99398043638;Taip;5;4;0;9
13686;Viltenė;Aitvariukai;1712349973;Taip;5;1;0;6
13687;Viltenė;Aitvariukai;55514676697;Taip;9;0;0;9
13688;Viltenė;Aitvariukai;14831307307;Taip;0;8;0;8
13689;Viltenė;Aitvariukai;70963916697;Taip;3;0;0;3
13690;Viltenė;Geniukų;5604263567;Taip;14;0;0;14
13691;Viltenė;Geniukų;1822220265;Taip;0;8;0;8
13692;Viltenė;Geniukų;9613791189;Taip;9;4;0;13
13693;Viltenė;Geniukų;6349032936;Taip;5;3;0;8
13694;Viltenė;Geniukų;7537754249;Taip;0;1;0;1
13695;Viltenė;Geniukų;1423254631;Taip;0;2;0;2
13696;Viltenė;Geniukų;3002690526;Taip;0;3;0;3
13697;Viltenė;Geniukų;6276349499;Taip;14;0;0;14
13698;Viltenė;Geniukų;3711956659;Taip;1;3;0;4
13699;Viltenė;Geniukų;1054469254;Taip;6;0;0;6
13700;Viltenė;Geniukų;4295285885;Taip;0;13;0;13
13701;Viltenė;Geniukų;6063181025;Taip;2;2;0;4
13702;Viltenė;Geniukų;1672091332;Taip;17;0;0;17
13703;Viltenė;Geniukų;9396183748;Taip;0;2;0;2
13704;Viltenė;Geniukų;4319685140;Taip;0;6;0;6
13705;Viltenė;Geniukų;6693601673;Taip;16;0;0;16
13706;Viltenė;Geniukų;8329611036;Taip;11;0;0;11
13707;Viltenė;Geniukų;8125023386;Taip;5;0;0;5
13708;Viltenė;Geniukų;8085993647;Taip;0;2;0;2
13709;Viltenė;Geniukų;9035687504;Taip;5;2;0;7
13710;Viltenė;Geniukų;5664573939;Taip;16;0;0;16
13711;Viltenė;Saulutės;2044754943;Taip;9;0;0;9
13712;Viltenė;Saulutės;6848403057;Taip;0;2;0;2
13713;Viltenė;Saulutės;1615415742;Taip;6;1;0;7
13714;Viltenė;Saulutės;7994367286;Taip;0;0;1;1
13715;Viltenė;Saulutės;9935236068;Taip;5;5;0;10
13716;Viltenė;Saulutės;6664059418;Taip;0;0;1;1
13717;Viltenė;Saulutės;2141002432;Taip;0;10;0;10
13718;Viltenė;Saulutės;8920533673;Taip;5;3;0;8
13719;Viltenė;Saulutės;5024192785;Taip;9;0;0;9
13720;Viltenė;Saulutės;92968672028;Taip;5;4;0;9
13721;Viltenė;Saulutės;3031926564;Taip;14;0;0;14
13722;Viltenė;Saulutės;1918867591;Taip;0;16;0;16
13723;Viltenė;Saulutės;1844509355;Taip;20;0;0;20
13724;Viltenė;Saulutės;7559243300;Taip;0;17;0;17
13725;Viltenė;Saulutės;3560474943;Taip;5;1;0;6
13726;Viltenė;Saulutės;2559945034;Taip;0;2;0;2
13727;Viltenė;Saulutės;2546789906;Taip;6;1;0;7
13728;Viltenė;Saulutės;3401975301;Taip;6;0;1;7
13729;Viltenė;Saulutės;9381280809;Taip;0;20;0;20
13730;Viltenė;Saulutės;7726650894;Taip;0;13;0;13
13731;Viltenė;Saulutės;1841732416;Taip;0;4;0;4
13732;Viltenė;Lapiukų;2016636764;Taip;12;0;0;12
13733;Viltenė;Lapiukų;1650304982;Taip;0;9;0;9
13734;Viltenė;Lapiukų;89844531860;Taip;0;1;0;1
13735;Viltenė;Lapiukų;8261531943;Taip;5;1;0;6
13736;Viltenė;Lapiukų;1884043126;Taip;2;0;0;2
13737;Viltenė;Lapiukų;60092202534;Taip;3;3;0;6
13738;Viltenė;Lapiukų;22318027000;Taip;0;3;0;3
13739;Viltenė;Lapiukų;1559623914;Taip;0;6;0;6
13740;Viltenė;Lapiukų;1503728117;Taip;0;10;0;10
13741;Viltenė;Lapiukų;1042196397;Taip;19;0;0;19
13742;Viltenė;Lapiukų;1210824560;Taip;14;2;0;16
13743;Viltenė;Lapiukų;2065651722;Taip;4;0;0;4
13744;Viltenė;Lapiukų;87698700338;Taip;2;1;0;3
13745;Viltenė;Lapiukų;3526237179;Taip;0;1;0;1
13746;Viltenė;Lapiukų;1662950901;Taip;5;0;0;5
13747;Viltenė;Lapiukų;1350487577;Taip;1;1;0;2
13748;Viltenė;Lapiukų;1592077335;Taip;0;20;0;20
13749;Viltenė;Lapiukų;1281808784;Taip;9;11;0;20
13750;Viltenė;Lapiukų;1726174128;Taip;10;0;0;10
13751;Viltenė;Lapiukų;4470172666;Taip;7;0;0;7
13752;Viltenė;Lapiukų;2527648089;Taip;11;2;0;13
13753;Viltenė;Lapiukų;93894985640;Taip;6;2;0;8
13754;Viltenė;Lapiukų;3259114583;Taip;4;11;0;15
13755;Viltenė;Voveriukai;8732323660;Taip;0;5;0;5
13756;Viltenė;Voveriukai;13795858727;Ne;12;1;0;13
13757;Viltenė;Voveriukai;1306624353;Taip;5;8;0;13
13758;Viltenė;Voveriukai;41763338811;Taip;5;0;0;5
13759;Viltenė;Voveriukai;46757944454;Taip;14;6;0;20
13760;Viltenė;Voveriukai;69918162258;Taip;11;0;0;11
13761;Viltenė;Voveriukai;76569470768;Taip;0;4;0;4
13762;Viltenė;Voveriukai;1262222404;Taip;7;0;0;7
13763;Viltenė;Voveriukai;69882566734;Taip;0;1;0;1
13764;Viltenė;Voveriukai;7245395388;Ne;0;1;0;1
13765;Viltenė;Voveriukai;77847693433;Taip;0;1;0;1
13766;Viltenė;Voveriukai;46252876577;Taip;0;5;0;5
13767;Viltenė;Voveriukai;92175043385;Taip;5;0;0;5
13768;Viltenė;Voveriukai;35466181637;Taip;5;0;1;6
13769;Viltenė;Voveriukai;54346881662;Taip;0;2;0;2
13770;Viltenė;Voveriukai;68243828276;Taip;0;4;0;4
13771;Viltenė;Voveriukai;1615151982;Taip;6;0;0;6
13772;Viltenė;Voveriukai;87296434240;Taip;0;1;0;1
13773;Viltenė;Voveriukai;5357769446;Taip;0;13;0;13
13774;Viltenė;Voveriukai;51997485918;Ne;0;7;0;7
13775;Viltenė;Voveriukai;1872042290;Taip;0;1;0;1
13776;Viltenė;Voveriukai;1926586646;Ne;0;1;0;1
13777;Viltenė;Voveriukai;2008408325;Ne;0;11;0;11
13778;Viltenė;Voveriukai;4441280059;Taip;14;0;0;14
13779;Viltenė;Triušikai;5280690534;Taip;0;0;1;1
13780;Viltenė;Triušikai;9242034622;Taip;9;0;0;9
13781;Viltenė;Triušikai;1243595112;Taip;11;0;0;11
13782;Viltenė;Triušikai;4388770140;Taip;7;0;0;7
13783;Viltenė;Triušikai;4604298036;Taip;0;9;0;9
13784;Viltenė;Triušikai;8110413064;Taip;9;1;0;10
13785;Viltenė;Triušikai;7693789849;Taip;4;16;0;20
13786;Viltenė;Triušikai;4036109404;Taip;11;0;0;11
13787;Viltenė;Triušikai;9756519374;Taip;20;0;0;20
13788;Viltenė;Triušikai;9820462941;Taip;14;0;0;14
13789;Viltenė;Triušikai;8527270437;Taip;0;1;0;1
13790;Viltenė;Triušikai;6621273812;Taip;0;1;0;1
13791;Viltenė;Triušikai;3278842582;Taip;5;2;0;7
13792;Viltenė;Triušikai;2026654467;Taip;5;4;0;9
13793;Viltenė;Triušikai;1598785483;Taip;16;0;0;16
13794;Viltenė;Triušikai;3073228245;Taip;2;0;2;4
13795;Viltenė;Triušikai;2383607612;Taip;6;0;1;7
13796;Viltenė;Triušikai;9197007374;Taip;0;17;0;17
13797;Viltenė;Triušikai;5522245968;Taip;0;2;0;2
13798;Viltenė;Kiškučiai;8549631247;Taip;12;0;0;12
13799;Viltenė;Kiškučiai;2884698447;Taip;7;2;0;9
13800;Viltenė;Kiškučiai;6481491422;Taip;2;0;0;2
13801;Viltenė;Kiškučiai;7092857844;Taip;0;6;0;6
13802;Viltenė;Kiškučiai;2452782594;Taip;6;0;0;6
13803;Viltenė;Kiškučiai;6355569231;Taip;0;20;0;20
13804;Viltenė;Kiškučiai;1126409020;Taip;8;1;0;9
13805;Viltenė;Kiškučiai;6555035887;Taip;7;1;0;8
13806;Viltenė;Kiškučiai;9228677568;Taip;1;4;0;5
13807;Viltenė;Kiškučiai;1840626621;Taip;2;4;0;6
13808;Viltenė;Kiškučiai;2815105107;Taip;1;1;0;2
13809;Viltenė;Kiškučiai;6511850468;Taip;0;17;0;17
13810;Viltenė;Kiškučiai;8477241365;Taip;20;0;0;20
13811;Viltenė;Kiškučiai;5850652322;Taip;15;1;0;16
13812;Viltenė;Kiškučiai;9187671201;Taip;10;0;0;10
13813;Viltenė;Kiškučiai;4616047113;Taip;9;0;0;9
13814;Viltenė;Kiškučiai;6060648988;Taip;19;0;0;19
13815;Viltenė;Kiškučiai;7796422726;Taip;6;1;0;7
13816;Viltenė;Nykštukų;4003018966;Taip;5;0;1;6
13817;Viltenė;Nykštukų;7912396297;Taip;3;6;0;9
13818;Viltenė;Nykštukų;3738838707;Taip;0;1;0;1
13819;Viltenė;Nykštukų;3777544301;Taip;5;1;0;6
13820;Viltenė;Nykštukų;9597857664;Taip;6;0;3;9
13821;Viltenė;Nykštukų;6642790962;Taip;11;0;0;11
13822;Viltenė;Nykštukų;9572407405;Taip;0;9;1;10
13823;Viltenė;Nykštukų;8473588098;Taip;9;6;0;15
13824;Viltenė;Nykštukų;3995418079;Taip;14;0;0;14
13825;Viltenė;Nykštukų;1399653129;Taip;8;0;7;15
13826;Viltenė;Nykštukų;4121448859;Taip;7;0;0;7
13827;Viltenė;Nykštukų;5599943846;Taip;17;0;0;17
13828;Viltenė;Nykštukų;3164402142;Taip;8;0;0;8
13829;Viltenė;Nykštukų;8603418399;Taip;16;0;0;16
13830;Viltenė;Nykštukų;5379804362;Taip;10;0;0;10
13831;Viltenė;Nykštukų;1936628249;Taip;0;2;0;2
13832;Viltenė;Nykštukų;6721689684;Taip;10;0;0;10
13833;Viltenė;Nykštukų;2585198498;Taip;14;0;0;14
13834;Viltenė;Nykštukų;7526555727;Taip;5;0;0;5
13835;Viltenė;Nykštukų;5552217000;Taip;6;1;0;7
13836;Voveraitė;ŽVIRBLIUKŲ;46063615245;Taip;5;4;0;9
13837;Voveraitė;ŽVIRBLIUKŲ;12366200545;Taip;0;3;0;3
13838;Voveraitė;ŽVIRBLIUKŲ;34170702690;Taip;6;0;0;6
13839;Voveraitė;ŽVIRBLIUKŲ;37044398892;Taip;0;1;0;1
13840;Voveraitė;ŽVIRBLIUKŲ;6903776113;Taip;12;4;0;16
13841;Voveraitė;ŽVIRBLIUKŲ;15716865051;Ne;0;11;0;11
13842;Voveraitė;ŽVIRBLIUKŲ;14865004407;Taip;1;4;0;5
13843;Voveraitė;ŽVIRBLIUKŲ;39956224681;Taip;1;12;0;13
13844;Voveraitė;ŽVIRBLIUKŲ;1261834247;Taip;0;14;0;14
13845;Voveraitė;ŽVIRBLIUKŲ;1055423524;Taip;0;11;0;11
13846;Voveraitė;ŽVIRBLIUKŲ;3137529068;Taip;0;8;0;8
13847;Voveraitė;ŽVIRBLIUKŲ;65838266846;Taip;11;1;0;12
13848;Voveraitė;ŽVIRBLIUKŲ;69198613700;Taip;5;0;0;5
13849;Voveraitė;ŽVIRBLIUKŲ;5357569948;Taip;0;7;0;7
13850;Voveraitė;VOVERIUKŲ;26264960973;Taip;5;2;0;7
13851;Voveraitė;VOVERIUKŲ;46318035221;Taip;3;1;0;4
13852;Voveraitė;VOVERIUKŲ;3818120898;Taip;10;9;0;19
13853;Voveraitė;VOVERIUKŲ;90300459408;Taip;5;0;0;5
13854;Voveraitė;VOVERIUKŲ;57033218205;Taip;12;1;0;13
13855;Voveraitė;VOVERIUKŲ;64724933885;Taip;3;1;0;4
13856;Voveraitė;VOVERIUKŲ;1587569563;Taip;6;0;0;6
13857;Voveraitė;VOVERIUKŲ;89873985894;Taip;0;2;0;2
13858;Voveraitė;VOVERIUKŲ;89216481616;Taip;12;2;0;14
13859;Voveraitė;VOVERIUKŲ;69797506996;Taip;14;4;0;18
13860;Voveraitė;VOVERIUKŲ;76074825733;Taip;7;4;0;11
13861;Voveraitė;VOVERIUKŲ;49205285378;Taip;0;5;0;5
13862;Voveraitė;VOVERIUKŲ;84508228457;Taip;12;2;0;14
13863;Voveraitė;VOVERIUKŲ;61376515242;Taip;0;8;0;8
13864;Voveraitė;VOVERIUKŲ;47111956594;Taip;5;3;0;8
13865;Voveraitė;VOVERIUKŲ;16514161872;Taip;0;2;0;2
13866;Voveraitė;VOVERIUKŲ;26080915874;Taip;0;9;0;9
13867;Voveraitė;VOVERIUKŲ;59442802443;Taip;1;5;0;6
13868;Voveraitė;VOVERIUKŲ;1398043988;Taip;10;0;0;10
13869;Voveraitė;VOVERIUKŲ;53801893219;Taip;0;4;0;4
13870;Voveraitė;KIŠKUČIŲ;3615729576;Ne;6;0;0;6
13871;Voveraitė;KIŠKUČIŲ;9231751171;Taip;2;2;0;4
13872;Voveraitė;KIŠKUČIŲ;4338861332;Taip;11;1;0;12
13873;Voveraitė;KIŠKUČIŲ;9933037872;Taip;13;0;0;13
13874;Voveraitė;KIŠKUČIŲ;3113780055;Taip;7;0;0;7
13875;Voveraitė;KIŠKUČIŲ;65926130735;Taip;7;0;0;7
13876;Voveraitė;KIŠKUČIŲ;7069780513;Taip;6;2;0;8
13877;Voveraitė;KIŠKUČIŲ;9997346812;Taip;16;2;0;18
13878;Voveraitė;KIŠKUČIŲ;9703726869;Taip;11;0;0;11
13879;Voveraitė;KIŠKUČIŲ;7314148938;Taip;3;0;0;3
13880;Voveraitė;KIŠKUČIŲ;4511771924;Taip;3;0;0;3
13881;Voveraitė;KIŠKUČIŲ;5521756833;Taip;20;0;0;20
13882;Voveraitė;KIŠKUČIŲ;9007031372;Taip;20;0;0;20
13883;Voveraitė;KIŠKUČIŲ;6369860178;Taip;0;20;0;20
13884;Voveraitė;KIŠKUČIŲ;6649068571;Taip;10;0;0;10
13885;Voveraitė;KIŠKUČIŲ;1775800865;Taip;0;7;0;7
13886;Voveraitė;KIŠKUČIŲ;6433760749;Taip;12;1;0;13
13887;Voveraitė;KODĖLČIUKŲ;3469734853;Taip;6;0;2;8
13888;Voveraitė;KODĖLČIUKŲ;9117809080;Taip;8;0;0;8
13889;Voveraitė;KODĖLČIUKŲ;5467979968;Taip;10;0;0;10
13890;Voveraitė;KODĖLČIUKŲ;46205148458;Taip;0;3;0;3
13891;Voveraitė;KODĖLČIUKŲ;1772758517;Taip;15;1;0;16
13892;Voveraitė;KODĖLČIUKŲ;9431523085;Taip;0;1;0;1
13893;Voveraitė;KODĖLČIUKŲ;51213803814;Taip;0;1;3;4
13894;Voveraitė;KODĖLČIUKŲ;36749754999;Taip;0;1;0;1
13895;Voveraitė;KODĖLČIUKŲ;6653141009;Taip;0;0;3;3
13896;Voveraitė;KODĖLČIUKŲ;4045121781;Taip;8;8;0;16
13897;Voveraitė;KODĖLČIUKŲ;2304004487;Taip;13;0;0;13
13898;Voveraitė;KODĖLČIUKŲ;2208396431;Taip;18;0;0;18
13899;Voveraitė;KODĖLČIUKŲ;6361417566;Taip;0;0;2;2
13900;Voveraitė;KODĖLČIUKŲ;5296850349;Taip;9;1;0;10
13901;Voveraitė;KODĖLČIUKŲ;2763656717;Taip;5;0;11;16
13902;Voveraitė;KODĖLČIUKŲ;4468214107;Taip;11;0;3;14
13903;Voveraitė;KODĖLČIUKŲ;9921313716;Taip;0;0;3;3
13904;Voveraitė;KODĖLČIUKŲ;5449490074;Taip;9;0;7;16
13905;Voveraitė;KODĖLČIUKŲ;7786378018;Taip;0;0;10;10
13906;Voveraitė;MEŠKIUKŲ;4079618555;Taip;0;8;0;8
13907;Voveraitė;MEŠKIUKŲ;3987058753;Taip;0;2;0;2
13908;Voveraitė;MEŠKIUKŲ;3381417855;Taip;0;4;0;4
13909;Voveraitė;MEŠKIUKŲ;3703062195;Taip;0;1;0;1
13910;Voveraitė;MEŠKIUKŲ;8438876806;Taip;12;4;0;16
13911;Voveraitė;MEŠKIUKŲ;1058273156;Taip;0;1;0;1
13912;Voveraitė;MEŠKIUKŲ;9149748841;Taip;5;4;0;9
13913;Voveraitė;MEŠKIUKŲ;5576058454;Taip;0;7;0;7
13914;Voveraitė;MEŠKIUKŲ;1629942114;Taip;0;11;0;11
13915;Voveraitė;MEŠKIUKŲ;6359983706;Taip;0;3;0;3
13916;Voveraitė;MEŠKIUKŲ;17534618616;Taip;0;5;0;5
13917;Voveraitė;MEŠKIUKŲ;1592633500;Taip;9;0;0;9
13918;Voveraitė;MEŠKIUKŲ;5437283673;Taip;4;2;0;6
13919;Voveraitė;MEŠKIUKŲ;7797966139;Taip;14;2;0;16
13920;Voveraitė;MEŠKIUKŲ;3029983180;Taip;0;5;0;5
13921;Voveraitė;MEŠKIUKŲ;9900940313;Taip;0;1;0;1
13922;Voveraitė;MEŠKIUKŲ;4680264973;Taip;0;3;0;3
13923;Voveraitė;MEŠKIUKŲ;5095849577;Taip;2;0;0;2
13924;Voveraitė;MEŠKIUKŲ;6886337758;Taip;0;15;0;15
13925;Voveraitė;BORUŽĖLIŲ;28598946561;Taip;0;7;0;7
13926;Voveraitė;BORUŽĖLIŲ;97620560960;Ne;0;1;0;1
13927;Voveraitė;BORUŽĖLIŲ;81073619227;Taip;0;11;0;11
13928;Voveraitė;BORUŽĖLIŲ;77602038332;Taip;0;1;0;1
13929;Voveraitė;BORUŽĖLIŲ;66403987802;Taip;0;6;0;6
13930;Voveraitė;BORUŽĖLIŲ;89152921324;Taip;5;7;0;12
13931;Voveraitė;BORUŽĖLIŲ;34369856708;Taip;0;1;0;1
13932;Voveraitė;BORUŽĖLIŲ;97109418554;Taip;0;6;0;6
13933;Voveraitė;BORUŽĖLIŲ;90671659606;Taip;0;2;0;2
13934;Voveraitė;BORUŽĖLIŲ;45746249613;Taip;0;5;3;8
13935;Voveraitė;BORUŽĖLIŲ;33234062327;Taip;0;3;0;3
13936;Voveraitė;BORUŽĖLIŲ;95730702606;Taip;0;1;0;1
13937;Voveraitė;BORUŽĖLIŲ;4440929639;Taip;0;9;5;14
13938;Voveraitė;BORUŽĖLIŲ;14945425849;Taip;0;4;0;4
13939;Voveraitė;BORUŽĖLIŲ;63634109515;Taip;4;3;0;7
13940;Voveraitė;BORUŽĖLIŲ;47199214035;Ne;0;3;0;3
13941;Voveraitė;BORUŽĖLIŲ;31214112756;Taip;0;3;0;3
13942;Voveraitė;BORUŽĖLIŲ;9288862466;Taip;0;3;0;3
13943;Voveraitė;PELĖDŽIUKŲ;59718931996;Taip;10;5;0;15
13944;Voveraitė;PELĖDŽIUKŲ;86565940690;Taip;0;5;0;5
13945;Voveraitė;PELĖDŽIUKŲ;2611108856;Taip;0;2;0;2
13946;Voveraitė;PELĖDŽIUKŲ;2009943498;Taip;9;0;0;9
13947;Voveraitė;PELĖDŽIUKŲ;6947553594;Taip;2;2;0;4
13948;Voveraitė;PELĖDŽIUKŲ;3114586597;Taip;20;0;0;20
13949;Voveraitė;PELĖDŽIUKŲ;76432985710;Taip;1;2;0;3
13950;Voveraitė;PELĖDŽIUKŲ;74161507529;Ne;9;0;0;9
13951;Voveraitė;PELĖDŽIUKŲ;85594406820;Taip;0;3;0;3
13952;Voveraitė;PELĖDŽIUKŲ;30591405375;Taip;0;7;0;7
13953;Voveraitė;PELĖDŽIUKŲ;42683378356;Taip;8;2;0;10
13954;Voveraitė;PELĖDŽIUKŲ;12670469264;Taip;4;6;0;10
13955;Voveraitė;PELĖDŽIUKŲ;68005956631;Taip;0;3;0;3
13956;Voveraitė;PELĖDŽIUKŲ;5232316253;Taip;0;2;0;2
13957;Voveraitė;PELĖDŽIUKŲ;32030461873;Taip;0;4;0;4
13958;Voveraitė;PELĖDŽIUKŲ;1273652060;Taip;0;11;0;11
13959;Voveraitė;PELĖDŽIUKŲ;68050017530;Taip;5;1;0;6
13960;Voveraitė;DRUGELIŲ;9623406874;Taip;14;3;0;17
13961;Voveraitė;DRUGELIŲ;1753442884;Taip;4;9;0;13
13962;Voveraitė;DRUGELIŲ;63032690186;Taip;0;12;0;12
13963;Voveraitė;DRUGELIŲ;7974406524;Taip;0;7;0;7
13964;Voveraitė;DRUGELIŲ;1032086466;Taip;0;5;0;5
13965;Voveraitė;DRUGELIŲ;2711136945;Taip;0;1;0;1
13966;Voveraitė;DRUGELIŲ;81628846458;Taip;12;5;0;17
13967;Voveraitė;DRUGELIŲ;2044914624;Taip;5;6;0;11
13968;Voveraitė;DRUGELIŲ;5037713667;Taip;4;0;0;4
13969;Voveraitė;DRUGELIŲ;2031078156;Taip;0;1;0;1
13970;Voveraitė;DRUGELIŲ;80330740714;Taip;16;1;0;17
13971;Voveraitė;DRUGELIŲ;6729475469;Taip;10;4;0;14
13972;Voveraitė;DRUGELIŲ;1397274691;Taip;0;17;0;17
13973;Voveraitė;DRUGELIŲ;1612322367;Taip;0;3;0;3
13974;Voveraitė;DRUGELIŲ;6847620019;Taip;0;19;0;19
13975;Voveraitė;DRUGELIŲ;53507758884;Taip;0;4;0;4
13976;Voveraitė;DRUGELIŲ;1780573926;Taip;10;0;0;10
13977;Voveraitė;DRUGELIŲ;8443005812;Taip;0;5;0;5
13978;Voveraitė;NYKŠTUKŲ;59346262217;Taip;5;8;0;13
13979;Voveraitė;NYKŠTUKŲ;44115826781;Taip;0;1;0;1
13980;Voveraitė;NYKŠTUKŲ;67851579200;Taip;0;2;0;2
13981;Voveraitė;NYKŠTUKŲ;2902148527;Taip;0;1;0;1
13982;Voveraitė;NYKŠTUKŲ;28656009009;Taip;5;5;0;10
13983;Voveraitė;NYKŠTUKŲ;1704834744;Taip;19;0;0;19
13984;Voveraitė;NYKŠTUKŲ;35549553867;Taip;0;2;0;2
13985;Voveraitė;NYKŠTUKŲ;49924157014;Taip;3;3;0;6
13986;Voveraitė;NYKŠTUKŲ;41182124889;Taip;0;1;0;1
13987;Voveraitė;NYKŠTUKŲ;13173711840;Taip;0;4;0;4
13988;Voveraitė;NYKŠTUKŲ;602726070;Taip;0;7;0;7
13989;Voveraitė;NYKŠTUKŲ;107968318;Taip;5;3;0;8
13990;Voveraitė;NYKŠTUKŲ;2762066479;Taip;11;0;0;11
13991;Voveraitė;NYKŠTUKŲ;66612277823;Taip;0;4;0;4
13992;Voveraitė;NYKŠTUKŲ;82642244788;Taip;2;2;0;4
13993;Voveraitė;NYKŠTUKŲ;1022447432;Taip;5;9;0;14
13994;Voveraitė;NYKŠTUKŲ;8666880821;Taip;14;4;0;18
13995;Voveraitė;NYKŠTUKŲ;2051732666;Taip;10;7;0;17
13996;Voveraitė;GENIUKŲ;23764078403;Taip;0;6;0;6
13997;Voveraitė;GENIUKŲ;29342867028;Taip;0;2;0;2
13998;Voveraitė;GENIUKŲ;78138420154;Taip;0;10;0;10
13999;Voveraitė;GENIUKŲ;18103338554;Taip;5;3;0;8
14000;Voveraitė;GENIUKŲ;92953475852;Taip;0;11;0;11
14001;Voveraitė;GENIUKŲ;3092390110;Taip;0;5;0;5
14002;Voveraitė;GENIUKŲ;6272832397;Taip;0;12;0;12
14003;Voveraitė;GENIUKŲ;6190239742;Taip;0;1;0;1
14004;Voveraitė;GENIUKŲ;90596813791;Taip;0;6;0;6
14005;Voveraitė;GENIUKŲ;1281767120;Taip;5;7;0;12
14006;Voveraitė;GENIUKŲ;1279597695;Taip;11;3;0;14
14007;Voveraitė;GENIUKŲ;59078135624;Taip;0;1;0;1
14008;Voveraitė;GENIUKŲ;57470452892;Taip;0;13;0;13
14009;Voveraitė;GENIUKŲ;28782803101;Taip;0;2;0;2
14010;Voveraitė;GENIUKŲ;67618706684;Taip;0;7;0;7
14011;Voveraitė;GENIUKŲ;50076604267;Taip;0;7;0;7
14012;Voveraitė;LAPIUKŲ;8925151080;Taip;0;0;6;6
14013;Voveraitė;LAPIUKŲ;4300235743;Taip;14;0;0;14
14014;Voveraitė;LAPIUKŲ;6684234832;Taip;0;0;3;3
14015;Voveraitė;LAPIUKŲ;9715405072;Taip;6;0;0;6
14016;Voveraitė;LAPIUKŲ;1441921029;Taip;7;0;0;7
14017;Voveraitė;LAPIUKŲ;8119493388;Taip;0;2;4;6
14018;Voveraitė;LAPIUKŲ;5804351872;Taip;0;0;1;1
14019;Voveraitė;LAPIUKŲ;2450726148;Taip;0;0;2;2
14020;Voveraitė;LAPIUKŲ;7531020548;Taip;8;3;0;11
14021;Voveraitė;LAPIUKŲ;7244142828;Taip;17;3;0;20
14022;Voveraitė;LAPIUKŲ;5510544648;Taip;14;0;1;15
14023;Voveraitė;LAPIUKŲ;3582805599;Taip;7;0;0;7
14024;Voveraitė;LAPIUKŲ;1988082807;Taip;6;0;0;6
14025;Voveraitė;LAPIUKŲ;6994680282;Taip;10;0;0;10
14026;Voveraitė;LAPIUKŲ;5705303891;Taip;7;0;12;19
14027;Voveraitė;LAPIUKŲ;6959751328;Taip;14;0;0;14
14028;Voveraitė;EŽIUKŲ;8373093305;Taip;15;0;0;15
14029;Voveraitė;EŽIUKŲ;2246291631;Taip;10;1;0;11
14030;Voveraitė;EŽIUKŲ;4324619869;Taip;4;1;0;5
14031;Voveraitė;EŽIUKŲ;1960385335;Taip;17;3;0;20
14032;Voveraitė;EŽIUKŲ;2322594823;Taip;20;0;0;20
14033;Voveraitė;EŽIUKŲ;6007396459;Taip;13;1;0;14
14034;Voveraitė;EŽIUKŲ;6073270223;Taip;3;6;4;13
14035;Voveraitė;EŽIUKŲ;2662384275;Taip;6;1;0;7
14036;Voveraitė;EŽIUKŲ;4563198733;Taip;6;11;0;17
14037;Voveraitė;EŽIUKŲ;7746424196;Taip;12;0;0;12
14038;Voveraitė;EŽIUKŲ;2594535017;Taip;5;0;0;5
14039;Voveraitė;EŽIUKŲ;9912862474;Taip;5;7;0;12
14040;Voveraitė;EŽIUKŲ;1340379090;Taip;7;4;0;11
14041;Voveraitė;EŽIUKŲ;5138855000;Taip;10;0;0;10
14042;Voveraitė;EŽIUKŲ;9195700962;Taip;5;12;0;17
14043;Voveraitė;EŽIUKŲ;1515087924;Taip;5;0;0;5
14044;"Trakų Vokė";Voveriukų;7858812338;Taip;11;0;1;12
14045;"Trakų Vokė";Voveriukų;2730385281;Taip;10;0;0;10
14046;"Trakų Vokė";Voveriukų;4854440884;Taip;20;0;0;20
14047;"Trakų Vokė";Voveriukų;2761614687;Taip;20;0;0;20
14048;"Trakų Vokė";Voveriukų;6234943180;Taip;5;0;11;16
14049;"Trakų Vokė";Voveriukų;5909584565;Taip;5;0;11;16
14050;"Trakų Vokė";Voveriukų;3913623741;Taip;10;0;1;11
14051;"Trakų Vokė";Voveriukų;6732422645;Taip;12;0;0;12
14052;"Trakų Vokė";Voveriukų;3209594216;Taip;11;0;0;11
14053;"Trakų Vokė";Voveriukų;5338798362;Taip;19;0;0;19
14054;"Trakų Vokė";Voveriukų;4040038648;Taip;0;6;1;7
14055;"Trakų Vokė";Voveriukų;3319243283;Taip;9;0;2;11
14056;"Trakų Vokė";Voveriukų;7727246187;Taip;1;0;8;9
14057;"Trakų Vokė";Voveriukų;3611639112;Taip;12;0;1;13
14058;"Trakų Vokė";Voveriukų;5206616285;Taip;19;0;0;19
14059;"Trakų Vokė";Boružėlių;84749146259;Taip;14;0;1;15
14060;"Trakų Vokė";Boružėlių;1100961040;Taip;5;0;0;5
14061;"Trakų Vokė";Boružėlių;38738283929;Taip;0;14;0;14
14062;"Trakų Vokė";Boružėlių;71993634591;Taip;10;0;1;11
14063;"Trakų Vokė";Boružėlių;1809637955;Taip;19;0;0;19
14064;"Trakų Vokė";Boružėlių;32336388708;Taip;10;0;0;10
14065;"Trakų Vokė";Boružėlių;1994808263;Taip;5;0;0;5
14066;"Trakų Vokė";Boružėlių;76399539244;Taip;0;11;0;11
14067;"Trakų Vokė";Boružėlių;39658854196;Taip;5;0;0;5
14068;"Trakų Vokė";Boružėlių;92262591306;Taip;5;3;0;8
14069;"Trakų Vokė";Boružėlių;37080835526;Taip;5;3;0;8
14070;"Trakų Vokė";Boružėlių;9642375918;Taip;3;3;0;6
14071;"Trakų Vokė";Boružėlių;89851471527;Taip;10;2;0;12
14072;"Trakų Vokė";Boružėlių;96632696431;Taip;5;0;1;6
14073;"Trakų Vokė";Boružėlių;43780546254;Taip;10;9;0;19
14074;"Trakų Vokė";Boružėlių;1805549433;Taip;5;0;1;6
14075;"Trakų Vokė";Boružėlių;66607811394;Taip;5;0;1;6
14076;"Trakų Vokė";Boružėlių;66867557436;Taip;5;0;0;5
14077;"Trakų Vokė";Boružėlių;68968521202;Taip;14;0;1;15
14078;"Trakų Vokė";Boružėlių;95403241312;Taip;6;0;0;6
14079;"Trakų Vokė";Boružėlių;1837766168;Taip;14;0;0;14
14080;"Trakų Vokė";Boružėlių;1858168427;Taip;3;6;0;9
14081;"Trakų Vokė";Boružėlių;49616069190;Taip;8;0;0;8
14082;"Trakų Vokė";Boružėlių;4409993300;Taip;17;0;1;18
14083;"Trakų Vokė";Boružėlių;2466258377;Ne;8;2;0;10
14084;"Trakų Vokė";BITUTUČIŲ;4903261568;Taip;0;6;1;7
14085;"Trakų Vokė";BITUTUČIŲ;4846130117;Taip;19;0;0;19
14086;"Trakų Vokė";BITUTUČIŲ;1461337199;Taip;5;0;0;5
14087;"Trakų Vokė";BITUTUČIŲ;7792654474;Taip;12;0;2;14
14088;"Trakų Vokė";BITUTUČIŲ;39255784762;Taip;7;0;0;7
14089;"Trakų Vokė";BITUTUČIŲ;50553766116;Taip;3;0;1;4
14090;"Trakų Vokė";BITUTUČIŲ;1433982328;Taip;10;0;0;10
14091;"Trakų Vokė";BITUTUČIŲ;2918937134;Taip;20;0;0;20
14092;"Trakų Vokė";BITUTUČIŲ;8542147751;Taip;1;0;0;1
14093;"Trakų Vokė";BITUTUČIŲ;1623166260;Taip;0;0;1;1
14094;"Trakų Vokė";BITUTUČIŲ;3406479364;Taip;13;0;0;13
14095;"Trakų Vokė";BITUTUČIŲ;1339594734;Taip;5;0;0;5
14096;"Trakų Vokė";BITUTUČIŲ;95320712086;Taip;5;0;0;5
14097;"Trakų Vokė";BITUTUČIŲ;5526830430;Taip;10;0;2;12
14098;"Trakų Vokė";BITUTUČIŲ;4914675622;Taip;4;0;3;7
14099;"Trakų Vokė";BITUTUČIŲ;1590598232;Taip;15;0;0;15
14100;"Trakų Vokė";BITUTUČIŲ;3373764541;Taip;9;0;0;9
14101;"Trakų Vokė";BITUTUČIŲ;2839396687;Taip;5;0;9;14
14102;"Trakų Vokė";BITUTUČIŲ;4849992906;Taip;10;9;0;19
14103;"Trakų Vokė";BITUTUČIŲ;8857529726;Taip;5;0;0;5
14104;"Trakų Vokė";BITUTUČIŲ;6221283878;Taip;0;0;4;4
14105;"Trakų Vokė";BITUTUČIŲ;3098390989;Taip;20;0;0;20
14106;"Trakų Vokė";BITUTUČIŲ;8997890367;Taip;5;0;0;5
14107;"Trakų Vokė";KIŠKUČIŲ;15897808544;Taip;2;1;6;9
14108;"Trakų Vokė";KIŠKUČIŲ;88989814775;Taip;5;0;0;5
14109;"Trakų Vokė";KIŠKUČIŲ;6675993703;Taip;14;0;0;14
14110;"Trakų Vokė";KIŠKUČIŲ;87781186373;Taip;3;1;0;4
14111;"Trakų Vokė";KIŠKUČIŲ;69866048102;Taip;14;0;0;14
14112;"Trakų Vokė";KIŠKUČIŲ;64083541565;Taip;9;0;1;10
14113;"Trakų Vokė";KIŠKUČIŲ;67434532111;Taip;7;6;0;13
14114;"Trakų Vokė";KIŠKUČIŲ;26598573711;Taip;20;0;0;20
14115;"Trakų Vokė";KIŠKUČIŲ;69311478204;Taip;11;0;0;11
14116;"Trakų Vokė";KIŠKUČIŲ;71417288063;Taip;0;0;20;20
14117;"Trakų Vokė";KIŠKUČIŲ;40200309769;Taip;0;0;1;1
14118;"Trakų Vokė";KIŠKUČIŲ;9705561511;Taip;2;0;3;5
14119;"Trakų Vokė";KIŠKUČIŲ;44023296535;Taip;0;5;0;5
14120;"Trakų Vokė";KIŠKUČIŲ;6418198934;Taip;16;0;0;16
14121;"Trakų Vokė";KIŠKUČIŲ;50697040061;Taip;0;11;0;11
14122;"Trakų Vokė";KIŠKUČIŲ;9135918587;Taip;5;0;1;6
14123;"Trakų Vokė";KIŠKUČIŲ;6362889550;Taip;5;0;2;7
14124;"Trakų Vokė";KIŠKUČIŲ;64019248229;Taip;1;0;0;1
14125;"Trakų Vokė";KIŠKUČIŲ;18796898215;Taip;8;0;1;9
14126;"Trakų Vokė";KIŠKUČIŲ;86504089176;Taip;1;0;1;2
14127;"Trakų Vokė";KIŠKUČIŲ;21329819892;Taip;12;0;0;12
14128;"Trakų Vokė";KIŠKUČIŲ;3210453801;Taip;6;5;2;13
14129;"Trakų Vokė";KIŠKUČIŲ;7753488216;Taip;11;0;1;12
14130;Zylutė;Katerok;62853712925;Taip;5;1;0;6
14131;Zylutė;Katerok;27007947432;Taip;5;0;3;8
14132;Zylutė;Katerok;54983937726;Taip;13;0;3;16
14133;Zylutė;Katerok;39472285691;Taip;0;1;0;1
14134;Zylutė;Katerok;43987426917;Taip;0;9;0;9
14135;Zylutė;Katerok;33326400213;Taip;0;6;0;6
14136;Zylutė;Katerok;86433183983;Taip;5;4;0;9
14137;Zylutė;Katerok;76259638454;Taip;0;8;0;8
14138;Zylutė;Katerok;54959972125;Ne;0;13;0;13
14139;Zylutė;Katerok;80556519366;Taip;0;1;0;1
14140;Zylutė;Katerok;1948356081;Taip;7;6;0;13
14141;Zylutė;Katerok;42734146389;Taip;9;1;0;10
14142;Zylutė;Katerok;53283282669;Taip;5;0;8;13
14143;Zylutė;Katerok;79923744237;Ne;6;5;0;11
14144;Zylutė;Katerok;58045325209;Taip;0;1;0;1
14145;Zylutė;Katerok;1005572131;Taip;0;0;2;2
14146;Zylutė;"Vesole misiaki";15597884044;Taip;2;2;0;4
14147;Zylutė;"Vesole misiaki";84947394033;Taip;0;4;0;4
14148;Zylutė;"Vesole misiaki";52918539110;Taip;5;2;0;7
14149;Zylutė;"Vesole misiaki";66338689682;Taip;5;0;0;5
14150;Zylutė;"Vesole misiaki";5323116194;Taip;10;1;0;11
14151;Zylutė;"Vesole misiaki";74314676598;Taip;0;6;0;6
14152;Zylutė;"Vesole misiaki";1911748280;Taip;0;1;0;1
14153;Zylutė;"Vesole misiaki";62887824954;Taip;5;0;0;5
14154;Zylutė;"Vesole misiaki";92871710315;Taip;9;0;0;9
14155;Zylutė;"Vesole misiaki";86301183281;Taip;12;1;0;13
14156;Zylutė;"Vesole misiaki";1623576857;Taip;1;4;0;5
14157;Zylutė;"Vesole misiaki";43690245314;Taip;0;1;0;1
14158;Zylutė;"Vesole misiaki";1256879956;Taip;5;10;0;15
14159;Zylutė;"Vesole misiaki";3126726854;Taip;14;4;0;18
14160;Zylutė;"Vesole misiaki";9484752315;Taip;0;7;0;7
14161;Zylutė;"Vesole misiaki";7140223126;Taip;6;5;0;11
14162;Zylutė;"Vesole misiaki";81796510706;Taip;15;0;0;15
14163;Zylutė;"Vesole misiaki";7606434084;Taip;5;2;0;7
14164;Zylutė;"Vesole misiaki";6299191475;Taip;6;5;0;11
14165;Zylutė;NYKŠTUKAI;88823731584;Ne;0;3;0;3
14166;Zylutė;NYKŠTUKAI;91938227358;Taip;0;15;0;15
14167;Zylutė;NYKŠTUKAI;55672880453;Taip;10;1;0;11
14168;Zylutė;NYKŠTUKAI;63798640792;Taip;6;4;0;10
14169;Zylutė;NYKŠTUKAI;19429820228;Taip;6;4;0;10
14170;Zylutė;NYKŠTUKAI;89083249598;Taip;0;0;1;1
14171;Zylutė;NYKŠTUKAI;53165044678;Taip;10;0;0;10
14172;Zylutė;NYKŠTUKAI;42712894954;Taip;10;1;0;11
14173;Zylutė;NYKŠTUKAI;87231809477;Taip;0;0;13;13
14174;Zylutė;NYKŠTUKAI;1584743051;Taip;15;0;0;15
14175;Zylutė;NYKŠTUKAI;1187261223;Taip;0;3;0;3
14176;Zylutė;NYKŠTUKAI;2276463136;Taip;15;0;0;15
14177;Zylutė;NYKŠTUKAI;7042731356;Taip;11;0;0;11
14178;Zylutė;NYKŠTUKAI;27488840113;Taip;10;4;1;15
14179;Zylutė;NYKŠTUKAI;35300054087;Taip;0;2;0;2
14180;Zylutė;NYKŠTUKAI;15110117571;Taip;20;0;0;20
14181;Zylutė;NYKŠTUKAI;1699222615;Taip;0;0;6;6
14182;Zylutė;NYKŠTUKAI;3246229837;Taip;14;0;0;14
14183;Zylutė;Ručijok;9913001904;Taip;8;2;0;10
14184;Zylutė;Ručijok;4415020772;Taip;0;0;1;1
14185;Zylutė;Ručijok;6221528830;Taip;5;1;1;7
14186;Zylutė;Ručijok;3608920051;Taip;0;9;0;9
14187;Zylutė;Ručijok;3117948118;Taip;0;13;0;13
14188;Zylutė;Ručijok;7241045507;Taip;0;0;4;4
14189;Zylutė;Ručijok;3826815202;Taip;5;1;0;6
14190;Zylutė;Ručijok;3943002728;Taip;6;0;0;6
14191;Zylutė;Ručijok;9381656201;Taip;20;0;0;20
14192;Zylutė;Ručijok;2654373943;Taip;12;1;0;13
14193;Zylutė;Ručijok;9325387975;Taip;7;6;0;13
14194;Zylutė;Ručijok;4497904128;Taip;20;0;0;20
14195;Zylutė;Ručijok;1423890598;Taip;9;0;1;10
14196;Zylutė;Ručijok;5264930854;Taip;0;4;0;4
14197;Zylutė;Ručijok;6569135467;Taip;0;0;5;5
14198;Zylutė;Ručijok;3363212754;Taip;14;0;3;17
14199;Zylutė;Raduga;31724596372;Taip;7;0;0;7
14200;Zylutė;Raduga;1756267879;Taip;15;0;0;15
14201;Zylutė;Raduga;42101273435;Taip;0;0;1;1
14202;Zylutė;Raduga;71494345484;Taip;0;3;0;3
14203;Zylutė;Raduga;24566804095;Taip;15;0;0;15
14204;Zylutė;Raduga;54294082958;Taip;6;7;0;13
14205;Zylutė;Raduga;11546608192;Taip;20;0;0;20
14206;Zylutė;Raduga;27116746304;Taip;5;6;0;11
14207;Zylutė;Raduga;31057429533;Taip;7;0;0;7
14208;Zylutė;Raduga;1035415228;Taip;0;3;0;3
14209;Zylutė;Raduga;1059365398;Taip;11;5;0;16
14210;Zylutė;Raduga;2092027180;Taip;0;14;0;14
14211;Zylutė;Raduga;60768660940;Taip;0;14;0;14
14212;Zylutė;Raduga;1840757726;Taip;4;2;0;6
14213;Zylutė;Raduga;78048289126;Taip;20;0;0;20
14214;Zylutė;Raduga;86343860903;Taip;0;6;0;6
14215;Zylutė;Raduga;6965021762;Taip;0;3;0;3
14216;Zylutė;Raduga;3179737181;Ne;8;0;0;8
14217;Zylutė;Raduga;1098174103;Taip;0;9;0;9
14218;Zylutė;"Miki Maus";9457189905;Taip;0;5;0;5
14219;Zylutė;"Miki Maus";9664467134;Taip;0;1;0;1
14220;Zylutė;"Miki Maus";8336138549;Taip;0;11;0;11
14221;Zylutė;"Miki Maus";8638652914;Taip;4;3;0;7
14222;Zylutė;"Miki Maus";9953834483;Taip;10;3;0;13
14223;Zylutė;"Miki Maus";2445444641;Taip;17;0;0;17
14224;Zylutė;"Miki Maus";9908198854;Taip;0;9;0;9
14225;Zylutė;"Miki Maus";4493469560;Taip;6;0;0;6
14226;Zylutė;"Miki Maus";5670953383;Taip;0;0;7;7
14227;Zylutė;"Miki Maus";5027134228;Taip;10;3;0;13
14228;Zylutė;"Miki Maus";4715704693;Taip;10;0;0;10
14229;Zylutė;"Miki Maus";4543822765;Taip;8;5;0;13
14230;Zylutė;"Miki Maus";4566817285;Taip;7;0;0;7
14231;Zylutė;"Miki Maus";2968625045;Taip;12;0;0;12
14232;Zylutė;"Miki Maus";2092319455;Taip;14;0;0;14
14233;Zylutė;Solnyško;52293061924;Taip;0;18;0;18
14234;Zylutė;Solnyško;50784859977;Taip;0;4;0;4
14235;Zylutė;Solnyško;1212526573;Taip;2;6;0;8
14236;Zylutė;Solnyško;2020113161;Taip;7;0;0;7
14237;Zylutė;Solnyško;2058827699;Taip;0;1;0;1
14238;Zylutė;Solnyško;1328824849;Ne;0;3;0;3
14239;Zylutė;Solnyško;37968324911;Taip;0;5;0;5
14240;Zylutė;Solnyško;16723015849;Taip;6;1;0;7
14241;Zylutė;Solnyško;64228069840;Taip;6;0;0;6
14242;Zylutė;Solnyško;22635713064;Taip;4;0;0;4
14243;Zylutė;Solnyško;98295398362;Taip;13;2;0;15
14244;Zylutė;Solnyško;63287117036;Taip;0;3;0;3
14245;Zylutė;Solnyško;1004049147;Taip;8;0;0;8
14246;Zylutė;Solnyško;8582483538;Taip;9;0;0;9
14247;Zylutė;Solnyško;2910542367;Taip;0;12;0;12
14248;Zylutė;Solnyško;1979823314;Taip;10;4;0;14
14249;Zylutė;Solnyško;9728065395;Taip;16;0;0;16
14250;Zylutė;Solnyško;36486637873;Ne;4;0;0;4
14251;Zylutė;Solnyško;5090740854;Taip;16;2;0;18
14252;Zylutė;Motyliok;45252076215;Ne;7;8;0;15
14253;Zylutė;Motyliok;45779928616;Taip;6;4;0;10
14254;Zylutė;Motyliok;1001570452;Taip;4;0;0;4
14255;Zylutė;Motyliok;35364823312;Taip;0;5;0;5
14256;Zylutė;Motyliok;20333534526;Taip;0;4;0;4
14257;Zylutė;Motyliok;1897162912;Taip;6;0;0;6
14258;Zylutė;Motyliok;1801436436;Taip;14;0;0;14
14259;Zylutė;Motyliok;1445891751;Taip;6;6;0;12
14260;Zylutė;Motyliok;1284845681;Taip;4;0;1;5
14261;Zylutė;Motyliok;1873200936;Taip;2;0;0;2
14262;Zylutė;Motyliok;8546942240;Taip;5;0;0;5
14263;Zylutė;Motyliok;7298260831;Taip;0;5;0;5
14264;Zylutė;Motyliok;2306517891;Taip;3;0;0;3
14265;Zylutė;Motyliok;5803032683;Taip;19;0;0;19
14266;Zylutė;Motyliok;3089235413;Taip;20;0;0;20
14267;Zylutė;Motyliok;23826981323;Taip;20;0;0;20
14268;Zylutė;Motyliok;1094217042;Taip;19;0;0;19
14269;Zylutė;Motyliok;1145364380;Taip;20;0;0;20
14270;Zylutė;Motyliok;7712651566;Ne;4;7;0;11
14271;Zylutė;"DRUŽNYJE REBIATA";12377363480;Taip;20;0;0;20
14272;Zylutė;"DRUŽNYJE REBIATA";1428614163;Taip;11;1;0;12
14273;Zylutė;"DRUŽNYJE REBIATA";1674095701;Taip;19;0;0;19
14274;Zylutė;"DRUŽNYJE REBIATA";3379725202;Taip;0;1;0;1
14275;Zylutė;"DRUŽNYJE REBIATA";3843999609;Taip;20;0;0;20
14276;Zylutė;"DRUŽNYJE REBIATA";3036582121;Taip;5;5;0;10
14277;Zylutė;"DRUŽNYJE REBIATA";9163527400;Taip;7;0;0;7
14278;Zylutė;"DRUŽNYJE REBIATA";2157398751;Taip;7;0;0;7
14279;Zylutė;"DRUŽNYJE REBIATA";4302751308;Taip;16;0;0;16
14280;Zylutė;"DRUŽNYJE REBIATA";8293541980;Taip;8;0;0;8
14281;Zylutė;"DRUŽNYJE REBIATA";5452659798;Taip;5;6;0;11
14282;Zylutė;"DRUŽNYJE REBIATA";9589810356;Taip;9;0;2;11
14283;Zylutė;"DRUŽNYJE REBIATA";5224781417;Ne;4;4;0;8
14284;Zylutė;"DRUŽNYJE REBIATA";5162635301;Taip;20;0;0;20
14285;Zylutė;"DRUŽNYJE REBIATA";7023565057;Taip;20;0;0;20
14286;Zylutė;"DRUŽNYJE REBIATA";5641148690;Taip;17;3;0;20
14287;Zylutė;"DRUŽNYJE REBIATA";7804533930;Taip;6;0;0;6
14288;Zylutė;VIEVERSĖLIAI;2125519672;Taip;0;1;0;1
14289;Zylutė;VIEVERSĖLIAI;4505081448;Taip;3;0;0;3
14290;Zylutė;VIEVERSĖLIAI;2104570334;Taip;6;5;0;11
14291;Zylutė;VIEVERSĖLIAI;72716975865;Taip;13;0;0;13
14292;Zylutė;VIEVERSĖLIAI;3055559237;Taip;8;0;0;8
14293;Zylutė;VIEVERSĖLIAI;2125424949;Taip;0;8;0;8
14294;Zylutė;VIEVERSĖLIAI;6275164528;Taip;11;0;0;11
14295;Zylutė;VIEVERSĖLIAI;5172154642;Taip;13;0;0;13
14296;Zylutė;VIEVERSĖLIAI;2943888466;Taip;2;0;0;2
14297;Zylutė;VIEVERSĖLIAI;6907378757;Taip;11;0;0;11
14298;Zylutė;VIEVERSĖLIAI;6723650872;Taip;5;0;0;5
14299;Zylutė;VIEVERSĖLIAI;3810636967;Taip;5;1;0;6
14300;Zylutė;VIEVERSĖLIAI;6154352500;Taip;0;1;0;1
14301;Zylutė;VIEVERSĖLIAI;9660898505;Taip;0;13;0;13
14302;Zylutė;VIEVERSĖLIAI;57138305703;Taip;0;7;0;7
14303;Zylutė;VIEVERSĖLIAI;5544338521;Taip;16;0;0;16
14304;Zylutė;VIEVERSĖLIAI;1897871944;Taip;0;4;0;4
14305;Zylutė;VIEVERSĖLIAI;4764295850;Taip;12;4;0;16
14306;Zylutė;VIEVERSĖLIAI;5687201052;Taip;10;0;0;10
14307;Zylutė;VIEVERSĖLIAI;1750040659;Taip;14;1;0;15
14308;Želmenėliai;Bitučių;43295789978;Taip;0;6;0;6
14309;Želmenėliai;Bitučių;97786398830;Taip;0;4;0;4
14310;Želmenėliai;Bitučių;66377316300;Taip;0;13;0;13
14311;Želmenėliai;Bitučių;8440363769;Taip;0;8;0;8
14312;Želmenėliai;Bitučių;14467050269;Taip;0;2;0;2
14313;Želmenėliai;Bitučių;77393977996;Taip;0;1;0;1
14314;Želmenėliai;Bitučių;36928282518;Taip;0;1;0;1
14315;Želmenėliai;Bitučių;1342057909;Taip;0;4;0;4
14316;Želmenėliai;Bitučių;83607110446;Taip;12;3;0;15
14317;Želmenėliai;Bitučių;93445022509;Taip;0;2;0;2
14318;Želmenėliai;Bitučių;1158828889;Taip;0;5;0;5
14319;Želmenėliai;Bitučių;2162788756;Taip;6;3;0;9
14320;Želmenėliai;Bitučių;3039903984;Ne;13;5;0;18
14321;Želmenėliai;Bitučių;1865274706;Taip;0;4;0;4
14322;Želmenėliai;Bitučių;5501491970;Taip;7;1;0;8
14323;Želmenėliai;Bitučių;1063647379;Ne;0;10;0;10
14324;Želmenėliai;Bitučių;71088679480;Taip;5;2;0;7
14325;Želmenėliai;Bitučių;7911857247;Taip;6;3;0;9
14326;Želmenėliai;Kačiukų;55423287751;Taip;0;10;0;10
14327;Želmenėliai;Kačiukų;53611793303;Taip;6;1;0;7
14328;Želmenėliai;Kačiukų;6806260100;Taip;0;2;0;2
14329;Želmenėliai;Kačiukų;25991128602;Taip;0;3;0;3
14330;Želmenėliai;Kačiukų;50204719384;Taip;6;9;0;15
14331;Želmenėliai;Kačiukų;54492404542;Taip;5;0;0;5
14332;Želmenėliai;Kačiukų;40147904205;Taip;9;0;0;9
14333;Želmenėliai;Kačiukų;75215159489;Taip;0;13;0;13
14334;Želmenėliai;Kačiukų;68168210430;Taip;20;0;0;20
14335;Želmenėliai;Kačiukų;52474082386;Taip;8;10;0;18
14336;Želmenėliai;Kačiukų;32945118976;Taip;0;1;0;1
14337;Želmenėliai;Kačiukų;72091418618;Taip;0;5;0;5
14338;Želmenėliai;Kačiukų;72029098066;Taip;0;10;0;10
14339;Želmenėliai;Kačiukų;59968327015;Taip;0;1;0;1
14340;Želmenėliai;Kačiukų;25744693727;Taip;0;5;0;5
14341;Želmenėliai;Kačiukų;41941728755;Taip;10;0;0;10
14342;Želmenėliai;Kačiukų;2005437403;Taip;0;5;0;5
14343;Želmenėliai;Kačiukų;1744939559;Taip;5;0;0;5
14344;Želmenėliai;Kačiukų;27187464726;Taip;0;1;0;1
14345;Želmenėliai;Voveriukų;1064518850;Taip;0;2;0;2
14346;Želmenėliai;Voveriukų;11316462529;Taip;4;0;2;6
14347;Želmenėliai;Voveriukų;2066711124;Taip;7;1;0;8
14348;Želmenėliai;Voveriukų;5696221669;Taip;0;7;0;7
14349;Želmenėliai;Voveriukų;51689349222;Taip;0;1;0;1
14350;Želmenėliai;Voveriukų;1799477959;Taip;0;2;1;3
14351;Želmenėliai;Voveriukų;98487229210;Taip;0;7;0;7
14352;Želmenėliai;Voveriukų;56814748796;Taip;14;1;0;15
14353;Želmenėliai;Voveriukų;21263242044;Taip;0;2;0;2
14354;Želmenėliai;Voveriukų;68226657214;Taip;0;9;0;9
14355;Želmenėliai;Voveriukų;1619190849;Taip;5;15;0;20
14356;Želmenėliai;Voveriukų;1868937175;Taip;4;0;0;4
14357;Želmenėliai;Voveriukų;77946540922;Taip;10;1;0;11
14358;Želmenėliai;Voveriukų;8218755050;Taip;12;0;0;12
14359;Želmenėliai;Voveriukų;3258904017;Taip;0;8;0;8
14360;Želmenėliai;Voveriukų;6783113916;Taip;0;11;0;11
14361;Želmenėliai;Ežiukų;34055134038;Taip;5;0;0;5
14362;Želmenėliai;Ežiukų;63879513374;Ne;14;0;0;14
14363;Želmenėliai;Ežiukų;12336777368;Ne;0;5;0;5
14364;Želmenėliai;Ežiukų;65633625929;Taip;0;4;0;4
14365;Želmenėliai;Ežiukų;5345737656;Taip;0;4;0;4
14366;Želmenėliai;Ežiukų;16400566719;Taip;11;1;0;12
14367;Želmenėliai;Ežiukų;2265545469;Taip;8;3;0;11
14368;Želmenėliai;Ežiukų;28030110904;Taip;0;18;0;18
14369;Želmenėliai;Ežiukų;22209426414;Taip;0;5;0;5
14370;Želmenėliai;Ežiukų;95095279050;Taip;0;7;0;7
14371;Želmenėliai;Ežiukų;21636460884;Taip;7;5;0;12
14372;Želmenėliai;Ežiukų;4699944934;Taip;0;1;0;1
14373;Želmenėliai;Ežiukų;90992236935;Taip;6;2;1;9
14374;Želmenėliai;Ežiukų;8394779853;Taip;0;17;0;17
14375;Želmenėliai;Ežiukų;1425695010;Taip;9;0;0;9
14376;Želmenėliai;Ežiukų;9234190447;Taip;0;1;0;1
14377;Želmenėliai;Ežiukų;1369976001;Taip;11;0;0;11
14378;Želmenėliai;Ežiukų;8478954608;Taip;9;0;0;9
14379;Želmenėliai;Ežiukų;1799391978;Taip;11;0;0;11
14380;Želmenėliai;Ežiukų;10686783804;Taip;0;2;2;4
14381;Želmenėliai;Peledžiukų;4206128805;Taip;15;0;0;15
14382;Želmenėliai;Peledžiukų;6816346946;Taip;11;2;0;13
14383;Želmenėliai;Peledžiukų;9359070885;Taip;5;1;0;6
14384;Želmenėliai;Peledžiukų;2727113833;Taip;6;1;0;7
14385;Želmenėliai;Peledžiukų;2428447892;Taip;11;3;0;14
14386;Želmenėliai;Peledžiukų;5787772212;Taip;20;0;0;20
14387;Želmenėliai;Peledžiukų;1239398642;Taip;0;8;0;8
14388;Želmenėliai;Peledžiukų;29112205705;Taip;7;0;0;7
14389;Želmenėliai;Peledžiukų;1248541555;Taip;9;2;0;11
14390;Želmenėliai;Peledžiukų;8995804360;Taip;0;4;0;4
14391;Želmenėliai;Peledžiukų;1522141057;Taip;11;1;1;13
14392;Želmenėliai;Peledžiukų;5616709457;Taip;20;0;0;20
14393;Želmenėliai;Peledžiukų;8300887366;Taip;8;1;0;9
14394;Želmenėliai;Peledžiukų;96660519820;Taip;5;5;0;10
14395;Želmenėliai;Peledžiukų;5842563754;Taip;0;5;0;5
14396;Želmenėliai;Peledžiukų;9375550172;Taip;10;9;0;19
14397;Želmenėliai;Peledžiukų;8478564831;Taip;9;0;0;9
14398;Želmenėliai;Peledžiukų;5638817349;Taip;0;1;0;1
14399;Želmenėliai;Peledžiukų;1941723687;Taip;11;1;0;12
14400;Želmenėliai;Peledžiukų;8590746750;Taip;11;2;0;13
14401;Želmenėliai;Drugelių;7664430346;Taip;1;2;0;3
14402;Želmenėliai;Drugelių;3417538909;Taip;0;2;0;2
14403;Želmenėliai;Drugelių;3295852546;Taip;8;0;2;10
14404;Želmenėliai;Drugelių;4739083871;Taip;15;0;0;15
14405;Želmenėliai;Drugelių;3379266015;Taip;0;4;0;4
14406;Želmenėliai;Drugelių;3737786832;Taip;19;0;0;19
14407;Želmenėliai;Drugelių;5633127620;Taip;0;20;0;20
14408;Želmenėliai;Drugelių;1984105453;Taip;15;5;0;20
14409;Želmenėliai;Drugelių;1920917916;Taip;20;0;0;20
14410;Želmenėliai;Drugelių;4652412483;Taip;0;14;0;14
14411;Želmenėliai;Drugelių;1652949383;Taip;0;5;0;5
14412;Želmenėliai;Drugelių;5046836398;Taip;3;0;0;3
14413;Želmenėliai;Drugelių;9237611484;Taip;0;4;0;4
14414;Želmenėliai;Drugelių;13558387807;Taip;0;3;0;3
14415;Želmenėliai;Drugelių;5143554665;Taip;4;1;0;5
14416;Želmenėliai;Drugelių;7585159351;Taip;5;6;0;11
14417;Želmenėliai;Drugelių;9207984505;Taip;10;0;0;10
14418;Želmenėliai;Drugelių;4634346755;Taip;13;1;0;14
14419;Želmenėliai;Drugelių;4916436238;Taip;6;13;0;19
14420;Želmenėliai;Drugelių;5558795651;Taip;20;0;0;20
14421;Želmenėliai;Voriukų;94772390737;Taip;0;1;0;1
14422;Želmenėliai;Voriukų;95258645888;Taip;5;13;0;18
14423;Želmenėliai;Voriukų;52040816124;Taip;0;1;1;2
14424;Želmenėliai;Voriukų;26335599312;Taip;10;0;0;10
14425;Želmenėliai;Voriukų;92945999406;Ne;5;1;0;6
14426;Želmenėliai;Voriukų;82671339119;Taip;4;0;0;4
14427;Želmenėliai;Voriukų;26377076407;Taip;11;2;0;13
14428;Želmenėliai;Voriukų;25839440205;Taip;0;7;0;7
14429;Želmenėliai;Voriukų;2017960244;Taip;0;4;0;4
14430;Želmenėliai;Voriukų;1494996935;Taip;0;18;0;18
14431;Želmenėliai;Voriukų;7587565685;Taip;9;4;5;18
14432;Želmenėliai;Voriukų;1299167028;Taip;0;12;0;12
14433;Želmenėliai;Boružėlių;51756630728;Taip;0;9;0;9
14434;Želmenėliai;Boružėlių;5223588064;Taip;11;0;0;11
14435;Želmenėliai;Boružėlių;91372955120;Taip;5;0;0;5
14436;Želmenėliai;Boružėlių;63043069680;Taip;7;1;0;8
14437;Želmenėliai;Boružėlių;10462964817;Taip;4;7;0;11
14438;Želmenėliai;Boružėlių;2103938312;Taip;9;5;0;14
14439;Želmenėliai;Boružėlių;35901929384;Taip;7;2;0;9
14440;Želmenėliai;Boružėlių;39675390598;Taip;13;4;0;17
14441;Želmenėliai;Boružėlių;1290780920;Taip;0;2;0;2
14442;Želmenėliai;Boružėlių;1699958696;Taip;0;13;0;13
14443;Želmenėliai;Boružėlių;98852944217;Taip;0;10;0;10
14444;Želmenėliai;Boružėlių;7502363323;Ne;11;3;0;14
14445;Želmenėliai;Boružėlių;1009164107;Taip;20;0;0;20
14446;Želmenėliai;Boružėlių;92486344928;Taip;0;12;0;12
14447;Želmenėliai;Boružėlių;1802714172;Taip;0;4;0;4
14448;Želmenėliai;Boružėlių;1686751892;Taip;20;0;0;20
14449;Želmenėliai;Boružėlių;1044902564;Ne;8;2;0;10
14450;Želmenėliai;Boružėlių;1933769076;Taip;0;2;0;2
14451;Želmenėliai;Boružėlių;1134743316;Taip;7;0;0;7
14452;Želmenėliai;Boružėlių;9414488405;Taip;14;0;3;17
14453;Želmenėliai;Pūkuotukų;73813829491;Taip;12;6;0;18
14454;Želmenėliai;Pūkuotukų;79879695958;Taip;13;0;0;13
14455;Želmenėliai;Pūkuotukų;54536849345;Taip;0;7;0;7
14456;Želmenėliai;Pūkuotukų;8936734213;Taip;6;0;0;6
14457;Želmenėliai;Pūkuotukų;1213403598;Taip;20;0;0;20
14458;Želmenėliai;Pūkuotukų;1803684569;Taip;18;0;0;18
14459;Želmenėliai;Pūkuotukų;1716801722;Taip;9;10;0;19
14460;Želmenėliai;Pūkuotukų;45440599686;Taip;0;15;0;15
14461;Želmenėliai;Pūkuotukų;50805473649;Taip;0;6;0;6
14462;Želmenėliai;Pūkuotukų;1405460015;Taip;7;2;0;9
14463;Želmenėliai;Pūkuotukų;85619767784;Taip;12;1;0;13
14464;Želmenėliai;Pūkuotukų;1800724034;Taip;9;0;0;9
14465;Želmenėliai;Pūkuotukų;74037118861;Taip;0;1;0;1
14466;Želmenėliai;Pūkuotukų;8706951420;Taip;0;2;0;2
14467;Želmenėliai;Pūkuotukų;7737877729;Taip;0;6;0;6
14468;Želmenėliai;Pūkuotukų;1426827854;Taip;0;9;0;9
14469;Želmenėliai;Pūkuotukų;1619412305;Taip;0;1;0;1
14470;Želmenėliai;Pūkuotukų;2036184590;Taip;0;2;0;2
14471;Želmenėliai;Pūkuotukų;22138795060;Taip;0;1;0;1
14472;Želmenėliai;Pūkuotukų;37152467004;Taip;7;0;0;7
14473;Želmenėliai;Ančiukų;1203343580;Taip;16;0;0;16
14474;Želmenėliai;Ančiukų;1614791794;Taip;5;0;0;5
14475;Želmenėliai;Ančiukų;4264751761;Taip;0;7;0;7
14476;Želmenėliai;Ančiukų;7940403585;Taip;8;2;0;10
14477;Želmenėliai;Ančiukų;3184074698;Taip;12;1;0;13
14478;Želmenėliai;Ančiukų;2570248893;Taip;5;9;0;14
14479;Želmenėliai;Ančiukų;3014568232;Taip;6;0;0;6
14480;Želmenėliai;Ančiukų;7563461821;Taip;11;8;0;19
14481;Želmenėliai;Ančiukų;4545012342;Taip;14;0;0;14
14482;Želmenėliai;Ančiukų;8504963337;Taip;0;4;4;8
14483;Želmenėliai;Ančiukų;9351650342;Taip;2;5;0;7
14484;Želmenėliai;Ančiukų;2577850672;Taip;8;3;0;11
14485;Želmenėliai;Ančiukų;4534946646;Taip;20;0;0;20
14486;Želmenėliai;Ančiukų;2111008869;Taip;10;2;0;12
14487;Želmenėliai;Ančiukų;4075533071;Taip;20;0;0;20
14488;Želmenėliai;Ančiukų;6916426436;Taip;0;2;0;2
14489;Želmenėliai;Nykštukų;9611741258;Taip;10;1;0;11
14490;Želmenėliai;Nykštukų;1619143702;Taip;6;1;0;7
14491;Želmenėliai;Nykštukų;9825545754;Taip;19;0;0;19
14492;Želmenėliai;Nykštukų;2794274146;Taip;14;0;0;14
14493;Želmenėliai;Nykštukų;3810550099;Taip;15;2;0;17
14494;Želmenėliai;Nykštukų;6635909614;Taip;13;0;0;13
14495;Želmenėliai;Nykštukų;2846903449;Taip;8;0;0;8
14496;Želmenėliai;Nykštukų;4473677352;Taip;13;0;0;13
14497;Želmenėliai;Nykštukų;8973215240;Taip;9;0;0;9
14498;Želmenėliai;Nykštukų;7505996978;Taip;0;14;0;14
14499;Želmenėliai;Nykštukų;7955645490;Taip;0;7;0;7
14500;Želmenėliai;Nykštukų;5314438217;Taip;0;1;0;1
14501;Želmenėliai;Nykštukų;9995500724;Taip;3;6;0;9
14502;Želmenėliai;Nykštukų;8954705816;Taip;7;0;0;7
14503;Želmenėliai;Lašelių;6799702725;Taip;15;0;0;15
14504;Želmenėliai;Lašelių;7423900312;Taip;7;3;0;10
14505;Želmenėliai;Lašelių;8358780570;Taip;11;5;0;16
14506;Želmenėliai;Lašelių;2122665619;Taip;3;0;0;3
14507;Želmenėliai;Lašelių;9006406225;Taip;7;3;0;10
14508;Želmenėliai;Lašelių;2102401372;Taip;0;1;0;1
14509;Želmenėliai;Lašelių;5171736943;Taip;11;2;0;13
14510;Želmenėliai;Lašelių;5147895081;Taip;3;2;0;5
14511;Želmenėliai;Lašelių;7957790300;Taip;11;1;0;12
14512;Želmenėliai;Lašelių;6481952132;Taip;0;4;0;4
14513;Želmenėliai;Lašelių;6876147546;Taip;0;0;3;3
14514;Želmenėliai;Lašelių;9126715074;Taip;0;14;0;14
14515;Želmenėliai;Lašelių;2563117992;Taip;10;0;0;10
14516;Želmenėliai;Lašelių;6180553648;Taip;0;12;0;12
14517;Želmenėliai;Lašelių;5211426226;Taip;15;1;0;16
14518;Žemyna;Čiauškučiai;96099047169;Taip;5;0;0;5
14519;Žemyna;Čiauškučiai;62565967575;Taip;0;1;1;2
14520;Žemyna;Čiauškučiai;25099273803;Taip;0;5;0;5
14521;Žemyna;Čiauškučiai;49793977825;Taip;0;7;0;7
14522;Žemyna;Čiauškučiai;10288969939;Taip;13;5;0;18
14523;Žemyna;Čiauškučiai;40843229500;Taip;5;2;0;7
14524;Žemyna;Čiauškučiai;69690099920;Taip;4;1;0;5
14525;Žemyna;Čiauškučiai;98477626952;Taip;0;5;1;6
14526;Žemyna;Čiauškučiai;71013970407;Taip;0;9;0;9
14527;Žemyna;Čiauškučiai;87939385151;Taip;8;0;0;8
14528;Žemyna;Čiauškučiai;56418377668;Taip;0;8;0;8
14529;Žemyna;Čiauškučiai;46550223916;Taip;1;0;0;1
14530;Žemyna;Čiauškučiai;98919412716;Taip;8;0;2;10
14531;Žemyna;Čiauškučiai;1535497308;Taip;0;0;1;1
14532;Žemyna;Čiauškučiai;89754744294;Taip;4;0;0;4
14533;Žemyna;Čiauškučiai;1790109762;Taip;0;3;0;3
14534;Žemyna;Čiauškučiai;83056273504;Taip;5;1;5;11
14535;Žemyna;Čiauškučiai;1866645242;Taip;7;0;0;7
14536;Žemyna;Čiauškučiai;1609941314;Taip;0;1;0;1
14537;Žemyna;Čiauškučiai;1917294883;Taip;7;0;0;7
14538;Žemyna;Čiauškučiai;1393006122;Taip;0;10;1;11
14539;Žemyna;Čiauškučiai;9409512255;Taip;11;0;2;13
14540;Žemyna;Nykštukai;69634515292;Taip;0;2;0;2
14541;Žemyna;Nykštukai;65677663175;Taip;7;6;2;15
14542;Žemyna;Nykštukai;74969696164;Taip;0;4;0;4
14543;Žemyna;Nykštukai;47974278492;Taip;0;5;0;5
14544;Žemyna;Nykštukai;92159859248;Taip;0;2;1;3
14545;Žemyna;Nykštukai;10344263960;Taip;0;0;12;12
14546;Žemyna;Nykštukai;54029612806;Taip;10;8;0;18
14547;Žemyna;Nykštukai;93378737171;Taip;7;0;1;8
14548;Žemyna;Nykštukai;5204796908;Taip;0;2;0;2
14549;Žemyna;Nykštukai;9556275322;Taip;10;5;0;15
14550;Žemyna;Nykštukai;81683768388;Taip;0;10;2;12
14551;Žemyna;Nykštukai;65117735882;Taip;0;5;1;6
14552;Žemyna;Nykštukai;59441904717;Taip;5;0;0;5
14553;Žemyna;Nykštukai;97712802830;Taip;5;1;0;6
14554;Žemyna;Nykštukai;70694756261;Taip;11;2;0;13
14555;Žemyna;Nykštukai;45269313606;Taip;0;1;0;1
14556;Žemyna;Nykštukai;30518889603;Taip;0;2;0;2
14557;Žemyna;Nykštukai;7670120949;Taip;0;0;5;5
14558;Žemyna;Nykštukai;78280621543;Taip;10;0;0;10
14559;Žemyna;Nykštukai;68982161758;Taip;7;0;3;10
14560;Žemyna;Nykštukai;1674165765;Taip;9;5;0;14
14561;Žemyna;Nykštukai;43708641831;Taip;3;12;3;18
14562;Žemyna;Nykštukai;2033947862;Taip;0;0;2;2
14563;Žemyna;Nykštukai;1337500221;Taip;0;10;0;10
14564;Žemyna;Nykštukai;6546437872;Taip;6;1;1;8
14565;Žemyna;Voveriukai;3135562485;Taip;9;0;0;9
14566;Žemyna;Voveriukai;2976467316;Taip;6;0;2;8
14567;Žemyna;Voveriukai;5940619734;Taip;5;0;0;5
14568;Žemyna;Voveriukai;6812823390;Taip;4;1;0;5
14569;Žemyna;Voveriukai;8500642069;Taip;10;1;0;11
14570;Žemyna;Voveriukai;6430348135;Taip;15;0;0;15
14571;Žemyna;Voveriukai;7925774308;Taip;12;0;0;12
14572;Žemyna;Voveriukai;2412956023;Taip;0;11;0;11
14573;Žemyna;Voveriukai;7341750699;Taip;5;1;0;6
14574;Žemyna;Voveriukai;3938938667;Taip;7;0;0;7
14575;Žemyna;Voveriukai;9958040413;Taip;3;0;8;11
14576;Žemyna;Voveriukai;1531980297;Taip;19;0;0;19
14577;Žemyna;Voveriukai;1114714466;Taip;5;0;15;20
14578;Žemyna;Voveriukai;1807466584;Taip;10;0;2;12
14579;Žemyna;Voveriukai;1543415914;Taip;7;0;2;9
14580;Žemyna;Voveriukai;7125026803;Taip;10;0;0;10
14581;Žemyna;Voveriukai;9148594407;Taip;9;1;0;10
14582;Žemyna;Voveriukai;6701717634;Taip;20;0;0;20
14583;Žemyna;Voveriukai;9866110744;Taip;11;0;0;11
14584;Žemyna;Voveriukai;7693278353;Taip;11;0;1;12
14585;Žemyna;Voveriukai;1118997229;Taip;8;1;0;9
14586;Žemyna;Kiškučiai;85577156077;Taip;8;2;1;11
14587;Žemyna;Kiškučiai;99073448709;Taip;0;1;0;1
14588;Žemyna;Kiškučiai;48525793006;Taip;5;0;0;5
14589;Žemyna;Kiškučiai;34426901653;Taip;5;2;0;7
14590;Žemyna;Kiškučiai;10048697347;Taip;0;1;0;1
14591;Žemyna;Kiškučiai;11629931607;Taip;7;0;0;7
14592;Žemyna;Kiškučiai;26634432947;Taip;0;13;0;13
14593;Žemyna;Kiškučiai;35576046194;Taip;11;0;0;11
14594;Žemyna;Kiškučiai;70742074799;Taip;10;0;0;10
14595;Žemyna;Kiškučiai;81211805661;Taip;20;0;0;20
14596;Žemyna;Kiškučiai;54667537300;Taip;3;0;0;3
14597;Žemyna;Kiškučiai;85184514538;Taip;0;1;0;1
14598;Žemyna;Kiškučiai;81784082355;Taip;10;0;0;10
14599;Žemyna;Kiškučiai;57614960761;Taip;5;2;0;7
14600;Žemyna;Kiškučiai;5140727629;Taip;3;3;0;6
14601;Žemyna;Kiškučiai;89531266711;Taip;9;0;0;9
14602;Žemyna;Kiškučiai;5730670827;Taip;11;1;0;12
14603;Žemyna;Kiškučiai;6766660258;Taip;10;9;0;19
14604;Žemyna;Kiškučiai;17162551563;Taip;9;0;0;9
14605;Žemyna;Kiškučiai;69734268809;Taip;0;1;2;3
14606;Žemyna;Kiškučiai;1040031432;Taip;1;0;0;1
14607;Žemyna;Kiškučiai;4928267472;Taip;14;0;1;15
14608;Žemyna;Vyturiukai;9232638767;Taip;0;0;7;7
14609;Žemyna;Vyturiukai;38769607968;Taip;4;1;1;6
14610;Žemyna;Vyturiukai;47470155594;Taip;3;0;3;6
14611;Žemyna;Vyturiukai;17098859260;Taip;10;2;0;12
14612;Žemyna;Vyturiukai;1687206394;Taip;1;0;1;2
14613;Žemyna;Vyturiukai;5508251792;Taip;5;0;1;6
14614;Žemyna;Vyturiukai;85135645557;Taip;15;0;0;15
14615;Žemyna;Vyturiukai;59506345859;Taip;4;2;0;6
14616;Žemyna;Vyturiukai;89787441782;Taip;0;2;0;2
14617;Žemyna;Vyturiukai;41538301616;Taip;5;1;0;6
14618;Žemyna;Vyturiukai;5506889213;Taip;0;3;0;3
14619;Žemyna;Vyturiukai;5306392307;Taip;14;0;0;14
14620;Žemyna;Vyturiukai;9018138289;Taip;7;0;0;7
14621;Žemyna;Vyturiukai;37570629861;Taip;20;0;0;20
14622;Žemyna;Vyturiukai;13242930752;Taip;2;5;0;7
14623;Žemyna;Vyturiukai;96473502730;Taip;20;0;0;20
14624;Žemyna;Vyturiukai;94548785045;Taip;0;0;3;3
14625;Žemyna;Vyturiukai;93423088394;Taip;4;11;0;15
14626;Žemyna;Vyturiukai;8040359407;Taip;8;0;2;10
14627;Žemyna;Vyturiukai;55161890341;Taip;14;5;0;19
14628;Žemyna;Vyturiukai;6618285685;Taip;0;5;0;5
14629;Žemyna;Vyturiukai;4524929331;Taip;5;0;0;5
14630;Žemyna;Pelėdžiukai;8415482981;Taip;10;5;0;15
14631;Žemyna;Pelėdžiukai;24282185059;Taip;0;0;1;1
14632;Žemyna;Pelėdžiukai;91945722729;Taip;0;9;0;9
14633;Žemyna;Pelėdžiukai;31409370999;Taip;0;2;0;2
14634;Žemyna;Pelėdžiukai;26452260516;Taip;10;1;0;11
14635;Žemyna;Pelėdžiukai;74855676264;Taip;0;1;0;1
14636;Žemyna;Pelėdžiukai;19262594854;Taip;9;0;0;9
14637;Žemyna;Pelėdžiukai;27764489212;Taip;2;1;1;4
14638;Žemyna;Pelėdžiukai;80111906824;Taip;5;0;0;5
14639;Žemyna;Pelėdžiukai;61994998037;Taip;12;0;0;12
14640;Žemyna;Pelėdžiukai;36616512238;Taip;7;3;0;10
14641;Žemyna;Pelėdžiukai;30019743988;Taip;0;1;0;1
14642;Žemyna;Pelėdžiukai;29377805386;Taip;2;0;1;3
14643;Žemyna;Pelėdžiukai;51131984130;Ne;6;0;2;8
14644;Žemyna;Pelėdžiukai;68149716927;Taip;0;2;0;2
14645;Žemyna;Pelėdžiukai;67275465624;Taip;1;3;0;4
14646;Žemyna;Pelėdžiukai;55015285610;Taip;5;4;1;10
14647;Žemyna;Pelėdžiukai;46049323529;Taip;18;0;0;18
14648;Žemyna;Pelėdžiukai;4680528929;Taip;9;2;0;11
14649;Žemyna;Pelėdžiukai;1218163998;Taip;19;0;0;19
14650;Žemyna;Pelėdžiukai;5183028594;Taip;0;2;3;5
14651;Žemyna;Pelėdžiukai;1717113454;Taip;2;4;1;7
14652;Žemyna;Vijurkai;3601375855;Taip;2;9;0;11
14653;Žemyna;Vijurkai;64499886011;Taip;10;1;0;11
14654;Žemyna;Vijurkai;38602852015;Taip;0;0;1;1
14655;Žemyna;Vijurkai;95274028121;Taip;5;0;0;5
14656;Žemyna;Vijurkai;60950769448;Taip;7;0;0;7
14657;Žemyna;Vijurkai;1015193590;Taip;16;4;0;20
14658;Žemyna;Vijurkai;64066518112;Taip;10;5;0;15
14659;Žemyna;Vijurkai;62651324131;Taip;14;0;1;15
14660;Žemyna;Vijurkai;38352111116;Taip;8;3;2;13
14661;Žemyna;Vijurkai;43441615793;Taip;0;1;0;1
14662;Žemyna;Vijurkai;55853738457;Taip;6;0;0;6
14663;Žemyna;Vijurkai;1197264568;Taip;0;7;0;7
14664;Žemyna;Vijurkai;36873572743;Taip;0;3;1;4
14665;Žemyna;Vijurkai;63747644828;Taip;0;4;0;4
14666;Žemyna;Vijurkai;1725097139;Taip;0;2;1;3
14667;Žemyna;Vijurkai;31365442622;Taip;3;0;0;3
14668;Žemyna;Vijurkai;76258813568;Taip;0;1;1;2
14669;Žemyna;Vijurkai;42384634418;Taip;0;1;0;1
14670;Žemyna;Vijurkai;38576112962;Taip;0;1;0;1
14671;Žemyna;Vijurkai;22741981912;Taip;0;1;0;1
14672;Žemyna;Vijurkai;80070453149;Taip;0;2;0;2
14673;Žemyna;Vijurkai;60321336886;Taip;9;0;0;9
14674;Žemyna;Vijurkai;72911809081;Taip;0;1;1;2
14675;Žemyna;Šnekučiai;88775150201;Taip;0;0;2;2
14676;Žemyna;Šnekučiai;8096035110;Taip;9;0;0;9
14677;Žemyna;Šnekučiai;1694969407;Taip;5;0;0;5
14678;Žemyna;Šnekučiai;58578414067;Taip;0;5;2;7
14679;Žemyna;Šnekučiai;9130965949;Taip;0;6;0;6
14680;Žemyna;Šnekučiai;1683299408;Taip;0;9;0;9
14681;Žemyna;Šnekučiai;39175264243;Taip;10;0;0;10
14682;Žemyna;Šnekučiai;35462796459;Taip;9;0;1;10
14683;Žemyna;Šnekučiai;50543973728;Taip;10;0;0;10
14684;Žemyna;Šnekučiai;1595030102;Taip;10;0;1;11
14685;Žemyna;Šnekučiai;6448628301;Taip;10;0;0;10
14686;Žemyna;Šnekučiai;1421842247;Taip;0;0;1;1
14687;Žemyna;Šnekučiai;47562685723;Taip;10;5;0;15
14688;Žemyna;Šnekučiai;32755929074;Taip;15;1;0;16
14689;Žemyna;Šnekučiai;54253890981;Taip;0;0;3;3
14690;Žemyna;Šnekučiai;54823974018;Taip;14;0;0;14
14691;Žemyna;Šnekučiai;1049546597;Taip;8;0;1;9
14692;Žemyna;Šnekučiai;99015221693;Taip;7;0;0;7
14693;Žemyna;Šnekučiai;38604851102;Taip;5;0;3;8
14694;Žemyna;Šnekučiai;2003368811;Taip;11;0;0;11
14695;Žemyna;Šnekučiai;1305667359;Taip;0;0;5;5
14696;Žemyna;Šnekučiai;6089122225;Taip;8;0;0;8
14697;Žemyna;Šnekučiai;55748223762;Taip;9;2;0;11
14698;Žemyna;Pabiručiai;88687293547;Taip;11;1;0;12
14699;Žemyna;Pabiručiai;43607772302;Taip;14;1;0;15
14700;Žemyna;Pabiručiai;1210307182;Taip;1;0;0;1
14701;Žemyna;Pabiručiai;1265326169;Taip;0;0;5;5
14702;Žemyna;Pabiručiai;4570281722;Taip;0;0;19;19
14703;Žemyna;Pabiručiai;2073608501;Taip;0;11;0;11
14704;Žemyna;Pabiručiai;92534877861;Taip;0;0;11;11
14705;Žemyna;Pabiručiai;75681135185;Taip;5;0;0;5
14706;Žemyna;Pabiručiai;3596822649;Taip;11;0;0;11
14707;Žemyna;Pabiručiai;86746604640;Taip;6;0;0;6
14708;Žemyna;Pabiručiai;6775880309;Taip;6;0;5;11
14709;Žemyna;Pabiručiai;82507236376;Taip;12;0;0;12
14710;Žemyna;Pabiručiai;84955588471;Taip;4;0;0;4
14711;Žemyna;Pabiručiai;80737839511;Taip;11;0;0;11
14712;Žemyna;Pabiručiai;82479499709;Taip;14;0;0;14
14713;Žemyna;Pabiručiai;60610765717;Taip;12;0;0;12
14714;Žemyna;Pabiručiai;14902924855;Taip;0;3;1;4
14715;Žemyna;Pabiručiai;1847882950;Taip;5;0;0;5
14716;Žemyna;Pabiručiai;15573695823;Taip;11;0;0;11
14717;Žemyna;Pabiručiai;2072914123;Taip;9;1;0;10
14718;Žemyna;Pabiručiai;50687988382;Taip;12;3;0;15
14719;Žemyna;Drugeliai;72801825176;Taip;8;4;0;12
14720;Žemyna;Drugeliai;2100326039;Taip;1;0;1;2
14721;Žemyna;Drugeliai;84680481889;Taip;6;0;2;8
14722;Žemyna;Drugeliai;1571182096;Taip;0;0;1;1
14723;Žemyna;Drugeliai;1471204471;Taip;12;1;0;13
14724;Žemyna;Drugeliai;1882507954;Taip;5;1;0;6
14725;Žemyna;Drugeliai;1607110213;Taip;10;0;1;11
14726;Žemyna;Drugeliai;1623854426;Taip;0;0;1;1
14727;Žemyna;Drugeliai;50369667193;Taip;16;0;0;16
14728;Žemyna;Drugeliai;1705971732;Taip;7;0;1;8
14729;Žemyna;Drugeliai;17784132877;Taip;8;0;0;8
14730;Žemyna;Drugeliai;97625732866;Taip;0;0;1;1
14731;Žemyna;Drugeliai;45222048620;Taip;12;0;0;12
14732;Žemyna;Drugeliai;1654912072;Taip;0;0;1;1
14733;Žemyna;Drugeliai;1968337404;Taip;0;6;2;8
14734;Žemyna;Drugeliai;27867030470;Taip;9;0;0;9
14735;Žemyna;Drugeliai;51870099224;Taip;12;0;1;13
14736;Žemyna;Drugeliai;1941650167;Taip;0;0;4;4
14737;Žemyna;Drugeliai;1541156624;Taip;9;0;1;10
14738;Žemyna;Drugeliai;2113826378;Taip;11;0;2;13
14739;Žemyna;Drugeliai;1867198805;Taip;0;0;5;5
14740;Žemyna;Drugeliai;1299164876;Taip;9;0;0;9
14741;Žemyna;"ŽIRNIUKAI ";6116581655;Taip;0;0;2;2
14742;Žemyna;"ŽIRNIUKAI ";9912869400;Taip;17;0;0;17
14743;Žemyna;"ŽIRNIUKAI ";9818711030;Taip;5;0;2;7
14744;Žemyna;"ŽIRNIUKAI ";9219519029;Taip;12;4;0;16
14745;Žemyna;"ŽIRNIUKAI ";6293560729;Taip;12;0;0;12
14746;Žemyna;"ŽIRNIUKAI ";5868208651;Taip;12;0;1;13
14747;Žemyna;"ŽIRNIUKAI ";5188496664;Taip;10;0;0;10
14748;Žemyna;"ŽIRNIUKAI ";7764615445;Taip;11;0;2;13
14749;Žemyna;"ŽIRNIUKAI ";7367602247;Taip;0;4;0;4
14750;Žemyna;"ŽIRNIUKAI ";7280740926;Taip;20;0;0;20
14751;Žemyna;"ŽIRNIUKAI ";6419974691;Taip;16;0;0;16
14752;Žemyna;"ŽIRNIUKAI ";2006173745;Taip;0;0;2;2
14753;Žemyna;"ŽIRNIUKAI ";5727308039;Taip;0;5;0;5
14754;Žemyna;"ŽIRNIUKAI ";2792702536;Taip;0;0;3;3
14755;Žemyna;"ŽIRNIUKAI ";5714771643;Taip;12;0;0;12
14756;Žemyna;"ŽIRNIUKAI ";3992383447;Taip;17;0;0;17
14757;Žemyna;"ŽIRNIUKAI ";4693414703;Taip;10;0;0;10
14758;Žemyna;"ŽIOGELIAI ";3643594001;Taip;0;4;7;11
14759;Žemyna;"ŽIOGELIAI ";7508491119;Taip;1;1;0;2
14760;Žemyna;"ŽIOGELIAI ";4265606762;Taip;10;3;0;13
14761;Žemyna;"ŽIOGELIAI ";4821941126;Taip;7;0;0;7
14762;Žemyna;"ŽIOGELIAI ";7781924111;Taip;10;0;0;10
14763;Žemyna;"ŽIOGELIAI ";3519840747;Taip;9;2;0;11
14764;Žemyna;"ŽIOGELIAI ";8622780639;Taip;4;0;0;4
14765;Žemyna;"ŽIOGELIAI ";6958537154;Taip;5;6;0;11
14766;Žemyna;"ŽIOGELIAI ";4444870782;Taip;0;6;0;6
14767;Žemyna;"ŽIOGELIAI ";2034162734;Taip;0;8;0;8
14768;Žemyna;"ŽIOGELIAI ";9182709647;Taip;11;4;0;15
14769;Žemyna;"ŽIOGELIAI ";7121742098;Taip;17;0;0;17
14770;Žemyna;"ŽIOGELIAI ";1468040559;Taip;20;0;0;20
14771;Žemyna;"ŽIOGELIAI ";4322192775;Taip;19;0;0;19
14772;Žemyna;"ŽIOGELIAI ";9653530823;Taip;10;0;0;10
14773;Žemyna;"ŽIOGELIAI ";2928125522;Taip;8;2;0;10
14774;Žemyna;"ŽIOGELIAI ";7005045961;Taip;6;2;0;8
14775;Žemyna;"ŽIOGELIAI ";5114094924;Taip;5;4;0;9
14776;Žemuogėlė;Boružiukai;64182347253;Taip;1;8;0;9
14777;Žemuogėlė;Boružiukai;23841110826;Taip;5;4;0;9
14778;Žemuogėlė;Boružiukai;89682626079;Taip;3;0;0;3
14779;Žemuogėlė;Boružiukai;21886029194;Taip;0;3;0;3
14780;Žemuogėlė;Boružiukai;7503799036;Taip;0;1;1;2
14781;Žemuogėlė;Boružiukai;95392130582;Taip;0;2;0;2
14782;Žemuogėlė;Boružiukai;3208009994;Taip;5;7;0;12
14783;Žemuogėlė;Boružiukai;1099252682;Taip;0;4;0;4
14784;Žemuogėlė;Boružiukai;2320908623;Taip;7;0;0;7
14785;Žemuogėlė;Boružiukai;2099256322;Taip;4;1;0;5
14786;Žemuogėlė;Boružiukai;1550066922;Taip;6;2;0;8
14787;Žemuogėlė;Boružiukai;1354590098;Taip;10;6;0;16
14788;Žemuogėlė;Boružiukai;1543283524;Taip;12;1;0;13
14789;Žemuogėlė;Boružiukai;1085793430;Taip;5;7;0;12
14790;Žemuogėlė;Boružiukai;1970687025;Taip;4;0;0;4
14791;Žemuogėlė;Boružiukai;52842591023;Taip;5;0;1;6
14792;Žemuogėlė;Boružiukai;97014601220;Taip;0;16;0;16
14793;Žemuogėlė;Boružiukai;5911529759;Taip;10;3;0;13
14794;Žemuogėlė;Boružiukai;31450036105;Taip;20;0;0;20
14795;Žemuogėlė;Boružiukai;93523683833;Taip;0;4;0;4
14796;Žemuogėlė;Boružiukai;1093128368;Taip;5;8;0;13
14797;Žemuogėlė;Boružiukai;70054283264;Taip;6;0;0;6
14798;Žemuogėlė;Boružiukai;40590616715;Taip;0;2;0;2
14799;Žemuogėlė;Boružiukai;1248683052;Taip;11;0;0;11
14800;Žemuogėlė;Boružiukai;2146044539;Taip;11;0;0;11
14801;Žemuogėlė;Šviesuliukai;4766971363;Taip;5;0;0;5
14802;Žemuogėlė;Šviesuliukai;3697024369;Taip;0;2;2;4
14803;Žemuogėlė;Šviesuliukai;8187939143;Taip;14;1;0;15
14804;Žemuogėlė;Šviesuliukai;96167322031;Taip;0;0;4;4
14805;Žemuogėlė;Šviesuliukai;73679997517;Taip;10;2;0;12
14806;Žemuogėlė;Šviesuliukai;24863928147;Taip;1;2;0;3
14807;Žemuogėlė;Šviesuliukai;29436958034;Taip;8;0;0;8
14808;Žemuogėlė;Šviesuliukai;1608544032;Taip;5;9;4;18
14809;Žemuogėlė;Šviesuliukai;9042246873;Taip;15;0;4;19
14810;Žemuogėlė;Šviesuliukai;1859848343;Taip;0;14;0;14
14811;Žemuogėlė;Šviesuliukai;4810459063;Taip;0;4;0;4
14812;Žemuogėlė;Šviesuliukai;57783467185;Taip;10;2;0;12
14813;Žemuogėlė;Šviesuliukai;75012082294;Taip;7;0;0;7
14814;Žemuogėlė;Šviesuliukai;5395954931;Taip;14;1;0;15
14815;Žemuogėlė;Šviesuliukai;1833523282;Taip;9;10;0;19
14816;Žemuogėlė;Šviesuliukai;3062268362;Taip;16;1;0;17
14817;Žemuogėlė;Šviesuliukai;9864664937;Taip;10;0;0;10
14818;Žemuogėlė;Šviesuliukai;3868254757;Taip;0;1;0;1
14819;Žemuogėlė;Šviesuliukai;1745679183;Taip;0;2;0;2
14820;Žemuogėlė;Šviesuliukai;9255723192;Taip;0;5;7;12
14821;Žemuogėlė;Šviesuliukai;2740942924;Taip;15;4;0;19
14822;Žemuogėlė;Šviesuliukai;5972567526;Taip;15;0;0;15
14823;Žemuogėlė;Šviesuliukai;1910570858;Taip;5;11;0;16
14824;Žemuogėlė;Lašiukai;88840615083;Ne;5;5;0;10
14825;Žemuogėlė;Lašiukai;32491995013;Taip;0;1;0;1
14826;Žemuogėlė;Lašiukai;1674933700;Taip;4;2;0;6
14827;Žemuogėlė;Lašiukai;10671271979;Taip;0;1;0;1
14828;Žemuogėlė;Lašiukai;95927288551;Taip;0;1;0;1
14829;Žemuogėlė;Lašiukai;91107541015;Taip;8;0;0;8
14830;Žemuogėlė;Lašiukai;53837299006;Taip;10;1;0;11
14831;Žemuogėlė;Lašiukai;51367008137;Taip;4;0;0;4
14832;Žemuogėlė;Lašiukai;46391565859;Taip;0;4;0;4
14833;Žemuogėlė;Lašiukai;86574419074;Taip;3;1;0;4
14834;Žemuogėlė;Lašiukai;71173323434;Taip;0;1;0;1
14835;Žemuogėlė;Lašiukai;84708796864;Taip;2;2;0;4
14836;Žemuogėlė;Lašiukai;98534411354;Taip;11;2;0;13
14837;Žemuogėlė;Lašiukai;78872439982;Taip;0;14;0;14
14838;Žemuogėlė;Skambaliukai;66580736408;Taip;0;9;0;9
14839;Žemuogėlė;Skambaliukai;84666403179;Taip;6;2;0;8
14840;Žemuogėlė;Skambaliukai;31759065949;Taip;0;2;0;2
14841;Žemuogėlė;Skambaliukai;9595187690;Taip;3;0;0;3
14842;Žemuogėlė;Skambaliukai;5784013969;Taip;0;2;0;2
14843;Žemuogėlė;Skambaliukai;4102456092;Taip;10;1;0;11
14844;Žemuogėlė;Skambaliukai;6181456167;Taip;0;1;0;1
14845;Žemuogėlė;Skambaliukai;3937319656;Taip;13;0;0;13
14846;Žemuogėlė;Skambaliukai;7593612588;Taip;10;5;0;15
14847;Žemuogėlė;Skambaliukai;9932212577;Taip;5;0;0;5
14848;Žemuogėlė;Skambaliukai;1461676033;Taip;8;2;0;10
14849;Žemuogėlė;Skambaliukai;8499817876;Taip;3;1;0;4
14850;Žemuogėlė;Skambaliukai;37376794703;Taip;4;2;0;6
14851;Žemuogėlė;Skambaliukai;8208792552;Taip;7;2;0;9
14852;Žemuogėlė;Skambaliukai;48157970479;Taip;2;3;0;5
14853;Žemuogėlė;Skambaliukai;42192628191;Taip;9;1;0;10
14854;Žemuogėlė;Skambaliukai;3354347837;Taip;0;1;0;1
14855;Žemuogėlė;Skambaliukai;2692095829;Taip;2;1;0;3
14856;Žemuogėlė;Skambaliukai;13566201686;Taip;10;2;0;12
14857;Žemuogėlė;Skambaliukai;2661677897;Taip;0;2;0;2
14858;Žemuogėlė;Spinduliukai;36386223863;Taip;0;8;0;8
14859;Žemuogėlė;Spinduliukai;50649509868;Taip;6;0;0;6
14860;Žemuogėlė;Spinduliukai;62971657427;Taip;0;2;0;2
14861;Žemuogėlė;Spinduliukai;62210251654;Taip;10;0;0;10
14862;Žemuogėlė;Spinduliukai;5888483930;Ne;0;10;0;10
14863;Žemuogėlė;Spinduliukai;24111477729;Taip;15;0;0;15
14864;Žemuogėlė;Spinduliukai;91720422401;Taip;2;1;0;3
14865;Žemuogėlė;Spinduliukai;11571302488;Taip;5;2;0;7
14866;Žemuogėlė;Spinduliukai;15246943974;Taip;0;1;0;1
14867;Žemuogėlė;Spinduliukai;54745410330;Taip;6;3;0;9
14868;Žemuogėlė;Spinduliukai;33317814956;Taip;5;2;0;7
14869;Žemuogėlė;Spinduliukai;97511628790;Taip;0;11;0;11
14870;Žemuogėlė;Spinduliukai;38094866639;Taip;15;3;0;18
14871;Žemuogėlė;Spinduliukai;89042677798;Taip;13;1;0;14
14872;Žemuogėlė;Spinduliukai;64042870424;Taip;0;5;0;5
14873;Žemuogėlė;Spinduliukai;3718360972;Ne;14;0;0;14
14874;Žemuogėlė;Perliukai;37726841145;Taip;0;2;0;2
14875;Žemuogėlė;Perliukai;33112231008;Taip;0;14;0;14
14876;Žemuogėlė;Perliukai;28795421460;Taip;6;1;0;7
14877;Žemuogėlė;Perliukai;92317183904;Taip;0;1;0;1
14878;Žemuogėlė;Perliukai;98006600854;Taip;9;2;0;11
14879;Žemuogėlė;Perliukai;66464155865;Taip;3;1;0;4
14880;Žemuogėlė;Perliukai;97664138036;Taip;10;0;0;10
14881;Žemuogėlė;Perliukai;87719167969;Taip;0;1;0;1
14882;Žemuogėlė;Perliukai;58604834495;Taip;5;1;0;6
14883;Žemuogėlė;Perliukai;1366286798;Taip;3;3;0;6
14884;Žemuogėlė;Perliukai;29973978107;Taip;13;0;0;13
14885;Žemuogėlė;Perliukai;53763899224;Taip;8;1;0;9
14886;Žemuogėlė;Perliukai;77880141132;Taip;6;0;0;6
14887;Žemuogėlė;Perliukai;8952696734;Taip;11;6;0;17
14888;Žemuogėlė;Perliukai;1844596636;Taip;0;1;0;1
14889;Žemuogėlė;Perliukai;13768771915;Taip;12;1;0;13
14890;Žemuogėlė;Perliukai;22761916112;Taip;3;6;0;9
14891;Žemuogėlė;Perliukai;60841198741;Taip;9;0;0;9
14892;Žemuogėlė;Perliukai;58679808617;Taip;0;5;0;5
14893;Žemuogėlė;Perliukai;34462365948;Taip;3;0;0;3
14894;Žemuogėlė;Perliukai;58894092756;Taip;0;1;0;1
14895;Žemuogėlė;Drugeliai;3854265246;Taip;0;2;3;5
14896;Žemuogėlė;Drugeliai;94792383091;Taip;0;1;0;1
14897;Žemuogėlė;Drugeliai;54663750186;Taip;5;2;0;7
14898;Žemuogėlė;Drugeliai;7403172794;Taip;0;2;0;2
14899;Žemuogėlė;Drugeliai;8023936861;Taip;14;0;0;14
14900;Žemuogėlė;Drugeliai;1608506638;Taip;6;1;0;7
14901;Žemuogėlė;Drugeliai;1448477562;Taip;6;1;0;7
14902;Žemuogėlė;Drugeliai;1223819270;Taip;4;2;0;6
14903;Žemuogėlė;Drugeliai;3134493860;Taip;0;2;0;2
14904;Žemuogėlė;Drugeliai;711908013;Taip;5;1;0;6
14905;Žemuogėlė;Drugeliai;1628749648;Taip;8;0;1;9
14906;Žemuogėlė;Drugeliai;6962103028;Taip;0;2;2;4
14907;Žemuogėlė;Drugeliai;38870047353;Taip;20;0;0;20
14908;Žemuogėlė;Drugeliai;3977351017;Taip;15;1;0;16
14909;Žemuogėlė;Drugeliai;4231767115;Taip;15;1;0;16
14910;Žemuogėlė;Drugeliai;8737612457;Taip;6;3;0;9
14911;Žemuogėlė;Drugeliai;5147617128;Taip;20;1;0;21
14912;Žemuogėlė;Drugeliai;5625943720;Taip;0;5;0;5
14913;Žemuogėlė;Drugeliai;1058207935;Taip;10;2;2;14
14914;Žemuogėlė;Drugeliai;7714826773;Taip;5;2;0;7
14915;Žemuogėlė;Drugeliai;1907004376;Taip;11;2;0;13
14916;Žemuogėlė;Drugeliai;9315711142;Taip;0;14;1;15
14917;Žemuogėlė;Drugeliai;2102057496;Taip;10;2;0;12
14918;Žemuogėlė;"VIEVERSIUKAI ";7804015060;Taip;12;7;0;19
14919;Žemuogėlė;"VIEVERSIUKAI ";3706531223;Taip;3;2;0;5
14920;Žemuogėlė;"VIEVERSIUKAI ";4565097904;Taip;14;1;0;15
14921;Žemuogėlė;"VIEVERSIUKAI ";1049009199;Taip;9;2;0;11
14922;Žemuogėlė;"VIEVERSIUKAI ";8644564820;Taip;20;0;0;20
14923;Žemuogėlė;"VIEVERSIUKAI ";9378432383;Taip;10;1;0;11
14924;Žemuogėlė;"VIEVERSIUKAI ";6747566307;Taip;8;0;0;8
14925;Žemuogėlė;"VIEVERSIUKAI ";4421397490;Taip;9;3;0;12
14926;Žemuogėlė;"VIEVERSIUKAI ";3714945248;Taip;24;0;0;24
14927;Žemuogėlė;"VIEVERSIUKAI ";2001471529;Taip;5;1;0;6
14928;Žemuogėlė;"VIEVERSIUKAI ";2841634296;Taip;0;5;0;5
14929;Žemuogėlė;"VIEVERSIUKAI ";6913038845;Taip;15;0;0;15
14930;Žemuogėlė;"VIEVERSIUKAI ";9579921777;Taip;19;0;0;19
14931;Žemuogėlė;"VIEVERSIUKAI ";6169845677;Taip;13;0;0;13
14932;Žemuogėlė;"VIEVERSIUKAI ";5532053268;Taip;0;1;0;1
14933;Žemuogėlė;"VIEVERSIUKAI ";1356340471;Taip;10;5;0;15
14934;Žemuogėlė;"NYKŠTUKAI ";3458374439;Taip;10;0;0;10
14935;Žemuogėlė;"NYKŠTUKAI ";3765022476;Taip;7;0;0;7
14936;Žemuogėlė;"NYKŠTUKAI ";9519563708;Taip;10;0;0;10
14937;Žemuogėlė;"NYKŠTUKAI ";9693894254;Taip;5;4;0;9
14938;Žemuogėlė;"NYKŠTUKAI ";2555902309;Taip;23;0;0;23
14939;Žemuogėlė;"NYKŠTUKAI ";4536398519;Taip;12;2;0;14
14940;Žemuogėlė;"NYKŠTUKAI ";8757701456;Taip;8;0;0;8
14941;Žemuogėlė;"NYKŠTUKAI ";1844299594;Taip;7;4;0;11
14942;Žemuogėlė;"NYKŠTUKAI ";2132549536;Taip;7;5;0;12
14943;Žemuogėlė;"NYKŠTUKAI ";8496353410;Taip;13;0;0;13
14944;Žemuogėlė;"NYKŠTUKAI ";9592456683;Taip;10;0;0;10
14945;Žemuogėlė;"NYKŠTUKAI ";6581889641;Taip;0;1;12;13
14946;Žemuogėlė;"NYKŠTUKAI ";5266493632;Taip;19;0;0;19
14947;Žemuogėlė;"NYKŠTUKAI ";3237083654;Taip;13;0;0;13
14948;Žemuogėlė;"NYKŠTUKAI ";2259779058;Taip;10;1;0;11
14949;Žemuogėlė;"NYKŠTUKAI ";5418395023;Taip;18;0;0;18
14950;Žemuogėlė;"NYKŠTUKAI ";1733808230;Taip;5;3;0;8
14951;Žemuogėlė;"NYKŠTUKAI ";1713927628;Taip;16;0;0;16
14952;Žemuogėlė;KIŠKUČIAI;3411390558;Taip;14;0;0;14
14953;Žemuogėlė;KIŠKUČIAI;6963684639;Taip;5;2;0;7
14954;Žemuogėlė;KIŠKUČIAI;1377813636;Taip;11;0;0;11
14955;Žemuogėlė;KIŠKUČIAI;9689082202;Taip;10;6;0;16
14956;Žemuogėlė;KIŠKUČIAI;8409711622;Taip;0;3;0;3
14957;Žemuogėlė;KIŠKUČIAI;9955429241;Taip;6;0;0;6
14958;Žemuogėlė;KIŠKUČIAI;5770044886;Taip;15;0;0;15
14959;Žemuogėlė;KIŠKUČIAI;6726124641;Taip;20;0;0;20
14960;Žemuogėlė;KIŠKUČIAI;5127370193;Taip;0;1;0;1
14961;Žemuogėlė;KIŠKUČIAI;5126348190;Taip;0;0;2;2
14962;Žemuogėlė;KIŠKUČIAI;7177725663;Taip;13;0;0;13
14963;Žemuogėlė;KIŠKUČIAI;2481547868;Taip;10;0;1;11
14964;Žemuogėlė;KIŠKUČIAI;3612833383;Taip;8;0;0;8
14965;Žemuogėlė;KIŠKUČIAI;3000676765;Taip;11;0;3;14
14966;Žemuogėlė;KIŠKUČIAI;4317453894;Taip;4;3;0;7
14967;Žemuogėlė;KIŠKUČIAI;1275552038;Taip;20;0;0;20
14968;Žibutė;PELĖDŽIUKAI;5811023607;Taip;0;0;1;1
14969;Žibutė;PELĖDŽIUKAI;54535455969;Taip;12;0;0;12
14970;Žibutė;PELĖDŽIUKAI;62146271609;Taip;5;5;0;10
14971;Žibutė;PELĖDŽIUKAI;85042822872;Taip;5;0;0;5
14972;Žibutė;PELĖDŽIUKAI;59824395612;Taip;10;4;0;14
14973;Žibutė;PELĖDŽIUKAI;2361682400;Taip;9;0;3;12
14974;Žibutė;PELĖDŽIUKAI;1826763192;Taip;0;5;1;6
14975;Žibutė;PELĖDŽIUKAI;1259481487;Taip;9;0;1;10
14976;Žibutė;PELĖDŽIUKAI;3826875107;Taip;10;3;3;16
14977;Žibutė;PELĖDŽIUKAI;3186792146;Taip;0;0;3;3
14978;Žibutė;PELĖDŽIUKAI;1226458088;Taip;2;0;0;2
14979;Žibutė;PELĖDŽIUKAI;7344095020;Taip;0;0;1;1
14980;Žibutė;PELĖDŽIUKAI;1078105287;Taip;0;4;0;4
14981;Žibutė;PELĖDŽIUKAI;2152452830;Taip;12;0;0;12
14982;Žibutė;PELĖDŽIUKAI;1394895695;Taip;11;0;3;14
14983;Žibutė;PELĖDŽIUKAI;2236930916;Taip;5;0;5;10
14984;Žibutė;PELĖDŽIUKAI;7095870173;Taip;15;1;0;16
14985;Žibutė;PELĖDŽIUKAI;2840754631;Taip;9;0;3;12
14986;Žibutė;PELĖDŽIUKAI;6089325755;Taip;10;0;1;11
14987;Žibutė;PELĖDŽIUKAI;1274409680;Taip;5;6;0;11
14988;Žibutė;KREGŽDUTĖS;65354441552;Taip;11;0;1;12
14989;Žibutė;KREGŽDUTĖS;10520617100;Taip;0;1;10;11
14990;Žibutė;KREGŽDUTĖS;41927765047;Taip;12;0;1;13
14991;Žibutė;KREGŽDUTĖS;27934987411;Taip;6;0;0;6
14992;Žibutė;KREGŽDUTĖS;69543986022;Taip;5;0;0;5
14993;Žibutė;KREGŽDUTĖS;58408466259;Taip;11;0;1;12
14994;Žibutė;KREGŽDUTĖS;76429804560;Taip;10;4;1;15
14995;Žibutė;KREGŽDUTĖS;70602200548;Taip;5;0;0;5
14996;Žibutė;KREGŽDUTĖS;27387035728;Taip;5;3;3;11
14997;Žibutė;KREGŽDUTĖS;16188398138;Taip;0;0;8;8
14998;Žibutė;KREGŽDUTĖS;74637399002;Taip;5;1;0;6
14999;Žibutė;KREGŽDUTĖS;72101352091;Taip;3;0;0;3
15000;Žibutė;KREGŽDUTĖS;61878941621;Taip;0;4;2;6
15001;Žibutė;KREGŽDUTĖS;68830297615;Taip;10;3;3;16
15002;Žibutė;KREGŽDUTĖS;89599338661;Taip;12;1;0;13
15003;Žibutė;KREGŽDUTĖS;30268398324;Taip;5;1;0;6
15004;Žibutė;KREGŽDUTĖS;23824219807;Taip;5;0;0;5
15005;Žibutė;KREGŽDUTĖS;93449098365;Taip;0;3;0;3
15006;Žibutė;KREGŽDUTĖS;5026713257;Taip;5;0;0;5
15007;Žibutė;KREGŽDUTĖS;12199795507;Taip;0;0;5;5
15008;Žibutė;KREGŽDUTĖS;21619209538;Taip;7;0;0;7
15009;Žibutė;KREGŽDUTĖS;72754807096;Taip;0;0;4;4
15010;Žibutė;KREGŽDUTĖS;2027777207;Taip;5;1;0;6
15011;Žibutė;KREGŽDUTĖS;1735074467;Taip;3;0;3;6
15012;Žibutė;BORUŽĖLĖS;3268141759;Taip;5;1;1;7
15013;Žibutė;BORUŽĖLĖS;7774532200;Taip;9;5;0;14
15014;Žibutė;BORUŽĖLĖS;1366469428;Taip;20;0;0;20
15015;Žibutė;BORUŽĖLĖS;2607509585;Taip;8;0;0;8
15016;Žibutė;BORUŽĖLĖS;4825064521;Taip;0;13;0;13
15017;Žibutė;BORUŽĖLĖS;5826523148;Taip;14;0;0;14
15018;Žibutė;BORUŽĖLĖS;5806696915;Taip;10;4;0;14
15019;Žibutė;BORUŽĖLĖS;3957898269;Taip;5;2;0;7
15020;Žibutė;BORUŽĖLĖS;4814936645;Taip;11;0;0;11
15021;Žibutė;BORUŽĖLĖS;4382812297;Taip;16;0;0;16
15022;Žibutė;BORUŽĖLĖS;5591698130;Taip;12;0;0;12
15023;Žibutė;BORUŽĖLĖS;1004098038;Taip;0;5;0;5
15024;Žibutė;BORUŽĖLĖS;2880593326;Taip;3;5;0;8
15025;Žibutė;BORUŽĖLĖS;7479437931;Taip;20;0;0;20
15026;Žibutė;BITUTĖS;3194445795;Taip;2;4;0;6
15027;Žibutė;BITUTĖS;14091973543;Taip;3;0;0;3
15028;Žibutė;BITUTĖS;24818054845;Taip;4;0;0;4
15029;Žibutė;BITUTĖS;29414890756;Taip;20;0;0;20
15030;Žibutė;BITUTĖS;27182644850;Taip;0;16;0;16
15031;Žibutė;BITUTĖS;9591439732;Taip;3;0;0;3
15032;Žibutė;BITUTĖS;4491727022;Taip;10;0;0;10
15033;Žibutė;BITUTĖS;90040902859;Taip;0;1;0;1
15034;Žibutė;BITUTĖS;12087873516;Taip;4;5;0;9
15035;Žibutė;BITUTĖS;39367516353;Taip;10;0;0;10
15036;Žibutė;BITUTĖS;1192143609;Taip;5;0;0;5
15037;Žibutė;BITUTĖS;72357016152;Taip;5;7;0;12
15038;Žibutė;BITUTĖS;1054908586;Taip;0;2;0;2
15039;Žibutė;BITUTĖS;1215072172;Taip;4;6;0;10
15040;Žibutė;BITUTĖS;1317512329;Taip;4;1;0;5
15041;Žibutė;BITUTĖS;2144866874;Ne;4;1;0;5
15042;Žibutė;BITUTĖS;2062794337;Taip;9;0;0;9
15043;Žibutė;BITUTĖS;1010766308;Taip;8;0;0;8
15044;Žibutė;BITUTĖS;1749323904;Taip;1;1;0;2
15045;Žibutė;BITUTĖS;19558564943;Taip;12;0;0;12
15046;Žibutė;BITUTĖS;9109825948;Taip;5;0;2;7
15047;Žibutė;BITUTĖS;6958822972;Taip;10;4;0;14
15048;Žibutė;BITUTĖS;62187632470;Taip;5;1;3;9
15049;Žibutė;KAČIUKAI;65433129636;Taip;5;0;1;6
15050;Žibutė;KAČIUKAI;94054589778;Taip;0;0;2;2
15051;Žibutė;KAČIUKAI;25658034484;Taip;5;1;1;7
15052;Žibutė;KAČIUKAI;6736950445;Taip;2;0;0;2
15053;Žibutė;KAČIUKAI;2089960385;Taip;3;0;5;8
15054;Žibutė;KAČIUKAI;30838051846;Taip;5;1;0;6
15055;Žibutė;KAČIUKAI;29408732286;Taip;0;6;7;13
15056;Žibutė;KAČIUKAI;35959201106;Taip;0;5;1;6
15057;Žibutė;KAČIUKAI;67702702073;Taip;9;0;7;16
15058;Žibutė;KAČIUKAI;60756444655;Taip;16;0;0;16
15059;Žibutė;KAČIUKAI;97730387781;Taip;2;0;1;3
15060;Žibutė;KAČIUKAI;51435935201;Taip;0;6;3;9
15061;Žibutė;KAČIUKAI;14243834326;Taip;9;0;3;12
15062;Žibutė;KAČIUKAI;1683770314;Taip;4;2;2;8
15063;Žibutė;KAČIUKAI;99502912405;Ne;0;7;1;8
15064;Žibutė;KAČIUKAI;76137370554;Taip;9;2;1;12
15065;Žibutė;KAČIUKAI;4475507372;Taip;10;0;0;10
15066;Žibutė;KAČIUKAI;2120935059;Taip;8;0;0;8
15067;Žibutė;KAČIUKAI;9655499291;Taip;5;0;1;6
15068;Žibutė;KAČIUKAI;31084244709;Taip;5;0;3;8
15069;Žibutė;ZUIKIAI;6495108202;Taip;4;5;0;9
15070;Žibutė;ZUIKIAI;8715912139;Taip;14;0;0;14
15071;Žibutė;ZUIKIAI;5416015554;Taip;5;0;1;6
15072;Žibutė;ZUIKIAI;2406005105;Taip;3;0;2;5
15073;Žibutė;ZUIKIAI;3555071718;Taip;14;0;1;15
15074;Žibutė;ZUIKIAI;7531027545;Taip;11;0;4;15
15075;Žibutė;ZUIKIAI;3645481894;Taip;14;1;0;15
15076;Žibutė;ZUIKIAI;6074488747;Taip;3;0;1;4
15077;Žibutė;ZUIKIAI;8880329060;Taip;3;0;1;4
15078;Žibutė;ZUIKIAI;2957525481;Taip;14;2;0;16
15079;Žibutė;ZUIKIAI;5009495840;Taip;5;0;1;6
15080;Žibutė;ZUIKIAI;7136145033;Taip;6;0;2;8
15081;Žibutė;ZUIKIAI;5575614158;Taip;15;0;1;16
15082;Žibutė;ZUIKIAI;5190377896;Taip;15;0;1;16
15083;Žibutė;ZUIKIAI;3191351976;Taip;4;0;9;13
15084;Žibutė;ZUIKIAI;9498011134;Taip;0;11;2;13
15085;Žiedas;Bitutės;569146317;Taip;6;0;0;6
15086;Žiedas;Bitutės;61612709115;Ne;5;0;0;5
15087;Žiedas;Bitutės;52916954220;Taip;5;3;0;8
15088;Žiedas;Bitutės;94672053787;Taip;4;5;0;9
15089;Žiedas;Bitutės;70618764845;Ne;8;0;0;8
15090;Žiedas;Bitutės;86696082162;Ne;0;4;0;4
15091;Žiedas;Bitutės;59723024689;Taip;12;1;0;13
15092;Žiedas;Bitutės;14576604550;Taip;9;0;0;9
15093;Žiedas;Bitutės;35737299683;Taip;0;9;0;9
15094;Žiedas;Bitutės;35961318907;Ne;2;3;0;5
15095;Žiedas;Bitutės;4246111136;Ne;0;2;0;2
15096;Žiedas;Bitutės;55194855496;Taip;9;1;0;10
15097;Žiedas;Bitutės;69138351989;Taip;0;5;0;5
15098;Žiedas;Bitutės;31072310441;Taip;0;7;0;7
15099;Žiedas;Bitutės;54614633445;Taip;4;3;0;7
15100;Žiedas;Bitutės;42649178759;Taip;0;1;0;1
15101;Žiedas;Bitutės;1529539343;Taip;10;1;0;11
15102;Žiedas;Bitutės;4753427269;Taip;8;1;0;9
15103;Žiedas;Bitutės;45167345380;Taip;5;2;0;7
15104;Žiedas;Bitutės;20748238520;Taip;9;0;0;9
15105;Žiedas;Bitutės;53409153553;Taip;5;8;0;13
15106;Žiedas;Bitutės;7708303405;Taip;0;2;0;2
15107;Žiedas;Bitutės;79291005378;Taip;2;5;0;7
15108;Žiedas;Varpeliai;32671505578;Taip;1;2;0;3
15109;Žiedas;Varpeliai;50534384762;Taip;5;0;0;5
15110;Žiedas;Varpeliai;5835879070;Taip;0;1;0;1
15111;Žiedas;Varpeliai;1733596148;Taip;0;3;0;3
15112;Žiedas;Varpeliai;55459877940;Taip;7;4;0;11
15113;Žiedas;Varpeliai;50069962197;Taip;6;2;0;8
15114;Žiedas;Varpeliai;59092030605;Taip;5;4;1;10
15115;Žiedas;Varpeliai;17275054601;Taip;5;4;0;9
15116;Žiedas;Varpeliai;1897597456;Taip;0;4;0;4
15117;Žiedas;Varpeliai;1443451076;Taip;5;5;0;10
15118;Žiedas;Varpeliai;1491929025;Taip;0;4;0;4
15119;Žiedas;Varpeliai;2075892389;Taip;5;0;2;7
15120;Žiedas;Varpeliai;9044903345;Taip;11;0;0;11
15121;Žiedas;Varpeliai;85152640431;Taip;1;2;0;3
15122;Žiedas;Varpeliai;2147350804;Taip;12;1;0;13
15123;Žiedas;Varpeliai;1366570116;Taip;5;0;0;5
15124;Žiedas;Varpeliai;37314210812;Taip;5;2;0;7
15125;Žiedas;Varpeliai;52683198809;Taip;2;2;0;4
15126;Žiedas;Varpeliai;99985645406;Taip;4;0;0;4
15127;Žiedas;Varpeliai;39022317368;Taip;13;0;0;13
15128;Žiedas;Varpeliai;1618815502;Taip;5;0;0;5
15129;Žiedas;Varpeliai;1332249885;Taip;10;0;0;10
15130;Žiedas;Varpeliai;12622490543;Ne;14;0;0;14
15131;Žiedas;Varpeliai;1120478375;Taip;8;7;0;15
15132;Žiedas;Varpeliai;2081656643;Taip;0;5;0;5
15133;Žiedas;Žirniukai;43123840066;Taip;0;0;2;2
15134;Žiedas;Žirniukai;65264733887;Ne;0;5;2;7
15135;Žiedas;Žirniukai;80003937908;Taip;3;2;2;7
15136;Žiedas;Žirniukai;4665596321;Taip;0;1;1;2
15137;Žiedas;Žirniukai;29411390190;Taip;3;2;0;5
15138;Žiedas;Žirniukai;20740539606;Taip;13;0;0;13
15139;Žiedas;Žirniukai;226707253;Taip;2;1;9;12
15140;Žiedas;Žirniukai;81304970766;Taip;0;2;2;4
15141;Žiedas;Žirniukai;28885468502;Ne;0;3;7;10
15142;Žiedas;Žirniukai;50295529511;Taip;2;5;0;7
15143;Žiedas;Žirniukai;23936058075;Taip;0;3;0;3
15144;Žiedas;Žirniukai;29665685563;Taip;5;0;0;5
15145;Žiedas;Žirniukai;22305887643;Taip;0;0;1;1
15146;Žiedas;Žirniukai;83630991208;Taip;5;3;2;10
15147;Žiedas;Žirniukai;33966765931;Taip;0;6;0;6
15148;Žiedas;Žirniukai;56303923223;Taip;1;0;0;1
15149;Žiedas;Žirniukai;39792014616;Taip;0;1;4;5
15150;Žiedas;Žirniukai;31369021056;Taip;0;5;0;5
15151;Žiedas;Žirniukai;34178608904;Taip;7;1;3;11
15152;Žiedas;Žirniukai;1398197280;Taip;0;4;0;4
15153;Žiedas;Žirniukai;1288374706;Taip;13;1;0;14
15154;Žiedas;Žirniukai;1631546874;Ne;0;5;0;5
15155;Žiedas;Žirniukai;1817676038;Taip;0;4;0;4
15156;Žiedas;Žirniukai;85519253910;Taip;0;0;2;2
15157;Žiedas;Žirniukai;2063680054;Taip;20;0;0;20
15158;Žiedas;Ramunėlės;9648580306;Taip;9;1;0;10
15159;Žiedas;Ramunėlės;9736967156;Taip;10;0;0;10
15160;Žiedas;Ramunėlės;4922560649;Taip;15;1;0;16
15161;Žiedas;Ramunėlės;2511423525;Taip;11;0;2;13
15162;Žiedas;Ramunėlės;7814504623;Taip;10;0;1;11
15163;Žiedas;Ramunėlės;2095655987;Taip;10;2;0;12
15164;Žiedas;Ramunėlės;7954517383;Taip;11;0;0;11
15165;Žiedas;Ramunėlės;7016509405;Taip;0;0;1;1
15166;Žiedas;Ramunėlės;9247088735;Taip;14;0;0;14
15167;Žiedas;Ramunėlės;9699668892;Taip;5;1;0;6
15168;Žiedas;Ramunėlės;6432090199;Taip;7;5;0;12
15169;Žiedas;Ramunėlės;1139186052;Taip;8;3;6;17
15170;Žiedas;Ramunėlės;5653785844;Taip;5;0;2;7
15171;Žiedas;Ramunėlės;5588136738;Taip;0;5;0;5
15172;Žiedas;Ramunėlės;5626494892;Taip;14;0;0;14
15173;Žiedas;Ramunėlės;1794393042;Taip;1;1;0;2
15174;Žiedas;Ramunėlės;2083493509;Taip;0;3;2;5
15175;Žiedas;Ramunėlės;7708360056;Taip;10;4;0;14
15176;Žiedas;Ramunėlės;7396006218;Taip;14;3;1;18
15177;Žiedas;Ramunėlės;3586376571;Taip;14;0;0;14
15178;Žiedas;Ramunėlės;6786526552;Taip;8;4;8;20
15179;Žiedas;Ramunėlės;3702078720;Taip;5;0;0;5
15180;Žiedas;Bruknelės;1772492727;Taip;11;0;3;14
15181;Žiedas;Bruknelės;6925923143;Taip;16;0;0;16
15182;Žiedas;Bruknelės;1781950568;Taip;6;0;0;6
15183;Žiedas;Bruknelės;1453937876;Taip;7;0;0;7
15184;Žiedas;Bruknelės;9573180529;Taip;20;0;0;20
15185;Žiedas;Bruknelės;3385568839;Taip;20;0;0;20
15186;Žiedas;Bruknelės;2718046390;Taip;5;3;0;8
15187;Žiedas;Bruknelės;9757771445;Taip;19;0;0;19
15188;Žiedas;Bruknelės;4749655084;Taip;0;2;0;2
15189;Žiedas;Bruknelės;5570910138;Taip;13;3;0;16
15190;Žiedas;Bruknelės;73923918829;Taip;10;0;0;10
15191;Žiedas;Bruknelės;3641595127;Taip;14;1;0;15
15192;Žiedas;Bruknelės;9894489800;Taip;15;0;0;15
15193;Žiedas;Bruknelės;6945326867;Taip;9;0;0;9
15194;Žiedas;Bruknelės;3613860509;Taip;0;5;0;5
15195;Žiedas;Bruknelės;9702211410;Taip;0;0;3;3
15196;Žiedas;Bruknelės;3370495317;Taip;5;5;0;10
15197;Žiedas;Bruknelės;2026462074;Taip;20;0;0;20
15198;Žiedas;Bruknelės;1856012121;Taip;12;0;1;13
15199;Žiedas;Bruknelės;1534169381;Taip;0;6;0;6
15200;Žiedas;Bruknelės;4521161684;Taip;10;3;0;13
15201;Žiedas;Bruknelės;9415269410;Taip;14;0;0;14
15202;Žiedas;Bruknelės;9094287056;Taip;11;0;0;11
15203;Žiedas;Bruknelės;5537717174;Taip;7;8;0;15
15204;Žiedas;Bruknelės;8372385066;Taip;6;0;3;9
15205;Žiedas;Pakalnutės;1063755068;Taip;11;0;0;11
15206;Žiedas;Pakalnutės;42049755986;Taip;0;8;0;8
15207;Žiedas;Pakalnutės;52721173922;Taip;20;0;0;20
15208;Žiedas;Pakalnutės;58252361010;Taip;10;7;0;17
15209;Žiedas;Pakalnutės;2060067625;Taip;0;6;0;6
15210;Žiedas;Pakalnutės;2434909184;Taip;2;0;0;2
15211;Žiedas;Pakalnutės;3616767119;Taip;2;0;0;2
15212;Žiedas;Pakalnutės;1835889494;Taip;19;0;0;19
15213;Žiedas;Pakalnutės;1600420971;Taip;18;0;0;18
15214;Žiedas;Pakalnutės;3930283171;Taip;7;7;0;14
15215;Žiedas;Pakalnutės;1985949180;Taip;5;0;1;6
15216;Žiedas;Pakalnutės;1708363648;Taip;14;0;0;14
15217;Žiedas;Pakalnutės;1779122644;Taip;7;5;0;12
15218;Žiedas;Pakalnutės;1200692015;Taip;0;1;0;1
15219;Žiedas;Pakalnutės;1013773415;Taip;14;0;0;14
15220;Žiedas;Pakalnutės;27339844730;Taip;0;7;0;7
15221;Žiedas;Pakalnutės;5812737969;Taip;0;2;0;2
15222;Žiedas;Pakalnutės;1127645903;Taip;15;1;0;16
15223;Žiedas;Pakalnutės;1219022794;Taip;5;6;0;11
15224;Žiedas;Pakalnutės;7647496475;Taip;5;8;0;13
15225;Žiedas;Pakalnutės;1785446716;Taip;3;1;0;4
15226;Žiedas;Pakalnutės;2094277643;Taip;5;0;0;5
15227;Žiedas;Pakalnutės;12960180114;Taip;8;2;0;10
15228;Žiedas;Spanguolytės;73847154996;Taip;11;7;0;18
15229;Žiedas;Spanguolytės;5282211767;Taip;0;9;0;9
15230;Žiedas;Spanguolytės;53090437775;Taip;5;1;0;6
15231;Žiedas;Spanguolytės;69245659818;Taip;5;6;0;11
15232;Žiedas;Spanguolytės;9363714015;Taip;10;2;0;12
15233;Žiedas;Spanguolytės;1318132922;Taip;11;0;0;11
15234;Žiedas;Spanguolytės;2037477873;Taip;0;1;0;1
15235;Žiedas;Spanguolytės;5079107907;Taip;0;5;0;5
15236;Žiedas;Spanguolytės;1450251779;Taip;0;6;0;6
15237;Žiedas;Spanguolytės;4502784565;Taip;12;1;0;13
15238;Žiedas;Spanguolytės;7136135394;Taip;12;4;0;16
15239;Žiedas;Spanguolytės;6964047214;Taip;9;0;1;10
15240;Žiedas;Spanguolytės;8517250094;Taip;0;0;3;3
15241;Žiedas;Spanguolytės;6815408748;Taip;11;0;0;11
15242;Žiedas;Spanguolytės;36350993825;Taip;20;0;0;20
15243;Žiedas;Spanguolytės;2391924358;Taip;0;3;0;3
15244;Žiedas;Spanguolytės;8172222365;Taip;0;4;0;4
15245;Žiedas;Spanguolytės;9259436243;Taip;6;5;0;11
15246;Žiedas;Spanguolytės;3346603228;Taip;16;4;0;20
15247;Žiedas;Spanguolytės;5451923881;Taip;20;0;0;20
15248;Žiedas;Rožytės;4016573192;Taip;5;0;2;7
15249;Žiedas;Rožytės;1771805131;Taip;11;4;0;15
15250;Žiedas;Rožytės;83777073799;Taip;8;5;0;13
15251;Žiedas;Rožytės;65360328423;Taip;16;1;0;17
15252;Žiedas;Rožytės;8241660222;Taip;6;0;1;7
15253;Žiedas;Rožytės;4621822895;Ne;0;5;0;5
15254;Žiedas;Rožytės;18236935510;Taip;0;11;0;11
15255;Žiedas;Rožytės;37978194696;Taip;15;0;0;15
15256;Žiedas;Rožytės;98235996578;Taip;11;0;0;11
15257;Žiedas;Rožytės;1971475040;Taip;10;0;0;10
15258;Žiedas;Rožytės;2098165226;Taip;7;0;0;7
15259;Žiedas;Rožytės;1079445123;Taip;19;0;0;19
15260;Žiedas;Rožytės;6745229012;Taip;10;0;0;10
15261;Žiedas;Rožytės;1136010138;Taip;11;3;0;14
15262;Žiedas;Rožytės;74421578926;Taip;13;3;0;16
15263;Žiedas;Rožytės;1618505155;Taip;2;6;0;8
15264;Žiedas;Rožytės;47457128214;Taip;14;0;0;14
15265;Žiedas;Rožytės;40744263923;Taip;0;0;3;3
15266;Žiedas;Rožytės;33135652351;Taip;14;0;1;15
15267;Žiedas;Rožytės;87240375524;Taip;0;7;0;7
15268;Žiedas;Rožytės;1893226570;Taip;19;0;0;19
15269;Žiedas;Rožytės;54324583490;Taip;18;0;0;18
15270;Žiedas;Rožytės;7283725455;Taip;10;4;0;14
15271;Žiedas;Rožytės;56707734658;Taip;5;4;0;9
15272;Žiedas;Rožytės;2157262849;Taip;0;13;0;13
15273;Žiedas;Pumpurėliai;5647232875;Taip;11;1;0;12
15274;Žiedas;Pumpurėliai;1048272199;Taip;1;3;0;4
15275;Žiedas;Pumpurėliai;5126173608;Taip;19;1;0;20
15276;Žiedas;Pumpurėliai;6443633568;Taip;0;20;0;20
15277;Žiedas;Pumpurėliai;5959899914;Taip;14;3;0;17
15278;Žiedas;Pumpurėliai;5885209631;Taip;8;5;0;13
15279;Žiedas;Pumpurėliai;7578964555;Taip;5;1;0;6
15280;Žiedas;Pumpurėliai;2134466899;Taip;19;0;0;19
15281;Žiedas;Pumpurėliai;7491134119;Taip;0;7;0;7
15282;Žiedas;Pumpurėliai;6658762922;Taip;10;2;0;12
15283;Žiedas;Pumpurėliai;1253833615;Taip;11;0;0;11
15284;Žiedas;Pumpurėliai;4497634040;Taip;16;0;0;16
15285;Žiedas;Pumpurėliai;5420327672;Taip;0;2;1;3
15286;Žiedas;Pumpurėliai;5108263139;Taip;0;0;20;20
15287;Žiedas;Pumpurėliai;5703750436;Taip;3;2;0;5
15288;Žiedas;Pumpurėliai;3857121753;Taip;10;0;1;11
15289;Žiedas;Pumpurėliai;3715928992;Taip;20;0;0;20
15290;Žiedas;Pumpurėliai;1737296046;Taip;5;0;0;5
15291;Žiedas;Pumpurėliai;9352485926;Taip;13;0;0;13
15292;Žiedas;Pumpurėliai;7333813704;Taip;20;0;0;20
15293;Žiedas;Žemuogėlės;7672879525;Taip;2;2;0;4
15294;Žiedas;Žemuogėlės;7097790025;Taip;1;2;0;3
15295;Žiedas;Žemuogėlės;3387263016;Taip;0;2;0;2
15296;Žiedas;Žemuogėlės;1219634640;Taip;0;0;1;1
15297;Žiedas;Žemuogėlės;8927034492;Taip;0;20;0;20
15298;Žiedas;Žemuogėlės;8208331527;Taip;0;15;0;15
15299;Žiedas;Žemuogėlės;1738121071;Taip;5;0;0;5
15300;Žiedas;Žemuogėlės;9037835899;Ne;20;0;0;20
15301;Žiedas;Žemuogėlės;1583038469;Taip;12;0;0;12
15302;Žiedas;Žemuogėlės;8812316692;Taip;19;0;0;19
15303;Žiedas;Žemuogėlės;3178778438;Taip;9;1;0;10
15304;Žiedas;Žemuogėlės;2849254119;Taip;20;0;0;20
15305;Žiedas;Žemuogėlės;5914428064;Taip;0;11;0;11
15306;Žiedas;Žemuogėlės;3900091129;Taip;0;8;0;8
15307;Žiedas;Žemuogėlės;9587581470;Taip;0;5;0;5
15308;Žiedas;Žemuogėlės;9218388800;Taip;6;4;0;10
15309;Žiedas;Žemuogėlės;9140396365;Taip;7;1;0;8
15310;Žiedas;Žemuogėlės;6444377924;Taip;1;0;0;1
15311;Žiedas;Žemuogėlės;7172793351;Taip;15;0;0;15
15312;Žiedas;Žemuogėlės;5578227349;Taip;5;0;0;5
15313;Žiedas;"Žibutė ";4983852075;Taip;8;4;0;12
15314;Žiedas;"Žibutė ";9129315784;Taip;10;1;0;11
15315;Žiedas;"Žibutė ";9750690920;Taip;5;7;0;12
15316;Žiedas;"Žibutė ";1333233100;Taip;15;0;0;15
15317;Žiedas;"Žibutė ";8645771800;Taip;20;0;0;20
15318;Žiedas;"Žibutė ";4556559021;Taip;14;0;0;14
15319;Žiedas;"Žibutė ";7942276632;Taip;9;0;0;9
15320;Žiedas;"Žibutė ";6041919197;Taip;3;0;0;3
15321;Žiedas;"Žibutė ";7187176169;Taip;5;2;0;7
15322;Žiedas;"Žibutė ";2182381160;Taip;6;1;0;7
15323;Žiedas;"Žibutė ";4284627073;Taip;17;0;0;17
15324;Žiedas;"Žibutė ";8822472312;Taip;10;1;0;11
15325;Žiedas;"Žibutė ";7952899220;Taip;8;0;0;8
15326;Žiedas;"Žibutė ";5020148822;Taip;14;0;0;14
15327;Žiedas;"Žibutė ";1777501190;Taip;13;2;0;15
15328;Žiedas;"Žibutė ";1043230748;Taip;0;12;0;12
15329;Žiedas;"Žibutė ";1844621525;Taip;5;7;0;12
15330;Žiedas;"Žibutė ";9021286246;Taip;8;0;0;8
15331;Žiedas;"Žibutė ";6175213274;Taip;5;0;0;5
15332;Žiedas;"Dobiliukai ";1484464986;Taip;5;1;0;6
15333;Žiedas;"Dobiliukai ";34193530;Taip;8;2;0;10
15334;Žiedas;"Dobiliukai ";1529988412;Taip;0;1;0;1
15335;Žiedas;"Dobiliukai ";78720591915;Taip;0;1;0;1
15336;Žiedas;"Dobiliukai ";2763469583;Taip;10;0;0;10
15337;Žiedas;"Dobiliukai ";86877563124;Taip;8;2;0;10
15338;Žiedas;"Dobiliukai ";1458152054;Taip;9;3;0;12
15339;Žiedas;"Dobiliukai ";69485023219;Taip;5;0;0;5
15340;Žiedas;"Dobiliukai ";1007894628;Taip;13;2;0;15
15341;Žiedas;"Dobiliukai ";1625009666;Taip;15;0;0;15
15342;Žiedas;"Dobiliukai ";1868951268;Taip;7;0;0;7
15343;Žiedas;"Dobiliukai ";1824692620;Taip;15;0;0;15
15344;Žiedas;"Dobiliukai ";9058688663;Taip;9;4;0;13
15345;Žiedas;"Dobiliukai ";2026728639;Taip;0;1;0;1
15346;Žiedas;"Dobiliukai ";7150433256;Taip;9;0;0;9
15347;Žiedas;"Dobiliukai ";6145720452;Taip;3;1;0;4
15348;Žiedas;"Dobiliukai ";1030089009;Taip;0;5;0;5
15349;Žiedas;"Dobiliukai ";4807479784;Taip;0;1;0;1
15350;Žiedas;"Dobiliukai ";2507543124;Taip;15;0;0;15
15351;Žiedas;Boružėlės;49024435947;Taip;0;5;0;5
15352;Žiedas;Boružėlės;39480704602;Taip;5;5;0;10
15353;Žiedas;Boružėlės;48191698488;Taip;0;1;0;1
15354;Žiedas;Boružėlės;18549289812;Taip;0;2;0;2
15355;Žiedas;Boružėlės;71843517726;Taip;0;1;0;1
15356;Žiedas;Boružėlės;9117238535;Taip;0;4;1;5
15357;Žiedas;Boružėlės;23799596522;Ne;4;0;3;7
15358;Žiedas;Boružėlės;71876894781;Ne;0;1;0;1
15359;Žiedas;Boružėlės;18469282227;Taip;0;1;0;1
15360;Žiedas;Boružėlės;13070834235;Taip;20;0;0;20
15361;Žiedas;Boružėlės;74893931156;Taip;0;1;0;1
15362;Žiedas;Boružėlės;25196433027;Taip;0;7;0;7
15363;Žiedas;Boružėlės;71241692542;Taip;5;0;0;5
15364;Žiedas;Boružėlės;2025846226;Taip;10;1;0;11
15365;Žiedas;Boružėlės;1748516954;Taip;0;3;0;3
15366;Žiedas;Boružėlės;55246099530;Taip;0;3;0;3
15367;Žiedas;Boružėlės;26141244088;Taip;0;2;5;7
15368;Žiedas;Boružėlės;12163984089;Taip;0;1;0;1
15369;Žiedas;Boružėlės;95883894012;Ne;0;2;0;2
15370;Žiogelis;SKRUZDELYTĖS;4508141956;Taip;18;0;1;19
15371;Žiogelis;SKRUZDELYTĖS;4343510173;Taip;0;11;0;11
15372;Žiogelis;SKRUZDELYTĖS;6346503991;Taip;5;0;0;5
15373;Žiogelis;SKRUZDELYTĖS;18018505301;Taip;0;8;0;8
15374;Žiogelis;SKRUZDELYTĖS;3503872654;Taip;2;0;0;2
15375;Žiogelis;SKRUZDELYTĖS;6067622823;Taip;7;1;0;8
15376;Žiogelis;SKRUZDELYTĖS;8702710674;Taip;0;12;0;12
15377;Žiogelis;SKRUZDELYTĖS;4671356872;Taip;3;5;0;8
15378;Žiogelis;SKRUZDELYTĖS;7881358741;Taip;0;3;0;3
15379;Žiogelis;SKRUZDELYTĖS;3750023611;Taip;8;0;0;8
15380;Žiogelis;SKRUZDELYTĖS;3609961581;Taip;10;0;0;10
15381;Žiogelis;SKRUZDELYTĖS;64865699245;Taip;5;1;0;6
15382;Žiogelis;SKRUZDELYTĖS;60959051938;Taip;8;0;0;8
15383;Žiogelis;SKRUZDELYTĖS;95713316600;Taip;0;1;1;2
15384;Žiogelis;SKRUZDELYTĖS;4445888917;Taip;6;0;0;6
15385;Žiogelis;SKRUZDELYTĖS;24941867247;Taip;9;0;0;9
15386;Žiogelis;SKRUZDELYTĖS;6659086172;Taip;19;0;0;19
15387;Žiogelis;SKRUZDELYTĖS;2883732914;Taip;5;0;0;5
15388;Žiogelis;SKRUZDELYTĖS;3189872952;Taip;5;0;0;5
15389;Žiogelis;SKRUZDELYTĖS;9295720241;Taip;18;0;0;18
15390;Žiogelis;SKRUZDELYTĖS;1568915914;Taip;10;2;0;12
15391;Žiogelis;SKRUZDELYTĖS;3203359908;Taip;16;0;0;16
15392;Žiogelis;SKRUZDELYTĖS;3320077143;Taip;6;0;0;6
15393;Žiogelis;ŽIRNIUKAI;7704256764;Taip;4;2;0;6
15394;Žiogelis;ŽIRNIUKAI;6701809272;Taip;0;2;1;3
15395;Žiogelis;ŽIRNIUKAI;8675451323;Taip;0;1;0;1
15396;Žiogelis;ŽIRNIUKAI;1660784232;Taip;20;0;0;20
15397;Žiogelis;ŽIRNIUKAI;1320651707;Taip;6;1;0;7
15398;Žiogelis;ŽIRNIUKAI;1235203700;Taip;11;0;0;11
15399;Žiogelis;ŽIRNIUKAI;1551989977;Taip;0;2;5;7
15400;Žiogelis;ŽIRNIUKAI;3310492752;Taip;5;0;1;6
15401;Žiogelis;ŽIRNIUKAI;5557800297;Taip;12;1;0;13
15402;Žiogelis;ŽIRNIUKAI;3392582853;Taip;12;1;0;13
15403;Žiogelis;ŽIRNIUKAI;2366095661;Taip;15;0;0;15
15404;Žiogelis;ŽIRNIUKAI;1320126836;Taip;5;1;0;6
15405;Žiogelis;ŽIRNIUKAI;1442866468;Taip;9;0;0;9
15406;Žiogelis;ŽIRNIUKAI;6697117406;Taip;11;0;0;11
15407;Žiogelis;ŽIRNIUKAI;9862582346;Taip;6;0;0;6
15408;Žiogelis;ŽIRNIUKAI;7087781379;Taip;6;3;0;9
15409;Žiogelis;ŽIRNIUKAI;4015109974;Taip;6;3;0;9
15410;Žiogelis;ŽIRNIUKAI;9406830518;Taip;15;0;0;15
15411;Žiogelis;ŽIRNIUKAI;3910954904;Taip;14;0;1;15
15412;Žiogelis;ŽIRNIUKAI;4713696984;Taip;5;0;1;6
15413;Žiogelis;DOBILĖLIAI;48593529087;Taip;3;0;0;3
15414;Žiogelis;DOBILĖLIAI;66336692039;Taip;0;2;1;3
15415;Žiogelis;DOBILĖLIAI;80149085891;Taip;0;1;0;1
15416;Žiogelis;DOBILĖLIAI;62821992692;Taip;0;4;2;6
15417;Žiogelis;DOBILĖLIAI;54215852783;Taip;0;0;1;1
15418;Žiogelis;DOBILĖLIAI;93657289013;Ne;9;0;0;9
15419;Žiogelis;DOBILĖLIAI;52411020277;Taip;0;0;1;1
15420;Žiogelis;DOBILĖLIAI;75553027681;Taip;0;4;0;4
15421;Žiogelis;DOBILĖLIAI;98097805447;Taip;3;2;0;5
15422;Žiogelis;DOBILĖLIAI;62488730896;Taip;0;4;0;4
15423;Žiogelis;DOBILĖLIAI;50662980044;Taip;0;0;3;3
15424;Žiogelis;DOBILĖLIAI;41857562297;Taip;5;0;0;5
15425;Žiogelis;DOBILĖLIAI;78375291773;Taip;0;0;1;1
15426;Žiogelis;DOBILĖLIAI;3820146581;Taip;4;0;0;4
15427;Žiogelis;DOBILĖLIAI;82777324022;Taip;11;6;0;17
15428;Žiogelis;DOBILĖLIAI;1970044099;Taip;0;1;0;1
15429;Žiogelis;DOBILĖLIAI;1100192617;Taip;3;0;0;3
15430;Žiogelis;DOBILĖLIAI;41258844862;Taip;0;0;5;5
15431;Žiogelis;BORUŽĖLĖS;49537204301;Taip;5;5;0;10
15432;Žiogelis;BORUŽĖLĖS;48952047191;Taip;0;8;0;8
15433;Žiogelis;BORUŽĖLĖS;57076857319;Taip;0;1;0;1
15434;Žiogelis;BORUŽĖLĖS;64779912059;Taip;0;0;3;3
15435;Žiogelis;BORUŽĖLĖS;73428910367;Taip;7;1;0;8
15436;Žiogelis;BORUŽĖLĖS;3136149837;Taip;14;0;0;14
15437;Žiogelis;BORUŽĖLĖS;96860756761;Taip;2;1;0;3
15438;Žiogelis;BORUŽĖLĖS;76191564181;Taip;5;0;0;5
15439;Žiogelis;BORUŽĖLĖS;41126779124;Taip;5;2;1;8
15440;Žiogelis;BORUŽĖLĖS;33241743715;Taip;0;2;2;4
15441;Žiogelis;BORUŽĖLĖS;57249343296;Taip;0;3;0;3
15442;Žiogelis;BORUŽĖLĖS;85673565399;Taip;10;5;0;15
15443;Žiogelis;BORUŽĖLĖS;30819925055;Taip;0;4;0;4
15444;Žiogelis;BORUŽĖLĖS;81464649021;Taip;0;2;5;7
15445;Žiogelis;BORUŽĖLĖS;35891668864;Taip;0;1;0;1
15446;Žiogelis;BORUŽĖLĖS;74697514256;Ne;0;1;3;4
15447;Žiogelis;BORUŽĖLĖS;18978600625;Taip;0;2;0;2
15448;Žiogelis;BORUŽĖLĖS;89033004994;Taip;20;0;0;20
15449;Žiogelis;BORUŽĖLĖS;32543247974;Taip;0;4;5;9
15450;Žiogelis;BORUŽĖLĖS;73146584544;Taip;0;10;0;10
15451;Žiogelis;BORUŽĖLĖS;86839909955;Taip;0;6;1;7
15452;Žiogelis;BORUŽĖLĖS;78885512443;Ne;5;2;0;7
15453;Žiogelis;BORUŽĖLĖS;52901528922;Taip;6;0;0;6
15454;Žiogelis;DRUGELIAI;9826756136;Taip;8;0;0;8
15455;Žiogelis;DRUGELIAI;40049935108;Taip;14;2;0;16
15456;Žiogelis;DRUGELIAI;37505015919;Taip;2;4;0;6
15457;Žiogelis;DRUGELIAI;85453441005;Taip;1;0;0;1
15458;Žiogelis;DRUGELIAI;25631779076;Taip;5;8;0;13
15459;Žiogelis;DRUGELIAI;91499233609;Taip;0;4;0;4
15460;Žiogelis;DRUGELIAI;40186714037;Taip;3;4;0;7
15461;Žiogelis;DRUGELIAI;52847485981;Taip;3;5;0;8
15462;Žiogelis;DRUGELIAI;96793345108;Taip;8;8;0;16
15463;Žiogelis;DRUGELIAI;96369154198;Taip;0;1;0;1
15464;Žiogelis;DRUGELIAI;56579227266;Taip;0;0;4;4
15465;Žiogelis;DRUGELIAI;66037746045;Taip;3;2;0;5
15466;Žiogelis;DRUGELIAI;68621438109;Taip;0;1;0;1
15467;Žiogelis;DRUGELIAI;18225364866;Taip;0;1;1;2
15468;Žiogelis;DRUGELIAI;18957711548;Taip;3;0;0;3
15469;Žiogelis;DRUGELIAI;52855728176;Ne;0;5;0;5
15470;Žiogelis;DRUGELIAI;35609682774;Taip;6;1;0;7
15471;Žiogelis;DRUGELIAI;1096666450;Taip;0;2;0;2
15472;Žiogelis;DRUGELIAI;1237788562;Taip;0;3;0;3
15473;Žiogelis;DRUGELIAI;1867019234;Taip;0;1;0;1
15474;Žiogelis;DRUGELIAI;1082983134;Taip;10;1;0;11
15475;Žiogelis;DRUGELIAI;97696839366;Taip;6;0;0;6
15476;Žiogelis;PELĖDŽIUKAI;25765405268;Taip;0;1;0;1
15477;Žiogelis;PELĖDŽIUKAI;40656416455;Taip;8;4;0;12
15478;Žiogelis;PELĖDŽIUKAI;58435832422;Taip;0;2;0;2
15479;Žiogelis;PELĖDŽIUKAI;65431295185;Taip;0;1;0;1
15480;Žiogelis;PELĖDŽIUKAI;54157468880;Taip;10;1;0;11
15481;Žiogelis;PELĖDŽIUKAI;90856268042;Taip;0;7;0;7
15482;Žiogelis;PELĖDŽIUKAI;75990939732;Taip;0;3;0;3
15483;Žiogelis;PELĖDŽIUKAI;99706324340;Taip;0;1;0;1
15484;Žiogelis;PELĖDŽIUKAI;46206606894;Taip;0;1;1;2
15485;Žiogelis;PELĖDŽIUKAI;87136010729;Taip;0;1;0;1
15486;Žiogelis;PELĖDŽIUKAI;5564124076;Taip;0;2;0;2
15487;Žiogelis;PELĖDŽIUKAI;88467192459;Taip;10;9;0;19
15488;Žiogelis;PELĖDŽIUKAI;23052639699;Taip;0;1;0;1
15489;Žiogelis;PELĖDŽIUKAI;30153333482;Taip;5;0;0;5
15490;Žiogelis;PELĖDŽIUKAI;9520854450;Taip;0;5;3;8
15491;Žiogelis;PELĖDŽIUKAI;46938187629;Taip;0;7;0;7
15492;Žiogelis;PELĖDŽIUKAI;65284631135;Taip;5;1;0;6
15493;Žiogelis;PELĖDŽIUKAI;1303123383;Taip;3;4;0;7
15494;Žiogelis;PELĖDŽIUKAI;62633906174;Taip;5;1;0;6
15495;Žiogelis;PELĖDŽIUKAI;2100993889;Taip;0;5;0;5
15496;Žiogelis;PELĖDŽIUKAI;82738581846;Taip;13;2;0;15
15497;Žiogelis;PELĖDŽIUKAI;80050087040;Taip;0;18;0;18
15498;Žiogelis;VARPELIAI;98313060080;Taip;7;0;0;7
15499;Žiogelis;VARPELIAI;63443494015;Taip;0;2;0;2
15500;Žiogelis;VARPELIAI;1069475442;Ne;0;4;0;4
15501;Žiogelis;VARPELIAI;81691405176;Taip;0;5;0;5
15502;Žiogelis;VARPELIAI;72043183625;Taip;4;1;0;5
15503;Žiogelis;VARPELIAI;42165847795;Taip;0;3;0;3
15504;Žiogelis;VARPELIAI;1198917418;Taip;9;0;0;9
15505;Žiogelis;VARPELIAI;1261679627;Taip;0;4;0;4
15506;Žiogelis;VARPELIAI;42895811959;Taip;9;1;0;10
15507;Žiogelis;VARPELIAI;44118139818;Taip;9;1;0;10
15508;Žiogelis;VARPELIAI;7708273984;Taip;3;4;0;7
15509;Žiogelis;VARPELIAI;12932356909;Taip;0;4;0;4
15510;Žiogelis;VARPELIAI;1060830668;Taip;20;0;0;20
15511;Žiogelis;VARPELIAI;9871477318;Taip;17;0;0;17
15512;Žiogelis;VARPELIAI;7824632294;Taip;0;2;0;2
15513;Žiogelis;VARPELIAI;6225523016;Taip;14;1;0;15
15514;Žiogelis;VARPELIAI;9436611716;Taip;6;8;0;14
15515;Žiogelis;VARPELIAI;2575280329;Taip;5;0;0;5
15516;Žiogelis;VARPELIAI;4402777236;Taip;7;4;0;11
15517;Žiogelis;VARPELIAI;1370071592;Taip;0;3;0;3
15518;Žiogelis;VARPELIAI;9416538794;Taip;6;1;0;7
15519;Žiogelis;KREGŽDUTĖS;1195431423;Taip;0;1;2;3
15520;Žiogelis;KREGŽDUTĖS;20399291813;Taip;5;7;0;12
15521;Žiogelis;KREGŽDUTĖS;1521276302;Taip;0;4;0;4
15522;Žiogelis;KREGŽDUTĖS;52932005977;Taip;10;1;0;11
15523;Žiogelis;KREGŽDUTĖS;28585504631;Taip;6;1;2;9
15524;Žiogelis;KREGŽDUTĖS;43521866470;Taip;0;0;18;18
15525;Žiogelis;KREGŽDUTĖS;71387182665;Taip;6;8;0;14
15526;Žiogelis;KREGŽDUTĖS;94690046398;Taip;0;1;0;1
15527;Žiogelis;KREGŽDUTĖS;94313785346;Taip;0;4;0;4
15528;Žiogelis;KREGŽDUTĖS;88933947850;Taip;5;1;4;10
15529;Žiogelis;KREGŽDUTĖS;22969768169;Taip;0;10;0;10
15530;Žiogelis;KREGŽDUTĖS;18304908981;Taip;0;7;0;7
15531;Žiogelis;KREGŽDUTĖS;1042591705;Taip;0;2;0;2
15532;Žiogelis;KREGŽDUTĖS;1160064257;Taip;0;1;1;2
15533;Žiogelis;KREGŽDUTĖS;1162630845;Taip;0;1;7;8
15534;Žiogelis;KREGŽDUTĖS;2072071751;Taip;0;1;2;3
15535;Žiogelis;KREGŽDUTĖS;1200247527;Taip;20;0;0;20
15536;Žiogelis;KREGŽDUTĖS;41448152472;Taip;0;1;0;1
15537;Žiogelis;KREGŽDUTĖS;44023584723;Taip;5;7;0;12
15538;Žiogelis;KREGŽDUTĖS;1915370991;Taip;0;3;0;3
15539;Žiogelis;KREGŽDUTĖS;1821759690;Taip;0;7;0;7
15540;Žiogelis;KREGŽDUTĖS;24010106626;Taip;0;10;0;10
15541;Žiogelis;ŽVIRBLIUKAI;5364996984;Taip;20;0;0;20
15542;Žiogelis;ŽVIRBLIUKAI;9568208184;Taip;20;0;0;20
15543;Žiogelis;ŽVIRBLIUKAI;2117192553;Taip;5;0;1;6
15544;Žiogelis;ŽVIRBLIUKAI;5961630249;Taip;5;0;0;5
15545;Žiogelis;ŽVIRBLIUKAI;8683148826;Taip;17;0;1;18
15546;Žiogelis;ŽVIRBLIUKAI;3502278745;Taip;5;0;0;5
15547;Žiogelis;ŽVIRBLIUKAI;5054228916;Taip;5;0;0;5
15548;Žiogelis;ŽVIRBLIUKAI;3308563362;Taip;5;0;1;6
15549;Žiogelis;ŽVIRBLIUKAI;3928697936;Taip;13;0;0;13
15550;Žiogelis;ŽVIRBLIUKAI;1190395481;Taip;5;0;0;5
15551;Žiogelis;ŽVIRBLIUKAI;8715501524;Taip;20;0;0;20
15552;Žiogelis;ŽVIRBLIUKAI;1465027680;Taip;10;0;1;11
15553;Žiogelis;ŽVIRBLIUKAI;6495456608;Taip;16;0;0;16
15554;Žiogelis;ŽVIRBLIUKAI;6340620973;Taip;6;2;1;9
15555;Žiogelis;ŽVIRBLIUKAI;3426813997;Taip;0;0;20;20
15556;Žiogelis;ŽVIRBLIUKAI;3852211212;Taip;0;4;0;4
15557;Žiogelis;ŽVIRBLIUKAI;9813150014;Taip;6;1;0;7
15558;Žiogelis;BITUTĖS;5639046412;Ne;0;15;0;15
15559;Žiogelis;BITUTĖS;65387706999;Taip;0;2;1;3
15560;Žiogelis;BITUTĖS;98660118094;Taip;20;0;0;20
15561;Žiogelis;BITUTĖS;6963163354;Taip;1;6;0;7
15562;Žiogelis;BITUTĖS;29876596658;Taip;6;5;0;11
15563;Žiogelis;BITUTĖS;8169022043;Taip;0;4;0;4
15564;Žiogelis;BITUTĖS;84919810287;Taip;0;2;0;2
15565;Žiogelis;BITUTĖS;48896172781;Taip;7;1;0;8
15566;Žiogelis;BITUTĖS;14932261911;Taip;8;0;0;8
15567;Žiogelis;BITUTĖS;67475530006;Taip;0;7;0;7
15568;Žiogelis;BITUTĖS;49836275638;Taip;0;2;1;3
15569;Žiogelis;BITUTĖS;8819549855;Taip;0;1;0;1
15570;Žiogelis;BITUTĖS;81608736626;Taip;0;4;0;4
15571;Žiogelis;BITUTĖS;39293593638;Taip;0;1;0;1
15572;Žiogelis;BITUTĖS;63956907259;Taip;5;0;0;5
15573;Žiogelis;BITUTĖS;73793165310;Taip;0;2;1;3
15574;Žiogelis;BITUTĖS;28788742249;Taip;0;2;1;3
15575;Žiogelis;BITUTĖS;4465151986;Taip;0;0;14;14
15576;Žiogelis;BITUTĖS;45051106222;Taip;0;7;0;7
15577;Žiogelis;BITUTĖS;87755643169;Taip;0;1;0;1
15578;Žiogelis;RIEŠUTĖLIAI;9981130790;Taip;20;0;0;20
15579;Žiogelis;RIEŠUTĖLIAI;9627583831;Taip;0;12;0;12
15580;Žiogelis;RIEŠUTĖLIAI;3420228264;Taip;0;1;0;1
15581;Žiogelis;RIEŠUTĖLIAI;5042341085;Taip;5;0;2;7
15582;Žiogelis;RIEŠUTĖLIAI;3752355139;Taip;3;0;2;5
15583;Žiogelis;RIEŠUTĖLIAI;3296450902;Taip;0;1;0;1
15584;Žiogelis;RIEŠUTĖLIAI;3820534331;Taip;5;0;0;5
15585;Žiogelis;RIEŠUTĖLIAI;1996517542;Taip;7;0;1;8
15586;Žiogelis;RIEŠUTĖLIAI;5545581078;Taip;0;1;0;1
15587;Žiogelis;RIEŠUTĖLIAI;4630381709;Taip;19;0;0;19
15588;Žiogelis;RIEŠUTĖLIAI;9790463889;Taip;10;4;0;14
15589;Žiogelis;RIEŠUTĖLIAI;6024752960;Taip;17;0;0;17
15590;Žiogelis;RIEŠUTĖLIAI;8853905367;Taip;17;0;0;17
15591;Žiogelis;RIEŠUTĖLIAI;1397686161;Taip;11;1;0;12
15592;Žiogelis;RIEŠUTĖLIAI;6760074113;Taip;9;0;0;9
15593;Žiogelis;RIEŠUTĖLIAI;3792114246;Taip;10;1;0;11
15594;Žiogelis;RIEŠUTĖLIAI;8293687695;Taip;15;0;0;15
15595;Žiogelis;RIEŠUTĖLIAI;2455244286;Taip;8;1;0;9
15596;Žolynėlis;Spanguolėlė;25151683915;Taip;7;0;0;7
15597;Žolynėlis;Spanguolėlė;8104525380;Taip;0;2;0;2
15598;Žolynėlis;Spanguolėlė;24353356454;Taip;13;7;0;20
15599;Žolynėlis;Spanguolėlė;97976573561;Taip;8;6;0;14
15600;Žolynėlis;Spanguolėlė;1920564803;Taip;14;0;0;14
15601;Žolynėlis;Spanguolėlė;92615552899;Taip;0;4;0;4
15602;Žolynėlis;Spanguolėlė;82641799101;Taip;0;6;0;6
15603;Žolynėlis;Spanguolėlė;95943166746;Taip;8;1;2;11
15604;Žolynėlis;Spanguolėlė;4109395683;Taip;10;5;0;15
15605;Žolynėlis;Spanguolėlė;5901704055;Taip;0;11;0;11
15606;Žolynėlis;Spanguolėlė;5717038791;Taip;8;5;0;13
15607;Žolynėlis;Spanguolėlė;9128728457;Taip;9;2;0;11
15608;Žolynėlis;Spanguolėlė;1216568014;Taip;0;12;0;12
15609;Žolynėlis;Spanguolėlė;7438853916;Taip;9;1;3;13
15610;Žolynėlis;Spanguolėlė;44063150309;Taip;5;1;1;7
15611;Žolynėlis;Spanguolėlė;8700231970;Taip;3;0;1;4
15612;Žolynėlis;Spanguolėlė;7831076713;Ne;11;0;2;13
15613;Žolynėlis;Spanguolėlė;1901979061;Taip;8;1;2;11
15614;Žolynėlis;Spanguolėlė;2984354887;Taip;9;2;0;11
15615;Žolynėlis;"RŪTELĖ (spec)";49076759224;Taip;16;2;0;18
15616;Žolynėlis;"RŪTELĖ (spec)";48837362422;Taip;3;2;1;6
15617;Žolynėlis;"RŪTELĖ (spec)";44929463545;Taip;12;1;0;13
15618;Žolynėlis;"RŪTELĖ (spec)";88879292846;Taip;0;7;0;7
15619;Žolynėlis;"RŪTELĖ (spec)";1540454207;Taip;8;0;0;8
15620;Žolynėlis;"RŪTELĖ (spec)";1954888655;Taip;11;5;0;16
15621;Žolynėlis;"SAULUTĖ (spec)";89488434450;Ne;20;0;0;20
15622;Žolynėlis;"SAULUTĖ (spec)";78150115970;Taip;0;2;0;2
15623;Žolynėlis;"SAULUTĖ (spec)";9468040148;Taip;14;2;0;16
15624;Žolynėlis;"SAULUTĖ (spec)";1153167430;Taip;8;0;0;8
15625;Žolynėlis;"LINELIS (spec)";93519259505;Taip;14;0;0;14
15626;Žolynėlis;"LINELIS (spec)";7717415005;Taip;20;0;0;20
15627;Žolynėlis;"LINELIS (spec)";2665355759;Taip;20;0;0;20
15628;Žolynėlis;"RASAKILA (spec)";5957587644;Taip;0;11;0;11
15629;Žolynėlis;"RASAKILA (spec)";4971887781;Taip;8;0;0;8
15630;Žolynėlis;"RASAKILA (spec)";3337602618;Ne;14;0;0;14
15631;Žolynėlis;"RASAKILA (spec)";2285501450;Taip;0;1;0;1
15632;Žolynėlis;"RAMUNĖLĖS (spec)";43729773415;Taip;2;0;0;2
15633;Žolynėlis;"RAMUNĖLĖS (spec)";17307655696;Taip;5;0;0;5
15634;Žolynėlis;"RAMUNĖLĖS (spec)";91598708166;Taip;14;0;0;14
15635;Žolynėlis;"RAMUNĖLĖS (spec)";42425570226;Taip;0;2;1;3
15636;Žolynėlis;"RAMUNĖLĖS (spec)";6080154964;Taip;0;2;5;7
15637;Žolynėlis;"RAMUNĖLĖS (spec)";67411709338;Taip;8;0;0;8
15638;Žolynėlis;Dobiliukai;59125596894;Taip;0;3;0;3
15639;Žolynėlis;Dobiliukai;1123243743;Taip;0;0;14;14
15640;Žolynėlis;Dobiliukai;1655571687;Taip;14;2;0;16
15641;Žolynėlis;Dobiliukai;1197188528;Taip;0;5;8;13
15642;Žolynėlis;Dobiliukai;79759781705;Taip;0;2;0;2
15643;Žolynėlis;Dobiliukai;1833898567;Taip;5;4;0;9
15644;Žolynėlis;Dobiliukai;1331253673;Taip;5;4;0;9
15645;Žolynėlis;Dobiliukai;89750778560;Taip;0;6;0;6
15646;Žolynėlis;Dobiliukai;76688557717;Taip;10;0;0;10
15647;Žolynėlis;Dobiliukai;47442048515;Taip;7;0;0;7
15648;Žolynėlis;Dobiliukai;75335374706;Taip;1;6;4;11
15649;Žolynėlis;Dobiliukai;42333222214;Taip;4;0;0;4
15650;Žolynėlis;Dobiliukai;29420971822;Taip;7;1;0;8
15651;Žolynėlis;Dobiliukai;1080834237;Taip;0;0;1;1
15652;Žolynėlis;Dobiliukai;1619061427;Taip;14;0;0;14
15653;Žolynėlis;Dobiliukai;71887799705;Taip;0;2;0;2
15654;Žolynėlis;Dobiliukai;8872394996;Taip;0;2;1;3
15655;Žolynėlis;Dobiliukai;39450377869;Taip;20;0;0;20
15656;Žolynėlis;Dobiliukai;1933377698;Taip;4;2;2;8
15657;Žolynėlis;Aguonėlė;7313345140;Taip;0;2;0;2
15658;Žolynėlis;Aguonėlė;1620578562;Taip;0;10;0;10
15659;Žolynėlis;Aguonėlė;77707724932;Taip;6;2;0;8
15660;Žolynėlis;Aguonėlė;66167062016;Taip;0;10;1;11
15661;Žolynėlis;Aguonėlė;4545601535;Taip;0;7;0;7
15662;Žolynėlis;Aguonėlė;95007685205;Taip;9;1;0;10
15663;Žolynėlis;Aguonėlė;61475380296;Taip;5;2;1;8
15664;Žolynėlis;Aguonėlė;2051626484;Taip;5;3;0;8
15665;Žolynėlis;Aguonėlė;1348748628;Taip;0;0;2;2
15666;Žolynėlis;Aguonėlė;8027151284;Taip;0;17;0;17
15667;Žolynėlis;Aguonėlė;47825918748;Taip;0;8;0;8
15668;Žolynėlis;Aguonėlė;6169887781;Taip;13;0;1;14
15669;Žolynėlis;Aguonėlė;28730145668;Taip;0;7;1;8
15670;Žolynėlis;Aguonėlė;14877714964;Taip;0;9;0;9
15671;Žolynėlis;Aguonėlė;84849092452;Taip;16;1;0;17
15672;Žolynėlis;Aguonėlė;1257427271;Taip;5;1;0;6
15673;Žolynėlis;Aguonėlė;3263848791;Taip;0;13;1;14
15674;Žolynėlis;Aguonėlė;5827146071;Taip;0;3;0;3
15675;Žolynėlis;Aguonėlė;7256502393;Taip;0;2;3;5
15676;Žolynėlis;Aguonėlė;79704789499;Taip;0;2;3;5
15677;Žolynėlis;Pienė;3088932720;Taip;9;1;0;10
15678;Žolynėlis;Pienė;2108221942;Taip;8;5;0;13
15679;Žolynėlis;Pienė;2934361190;Taip;9;9;0;18
15680;Žolynėlis;Pienė;7980206574;Taip;6;0;0;6
15681;Žolynėlis;Pienė;2460982987;Taip;1;0;2;3
15682;Žolynėlis;Pienė;7339110559;Taip;8;1;0;9
15683;Žolynėlis;Pienė;6763515483;Taip;16;0;0;16
15684;Žolynėlis;Pienė;8215427354;Taip;0;9;2;11
15685;Žolynėlis;Pienė;1485195267;Taip;9;2;0;11
15686;Žolynėlis;Pienė;1163753820;Taip;11;2;0;13
15687;Žolynėlis;Pienė;9106152447;Taip;8;4;0;12
15688;Žolynėlis;Pienė;1879046798;Taip;2;0;0;2
15689;Žolynėlis;Pienė;9941248291;Taip;20;0;0;20
15690;Žolynėlis;Pienė;7827343027;Taip;10;0;10;20
15691;Žolynėlis;Pienė;1338278043;Taip;0;0;20;20
15692;Žolynėlis;Čiobreliai;68439377746;Taip;5;1;0;6
15693;Žolynėlis;Čiobreliai;4379062413;Taip;5;3;0;8
15694;Žolynėlis;Čiobreliai;96960531652;Taip;0;6;0;6
15695;Žolynėlis;Čiobreliai;1135293576;Taip;0;6;0;6
15696;Žolynėlis;Čiobreliai;1188610173;Taip;5;3;0;8
15697;Žolynėlis;Čiobreliai;5262662371;Taip;6;10;0;16
15698;Žolynėlis;Čiobreliai;52441582081;Taip;0;7;0;7
15699;Žolynėlis;Čiobreliai;80589192193;Taip;0;3;0;3
15700;Žolynėlis;Čiobreliai;32852326605;Taip;5;1;0;6
15701;Žolynėlis;Čiobreliai;60635877748;Taip;7;0;0;7
15702;Žolynėlis;Čiobreliai;67610580721;Taip;12;4;0;16
15703;Žolynėlis;Čiobreliai;2142241983;Ne;0;12;0;12
15704;Žolynėlis;Čiobreliai;93243311709;Taip;0;9;0;9
15705;Žolynėlis;Čiobreliai;91866724044;Taip;8;6;0;14
15706;Žolynėlis;Čiobreliai;28388449859;Ne;10;0;0;10
15707;Žolynėlis;Čiobreliai;16469644694;Taip;6;1;0;7
15708;Žolynėlis;Čiobreliai;58271736414;Taip;0;6;0;6
15709;Žolynėlis;Čiobreliai;76160324851;Taip;6;6;0;12
15710;Žolynėlis;Avietėlė;9207088786;Taip;4;0;1;5
15711;Žolynėlis;Avietėlė;1337138547;Taip;0;4;5;9
15712;Žolynėlis;Avietėlė;5432464074;Taip;20;0;0;20
15713;Žolynėlis;Avietėlė;3192462197;Taip;6;4;0;10
15714;Žolynėlis;Avietėlė;1189484802;Taip;3;2;0;5
15715;Žolynėlis;Avietėlė;2881461471;Taip;10;2;0;12
15716;Žolynėlis;Avietėlė;5173171444;Taip;0;6;0;6
15717;Žolynėlis;Avietėlė;3984024179;Taip;18;1;0;19
15718;Žolynėlis;Avietėlė;3149718901;Taip;0;0;2;2
15719;Žolynėlis;Avietėlė;6829144389;Taip;0;20;0;20
15720;Žolynėlis;Avietėlė;6416217971;Taip;9;0;0;9
15721;Žolynėlis;Avietėlė;8646095992;Taip;20;0;0;20
15722;Žolynėlis;Rugiagėlė;5767549779;Taip;2;2;0;4
15723;Žolynėlis;Rugiagėlė;1590210772;Taip;4;0;0;4
15724;Žolynėlis;Rugiagėlė;1223126521;Taip;8;4;0;12
15725;Žolynėlis;Rugiagėlė;8547773739;Taip;7;2;0;9
15726;Žolynėlis;Rugiagėlė;25487230804;Taip;11;2;0;13
15727;Žolynėlis;Rugiagėlė;7870236961;Taip;0;0;6;6
15728;Žolynėlis;Rugiagėlė;2785156297;Taip;14;4;0;18
15729;Žolynėlis;Rugiagėlė;2779563503;Taip;6;0;4;10
15730;Žolynėlis;Rugiagėlė;3422605135;Taip;0;2;0;2
15731;Žolynėlis;Rugiagėlė;5650427433;Taip;11;1;0;12
15732;Žolynėlis;Rugiagėlė;1473516753;Taip;0;0;14;14
15733;Žolynėlis;Rugiagėlė;9997358375;Taip;5;0;1;6
15734;Žuvėdra;"JŪROS ŽVAIGŽDUTĖS";91701621174;Taip;0;10;3;13
15735;Žuvėdra;"JŪROS ŽVAIGŽDUTĖS";64256836669;Taip;0;3;4;7
15736;Žuvėdra;"JŪROS ŽVAIGŽDUTĖS";27394642359;Taip;0;9;0;9
15737;Žuvėdra;"JŪROS ŽVAIGŽDUTĖS";74637620163;Ne;0;1;1;2
15738;Žuvėdra;"JŪROS ŽVAIGŽDUTĖS";8495976081;Ne;12;3;0;15
15739;Žuvėdra;"JŪROS ŽVAIGŽDUTĖS";35541220076;Taip;4;0;2;6
15740;Žuvėdra;"JŪROS ŽVAIGŽDUTĖS";61744715160;Taip;0;12;0;12
15741;Žuvėdra;"JŪROS ŽVAIGŽDUTĖS";16298551647;Taip;0;1;0;1
15742;Žuvėdra;"JŪROS ŽVAIGŽDUTĖS";12396055288;Taip;0;1;2;3
15743;Žuvėdra;"JŪROS ŽVAIGŽDUTĖS";88986915159;Taip;0;1;1;2
15744;Žuvėdra;"JŪROS ŽVAIGŽDUTĖS";3516571980;Taip;7;0;4;11
15745;Žuvėdra;"JŪROS ŽVAIGŽDUTĖS";69459090757;Taip;0;8;0;8
15746;Žuvėdra;"JŪROS ŽVAIGŽDUTĖS";1088862044;Taip;0;9;0;9
15747;Žuvėdra;"JŪROS ŽVAIGŽDUTĖS";62330617142;Taip;0;0;5;5
15748;Žuvėdra;"JŪROS ŽVAIGŽDUTĖS";1553949223;Taip;0;0;6;6
15749;Žuvėdra;"JŪROS ŽVAIGŽDUTĖS";83557400243;Taip;6;8;0;14
15750;Žuvėdra;"JŪROS ŽVAIGŽDUTĖS";4572580937;Taip;0;3;0;3
15751;Žuvėdra;"JŪROS ŽVAIGŽDUTĖS";83890207087;Taip;10;6;0;16
15752;Žuvėdra;DELFINUKAI;1298316563;Ne;10;8;0;18
15753;Žuvėdra;DELFINUKAI;23851864127;Taip;0;4;4;8
15754;Žuvėdra;DELFINUKAI;1634351151;Taip;0;8;1;9
15755;Žuvėdra;DELFINUKAI;8843700949;Ne;0;4;0;4
15756;Žuvėdra;DELFINUKAI;1203660127;Taip;10;4;0;14
15757;Žuvėdra;DELFINUKAI;87882215162;Taip;0;1;2;3
15758;Žuvėdra;DELFINUKAI;67652620656;Taip;2;0;1;3
15759;Žuvėdra;DELFINUKAI;9911525172;Taip;0;6;0;6
15760;Žuvėdra;DELFINUKAI;34574939898;Taip;1;12;0;13
15761;Žuvėdra;DELFINUKAI;11300891895;Taip;8;0;0;8
15762;Žuvėdra;DELFINUKAI;42069870710;Taip;5;4;4;13
15763;Žuvėdra;DELFINUKAI;19471902337;Taip;0;17;0;17
15764;Žuvėdra;DELFINUKAI;28021807339;Taip;0;7;0;7
15765;Žuvėdra;DELFINUKAI;8096854841;Taip;0;20;0;20
15766;Žuvėdra;DELFINUKAI;3148638780;Taip;14;1;0;15
15767;Žuvėdra;DELFINUKAI;17110908746;Taip;0;14;0;14
15768;Žuvėdra;DELFINUKAI;3943563359;Taip;15;0;0;15
15769;Žuvėdra;DELFINUKAI;41258849574;Taip;12;0;0;12
15770;Žuvėdra;DELFINUKAI;5472830961;Ne;14;0;0;14
15771;Žuvėdra;DELFINUKAI;1147279898;Taip;0;11;0;11
15772;Žuvėdra;DELFINUKAI;2334342995;Taip;9;0;0;9
15773;Žuvėdra;DELFINUKAI;5558584030;Taip;11;0;2;13
15774;Žuvėdra;DELFINUKAI;5049101816;Taip;9;6;0;15
15775;Žuvėdra;OSMINOŽKI;3069966490;Taip;5;1;5;11
15776;Žuvėdra;OSMINOŽKI;27467834587;Taip;12;0;3;15
15777;Žuvėdra;OSMINOŽKI;65157356661;Taip;8;5;0;13
15778;Žuvėdra;OSMINOŽKI;47125994363;Taip;7;3;0;10
15779;Žuvėdra;OSMINOŽKI;21905924984;Taip;0;5;0;5
15780;Žuvėdra;OSMINOŽKI;82141291604;Taip;6;0;0;6
15781;Žuvėdra;OSMINOŽKI;64732685802;Taip;5;5;3;13
15782;Žuvėdra;OSMINOŽKI;1434244321;Taip;0;1;4;5
15783;Žuvėdra;OSMINOŽKI;960934150;Taip;7;5;0;12
15784;Žuvėdra;OSMINOŽKI;51868435508;Taip;6;0;0;6
15785;Žuvėdra;OSMINOŽKI;1762760384;Taip;5;0;4;9
15786;Žuvėdra;OSMINOŽKI;1963584073;Taip;0;10;0;10
15787;Žuvėdra;OSMINOŽKI;2136463079;Taip;12;0;0;12
15788;Žuvėdra;OSMINOŽKI;74446494235;Taip;10;5;0;15
15789;Žuvėdra;OSMINOŽKI;41564122720;Taip;6;0;0;6
15790;Žuvėdra;OSMINOŽKI;1639340750;Taip;9;0;0;9
15791;Žuvėdra;OSMINOŽKI;3487938908;Taip;0;1;0;1
15792;Žuvėdra;OSMINOŽKI;66236924555;Taip;0;3;0;3
15793;Žuvėdra;OSMINOŽKI;66973380124;Taip;9;1;1;11
15794;Žuvėdra;OSMINOŽKI;3862711062;Ne;9;3;0;12
15795;Žuvėdra;OSMINOŽKI;8134671188;Taip;0;0;8;8
15796;Žuvėdra;OSMINOŽKI;4588593273;Taip;13;0;1;14
15797;Žuvėdra;OSMINOŽKI;55687216943;Taip;10;4;0;14
15798;Žuvėdra;OSMINOŽKI;1236696072;Taip;8;4;0;12
15799;Žuvėdra;RUSALAČKA;24915726868;Taip;12;0;1;13
15800;Žuvėdra;RUSALAČKA;1116645502;Taip;5;3;0;8
15801;Žuvėdra;RUSALAČKA;1195732987;Taip;0;14;0;14
15802;Žuvėdra;RUSALAČKA;1312918359;Taip;0;2;0;2
15803;Žuvėdra;RUSALAČKA;1923452638;Taip;0;4;0;4
15804;Žuvėdra;RUSALAČKA;6468506668;Ne;7;1;0;8
15805;Žuvėdra;RUSALAČKA;8408371550;Taip;10;0;0;10
15806;Žuvėdra;RUSALAČKA;2731016281;Taip;5;6;0;11
15807;Žuvėdra;RUSALAČKA;1164464390;Taip;6;6;0;12
15808;Žuvėdra;RUSALAČKA;1340241206;Taip;6;0;0;6
15809;Žuvėdra;RUSALAČKA;5021263583;Taip;13;5;0;18
15810;Žuvėdra;RUSALAČKA;5489757084;Taip;0;2;0;2
15811;Žuvėdra;RUSALAČKA;14760907606;Taip;10;0;1;11
15812;Žuvėdra;RUSALAČKA;1632308084;Taip;2;1;0;3
15813;Žuvėdra;RUSALAČKA;4011849839;Taip;3;6;0;9
15814;Žuvėdra;RUSALAČKA;75901332720;Taip;4;3;0;7
15815;Žuvėdra;RUSALAČKA;5684848140;Taip;14;5;0;19
15816;Žuvėdra;RUSALAČKA;5496071972;Taip;12;0;0;12
15817;Žuvėdra;RUSALAČKA;6612880861;Taip;0;1;0;1
15818;Žuvėdra;RUSALAČKA;1941428466;Taip;8;0;0;8
15819;Žuvėdra;RUSALAČKA;6007871092;Taip;8;0;0;8
15820;Žuvėdra;RUSALAČKA;63053155507;Taip;10;1;0;11
15821;Žuvėdra;JANTARIKI;5674529681;Taip;0;5;0;5
15822;Žuvėdra;JANTARIKI;1509519996;Taip;0;20;0;20
15823;Žuvėdra;JANTARIKI;6537464526;Taip;0;20;0;20
15824;Žuvėdra;JANTARIKI;9870595577;Taip;8;0;0;8
15825;Žuvėdra;JANTARIKI;6294045755;Taip;4;0;0;4
15826;Žuvėdra;JANTARIKI;7710853637;Taip;4;0;0;4
15827;Žuvėdra;JANTARIKI;7630057671;Taip;5;0;0;5
15828;Žuvėdra;JANTARIKI;7368183516;Taip;0;20;0;20
15829;Žuvėdra;JANTARIKI;3068069755;Taip;11;1;0;12
15830;Žuvėdra;JANTARIKI;5151984122;Taip;0;11;0;11
15831;Žuvėdra;JANTARIKI;3185158741;Taip;6;0;0;6
15832;Žuvėdra;JANTARIKI;1200084485;Taip;5;3;1;9
15833;Žuvėdra;JANTARIKI;2694424532;Taip;20;0;0;20
15834;Žuvėdra;JANTARIKI;5198825127;Taip;20;0;0;20
15835;Žuvėdra;JANTARIKI;4177319374;Taip;0;0;2;2
15836;Žuvėdra;"AUKSINĖ ŽUVELĖ";6547167325;Taip;3;0;0;3
15837;Žuvėdra;"AUKSINĖ ŽUVELĖ";8434697374;Taip;3;9;0;12
15838;Žuvėdra;"AUKSINĖ ŽUVELĖ";5157814568;Taip;0;10;0;10
15839;Žuvėdra;"AUKSINĖ ŽUVELĖ";7916717208;Taip;7;8;0;15
15840;Žuvėdra;"AUKSINĖ ŽUVELĖ";4497938258;Taip;5;1;0;6
15841;Žuvėdra;"AUKSINĖ ŽUVELĖ";2092890028;Taip;0;7;0;7
15842;Žuvėdra;"AUKSINĖ ŽUVELĖ";1311162040;Taip;0;5;0;5
15843;Žuvėdra;"AUKSINĖ ŽUVELĖ";3853045274;Taip;0;4;0;4
15844;Žuvėdra;"AUKSINĖ ŽUVELĖ";4864834075;Taip;0;1;0;1
15845;Žuvėdra;"AUKSINĖ ŽUVELĖ";5764128482;Taip;16;0;1;17
15846;Žuvėdra;"AUKSINĖ ŽUVELĖ";9593426121;Taip;0;6;0;6
15847;Žuvėdra;"AUKSINĖ ŽUVELĖ";2019806688;Taip;0;6;0;6
15848;Žuvėdra;"AUKSINĖ ŽUVELĖ";6602037942;Taip;20;0;0;20
15849;Žuvėdra;"AUKSINĖ ŽUVELĖ";3464935314;Taip;6;3;0;9
15850;Žvangutis;PELIUKŲ;1265027238;Taip;10;0;0;10
15851;Žvangutis;PELIUKŲ;6701947168;Taip;0;1;0;1
15852;Žvangutis;PELIUKŲ;6068428687;Taip;7;4;0;11
15853;Žvangutis;PELIUKŲ;50889154641;Taip;12;0;1;13
15854;Žvangutis;PELIUKŲ;1339151674;Taip;4;0;0;4
15855;Žvangutis;PELIUKŲ;1310113034;Taip;0;0;4;4
15856;Žvangutis;PELIUKŲ;7202747419;Taip;9;0;2;11
15857;Žvangutis;PELIUKŲ;9149037184;Taip;0;15;0;15
15858;Žvangutis;PELIUKŲ;3665275100;Taip;10;0;1;11
15859;Žvangutis;PELIUKŲ;7320625500;Taip;0;4;0;4
15860;Žvangutis;PELIUKŲ;3513746926;Taip;13;0;4;17
15861;Žvangutis;PELIUKŲ;4053450010;Taip;5;0;4;9
15862;Žvangutis;PELIUKŲ;9408369641;Taip;5;0;7;12
15863;Žvangutis;PELIUKŲ;6110958520;Taip;11;0;1;12
15864;Žvangutis;PELIUKŲ;5012996199;Taip;13;0;0;13
15865;Žvangutis;PELIUKŲ;8288997508;Taip;0;13;0;13
15866;Žvangutis;PELIUKŲ;3817258555;Taip;6;0;0;6
15867;Žvangutis;PELIUKŲ;6844824726;Taip;0;16;0;16
15868;Žvangutis;PELIUKŲ;3315858185;Taip;19;0;0;19
15869;Žvangutis;PELIUKŲ;92356998180;Taip;11;0;2;13
15870;Žvangutis;PELIUKŲ;6815104137;Taip;8;0;0;8
15871;Žvangutis;PELIUKŲ;5683601025;Taip;0;11;0;11
15872;Žvangutis;PELIUKŲ;8617941954;Taip;0;11;0;11
15873;Žvangutis;ANČIUKŲ;63793471104;Taip;0;2;0;2
15874;Žvangutis;ANČIUKŲ;10323604113;Taip;0;9;0;9
15875;Žvangutis;ANČIUKŲ;26860427962;Taip;0;14;0;14
15876;Žvangutis;ANČIUKŲ;4211541351;Taip;0;1;0;1
15877;Žvangutis;ANČIUKŲ;3753209769;Taip;20;0;0;20
15878;Žvangutis;ANČIUKŲ;5959638828;Ne;0;7;0;7
15879;Žvangutis;ANČIUKŲ;1008391034;Taip;5;1;0;6
15880;Žvangutis;ANČIUKŲ;1648977542;Taip;0;5;0;5
15881;Žvangutis;ANČIUKŲ;59628443049;Taip;0;12;0;12
15882;Žvangutis;ANČIUKŲ;72773865306;Taip;0;9;0;9
15883;Žvangutis;ANČIUKŲ;48094219446;Taip;0;9;0;9
15884;Žvangutis;ANČIUKŲ;36450810822;Taip;0;2;1;3
15885;Žvangutis;ANČIUKŲ;40512304884;Taip;0;7;0;7
15886;Žvangutis;ANČIUKŲ;44414276315;Taip;0;17;0;17
15887;Žvangutis;ANČIUKŲ;607103192;Ne;0;1;0;1
15888;Žvangutis;ANČIUKŲ;78462097679;Taip;0;2;0;2
15889;Žvangutis;ANČIUKŲ;77005496286;Taip;7;3;0;10
15890;Žvangutis;ANČIUKŲ;90542583948;Taip;5;1;0;6
15891;Žvangutis;ANČIUKŲ;40872355721;Taip;0;1;0;1
15892;Žvangutis;ANČIUKŲ;29578115987;Taip;0;6;0;6
15893;Žvangutis;ANČIUKŲ;7611207661;Taip;6;4;0;10
15894;Žvangutis;ANČIUKŲ;1416765181;Taip;18;0;0;18
15895;Žvangutis;ANČIUKŲ;1719611510;Taip;5;0;0;5
15896;Žvangutis;ANČIUKŲ;1647547244;Taip;0;10;1;11
15897;Žvangutis;PELĖDŽIUKŲ;95130491335;Taip;14;0;0;14
15898;Žvangutis;PELĖDŽIUKŲ;16003414040;Taip;0;0;13;13
15899;Žvangutis;PELĖDŽIUKŲ;93175189832;Taip;4;3;4;11
15900;Žvangutis;PELĖDŽIUKŲ;1353686877;Taip;0;0;7;7
15901;Žvangutis;PELĖDŽIUKŲ;98607926663;Taip;8;1;0;9
15902;Žvangutis;PELĖDŽIUKŲ;9618217868;Taip;0;7;1;8
15903;Žvangutis;PELĖDŽIUKŲ;91140904183;Taip;12;0;0;12
15904;Žvangutis;PELĖDŽIUKŲ;30697407645;Ne;20;0;0;20
15905;Žvangutis;PELĖDŽIUKŲ;86145834840;Taip;5;9;0;14
15906;Žvangutis;PELĖDŽIUKŲ;93894162596;Taip;19;0;0;19
15907;Žvangutis;PELĖDŽIUKŲ;38451136109;Taip;18;0;0;18
15908;Žvangutis;PELĖDŽIUKŲ;39364323060;Taip;0;17;0;17
15909;Žvangutis;PELĖDŽIUKŲ;57033172828;Taip;7;7;3;17
15910;Žvangutis;PELĖDŽIUKŲ;80054829676;Taip;14;0;5;19
15911;Žvangutis;PELĖDŽIUKŲ;11053503331;Taip;10;0;0;10
15912;Žvangutis;PELĖDŽIUKŲ;96992002828;Taip;0;6;0;6
15913;Žvangutis;PELĖDŽIUKŲ;41703990445;Taip;14;1;0;15
15914;Žvangutis;PELĖDŽIUKŲ;5929099485;Taip;0;11;0;11
15915;Žvangutis;PELĖDŽIUKŲ;77044982999;Taip;0;0;13;13
15916;Žvangutis;PELĖDŽIUKŲ;46410307693;Taip;3;2;1;6
15917;Žvangutis;PELĖDŽIUKŲ;18751626988;Taip;12;0;0;12
15918;Žvangutis;PELĖDŽIUKŲ;3049348955;Taip;0;0;2;2
15919;Žvangutis;PELĖDŽIUKŲ;5616640228;Taip;0;1;0;1
15920;Žvangutis;PELĖDŽIUKŲ;1898484868;Taip;6;5;0;11
15921;Žvangutis;PELĖDŽIUKŲ;77459956838;Taip;0;16;0;16
15922;Žvangutis;PELĖDŽIUKŲ;46159057420;Taip;0;6;2;8
15923;Žvangutis;PELĖDŽIUKŲ;12457255518;Taip;7;2;0;9
15924;Žvangutis;KAČIUKŲ;2291142377;Taip;0;1;0;1
15925;Žvangutis;KAČIUKŲ;1882797491;Taip;0;4;0;4
15926;Žvangutis;KAČIUKŲ;65598561926;Taip;14;0;0;14
15927;Žvangutis;KAČIUKŲ;87842631698;Taip;5;0;0;5
15928;Žvangutis;KAČIUKŲ;52676408047;Taip;12;0;1;13
15929;Žvangutis;KAČIUKŲ;1845521463;Taip;8;5;1;14
15930;Žvangutis;KAČIUKŲ;52544167449;Taip;0;2;0;2
15931;Žvangutis;KAČIUKŲ;8697156717;Taip;10;2;0;12
15932;Žvangutis;KAČIUKŲ;23369081648;Taip;0;14;0;14
15933;Žvangutis;KAČIUKŲ;6989839997;Taip;13;0;0;13
15934;Žvangutis;KAČIUKŲ;1065463278;Ne;0;1;0;1
15935;Žvangutis;KAČIUKŲ;1369424754;Taip;0;14;0;14
15936;Žvangutis;KAČIUKŲ;1823402065;Taip;5;1;0;6
15937;Žvangutis;KAČIUKŲ;6343552093;Taip;0;15;0;15
15938;Žvangutis;KAČIUKŲ;2145325174;Taip;6;4;0;10
15939;Žvangutis;KAČIUKŲ;7267340112;Taip;10;4;0;14
15940;Žvangutis;KAČIUKŲ;2251482949;Taip;0;10;0;10
15941;Žvangutis;KAČIUKŲ;45857502483;Taip;20;0;0;20
15942;Žvangutis;KAČIUKŲ;1642007971;Taip;0;18;0;18
15943;Žvangutis;KAČIUKŲ;4699447138;Taip;5;2;0;7
15944;Žvangutis;KAČIUKŲ;1862121693;Taip;10;6;0;16
15945;Žvangutis;KAČIUKŲ;9145365865;Taip;3;9;0;12
15946;Žvangutis;KAČIUKŲ;619059820;Taip;0;4;1;5
15947;Žvangutis;MEŠKUČIŲ;2755838558;Taip;0;5;0;5
15948;Žvangutis;MEŠKUČIŲ;2411307963;Taip;14;0;0;14
15949;Žvangutis;MEŠKUČIŲ;7581320158;Taip;0;7;0;7
15950;Žvangutis;MEŠKUČIŲ;1322688456;Taip;5;1;0;6
15951;Žvangutis;MEŠKUČIŲ;9468660351;Taip;8;5;0;13
15952;Žvangutis;MEŠKUČIŲ;1185135525;Taip;0;6;0;6
15953;Žvangutis;MEŠKUČIŲ;2600596320;Taip;6;1;0;7
15954;Žvangutis;MEŠKUČIŲ;7721746116;Taip;7;1;0;8
15955;Žvangutis;MEŠKUČIŲ;2623107843;Taip;5;2;0;7
15956;Žvangutis;MEŠKUČIŲ;2598842770;Taip;9;6;0;15
15957;Žvangutis;MEŠKUČIŲ;2570379643;Taip;5;14;0;19
15958;Žvangutis;MEŠKUČIŲ;9036869235;Taip;0;19;0;19
15959;Žvangutis;MEŠKUČIŲ;2922083476;Taip;9;0;0;9
15960;Žvangutis;MEŠKUČIŲ;7483570779;Taip;3;6;0;9
15961;Žvangutis;MEŠKUČIŲ;1282567366;Taip;3;2;0;5
15962;Žvangutis;KIŠKUČIŲ;1687362077;Taip;0;4;0;4
15963;Žvangutis;KIŠKUČIŲ;1886637245;Taip;12;0;0;12
15964;Žvangutis;KIŠKUČIŲ;96443240617;Taip;0;7;0;7
15965;Žvangutis;KIŠKUČIŲ;4249416168;Taip;10;10;0;20
15966;Žvangutis;KIŠKUČIŲ;1615111824;Taip;0;0;1;1
15967;Žvangutis;KIŠKUČIŲ;1096499939;Taip;0;7;0;7
15968;Žvangutis;KIŠKUČIŲ;1481786579;Taip;9;0;0;9
15969;Žvangutis;KIŠKUČIŲ;1334567751;Taip;0;16;0;16
15970;Žvangutis;KIŠKUČIŲ;2138652487;Taip;20;0;0;20
15971;Žvangutis;KIŠKUČIŲ;1693249341;Taip;0;7;0;7
15972;Žvangutis;KIŠKUČIŲ;4798540560;Taip;0;2;0;2
15973;Žvangutis;KIŠKUČIŲ;1847928083;Taip;0;14;0;14
15974;Žvangutis;KIŠKUČIŲ;1665136168;Taip;14;0;0;14
15975;Žvangutis;KIŠKUČIŲ;1251015310;Taip;1;4;0;5
15976;Žvangutis;KIŠKUČIŲ;5563516622;Taip;0;6;0;6
15977;Žvangutis;KIŠKUČIŲ;74528704135;Taip;0;7;0;7
15978;Žvangutis;KIŠKUČIŲ;57385778197;Taip;14;0;4;18
15979;Žvangutis;KIŠKUČIŲ;3775960571;Taip;14;0;0;14
15980;Žvangutis;KIŠKUČIŲ;11567978993;Taip;14;0;0;14
15981;Žvangutis;KIŠKUČIŲ;79808715852;Taip;0;20;0;20
15982;Žvangutis;KIŠKUČIŲ;9134683276;Taip;0;13;0;13
15983;Žirniukas;Boružiukų;38558266443;Taip;0;2;0;2
15984;Žirniukas;Boružiukų;85078595504;Ne;5;4;0;9
15985;Žirniukas;Boružiukų;87149595988;Taip;5;6;0;11
15986;Žirniukas;Boružiukų;57130875338;Taip;11;0;0;11
15987;Žirniukas;Boružiukų;63316123515;Taip;0;4;0;4
15988;Žirniukas;Boružiukų;7648905323;Taip;6;4;0;10
15989;Žirniukas;Boružiukų;25844087366;Taip;6;3;0;9
15990;Žirniukas;Boružiukų;86712175200;Taip;0;8;0;8
15991;Žirniukas;Boružiukų;68085114059;Ne;14;1;0;15
15992;Žirniukas;Boružiukų;79871296529;Taip;5;0;1;6
15993;Žirniukas;Boružiukų;74201207995;Taip;0;1;7;8
15994;Žirniukas;Boružiukų;77137353896;Taip;0;3;0;3
15995;Žirniukas;Boružiukų;5797345627;Taip;0;6;3;9
15996;Žirniukas;Boružiukų;27435013977;Taip;4;5;0;9
15997;Žirniukas;Boružiukų;93794255172;Taip;20;0;0;20
15998;Žirniukas;Boružiukų;63115775194;Taip;11;0;0;11
15999;Žirniukas;Boružiukų;97256249008;Taip;3;5;0;8
16000;Žirniukas;Boružiukų;70866622909;Taip;5;0;0;5
16001;Žirniukas;Boružiukų;35928289177;Taip;5;3;0;8
16002;Žirniukas;Boružiukų;67770044313;Taip;0;2;0;2
16003;Žirniukas;Boružiukų;52079839837;Taip;0;2;0;2
16004;Žirniukas;Boružiukų;1746748097;Taip;0;10;0;10
16005;Žirniukas;Smalsučiai;65471257240;Taip;12;0;0;12
16006;Žirniukas;Smalsučiai;99019576563;Taip;0;0;5;5
16007;Žirniukas;Smalsučiai;56948775759;Taip;10;0;0;10
16008;Žirniukas;Smalsučiai;83035751096;Taip;0;4;0;4
16009;Žirniukas;Smalsučiai;23221186484;Taip;10;0;0;10
16010;Žirniukas;Smalsučiai;43241022100;Taip;11;0;0;11
16011;Žirniukas;Smalsučiai;54285529186;Taip;1;1;0;2
16012;Žirniukas;Smalsučiai;1382313386;Taip;5;1;0;6
16013;Žirniukas;Smalsučiai;49058747304;Taip;8;2;0;10
16014;Žirniukas;Smalsučiai;6718181545;Taip;14;0;0;14
16015;Žirniukas;Smalsučiai;54685058502;Taip;19;0;0;19
16016;Žirniukas;Smalsučiai;59972903968;Taip;0;1;2;3
16017;Žirniukas;Smalsučiai;4377015113;Taip;11;0;0;11
16018;Žirniukas;Smalsučiai;37416946100;Taip;0;3;0;3
16019;Žirniukas;Smalsučiai;3723155762;Taip;0;1;1;2
16020;Žirniukas;Smalsučiai;3239212369;Taip;0;7;0;7
16021;Žirniukas;Smalsučiai;15527206706;Taip;0;1;0;1
16022;Žirniukas;Smalsučiai;83997736517;Taip;0;1;0;1
16023;Žirniukas;Smalsučiai;1150580143;Taip;3;2;3;8
16024;Žirniukas;Smalsučiai;7739943293;Taip;0;8;0;8
16025;Žirniukas;Gėlyčių;86374817570;Taip;0;2;11;13
16026;Žirniukas;Gėlyčių;51940895885;Taip;10;4;0;14
16027;Žirniukas;Gėlyčių;469740948;Taip;6;3;0;9
16028;Žirniukas;Gėlyčių;1514883654;Ne;0;17;0;17
16029;Žirniukas;Gėlyčių;3807957588;Taip;3;13;0;16
16030;Žirniukas;Gėlyčių;57834170089;Taip;0;4;0;4
16031;Žirniukas;Gėlyčių;9192660067;Taip;0;11;0;11
16032;Žirniukas;Gėlyčių;74425301830;Taip;5;6;0;11
16033;Žirniukas;Gėlyčių;3763537106;Taip;11;0;0;11
16034;Žirniukas;Gėlyčių;7809088591;Taip;10;0;0;10
16035;Žirniukas;Gėlyčių;6649555415;Taip;10;0;6;16
16036;Žirniukas;Gėlyčių;59028339197;Taip;5;0;13;18
16037;Žirniukas;Gėlyčių;32583177093;Taip;0;2;0;2
16038;Žirniukas;Gėlyčių;91259031678;Taip;7;0;0;7
16039;Žirniukas;Gėlyčių;1804181833;Taip;10;0;1;11
16040;Žirniukas;Gėlyčių;47573534391;Taip;5;1;0;6
16041;Žirniukas;Gėlyčių;1878369945;Taip;10;10;0;20
16042;Žirniukas;Gėlyčių;2072018782;Taip;6;3;0;9
16043;Žirniukas;Gėlyčių;1378845384;Taip;5;5;0;10
16044;Žirniukas;Nykštukų;4378877068;Taip;8;6;0;14
16045;Žirniukas;Nykštukų;2309995947;Taip;11;0;1;12
16046;Žirniukas;Nykštukų;1944169398;Taip;0;2;0;2
16047;Žirniukas;Nykštukų;1514504241;Taip;0;1;1;2
16048;Žirniukas;Nykštukų;1064894307;Taip;5;3;0;8
16049;Žirniukas;Nykštukų;1162904969;Taip;0;11;0;11
16050;Žirniukas;Nykštukų;2049123663;Taip;0;0;3;3
16051;Žirniukas;Nykštukų;1017483419;Taip;10;0;0;10
16052;Žirniukas;Nykštukų;6957047759;Taip;10;0;0;10
16053;Žirniukas;Nykštukų;2151329751;Taip;5;2;0;7
16054;Žirniukas;Nykštukų;5939918015;Taip;1;0;0;1
16055;Žirniukas;Nykštukų;3010062747;Taip;6;0;0;6
16056;Žirniukas;Nykštukų;2162238771;Taip;0;1;2;3
16057;Žirniukas;Nykštukų;2029018108;Taip;12;1;0;13
16058;Žirniukas;Nykštukų;5987510202;Taip;5;6;0;11
16059;Žirniukas;Nykštukų;5104110821;Taip;0;1;1;2
16060;Žirniukas;Nykštukų;5471647472;Taip;8;0;1;9
16061;Žirniukas;Nykštukų;7644911127;Taip;5;0;1;6
16062;Žirniukas;Nykštukų;6180439078;Taip;3;0;0;3
16063;Žirniukas;Nykštukų;3808838764;Taip;0;3;7;10
16064;Žirniukas;Nykštukų;7975957714;Taip;7;1;2;10
16065;Žirniukas;Saulytės;37852143615;Taip;16;0;1;17
16066;Žirniukas;Saulytės;1409567693;Taip;0;10;0;10
16067;Žirniukas;Saulytės;2022475049;Taip;15;1;0;16
16068;Žirniukas;Saulytės;32419042337;Taip;11;0;0;11
16069;Žirniukas;Saulytės;65003409430;Taip;1;2;0;3
16070;Žirniukas;Saulytės;71263500233;Taip;14;0;6;20
16071;Žirniukas;Saulytės;65898776759;Taip;5;0;0;5
16072;Žirniukas;Saulytės;51172128673;Taip;0;2;0;2
16073;Žirniukas;Saulytės;85066293475;Taip;0;0;3;3
16074;Žirniukas;Saulytės;29420916883;Taip;1;0;0;1
16075;Žirniukas;Saulytės;5189034384;Taip;16;0;0;16
16076;Žirniukas;Saulytės;68565861419;Taip;6;0;1;7
16077;Žirniukas;Saulytės;2294854901;Taip;0;9;7;16
16078;Žirniukas;Saulytės;5188013194;Taip;5;0;2;7
16079;Žirniukas;Saulytės;69810421328;Taip;10;1;1;12
16080;Žirniukas;Saulytės;66153778144;Taip;0;0;7;7
16081;Žirniukas;Saulytės;47491327916;Taip;11;0;0;11
16082;Žirniukas;Saulytės;98028824068;Taip;8;0;0;8
16083;Žirniukas;Saulytės;28992463324;Taip;5;0;2;7
16084;Žirniukas;Saulytės;60060805955;Taip;9;0;0;9
16085;Žirniukas;Saulytės;71922426195;Taip;1;5;0;6
16086;Žirniukas;Drugelių;2141162140;Taip;6;3;0;9
16087;Žirniukas;Drugelių;1294183547;Taip;4;4;0;8
16088;Žirniukas;Drugelių;2557138057;Taip;0;1;5;6
16089;Žirniukas;Drugelių;3068684150;Taip;5;0;3;8
16090;Žirniukas;Drugelių;8644938346;Taip;0;11;0;11
16091;Žirniukas;Drugelių;2867806329;Taip;0;7;0;7
16092;Žirniukas;Drugelių;8190751348;Taip;8;1;3;12
16093;Žirniukas;Drugelių;1991599271;Taip;19;0;0;19
16094;Žirniukas;Drugelių;2282495237;Taip;0;0;5;5
16095;Žirniukas;Drugelių;1961708150;Taip;0;8;0;8
16096;Žirniukas;Drugelių;1393738771;Taip;4;1;0;5
16097;Žirniukas;Drugelių;6409900451;Taip;5;0;8;13
16098;Žirniukas;Drugelių;46265018782;Taip;11;0;0;11
16099;Žirniukas;Drugelių;7190628011;Taip;5;8;0;13
16100;Žirniukas;Drugelių;5434774408;Taip;3;1;7;11
16101;Žirniukas;Drugelių;9374080010;Taip;11;0;0;11
16102;Žirniukas;Drugelių;1095501791;Taip;12;0;0;12
16103;Žirniukas;Pelėdžiukai;1163690644;Taip;8;6;0;14
16104;Žirniukas;Pelėdžiukai;1685677297;Taip;2;1;0;3
16105;Žirniukas;Pelėdžiukai;9424009308;Taip;0;1;6;7
16106;Žirniukas;Pelėdžiukai;1542257475;Taip;8;1;4;13
16107;Žirniukas;Pelėdžiukai;98781117814;Taip;0;15;2;17
16108;Žirniukas;Pelėdžiukai;1158530590;Taip;0;1;1;2
16109;Žirniukas;Pelėdžiukai;1352159915;Taip;10;0;2;12
16110;Žirniukas;Pelėdžiukai;1096649614;Taip;3;4;0;7
16111;Žirniukas;Pelėdžiukai;1699821845;Taip;6;0;0;6
16112;Žirniukas;Pelėdžiukai;52845409413;Taip;14;0;1;15
16113;Žirniukas;Pelėdžiukai;1609778506;Taip;0;0;1;1
16114;Žirniukas;Pelėdžiukai;1506642709;Taip;2;1;0;3
16115;Žirniukas;Pelėdžiukai;98441955394;Taip;4;0;1;5
16116;Žirniukas;Pelėdžiukai;4789330923;Taip;0;0;9;9
16117;Žirniukas;Pelėdžiukai;2118772211;Taip;9;0;0;9
16118;Žirniukas;Pelėdžiukai;1788183728;Taip;10;0;0;10
16119;Žirniukas;Pelėdžiukai;1607867151;Taip;10;0;2;12
16120;Žirniukas;Pelėdžiukai;1586083174;Taip;11;4;0;15
16121;Žirniukas;Pelėdžiukai;52181077421;Taip;0;1;10;11
16122;Žirniukas;Pelėdžiukai;5479153220;Taip;8;1;1;10
16123;Žirniukas;Pelėdžiukai;4842182809;Taip;18;0;0;18
16124;Žirniukas;ZUIKUČIAI;6624263476;Taip;3;0;0;3
16125;Žirniukas;ZUIKUČIAI;2785102131;Taip;10;0;0;10
16126;Žirniukas;ZUIKUČIAI;6641200341;Taip;14;0;0;14
16127;Žirniukas;ZUIKUČIAI;9647374339;Taip;2;1;0;3
16128;Žirniukas;ZUIKUČIAI;6268788036;Taip;0;3;0;3
16129;Žirniukas;ZUIKUČIAI;1867254291;Taip;0;2;5;7
16130;Žirniukas;ZUIKUČIAI;8148254025;Taip;10;0;0;10
16131;Žirniukas;ZUIKUČIAI;2348752207;Taip;0;0;20;20
16132;Žirniukas;ZUIKUČIAI;7872611724;Taip;12;1;0;13
16133;Žirniukas;ZUIKUČIAI;2636634198;Taip;0;0;10;10
16134;Žirniukas;ZUIKUČIAI;6531175340;Taip;6;1;1;8
16135;Žirniukas;ZUIKUČIAI;8213507698;Taip;12;0;0;12
16136;Žirniukas;ZUIKUČIAI;2528905738;Taip;15;1;0;16
16137;Žirniukas;ZUIKUČIAI;6363169823;Taip;10;0;0;10
16138;Žirniukas;ZUIKUČIAI;5058103759;Taip;6;7;1;14
16139;Žirniukas;ZUIKUČIAI;3610402086;Taip;10;0;0;10
16140;Aušra;Kodėlčiukai;70233681803;Taip;0;1;0;1
16141;Aušra;Kodėlčiukai;40714551025;Taip;0;8;0;8
16142;Aušra;Kodėlčiukai;40499781883;Taip;0;7;2;9
16143;Aušra;Kodėlčiukai;27091243109;Taip;0;3;0;3
16144;Aušra;Kodėlčiukai;9605206310;Taip;0;1;0;1
16145;Aušra;Kodėlčiukai;19504477542;Taip;0;3;2;5
16146;Aušra;Kodėlčiukai;37104403122;Taip;5;3;0;8
16147;Aušra;Kodėlčiukai;88655846176;Taip;7;2;2;11
16148;Aušra;Kodėlčiukai;13157844661;Taip;0;6;0;6
16149;Aušra;Kodėlčiukai;22032396703;Taip;0;3;0;3
16150;Aušra;Kodėlčiukai;43666690361;Taip;10;4;0;14
16151;Aušra;Kodėlčiukai;97781409787;Ne;7;2;0;9
16152;Aušra;Kodėlčiukai;68160889669;Taip;0;6;0;6
16153;Aušra;Kodėlčiukai;69081281749;Taip;4;9;0;13
16154;Aušra;Kodėlčiukai;8510995681;Taip;0;0;2;2
16155;Aušra;Kodėlčiukai;18987709566;Taip;0;11;0;11
16156;Aušra;Kodėlčiukai;10347002342;Taip;0;11;0;11
16157;Aušra;Kodėlčiukai;8913242414;Taip;2;0;0;2
16158;Aušra;Kodėlčiukai;73509864636;Ne;0;1;0;1
16159;Aušra;Kodėlčiukai;52958921337;Taip;5;2;0;7
16160;Aušra;Kodėlčiukai;3284383302;Taip;0;2;0;2
16161;Aušra;Pelėdžiukai;8686777160;Taip;12;2;0;14
16162;Aušra;Pelėdžiukai;15657824495;Taip;9;8;0;17
16163;Aušra;Pelėdžiukai;1385844067;Taip;0;6;0;6
16164;Aušra;Pelėdžiukai;35429495907;Taip;5;3;2;10
16165;Aušra;Pelėdžiukai;79051821501;Taip;8;0;0;8
16166;Aušra;Pelėdžiukai;3001784066;Taip;0;7;0;7
16167;Aušra;Pelėdžiukai;21234588466;Taip;0;3;0;3
16168;Aušra;Pelėdžiukai;23609052737;Taip;8;8;0;16
16169;Aušra;Pelėdžiukai;3823619675;Taip;13;6;0;19
16170;Aušra;Pelėdžiukai;41017803426;Taip;4;0;1;5
16171;Aušra;Pelėdžiukai;58254707316;Taip;0;1;0;1
16172;Aušra;Pelėdžiukai;18943927144;Taip;20;0;0;20
16173;Aušra;Pelėdžiukai;1623803107;Taip;1;2;0;3
16174;Aušra;Pelėdžiukai;2121418946;Taip;11;0;0;11
16175;Aušra;Pelėdžiukai;5409157554;Taip;0;0;1;1
16176;Aušra;Pelėdžiukai;2227238810;Taip;8;1;0;9
16177;Aušra;Pelėdžiukai;2000206874;Taip;5;0;4;9
16178;Aušra;Pelėdžiukai;4325224130;Taip;0;0;4;4
16179;Aušra;Pelėdžiukai;59267104215;Taip;0;6;0;6
16180;Aušra;Smalsučiai;1049364899;Taip;5;1;0;6
16181;Aušra;Smalsučiai;95327350432;Taip;0;9;0;9
16182;Aušra;Smalsučiai;1154675251;Taip;0;6;1;7
16183;Aušra;Smalsučiai;1473962346;Taip;5;1;0;6
16184;Aušra;Smalsučiai;1427235223;Taip;6;0;1;7
16185;Aušra;Smalsučiai;2128822237;Taip;0;6;0;6
16186;Aušra;Smalsučiai;1767520195;Taip;0;1;0;1
16187;Aušra;Smalsučiai;76979979920;Taip;9;0;0;9
16188;Aušra;Smalsučiai;97571593143;Taip;0;7;0;7
16189;Aušra;Smalsučiai;59235411329;Taip;7;5;1;13
16190;Aušra;Smalsučiai;42344686036;Taip;0;6;0;6
16191;Aušra;Smalsučiai;62209740677;Taip;0;0;2;2
16192;Aušra;Smalsučiai;2019580127;Taip;10;5;0;15
16193;Aušra;Smalsučiai;95586246863;Taip;3;0;4;7
16194;Aušra;Smalsučiai;1095212350;Taip;0;0;3;3
16195;Aušra;Smalsučiai;66203768924;Taip;0;10;0;10
16196;Aušra;Smalsučiai;7962184651;Taip;0;2;0;2
16197;Aušra;Smalsučiai;12689030409;Taip;12;0;0;12
16198;Aušra;Smalsučiai;98150444770;Taip;7;0;0;7
16199;Aušra;Smalsučiai;1167565535;Taip;0;14;0;14
16200;Aušra;Smalsučiai;52044254281;Taip;6;0;4;10
16201;Aušra;Smalsučiai;1831747749;Taip;9;1;0;10
16202;Aušra;Smalsučiai;5447986535;Taip;0;7;0;7
16203;Aušra;Smalsučiai;4645855409;Taip;9;8;0;17
16204;Aušra;Pagrandukai;7043021721;Taip;10;7;0;17
16205;Aušra;Pagrandukai;2023718424;Taip;0;1;3;4
16206;Aušra;Pagrandukai;8709340592;Taip;10;1;9;20
16207;Aušra;Pagrandukai;5524681006;Taip;7;4;9;20
16208;Aušra;Pagrandukai;4404047456;Taip;9;0;0;9
16209;Aušra;Pagrandukai;3680329197;Taip;14;2;0;16
16210;Aušra;Pagrandukai;2288159223;Taip;20;0;0;20
16211;Aušra;Pagrandukai;4805298824;Taip;7;0;0;7
16212;Aušra;Pagrandukai;29499576216;Taip;0;3;0;3
16213;Aušra;Pagrandukai;1940882109;Taip;0;2;3;5
16214;Aušra;Pagrandukai;7814902928;Taip;15;0;1;16
16215;Aušra;Pagrandukai;9702136789;Taip;0;10;0;10
16216;Aušra;Pagrandukai;6384243597;Taip;0;8;0;8
16217;Aušra;Pagrandukai;1612662076;Taip;0;5;0;5
16218;Aušra;Pagrandukai;3898178166;Taip;6;0;0;6
16219;Aušra;Pagrandukai;4352174590;Taip;6;0;5;11
16220;Aušra;Pagrandukai;1575761029;Taip;5;4;0;9
16221;Aušra;Pagrandukai;5673568541;Taip;8;0;0;8
16222;Aušra;Pagrandukai;1717797530;Taip;10;0;10;20
16223;Aušra;Pagrandukai;97102749430;Taip;0;1;3;4
16224;Aušra;Pagrandukai;5777939563;Taip;11;0;0;11
16225;Aušra;Pagrandukai;8740755922;Taip;5;3;4;12
16226;Aušra;"1A klasė";81428848455;Taip;4;6;0;10
16227;Aušra;"1A klasė";52864653926;Taip;3;6;0;9
16228;Aušra;"1A klasė";5166358753;Taip;2;6;0;8
16229;Aušra;"1A klasė";78030425432;Taip;5;6;0;11
16230;Aušra;"1A klasė";77425098448;Taip;1;6;0;7
16231;Aušra;"1A klasė";13361663464;Taip;1;6;0;7
16232;Aušra;"1A klasė";21856009403;Taip;0;6;0;6
16233;Aušra;"1A klasė";93365393803;Taip;2;6;0;8
16234;Aušra;"1A klasė";44870195034;Taip;1;6;0;7
16235;Aušra;"1A klasė";10272136932;Taip;0;6;0;6
16236;Aušra;"1A klasė";29636399665;Taip;3;6;0;9
16237;Aušra;"1A klasė";42015974556;Taip;1;6;0;7
16238;Aušra;"1A klasė";19718806057;Taip;0;6;0;6
16239;Aušra;"1A klasė";19920237804;Taip;6;6;0;12
16240;Aušra;"1A klasė";2113586354;Taip;1;6;0;7
16241;Aušra;"1A klasė";70687041413;Taip;1;6;0;7
16242;Aušra;"1A klasė";47725613978;Taip;2;6;0;8
16243;Aušra;"1A klasė";94704151051;Taip;0;6;0;6
16244;Aušra;"1A klasė";20550256232;Taip;0;6;0;6
16245;Aušra;"1B klasė";35703433862;Taip;0;6;0;6
16246;Aušra;"1B klasė";41039525379;Taip;0;6;0;6
16247;Aušra;"1B klasė";59107169775;Taip;0;6;0;6
16248;Aušra;"1B klasė";41852924528;Taip;0;6;0;6
16249;Aušra;"1B klasė";58526614808;Taip;0;6;0;6
16250;Aušra;"1B klasė";64562667133;Taip;0;6;0;6
16251;Aušra;"1B klasė";36899257479;Ne;0;6;0;6
16252;Aušra;"1B klasė";95076478544;Ne;0;6;0;6
16253;Aušra;"1B klasė";83119050626;Taip;0;6;0;6
16254;Aušra;"1B klasė";52332096506;Taip;0;6;0;6
16255;Aušra;"1B klasė";45165946624;Taip;0;6;0;6
16256;Aušra;"1B klasė";22923377435;Taip;3;6;0;9
16257;Aušra;"1B klasė";71596384638;Taip;3;6;0;9
16258;Aušra;"1B klasė";36889923728;Taip;0;6;0;6
16259;Aušra;"1B klasė";48349819906;Ne;0;6;0;6
16260;Aušra;"1B klasė";1815771421;Taip;2;6;0;8
16261;Aušra;"1B klasė";92119607174;Taip;1;6;0;7
16262;Aušra;"1B klasė";37339481276;Taip;1;6;0;7
16263;Aušra;"1B klasė";8901585006;Taip;4;6;0;10
16264;Aušra;"1B klasė";52909474598;Ne;2;6;0;8
16265;Aušra;"2A klasė";8497743711;Ne;1;6;0;7
16266;Aušra;"2A klasė";9510786725;Ne;2;6;0;8
16267;Aušra;"2A klasė";5770340819;Ne;1;6;0;7
16268;Aušra;"2A klasė";5792862565;Ne;7;6;0;13
16269;Aušra;"2A klasė";8892613555;Ne;0;6;0;6
16270;Aušra;"2A klasė";7931858964;Ne;2;6;0;8
16271;Aušra;"2A klasė";4399210916;Ne;1;6;0;7
16272;Aušra;"2A klasė";1585279799;Ne;0;6;0;6
16273;Aušra;"2A klasė";2796012982;Ne;0;6;0;6
16274;Aušra;"2A klasė";9584232864;Ne;3;6;0;9
16275;Aušra;"2A klasė";7113793626;Ne;0;6;0;6
16276;Aušra;"2A klasė";2908360090;Ne;0;6;0;6
16277;Aušra;"2A klasė";5825720308;Ne;0;6;0;6
16278;Aušra;"2A klasė";8367064629;Ne;0;6;0;6
16279;Aušra;"2A klasė";8632721907;Ne;0;6;0;6
16280;Aušra;"2A klasė";3435983733;Ne;0;6;0;6
16281;Aušra;"2A klasė";7313001921;Ne;1;6;0;7
16282;Aušra;"2A klasė";6942076490;Ne;0;6;0;6
16283;Aušra;"2A klasė";6534693192;Ne;6;6;0;12
16284;Aušra;"2A klasė";7439801986;Ne;0;6;0;6
16285;Aušra;"2A klasė";4952796453;Ne;4;6;0;10
16286;Aušra;"2A klasė";1404310604;Ne;0;6;0;6
16287;Aušra;"2A klasė";2280410145;Ne;0;6;0;6
16288;Aušra;"2A klasė";75839555732;Taip;5;6;0;11
16289;Aušra;"3A klasė";2863356239;Ne;0;6;0;6
16290;Aušra;"3A klasė";6540515450;Ne;0;6;0;6
16291;Aušra;"3A klasė";6232778631;Ne;5;6;0;11
16292;Aušra;"3A klasė";3115696927;Ne;0;6;0;6
16293;Aušra;"3A klasė";8543429220;Ne;5;6;0;11
16294;Aušra;"3A klasė";1685764132;Ne;0;6;0;6
16295;Aušra;"3A klasė";5340257141;Ne;0;6;0;6
16296;Aušra;"3A klasė";4341245904;Ne;0;6;0;6
16297;Aušra;"3A klasė";9430084940;Ne;5;6;0;11
16298;Aušra;"3A klasė";2942755846;Ne;4;6;0;10
16299;Aušra;"3A klasė";3749854924;Ne;1;6;0;7
16300;Aušra;"3A klasė";2951199272;Ne;0;6;0;6
16301;Aušra;"3A klasė";2072790876;Ne;0;6;0;6
16302;Aušra;"3A klasė";1414034080;Ne;6;6;0;12
16303;Aušra;"3A klasė";8550981774;Ne;0;6;0;6
16304;Aušra;"3A klasė";4257487788;Ne;0;6;0;6
16305;Aušra;"3A klasė";9332506542;Ne;2;6;0;8
16306;Aušra;"3A klasė";7499852390;Ne;6;6;0;12
16307;Aušra;"3A klasė";8801106119;Ne;0;6;0;6
16308;Aušra;"3A klasė";7435902333;Ne;3;6;0;9
16309;Aušra;"3A klasė";4073898542;Ne;0;6;0;6
16310;Aušra;"4A klasė";7968234670;Ne;0;6;0;6
16311;Aušra;"4A klasė";5809362777;Ne;8;6;0;14
16312;Aušra;"4A klasė";6160171536;Ne;1;6;0;7
16313;Aušra;"4A klasė";6846696720;Ne;0;6;0;6
16314;Aušra;"4A klasė";7665944746;Ne;0;6;0;6
16315;Aušra;"4A klasė";1523223244;Ne;0;6;0;6
16316;Aušra;"4A klasė";4708591140;Ne;0;6;0;6
16317;Aušra;"4A klasė";6865621533;Ne;1;6;0;7
16318;Aušra;"4A klasė";9176277054;Ne;0;6;0;6
16319;Aušra;"4A klasė";1996371462;Ne;0;6;0;6
16320;Aušra;"4A klasė";4682402426;Ne;0;6;0;6
16321;Aušra;"4A klasė";3917149879;Ne;0;6;0;6
16322;Aušra;"4A klasė";6022331977;Ne;1;6;0;7
16323;Aušra;"4A klasė";3215515556;Ne;0;6;0;6
16324;Aušra;"2B klasė";7075053685;Ne;0;6;0;6
16325;Aušra;"2B klasė";8476695862;Ne;2;6;0;8
16326;Aušra;"2B klasė";2893668707;Ne;0;6;0;6
16327;Aušra;"2B klasė";7321317333;Ne;0;6;0;6
16328;Aušra;"2B klasė";9736905104;Ne;0;6;0;6
16329;Aušra;"2B klasė";4979458559;Ne;0;6;0;6
16330;Aušra;"2B klasė";2075587354;Ne;1;6;0;7
16331;Aušra;"2B klasė";2610054474;Ne;7;6;0;13
16332;Aušra;"2B klasė";9695887585;Ne;0;6;0;6
16333;Aušra;"2B klasė";7697924792;Ne;1;6;0;7
16334;Aušra;"2B klasė";7553225340;Ne;0;6;0;6
16335;Aušra;"2B klasė";5005513948;Ne;5;6;0;11
16336;Aušra;"2B klasė";3225989797;Ne;8;6;0;14
16337;Aušra;"2B klasė";3114317363;Ne;1;6;0;7
16338;Aušra;"2B klasė";7713995959;Ne;0;6;0;6
16339;Aušra;"2B klasė";9600565378;Ne;0;6;0;6
16340;Aušra;"2B klasė";65535488153;Taip;8;6;0;14
16341;Aušra;"2B klasė";11449775297;Taip;5;6;0;11
16342;Aušra;"2B klasė";2401823401;Ne;3;6;0;9
16343;Aušra;"2B klasė";70054065156;Taip;3;6;0;9
16344;Berželis;"BOŽJI KOROVKI";1612263252;Taip;0;3;0;3
16345;Berželis;"BOŽJI KOROVKI";59374659821;Taip;0;1;0;1
16346;Berželis;"BOŽJI KOROVKI";69799827219;Taip;0;1;0;1
16347;Berželis;"BOŽJI KOROVKI";75750848557;Ne;0;6;0;6
16348;Berželis;"BOŽJI KOROVKI";56738219250;Taip;10;2;0;12
16349;Berželis;"BOŽJI KOROVKI";56482980062;Ne;0;1;0;1
16350;Berželis;"BOŽJI KOROVKI";27150769109;Taip;0;3;0;3
16351;Berželis;"BOŽJI KOROVKI";58375151019;Taip;5;4;0;9
16352;Berželis;"BOŽJI KOROVKI";62619974918;Taip;0;0;1;1
16353;Berželis;"BOŽJI KOROVKI";88322206113;Taip;0;2;0;2
16354;Berželis;"BOŽJI KOROVKI";19460486970;Taip;5;0;0;5
16355;Berželis;"BOŽJI KOROVKI";79818178445;Taip;0;1;0;1
16356;Berželis;"BOŽJI KOROVKI";9901922166;Taip;0;2;0;2
16357;Berželis;PČIOLKI;1923453586;Taip;5;4;7;16
16358;Berželis;PČIOLKI;91965136118;Taip;2;0;1;3
16359;Berželis;PČIOLKI;83552840429;Taip;0;4;2;6
16360;Berželis;PČIOLKI;93628329777;Taip;5;4;0;9
16361;Berželis;PČIOLKI;13541556141;Taip;0;4;0;4
16362;Berželis;PČIOLKI;4330158489;Taip;5;4;2;11
16363;Berželis;PČIOLKI;95780247776;Taip;5;4;0;9
16364;Berželis;PČIOLKI;79546239108;Taip;2;2;0;4
16365;Berželis;PČIOLKI;6959738006;Taip;0;4;0;4
16366;Berželis;PČIOLKI;37637382978;Taip;2;0;0;2
16367;Berželis;PČIOLKI;41988540665;Taip;0;4;1;5
16368;Berželis;PČIOLKI;44215014337;Taip;0;2;0;2
16369;Berželis;PČIOLKI;2066819593;Taip;5;4;0;9
16370;Berželis;PČIOLKI;84379482983;Taip;10;4;0;14
16371;Berželis;PČIOLKI;37451475613;Taip;3;4;2;9
16372;Berželis;PČIOLKI;95587380846;Taip;10;4;1;15
16373;Berželis;PČIOLKI;48161697699;Taip;3;4;0;7
16374;Berželis;PČIOLKI;18002985276;Taip;5;7;0;12
16375;Berželis;PČIOLKI;1776837439;Taip;0;6;0;6
16376;Berželis;PČIOLKI;17710158252;Taip;5;4;1;10
16377;Berželis;PČIOLKI;7277445666;Taip;4;4;0;8
16378;Berželis;PČIOLKI;36854023525;Taip;5;0;0;5
16379;Berželis;PČIOLKI;7512720601;Taip;0;0;4;4
16380;Berželis;SOLNYŠKO;1740077377;Taip;5;4;0;9
16381;Berželis;SOLNYŠKO;1855559693;Taip;0;11;0;11
16382;Berželis;SOLNYŠKO;91676607875;Taip;20;0;0;20
16383;Berželis;SOLNYŠKO;1729593575;Taip;16;0;0;16
16384;Berželis;SOLNYŠKO;4605587503;Taip;0;4;0;4
16385;Berželis;SOLNYŠKO;2069597007;Taip;4;9;0;13
16386;Berželis;SOLNYŠKO;97145959022;Taip;5;8;0;13
16387;Berželis;SOLNYŠKO;5747645162;Taip;5;1;0;6
16388;Berželis;SOLNYŠKO;7334971595;Taip;5;1;0;6
16389;Berželis;SOLNYŠKO;3923999931;Ne;5;0;0;5
16390;Berželis;SOLNYŠKO;9022925550;Taip;0;11;0;11
16391;Berželis;SOLNYŠKO;68853290649;Taip;11;0;0;11
16392;Berželis;SOLNYŠKO;5332069480;Taip;13;0;0;13
16393;Berželis;SOLNYŠKO;1929783185;Taip;6;8;0;14
16394;Berželis;SOLNYŠKO;1136612100;Taip;0;14;0;14
16395;Berželis;SOLNYŠKO;7713921014;Ne;2;0;0;2
16396;Berželis;SOLNYŠKO;50400542457;Taip;0;1;0;1
16397;Berželis;BABOČKI;5371508044;Taip;12;0;0;12
16398;Berželis;BABOČKI;1076719080;Taip;10;0;0;10
16399;Berželis;BABOČKI;2016194182;Taip;6;4;0;10
16400;Berželis;BABOČKI;2030770943;Taip;5;1;0;6
16401;Berželis;BABOČKI;1750209600;Taip;10;3;0;13
16402;Berželis;BABOČKI;9839929976;Taip;5;4;0;9
16403;Berželis;BABOČKI;4100740863;Taip;0;20;0;20
16404;Berželis;BABOČKI;2667957070;Taip;0;2;2;4
16405;Berželis;BABOČKI;7781031211;Taip;0;7;0;7
16406;Berželis;BABOČKI;2493612905;Taip;15;0;0;15
16407;Berželis;BABOČKI;5688897783;Taip;6;3;0;9
16408;Berželis;BABOČKI;6942559693;Taip;0;4;2;6
16409;Berželis;BABOČKI;6352635742;Taip;2;5;0;7
16410;Berželis;BABOČKI;3097809074;Taip;14;0;0;14
16411;Berželis;BABOČKI;8448872491;Taip;14;0;0;14
16412;Berželis;BABOČKI;2954451168;Taip;0;1;0;1
16413;Berželis;BABOČKI;4312062240;Taip;9;1;0;10
16414;Berželis;SOVUŠKI;8939353460;Taip;18;0;0;18
16415;Berželis;SOVUŠKI;5879965735;Taip;9;0;4;13
16416;Berželis;SOVUŠKI;1183377037;Taip;1;0;0;1
16417;Berželis;SOVUŠKI;61614684164;Taip;5;0;2;7
16418;Berželis;SOVUŠKI;1573177287;Taip;14;0;0;14
16419;Berželis;SOVUŠKI;11671380984;Taip;0;8;0;8
16420;Berželis;SOVUŠKI;1927042277;Taip;6;1;0;7
16421;Berželis;SOVUŠKI;1566912722;Taip;6;1;0;7
16422;Berželis;SOVUŠKI;1865658456;Taip;15;0;1;16
16423;Berželis;SOVUŠKI;1061894314;Taip;5;0;0;5
16424;Berželis;SOVUŠKI;5739686368;Taip;3;0;0;3
16425;Berželis;SOVUŠKI;25985469678;Taip;15;3;0;18
16426;Berželis;SOVUŠKI;2028316867;Ne;0;11;0;11
16427;Berželis;SOVUŠKI;83253240251;Taip;14;0;0;14
16428;Berželis;SOVUŠKI;1470907829;Taip;0;0;4;4
16429;Berželis;SOVUŠKI;9134420285;Taip;3;0;0;3
16430;Berželis;SOVUŠKI;4080387580;Taip;0;2;1;3
16431;Berželis;SOVUŠKI;5337604370;Taip;3;0;0;3
16432;Berželis;SOVUŠKI;1492203156;Taip;8;2;0;10
16433;Berželis;PODSOLNUŠKI;4521372127;Taip;2;4;0;6
16434;Berželis;PODSOLNUŠKI;2214171136;Taip;0;10;0;10
16435;Berželis;PODSOLNUŠKI;97218091736;Taip;7;0;0;7
16436;Berželis;PODSOLNUŠKI;1521982237;Taip;14;0;2;16
16437;Berželis;PODSOLNUŠKI;4013215941;Taip;0;1;0;1
16438;Berželis;PODSOLNUŠKI;7526006253;Taip;3;1;0;4
16439;Berželis;PODSOLNUŠKI;64214150955;Taip;5;4;0;9
16440;Berželis;PODSOLNUŠKI;9024992452;Taip;0;1;0;1
16441;Berželis;PODSOLNUŠKI;9644196870;Taip;1;1;0;2
16442;Berželis;PODSOLNUŠKI;5084171353;Taip;14;0;0;14
16443;Berželis;PODSOLNUŠKI;6473498471;Taip;7;0;0;7
16444;Berželis;PODSOLNUŠKI;1067618571;Taip;15;0;0;15
16445;Berželis;PODSOLNUŠKI;3772780161;Taip;20;0;0;20
16446;Berželis;PODSOLNUŠKI;4563582416;Taip;20;0;0;20
16447;Berželis;PODSOLNUŠKI;7227603702;Taip;9;0;0;9
16448;Berželis;PODSOLNUŠKI;6113571093;Taip;17;0;0;17
16449;Berželis;PODSOLNUŠKI;1036370516;Taip;5;0;1;6
16450;Berželis;PODSOLNUŠKI;4284157599;Taip;14;0;0;14
16451;Berželis;PODSOLNUŠKI;2615440913;Taip;20;0;0;20
16452;Berželis;"1 klasė";93543942806;Taip;10;4;0;14
16453;Berželis;"1 klasė";68739754511;Taip;5;4;0;9
16454;Berželis;"1 klasė";5442568208;Taip;0;4;0;4
16455;Berželis;"1 klasė";9168601277;Taip;1;4;0;5
16456;Berželis;"1 klasė";2412399682;Taip;3;4;0;7
16457;Berželis;"1 klasė";34721593327;Taip;1;4;0;5
16458;Berželis;"1 klasė";40956353978;Taip;10;4;0;14
16459;Berželis;"1 klasė";12564193771;Taip;0;4;0;4
16460;Berželis;"1 klasė";3658542055;Taip;0;4;0;4
16461;Berželis;"1 klasė";945754955;Taip;10;4;0;14
16462;Berželis;"1 klasė";84043380820;Taip;0;4;0;4
16463;Berželis;"2 klasė";4263364972;Taip;0;4;0;4
16464;Berželis;"2 klasė";4381565277;Ne;1;4;0;5
16465;Berželis;"2 klasė";7489328291;Ne;4;4;0;8
16466;Berželis;"2 klasė";8888053187;Ne;0;4;0;4
16467;Berželis;"2 klasė";6442475480;Ne;0;4;0;4
16468;Berželis;"2 klasė";3576772433;Ne;0;4;0;4
16469;Berželis;"2 klasė";7835087499;Ne;0;4;0;4
16470;Berželis;"2 klasė";5004603567;Ne;4;4;0;8
16471;Berželis;"2 klasė";9657020323;Ne;0;4;0;4
16472;Berželis;"2 klasė";8433247380;Ne;0;4;0;4
16473;Berželis;"2 klasė";4941738193;Ne;5;4;0;9
16474;Berželis;"2 klasė";1448407405;Ne;0;4;0;4
16475;Berželis;"3 klasė";8102357654;Ne;1;4;0;5
16476;Berželis;"3 klasė";2501433917;Ne;0;4;0;4
16477;Berželis;"3 klasė";1161378829;Ne;1;4;0;5
16478;Berželis;"3 klasė";8322372921;Ne;0;4;0;4
16479;Berželis;"3 klasė";5856177876;Ne;5;4;0;9
16480;Berželis;"3 klasė";6702857359;Ne;2;4;0;6
16481;Berželis;"3 klasė";4245771747;Ne;2;4;0;6
16482;Berželis;"3 klasė";3149377224;Ne;0;4;0;4
16483;Berželis;"3 klasė";3064700283;Ne;0;4;0;4
16484;Berželis;"3 klasė";9998560354;Ne;0;4;0;4
16485;Berželis;"3 klasė";8143634742;Ne;0;4;0;4
16486;Berželis;"3 klasė";9486991928;Ne;0;4;0;4
16487;Berželis;"3 klasė";8921842915;Ne;0;4;0;4
16488;Berželis;"3 klasė";7728620622;Ne;2;4;0;6
16489;Berželis;"3 klasė";2691853015;Ne;3;4;0;7
16490;Berželis;"3 klasė";2955045450;Ne;0;4;0;4
16491;Berželis;"3 klasė";62987603892;Taip;0;4;0;4
16492;Berželis;"3 klasė";50930845005;Taip;1;4;0;5
16493;Berželis;"4 klasė";2332539534;Ne;0;4;0;4
16494;Berželis;"4 klasė";5637244096;Ne;11;4;0;15
16495;Berželis;"4 klasė";3565822447;Ne;6;4;0;10
16496;Berželis;"4 klasė";9635029366;Ne;5;4;0;9
16497;Berželis;"4 klasė";3773489172;Ne;0;4;0;4
16498;Berželis;"4 klasė";4354272806;Ne;2;4;0;6
16499;Berželis;"4 klasė";2827130989;Ne;0;4;0;4
16500;Berželis;"4 klasė";2155354527;Ne;2;4;0;6
16501;Berželis;"4 klasė";5467777166;Ne;2;4;0;6
16502;Berželis;"4 klasė";6588688183;Taip;0;4;0;4
16503;Saulutė;Drugeliai;66108847230;Taip;3;4;0;7
16504;Saulutė;Drugeliai;1513449225;Taip;5;1;0;6
16505;Saulutė;Drugeliai;1556270046;Taip;6;2;0;8
16506;Saulutė;Drugeliai;3064199909;Taip;10;0;2;12
16507;Saulutė;Drugeliai;2097055107;Taip;7;1;0;8
16508;Saulutė;Drugeliai;1717909005;Taip;5;4;0;9
16509;Saulutė;Drugeliai;1283800571;Taip;5;0;1;6
16510;Saulutė;Drugeliai;8599199376;Taip;19;0;0;19
16511;Saulutė;Drugeliai;1750571258;Taip;8;0;0;8
16512;Saulutė;Drugeliai;87814849917;Taip;1;1;2;4
16513;Saulutė;Drugeliai;1609952589;Taip;0;5;0;5
16514;Saulutė;Drugeliai;1386800520;Taip;9;1;3;13
16515;Saulutė;Drugeliai;1261384337;Taip;5;4;0;9
16516;Saulutė;Drugeliai;1320018338;Taip;10;0;10;20
16517;Saulutė;Drugeliai;1291318940;Taip;20;0;0;20
16518;Saulutė;Drugeliai;2162114750;Ne;0;0;19;19
16519;Saulutė;Drugeliai;9550046358;Taip;0;1;0;1
16520;Saulutė;Drugeliai;1391904744;Taip;5;1;3;9
16521;Saulutė;Drugeliai;8944601874;Taip;16;0;0;16
16522;Saulutė;Drugeliai;1421523719;Taip;5;5;0;10
16523;Saulutė;Drugeliai;67332285574;Taip;6;0;0;6
16524;Saulutė;Drugeliai;4272320685;Taip;0;5;0;5
16525;Saulutė;Drugeliai;1020606591;Taip;0;6;0;6
16526;Saulutė;"Saulės zuikučiai";8946107286;Taip;11;0;0;11
16527;Saulutė;"Saulės zuikučiai";2397257894;Taip;5;0;0;5
16528;Saulutė;"Saulės zuikučiai";1888990522;Taip;0;5;0;5
16529;Saulutė;"Saulės zuikučiai";1686338325;Taip;0;0;2;2
16530;Saulutė;"Saulės zuikučiai";2010774109;Taip;0;18;0;18
16531;Saulutė;"Saulės zuikučiai";3089541630;Taip;0;3;0;3
16532;Saulutė;"Saulės zuikučiai";5148542811;Taip;0;20;0;20
16533;Saulutė;"Saulės zuikučiai";1562393383;Taip;11;0;0;11
16534;Saulutė;"Saulės zuikučiai";9269501176;Taip;0;20;0;20
16535;Saulutė;"Saulės zuikučiai";9521155670;Taip;0;0;1;1
16536;Saulutė;"Saulės zuikučiai";2259917151;Taip;14;0;0;14
16537;Saulutė;"Saulės zuikučiai";3691381351;Taip;14;0;0;14
16538;Saulutė;"Saulės zuikučiai";3749374270;Taip;0;1;1;2
16539;Saulutė;"Saulės zuikučiai";9146298505;Taip;0;1;0;1
16540;Saulutė;"Saulės zuikučiai";6754944061;Taip;5;10;1;16
16541;Saulutė;"Saulės zuikučiai";8242602551;Taip;3;0;2;5
16542;Saulutė;"Saulės zuikučiai";1324799653;Taip;6;6;0;12
16543;Saulutė;"Saulės zuikučiai";5247769309;Taip;10;1;0;11
16544;Saulutė;"Saulės zuikučiai";1855999738;Ne;9;0;0;9
16545;Saulutė;"Saulės zuikučiai";2816806902;Taip;8;6;0;14
16546;Saulutė;"Saulės zuikučiai";7844396402;Taip;5;1;0;6
16547;Saulutė;"Saulės zuikučiai";2781003892;Taip;9;0;1;10
16548;Saulutė;Boružėlės;36955032265;Taip;0;2;5;7
16549;Saulutė;Boružėlės;44452051978;Ne;0;4;2;6
16550;Saulutė;Boružėlės;25124975646;Taip;0;4;0;4
16551;Saulutė;Boružėlės;36414547943;Taip;0;4;1;5
16552;Saulutė;Boružėlės;54950572289;Taip;0;4;1;5
16553;Saulutė;Boružėlės;92695618159;Taip;0;4;1;5
16554;Saulutė;Boružėlės;87409240076;Taip;5;4;2;11
16555;Saulutė;Boružėlės;1337654926;Taip;12;3;0;15
16556;Saulutė;Boružėlės;76744652185;Taip;0;4;2;6
16557;Saulutė;Boružėlės;97296161595;Taip;5;1;0;6
16558;Saulutė;Boružėlės;1804521229;Taip;0;14;1;15
16559;Saulutė;Boružėlės;1005459768;Taip;0;4;6;10
16560;Saulutė;Boružėlės;1205642335;Taip;6;4;4;14
16561;Saulutė;Boružėlės;43512415452;Taip;0;4;1;5
16562;Saulutė;Boružėlės;1644704074;Taip;0;3;2;5
16563;Saulutė;Boružėlės;8168961080;Ne;0;3;4;7
16564;Saulutė;Boružėlės;89710141573;Taip;14;0;1;15
16565;Saulutė;Boružėlės;46280382280;Taip;1;4;1;6
16566;Saulutė;Boružėlės;10893091651;Taip;5;0;0;5
16567;Saulutė;Boružėlės;70392220915;Taip;7;4;0;11
16568;Saulutė;Nykštukai;34712531615;Taip;0;1;1;2
16569;Saulutė;Nykštukai;10407286767;Taip;0;2;1;3
16570;Saulutė;Nykštukai;95826894716;Taip;0;4;0;4
16571;Saulutė;Nykštukai;6406135063;Ne;5;4;2;11
16572;Saulutė;Nykštukai;59825470089;Taip;3;4;0;7
16573;Saulutė;Nykštukai;65195759604;Taip;5;4;0;9
16574;Saulutė;Nykštukai;84984808072;Taip;5;2;0;7
16575;Saulutė;Nykštukai;46092441981;Taip;5;2;0;7
16576;Saulutė;Nykštukai;37119876987;Taip;0;4;0;4
16577;Saulutė;Nykštukai;63869261653;Taip;20;0;0;20
16578;Saulutė;Nykštukai;9583443237;Taip;9;1;0;10
16579;Saulutė;Nykštukai;7318452189;Taip;0;14;0;14
16580;Saulutė;Nykštukai;78558743548;Taip;10;0;2;12
16581;Saulutė;Nykštukai;91371507376;Ne;9;0;0;9
16582;Saulutė;Nykštukai;1332002470;Taip;0;5;0;5
16583;Saulutė;Nykštukai;3183309722;Ne;0;4;0;4
16584;Saulutė;Nykštukai;1911318708;Taip;17;0;0;17
16585;Saulutė;Nykštukai;9081236999;Ne;0;1;3;4
16586;Saulutė;Nykštukai;9565528566;Taip;20;0;0;20
16587;Saulutė;Meškiukai;8433646525;Taip;10;0;0;10
16588;Saulutė;Meškiukai;3410606033;Taip;14;0;0;14
16589;Saulutė;Meškiukai;9314889468;Taip;19;0;0;19
16590;Saulutė;Meškiukai;6608003946;Taip;10;10;0;20
16591;Saulutė;Meškiukai;8257363228;Taip;20;0;0;20
16592;Saulutė;Meškiukai;7764493159;Taip;3;0;0;3
16593;Saulutė;Meškiukai;5565832676;Taip;3;0;0;3
16594;Saulutė;Meškiukai;9173336078;Taip;6;0;0;6
16595;Saulutė;Meškiukai;3026114869;Taip;15;0;0;15
16596;Saulutė;Meškiukai;6057668143;Taip;9;0;0;9
16597;Saulutė;Meškiukai;7413098580;Taip;11;0;0;11
16598;Saulutė;Meškiukai;2813274509;Taip;12;0;0;12
16599;Saulutė;Meškiukai;5999318972;Taip;5;0;1;6
16600;Saulutė;Meškiukai;2074473832;Taip;11;0;1;12
16601;Saulutė;Ežiukai;19918665437;Taip;12;0;0;12
16602;Saulutė;Ežiukai;63481737955;Taip;0;0;3;3
16603;Saulutė;Ežiukai;55160240384;Taip;0;9;0;9
16604;Saulutė;Ežiukai;1861612651;Taip;8;0;0;8
16605;Saulutė;Ežiukai;19852146326;Taip;0;7;0;7
16606;Saulutė;Ežiukai;1745560688;Taip;6;1;0;7
16607;Saulutė;Ežiukai;32539394191;Taip;2;2;3;7
16608;Saulutė;Ežiukai;1913500127;Taip;6;4;0;10
16609;Saulutė;Ežiukai;3608072547;Taip;7;0;0;7
16610;Saulutė;Ežiukai;1579654900;Taip;6;0;0;6
16611;Saulutė;Ežiukai;6099238784;Taip;6;0;3;9
16612;Saulutė;Ežiukai;12674831673;Taip;19;0;0;19
16613;Saulutė;Ežiukai;1546200973;Taip;9;0;0;9
16614;Saulutė;Ežiukai;8497765010;Taip;8;0;8;16
16615;Saulutė;Ežiukai;1077526046;Taip;15;0;0;15
16616;Saulutė;Ežiukai;1917058710;Taip;10;0;0;10
16617;Saulutė;Ežiukai;2059267616;Taip;9;0;0;9
16618;Saulutė;Ežiukai;1212865434;Ne;6;0;3;9
16619;Saulutė;Ežiukai;2190922941;Taip;15;0;0;15
16620;Saulutė;Ežiukai;3268714222;Taip;0;15;5;20
16621;Saulutė;Ežiukai;5326279083;Taip;5;1;1;7
16622;Saulutė;Bitutės;9892855816;Taip;10;0;0;10
16623;Saulutė;Bitutės;4510990261;Taip;15;0;0;15
16624;Saulutė;Bitutės;3272296969;Taip;0;8;0;8
16625;Saulutė;Bitutės;2545930114;Taip;14;0;1;15
16626;Saulutė;Bitutės;2140277182;Taip;17;0;2;19
16627;Saulutė;Bitutės;6044672321;Taip;0;0;7;7
16628;Saulutė;Bitutės;6396954377;Taip;13;0;1;14
16629;Saulutė;Bitutės;3295289082;Taip;0;0;2;2
16630;Saulutė;Bitutės;8390767549;Taip;14;0;1;15
16631;Saulutė;Bitutės;1056158093;Taip;8;0;2;10
16632;Saulutė;Bitutės;7888435573;Taip;1;0;1;2
16633;Saulutė;Bitutės;7297886198;Taip;20;0;0;20
16634;Saulutė;Bitutės;7576532632;Taip;12;0;5;17
16635;Saulutė;Bitutės;8708184278;Taip;13;0;0;13
16636;Saulutė;Bitutės;8040751073;Taip;10;0;1;11
16637;Saulutė;Bitutės;1587328722;Taip;0;5;0;5
16638;Saulutė;Bitutės;7574225926;Taip;14;0;0;14
16639;Saulutė;Bitutės;8512137633;Taip;20;0;0;20
16640;Saulutė;Bitutės;2725491887;Taip;10;0;3;13
16641;Saulutė;Bitutės;4123500930;Ne;0;4;8;12
16642;Saulutė;Pelėdžiukai;3445723020;Ne;14;0;1;15
16643;Saulutė;Pelėdžiukai;1785740531;Taip;0;3;3;6
16644;Saulutė;Pelėdžiukai;1534183935;Taip;14;0;0;14
16645;Saulutė;Pelėdžiukai;27386434894;Taip;4;1;2;7
16646;Saulutė;Pelėdžiukai;27752316336;Taip;1;1;0;2
16647;Saulutė;Pelėdžiukai;7539721995;Taip;0;3;0;3
16648;Saulutė;Pelėdžiukai;65492344097;Taip;5;5;3;13
16649;Saulutė;Pelėdžiukai;1935503629;Taip;0;0;3;3
16650;Saulutė;Pelėdžiukai;77923802656;Taip;6;0;0;6
16651;Saulutė;Pelėdžiukai;79919438191;Taip;3;0;6;9
16652;Saulutė;Pelėdžiukai;31705050946;Taip;9;0;2;11
16653;Saulutė;Pelėdžiukai;45306237230;Taip;0;4;0;4
16654;Saulutė;Pelėdžiukai;14195215027;Taip;5;4;2;11
16655;Saulutė;Pelėdžiukai;28772515317;Ne;10;4;1;15
16656;Saulutė;Pelėdžiukai;50944263059;Taip;0;0;3;3
16657;Saulutė;Pelėdžiukai;1510434265;Taip;0;0;3;3
16658;Saulutė;Pelėdžiukai;5574049005;Taip;19;0;1;20
16659;Saulutė;Pelėdžiukai;77170708225;Taip;0;1;0;1
16660;Saulutė;Pelėdžiukai;4312318284;Taip;15;0;0;15
16661;Saulutė;Zylutės;91834332717;Taip;0;8;0;8
16662;Saulutė;Zylutės;1277263391;Taip;5;0;4;9
16663;Saulutė;Zylutės;37315117916;Taip;0;0;4;4
16664;Saulutė;Zylutės;75405796772;Taip;8;1;0;9
16665;Saulutė;Zylutės;35570367633;Taip;3;0;1;4
16666;Saulutė;Zylutės;2098990667;Taip;6;1;0;7
16667;Saulutė;Zylutės;6557918941;Taip;0;1;0;1
16668;Saulutė;Zylutės;78967475616;Ne;8;4;2;14
16669;Saulutė;Zylutės;1786491396;Taip;0;7;0;7
16670;Saulutė;Zylutės;55982591521;Taip;7;0;1;8
16671;Saulutė;Zylutės;3246485288;Taip;3;0;1;4
16672;Saulutė;Zylutės;21703177024;Taip;5;1;3;9
16673;Saulutė;Zylutės;54373231773;Taip;0;10;0;10
16674;Saulutė;Zylutės;88168936754;Taip;8;0;2;10
16675;Saulutė;Zylutės;85182498024;Taip;0;4;0;4
16676;Saulutė;Zylutės;98979263108;Taip;0;14;0;14
16677;Saulutė;Zylutės;16622528829;Taip;0;18;0;18
16678;Saulutė;Zylutės;1475031090;Taip;5;0;1;6
16679;Saulutė;Zylutės;57283533169;Taip;8;2;0;10
16680;Saulutė;Zylutės;3450668814;Taip;8;3;0;11
16681;Saulutė;Zylutės;13147367113;Taip;5;4;3;12
16682;Saulutė;"1 klasė";5997216605;Taip;16;4;0;20
16683;Saulutė;"1 klasė";92198716772;Taip;5;4;0;9
16684;Saulutė;"1 klasė";8632066475;Ne;16;4;0;20
16685;Saulutė;"1 klasė";67739063665;Taip;0;4;0;4
16686;Saulutė;"1 klasė";50110262859;Taip;6;4;0;10
16687;Saulutė;"1 klasė";6469772450;Taip;16;4;0;20
16688;Saulutė;"1 klasė";4302511346;Ne;16;4;0;20
16689;Saulutė;"1 klasė";18122758338;Taip;1;4;0;5
16690;Saulutė;"1 klasė";8962761979;Taip;16;4;0;20
16691;Saulutė;"1 klasė";7785909571;Ne;2;4;0;6
16692;Saulutė;"1 klasė";5822529731;Taip;5;4;0;9
16693;Saulutė;"1 klasė";2095347468;Taip;0;4;0;4
16694;Saulutė;"1 klasė";56289088231;Taip;6;4;0;10
16695;Saulutė;"1 klasė";1418237274;Taip;2;4;0;6
16696;Saulutė;"1 klasė";13916981850;Taip;0;4;0;4
16697;Saulutė;"1 klasė";61123463673;Taip;12;4;0;16
16698;Saulutė;"1 klasė";39606108938;Ne;5;4;0;9
16699;Saulutė;"1 klasė";82106514982;Taip;2;4;0;6
16700;Saulutė;"1 klasė";58163470119;Taip;7;4;0;11
16701;Saulutė;"1 klasė";81191097069;Taip;1;4;0;5
16702;Saulutė;"1 klasė";37839378248;Taip;0;4;0;4
16703;Saulutė;"1 klasė";90078805222;Taip;5;4;0;9
16704;Saulutė;"1 klasė";61113930769;Taip;0;4;0;4
16705;Saulutė;"1 klasė";42204884890;Ne;0;4;0;4
16706;Saulutė;"1 klasė";12964000357;Taip;8;4;0;12
16707;Saulutė;"1 klasė";25720655179;Taip;0;4;0;4
16708;Saulutė;"1 klasė";30863736694;Taip;4;4;0;8
16709;Saulutė;"1 klasė";45877127245;Taip;1;4;0;5
16710;Saulutė;"1 klasė";8308288099;Ne;10;4;0;14
16711;Saulutė;"1 klasė";54726632101;Taip;0;4;0;4
16712;Saulutė;"1 klasė";16523279366;Taip;3;4;0;7
16713;Saulutė;"2 klasė";1701868565;Taip;1;4;0;5
16714;Saulutė;"2 klasė";6924270821;Ne;0;4;0;4
16715;Saulutė;"2 klasė";3450860412;Ne;1;4;0;5
16716;Saulutė;"2 klasė";1081812391;Taip;5;4;0;9
16717;Saulutė;"2 klasė";1436690766;Taip;5;4;0;9
16718;Saulutė;"2 klasė";7577219457;Taip;6;4;0;10
16719;Saulutė;"2 klasė";2517511237;Taip;0;4;0;4
16720;Saulutė;"2 klasė";1153099638;Taip;6;4;0;10
16721;Saulutė;"2 klasė";5786453424;Taip;9;4;0;13
16722;Saulutė;"2 klasė";8531372660;Taip;2;4;0;6
16723;Saulutė;"2 klasė";1117229507;Taip;7;4;0;11
16724;Saulutė;"2 klasė";4342595483;Taip;4;4;0;8
16725;Saulutė;"2 klasė";3614749034;Taip;2;4;0;6
16726;Saulutė;"2 klasė";3937034221;Ne;6;4;0;10
16727;Saulutė;"2 klasė";7543978588;Taip;1;4;0;5
16728;Saulutė;"2 klasė";7696948081;Taip;0;4;0;4
16729;Saulutė;"2 klasė";4252242862;Taip;1;4;0;5
16730;Saulutė;"2 klasė";2957436888;Taip;4;4;0;8
16731;Saulutė;"2 klasė";1312993030;Taip;7;4;0;11
16732;Saulutė;"2 klasė";3755300838;Taip;3;4;0;7
16733;Saulutė;"2 klasė";9744870287;Taip;0;4;0;4
16734;Saulutė;"2 klasė";8953313952;Ne;3;4;0;7
16735;Saulutė;"2 klasė";8192525690;Taip;0;4;0;4
16736;Saulutė;"2 klasė";6025668467;Taip;10;4;0;14
16737;Saulutė;"3 klasė";1604607524;Ne;11;4;0;15
16738;Saulutė;"3 klasė";1787634725;Ne;2;4;0;6
16739;Saulutė;"3 klasė";6128992723;Ne;0;4;0;4
16740;Saulutė;"3 klasė";3806787884;Ne;1;4;0;5
16741;Saulutė;"3 klasė";9155511473;Ne;6;4;0;10
16742;Saulutė;"3 klasė";3302267009;Ne;0;4;0;4
16743;Saulutė;"3 klasė";1659579883;Ne;4;4;0;8
16744;Saulutė;"3 klasė";9833653313;Ne;2;4;0;6
16745;Saulutė;"3 klasė";5193599921;Ne;0;4;0;4
16746;Saulutė;"3 klasė";9113434597;Ne;0;4;0;4
16747;Saulutė;"3 klasė";8601544457;Taip;1;4;0;5
16748;Saulutė;"3 klasė";8506064421;Ne;0;4;0;4
16749;Saulutė;"3 klasė";7700196440;Ne;4;4;0;8
16750;Saulutė;"3 klasė";9621988308;Ne;16;4;0;20
16751;Saulutė;"3 klasė";4189732482;Ne;16;4;0;20
16752;Saulutė;"3 klasė";2638495931;Ne;16;4;0;20
16753;Saulutė;"3 klasė";6797161399;Ne;3;4;0;7
16754;Saulutė;"3 klasė";9885756874;Ne;7;4;0;11
16755;Saulutė;"3 klasė";6957680310;Ne;6;4;0;10
16756;Saulutė;"3 klasė";7343265118;Ne;16;4;0;20
16757;Saulutė;"3 klasė";2374587130;Ne;0;4;0;4
16758;Saulutė;"4 klasė";5056875822;Ne;0;4;0;4
16759;Saulutė;"4 klasė";9319954066;Ne;0;4;0;4
16760;Saulutė;"4 klasė";6584576600;Ne;1;4;0;5
16761;Saulutė;"4 klasė";5395865996;Ne;10;4;0;14
16762;Saulutė;"4 klasė";7115874340;Ne;8;4;0;12
16763;Saulutė;"4 klasė";4407219804;Ne;5;4;0;9
16764;Saulutė;"4 klasė";7050670622;Ne;1;4;0;5
16765;Saulutė;"4 klasė";4724713439;Ne;5;4;0;9
16766;Saulutė;"4 klasė";7656351068;Ne;0;4;0;4
16767;Saulutė;"4 klasė";3798600407;Ne;4;4;0;8
16768;Saulutė;"4 klasė";9802910644;Ne;0;4;0;4
16769;Saulutė;"4 klasė";4804531706;Ne;0;4;0;4
16770;Saulutė;"4 klasė";2876473029;Ne;5;4;0;9
16771;Svaja;SAULĖGRĄŽA;1649920341;Taip;6;0;0;6
16772;Svaja;SAULĖGRĄŽA;50510924690;Taip;10;0;0;10
16773;Svaja;SAULĖGRĄŽA;54462393937;Taip;5;3;0;8
16774;Svaja;SAULĖGRĄŽA;57216299421;Ne;5;7;0;12
16775;Svaja;SAULĖGRĄŽA;1181877436;Taip;4;0;1;5
16776;Svaja;SAULĖGRĄŽA;64487515384;Taip;4;0;0;4
16777;Svaja;SAULĖGRĄŽA;25578518444;Taip;14;0;0;14
16778;Svaja;SAULĖGRĄŽA;93651139102;Taip;4;0;0;4
16779;Svaja;SAULĖGRĄŽA;1470843400;Taip;0;0;1;1
16780;Svaja;SAULĖGRĄŽA;6057524892;Taip;15;0;0;15
16781;Svaja;SAULĖGRĄŽA;63346231562;Taip;15;0;0;15
16782;Svaja;SAULĖGRĄŽA;73391331150;Taip;10;0;0;10
16783;Svaja;SAULĖGRĄŽA;41183537732;Taip;5;0;3;8
16784;Svaja;SAULĖGRĄŽA;30833178157;Taip;4;0;0;4
16785;Svaja;SAULĖGRĄŽA;70507326327;Taip;0;0;2;2
16786;Svaja;SAULĖGRĄŽA;25934507261;Taip;10;0;1;11
16787;Svaja;SAULĖGRĄŽA;70506691027;Taip;0;1;0;1
16788;Svaja;SAULĖGRĄŽA;89047123808;Taip;14;0;0;14
16789;Svaja;SAULĖGRĄŽA;7348182434;Taip;0;0;1;1
16790;Svaja;SAULĖGRĄŽA;1795682827;Taip;10;1;0;11
16791;Svaja;SAULĖGRĄŽA;8011137572;Taip;0;0;3;3
16792;Svaja;SAULĖGRĄŽA;3499148291;Taip;10;0;1;11
16793;Svaja;SAULĖGRĄŽA;4416877973;Taip;0;4;0;4
16794;Svaja;SAULĖGRĄŽA;99005386537;Taip;5;2;0;7
16795;Svaja;"STEBUKLINGAS ŽIBINTAS";83624935456;Taip;0;4;0;4
16796;Svaja;"STEBUKLINGAS ŽIBINTAS";9847061480;Taip;11;0;0;11
16797;Svaja;"STEBUKLINGAS ŽIBINTAS";1660742385;Taip;0;4;0;4
16798;Svaja;"STEBUKLINGAS ŽIBINTAS";9628146488;Taip;11;0;0;11
16799;Svaja;"STEBUKLINGAS ŽIBINTAS";69028070656;Taip;15;1;0;16
16800;Svaja;"STEBUKLINGAS ŽIBINTAS";15252353189;Taip;0;1;0;1
16801;Svaja;"STEBUKLINGAS ŽIBINTAS";1017471747;Taip;20;0;0;20
16802;Svaja;"STEBUKLINGAS ŽIBINTAS";1304775332;Taip;10;2;0;12
16803;Svaja;"STEBUKLINGAS ŽIBINTAS";46458496887;Taip;2;2;0;4
16804;Svaja;"STEBUKLINGAS ŽIBINTAS";26902749194;Taip;0;4;0;4
16805;Svaja;"STEBUKLINGAS ŽIBINTAS";1903424547;Taip;6;4;0;10
16806;Svaja;"STEBUKLINGAS ŽIBINTAS";30360097999;Taip;12;1;0;13
16807;Svaja;"STEBUKLINGAS ŽIBINTAS";19887874988;Taip;0;0;6;6
16808;Svaja;"STEBUKLINGAS ŽIBINTAS";1967394949;Taip;13;1;0;14
16809;Svaja;"STEBUKLINGAS ŽIBINTAS";36362624522;Taip;0;5;0;5
16810;Svaja;"STEBUKLINGAS ŽIBINTAS";7719185632;Taip;9;2;0;11
16811;Svaja;"STEBUKLINGAS ŽIBINTAS";1297727288;Taip;13;0;0;13
16812;Svaja;"STEBUKLINGAS ŽIBINTAS";30027404222;Taip;0;2;0;2
16813;Svaja;"STEBUKLINGAS ŽIBINTAS";57216954289;Taip;6;0;3;9
16814;Svaja;"STEBUKLINGAS ŽIBINTAS";51382165039;Taip;14;1;0;15
16815;Svaja;"STEBUKLINGAS ŽIBINTAS";1352488176;Taip;10;4;0;14
16816;Svaja;"STEBUKLINGAS ŽIBINTAS";44989143252;Taip;10;0;4;14
16817;Svaja;"STEBUKLINGAS ŽIBINTAS";1943166503;Taip;0;1;3;4
16818;Svaja;"STEBUKLINGAS ŽIBINTAS";6056157113;Taip;0;4;0;4
16819;Svaja;"STEBUKLINGAS ŽIBINTAS";8198614500;Taip;2;4;7;13
16820;Svaja;SAULUTĖ;50207734108;Taip;12;0;0;12
16821;Svaja;SAULUTĖ;20473739993;Taip;0;4;0;4
16822;Svaja;SAULUTĖ;2493749424;Taip;0;0;6;6
16823;Svaja;SAULUTĖ;30719991872;Taip;20;0;0;20
16824;Svaja;SAULUTĖ;6665752307;Taip;6;4;1;11
16825;Svaja;SAULUTĖ;80459437057;Taip;15;2;0;17
16826;Svaja;SAULUTĖ;4968201186;Taip;10;0;0;10
16827;Svaja;SAULUTĖ;8689706130;Taip;15;0;0;15
16828;Svaja;SAULUTĖ;6807834176;Taip;17;0;0;17
16829;Svaja;SAULUTĖ;7020342969;Taip;0;4;0;4
16830;Svaja;SAULUTĖ;3633996231;Taip;11;0;1;12
16831;Svaja;SAULUTĖ;2750615517;Taip;6;0;2;8
16832;Svaja;SAULUTĖ;3049808328;Taip;2;0;1;3
16833;Svaja;SAULUTĖ;1045300185;Taip;7;0;0;7
16834;Svaja;SAULUTĖ;4341042027;Taip;4;4;0;8
16835;Svaja;SAULUTĖ;3802996573;Taip;10;0;1;11
16836;Svaja;SAULUTĖ;6676145522;Taip;11;0;0;11
16837;Svaja;SAULUTĖ;7936765752;Taip;8;0;0;8
16838;Svaja;SAULUTĖ;4293339784;Taip;16;0;0;16
16839;Svaja;SAULUTĖ;9475971731;Taip;9;0;0;9
16840;Svaja;SAULUTĖ;5479482244;Ne;1;9;0;10
16841;Svaja;SAULUTĖ;7473493846;Taip;14;0;0;14
16842;Svaja;SAULUTĖ;5443682744;Taip;14;4;0;18
16843;Svaja;SAULUTĖ;9112198914;Taip;11;0;1;12
16844;Svaja;"AUKSINĖ ŽUVELĖ";43307670660;Taip;11;4;0;15
16845;Svaja;"AUKSINĖ ŽUVELĖ";25194696146;Taip;1;4;0;5
16846;Svaja;"AUKSINĖ ŽUVELĖ";55925058866;Taip;5;0;2;7
16847;Svaja;"AUKSINĖ ŽUVELĖ";1704075006;Taip;0;1;0;1
16848;Svaja;"AUKSINĖ ŽUVELĖ";70641067006;Taip;6;1;0;7
16849;Svaja;"AUKSINĖ ŽUVELĖ";8875237023;Taip;11;0;2;13
16850;Svaja;"AUKSINĖ ŽUVELĖ";8279605005;Taip;4;0;1;5
16851;Svaja;"AUKSINĖ ŽUVELĖ";1437557657;Taip;20;0;0;20
16852;Svaja;"AUKSINĖ ŽUVELĖ";87432529423;Taip;5;4;0;9
16853;Svaja;"AUKSINĖ ŽUVELĖ";36505115395;Taip;0;0;1;1
16854;Svaja;"AUKSINĖ ŽUVELĖ";58102699652;Taip;0;3;0;3
16855;Svaja;"AUKSINĖ ŽUVELĖ";6593047776;Taip;0;0;4;4
16856;Svaja;"AUKSINĖ ŽUVELĖ";5335776957;Ne;11;4;0;15
16857;Svaja;"AUKSINĖ ŽUVELĖ";8242667827;Taip;11;3;0;14
16858;Svaja;"AUKSINĖ ŽUVELĖ";6211339131;Taip;11;3;0;14
16859;Svaja;"AUKSINĖ ŽUVELĖ";7911488445;Taip;5;0;1;6
16860;Svaja;"AUKSINĖ ŽUVELĖ";1295012978;Taip;10;0;4;14
16861;Svaja;"AUKSINĖ ŽUVELĖ";64196174690;Taip;14;0;1;15
16862;Svaja;"AUKSINĖ ŽUVELĖ";97298858365;Taip;5;4;2;11
16863;Svaja;"AUKSINĖ ŽUVELĖ";22702341083;Taip;19;0;0;19
16864;Svaja;"AUKSINĖ ŽUVELĖ";3077814152;Taip;20;0;0;20
16865;Svaja;"AUKSINĖ ŽUVELĖ";2076060840;Taip;5;7;0;12
16866;Svaja;"AUKSINĖ ŽUVELĖ";43223177664;Taip;5;0;0;5
16867;Svaja;"AUKSINĖ ŽUVELĖ";27445299450;Taip;8;4;1;13
16868;Svaja;"PRIE ĮLANKOS";2165716699;Taip;14;0;0;14
16869;Svaja;"PRIE ĮLANKOS";6020060540;Taip;6;0;1;7
16870;Svaja;"PRIE ĮLANKOS";75104768118;Taip;0;0;1;1
16871;Svaja;"PRIE ĮLANKOS";94449039022;Taip;0;0;4;4
16872;Svaja;"PRIE ĮLANKOS";1367687415;Taip;0;0;2;2
16873;Svaja;"PRIE ĮLANKOS";92044111261;Taip;1;0;0;1
16874;Svaja;"PRIE ĮLANKOS";74904581010;Taip;13;0;0;13
16875;Svaja;"PRIE ĮLANKOS";1847775266;Taip;0;0;1;1
16876;Svaja;"PRIE ĮLANKOS";44418402260;Taip;5;0;0;5
16877;Svaja;"PRIE ĮLANKOS";8828911320;Taip;0;0;1;1
16878;Svaja;"PRIE ĮLANKOS";54328462992;Taip;0;4;0;4
16879;Svaja;"PRIE ĮLANKOS";18238622848;Taip;0;0;9;9
16880;Svaja;"PRIE ĮLANKOS";4617061890;Taip;7;0;2;9
16881;Svaja;"PRIE ĮLANKOS";71708072632;Taip;5;0;1;6
16882;Svaja;"PRIE ĮLANKOS";56506642672;Taip;5;0;1;6
16883;Svaja;"PRIE ĮLANKOS";34141773112;Ne;0;0;3;3
16884;Svaja;"PRIE ĮLANKOS";40856210635;Taip;14;0;0;14
16885;Svaja;"PRIE ĮLANKOS";36001411632;Taip;5;0;3;8
16886;Svaja;"PRIE ĮLANKOS";3604946305;Taip;12;0;0;12
16887;Svaja;"PRIE ĮLANKOS";6905550313;Taip;0;5;0;5
16888;Svaja;"1 B klasė";8876971658;Taip;0;20;0;20
16889;Svaja;"1 B klasė";30200636424;Ne;0;13;0;13
16890;Svaja;"1 B klasė";8802243719;Taip;0;4;0;4
16891;Svaja;"1 B klasė";9401605132;Taip;0;6;0;6
16892;Svaja;"1 B klasė";77796846388;Taip;0;5;0;5
16893;Svaja;"1 B klasė";71840791098;Taip;0;4;0;4
16894;Svaja;"1 B klasė";5712106350;Taip;0;9;0;9
16895;Svaja;"1 B klasė";57983452414;Taip;0;7;0;7
16896;Svaja;"1 B klasė";71086654007;Taip;0;5;0;5
16897;Svaja;"1 B klasė";29972474690;Taip;0;10;0;10
16898;Svaja;"1 B klasė";38464012322;Taip;0;4;0;4
16899;Svaja;"1 B klasė";15871540340;Taip;0;14;0;14
16900;Svaja;"1 B klasė";47441661801;Ne;0;4;0;4
16901;Svaja;"1 B klasė";68894832324;Taip;0;5;0;5
16902;Svaja;"1 B klasė";7747921362;Ne;0;13;0;13
16903;Svaja;"1 B klasė";21035820496;Taip;0;6;0;6
16904;Svaja;"1 B klasė";61996055386;Taip;0;4;0;4
16905;Svaja;"1 B klasė";59707838958;Taip;0;5;0;5
16906;Svaja;"1 B klasė";62579722313;Taip;0;10;0;10
16907;Svaja;"1 B klasė";77712240909;Taip;0;8;0;8
16908;Svaja;"1 B klasė";27313057222;Taip;0;6;0;6
16909;Svaja;"1 B klasė";97651620085;Taip;0;4;0;4
16910;Svaja;"1 A klasė";28311552445;Taip;0;4;0;4
16911;Svaja;"1 A klasė";88447528808;Taip;0;5;0;5
16912;Svaja;"1 A klasė";21534170175;Taip;0;4;0;4
16913;Svaja;"1 A klasė";89075087937;Taip;0;20;0;20
16914;Svaja;"1 A klasė";72655912805;Taip;0;4;0;4
16915;Svaja;"1 A klasė";16955510836;Taip;0;10;0;10
16916;Svaja;"1 A klasė";49184638535;Taip;0;20;0;20
16917;Svaja;"1 A klasė";66507774550;Taip;0;7;0;7
16918;Svaja;"1 A klasė";2019179013;Taip;0;10;0;10
16919;Svaja;"1 A klasė";69928474471;Taip;0;14;0;14
16920;Svaja;"1 A klasė";56095979514;Taip;0;9;0;9
16921;Svaja;"1 A klasė";24812635291;Taip;0;7;0;7
16922;Svaja;"1 A klasė";99157757025;Ne;0;8;0;8
16923;Svaja;"1 A klasė";89627730276;Taip;0;13;0;13
16924;Svaja;"1 A klasė";48859926231;Taip;0;4;0;4
16925;Svaja;"1 A klasė";20363553383;Taip;0;18;0;18
16926;Svaja;"1 A klasė";70513111186;Ne;0;6;0;6
16927;Svaja;"1 A klasė";31604152893;Taip;0;5;0;5
16928;Svaja;"1 A klasė";76101749947;Taip;0;20;0;20
16929;Svaja;"1 A klasė";96680395594;Taip;0;5;0;5
16930;Svaja;"1 A klasė";58497063533;Taip;0;13;0;13
16931;Svaja;"1 A klasė";38781141060;Taip;0;12;0;12
16932;Svaja;"1 C klasė";2018073862;Taip;0;10;0;10
16933;Svaja;"1 C klasė";70157518595;Taip;0;5;0;5
16934;Svaja;"1 C klasė";73691352138;Taip;0;4;0;4
16935;Svaja;"1 C klasė";6613028133;Taip;0;4;0;4
16936;Svaja;"1 C klasė";5288858941;Ne;0;4;0;4
16937;Svaja;"1 C klasė";5975083034;Taip;0;20;0;20
16938;Svaja;"1 C klasė";94437606762;Taip;0;5;0;5
16939;Svaja;"1 C klasė";25585032766;Taip;0;20;0;20
16940;Svaja;"1 C klasė";79572045341;Taip;0;8;0;8
16941;Svaja;"1 C klasė";50116820543;Taip;0;4;0;4
16942;Svaja;"1 C klasė";1869833113;Taip;0;8;0;8
16943;Svaja;"1 C klasė";66967032561;Taip;0;20;0;20
16944;Svaja;"1 C klasė";79260508923;Taip;0;4;0;4
16945;Svaja;"1 C klasė";3909240894;Taip;0;4;0;4
16946;Svaja;"1 C klasė";82358174131;Taip;0;7;0;7
16947;Svaja;"1 C klasė";53352329988;Taip;0;6;0;6
16948;Svaja;"1 C klasė";59917024948;Taip;0;4;0;4
16949;Svaja;"1 C klasė";48888360976;Taip;0;4;0;4
16950;Svaja;"1 C klasė";76871144487;Taip;0;9;0;9
16951;Svaja;"1 C klasė";73440582394;Taip;0;9;0;9
16952;Svaja;"1 C klasė";60982723867;Taip;0;20;0;20
16953;Svaja;"1 C klasė";12226488343;Taip;0;14;0;14
16954;Svaja;"2 A klasė";9170681988;Taip;0;9;0;9
16955;Svaja;"2 A klasė";6331528628;Taip;0;6;0;6
16956;Svaja;"2 A klasė";3545160978;Taip;0;20;0;20
16957;Svaja;"2 A klasė";3812365439;Taip;0;9;0;9
16958;Svaja;"2 A klasė";4732976577;Ne;0;6;0;6
16959;Svaja;"2 A klasė";4819506647;Taip;0;4;0;4
16960;Svaja;"2 A klasė";7374204735;Taip;0;6;0;6
16961;Svaja;"2 A klasė";4147975771;Taip;0;5;0;5
16962;Svaja;"2 A klasė";5355661673;Taip;0;5;0;5
16963;Svaja;"2 A klasė";8907191675;Taip;0;4;0;4
16964;Svaja;"2 A klasė";7406969545;Taip;0;7;0;7
16965;Svaja;"2 A klasė";6182584108;Taip;0;5;0;5
16966;Svaja;"2 A klasė";6561055995;Taip;0;4;0;4
16967;Svaja;"2 A klasė";7745440861;Taip;0;4;0;4
16968;Svaja;"2 A klasė";3100769948;Taip;0;8;0;8
16969;Svaja;"2 A klasė";1932041952;Taip;0;5;0;5
16970;Svaja;"2 A klasė";2963665708;Taip;0;8;0;8
16971;Svaja;"2 A klasė";6166818062;Taip;0;10;0;10
16972;Svaja;"2 A klasė";5400447747;Taip;0;11;0;11
16973;Svaja;"2 A klasė";4677183471;Taip;0;4;0;4
16974;Svaja;"2 A klasė";3876795349;Taip;0;13;0;13
16975;Svaja;"2 A klasė";4570702330;Taip;0;8;0;8
16976;Svaja;"2 A klasė";4559408388;Taip;0;4;0;4
16977;Svaja;"2 A klasė";1851430613;Taip;0;5;0;5
16978;Svaja;"2 A klasė";6301200166;Ne;0;12;0;12
16979;Svaja;"2 B klasė";6685023540;Taip;0;4;0;4
16980;Svaja;"2 B klasė";3917545035;Taip;0;20;0;20
16981;Svaja;"2 B klasė";3154268090;Taip;0;9;0;9
16982;Svaja;"2 B klasė";9833804885;Taip;0;4;0;4
16983;Svaja;"2 B klasė";7137011094;Taip;0;4;0;4
16984;Svaja;"2 B klasė";8497722175;Taip;0;4;0;4
16985;Svaja;"2 B klasė";1949789571;Taip;0;4;0;4
16986;Svaja;"2 B klasė";5316972581;Taip;0;20;0;20
16987;Svaja;"2 B klasė";5304302886;Taip;0;4;0;4
16988;Svaja;"2 B klasė";9390649669;Ne;0;5;0;5
16989;Svaja;"2 B klasė";2543801351;Taip;0;4;0;4
16990;Svaja;"2 B klasė";2768998567;Taip;0;5;0;5
16991;Svaja;"2 B klasė";5417233257;Taip;0;4;0;4
16992;Svaja;"2 B klasė";8934053695;Ne;0;4;0;4
16993;Svaja;"2 B klasė";6888324693;Taip;0;4;0;4
16994;Svaja;"2 B klasė";9741563523;Taip;0;4;0;4
16995;Svaja;"2 B klasė";9474581791;Taip;0;4;0;4
16996;Svaja;"2 B klasė";7185891478;Ne;0;20;0;20
16997;Svaja;"2 B klasė";6949932613;Taip;0;4;0;4
16998;Svaja;"2 B klasė";9227257148;Taip;0;4;0;4
16999;Svaja;"2 B klasė";7403841330;Taip;0;7;0;7
17000;Svaja;"2 B klasė";6387070757;Taip;0;5;0;5
17001;Svaja;"2 B klasė";4859522896;Taip;0;5;0;5
17002;Svaja;"2 B klasė";7165840275;Taip;0;4;0;4
17003;Svaja;"2 B klasė";4858401763;Taip;0;9;0;9
17004;Svaja;"2 B klasė";986820082;Taip;0;4;0;4
17005;Svaja;"3 A klasė";6890796785;Taip;0;6;0;6
17006;Svaja;"3 A klasė";4321787638;Taip;0;4;0;4
17007;Svaja;"3 A klasė";8045419081;Taip;0;6;0;6
17008;Svaja;"3 A klasė";3060720122;Taip;0;11;0;11
17009;Svaja;"3 A klasė";4191652201;Taip;0;20;0;20
17010;Svaja;"3 A klasė";2408787820;Taip;0;4;0;4
17011;Svaja;"3 A klasė";2143707618;Taip;0;4;0;4
17012;Svaja;"3 A klasė";9922327181;Taip;0;5;0;5
17013;Svaja;"3 A klasė";7360643147;Taip;0;4;0;4
17014;Svaja;"3 A klasė";9431617139;Taip;0;20;0;20
17015;Svaja;"3 A klasė";5072924063;Taip;0;5;0;5
17016;Svaja;"3 A klasė";1224863574;Ne;0;5;0;5
17017;Svaja;"3 A klasė";5866029763;Ne;0;20;0;20
17018;Svaja;"3 A klasė";5224191012;Taip;0;4;0;4
17019;Svaja;"3 A klasė";2396489897;Taip;0;4;0;4
17020;Svaja;"3 A klasė";3362976996;Taip;0;6;0;6
17021;Svaja;"3 A klasė";6924433006;Taip;0;11;0;11
17022;Svaja;"3 A klasė";6379522088;Taip;0;20;0;20
17023;Svaja;"3 A klasė";6859893256;Taip;0;20;0;20
17024;Svaja;"3 A klasė";7222472406;Taip;0;6;0;6
17025;Svaja;"3 A klasė";8566329547;Taip;0;20;0;20
17026;Svaja;"3 A klasė";8014577929;Taip;0;9;0;9
17027;Svaja;"3 A klasė";5916292577;Taip;0;19;0;19
17028;Svaja;"3 B klasė";4730576902;Taip;0;5;0;5
17029;Svaja;"3 B klasė";1717017574;Taip;0;20;0;20
17030;Svaja;"3 B klasė";6738703814;Taip;0;4;0;4
17031;Svaja;"3 B klasė";9134285226;Taip;0;9;0;9
17032;Svaja;"3 B klasė";5936330139;Taip;0;9;0;9
17033;Svaja;"3 B klasė";5872552939;Taip;0;20;0;20
17034;Svaja;"3 B klasė";7732761679;Taip;0;4;0;4
17035;Svaja;"3 B klasė";9268837216;Taip;0;20;0;20
17036;Svaja;"3 B klasė";3914701993;Taip;0;7;0;7
17037;Svaja;"3 B klasė";6125002433;Taip;0;20;0;20
17038;Svaja;"3 B klasė";7318107259;Taip;0;8;0;8
17039;Svaja;"3 B klasė";3710090923;Taip;0;5;0;5
17040;Svaja;"3 B klasė";4798681160;Taip;0;10;0;10
17041;Svaja;"3 B klasė";8694436642;Taip;0;5;0;5
17042;Svaja;"3 B klasė";9634453365;Taip;0;8;0;8
17043;Svaja;"3 B klasė";5247586745;Taip;0;13;0;13
17044;Svaja;"3 B klasė";3794316760;Taip;0;4;0;4
17045;Svaja;"3 B klasė";2827984254;Taip;0;5;0;5
17046;Svaja;"3 B klasė";2414969796;Taip;0;4;0;4
17047;Svaja;"3 B klasė";6780795284;Taip;0;5;0;5
17048;Svaja;"3 B klasė";7211076381;Taip;0;5;0;5
17049;Svaja;"3 B klasė";7731424463;Taip;0;7;0;7
17050;Svaja;"3 B klasė";6933648513;Taip;0;12;0;12
17051;Svaja;"3 B klasė";2601042375;Taip;0;4;0;4
17052;Svaja;"4 A klasė";8379446890;Taip;0;5;0;5
17053;Svaja;"4 A klasė";4502453706;Taip;0;4;0;4
17054;Svaja;"4 A klasė";2634945863;Taip;0;4;0;4
17055;Svaja;"4 A klasė";2809419614;Taip;0;8;0;8
17056;Svaja;"4 A klasė";7907240014;Taip;0;6;0;6
17057;Svaja;"4 A klasė";1879036130;Taip;0;4;0;4
17058;Svaja;"4 A klasė";3557342819;Taip;0;4;0;4
17059;Svaja;"4 A klasė";1541293330;Taip;0;5;0;5
17060;Svaja;"4 A klasė";9632176714;Taip;0;6;0;6
17061;Svaja;"4 A klasė";5365820503;Taip;0;20;0;20
17062;Svaja;"4 A klasė";5377640073;Taip;0;5;0;5
17063;Svaja;"4 A klasė";5932025585;Taip;0;20;0;20
17064;Svaja;"4 A klasė";4448306552;Taip;0;4;0;4
17065;Svaja;"4 A klasė";3819417941;Taip;0;8;0;8
17066;Svaja;"4 A klasė";5422477471;Taip;0;4;0;4
17067;Svaja;"4 A klasė";9560407704;Taip;0;9;0;9
17068;Svaja;"4 A klasė";6887675378;Taip;0;5;0;5
17069;Svaja;"4 A klasė";5552969529;Taip;0;20;0;20
17070;Svaja;"4 A klasė";6527332163;Ne;0;20;0;20
17071;Svaja;"4 A klasė";4420778031;Ne;0;5;0;5
17072;Svaja;"4 A klasė";1318515776;Ne;0;6;0;6
17073;Svaja;"4 A klasė";6591381153;Taip;0;4;0;4
17074;Svaja;"4 B klasė";2768409576;Taip;0;4;0;4
17075;Svaja;"4 B klasė";6124187250;Taip;0;4;0;4
17076;Svaja;"4 B klasė";3445358104;Taip;0;4;0;4
17077;Svaja;"4 B klasė";8257824129;Taip;0;4;0;4
17078;Svaja;"4 B klasė";15051722330;Ne;0;20;0;20
17079;Svaja;"4 B klasė";9756573320;Ne;0;4;0;4
17080;Svaja;"4 B klasė";5679764500;Ne;0;4;0;4
17081;Svaja;"4 B klasė";2942860075;Taip;0;20;0;20
17082;Svaja;"4 B klasė";7431124365;Taip;0;4;0;4
17083;Svaja;"4 B klasė";9029354129;Ne;0;20;0;20
17084;Svaja;"4 B klasė";4170528723;Taip;0;9;0;9
17085;Svaja;"4 B klasė";1724834986;Taip;0;4;0;4
17086;Svaja;"4 B klasė";2246964964;Taip;0;4;0;4
17087;Svaja;"4 B klasė";9383146218;Taip;0;5;0;5
17088;Svaja;"4 B klasė";7544188561;Taip;0;4;0;4
17089;Svaja;"4 B klasė";4838709655;Taip;0;5;0;5
17090;Svaja;"4 C klasė";24199055534;Taip;0;5;0;5
17091;Svaja;"4 C klasė";4871898511;Taip;0;4;0;4
17092;Svaja;"4 C klasė";6827780228;Ne;0;9;0;9
17093;Svaja;"4 C klasė";3480325745;Taip;0;5;0;5
17094;Svaja;"4 C klasė";5273709766;Taip;0;4;0;4
17095;Svaja;"4 C klasė";4400964054;Taip;0;4;0;4
17096;Svaja;"4 C klasė";1756029299;Taip;0;4;0;4
17097;Svaja;"4 C klasė";3944371247;Taip;0;14;0;14
17098;Svaja;"4 C klasė";5410020482;Taip;0;11;0;11
17099;Svaja;"4 C klasė";8520619615;Taip;0;5;0;5
17100;Svaja;"4 C klasė";8459888164;Taip;0;12;0;12
17101;Svaja;"4 C klasė";1682947310;Taip;0;6;0;6
17102;Svaja;"4 C klasė";3245287315;Taip;0;7;0;7
17103;Svaja;"4 C klasė";3577413686;Taip;0;7;0;7
17104;Svaja;"4 C klasė";6765359935;Taip;0;9;0;9
17105;Svaja;"4 C klasė";6024185313;Taip;0;9;0;9
17106;Svaja;"4 C klasė";6734876523;Taip;0;4;0;4
17107;Svaja;"4 C klasė";8196107158;Taip;0;10;0;10
17108;Svaja;"4 C klasė";2181069343;Taip;0;4;0;4
17109;Svaja;"4 C klasė";7005464407;Taip;0;7;0;7
17110;Svaja;"4 C klasė";9957531674;Taip;0;5;0;5
17111;Svaja;"4 C klasė";2163905715;Taip;0;20;0;20
17112;Svaja;"4 C klasė";5281026613;Taip;0;20;0;20
17113;Svaja;"4 C klasė";7173700967;Taip;0;8;0;8
17114;Svaja;"2 C klasė";4022762780;Taip;0;20;0;20
17115;Svaja;"2 C klasė";5749575112;Taip;0;6;0;6
17116;Svaja;"2 C klasė";8150945946;Taip;0;20;0;20
17117;Svaja;"2 C klasė";1915009909;Taip;0;4;0;4
17118;Svaja;"2 C klasė";4310597965;Taip;0;11;0;11
17119;Svaja;"2 C klasė";8274918664;Taip;0;6;0;6
17120;Svaja;"2 C klasė";4333896021;Taip;0;4;0;4
17121;Svaja;"2 C klasė";5467666579;Taip;0;12;0;12
17122;Svaja;"2 C klasė";5453168902;Taip;0;10;0;10
17123;Svaja;"2 C klasė";1750972673;Taip;0;4;0;4
17124;Svaja;"2 C klasė";5633989310;Taip;0;4;0;4
17125;Svaja;"2 C klasė";4807854408;Taip;0;20;0;20
17126;Svaja;"2 C klasė";9653780566;Taip;0;5;0;5
17127;Svaja;"2 C klasė";8556383911;Ne;0;4;0;4
17128;Svaja;"2 C klasė";5736016717;Taip;0;20;0;20
17129;Svaja;"2 C klasė";6956015602;Taip;0;20;0;20
17130;Svaja;"2 C klasė";4196053724;Taip;0;4;0;4
17131;Svaja;"2 C klasė";6155277279;Ne;0;20;0;20
17132;Svaja;"2 C klasė";6750156163;Taip;0;6;0;6
17133;Svaja;"2 C klasė";3466700144;Taip;0;4;0;4
17134;Svaja;"2 C klasė";9961965117;Taip;0;20;0;20
17135;Svaja;"2 C klasė";4809644609;Taip;0;4;0;4
17136;Svaja;"2 C klasė";1910435736;Taip;0;5;0;5
17137;Svaja;"2 C klasė";5205253544;Taip;0;8;0;8
17138;Svaja;"2 C klasė";6958729265;Taip;0;4;0;4
17139;Šilelis;PAUKŠTELIAI;1048576329;Taip;4;4;1;9
17140;Šilelis;PAUKŠTELIAI;15636728118;Taip;7;0;1;8
17141;Šilelis;PAUKŠTELIAI;79937811039;Taip;0;3;0;3
17142;Šilelis;PAUKŠTELIAI;2478018487;Taip;7;0;0;7
17143;Šilelis;PAUKŠTELIAI;43394471973;Taip;14;1;0;15
17144;Šilelis;PAUKŠTELIAI;78892676375;Ne;13;1;0;14
17145;Šilelis;PAUKŠTELIAI;2033871385;Taip;0;5;0;5
17146;Šilelis;PAUKŠTELIAI;5025537628;Taip;0;1;0;1
17147;Šilelis;PAUKŠTELIAI;8969858170;Taip;10;0;2;12
17148;Šilelis;PAUKŠTELIAI;2078673522;Taip;5;0;2;7
17149;Šilelis;PAUKŠTELIAI;1150836049;Taip;0;2;3;5
17150;Šilelis;PAUKŠTELIAI;33018110830;Taip;0;4;2;6
17151;Šilelis;PAUKŠTELIAI;9756832600;Taip;0;2;0;2
17152;Šilelis;PAUKŠTELIAI;3847912854;Taip;0;0;2;2
17153;Šilelis;PAUKŠTELIAI;38884246104;Taip;5;2;0;7
17154;Šilelis;PAUKŠTELIAI;1610171462;Taip;0;0;2;2
17155;Šilelis;PAUKŠTELIAI;2256130191;Taip;0;0;2;2
17156;Šilelis;PAUKŠTELIAI;8337759186;Taip;20;0;0;20
17157;Šilelis;PAUKŠTELIAI;79806281817;Taip;20;0;0;20
17158;Šilelis;PAUKŠTELIAI;89770278636;Taip;10;0;1;11
17159;Šilelis;SKRUZDELIUKAI;20231469825;Taip;10;0;0;10
17160;Šilelis;SKRUZDELIUKAI;30754812113;Taip;5;0;0;5
17161;Šilelis;SKRUZDELIUKAI;38262299304;Taip;2;3;2;7
17162;Šilelis;SKRUZDELIUKAI;45002017060;Taip;0;17;0;17
17163;Šilelis;SKRUZDELIUKAI;80919252085;Taip;0;7;0;7
17164;Šilelis;SKRUZDELIUKAI;57505829630;Taip;8;0;0;8
17165;Šilelis;SKRUZDELIUKAI;1801211208;Taip;0;0;1;1
17166;Šilelis;SKRUZDELIUKAI;46216564439;Taip;9;0;0;9
17167;Šilelis;SKRUZDELIUKAI;43285060688;Taip;5;4;0;9
17168;Šilelis;SKRUZDELIUKAI;1176917186;Taip;3;1;0;4
17169;Šilelis;SKRUZDELIUKAI;1462541640;Taip;0;1;0;1
17170;Šilelis;SKRUZDELIUKAI;2105377652;Taip;0;1;0;1
17171;Šilelis;SKRUZDELIUKAI;1146878499;Taip;0;0;3;3
17172;Šilelis;SKRUZDELIUKAI;1807785773;Taip;5;2;1;8
17173;Šilelis;SKRUZDELIUKAI;7488080791;Taip;6;0;0;6
17174;Šilelis;SKRUZDELIUKAI;2756742620;Taip;0;0;1;1
17175;Šilelis;SKRUZDELIUKAI;1483339314;Taip;5;5;0;10
17176;Šilelis;SKRUZDELIUKAI;53707043315;Taip;0;1;3;4
17177;Šilelis;SKRUZDELIUKAI;97609897018;Taip;5;4;0;9
17178;Šilelis;SKRUZDELIUKAI;9141446821;Taip;0;1;2;3
17179;Šilelis;SKRUZDELIUKAI;9690607334;Taip;0;3;7;10
17180;Šilelis;SMERFY;2957745091;Taip;0;1;0;1
17181;Šilelis;SMERFY;8471020975;Taip;5;4;4;13
17182;Šilelis;SMERFY;1246899777;Taip;0;8;0;8
17183;Šilelis;SMERFY;93686653078;Taip;5;0;5;10
17184;Šilelis;SMERFY;8980788109;Taip;10;4;0;14
17185;Šilelis;SMERFY;30180586342;Taip;0;0;2;2
17186;Šilelis;SMERFY;7936978436;Taip;11;0;0;11
17187;Šilelis;SMERFY;7126070419;Ne;13;1;0;14
17188;Šilelis;SMERFY;8100789958;Taip;0;1;0;1
17189;Šilelis;SMERFY;6572969153;Taip;7;4;0;11
17190;Šilelis;SMERFY;5036549574;Taip;20;0;0;20
17191;Šilelis;SMERFY;74190923349;Taip;0;5;0;5
17192;Šilelis;SMERFY;5665331529;Taip;1;1;0;2
17193;Šilelis;SMERFY;6773906184;Ne;0;1;0;1
17194;Šilelis;SMERFY;3089270468;Taip;16;0;0;16
17195;Šilelis;SMERFY;7824279279;Ne;0;4;0;4
17196;Šilelis;SMERFY;5496605727;Taip;11;0;1;12
17197;Šilelis;EŽIUKAI;6336168033;Taip;0;0;1;1
17198;Šilelis;EŽIUKAI;8416126751;Taip;15;0;0;15
17199;Šilelis;EŽIUKAI;9266061396;Taip;4;0;0;4
17200;Šilelis;EŽIUKAI;8328948120;Taip;20;0;0;20
17201;Šilelis;EŽIUKAI;6359318134;Taip;9;0;0;9
17202;Šilelis;EŽIUKAI;4494932923;Taip;10;4;0;14
17203;Šilelis;EŽIUKAI;7074963804;Taip;0;3;0;3
17204;Šilelis;EŽIUKAI;7534468539;Taip;16;0;4;20
17205;Šilelis;EŽIUKAI;1165219272;Taip;13;0;0;13
17206;Šilelis;EŽIUKAI;4504627601;Taip;8;0;2;10
17207;Šilelis;EŽIUKAI;3234612149;Taip;20;0;0;20
17208;Šilelis;EŽIUKAI;4702068672;Taip;7;8;5;20
17209;Šilelis;EŽIUKAI;1724976098;Taip;13;2;0;15
17210;Šilelis;EŽIUKAI;5598152793;Taip;11;2;0;13
17211;Šilelis;EŽIUKAI;1586414960;Taip;17;0;0;17
17212;Šilelis;EŽIUKAI;5020209473;Taip;2;0;0;2
17213;Šilelis;EŽIUKAI;2397366916;Taip;16;0;0;16
17214;Šilelis;NYKŠTUKAI;53418739087;Taip;10;0;4;14
17215;Šilelis;NYKŠTUKAI;47822247496;Taip;8;0;1;9
17216;Šilelis;NYKŠTUKAI;26500981786;Taip;3;2;1;6
17217;Šilelis;NYKŠTUKAI;51144587636;Taip;0;3;0;3
17218;Šilelis;NYKŠTUKAI;54390109952;Taip;7;0;0;7
17219;Šilelis;NYKŠTUKAI;23708962006;Taip;9;0;3;12
17220;Šilelis;NYKŠTUKAI;27632618220;Taip;5;1;0;6
17221;Šilelis;NYKŠTUKAI;17041507614;Ne;0;11;0;11
17222;Šilelis;NYKŠTUKAI;46963038100;Taip;10;3;0;13
17223;Šilelis;NYKŠTUKAI;36489228256;Taip;0;11;0;11
17224;Šilelis;NYKŠTUKAI;88867863035;Taip;0;4;0;4
17225;Šilelis;NYKŠTUKAI;11569489731;Taip;5;2;0;7
17226;Šilelis;NYKŠTUKAI;1062766090;Taip;0;2;4;6
17227;Šilelis;NYKŠTUKAI;1740251009;Taip;5;0;2;7
17228;Šilelis;NYKŠTUKAI;1291493034;Taip;4;0;1;5
17229;Šilelis;NYKŠTUKAI;1525689616;Taip;0;13;0;13
17230;Šilelis;NYKŠTUKAI;6000255910;Taip;20;0;0;20
17231;Šilelis;NYKŠTUKAI;96137271177;Taip;0;1;5;6
17232;Šilelis;NYKŠTUKAI;38324408521;Taip;0;0;2;2
17233;Šilelis;ANČIUKAI;6560491835;Taip;0;1;0;1
17234;Šilelis;ANČIUKAI;58760882565;Ne;0;0;1;1
17235;Šilelis;ANČIUKAI;3489973354;Taip;11;0;0;11
17236;Šilelis;ANČIUKAI;13655605764;Taip;3;0;3;6
17237;Šilelis;ANČIUKAI;5489571459;Taip;7;0;0;7
17238;Šilelis;ANČIUKAI;34382940842;Taip;12;2;1;15
17239;Šilelis;ANČIUKAI;942416614;Ne;0;0;1;1
17240;Šilelis;ANČIUKAI;37050806780;Taip;0;4;0;4
17241;Šilelis;ANČIUKAI;1490838609;Taip;6;0;1;7
17242;Šilelis;ANČIUKAI;1621768113;Taip;0;4;0;4
17243;Šilelis;ANČIUKAI;3892886609;Taip;8;0;0;8
17244;Šilelis;ANČIUKAI;1257686463;Taip;6;0;14;20
17245;Šilelis;ANČIUKAI;1633933962;Taip;0;0;6;6
17246;Šilelis;ANČIUKAI;8127562502;Taip;0;7;0;7
17247;Šilelis;ANČIUKAI;7201199871;Taip;0;2;0;2
17248;Šilelis;ANČIUKAI;1766981537;Taip;0;2;0;2
17249;Šilelis;ANČIUKAI;5003717844;Taip;0;0;18;18
17250;Šilelis;KAČIUKAI;60947954575;Taip;0;0;3;3
17251;Šilelis;KAČIUKAI;46602255998;Taip;6;0;0;6
17252;Šilelis;KAČIUKAI;44480420068;Taip;0;0;1;1
17253;Šilelis;KAČIUKAI;23606747301;Taip;7;2;0;9
17254;Šilelis;KAČIUKAI;79896955546;Ne;0;7;0;7
17255;Šilelis;KAČIUKAI;1738220599;Taip;0;5;0;5
17256;Šilelis;KAČIUKAI;29262195378;Taip;7;4;0;11
17257;Šilelis;KAČIUKAI;54739790731;Taip;0;0;2;2
17258;Šilelis;KAČIUKAI;36678503356;Taip;0;1;0;1
17259;Šilelis;KAČIUKAI;1106460550;Taip;5;0;1;6
17260;Šilelis;KAČIUKAI;21170737202;Taip;0;6;0;6
17261;Šilelis;KAČIUKAI;61499715350;Ne;0;3;0;3
17262;Šilelis;KAČIUKAI;56287881538;Taip;0;0;1;1
17263;Šilelis;KAČIUKAI;11738059485;Ne;20;0;0;20
17264;Šilelis;KAČIUKAI;2112799379;Taip;11;1;0;12
17265;Šilelis;KAČIUKAI;56920875808;Taip;0;5;0;5
17266;Šilelis;KAČIUKAI;82621352730;Taip;0;0;2;2
17267;Šilelis;KIŠKUČIAI;62991250307;Taip;10;2;0;12
17268;Šilelis;KIŠKUČIAI;1392455608;Taip;10;0;0;10
17269;Šilelis;KIŠKUČIAI;65917456866;Taip;0;0;1;1
17270;Šilelis;KIŠKUČIAI;193181908;Taip;10;0;0;10
17271;Šilelis;KIŠKUČIAI;21871530266;Taip;14;0;0;14
17272;Šilelis;KIŠKUČIAI;1747920772;Taip;0;0;3;3
17273;Šilelis;KIŠKUČIAI;1904442630;Taip;4;1;0;5
17274;Šilelis;KIŠKUČIAI;1640789816;Taip;8;2;0;10
17275;Šilelis;KIŠKUČIAI;6061033736;Taip;15;4;0;19
17276;Šilelis;KIŠKUČIAI;1976745574;Taip;11;0;0;11
17277;Šilelis;KIŠKUČIAI;88436890881;Taip;10;3;0;13
17278;Šilelis;KIŠKUČIAI;29368876227;Taip;10;0;1;11
17279;Šilelis;KIŠKUČIAI;4580716838;Taip;0;0;3;3
17280;Šilelis;KIŠKUČIAI;8399364170;Taip;10;3;0;13
17281;Šilelis;KIŠKUČIAI;5478094866;Taip;14;0;0;14
17282;Šilelis;KIŠKUČIAI;6096639483;Taip;7;8;5;20
17283;Šilelis;KREGŽDUTĖS;1344825612;Taip;6;0;1;7
17284;Šilelis;KREGŽDUTĖS;3655800765;Taip;10;0;0;10
17285;Šilelis;KREGŽDUTĖS;50209412455;Taip;0;13;0;13
17286;Šilelis;KREGŽDUTĖS;1719681061;Taip;0;2;0;2
17287;Šilelis;KREGŽDUTĖS;2049105004;Taip;7;0;0;7
17288;Šilelis;KREGŽDUTĖS;35712878822;Taip;0;0;5;5
17289;Šilelis;KREGŽDUTĖS;36811772392;Taip;0;1;0;1
17290;Šilelis;KREGŽDUTĖS;1958785859;Taip;0;6;0;6
17291;Šilelis;KREGŽDUTĖS;89194687299;Taip;0;8;0;8
17292;Šilelis;KREGŽDUTĖS;4187993554;Taip;0;1;0;1
17293;Šilelis;KREGŽDUTĖS;1571063782;Taip;9;1;0;10
17294;Šilelis;KREGŽDUTĖS;1930906118;Taip;4;0;0;4
17295;Šilelis;KREGŽDUTĖS;82928837930;Taip;0;8;0;8
17296;Šilelis;KREGŽDUTĖS;5186367833;Taip;2;0;0;2
17297;Šilelis;KREGŽDUTĖS;1984731000;Taip;0;12;0;12
17298;Šilelis;KREGŽDUTĖS;1528581005;Taip;4;0;1;5
17299;Šilelis;KREGŽDUTĖS;40753518660;Taip;0;0;2;2
17300;Šilelis;KREGŽDUTĖS;75274553746;Taip;10;3;0;13
17301;Šilelis;KREGŽDUTĖS;7542121945;Taip;0;2;0;2
17302;Šilelis;KREGŽDUTĖS;20994727549;Taip;9;2;0;11
17303;Šilelis;KREGŽDUTĖS;8915228012;Taip;15;3;0;18
17304;Šilelis;KREGŽDUTĖS;8012626513;Taip;10;0;1;11
17305;Šilelis;PAGRANDUKAI;43259107285;Taip;2;7;0;9
17306;Šilelis;PAGRANDUKAI;8491275729;Taip;2;1;0;3
17307;Šilelis;PAGRANDUKAI;3660152224;Taip;15;0;0;15
17308;Šilelis;PAGRANDUKAI;4814863979;Taip;17;0;0;17
17309;Šilelis;PAGRANDUKAI;9670243727;Taip;11;0;0;11
17310;Šilelis;PAGRANDUKAI;8357287467;Taip;15;3;0;18
17311;Šilelis;PAGRANDUKAI;20525573092;Taip;10;0;0;10
17312;Šilelis;PAGRANDUKAI;1288690113;Taip;6;3;0;9
17313;Šilelis;PAGRANDUKAI;3583955729;Taip;10;4;0;14
17314;Šilelis;PAGRANDUKAI;5324806808;Taip;0;0;2;2
17315;Šilelis;PAGRANDUKAI;8199573104;Taip;16;0;0;16
17316;Šilelis;PAGRANDUKAI;9113098594;Taip;7;0;0;7
17317;Šilelis;PAGRANDUKAI;3485639108;Taip;0;5;0;5
17318;Šilelis;PAGRANDUKAI;1468050550;Taip;5;0;2;7
17319;Šilelis;PAGRANDUKAI;8265212749;Taip;0;3;0;3
17320;Šilelis;PAGRANDUKAI;9081488972;Taip;10;0;0;10
17321;Šilelis;PAGRANDUKAI;55396452032;Taip;2;3;0;5
17322;Šilelis;PAGRANDUKAI;7623203279;Taip;10;2;0;12
17323;Šilelis;PAGRANDUKAI;2397630691;Taip;18;0;0;18
17324;Šilelis;PAGRANDUKAI;3807787648;Taip;12;0;0;12
17325;Šilelis;PAGRANDUKAI;2354942164;Taip;11;0;0;11
17326;Šilelis;BITUTĖS;2948291866;Taip;4;2;0;6
17327;Šilelis;BITUTĖS;4682742121;Taip;14;0;0;14
17328;Šilelis;BITUTĖS;7512731255;Taip;18;0;0;18
17329;Šilelis;BITUTĖS;1268335563;Taip;14;0;0;14
17330;Šilelis;BITUTĖS;4781652156;Taip;14;3;0;17
17331;Šilelis;BITUTĖS;9035595952;Taip;7;0;0;7
17332;Šilelis;BITUTĖS;6104538160;Taip;9;0;0;9
17333;Šilelis;BITUTĖS;3686287802;Taip;10;0;0;10
17334;Šilelis;BITUTĖS;1821827154;Taip;13;0;0;13
17335;Šilelis;BITUTĖS;8271830626;Taip;19;0;0;19
17336;Šilelis;BITUTĖS;1142044361;Taip;14;0;0;14
17337;Šilelis;BITUTĖS;7814807923;Taip;14;0;0;14
17338;Šilelis;BITUTĖS;5305660046;Taip;12;0;0;12
17339;Šilelis;BITUTĖS;9071963194;Taip;16;0;0;16
17340;Šilelis;BITUTĖS;3685607529;Taip;9;0;3;12
17341;Šilelis;BITUTĖS;1306672095;Taip;0;0;3;3
17342;Šilelis;BITUTĖS;6297546907;Taip;0;0;20;20
17343;Šilelis;DRUGELIAI;1877467761;Taip;9;3;0;12
17344;Šilelis;DRUGELIAI;2079073174;Taip;4;0;0;4
17345;Šilelis;DRUGELIAI;3598370884;Taip;3;7;0;10
17346;Šilelis;DRUGELIAI;1618432877;Taip;6;0;1;7
17347;Šilelis;DRUGELIAI;1347150938;Taip;13;0;0;13
17348;Šilelis;DRUGELIAI;7636725161;Taip;0;0;3;3
17349;Šilelis;DRUGELIAI;9256656029;Taip;7;4;0;11
17350;Šilelis;DRUGELIAI;1891388542;Taip;3;1;0;4
17351;Šilelis;DRUGELIAI;5759824196;Taip;11;0;0;11
17352;Šilelis;DRUGELIAI;31906089315;Taip;0;9;0;9
17353;Šilelis;DRUGELIAI;4115738520;Taip;9;0;0;9
17354;Šilelis;DRUGELIAI;3824174896;Taip;9;0;0;9
17355;Šilelis;DRUGELIAI;8090765017;Taip;13;2;0;15
17356;Šilelis;DRUGELIAI;54633547799;Taip;20;0;0;20
17357;Šilelis;DRUGELIAI;9100047520;Taip;7;0;0;7
17358;Šilelis;DRUGELIAI;6201567680;Taip;20;0;0;20
17359;Šilelis;DRUGELIAI;1019874215;Taip;3;1;0;4
17360;Šilelis;DRUGELIAI;5863425750;Taip;14;4;0;18
17361;Šilelis;DRUGELIAI;1448291886;Taip;2;7;0;9
17362;Šilelis;DRUGELIAI;1638362625;Taip;10;0;2;12
17363;Šilelis;DRUGELIAI;9482667810;Taip;9;0;0;9
17364;Šilelis;DRUGELIAI;5379171382;Taip;0;0;1;1
17365;Šilelis;DRUGELIAI;6230566495;Taip;20;0;0;20
17366;Šilelis;DRUGELIAI;6523676718;Taip;5;0;3;8
17367;Vaduvos;PAGRANDUKAI;1431863758;Taip;0;4;0;4
17368;Vaduvos;PAGRANDUKAI;8408017356;Taip;0;6;0;6
17369;Vaduvos;PAGRANDUKAI;72724196791;Taip;15;3;0;18
17370;Vaduvos;PAGRANDUKAI;9371067563;Taip;0;1;0;1
17371;Vaduvos;PAGRANDUKAI;9987311980;Taip;0;8;0;8
17372;Vaduvos;PAGRANDUKAI;6425640531;Taip;5;0;1;6
17373;Vaduvos;PAGRANDUKAI;4029586203;Taip;3;0;0;3
17374;Vaduvos;PAGRANDUKAI;73800920781;Taip;0;4;1;5
17375;Vaduvos;PAGRANDUKAI;18035723255;Taip;5;0;5;10
17376;Vaduvos;PAGRANDUKAI;7397068779;Ne;0;5;0;5
17377;Vaduvos;PAGRANDUKAI;8875709110;Taip;0;6;0;6
17378;Vaduvos;PAGRANDUKAI;4789480822;Taip;11;7;0;18
17379;Vaduvos;PAGRANDUKAI;7305111076;Taip;5;2;0;7
17380;Vaduvos;PAGRANDUKAI;68848152670;Taip;11;0;0;11
17381;Vaduvos;PAGRANDUKAI;4105978403;Taip;0;6;0;6
17382;Vaduvos;PAGRANDUKAI;3111866557;Taip;20;0;0;20
17383;Vaduvos;PAGRANDUKAI;5428067167;Taip;0;2;0;2
17384;Vaduvos;PAGRANDUKAI;3699578284;Taip;12;0;1;13
17385;Vaduvos;KODĖLČIUKAI;53866301875;Ne;19;0;0;19
17386;Vaduvos;KODĖLČIUKAI;67324784528;Taip;0;6;0;6
17387;Vaduvos;KODĖLČIUKAI;78245732319;Taip;5;1;0;6
17388;Vaduvos;KODĖLČIUKAI;17473821556;Taip;0;1;0;1
17389;Vaduvos;KODĖLČIUKAI;41272273463;Taip;3;1;2;6
17390;Vaduvos;KODĖLČIUKAI;1532675814;Taip;0;2;0;2
17391;Vaduvos;KODĖLČIUKAI;33277362439;Ne;6;5;0;11
17392;Vaduvos;KODĖLČIUKAI;27419094487;Taip;3;5;0;8
17393;Vaduvos;KODĖLČIUKAI;61243424057;Taip;0;2;1;3
17394;Vaduvos;KODĖLČIUKAI;81605493207;Taip;1;4;0;5
17395;Vaduvos;KODĖLČIUKAI;36931517006;Taip;0;7;0;7
17396;Vaduvos;KODĖLČIUKAI;90211578805;Taip;0;1;0;1
17397;Vaduvos;KODĖLČIUKAI;2019573643;Taip;0;7;0;7
17398;Vaduvos;KODĖLČIUKAI;42498568346;Taip;5;0;0;5
17399;Vaduvos;KODĖLČIUKAI;96148085691;Taip;0;5;0;5
17400;Vaduvos;KODĖLČIUKAI;2181614424;Taip;5;0;0;5
17401;Vaduvos;KODĖLČIUKAI;97878811046;Taip;5;0;0;5
17402;Vaduvos;KODĖLČIUKAI;89793734700;Taip;0;2;3;5
17403;Vaduvos;KODĖLČIUKAI;48433447683;Taip;0;1;0;1
17404;Vaduvos;KODĖLČIUKAI;32138087379;Taip;0;3;0;3
17405;Vaduvos;SMALSUČIAI;7786986697;Taip;4;1;0;5
17406;Vaduvos;SMALSUČIAI;12330772986;Taip;0;5;0;5
17407;Vaduvos;SMALSUČIAI;25732368565;Taip;0;0;20;20
17408;Vaduvos;SMALSUČIAI;54606265707;Taip;0;9;0;9
17409;Vaduvos;SMALSUČIAI;98259624669;Taip;10;4;0;14
17410;Vaduvos;SMALSUČIAI;8183322974;Taip;0;5;0;5
17411;Vaduvos;SMALSUČIAI;78931952732;Taip;0;4;8;12
17412;Vaduvos;SMALSUČIAI;3632802933;Ne;0;4;0;4
17413;Vaduvos;SMALSUČIAI;1107557891;Ne;10;7;0;17
17414;Vaduvos;SMALSUČIAI;4807104855;Taip;0;4;3;7
17415;Vaduvos;SMALSUČIAI;2605583220;Taip;10;0;0;10
17416;Vaduvos;SMALSUČIAI;54193761898;Taip;1;0;4;5
17417;Vaduvos;SMALSUČIAI;5307128703;Taip;5;0;1;6
17418;Vaduvos;SMALSUČIAI;1139509471;Taip;5;4;1;10
17419;Vaduvos;SMALSUČIAI;13178417729;Taip;6;5;0;11
17420;Vaduvos;SMALSUČIAI;72018210447;Taip;8;6;0;14
17421;Vaduvos;SMALSUČIAI;6121365922;Taip;5;0;3;8
17422;Vaduvos;SMALSUČIAI;62183976729;Taip;14;0;3;17
17423;Vaduvos;GILIUKAI;11202010413;Taip;1;5;0;6
17424;Vaduvos;GILIUKAI;1046867513;Ne;9;0;0;9
17425;Vaduvos;GILIUKAI;4342471835;Taip;1;0;1;2
17426;Vaduvos;GILIUKAI;15757662594;Taip;0;1;0;1
17427;Vaduvos;GILIUKAI;41870343319;Taip;0;7;0;7
17428;Vaduvos;GILIUKAI;97007740148;Taip;0;0;20;20
17429;Vaduvos;GILIUKAI;1464016847;Taip;6;0;3;9
17430;Vaduvos;GILIUKAI;2006018986;Taip;0;5;0;5
17431;Vaduvos;GILIUKAI;46608435244;Taip;10;0;0;10
17432;Vaduvos;GILIUKAI;86095539298;Taip;2;0;3;5
17433;Vaduvos;GILIUKAI;21499108813;Taip;4;1;0;5
17434;Vaduvos;GILIUKAI;59616893535;Taip;14;0;0;14
17435;Vaduvos;GILIUKAI;22641388717;Taip;0;0;2;2
17436;Vaduvos;GILIUKAI;61046090149;Taip;9;0;0;9
17437;Vaduvos;GILIUKAI;87008942241;Taip;13;0;0;13
17438;Vaduvos;GILIUKAI;68937983441;Taip;0;5;0;5
17439;Vaduvos;GILIUKAI;1176603533;Taip;15;0;0;15
17440;Vaduvos;GILIUKAI;1703266825;Taip;2;0;0;2
17441;Vaduvos;GILIUKAI;65843855427;Taip;8;3;0;11
17442;Vaduvos;GILIUKAI;1825188497;Taip;15;0;0;15
17443;Vaduvos;BORUŽĖLĖS;24887196729;Taip;0;4;0;4
17444;Vaduvos;BORUŽĖLĖS;16882774330;Taip;5;5;0;10
17445;Vaduvos;BORUŽĖLĖS;70693742936;Taip;9;0;0;9
17446;Vaduvos;BORUŽĖLĖS;4670249904;Taip;0;0;1;1
17447;Vaduvos;BORUŽĖLĖS;1385184350;Taip;0;0;4;4
17448;Vaduvos;BORUŽĖLĖS;65647119496;Taip;4;0;0;4
17449;Vaduvos;BORUŽĖLĖS;68420568339;Taip;3;0;0;3
17450;Vaduvos;BORUŽĖLĖS;96803174459;Taip;3;7;0;10
17451;Vaduvos;BORUŽĖLĖS;19390879176;Taip;2;0;0;2
17452;Vaduvos;BORUŽĖLĖS;47465933557;Taip;0;5;0;5
17453;Vaduvos;BORUŽĖLĖS;16006064074;Taip;0;1;0;1
17454;Vaduvos;BORUŽĖLĖS;55138588393;Taip;0;6;0;6
17455;Vaduvos;BORUŽĖLĖS;3172047211;Taip;13;0;0;13
17456;Vaduvos;BORUŽĖLĖS;62521006557;Taip;5;0;1;6
17457;Vaduvos;BORUŽĖLĖS;93924290247;Taip;3;3;2;8
17458;Vaduvos;BORUŽĖLĖS;29983824202;Taip;0;1;0;1
17459;Vaduvos;BORUŽĖLĖS;61243200177;Taip;0;4;0;4
17460;Vaduvos;BORUŽĖLĖS;95104294893;Taip;9;0;2;11
17461;Vaduvos;BORUŽĖLĖS;6155494370;Ne;2;4;0;6
17462;Vaduvos;BORUŽĖLĖS;97423576166;Taip;0;11;0;11
17463;Vaduvos;BORUŽĖLĖS;94906586734;Taip;0;6;0;6
17464;Vaduvos;DRUGELIAI;39687066893;Taip;6;0;1;7
17465;Vaduvos;DRUGELIAI;6192828320;Taip;0;5;0;5
17466;Vaduvos;DRUGELIAI;87671358423;Taip;0;7;0;7
17467;Vaduvos;DRUGELIAI;76644896831;Taip;0;6;0;6
17468;Vaduvos;DRUGELIAI;1241148402;Taip;5;0;0;5
17469;Vaduvos;DRUGELIAI;93406851755;Taip;0;0;3;3
17470;Vaduvos;DRUGELIAI;14297366745;Taip;0;7;0;7
17471;Vaduvos;DRUGELIAI;13888236429;Taip;17;0;0;17
17472;Vaduvos;DRUGELIAI;13203715320;Taip;18;0;0;18
17473;Vaduvos;DRUGELIAI;26736566969;Taip;0;0;1;1
17474;Vaduvos;DRUGELIAI;64074141491;Taip;6;9;0;15
17475;Vaduvos;DRUGELIAI;66359913774;Taip;7;5;0;12
17476;Vaduvos;DRUGELIAI;49738318631;Taip;14;0;0;14
17477;Vaduvos;DRUGELIAI;3722349868;Taip;0;7;0;7
17478;Vaduvos;DRUGELIAI;3174998523;Taip;5;0;2;7
17479;Vaduvos;DRUGELIAI;96892752634;Taip;11;0;1;12
17480;Vaduvos;DRUGELIAI;8802765960;Taip;11;0;0;11
17481;Vaduvos;RIEŠUTĖLIAI;9429028460;Taip;6;9;0;15
17482;Vaduvos;RIEŠUTĖLIAI;9072097216;Taip;0;0;1;1
17483;Vaduvos;RIEŠUTĖLIAI;9178907705;Taip;14;0;2;16
17484;Vaduvos;RIEŠUTĖLIAI;6210729584;Taip;0;5;0;5
17485;Vaduvos;RIEŠUTĖLIAI;4365144594;Taip;19;0;0;19
17486;Vaduvos;RIEŠUTĖLIAI;9606193112;Taip;9;0;0;9
17487;Vaduvos;RIEŠUTĖLIAI;9540008495;Taip;1;0;1;2
17488;Vaduvos;RIEŠUTĖLIAI;4177935331;Taip;8;0;0;8
17489;Vaduvos;RIEŠUTĖLIAI;9062135043;Taip;10;3;0;13
17490;Vaduvos;RIEŠUTĖLIAI;1422507884;Taip;19;0;0;19
17491;Vaduvos;RIEŠUTĖLIAI;6810198013;Taip;6;2;0;8
17492;Vaduvos;RIEŠUTĖLIAI;4270137614;Taip;4;1;0;5
17493;Vaduvos;RIEŠUTĖLIAI;3682708061;Taip;19;0;0;19
17494;Vaduvos;RIEŠUTĖLIAI;7181151562;Taip;6;0;0;6
17495;Vaduvos;"1 klasė";96473212525;Taip;0;5;0;5
17496;Vaduvos;"1 klasė";75428164558;Taip;0;4;0;4
17497;Vaduvos;"1 klasė";13721939854;Taip;0;4;0;4
17498;Vaduvos;"1 klasė";35999855339;Taip;0;20;0;20
17499;Vaduvos;"1 klasė";61830127618;Taip;0;4;0;4
17500;Vaduvos;"1 klasė";4591744662;Taip;0;20;0;20
17501;Vaduvos;"1 klasė";9149523910;Taip;0;20;0;20
17502;Vaduvos;"1 klasė";76662161382;Taip;0;10;0;10
17503;Vaduvos;"1 klasė";18300713872;Taip;0;20;0;20
17504;Vaduvos;"1 klasė";1768173501;Taip;0;6;0;6
17505;Vaduvos;"1 klasė";768455288;Ne;0;6;0;6
17506;Vaduvos;"1 klasė";60531886576;Taip;0;4;0;4
17507;Vaduvos;"1 klasė";38462664426;Ne;0;4;0;4
17508;Vaduvos;"1 klasė";63286903462;Taip;0;4;0;4
17509;Vaduvos;"1 klasė";20841176336;Taip;0;4;0;4
17510;Vaduvos;"1 klasė";6049882391;Ne;0;7;0;7
17511;Vaduvos;"1 klasė";38013859931;Taip;0;8;0;8
17512;Vaduvos;"1 klasė";2004208381;Taip;0;4;0;4
17513;Vaduvos;"1 klasė";1821644443;Ne;0;9;0;9
17514;Vaduvos;"1 klasė";26934740147;Taip;0;20;0;20
17515;Vaduvos;"1 klasė";7172286009;Taip;0;8;0;8
17516;Vaduvos;"1 klasė";2029363844;Taip;0;20;0;20
17517;Vaduvos;"1 klasė";8188624118;Ne;0;20;0;20
17518;Vaduvos;"2 klasė";8594896510;Taip;0;9;0;9
17519;Vaduvos;"2 klasė";8009941823;Taip;0;9;0;9
17520;Vaduvos;"2 klasė";1060727236;Taip;0;10;0;10
17521;Vaduvos;"2 klasė";2423925079;Taip;0;20;0;20
17522;Vaduvos;"2 klasė";7410760461;Taip;0;20;0;20
17523;Vaduvos;"2 klasė";6487033699;Taip;0;4;0;4
17524;Vaduvos;"2 klasė";1671409152;Taip;0;4;0;4
17525;Vaduvos;"2 klasė";5072769647;Taip;0;4;0;4
17526;Vaduvos;"2 klasė";4637670260;Taip;0;4;0;4
17527;Vaduvos;"2 klasė";7236550835;Taip;0;4;0;4
17528;Vaduvos;"2 klasė";9372936408;Taip;0;4;0;4
17529;Vaduvos;"2 klasė";7243175751;Taip;0;10;0;10
17530;Vaduvos;"2 klasė";2482212122;Taip;0;4;0;4
17531;Vaduvos;"2 klasė";1982860223;Taip;0;4;0;4
17532;Vaduvos;"2 klasė";4447152355;Taip;0;4;0;4
17533;Vaduvos;"2 klasė";2584358725;Taip;0;11;0;11
17534;Vaduvos;"2 klasė";3325229112;Taip;0;5;0;5
17535;Vaduvos;"2 klasė";5531150399;Taip;0;20;0;20
17536;Vaduvos;"2 klasė";6980440631;Taip;0;4;0;4
17537;Vaduvos;"2 klasė";1091221509;Taip;0;4;0;4
17538;Vaduvos;"2 klasė";7614692200;Taip;0;4;0;4
17539;Vaduvos;"2 klasė";8216757208;Taip;0;20;0;20
17540;Vaduvos;"2 klasė";5459268700;Taip;0;20;0;20
17541;Vaduvos;"2 klasė";5593756016;Taip;0;5;0;5
17542;Vaduvos;"2 klasė";1642242442;Taip;0;9;0;9
17543;Vaduvos;"2 klasė";8928517238;Taip;0;4;0;4
17544;Vaduvos;"2 klasė";5099560123;Taip;0;4;0;4
17545;Vaduvos;"2 klasė";7899239147;Taip;0;4;0;4
17546;Vaduvos;"3 klasė";9644782309;Taip;0;7;0;7
17547;Vaduvos;"3 klasė";7719637673;Taip;0;5;0;5
17548;Vaduvos;"3 klasė";3784730324;Taip;0;4;0;4
17549;Vaduvos;"3 klasė";6964778383;Taip;0;4;0;4
17550;Vaduvos;"3 klasė";1841919654;Taip;0;4;0;4
17551;Vaduvos;"3 klasė";8241399720;Taip;0;4;0;4
17552;Vaduvos;"3 klasė";1086186628;Taip;0;4;0;4
17553;Vaduvos;"3 klasė";7838224919;Ne;0;4;0;4
17554;Vaduvos;"3 klasė";9494193819;Taip;0;20;0;20
17555;Vaduvos;"3 klasė";3755145838;Taip;0;20;0;20
17556;Vaduvos;"3 klasė";2149582337;Taip;0;6;0;6
17557;Vaduvos;"3 klasė";6896561963;Taip;0;11;0;11
17558;Vaduvos;"3 klasė";6748405557;Taip;0;4;0;4
17559;Vaduvos;"3 klasė";5523290081;Taip;0;4;0;4
17560;Vaduvos;"3 klasė";5786723345;Ne;0;6;0;6
17561;Vaduvos;"3 klasė";1730710569;Taip;0;4;0;4
17562;Vaduvos;"3 klasė";1461738157;Taip;0;5;0;5
17563;Vaduvos;"3 klasė";6744521293;Taip;0;14;0;14
17564;Vaduvos;"3 klasė";7786044620;Taip;0;20;0;20
17565;Vaduvos;"3 klasė";4347558872;Taip;0;4;0;4
17566;Vaduvos;"3 klasė";1954540001;Taip;0;8;0;8
17567;Vaduvos;"3 klasė";8801412437;Taip;0;4;0;4
17568;Vaduvos;"3 klasė";3583694770;Taip;0;9;0;9
17569;Vaduvos;"3 klasė";9271050464;Taip;0;4;0;4
17570;Vaduvos;"3 klasė";9441676636;Ne;0;6;0;6
17571;Vaduvos;"4 klasė";6654601642;Taip;0;7;0;7
17572;Vaduvos;"4 klasė";8237000050;Taip;0;5;0;5
17573;Vaduvos;"4 klasė";3145407318;Ne;0;5;0;5
17574;Vaduvos;"4 klasė";3333293097;Taip;0;11;0;11
17575;Vaduvos;"4 klasė";5309061557;Taip;0;7;0;7
17576;Vaduvos;"4 klasė";9693003688;Taip;0;5;0;5
17577;Vaduvos;"4 klasė";6371618427;Taip;0;6;0;6
17578;Vaduvos;"4 klasė";4965870077;Taip;0;20;0;20
17579;Vaduvos;"4 klasė";3290259977;Taip;0;4;0;4
17580;Vaduvos;"4 klasė";7585921384;Taip;0;4;0;4
17581;Vaduvos;"4 klasė";8971158534;Taip;0;5;0;5
17582;Vaduvos;"4 klasė";4629364623;Taip;0;4;0;4
17583;Vaduvos;"4 klasė";4106358850;Taip;0;4;0;4
17584;Vaduvos;"4 klasė";7163757633;Taip;0;5;0;5
17585;Vaduvos;"4 klasė";3710305066;Taip;0;4;0;4
17586;Vaduvos;"4 klasė";8401121977;Taip;0;8;0;8
17587;Vaduvos;"4 klasė";1682529973;Ne;0;20;0;20
17588;Vaduvos;"4 klasė";5094558878;Taip;0;5;0;5
17589;Vaduvos;"4 klasė";1741464526;Taip;0;11;0;11
17590;Vaduvos;"4 klasė";3868511136;Taip;0;4;0;4
17591;Vaduvos;"4 klasė";9224232442;Taip;0;4;0;4
17592;Vaduvos;"4 klasė";6583877755;Taip;0;20;0;20
17593;Vilkpėdės;BORUŽĖLĖS;79390794424;Taip;1;5;0;6
17594;Vilkpėdės;BORUŽĖLĖS;64143309761;Taip;8;1;0;9
17595;Vilkpėdės;BORUŽĖLĖS;34554036711;Ne;0;6;0;6
17596;Vilkpėdės;BORUŽĖLĖS;64276583853;Taip;5;2;0;7
17597;Vilkpėdės;BORUŽĖLĖS;93369779426;Taip;5;0;0;5
17598;Vilkpėdės;BORUŽĖLĖS;18177210107;Taip;0;1;0;1
17599;Vilkpėdės;BORUŽĖLĖS;94327243660;Taip;0;6;0;6
17600;Vilkpėdės;BORUŽĖLĖS;25560685550;Taip;0;3;0;3
17601;Vilkpėdės;BORUŽĖLĖS;69023855545;Taip;5;10;0;15
17602;Vilkpėdės;BORUŽĖLĖS;72601980553;Taip;11;2;0;13
17603;Vilkpėdės;BORUŽĖLĖS;40684269684;Taip;0;4;0;4
17604;Vilkpėdės;BORUŽĖLĖS;70459205616;Taip;5;0;0;5
17605;Vilkpėdės;BORUŽĖLĖS;18795042529;Taip;10;0;0;10
17606;Vilkpėdės;BORUŽĖLĖS;18926013798;Taip;10;1;0;11
17607;Vilkpėdės;BORUŽĖLĖS;1468040255;Taip;0;5;0;5
17608;Vilkpėdės;BORUŽĖLĖS;73735463059;Taip;5;0;0;5
17609;Vilkpėdės;BORUŽĖLĖS;12155790021;Taip;0;6;0;6
17610;Vilkpėdės;SKRUZDĖLIUKAI;32683398503;Taip;0;7;0;7
17611;Vilkpėdės;SKRUZDĖLIUKAI;41394645789;Taip;3;7;0;10
17612;Vilkpėdės;SKRUZDĖLIUKAI;61457409195;Taip;3;4;0;7
17613;Vilkpėdės;SKRUZDĖLIUKAI;90226911248;Taip;0;7;0;7
17614;Vilkpėdės;SKRUZDĖLIUKAI;73812058890;Taip;8;9;0;17
17615;Vilkpėdės;SKRUZDĖLIUKAI;18860888473;Taip;0;6;0;6
17616;Vilkpėdės;SKRUZDĖLIUKAI;19719432462;Taip;11;0;0;11
17617;Vilkpėdės;SKRUZDĖLIUKAI;70184817311;Taip;7;0;1;8
17618;Vilkpėdės;SKRUZDĖLIUKAI;93775558547;Taip;17;0;0;17
17619;Vilkpėdės;SKRUZDĖLIUKAI;90816091771;Taip;0;4;0;4
17620;Vilkpėdės;SKRUZDĖLIUKAI;26983231264;Taip;19;0;0;19
17621;Vilkpėdės;SKRUZDĖLIUKAI;89124218945;Taip;1;1;0;2
17622;Vilkpėdės;SKRUZDĖLIUKAI;21841574426;Taip;3;8;0;11
17623;Vilkpėdės;SKRUZDĖLIUKAI;89601406730;Taip;7;0;0;7
17624;Vilkpėdės;SKRUZDĖLIUKAI;81712437117;Taip;5;0;0;5
17625;Vilkpėdės;SKRUZDĖLIUKAI;60687258266;Taip;10;2;0;12
17626;Vilkpėdės;SKRUZDĖLIUKAI;95408044297;Taip;14;0;0;14
17627;Vilkpėdės;SKRUZDĖLIUKAI;58037049872;Taip;0;12;0;12
17628;Vilkpėdės;SKRUZDĖLIUKAI;63180329851;Ne;0;7;0;7
17629;Vilkpėdės;SKRUZDĖLIUKAI;3001209213;Taip;5;1;0;6
17630;Vilkpėdės;SKRUZDĖLIUKAI;95615604947;Taip;2;2;0;4
17631;Vilkpėdės;SKRUZDĖLIUKAI;25846393751;Taip;10;1;0;11
17632;Vilkpėdės;SKRUZDĖLIUKAI;33842357499;Taip;5;8;0;13
17633;Vilkpėdės;SKRUZDĖLIUKAI;64155507543;Taip;9;0;0;9
17634;Vilkpėdės;"1 klasė";61833757576;Taip;3;6;0;9
17635;Vilkpėdės;"1 klasė";88279045901;Taip;3;6;0;9
17636;Vilkpėdės;"1 klasė";78547386756;Taip;0;6;0;6
17637;Vilkpėdės;"1 klasė";66451097025;Taip;6;6;0;12
17638;Vilkpėdės;"1 klasė";45308906788;Taip;1;6;0;7
17639;Vilkpėdės;"1 klasė";31260025568;Taip;9;6;0;15
17640;Vilkpėdės;"1 klasė";1636921006;Ne;1;6;0;7
17641;Vilkpėdės;"1 klasė";51286525404;Taip;2;6;0;8
17642;Vilkpėdės;"1 klasė";90217345315;Taip;0;6;0;6
17643;Vilkpėdės;"1 klasė";37450374921;Taip;5;6;0;11
17644;Vilkpėdės;"1 klasė";25167535799;Taip;7;6;0;13
17645;Vilkpėdės;"1 klasė";79269485254;Taip;2;6;0;8
17646;Vilkpėdės;"1 klasė";1032216128;Taip;5;6;0;11
17647;Vilkpėdės;"1 klasė";49513181091;Taip;2;6;0;8
17648;Vilkpėdės;"1 klasė";64216245300;Taip;2;6;0;8
17649;Vilkpėdės;"1 klasė";64898472080;Taip;1;6;0;7
17650;Vilkpėdės;"1 klasė";2806307083;Taip;2;6;0;8
17651;Vilkpėdės;DRUGELIAI;2420271759;Taip;20;0;0;20
17652;Vilkpėdės;DRUGELIAI;9294350205;Taip;15;0;0;15
17653;Vilkpėdės;DRUGELIAI;2377248778;Taip;13;0;0;13
17654;Vilkpėdės;DRUGELIAI;7698759895;Taip;0;4;0;4
17655;Vilkpėdės;DRUGELIAI;3351309750;Taip;0;0;2;2
17656;Vilkpėdės;DRUGELIAI;1019057127;Taip;12;0;0;12
17657;Vilkpėdės;DRUGELIAI;1807884737;Taip;20;0;0;20
17658;Vilkpėdės;DRUGELIAI;9894466439;Taip;6;0;0;6
17659;Vilkpėdės;DRUGELIAI;9460356725;Taip;9;0;0;9
17660;Vilkpėdės;DRUGELIAI;8015392054;Taip;5;0;0;5
17661;Vilkpėdės;DRUGELIAI;8693750994;Taip;20;0;0;20
17662;Vilkpėdės;DRUGELIAI;2320350937;Taip;6;8;0;14
17663;Vilkpėdės;DRUGELIAI;7795186132;Taip;7;0;0;7
17664;Vilkpėdės;DRUGELIAI;6762306583;Taip;14;0;2;16
17665;Vilkpėdės;DRUGELIAI;8581661608;Taip;1;0;0;1
17666;Vilkpėdės;DRUGELIAI;6261547304;Taip;6;0;0;6
17667;Vilkpėdės;ŽIOGELIAI;2065010940;Taip;0;10;0;10
17668;Vilkpėdės;ŽIOGELIAI;1052719398;Taip;5;4;0;9
17669;Vilkpėdės;ŽIOGELIAI;1145968615;Taip;5;5;0;10
17670;Vilkpėdės;ŽIOGELIAI;1598018406;Taip;5;1;1;7
17671;Vilkpėdės;ŽIOGELIAI;55747681017;Taip;5;0;3;8
17672;Vilkpėdės;ŽIOGELIAI;1136036746;Taip;6;1;0;7
17673;Vilkpėdės;ŽIOGELIAI;51976067616;Taip;4;1;1;6
17674;Vilkpėdės;ŽIOGELIAI;73470824566;Taip;2;0;4;6
17675;Vilkpėdės;ŽIOGELIAI;40385792431;Taip;0;4;0;4
17676;Vilkpėdės;ŽIOGELIAI;72227817278;Taip;11;0;0;11
17677;Vilkpėdės;ŽIOGELIAI;1042000830;Taip;0;0;1;1
17678;Vilkpėdės;ŽIOGELIAI;1527272055;Ne;0;6;0;6
17679;Vilkpėdės;ŽIOGELIAI;1384224802;Taip;0;1;0;1
17680;Vilkpėdės;ŽIOGELIAI;25008201566;Taip;11;0;2;13
17681;Vilkpėdės;ŽIOGELIAI;9393571483;Taip;6;7;1;14
17682;Vilkpėdės;BITUTĖS;9605399822;Taip;5;9;0;14
17683;Vilkpėdės;BITUTĖS;9589862809;Taip;14;0;0;14
17684;Vilkpėdės;BITUTĖS;7875898177;Taip;3;2;0;5
17685;Vilkpėdės;BITUTĖS;3935245964;Taip;5;9;0;14
17686;Vilkpėdės;BITUTĖS;9867411687;Taip;5;1;0;6
17687;Vilkpėdės;BITUTĖS;4735164204;Taip;17;0;0;17
17688;Vilkpėdės;BITUTĖS;46561435465;Taip;11;1;0;12
17689;Vilkpėdės;BITUTĖS;48059844727;Taip;5;1;0;6
17690;Vilkpėdės;BITUTĖS;1195392132;Taip;14;0;0;14
17691;Vilkpėdės;BITUTĖS;7634355147;Taip;5;0;0;5
17692;Vilkpėdės;BITUTĖS;4392760215;Taip;0;9;0;9
17693;Vilkpėdės;BITUTĖS;2955411131;Taip;15;2;0;17
17694;Vilkpėdės;BITUTĖS;2736368118;Taip;11;1;0;12
17695;Vilkpėdės;BITUTĖS;4515945951;Taip;11;0;0;11
17696;Vilkpėdės;BITUTĖS;2900581406;Taip;2;1;0;3
17697;Vilkpėdės;BITUTĖS;7527929277;Taip;9;0;0;9
17698;Vilkpėdės;BITUTĖS;8865545376;Taip;4;4;0;8
17699;Vilkpėdės;BITUTĖS;4276158771;Taip;5;4;0;9
17700;Vilkpėdės;BITUTĖS;7889480219;Taip;0;5;0;5
17701;Vilkpėdės;BITUTĖS;8128254701;Taip;12;0;2;14
17702;Vilkpėdės;"2 klasė";4562930821;Ne;1;6;0;7
17703;Vilkpėdės;"2 klasė";4450490805;Ne;0;6;0;6
17704;Vilkpėdės;"2 klasė";5753361387;Ne;0;6;0;6
17705;Vilkpėdės;"2 klasė";3330174377;Ne;0;6;0;6
17706;Vilkpėdės;"2 klasė";7678586010;Ne;0;6;0;6
17707;Vilkpėdės;"2 klasė";9422266523;Ne;0;9;0;9
17708;Vilkpėdės;"2 klasė";7567054902;Ne;0;6;0;6
17709;Vilkpėdės;"2 klasė";1894949069;Ne;1;6;0;7
17710;Vilkpėdės;"2 klasė";6750171948;Ne;0;9;0;9
17711;Vilkpėdės;"2 klasė";2877690064;Ne;0;6;0;6
17712;Vilkpėdės;"2 klasė";4975532783;Ne;1;6;0;7
17713;Vilkpėdės;"2 klasė";3096541013;Ne;0;6;0;6
17714;Vilkpėdės;"2 klasė";4467711387;Ne;3;6;0;9
17715;Vilkpėdės;"2 klasė";6334059519;Ne;0;7;0;7
17716;Vilkpėdės;"3 klasė";1827316635;Ne;8;6;0;14
17717;Vilkpėdės;"3 klasė";5788552120;Ne;6;6;0;12
17718;Vilkpėdės;"3 klasė";3008839195;Ne;0;6;0;6
17719;Vilkpėdės;"3 klasė";2097704371;Ne;3;6;0;9
17720;Vilkpėdės;"3 klasė";5948799757;Ne;0;6;0;6
17721;Vilkpėdės;"3 klasė";7851213782;Ne;0;6;0;6
17722;Vilkpėdės;"3 klasė";8214989068;Ne;0;6;0;6
17723;Vilkpėdės;"3 klasė";6408620430;Ne;4;6;0;10
17724;Vilkpėdės;"3 klasė";2407908295;Ne;0;6;0;6
17725;Vilkpėdės;"3 klasė";6786266832;Ne;5;6;0;11
17726;Vilkpėdės;"4 klasė";5691976624;Ne;1;6;0;7
17727;Vilkpėdės;"4 klasė";5064616447;Ne;0;6;0;6
17728;Vilkpėdės;"4 klasė";5959800100;Ne;0;6;0;6
17729;Vilkpėdės;"4 klasė";9264492438;Ne;0;7;0;7
17730;Vilkpėdės;"4 klasė";4656816734;Ne;2;6;0;8
17731;Vilkpėdės;"4 klasė";3688858757;Ne;1;11;0;12
17732;Vilkpėdės;"4 klasė";5115595730;Ne;0;7;0;7
17733;Vilkpėdės;"4 klasė";5877781210;Ne;0;6;0;6
17734;Vilkpėdės;"4 klasė";6917717899;Ne;0;8;0;8
17735;Vilkpėdės;"4 klasė";4672603333;Ne;10;6;0;16
17736;Vilkpėdės;"4 klasė";9436443664;Ne;2;6;0;8
17737;Vilkpėdės;"4 klasė";5522788819;Ne;0;7;0;7
17738;Vilkpėdės;"4 klasė";1115530668;Ne;0;6;0;6
17739;Vilkpėdės;"4 klasė";6851966570;Ne;0;6;0;6
17740;Vilkpėdės;"4 klasė";5191937870;Ne;0;6;0;6
17741;Vilkpėdės;"4 klasė";9953554437;Taip;1;6;0;7
17742;Žiburėlis;Nykštukai;45509849089;Taip;6;3;0;9
17743;Žiburėlis;Nykštukai;32837087738;Taip;0;5;0;5
17744;Žiburėlis;Nykštukai;57892276898;Taip;8;1;2;11
17745;Žiburėlis;Nykštukai;87417486808;Taip;10;4;0;14
17746;Žiburėlis;Nykštukai;82679341920;Taip;9;0;0;9
17747;Žiburėlis;Nykštukai;73054546792;Taip;0;3;0;3
17748;Žiburėlis;Nykštukai;98670272543;Taip;8;6;0;14
17749;Žiburėlis;Nykštukai;61148040564;Taip;0;2;0;2
17750;Žiburėlis;Nykštukai;77674964341;Taip;9;0;0;9
17751;Žiburėlis;Nykštukai;16215414453;Taip;0;3;0;3
17752;Žiburėlis;Nykštukai;16721946185;Taip;1;0;0;1
17753;Žiburėlis;Nykštukai;58253869146;Taip;8;6;0;14
17754;Žiburėlis;Nykštukai;49081936325;Taip;0;8;0;8
17755;Žiburėlis;Nykštukai;25826760783;Taip;11;1;0;12
17756;Žiburėlis;Nykštukai;78861342608;Taip;10;0;0;10
17757;Žiburėlis;Nykštukai;50484332477;Taip;0;1;0;1
17758;Žiburėlis;Nykštukai;90296810303;Taip;2;0;0;2
17759;Žiburėlis;Nykštukai;13256396372;Taip;5;1;0;6
17760;Žiburėlis;Nykštukai;78896331135;Taip;0;1;0;1
17761;Žiburėlis;Nykštukai;68423991252;Taip;0;8;0;8
17762;Žiburėlis;Nykštukai;7135920347;Taip;0;11;0;11
17763;Žiburėlis;Nykštukai;1133294157;Taip;8;4;0;12
17764;Žiburėlis;Nykštukai;25079486133;Taip;0;1;0;1
17765;Žiburėlis;Nykštukai;9918037209;Taip;7;2;0;9
17766;Žiburėlis;"Žiniukai ";18125169377;Taip;5;0;0;5
17767;Žiburėlis;"Žiniukai ";29552486526;Taip;0;20;0;20
17768;Žiburėlis;"Žiniukai ";92036821482;Taip;7;0;0;7
17769;Žiburėlis;"Žiniukai ";70925677727;Taip;12;2;0;14
17770;Žiburėlis;"Žiniukai ";1858285649;Taip;0;2;0;2
17771;Žiburėlis;"Žiniukai ";41774939326;Taip;0;1;0;1
17772;Žiburėlis;"Žiniukai ";5412445634;Taip;6;0;0;6
17773;Žiburėlis;"Žiniukai ";1673061718;Taip;15;0;0;15
17774;Žiburėlis;"Žiniukai ";4454602197;Taip;3;0;0;3
17775;Žiburėlis;"Žiniukai ";6517292491;Taip;4;10;0;14
17776;Žiburėlis;"Žiniukai ";70987307796;Taip;4;0;1;5
17777;Žiburėlis;"Žiniukai ";74200469110;Ne;0;6;0;6
17778;Žiburėlis;"Žiniukai ";19010380383;Taip;6;0;0;6
17779;Žiburėlis;"Smalsiukai ";5914668910;Ne;13;0;0;13
17780;Žiburėlis;"Smalsiukai ";1673873271;Ne;3;5;0;8
17781;Žiburėlis;"Smalsiukai ";3128936681;Ne;5;5;0;10
17782;Žiburėlis;"Smalsiukai ";31082738591;Taip;11;0;0;11
17783;Žiburėlis;"Smalsiukai ";6669203205;Ne;0;1;0;1
17784;Žiburėlis;"Smalsiukai ";78850854161;Taip;4;1;0;5
17785;Žiburėlis;"Smalsiukai ";95216886081;Taip;0;3;0;3
17786;Žiburėlis;"Smalsiukai ";37375035477;Taip;0;1;0;1
17787;Žiburėlis;"Smalsiukai ";54487369856;Taip;0;2;0;2
17788;Žiburėlis;"Smalsiukai ";81892440397;Taip;7;1;0;8
17789;Žiburėlis;"Smalsiukai ";89219215887;Taip;7;1;0;8
17790;Žiburėlis;"Smalsiukai ";1483522393;Taip;8;0;0;8
17791;Žiburėlis;"Smalsiukai ";93584914250;Taip;13;0;0;13
17792;Žiburėlis;"Smalsiukai ";58094756644;Taip;0;7;0;7
17793;Žiburėlis;"Giliukai ";52216192635;Taip;17;0;0;17
17794;Žiburėlis;"Giliukai ";4355778076;Taip;7;1;0;8
17795;Žiburėlis;"Giliukai ";92490398630;Taip;6;1;0;7
17796;Žiburėlis;"Giliukai ";67168630669;Taip;5;7;0;12
17797;Žiburėlis;"Giliukai ";3867540155;Taip;3;0;0;3
17798;Žiburėlis;"Giliukai ";7578655857;Taip;0;15;0;15
17799;Žiburėlis;"Giliukai ";75538036055;Taip;0;5;0;5
17800;Žiburėlis;"Giliukai ";9253393819;Taip;2;2;0;4
17801;Žiburėlis;"Giliukai ";8677998615;Taip;8;0;0;8
17802;Žiburėlis;"Giliukai ";2796489509;Taip;14;2;0;16
17803;Žiburėlis;"Giliukai ";18739941845;Taip;0;2;0;2
17804;Žiburėlis;"Giliukai ";24639355056;Taip;0;8;0;8
17805;Žiburėlis;"Giliukai ";1842029645;Taip;8;0;0;8
17806;Žiburėlis;"Giliukai ";6519139977;Taip;20;0;0;20
17807;Žiburėlis;"Giliukai ";7861704875;Taip;14;0;0;14
17808;Žiburėlis;"Giliukai ";34873231652;Taip;3;1;0;4
17809;Žiburėlis;"Giliukai ";1125662904;Taip;19;0;0;19
17810;Žiburėlis;"Giliukai ";2175751377;Taip;0;0;1;1
17811;Žiburėlis;"Giliukai ";8531121002;Taip;20;0;0;20
17812;Žiburėlis;"Giliukai ";28985997205;Taip;15;0;0;15
17813;Žiburėlis;"1 klasė";1551527192;Ne;2;0;0;2
17814;Žiburėlis;"1 klasė";9177048702;Taip;0;20;0;20
17815;Žiburėlis;"1 klasė";83887875309;Taip;7;0;0;7
17816;Žiburėlis;"1 klasė";78965453247;Ne;9;0;0;9
17817;Žiburėlis;"1 klasė";19924188057;Taip;5;0;0;5
17818;Žiburėlis;"1 klasė";56929631997;Taip;5;0;0;5
17819;Žiburėlis;"1 klasė";10039457828;Taip;1;0;0;1
17820;Žiburėlis;"1 klasė";33877368082;Taip;3;0;0;3
17821;Žiburėlis;"1 klasė";23334642950;Taip;7;0;0;7
17822;Žiburėlis;"1 klasė";91397954329;Taip;2;0;0;2
17823;Žiburėlis;"1 klasė";3462265950;Taip;0;20;0;20
17824;Žiburėlis;Meškiukai;7070952018;Taip;0;2;0;2
17825;Žiburėlis;Meškiukai;38096163093;Taip;5;1;0;6
17826;Žiburėlis;Meškiukai;96004573835;Taip;7;3;0;10
17827;Žiburėlis;Meškiukai;549348368;Taip;0;12;0;12
17828;Žiburėlis;Meškiukai;2270893326;Taip;0;7;0;7
17829;Žiburėlis;Meškiukai;1728059994;Taip;13;0;0;13
17830;Žiburėlis;Meškiukai;9069606713;Taip;3;2;0;5
17831;Žiburėlis;Meškiukai;3678560815;Taip;4;2;0;6
17832;Žiburėlis;Meškiukai;57749440744;Taip;7;0;0;7
17833;Žiburėlis;Meškiukai;1614403409;Taip;5;3;0;8
17834;Žiburėlis;Meškiukai;808556747;Taip;0;14;0;14
17835;Žiburėlis;Meškiukai;43206636255;Taip;4;0;0;4
17836;Žiburėlis;Meškiukai;60150682872;Taip;0;5;0;5
17837;Žiburėlis;Meškiukai;50869669391;Taip;8;2;0;10
17838;Žiburėlis;Meškiukai;30337030701;Taip;0;2;0;2
17839;Žiburėlis;Meškiukai;1612968712;Taip;0;2;0;2
17840;Žiburėlis;Meškiukai;5495813195;Taip;13;6;0;19
17841;Žiburėlis;Meškiukai;42442737710;Taip;0;4;0;4
17842;Žiburėlis;Viščiukai;7402647048;Taip;15;0;0;15
17843;Žiburėlis;Viščiukai;8215816053;Taip;0;10;0;10
17844;Žiburėlis;Viščiukai;9352485231;Taip;7;1;0;8
17845;Žiburėlis;Viščiukai;4710995351;Taip;20;0;0;20
17846;Žiburėlis;Viščiukai;3646988912;Taip;19;0;0;19
17847;Žiburėlis;Viščiukai;7633450988;Taip;7;0;0;7
17848;Žiburėlis;Viščiukai;2292895729;Taip;14;0;0;14
17849;Žiburėlis;Viščiukai;1411830789;Taip;0;3;0;3
17850;Žiburėlis;Viščiukai;7273838695;Taip;0;3;0;3
17851;Žiburėlis;Viščiukai;5098955523;Taip;19;0;0;19
17852;Žiburėlis;Viščiukai;6250610187;Taip;0;7;0;7
17853;Žiburėlis;Viščiukai;5629404179;Taip;20;0;0;20
17854;Žiburėlis;Viščiukai;9806454408;Taip;3;1;0;4
17855;Žiburėlis;Viščiukai;1764592065;Taip;1;0;0;1
17856;Žiburėlis;Viščiukai;8686565770;Taip;5;2;0;7
17857;Žiburėlis;Viščiukai;6696156248;Taip;13;4;0;17
17858;Žiburėlis;Viščiukai;3938379566;Taip;19;0;0;19
17859;Žiburėlis;Viščiukai;5556807335;Taip;4;0;0;4
17860;Žiburėlis;"Drambliukai ";8902837168;Taip;1;0;0;1
17861;Žiburėlis;"Drambliukai ";7862546963;Taip;1;0;0;1
17862;Žiburėlis;"Drambliukai ";8535429783;Taip;0;5;0;5
17863;Žiburėlis;"Drambliukai ";9670396828;Taip;20;0;0;20
17864;Žiburėlis;"Drambliukai ";1720078356;Taip;11;0;0;11
17865;Žiburėlis;"Drambliukai ";5517458323;Taip;10;0;0;10
17866;Žiburėlis;"Drambliukai ";2982016133;Taip;5;1;0;6
17867;Žiburėlis;"Drambliukai ";7424129974;Taip;0;8;0;8
17868;Žiburėlis;"Drambliukai ";5816890413;Taip;12;2;0;14
17869;Žiburėlis;"Drambliukai ";9336617879;Taip;0;1;0;1
17870;Žiburėlis;"Drambliukai ";2928528630;Taip;15;0;0;15
17871;Žiburėlis;"Drambliukai ";8109335587;Taip;0;2;0;2
17872;Žiburėlis;"Drambliukai ";4187381976;Taip;20;0;0;20
17873;Žiburėlis;"Drambliukai ";2624326930;Taip;0;3;0;3
17874;Žiburėlis;"Drambliukai ";6300247811;Taip;6;3;0;9
17875;Žiburėlis;"Drambliukai ";3033049328;Taip;0;5;0;5
17876;Žiburėlis;"Drambliukai ";3687703187;Taip;0;1;0;1
17877;Žiburėlis;"Drambliukai ";1876645582;Taip;5;0;0;5
17878;Žiburėlis;"Drambliukai ";5006361324;Taip;5;5;0;10
17879;Žiburėlis;"Drambliukai ";5303511810;Taip;13;0;0;13
17880;Žiburėlis;"Drambliukai ";3262856058;Taip;0;10;0;10
17881;Žiburėlis;"Drambliukai ";7211961512;Taip;1;4;0;5
17882;Žiburėlis;"2 klasė";5587135070;Ne;9;0;0;9
17883;Žiburėlis;"2 klasė";5154752431;Ne;8;0;0;8
17884;Žiburėlis;"2 klasė";6555937866;Ne;3;0;0;3
17885;Žiburėlis;"2 klasė";6532799193;Ne;6;0;0;6
17886;Žiburėlis;"2 klasė";8108287017;Ne;0;20;0;20
17887;Žiburėlis;"2 klasė";8967516850;Ne;6;0;0;6
17888;Žiburėlis;"2 klasė";5730454385;Ne;14;0;0;14
17889;Žiburėlis;"2 klasė";7420310542;Ne;11;0;0;11
17890;Žiburėlis;"2 klasė";9030168070;Ne;5;0;0;5
17891;Žiburėlis;"2 klasė";1040139766;Ne;2;0;0;2
17892;Žiburėlis;"2 klasė";2895056046;Ne;6;0;0;6
17893;Žiburėlis;"2 klasė";7244452816;Ne;5;0;0;5
17894;Žiburėlis;"3 klasė";8539444386;Ne;1;0;0;1
17895;Žiburėlis;"3 klasė";9676316394;Ne;2;0;0;2
17896;Žiburėlis;"3 klasė";8942909201;Ne;1;0;0;1
17897;Žiburėlis;"3 klasė";6088424692;Ne;0;24;0;24
17898;Žiburėlis;"3 klasė";3493549126;Ne;0;24;0;24
17899;Žiburėlis;"3 klasė";4444164248;Ne;9;0;0;9
17900;Žiburėlis;"3 klasė";8755335337;Ne;0;24;0;24
17901;Žiburėlis;"3 klasė";5999075406;Ne;0;24;0;24
17902;Žiburėlis;"3 klasė";6548933505;Ne;4;0;0;4
17903;Žiburėlis;"3 klasė";9803636658;Ne;0;24;0;24
17904;Žiburėlis;"4 klasė";9952387998;Ne;1;0;0;1
17905;Žiburėlis;"4 klasė";8525158050;Ne;5;0;0;5
17906;Žiburėlis;"4 klasė";6800376566;Ne;2;0;0;2
17907;Žiburėlis;"4 klasė";6362934592;Ne;0;24;0;24
17908;Žiburėlis;"4 klasė";8758526732;Ne;0;24;0;24
17909;Žiburėlis;"4 klasė";2638686151;Ne;1;0;0;1
17910;Žiburėlis;"4 klasė";4067505776;Ne;1;0;0;1
17911;Žiburėlis;"4 klasė";6388681440;Ne;1;0;0;1
17912;Žiburėlis;"4 klasė";5014047026;Ne;5;0;0;5
17913;Žiburėlis;"4 klasė";4827287214;Ne;0;0;1;1
17914;Žiburėlis;"4 klasė";8711998371;Ne;3;0;0;3
17915;Žiburėlis;"4 klasė";2354284014;Ne;0;24;0;24
17916;Justinukas;SMALSUČIŲ;7005815238;Taip;20;0;0;20
17917;Justinukas;SMALSUČIŲ;13170636069;Taip;0;6;1;7
17918;Justinukas;SMALSUČIŲ;3118698712;Taip;6;10;0;16
17919;Justinukas;SMALSUČIŲ;3312575449;Taip;0;2;0;2
17920;Justinukas;SMALSUČIŲ;1773690115;Taip;5;2;3;10
17921;Justinukas;SMALSUČIŲ;1121936989;Taip;8;0;0;8
17922;Justinukas;SMALSUČIŲ;46705419124;Taip;9;2;0;11
17923;Justinukas;SMALSUČIŲ;49343952061;Taip;3;13;0;16
17924;Justinukas;SMALSUČIŲ;8741735734;Taip;19;0;0;19
17925;Justinukas;SMALSUČIŲ;8529082669;Taip;12;3;0;15
17926;Justinukas;SMALSUČIŲ;7678062264;Taip;11;9;0;20
17927;Justinukas;SMALSUČIŲ;1830060403;Taip;14;1;0;15
17928;Justinukas;SMALSUČIŲ;6597383913;Taip;13;0;0;13
17929;Justinukas;SMALSUČIŲ;67366895767;Taip;4;7;0;11
17930;Justinukas;SMALSUČIŲ;9349373645;Taip;0;1;0;1
17931;Justinukas;SMALSUČIŲ;8848775795;Taip;7;0;0;7
17932;Justinukas;SMALSUČIŲ;3062444365;Taip;9;0;0;9
17933;Justinukas;SMALSUČIŲ;93600065957;Taip;17;0;0;17
17934;Justinukas;SMALSUČIŲ;2317566323;Taip;13;0;0;13
17935;Justinukas;SMALSUČIŲ;1704933971;Taip;14;0;1;15
17936;Justinukas;SVAJOKLIŲ;9822696769;Taip;0;13;0;13
17937;Justinukas;SVAJOKLIŲ;34905919221;Taip;7;1;0;8
17938;Justinukas;SVAJOKLIŲ;1627717901;Taip;7;2;0;9
17939;Justinukas;SVAJOKLIŲ;6234625191;Taip;2;1;0;3
17940;Justinukas;SVAJOKLIŲ;752609119;Taip;3;4;0;7
17941;Justinukas;SVAJOKLIŲ;5225263863;Taip;0;5;0;5
17942;Justinukas;SVAJOKLIŲ;3863971540;Taip;0;4;0;4
17943;Justinukas;SVAJOKLIŲ;43527855441;Taip;0;6;0;6
17944;Justinukas;SVAJOKLIŲ;16029286933;Taip;0;6;0;6
17945;Justinukas;SVAJOKLIŲ;8971898312;Taip;0;20;0;20
17946;Justinukas;SVAJOKLIŲ;48101258124;Taip;0;1;0;1
17947;Justinukas;SVAJOKLIŲ;1216138998;Taip;0;4;0;4
17948;Justinukas;SVAJOKLIŲ;7316804839;Taip;5;0;0;5
17949;Justinukas;SVAJOKLIŲ;3790209561;Taip;20;0;0;20
17950;Justinukas;SVAJOKLIŲ;9558483512;Taip;5;5;0;10
17951;Justinukas;SVAJOKLIŲ;1814943669;Taip;7;5;0;12
17952;Justinukas;SVAJOKLIŲ;37288931495;Taip;0;5;0;5
17953;Justinukas;SVAJOKLIŲ;8636869322;Taip;20;0;0;20
17954;Justinukas;SVAJOKLIŲ;6766493175;Taip;12;2;0;14
17955;Justinukas;SVAJOKLIŲ;5494500249;Taip;12;2;0;14
17956;Justinukas;SVAJOKLIŲ;6816901962;Taip;7;7;0;14
17957;Justinukas;SVAJOKLIŲ;3657642693;Taip;4;6;0;10
17958;Justinukas;"SAULĖS ZUIKIŲ";1550323727;Taip;5;1;0;6
17959;Justinukas;"SAULĖS ZUIKIŲ";40999006978;Taip;0;1;0;1
17960;Justinukas;"SAULĖS ZUIKIŲ";29875250126;Taip;14;0;0;14
17961;Justinukas;"SAULĖS ZUIKIŲ";3813820356;Taip;12;3;0;15
17962;Justinukas;"SAULĖS ZUIKIŲ";3215259838;Taip;20;0;0;20
17963;Justinukas;"SAULĖS ZUIKIŲ";66240994100;Taip;14;0;0;14
17964;Justinukas;"SAULĖS ZUIKIŲ";8350429513;Taip;0;9;0;9
17965;Justinukas;"SAULĖS ZUIKIŲ";2532510817;Taip;0;11;0;11
17966;Justinukas;"SAULĖS ZUIKIŲ";52253951149;Taip;9;5;0;14
17967;Justinukas;"SAULĖS ZUIKIŲ";9411813711;Taip;6;0;3;9
17968;Justinukas;"SAULĖS ZUIKIŲ";4887565054;Taip;0;2;1;3
17969;Justinukas;"SAULĖS ZUIKIŲ";1806484271;Taip;14;3;0;17
17970;Justinukas;"SAULĖS ZUIKIŲ";8716574742;Taip;5;0;0;5
17971;Justinukas;"SAULĖS ZUIKIŲ";78270625975;Taip;20;0;0;20
17972;Justinukas;"SAULĖS ZUIKIŲ";5215250778;Taip;12;0;0;12
17973;Justinukas;"SAULĖS ZUIKIŲ";2018007566;Taip;1;3;0;4
17974;Justinukas;"SAULĖS ZUIKIŲ";1590855655;Taip;10;1;0;11
17975;Justinukas;"SAULĖS ZUIKIŲ";49880907488;Taip;17;0;0;17
17976;Justinukas;"SAULĖS ZUIKIŲ";76257661228;Taip;10;2;0;12
17977;Justinukas;"SAULĖS ZUIKIŲ";1967313365;Taip;0;7;0;7
17978;Justinukas;"SAULĖS ZUIKIŲ";56402748009;Taip;12;1;0;13
17979;Justinukas;PABIRUČIŲ;1996480143;Taip;0;8;0;8
17980;Justinukas;PABIRUČIŲ;76659578448;Taip;0;8;0;8
17981;Justinukas;PABIRUČIŲ;1655237708;Taip;0;6;0;6
17982;Justinukas;PABIRUČIŲ;1206482166;Taip;0;14;0;14
17983;Justinukas;PABIRUČIŲ;42308434800;Taip;7;0;0;7
17984;Justinukas;PABIRUČIŲ;20865224818;Taip;6;2;3;11
17985;Justinukas;PABIRUČIŲ;37019368317;Taip;1;1;0;2
17986;Justinukas;PABIRUČIŲ;53571863888;Ne;5;1;0;6
17987;Justinukas;PABIRUČIŲ;23762150256;Taip;3;2;0;5
17988;Justinukas;PABIRUČIŲ;62276887757;Taip;5;4;0;9
17989;Justinukas;PABIRUČIŲ;28457909446;Ne;20;0;0;20
17990;Justinukas;PABIRUČIŲ;70334519732;Taip;14;0;0;14
17991;Justinukas;PABIRUČIŲ;94562009887;Taip;5;6;0;11
17992;Justinukas;PABIRUČIŲ;31817312555;Taip;11;2;0;13
17993;Justinukas;PABIRUČIŲ;16910061636;Taip;0;9;0;9
17994;Justinukas;PABIRUČIŲ;46373287636;Taip;10;0;0;10
17995;Justinukas;PABIRUČIŲ;72517122863;Taip;10;7;0;17
17996;Justinukas;PABIRUČIŲ;42486181827;Taip;0;4;0;4
17997;Justinukas;PABIRUČIŲ;45490599266;Taip;4;4;0;8
17998;Justinukas;PABIRUČIŲ;10573989701;Taip;2;0;1;3
17999;Justinukas;PABIRUČIŲ;41914970891;Taip;7;1;0;8
18000;Justinukas;PABIRUČIŲ;1557388485;Taip;5;1;0;6
18001;Justinukas;VYTURIUKŲ;1319540676;Taip;7;2;1;10
18002;Justinukas;VYTURIUKŲ;1585956968;Taip;11;0;0;11
18003;Justinukas;VYTURIUKŲ;4056697803;Taip;0;6;0;6
18004;Justinukas;VYTURIUKŲ;1181972027;Taip;5;0;0;5
18005;Justinukas;VYTURIUKŲ;59176678396;Taip;0;7;0;7
18006;Justinukas;VYTURIUKŲ;1598234416;Taip;0;6;0;6
18007;Justinukas;VYTURIUKŲ;1511044883;Taip;10;1;0;11
18008;Justinukas;VYTURIUKŲ;1555183700;Taip;0;7;0;7
18009;Justinukas;VYTURIUKŲ;1785794727;Taip;5;11;0;16
18010;Justinukas;VYTURIUKŲ;99512297006;Taip;0;1;0;1
18011;Justinukas;VYTURIUKŲ;28095047700;Taip;8;1;0;9
18012;Justinukas;VYTURIUKŲ;91620507403;Taip;11;1;1;13
18013;Justinukas;VYTURIUKŲ;26842499755;Taip;0;2;0;2
18014;Justinukas;VYTURIUKŲ;35192728896;Taip;12;0;0;12
18015;Justinukas;VYTURIUKŲ;1005872691;Taip;9;1;0;10
18016;Justinukas;VYTURIUKŲ;13774489893;Taip;13;0;1;14
18017;Justinukas;VYTURIUKŲ;2002649360;Taip;9;1;0;10
18018;Justinukas;VYTURIUKŲ;30823793919;Taip;20;0;0;20
18019;Justinukas;VYTURIUKŲ;1956705813;Taip;0;0;1;1
18020;Justinukas;VYTURIUKŲ;89330918024;Taip;5;3;2;10
18021;Justinukas;VYTURIUKŲ;49578167204;Taip;0;3;0;3
18022;Justinukas;KODĖLČIUKŲ;4946448574;Taip;1;1;0;2
18023;Justinukas;KODĖLČIUKŲ;1418462058;Taip;5;0;0;5
18024;Justinukas;KODĖLČIUKŲ;1022310072;Taip;3;0;2;5
18025;Justinukas;KODĖLČIUKŲ;33481357566;Taip;0;17;0;17
18026;Justinukas;KODĖLČIUKŲ;67436657541;Taip;8;0;0;8
18027;Justinukas;KODĖLČIUKŲ;29009575642;Taip;0;2;0;2
18028;Justinukas;KODĖLČIUKŲ;55428936508;Taip;3;0;0;3
18029;Justinukas;KODĖLČIUKŲ;11824002845;Taip;7;0;2;9
18030;Justinukas;KODĖLČIUKŲ;29696816177;Taip;10;5;0;15
18031;Justinukas;KODĖLČIUKŲ;50050288702;Taip;3;1;0;4
18032;Justinukas;KODĖLČIUKŲ;65541524010;Taip;0;4;0;4
18033;Justinukas;KODĖLČIUKŲ;70144957042;Taip;0;3;0;3
18034;Justinukas;KODĖLČIUKŲ;89566764594;Taip;0;4;0;4
18035;Justinukas;KODĖLČIUKŲ;21904117684;Taip;0;11;0;11
18036;Justinukas;KODĖLČIUKŲ;95563958391;Taip;6;0;5;11
18037;Justinukas;KODĖLČIUKŲ;51111749099;Taip;2;1;0;3
18038;Justinukas;KODĖLČIUKŲ;79380650760;Taip;0;6;0;6
18039;Justinukas;KODĖLČIUKŲ;42959183109;Taip;0;15;0;15
18040;Justinukas;KODĖLČIUKŲ;84179174899;Taip;3;0;0;3
18041;Justinukas;KODĖLČIUKŲ;1820490979;Taip;0;2;0;2
18042;Justinukas;KODĖLČIUKŲ;1962802968;Taip;1;8;0;9
18043;Justinukas;VIKRUOLIŲ;57621616956;Taip;11;6;0;17
18044;Justinukas;VIKRUOLIŲ;59108759161;Taip;20;0;0;20
18045;Justinukas;VIKRUOLIŲ;2776259830;Taip;0;2;0;2
18046;Justinukas;VIKRUOLIŲ;79934530654;Taip;5;2;0;7
18047;Justinukas;VIKRUOLIŲ;95467011497;Taip;5;1;2;8
18048;Justinukas;VIKRUOLIŲ;48732379120;Ne;18;1;0;19
18049;Justinukas;VIKRUOLIŲ;1844038414;Taip;14;1;0;15
18050;Justinukas;VIKRUOLIŲ;2952798555;Taip;19;0;0;19
18051;Justinukas;VIKRUOLIŲ;54102488427;Taip;5;10;0;15
18052;Justinukas;VIKRUOLIŲ;28543773229;Taip;11;1;0;12
18053;Justinukas;VIKRUOLIŲ;68853730495;Taip;5;1;0;6
18054;Justinukas;VIKRUOLIŲ;70062275466;Taip;0;3;0;3
18055;Justinukas;VIKRUOLIŲ;80827159258;Taip;16;0;0;16
18056;Justinukas;VIKRUOLIŲ;311074533;Taip;20;0;0;20
18057;Justinukas;VIKRUOLIŲ;55151392377;Taip;4;1;0;5
18058;Justinukas;VIKRUOLIŲ;97284171512;Taip;1;0;1;2
18059;Justinukas;VIKRUOLIŲ;1955952962;Taip;6;1;0;7
18060;Justinukas;VIKRUOLIŲ;1480054888;Taip;17;0;0;17
18061;Justinukas;VIKRUOLIŲ;5199005933;Taip;0;7;0;7
18062;Justinukas;VIKRUOLIŲ;2120659659;Taip;9;3;0;12
18063;Justinukas;PELEDŽIUKŲ;1789533195;Taip;7;4;0;11
18064;Justinukas;PELEDŽIUKŲ;74887990218;Taip;0;0;2;2
18065;Justinukas;PELEDŽIUKŲ;1937753510;Taip;1;1;0;2
18066;Justinukas;PELEDŽIUKŲ;6268022925;Taip;0;0;2;2
18067;Justinukas;PELEDŽIUKŲ;1405642653;Taip;0;6;0;6
18068;Justinukas;PELEDŽIUKŲ;1976450069;Taip;2;0;1;3
18069;Justinukas;PELEDŽIUKŲ;90692179185;Taip;5;8;0;13
18070;Justinukas;PELEDŽIUKŲ;61301662234;Taip;14;1;0;15
18071;Justinukas;PELEDŽIUKŲ;2027779101;Taip;12;0;1;13
18072;Justinukas;PELEDŽIUKŲ;8742157840;Taip;2;10;1;13
18073;Justinukas;PELEDŽIUKŲ;55089909579;Taip;0;10;1;11
18074;Justinukas;PELEDŽIUKŲ;12741015006;Taip;7;6;0;13
18075;Justinukas;PELEDŽIUKŲ;6961211392;Taip;11;0;0;11
18076;Justinukas;PELEDŽIUKŲ;48908098476;Taip;0;14;0;14
18077;Justinukas;PELEDŽIUKŲ;6604163285;Taip;5;12;0;17
18078;Justinukas;PELEDŽIUKŲ;1266695122;Taip;2;0;0;2
18079;Justinukas;PELEDŽIUKŲ;1264545164;Taip;10;0;0;10
18080;Justinukas;PELEDŽIUKŲ;1846303993;Taip;17;0;0;17
18081;Justinukas;ŽIRNIUKŲ;5876182759;Taip;5;2;0;7
18082;Justinukas;ŽIRNIUKŲ;8566530492;Taip;7;1;0;8
18083;Justinukas;ŽIRNIUKŲ;2900181358;Taip;13;3;0;16
18084;Justinukas;ŽIRNIUKŲ;5978993456;Taip;20;0;0;20
18085;Justinukas;ŽIRNIUKŲ;5870609685;Taip;14;0;0;14
18086;Justinukas;ŽIRNIUKŲ;8965456115;Taip;14;2;0;16
18087;Justinukas;ŽIRNIUKŲ;8455069158;Taip;5;0;0;5
18088;Justinukas;ŽIRNIUKŲ;8874979704;Taip;2;1;0;3
18089;Justinukas;ŽIRNIUKŲ;3193143474;Taip;16;0;0;16
18090;Justinukas;ŽIRNIUKŲ;1540892686;Taip;16;0;0;16
18091;Justinukas;ŽIRNIUKŲ;3729297918;Taip;9;0;2;11
18092;Justinukas;ŽIRNIUKŲ;2268124610;Taip;0;6;3;9
18093;Justinukas;GUDRUČIŲ;2241816838;Taip;16;0;0;16
18094;Justinukas;GUDRUČIŲ;6482808707;Taip;4;3;0;7
18095;Justinukas;GUDRUČIŲ;4756483798;Taip;0;2;0;2
18096;Justinukas;GUDRUČIŲ;3206751576;Taip;5;1;0;6
18097;Justinukas;GUDRUČIŲ;6470287041;Taip;16;0;0;16
18098;Justinukas;GUDRUČIŲ;3268913601;Taip;4;1;0;5
18099;Justinukas;GUDRUČIŲ;2017929633;Taip;2;1;0;3
18100;Justinukas;GUDRUČIŲ;7710916537;Taip;10;7;0;17
18101;Justinukas;GUDRUČIŲ;4194429972;Taip;5;11;0;16
18102;Justinukas;GUDRUČIŲ;8913463448;Taip;20;0;0;20
18103;Justinukas;GUDRUČIŲ;1426415687;Taip;10;0;0;10
18104;Justinukas;GUDRUČIŲ;7854674833;Taip;12;2;0;14
18105;Justinukas;GUDRUČIŲ;3768735503;Taip;5;0;0;5
18106;Justinukas;GUDRUČIŲ;8086378912;Taip;11;6;0;17
18107;Justinukas;GUDRUČIŲ;4271601149;Taip;17;0;0;17
18108;Justinukas;BORUŽIUKŲ;6897988246;Taip;9;6;0;15
18109;Justinukas;BORUŽIUKŲ;4542350401;Taip;20;0;0;20
18110;Justinukas;BORUŽIUKŲ;4347647695;Taip;0;2;0;2
18111;Justinukas;BORUŽIUKŲ;3388483002;Taip;13;6;0;19
18112;Justinukas;BORUŽIUKŲ;1129392970;Taip;0;0;1;1
18113;Justinukas;BORUŽIUKŲ;8281005516;Taip;0;10;1;11
18114;Justinukas;BORUŽIUKŲ;1398976932;Taip;0;1;0;1
18115;Justinukas;BORUŽIUKŲ;9823188609;Taip;0;0;5;5
18116;Justinukas;BORUŽIUKŲ;1977242147;Taip;15;0;0;15
18117;Justinukas;BORUŽIUKŲ;29165025048;Taip;0;0;7;7
18118;Justinukas;BORUŽIUKŲ;5258444578;Taip;0;0;2;2
18119;Justinukas;BORUŽIUKŲ;4574673585;Taip;0;10;0;10
18120;Justinukas;BORUŽIUKŲ;7006338378;Taip;20;0;0;20
18121;Justinukas;BORUŽIUKŲ;7166828675;Taip;19;0;0;19
18122;Justinukas;BORUŽIUKŲ;39916867354;Taip;0;1;0;1
18123;Justinukas;BORUŽIUKŲ;4010638658;Taip;0;2;0;2
18124;Justinukas;BORUŽIUKŲ;1172609518;Taip;18;0;0;18
18125;Justinukas;BORUŽIUKŲ;1616324236;Taip;0;2;3;5
18126;Justinukas;BORUŽIUKŲ;3030820917;Taip;20;0;0;20
18127;Aidas;Boružėlių;3748420427;Taip;4;1;0;5
18128;Aidas;Boružėlių;2027860670;Taip;19;0;0;19
18129;Aidas;Boružėlių;8915901727;Taip;0;1;0;1
18130;Aidas;Boružėlių;5311183877;Taip;9;3;0;12
18131;Aidas;Drugelių;1505697405;Ne;9;0;0;9
18132;Aidas;Drugelių;5346078886;Taip;5;0;0;5
18133;Aidas;Drugelių;1001916537;Taip;0;1;0;1
18134;Aidas;Drugelių;3473596157;Taip;6;1;0;7
18135;Aidas;Drugelių;15257986685;Taip;0;6;0;6
18136;Aidas;Drugelių;1653793823;Taip;6;0;0;6
18137;Aidas;Drugelių;2954393415;Taip;2;1;0;3
18138;Aidas;Aitvariukų;17920063762;Taip;0;2;0;2
18139;Aidas;Aitvariukų;30954912922;Taip;11;3;0;14
18140;Aidas;Aitvariukų;6700193362;Taip;7;1;0;8
18141;Aidas;Aitvariukų;3127870635;Taip;0;4;0;4
18142;Aidas;Aitvariukų;6664241303;Taip;5;0;0;5
18143;Aidas;"Meškučių kl.";9456640135;Ne;19;1;0;20
18144;Aidas;"Meškučių kl.";3496627131;Ne;0;5;0;5
18145;Aidas;"Meškučių kl.";2970002617;Ne;0;1;0;1
18146;Aidas;"Meškučių kl.";3094228969;Ne;0;8;0;8
18147;Aidas;"Meškučių kl.";8177181962;Ne;0;3;0;3
18148;Aidas;"Meškučių kl.";4980030389;Ne;0;1;0;1
18149;Aidas;"Gaidelių kl.";5100740847;Ne;0;1;0;1
18150;Aidas;"Gaidelių kl.";3808707012;Ne;5;1;0;6
18151;Aidas;"Gaidelių kl.";1322335360;Taip;0;1;0;1
18152;Aidas;"Gaidelių kl.";8642665550;Ne;0;1;0;1
18153;Aidas;"Gaidelių kl.";5806540190;Ne;0;1;0;1
18154;Aidas;"Gaidelių kl.";7803641933;Ne;0;1;0;1
18155;Aidas;"Gaidelių kl.";8056436399;Ne;0;1;0;1
18156;Aidas;"Gaidelių kl.";2501187241;Ne;20;0;0;20
18157;Aidas;"Kiškelių kl";6213577188;Ne;0;2;0;2
18158;Aidas;"Kiškelių kl";7740504510;Ne;0;1;0;1
18159;Aidas;"Kiškelių kl";2681438925;Taip;3;1;0;4
18160;Aidas;"Kiškelių kl";2234931428;Ne;0;1;0;1
18161;Aidas;"Kiškelių kl";5388697695;Ne;0;4;0;4
18162;Aidas;"Kiškelių kl";7354905114;Ne;6;6;0;12
18163;Aidas;"Kiškelių kl";6868265902;Ne;0;1;0;1
18164;Aidas;"Kiškelių kl";2446003793;Ne;0;1;0;1
18165;Aidas;"Kiškelių kl";4738867530;Taip;0;4;0;4
18166;Aidas;"Ančiukų kl.";4081645294;Ne;0;1;0;1
18167;Aidas;"Ančiukų kl.";1742331213;Ne;6;2;0;8
18168;Aidas;"Ančiukų kl.";92425322676;Ne;0;4;0;4
18169;Aidas;"Ančiukų kl.";81654551230;Taip;0;4;0;4
18170;Aidas;"Ančiukų kl.";9816043688;Ne;6;6;0;12
18171;Aidas;"Ančiukų kl.";20604410476;Ne;5;4;0;9
18172;Aidas;"Ančiukų kl.";63508565206;Ne;0;4;0;4
18173;Aidas;"Ančiukų kl.";1079077463;Taip;1;2;0;3
18174;Aidas;"Ančiukų kl.";3194974747;Taip;15;0;0;15
18175;Aidas;"Pelėdžiukų kl.";5712688030;Ne;0;1;0;1
18176;Aidas;"Pelėdžiukų kl.";2991400032;Ne;0;1;0;1
18177;Aidas;"Pelėdžiukų kl.";5326012529;Ne;0;1;0;1
18178;Aidas;"Pelėdžiukų kl.";5655286565;Ne;0;1;0;1
18179;Aidas;"Pelėdžiukų kl.";3279914631;Ne;0;2;0;2
18180;Aidas;"Pelėdžiukų kl.";7148658584;Ne;0;1;0;1
18181;Aidas;"Pelėdžiukų kl.";3808657280;Ne;0;1;0;1
18182;Aidas;"Pelėdžiukų kl.";2945444897;Taip;0;1;0;1
18183;Aidas;"Papūgėlių kl.";3447250754;Ne;0;2;0;2
18184;Aidas;"Papūgėlių kl.";2184123290;Taip;5;5;0;10
18185;Aidas;"Papūgėlių kl.";3352587395;Ne;0;2;0;2
18186;Aidas;"Papūgėlių kl.";4372628947;Ne;0;1;0;1
18187;Aidas;"Papūgėlių kl.";5570772793;Ne;5;1;0;6
18188;Aidas;"Papūgėlių kl.";3442250711;Ne;0;4;0;4
18189;Aidas;"Papūgėlių kl.";5905008395;Ne;0;4;0;4
18190;Aidas;"Papūgėlių kl.";9613466086;Taip;6;9;0;15
18191;Aidas;"Saulutės kl.";1535004699;Ne;0;12;0;12
18192;Aidas;"Saulutės kl.";6356218442;Ne;0;4;0;4
18193;Aidas;"Saulutės kl.";9944901942;Ne;6;6;0;12
18194;Aidas;"Saulutės kl.";74897451962;Taip;3;4;0;7
18195;Aidas;"Saulutės kl.";4890362155;Taip;7;4;0;11
18196;Aidas;"Saulutės kl.";6778658540;Taip;0;4;0;4
18197;Aidas;"Saulutės kl.";7329254454;Taip;0;1;0;1
18198;Aidas;"Saulutės kl.";2000234311;Taip;3;1;0;4
18199;Aidas;"Saulutės kl.";4990112920;Taip;14;4;0;18
18200;Aidas;"Saulutės kl.";88721781220;Ne;0;3;0;3
18201;Aidas;"Katinėlių kl.";4367406525;Taip;19;0;0;19
18202;Aidas;"Katinėlių kl.";1010885560;Ne;0;1;0;1
18203;Aidas;"Katinėlių kl.";7821044288;Taip;0;7;0;7
18204;Aidas;"Katinėlių kl.";8377829773;Ne;0;1;0;1
18205;Bangelė;Aštuonkojai;20827674346;Taip;0;3;0;3
18206;Bangelė;Aštuonkojai;68082711504;Taip;4;1;0;5
18207;Bangelė;Aštuonkojai;51571795638;Ne;15;0;0;15
18208;Bangelė;Aštuonkojai;8280327053;Taip;4;0;8;12
18209;Bangelė;Aštuonkojai;61812452736;Taip;5;0;3;8
18210;Bangelė;Aštuonkojai;81379253837;Taip;5;5;0;10
18211;Bangelė;Aštuonkojai;5142785037;Taip;0;4;0;4
18212;Bangelė;Aštuonkojai;83691968186;Taip;7;6;0;13
18213;Bangelė;Aštuonkojai;76618850202;Taip;5;1;0;6
18214;Bangelė;Aštuonkojai;84855013193;Taip;0;2;0;2
18215;Bangelė;Aštuonkojai;69413101571;Taip;6;1;0;7
18216;Bangelė;Aštuonkojai;24209781144;Taip;6;1;0;7
18217;Bangelė;Aštuonkojai;18979714088;Taip;0;4;0;4
18218;Bangelė;Aštuonkojai;89458174517;Taip;8;0;0;8
18219;Bangelė;Aštuonkojai;70270153561;Ne;0;1;2;3
18220;Bangelė;Aštuonkojai;13284428796;Taip;11;2;0;13
18221;Bangelė;Aštuonkojai;7957072941;Taip;0;3;0;3
18222;Bangelė;Aštuonkojai;24895047229;Taip;11;1;0;12
18223;Bangelė;Aštuonkojai;1593861817;Taip;0;3;0;3
18224;Bangelė;Aštuonkojai;45145282759;Taip;9;0;2;11
18225;Bangelė;Aštuonkojai;2067377559;Taip;19;0;0;19
18226;Bangelė;Aštuonkojai;1312545465;Taip;0;4;0;4
18227;Bangelė;Aštuonkojai;1862514267;Taip;6;1;0;7
18228;Bangelė;Delfinukai,;7263228478;Taip;5;3;0;8
18229;Bangelė;Delfinukai,;1296464444;Taip;0;5;0;5
18230;Bangelė;Delfinukai,;1953702121;Taip;5;0;0;5
18231;Bangelė;Delfinukai,;1594486275;Taip;0;6;0;6
18232;Bangelė;Delfinukai,;3505492809;Taip;8;0;1;9
18233;Bangelė;Delfinukai,;22773040549;Taip;0;0;12;12
18234;Bangelė;Delfinukai,;6508452044;Taip;0;8;0;8
18235;Bangelė;Delfinukai,;2045465669;Taip;5;12;0;17
18236;Bangelė;Delfinukai,;1177022224;Taip;0;6;0;6
18237;Bangelė;Delfinukai,;95548866362;Taip;0;12;0;12
18238;Bangelė;Delfinukai,;1377575533;Taip;9;5;0;14
18239;Bangelė;Delfinukai,;3044914280;Taip;0;4;0;4
18240;Bangelė;Delfinukai,;7059603451;Taip;15;2;0;17
18241;Bangelė;Delfinukai,;4342844311;Taip;0;0;1;1
18242;Bangelė;Delfinukai,;1053744221;Taip;0;0;2;2
18243;Bangelė;Delfinukai,;4187165474;Taip;0;6;0;6
18244;Bangelė;"Saulės spindulėliai";7324007016;Taip;15;4;0;19
18245;Bangelė;"Saulės spindulėliai";8693782399;Taip;0;3;0;3
18246;Bangelė;"Saulės spindulėliai";8183516661;Taip;0;11;0;11
18247;Bangelė;"Saulės spindulėliai";65814392847;Taip;0;1;0;1
18248;Bangelė;"Saulės spindulėliai";47925578720;Taip;0;1;0;1
18249;Bangelė;"Saulės spindulėliai";99763916617;Taip;0;1;0;1
18250;Bangelė;"Saulės spindulėliai";22633862463;Taip;0;4;1;5
18251;Bangelė;"Saulės spindulėliai";30494044355;Taip;0;7;0;7
18252;Bangelė;"Saulės spindulėliai";83292810870;Taip;0;7;0;7
18253;Bangelė;"Saulės spindulėliai";17203636760;Ne;0;12;0;12
18254;Bangelė;"Saulės spindulėliai";21078822314;Taip;10;0;0;10
18255;Bangelė;"Saulės spindulėliai";95340587554;Taip;0;2;0;2
18256;Bangelė;"Saulės spindulėliai";27628473523;Taip;0;1;0;1
18257;Bangelė;"Saulės spindulėliai";75561871028;Taip;0;10;0;10
18258;Bangelė;"Saulės spindulėliai";26684336190;Taip;0;6;0;6
18259;Bangelė;"Saulės spindulėliai";50893212045;Taip;0;13;0;13
18260;Bangelė;"Saulės spindulėliai";83733094674;Taip;1;1;0;2
18261;Bangelė;"Pingvinukai ";1728085772;Taip;10;0;1;11
18262;Bangelė;"Pingvinukai ";9150185864;Taip;4;1;5;10
18263;Bangelė;"Pingvinukai ";6173470021;Taip;7;0;0;7
18264;Bangelė;"Pingvinukai ";55668308050;Taip;4;13;0;17
18265;Bangelė;"Pingvinukai ";2503946448;Taip;19;0;0;19
18266;Bangelė;"Pingvinukai ";6026399355;Taip;0;1;0;1
18267;Bangelė;"Pingvinukai ";3338203753;Taip;0;0;3;3
18268;Bangelė;"Pingvinukai ";1377734102;Taip;0;6;0;6
18269;Bangelė;"Pingvinukai ";9788923823;Taip;20;0;0;20
18270;Bangelė;"Pingvinukai ";9341038058;Taip;4;3;0;7
18271;Bangelė;"Pingvinukai ";5950451237;Taip;0;4;0;4
18272;Bangelė;"Pingvinukai ";2027892816;Taip;0;1;0;1
18273;Bangelė;"Pingvinukai ";1447396084;Taip;0;1;0;1
18274;Bangelė;"Pingvinukai ";5034268767;Taip;0;0;1;1
18275;Bangelė;"Pingvinukai ";4204797742;Taip;6;12;0;18
18276;Bangelė;"Pingvinukai ";1661384764;Taip;0;0;11;11
18277;Bangelė;"Pingvinukai ";1032881464;Taip;19;0;0;19
18278;Bangelė;"Pingvinukai ";9464115339;Taip;0;10;0;10
18279;Bangelė;"Jūros žvaigždutės ";2872188915;Taip;7;0;1;8
18280;Bangelė;"Jūros žvaigždutės ";7723290276;Taip;6;0;1;7
18281;Bangelė;"Jūros žvaigždutės ";4401389067;Taip;5;0;0;5
18282;Bangelė;"Jūros žvaigždutės ";1528387105;Taip;0;7;0;7
18283;Bangelė;"Jūros žvaigždutės ";6712145066;Taip;10;0;0;10
18284;Bangelė;"Jūros žvaigždutės ";9822287576;Taip;10;4;4;18
18285;Bangelė;"Jūros žvaigždutės ";7375004714;Taip;6;0;1;7
18286;Bangelė;"Jūros žvaigždutės ";7701956270;Taip;0;1;2;3
18287;Bangelė;"Jūros žvaigždutės ";1367082230;Taip;8;0;0;8
18288;Bangelė;"Jūros žvaigždutės ";1348995498;Ne;10;2;0;12
18289;Bangelė;"Jūros žvaigždutės ";3900236858;Taip;0;1;0;1
18290;Bangelė;"Jūros žvaigždutės ";2017886238;Taip;4;0;1;5
18291;Bangelė;"Jūros žvaigždutės ";8836861853;Taip;6;0;1;7
18292;Bangelė;"Jūros žvaigždutės ";4571869439;Taip;9;4;0;13
18293;Bangelė;"Jūros žvaigždutės ";4122927034;Ne;0;3;0;3
18294;Bangelė;"Jūros žvaigždutės ";8758933649;Taip;9;1;3;13
18295;Bangelė;"Jūros žvaigždutės ";9041585534;Taip;20;0;0;20
18296;Bangelė;"Jūros žvaigždutės ";4506651162;Taip;0;1;0;1
18297;Bangelė;"Jūros žvaigždutės ";9672505885;Taip;6;7;1;14
18298;Bangelė;"Jūros žvaigždutės ";7248631013;Taip;10;0;0;10
18299;Bangelė;"Jūros žvaigždutės ";4338067260;Taip;10;0;8;18
18300;Bangelė;Žuvytės;77615973000;Taip;1;5;0;6
18301;Bangelė;Žuvytės;411039166;Taip;6;5;0;11
18302;Bangelė;Žuvytės;7114709352;Taip;20;0;0;20
18303;Bangelė;Žuvytės;28845494407;Taip;14;3;0;17
18304;Bangelė;Žuvytės;2195543161;Ne;5;1;0;6
18305;Bangelė;Žuvytės;9983202427;Ne;0;1;0;1
18306;Bangelė;Žuvytės;3115177810;Taip;14;0;1;15
18307;Bangelė;Žuvytės;1790881495;Taip;0;5;0;5
18308;Bangelė;Žuvytės;1683377649;Taip;0;4;0;4
18309;Bangelė;Žuvytės;6739499483;Taip;14;0;5;19
18310;Bangelė;Žuvytės;47454787439;Taip;10;0;0;10
18311;Bangelė;Žuvytės;5573145836;Taip;3;4;1;8
18312;Bangelė;Žuvytės;5159962168;Taip;10;5;0;15
18313;Bangelė;Žuvytės;2112394008;Taip;0;0;3;3
18314;Bangelė;Žuvytės;1065164865;Taip;0;0;12;12
18315;Bangelė;Žuvytės;42739113312;Ne;10;0;0;10
18316;Bangelė;Ruoniai;77600323792;Taip;11;0;0;11
18317;Bangelė;Ruoniai;78837447598;Taip;5;2;0;7
18318;Bangelė;Ruoniai;34804550825;Taip;0;4;0;4
18319;Bangelė;Ruoniai;7559190407;Taip;8;4;6;18
18320;Bangelė;Ruoniai;1656261128;Taip;0;13;0;13
18321;Bangelė;Ruoniai;11083985386;Taip;0;9;0;9
18322;Bangelė;Ruoniai;76353372848;Taip;5;0;0;5
18323;Bangelė;Ruoniai;99771696381;Taip;6;6;0;12
18324;Bangelė;Ruoniai;17608442103;Taip;0;10;0;10
18325;Bangelė;Ruoniai;60823401986;Taip;5;5;1;11
18326;Bangelė;Ruoniai;1189143700;Taip;5;0;0;5
18327;Bangelė;Ruoniai;84620904798;Taip;2;0;6;8
18328;Bangelė;Ruoniai;37790897510;Taip;2;0;0;2
18329;Bangelė;Ruoniai;84797019693;Ne;2;6;0;8
18330;Bangelė;Ruoniai;2749669816;Taip;5;0;1;6
18331;Bangelė;Ruoniai;1258870576;Taip;0;4;2;6
18332;Bangelė;Ruoniai;91953522637;Taip;5;0;1;6
18333;Bangelė;Ruoniai;99823581960;Taip;0;7;0;7
18334;Bangelė;Ruoniai;2423625777;Taip;10;6;0;16
18335;Bangelė;Ruoniai;1823592268;Taip;6;1;0;7
18336;Bangelė;"Pagrandukai ";7434358474;Taip;0;0;7;7
18337;Bangelė;"Pagrandukai ";6861123988;Taip;5;8;0;13
18338;Bangelė;"Pagrandukai ";1351714626;Taip;12;0;0;12
18339;Bangelė;"Pagrandukai ";1754002501;Taip;9;0;1;10
18340;Bangelė;"Pagrandukai ";6953698592;Taip;11;0;1;12
18341;Bangelė;"Pagrandukai ";6216334243;Taip;0;5;0;5
18342;Bangelė;"Pagrandukai ";3063439996;Taip;9;4;0;13
18343;Bangelė;"Pagrandukai ";2156837975;Taip;2;0;0;2
18344;Bangelė;"Pagrandukai ";9801978617;Taip;5;1;0;6
18345;Bangelė;"Pagrandukai ";3634678954;Taip;14;2;0;16
18346;Bangelė;"Pagrandukai ";7434879947;Taip;20;0;0;20
18347;Bangelė;"Pagrandukai ";1390623903;Taip;6;5;0;11
18348;Bangelė;"Pagrandukai ";7136625230;Taip;13;0;0;13
18349;Bangelė;"Pagrandukai ";5761137540;Taip;0;15;0;15
18350;Bangelė;"Pagrandukai ";8316505307;Taip;6;0;0;6
18351;Bangelė;"Pagrandukai ";6145050734;Taip;0;0;1;1
18352;Bangelė;"Zuikučiai ";9706351115;Taip;14;0;0;14
18353;Bangelė;"Zuikučiai ";4412780063;Taip;15;0;5;20
18354;Bangelė;"Zuikučiai ";9009809585;Ne;20;0;0;20
18355;Bangelė;"Zuikučiai ";8734511431;Taip;0;8;0;8
18356;Bangelė;"Zuikučiai ";6044653707;Taip;6;13;0;19
18357;Bangelė;"Zuikučiai ";1915827035;Taip;6;13;0;19
18358;Bangelė;"Zuikučiai ";7685394517;Taip;1;0;0;1
18359;Bangelė;"Zuikučiai ";3991021350;Taip;11;3;0;14
18360;Bangelė;"Zuikučiai ";3990966706;Taip;5;4;0;9
18361;Bangelė;"Zuikučiai ";2764009011;Taip;16;0;0;16
18362;Bangelė;"Zuikučiai ";8799415648;Taip;0;0;9;9
18363;Bangelė;"Zuikučiai ";3334029244;Taip;11;0;0;11
18364;Bangelė;"Zuikučiai ";7230987338;Taip;0;0;1;1
18365;Bangelė;"Zuikučiai ";7337449523;Taip;0;0;1;1
18366;Bangelė;"Zuikučiai ";7174742281;Taip;11;1;0;12
18367;Bangelė;"Zuikučiai ";3579974049;Taip;12;1;0;13
18368;Gėlynas;PAKALNUTĖ;95681874019;Taip;5;1;0;6
18369;Gėlynas;PAKALNUTĖ;22067595840;Taip;2;5;0;7
18370;Gėlynas;PAKALNUTĖ;99637531213;Taip;5;15;0;20
18371;Gėlynas;PAKALNUTĖ;7735904549;Taip;9;0;0;9
18372;Gėlynas;PAKALNUTĖ;72991081966;Taip;0;4;0;4
18373;Gėlynas;PAKALNUTĖ;85912494214;Taip;0;2;0;2
18374;Gėlynas;PAKALNUTĖ;23134075402;Taip;0;1;0;1
18375;Gėlynas;PAKALNUTĖ;93919808581;Taip;2;8;0;10
18376;Gėlynas;PAKALNUTĖ;65634206992;Taip;0;13;0;13
18377;Gėlynas;PAKALNUTĖ;75827864070;Taip;1;2;0;3
18378;Gėlynas;PAKALNUTĖ;14307514975;Taip;0;1;0;1
18379;Gėlynas;PAKALNUTĖ;31532261756;Taip;5;4;0;9
18380;Gėlynas;PAKALNUTĖ;91530210644;Taip;0;5;0;5
18381;Gėlynas;PAKALNUTĖ;72544014665;Taip;0;6;1;7
18382;Gėlynas;PAKALNUTĖ;40702362906;Taip;0;11;0;11
18383;Gėlynas;PAKALNUTĖ;75222833700;Taip;5;5;0;10
18384;Gėlynas;PAKALNUTĖ;55177015936;Taip;0;1;0;1
18385;Gėlynas;PAKALNUTĖ;1406567756;Taip;0;2;0;2
18386;Gėlynas;VARPELIS;10328968209;Taip;16;0;0;16
18387;Gėlynas;VARPELIS;31203005706;Taip;9;3;0;12
18388;Gėlynas;VARPELIS;25587271237;Taip;5;0;0;5
18389;Gėlynas;VARPELIS;69440015944;Taip;11;0;1;12
18390;Gėlynas;VARPELIS;88267408077;Taip;1;0;1;2
18391;Gėlynas;VARPELIS;79659995227;Taip;9;2;0;11
18392;Gėlynas;VARPELIS;83480285704;Taip;8;0;0;8
18393;Gėlynas;VARPELIS;32029146963;Taip;16;2;0;18
18394;Gėlynas;VARPELIS;49356547308;Taip;10;0;0;10
18395;Gėlynas;VARPELIS;2694971710;Taip;15;0;0;15
18396;Gėlynas;VARPELIS;96358879500;Taip;0;1;0;1
18397;Gėlynas;VARPELIS;64162031157;Taip;10;0;0;10
18398;Gėlynas;VARPELIS;81669521777;Ne;0;4;0;4
18399;Gėlynas;VARPELIS;95226235881;Taip;13;0;0;13
18400;Gėlynas;VARPELIS;1321152075;Taip;2;4;0;6
18401;Gėlynas;VARPELIS;87982340000;Taip;5;6;0;11
18402;Gėlynas;VARPELIS;53718930602;Taip;2;0;0;2
18403;Gėlynas;VARPELIS;85776411183;Taip;4;0;0;4
18404;Gėlynas;RAKTAŽOLĖ;1418321973;Taip;0;1;0;1
18405;Gėlynas;RAKTAŽOLĖ;93572183033;Taip;0;2;0;2
18406;Gėlynas;RAKTAŽOLĖ;4508497773;Taip;2;1;0;3
18407;Gėlynas;RAKTAŽOLĖ;84522552145;Taip;0;15;0;15
18408;Gėlynas;RAKTAŽOLĖ;63379609794;Taip;0;9;0;9
18409;Gėlynas;RAKTAŽOLĖ;33068084227;Taip;6;0;0;6
18410;Gėlynas;RAKTAŽOLĖ;1797681067;Taip;4;0;2;6
18411;Gėlynas;RAKTAŽOLĖ;16850449718;Taip;1;0;0;1
18412;Gėlynas;RAKTAŽOLĖ;1117528954;Taip;0;17;0;17
18413;Gėlynas;RAKTAŽOLĖ;57429063547;Taip;17;1;0;18
18414;Gėlynas;RAKTAŽOLĖ;1483072450;Taip;3;0;0;3
18415;Gėlynas;RAKTAŽOLĖ;7796794153;Taip;8;0;0;8
18416;Gėlynas;RAKTAŽOLĖ;6264361257;Taip;7;0;2;9
18417;Gėlynas;RAKTAŽOLĖ;1047462165;Taip;0;10;0;10
18418;Gėlynas;RAKTAŽOLĖ;1754734306;Taip;10;0;0;10
18419;Gėlynas;RAKTAŽOLĖ;9780911032;Taip;10;0;0;10
18420;Gėlynas;RAKTAŽOLĖ;84546885977;Taip;0;13;0;13
18421;Gėlynas;RAKTAŽOLĖ;5135747448;Taip;0;1;0;1
18422;Gėlynas;RAKTAŽOLĖ;7808971151;Taip;0;11;0;11
18423;Gėlynas;SAULĖGRĄŽA;1191494598;Taip;2;0;0;2
18424;Gėlynas;SAULĖGRĄŽA;1407350449;Taip;14;0;0;14
18425;Gėlynas;SAULĖGRĄŽA;1676904275;Taip;6;1;0;7
18426;Gėlynas;SAULĖGRĄŽA;1338585475;Ne;5;6;0;11
18427;Gėlynas;SAULĖGRĄŽA;2050384850;Taip;5;0;0;5
18428;Gėlynas;SAULĖGRĄŽA;85310323038;Taip;5;5;0;10
18429;Gėlynas;SAULĖGRĄŽA;47220216751;Taip;6;2;0;8
18430;Gėlynas;SAULĖGRĄŽA;2099722437;Taip;7;1;0;8
18431;Gėlynas;SAULĖGRĄŽA;86881175896;Taip;5;0;0;5
18432;Gėlynas;SAULĖGRĄŽA;1053422007;Taip;6;0;0;6
18433;Gėlynas;SAULĖGRĄŽA;1608626732;Taip;7;4;0;11
18434;Gėlynas;SAULĖGRĄŽA;44391516295;Taip;10;0;0;10
18435;Gėlynas;SAULĖGRĄŽA;1363040744;Taip;6;0;0;6
18436;Gėlynas;SAULĖGRĄŽA;2018911523;Taip;20;0;0;20
18437;Gėlynas;SAULĖGRĄŽA;1431418368;Taip;2;4;0;6
18438;Gėlynas;SAULĖGRĄŽA;15277524754;Taip;5;0;0;5
18439;Gėlynas;SAULĖGRĄŽA;8324564359;Taip;3;2;0;5
18440;Gėlynas;RAMUNĖLĖ;4382465307;Taip;0;18;0;18
18441;Gėlynas;RAMUNĖLĖ;7814357385;Taip;6;3;0;9
18442;Gėlynas;RAMUNĖLĖ;8464074679;Taip;10;0;0;10
18443;Gėlynas;RAMUNĖLĖ;7562201835;Taip;0;2;0;2
18444;Gėlynas;RAMUNĖLĖ;8615943743;Taip;5;2;0;7
18445;Gėlynas;RAMUNĖLĖ;3572020585;Taip;6;0;0;6
18446;Gėlynas;RAMUNĖLĖ;1674569569;Taip;5;5;0;10
18447;Gėlynas;RAMUNĖLĖ;5695333666;Taip;6;2;0;8
18448;Gėlynas;RAMUNĖLĖ;90046802421;Taip;0;2;0;2
18449;Gėlynas;RAMUNĖLĖ;2230224971;Taip;0;1;0;1
18450;Gėlynas;RAMUNĖLĖ;5395474698;Taip;0;3;0;3
18451;Gėlynas;RAMUNĖLĖ;2348787949;Taip;6;1;0;7
18452;Gėlynas;RAMUNĖLĖ;3890687425;Taip;7;0;0;7
18453;Gėlynas;RAMUNĖLĖ;5124029118;Taip;0;19;0;19
18454;Gėlynas;RAMUNĖLĖ;9026298982;Taip;5;1;0;6
18455;Gėlynas;RAMUNĖLĖ;6815740588;Taip;5;8;0;13
18456;Gėlynas;RAMUNĖLĖ;5541707540;Taip;5;0;0;5
18457;Gėlynas;ŽIBUTĖ;6898127005;Taip;8;0;0;8
18458;Gėlynas;ŽIBUTĖ;77283628988;Taip;14;2;0;16
18459;Gėlynas;ŽIBUTĖ;1257113113;Taip;4;6;0;10
18460;Gėlynas;ŽIBUTĖ;2417880374;Taip;0;0;18;18
18461;Gėlynas;ŽIBUTĖ;2349352560;Taip;11;0;0;11
18462;Gėlynas;ŽIBUTĖ;4445250490;Taip;10;0;0;10
18463;Gėlynas;ŽIBUTĖ;6528464599;Taip;19;0;0;19
18464;Gėlynas;ŽIBUTĖ;2906909558;Taip;8;0;2;10
18465;Gėlynas;ŽIBUTĖ;9911225363;Taip;6;3;1;10
18466;Gėlynas;ŽIBUTĖ;2400929266;Taip;0;0;1;1
18467;Gėlynas;ŽIBUTĖ;1897547388;Taip;11;0;0;11
18468;Gėlynas;ŽIBUTĖ;3365442661;Taip;8;0;1;9
18469;Gėlynas;ŽIBUTĖ;7337987259;Taip;0;2;0;2
18470;Gėlynas;ŽIBUTĖ;6042268146;Taip;13;0;0;13
18471;Gėlynas;ŽIBUTĖ;5320531856;Taip;11;1;0;12
18472;Gėlynas;ŽIBUTĖ;9724668402;Taip;10;0;0;10
18473;Gėlynas;ŽIBUTĖ;2520059010;Taip;0;10;0;10
18474;Obelėlė;Bildukai;43664898514;Taip;0;1;0;1
18475;Obelėlė;Bildukai;58388471530;Taip;0;0;3;3
18476;Obelėlė;Bildukai;34628612328;Taip;7;0;0;7
18477;Obelėlė;Bildukai;2024391462;Taip;1;7;0;8
18478;Obelėlė;Bildukai;15196087730;Taip;16;0;4;20
18479;Obelėlė;Bildukai;75737109657;Taip;2;0;2;4
18480;Obelėlė;Bildukai;1466324860;Taip;14;0;0;14
18481;Obelėlė;Bildukai;52857531341;Taip;20;0;0;20
18482;Obelėlė;Bildukai;68222818886;Taip;0;0;1;1
18483;Obelėlė;Bildukai;1831642058;Taip;0;6;0;6
18484;Obelėlė;Bildukai;13913516066;Taip;5;0;1;6
18485;Obelėlė;Bildukai;50077685481;Taip;5;0;0;5
18486;Obelėlė;Bildukai;14986936220;Taip;0;0;8;8
18487;Obelėlė;Bildukai;88058597079;Taip;0;4;1;5
18488;Obelėlė;Bildukai;22986329944;Ne;0;0;2;2
18489;Obelėlė;Bildukai;29677456066;Taip;0;0;1;1
18490;Obelėlė;Bildukai;646883449;Taip;5;4;0;9
18491;Obelėlė;Bildukai;89380447507;Taip;6;0;0;6
18492;Obelėlė;Bildukai;65936525141;Taip;0;2;0;2
18493;Obelėlė;Bildukai;1816297607;Taip;10;0;0;10
18494;Obelėlė;Bildukai;19376935875;Taip;0;0;1;1
18495;Obelėlė;Gudručiai;72489178187;Taip;4;0;0;4
18496;Obelėlė;Gudručiai;83283114997;Taip;0;9;0;9
18497;Obelėlė;Gudručiai;25763539568;Taip;0;5;0;5
18498;Obelėlė;Gudručiai;66833202848;Taip;0;3;0;3
18499;Obelėlė;Gudručiai;22021301000;Taip;0;3;2;5
18500;Obelėlė;Gudručiai;72425110965;Taip;15;2;0;17
18501;Obelėlė;Gudručiai;42893341690;Taip;1;6;0;7
18502;Obelėlė;Gudručiai;77857591361;Taip;0;4;0;4
18503;Obelėlė;Gudručiai;36963205388;Taip;0;3;0;3
18504;Obelėlė;Gudručiai;50335422474;Taip;0;5;0;5
18505;Obelėlė;Gudručiai;15681100220;Taip;0;6;0;6
18506;Obelėlė;Gudručiai;30827740191;Taip;0;2;0;2
18507;Obelėlė;Gudručiai;49086730989;Taip;0;20;0;20
18508;Obelėlė;Gudručiai;1425516089;Taip;2;4;1;7
18509;Obelėlė;Gudručiai;1379383341;Taip;0;3;0;3
18510;Obelėlė;Gudručiai;1582535117;Taip;14;0;0;14
18511;Obelėlė;Gudručiai;1411457282;Ne;0;5;1;6
18512;Obelėlė;Drugeliai;5960204860;Taip;8;4;0;12
18513;Obelėlė;Drugeliai;1874574001;Taip;15;0;0;15
18514;Obelėlė;Drugeliai;1271351257;Taip;16;4;0;20
18515;Obelėlė;Drugeliai;1980250599;Taip;5;0;3;8
18516;Obelėlė;Drugeliai;1185247095;Taip;0;1;0;1
18517;Obelėlė;Drugeliai;8115772385;Taip;0;0;7;7
18518;Obelėlė;Drugeliai;2018689468;Taip;0;0;1;1
18519;Obelėlė;Drugeliai;1248853135;Taip;9;0;1;10
18520;Obelėlė;Drugeliai;7120041402;Taip;9;0;2;11
18521;Obelėlė;Drugeliai;2110458181;Taip;0;0;3;3
18522;Obelėlė;Drugeliai;4404544549;Taip;19;0;0;19
18523;Obelėlė;Drugeliai;9059791812;Taip;14;0;1;15
18524;Obelėlė;Drugeliai;4835765774;Taip;14;0;0;14
18525;Obelėlė;Drugeliai;46597815116;Taip;6;0;2;8
18526;Obelėlė;Drugeliai;65578250853;Taip;7;0;3;10
18527;Obelėlė;Drugeliai;1044733634;Taip;1;4;4;9
18528;Obelėlė;Drugeliai;1847501295;Taip;5;0;0;5
18529;Obelėlė;Drugeliai;6006139132;Taip;0;0;3;3
18530;Obelėlė;Pasakaitė;1695933896;Taip;10;0;0;10
18531;Obelėlė;Pasakaitė;1833543299;Taip;5;1;0;6
18532;Obelėlė;Pasakaitė;1555780072;Taip;9;0;0;9
18533;Obelėlė;Pasakaitė;77743243622;Taip;1;0;0;1
18534;Obelėlė;Pasakaitė;1543298097;Taip;2;0;1;3
18535;Obelėlė;Pasakaitė;79601449969;Taip;0;0;3;3
18536;Obelėlė;Pasakaitė;3330983614;Taip;0;3;2;5
18537;Obelėlė;Pasakaitė;4257479486;Taip;16;0;1;17
18538;Obelėlė;Pasakaitė;8394566707;Taip;5;4;0;9
18539;Obelėlė;Pasakaitė;10939948244;Taip;0;0;9;9
18540;Obelėlė;Pasakaitė;1707652145;Taip;1;6;0;7
18541;Obelėlė;Pasakaitė;1141707374;Taip;5;5;0;10
18542;Obelėlė;Pasakaitė;6789881144;Taip;20;0;0;20
18543;Obelėlė;Pasakaitė;9934596750;Taip;0;16;0;16
18544;Obelėlė;Pasakaitė;6036130112;Taip;2;0;2;4
18545;Obelėlė;Pasakaitė;8324404990;Taip;15;0;5;20
18546;Obelėlė;Pasakaitė;1893470952;Taip;10;0;2;12
18547;Obelėlė;Pasakaitė;7754276632;Taip;0;20;0;20
18548;Obelėlė;Svajokliai;23509261393;Taip;0;9;0;9
18549;Obelėlė;Svajokliai;6994800595;Taip;6;0;2;8
18550;Obelėlė;Svajokliai;7041085872;Taip;5;4;11;20
18551;Obelėlė;Svajokliai;35070707820;Taip;0;2;0;2
18552;Obelėlė;Svajokliai;97950830777;Taip;3;0;1;4
18553;Obelėlė;Svajokliai;80357143791;Taip;0;3;2;5
18554;Obelėlė;Svajokliai;97594253013;Taip;0;1;1;2
18555;Obelėlė;Svajokliai;17252134237;Taip;10;4;0;14
18556;Obelėlė;Svajokliai;15750481943;Taip;0;10;0;10
18557;Obelėlė;Svajokliai;93272717922;Taip;0;7;0;7
18558;Obelėlė;Svajokliai;67212667852;Taip;0;4;7;11
18559;Obelėlė;Svajokliai;64573865421;Taip;6;0;0;6
18560;Obelėlė;Svajokliai;75091826601;Taip;6;0;0;6
18561;Obelėlė;Smalsučiai;43103357250;Taip;20;0;0;20
18562;Obelėlė;Smalsučiai;6347375324;Taip;0;16;0;16
18563;Obelėlė;Smalsučiai;1337679766;Taip;0;3;1;4
18564;Obelėlė;Smalsučiai;2107924334;Taip;4;0;1;5
18565;Obelėlė;Smalsučiai;75387550210;Taip;0;0;2;2
18566;Obelėlė;Smalsučiai;72224972200;Taip;4;2;0;6
18567;Obelėlė;Smalsučiai;3220190193;Ne;0;4;2;6
18568;Obelėlė;Smalsučiai;39757539751;Taip;5;0;1;6
18569;Obelėlė;Smalsučiai;27275867716;Taip;0;4;0;4
18570;Obelėlė;Smalsučiai;20691217408;Taip;6;0;1;7
18571;Obelėlė;Smalsučiai;35495444231;Taip;0;0;18;18
18572;Obelėlė;Smalsučiai;88798186419;Taip;9;0;0;9
18573;Obelėlė;Smalsučiai;97298049429;Taip;12;0;0;12
18574;Obelėlė;Smalsučiai;68776273648;Taip;10;6;0;16
18575;Obelėlė;Smalsučiai;78242377913;Taip;11;0;0;11
18576;Obelėlė;Smalsučiai;2995640371;Taip;9;0;2;11
18577;Obelėlė;Smalsučiai;1915402358;Taip;0;0;2;2
18578;Obelėlė;Smalsučiai;1758206243;Taip;0;0;7;7
18579;Obelėlė;Pabiručiai;1547195948;Taip;5;0;0;5
18580;Obelėlė;Pabiručiai;1586544097;Taip;3;0;0;3
18581;Obelėlė;Pabiručiai;94350358246;Taip;10;1;0;11
18582;Obelėlė;Pabiručiai;74915473313;Taip;5;6;0;11
18583;Obelėlė;Pabiručiai;79388410820;Taip;0;1;0;1
18584;Obelėlė;Pabiručiai;40103909643;Taip;5;5;0;10
18585;Obelėlė;Pabiručiai;2662966388;Taip;9;0;0;9
18586;Obelėlė;Pabiručiai;2678719111;Taip;15;0;0;15
18587;Obelėlė;Pabiručiai;1420633482;Taip;2;0;2;4
18588;Obelėlė;Pabiručiai;1698995389;Taip;14;0;0;14
18589;Obelėlė;Pabiručiai;79669290078;Ne;2;0;1;3
18590;Obelėlė;Pabiručiai;31018018065;Taip;5;0;2;7
18591;Obelėlė;Pabiručiai;2015165566;Taip;4;0;1;5
18592;Obelėlė;Pabiručiai;16430825029;Taip;3;2;0;5
18593;Obelėlė;Pabiručiai;8882103124;Taip;8;0;2;10
18594;Obelėlė;Pabiručiai;69055416041;Taip;5;6;0;11
18595;Obelėlė;Pabiručiai;1576498450;Taip;5;0;1;6
18596;Obelėlė;Pabiručiai;74455701543;Taip;12;1;1;14
18597;Obelėlė;Pabiručiai;1978974359;Ne;5;0;1;6
18598;Obelėlė;Strakaliukai;2105005710;Taip;0;0;1;1
18599;Obelėlė;Strakaliukai;5512990125;Taip;2;0;2;4
18600;Obelėlė;Strakaliukai;2014450377;Taip;0;6;0;6
18601;Obelėlė;Strakaliukai;2093164210;Taip;2;0;0;2
18602;Obelėlė;Strakaliukai;1210385417;Taip;0;0;2;2
18603;Obelėlė;Strakaliukai;1536889615;Taip;10;0;5;15
18604;Obelėlė;Strakaliukai;1670594471;Taip;0;9;0;9
18605;Obelėlė;Strakaliukai;1770448857;Taip;5;0;3;8
18606;Obelėlė;Strakaliukai;1484822838;Taip;10;0;0;10
18607;Obelėlė;Strakaliukai;82119081040;Taip;4;0;3;7
18608;Obelėlė;Strakaliukai;1020414332;Taip;4;0;2;6
18609;Obelėlė;Strakaliukai;8202131299;Taip;5;0;7;12
18610;Obelėlė;Strakaliukai;58153232854;Taip;7;0;0;7
18611;Obelėlė;Strakaliukai;49378314043;Taip;7;3;2;12
18612;Obelėlė;Strakaliukai;57788788343;Taip;0;5;0;5
18613;Obelėlė;Strakaliukai;1824412493;Ne;0;16;0;16
18614;Obelėlė;Strakaliukai;31721462678;Taip;0;0;2;2
18615;Obelėlė;Strakaliukai;52277220462;Taip;1;0;4;5
18616;Obelėlė;Strakaliukai;74564453474;Taip;5;0;6;11
18617;Obelėlė;Strakaliukai;8904956649;Taip;0;10;1;11
18618;Obelėlė;Saulutė;98290583667;Taip;0;0;1;1
18619;Obelėlė;Saulutė;77954383604;Taip;0;2;0;2
18620;Obelėlė;Saulutė;1826138505;Taip;0;4;0;4
18621;Obelėlė;Saulutė;1987783063;Taip;5;0;0;5
18622;Obelėlė;Saulutė;38968623613;Taip;0;0;4;4
18623;Obelėlė;Saulutė;1741425229;Taip;0;6;1;7
18624;Obelėlė;Saulutė;1336592238;Taip;0;0;5;5
18625;Obelėlė;Saulutė;1240673124;Taip;2;0;0;2
18626;Obelėlė;Saulutė;24010838180;Taip;0;3;0;3
18627;Obelėlė;Saulutė;1935023634;Taip;6;0;2;8
18628;Obelėlė;Saulutė;1061262980;Taip;10;4;0;14
18629;Obelėlė;Saulutė;2099500866;Taip;0;0;4;4
18630;Obelėlė;Saulutė;6054898307;Taip;10;0;3;13
18631;Obelėlė;Saulutė;3076493150;Taip;7;0;3;10
18632;Obelėlė;Saulutė;1521926754;Taip;10;0;3;13
18633;Obelėlė;Saulutė;6720229368;Ne;0;0;4;4
18634;Obelėlė;Saulutė;1601102808;Taip;5;0;2;7
18635;Obelėlė;Saulutė;1021948127;Taip;15;0;0;15
18636;Obelėlė;Rieduliukai;1706102918;Taip;6;3;1;10
18637;Obelėlė;Rieduliukai;8682794598;Taip;0;0;4;4
18638;Obelėlė;Rieduliukai;8754552660;Taip;16;0;2;18
18639;Obelėlė;Rieduliukai;7934760271;Taip;20;0;0;20
18640;Obelėlė;Rieduliukai;9716500560;Taip;6;0;0;6
18641;Obelėlė;Rieduliukai;3604960887;Taip;14;1;0;15
18642;Obelėlė;Rieduliukai;4251418414;Taip;0;0;3;3
18643;Obelėlė;Rieduliukai;7128421330;Taip;0;6;0;6
18644;Obelėlė;Rieduliukai;5943314566;Taip;0;20;0;20
18645;Obelėlė;Rieduliukai;6364101139;Taip;6;0;0;6
18646;Obelėlė;Rieduliukai;6691540418;Taip;14;0;1;15
18647;Obelėlė;Rieduliukai;5326258755;Taip;6;1;3;10
18648;Obelėlė;Rieduliukai;2770477678;Taip;0;1;0;1
18649;Obelėlė;Žirniukai;2014314139;Taip;5;0;0;5
18650;Obelėlė;Žirniukai;9900484892;Taip;19;0;1;20
18651;Obelėlė;Žirniukai;6325027163;Taip;12;0;0;12
18652;Obelėlė;Žirniukai;6145113624;Taip;6;0;0;6
18653;Obelėlė;Žirniukai;9586720282;Taip;0;20;0;20
18654;Obelėlė;Žirniukai;9567704282;Taip;7;0;0;7
18655;Obelėlė;Žirniukai;8231489868;Taip;5;0;2;7
18656;Obelėlė;Žirniukai;9305279614;Taip;10;6;3;19
18657;Obelėlė;Žirniukai;4995817505;Taip;9;0;0;9
18658;Obelėlė;Žirniukai;4015702815;Taip;0;6;5;11
18659;Obelėlė;Žirniukai;4309139638;Taip;9;0;0;9
18660;Obelėlė;Žirniukai;9736557012;Taip;0;20;0;20
18661;Obelėlė;Žirniukai;6720058972;Taip;10;0;0;10
18662;Obelėlė;Žirniukai;5141585309;Taip;14;0;1;15
18663;Obelėlė;Bičiuliai;9031690002;Taip;5;1;0;6
18664;Obelėlė;Bičiuliai;3425736276;Taip;6;0;0;6
18665;Obelėlė;Bičiuliai;1507072248;Taip;10;0;4;14
18666;Obelėlė;Bičiuliai;5776116844;Taip;5;2;0;7
18667;Obelėlė;Bičiuliai;8487088625;Taip;16;0;2;18
18668;Obelėlė;Bičiuliai;1630067014;Taip;10;0;0;10
18669;Obelėlė;Bičiuliai;1537769810;Taip;1;0;0;1
18670;Obelėlė;Bičiuliai;8371648703;Taip;5;0;0;5
18671;Obelėlė;Bičiuliai;3517342646;Taip;14;0;0;14
18672;Obelėlė;Bičiuliai;8757731600;Taip;2;0;4;6
18673;Obelėlė;Bičiuliai;2329734472;Taip;6;0;1;7
18674;Obelėlė;Bičiuliai;1419189517;Taip;20;0;0;20
18675;Obelėlė;Bičiuliai;5933910526;Taip;5;0;2;7
18676;Obelėlė;Bičiuliai;4220808775;Taip;11;0;0;11
18677;Obelėlė;Bičiuliai;8155712451;Taip;0;0;1;1
18678;Obelėlė;Bičiuliai;4849175527;Taip;10;0;3;13
18679;Obelėlė;Bičiuliai;9805481603;Taip;11;0;0;11
18680;Spygliukas;Bitutės;49406606185;Taip;0;8;8;16
18681;Spygliukas;Bitutės;97773415559;Taip;16;0;0;16
18682;Spygliukas;Bitutės;26529424930;Taip;0;1;0;1
18683;Spygliukas;Bitutės;68487983068;Taip;5;4;0;9
18684;Spygliukas;Bitutės;47077562116;Taip;8;0;0;8
18685;Spygliukas;Bitutės;56991221970;Taip;5;2;0;7
18686;Spygliukas;Bitutės;45296663285;Taip;8;0;0;8
18687;Spygliukas;Bitutės;21074122407;Taip;3;1;0;4
18688;Spygliukas;Bitutės;12711940653;Taip;8;0;0;8
18689;Spygliukas;Bitutės;26697357569;Taip;0;11;0;11
18690;Spygliukas;Bitutės;77970187363;Taip;0;0;1;1
18691;Spygliukas;Bitutės;7829656569;Taip;8;0;0;8
18692;Spygliukas;Bitutės;1076152986;Taip;11;0;1;12
18693;Spygliukas;Bitutės;1122973994;Taip;14;0;0;14
18694;Spygliukas;Bitutės;1341415412;Taip;10;0;0;10
18695;Spygliukas;Bitutės;1227595604;Ne;10;7;0;17
18696;Spygliukas;Bitutės;1971162865;Taip;12;4;2;18
18697;Spygliukas;Kiškučiai;9001243644;Taip;20;0;0;20
18698;Spygliukas;Kiškučiai;2058015313;Taip;0;0;4;4
18699;Spygliukas;Kiškučiai;2980459339;Taip;5;0;0;5
18700;Spygliukas;Kiškučiai;4430242310;Taip;0;1;0;1
18701;Spygliukas;Kiškučiai;7250958367;Taip;1;0;0;1
18702;Spygliukas;Kiškučiai;9392554576;Taip;9;0;0;9
18703;Spygliukas;Kiškučiai;8646122773;Taip;9;1;0;10
18704;Spygliukas;Kiškučiai;1940209166;Taip;8;0;1;9
18705;Spygliukas;Kiškučiai;2935281062;Taip;9;0;0;9
18706;Spygliukas;Kiškučiai;8048474808;Taip;12;0;1;13
18707;Spygliukas;Kiškučiai;1679263120;Taip;1;0;0;1
18708;Spygliukas;Kiškučiai;4933577424;Taip;5;0;0;5
18709;Spygliukas;Kiškučiai;1855897974;Taip;12;0;1;13
18710;Spygliukas;Kiškučiai;1228469923;Taip;5;2;0;7
18711;Spygliukas;Kiškučiai;8103481313;Taip;20;0;0;20
18712;Spygliukas;Kiškučiai;8992822256;Taip;14;0;0;14
18713;Spygliukas;Kiškučiai;7421000718;Taip;0;0;1;1
18714;Spygliukas;Boružėlės;1939828587;Taip;6;0;0;6
18715;Spygliukas;Boružėlės;1238940921;Taip;5;8;0;13
18716;Spygliukas;Boružėlės;93029375520;Taip;2;1;0;3
18717;Spygliukas;Boružėlės;1163722642;Taip;10;0;0;10
18718;Spygliukas;Boružėlės;9288806012;Taip;5;2;0;7
18719;Spygliukas;Boružėlės;4104158994;Taip;14;0;1;15
18720;Spygliukas;Boružėlės;10858715103;Taip;14;0;0;14
18721;Spygliukas;Boružėlės;1002603766;Taip;2;7;0;9
18722;Spygliukas;Boružėlės;34209607173;Taip;9;0;0;9
18723;Spygliukas;Boružėlės;1842315404;Taip;0;1;0;1
18724;Spygliukas;Boružėlės;73047963456;Taip;0;0;5;5
18725;Spygliukas;Boružėlės;7114613140;Taip;5;0;0;5
18726;Spygliukas;Boružėlės;92279064240;Taip;5;5;0;10
18727;Spygliukas;Boružėlės;30201229961;Taip;0;6;0;6
18728;Spygliukas;Boružėlės;79584454527;Taip;0;1;0;1
18729;Spygliukas;Boružėlės;1321926079;Taip;4;0;0;4
18730;Spygliukas;Boružėlės;9513387087;Ne;11;5;1;17
18731;Spygliukas;Boružėlės;1193015656;Taip;0;0;1;1
18732;Spygliukas;Ežiukai;1832756255;Taip;4;2;1;7
18733;Spygliukas;Ežiukai;9593700812;Taip;1;5;0;6
18734;Spygliukas;Ežiukai;2126162527;Taip;2;0;0;2
18735;Spygliukas;Ežiukai;1260920726;Taip;2;1;6;9
18736;Spygliukas;Ežiukai;42285404110;Taip;8;0;0;8
18737;Spygliukas;Ežiukai;2040903312;Taip;20;0;0;20
18738;Spygliukas;Ežiukai;3037648954;Taip;2;0;0;2
18739;Spygliukas;Ežiukai;1211969263;Taip;9;2;0;11
18740;Spygliukas;Ežiukai;7219659640;Taip;0;2;0;2
18741;Spygliukas;Ežiukai;1881745347;Taip;0;1;0;1
18742;Spygliukas;Ežiukai;4355472423;Taip;8;2;0;10
18743;Spygliukas;Ežiukai;53324066837;Ne;0;7;0;7
18744;Spygliukas;Ežiukai;9957292202;Taip;6;4;0;10
18745;Spygliukas;Ežiukai;1298381738;Taip;20;0;0;20
18746;Spygliukas;Ežiukai;7649832094;Taip;4;14;0;18
18747;Spygliukas;Ežiukai;5780485510;Taip;8;0;0;8
18748;Spygliukas;Ežiukai;8686118262;Taip;2;0;1;3
18749;Spygliukas;Ežiukai;5253108181;Taip;20;0;0;20
18750;Spygliukas;Ežiukai;3785469286;Taip;0;0;9;9
18751;Spygliukas;Ežiukai;29015391754;Taip;5;0;0;5
18752;Spygliukas;Ežiukai;84556142803;Taip;10;1;0;11
18753;Spygliukas;Geniukai;42786380899;Taip;5;2;0;7
18754;Spygliukas;Geniukai;20248450562;Ne;9;0;0;9
18755;Spygliukas;Geniukai;35839138942;Taip;4;6;0;10
18756;Spygliukas;Geniukai;20458611180;Taip;5;0;0;5
18757;Spygliukas;Geniukai;45881077771;Taip;6;7;0;13
18758;Spygliukas;Geniukai;28639466275;Taip;5;0;0;5
18759;Spygliukas;Geniukai;15887839786;Taip;5;0;0;5
18760;Spygliukas;Geniukai;90555084491;Taip;5;4;0;9
18761;Spygliukas;Geniukai;88332181449;Taip;0;5;0;5
18762;Spygliukas;Geniukai;58880461920;Taip;3;0;0;3
18763;Spygliukas;Geniukai;80768950728;Ne;10;0;0;10
18764;Spygliukas;Geniukai;38040423877;Taip;0;6;0;6
18765;Spygliukas;Geniukai;53280907352;Taip;5;0;0;5
18766;Spygliukas;Geniukai;91727550789;Taip;0;4;2;6
18767;Spygliukas;Geniukai;1482370515;Taip;4;7;0;11
18768;Spygliukas;Geniukai;1908975286;Taip;6;0;0;6
18769;Spygliukas;Geniukai;1012592509;Taip;5;0;0;5
18770;Spygliukas;Geniukai;1847162482;Taip;17;0;0;17
18771;Spygliukas;Geniukai;1398592801;Taip;20;0;0;20
18772;Spygliukas;Riešutėliai;88173456147;Taip;0;11;0;11
18773;Spygliukas;Riešutėliai;72370650994;Taip;0;5;0;5
18774;Spygliukas;Riešutėliai;29046559255;Taip;0;0;2;2
18775;Spygliukas;Riešutėliai;80403876623;Taip;0;0;1;1
18776;Spygliukas;Riešutėliai;76913033601;Taip;4;2;0;6
18777;Spygliukas;Riešutėliai;15330844181;Taip;0;7;0;7
18778;Spygliukas;Riešutėliai;61168086526;Taip;0;0;1;1
18779;Spygliukas;Riešutėliai;42616212;Taip;0;0;2;2
18780;Spygliukas;Riešutėliai;80514549747;Taip;10;0;0;10
18781;Spygliukas;Riešutėliai;60381587208;Taip;5;0;5;10
18782;Spygliukas;Riešutėliai;40730123107;Taip;0;6;0;6
18783;Spygliukas;Riešutėliai;75872222695;Taip;0;0;1;1
18784;Spygliukas;Riešutėliai;14061921481;Taip;5;0;0;5
18785;Spygliukas;Riešutėliai;77665543739;Taip;8;0;0;8
18786;Spygliukas;Riešutėliai;84487759175;Taip;8;0;0;8
18787;Spygliukas;Riešutėliai;1580382515;Taip;2;10;0;12
18788;Spygliukas;Riešutėliai;4219250715;Taip;16;0;0;16
18789;Spygliukas;Riešutėliai;1429385840;Taip;6;7;0;13
18790;Spygliukas;Pelėdžiukai;91102341053;Taip;9;0;0;9
18791;Spygliukas;Pelėdžiukai;6104639970;Taip;1;0;0;1
18792;Spygliukas;Pelėdžiukai;85751149838;Taip;3;6;3;12
18793;Spygliukas;Pelėdžiukai;17541702082;Ne;7;1;0;8
18794;Spygliukas;Pelėdžiukai;20304216159;Taip;0;3;4;7
18795;Spygliukas;Pelėdžiukai;7675515299;Taip;4;0;0;4
18796;Spygliukas;Pelėdžiukai;66170193369;Ne;0;4;0;4
18797;Spygliukas;Pelėdžiukai;95031107059;Taip;0;1;0;1
18798;Spygliukas;Pelėdžiukai;33559493599;Taip;5;0;0;5
18799;Spygliukas;Pelėdžiukai;41129167567;Taip;4;5;0;9
18800;Spygliukas;Pelėdžiukai;54932584770;Taip;20;0;0;20
18801;Spygliukas;Pelėdžiukai;31918025260;Taip;12;3;0;15
18802;Spygliukas;Pelėdžiukai;57098709793;Taip;6;3;0;9
18803;Spygliukas;Pelėdžiukai;96967766273;Taip;0;4;0;4
18804;Spygliukas;Pelėdžiukai;1447408559;Taip;0;4;0;4
18805;Spygliukas;Pelėdžiukai;63899991046;Taip;9;3;0;12
18806;Spygliukas;Pelėdžiukai;8252228033;Taip;6;6;3;15
18807;Spygliukas;Pelėdžiukai;67896776952;Taip;5;2;0;7
18808;Spygliukas;Zylutės;6242194100;Taip;9;0;0;9
18809;Spygliukas;Zylutės;2739564216;Taip;14;0;0;14
18810;Spygliukas;Zylutės;4721066953;Taip;17;0;0;17
18811;Spygliukas;Zylutės;7900652746;Taip;14;1;0;15
18812;Spygliukas;Zylutės;4949371837;Taip;8;0;0;8
18813;Spygliukas;Zylutės;6457632191;Taip;20;0;0;20
18814;Spygliukas;Zylutės;4650693672;Taip;11;0;2;13
18815;Spygliukas;Zylutės;9178184431;Taip;5;5;0;10
18816;Spygliukas;Zylutės;1691209405;Taip;5;0;0;5
18817;Spygliukas;Zylutės;4577592862;Taip;20;0;0;20
18818;Spygliukas;Zylutės;4610504338;Taip;1;0;1;2
18819;Spygliukas;Zylutės;6835488489;Taip;8;0;0;8
18820;Spygliukas;Zylutės;3365209400;Taip;0;0;6;6
18821;Spygliukas;Zylutės;3658613027;Ne;10;0;3;13
18822;Spygliukas;Skruzdėliukai;5561426508;Taip;8;0;0;8
18823;Spygliukas;Skruzdėliukai;2177856916;Taip;0;3;7;10
18824;Spygliukas;Skruzdėliukai;8825264090;Taip;6;0;3;9
18825;Spygliukas;Skruzdėliukai;8404929784;Taip;2;0;1;3
18826;Spygliukas;Skruzdėliukai;6931145017;Taip;7;0;0;7
18827;Spygliukas;Skruzdėliukai;3041184642;Taip;13;4;0;17
18828;Spygliukas;Skruzdėliukai;9070219319;Taip;4;0;0;4
18829;Spygliukas;Skruzdėliukai;9285259322;Taip;0;6;3;9
18830;Spygliukas;Skruzdėliukai;8806126755;Taip;10;0;4;14
18831;Spygliukas;Skruzdėliukai;8476882854;Taip;20;0;0;20
18832;Spygliukas;Skruzdėliukai;4245624629;Taip;1;0;0;1
18833;Spygliukas;Skruzdėliukai;6332646009;Taip;10;0;0;10
18834;Spygliukas;Skruzdėliukai;3706443395;Taip;10;0;0;10
18835;Spygliukas;Skruzdėliukai;9112172144;Taip;20;0;0;20
18836;Spygliukas;Skruzdėliukai;5765106914;Taip;0;0;5;5
18837;Spygliukas;Skruzdėliukai;2395961015;Taip;5;0;1;6
18838;Spygliukas;Voveraitės;5049529300;Taip;0;0;1;1
18839;Spygliukas;Voveraitės;1987926577;Taip;0;0;1;1
18840;Spygliukas;Voveraitės;1367964100;Taip;11;5;1;17
18841;Spygliukas;Voveraitės;1773639994;Taip;14;0;0;14
18842;Spygliukas;Voveraitės;2066739772;Taip;10;0;0;10
18843;Spygliukas;Voveraitės;8596667547;Taip;10;0;2;12
18844;Spygliukas;Voveraitės;1042495269;Taip;2;2;0;4
18845;Spygliukas;Voveraitės;1590677993;Taip;17;0;0;17
18846;Spygliukas;Voveraitės;1030973848;Taip;5;0;0;5
18847;Spygliukas;Voveraitės;1935233612;Taip;0;9;0;9
18848;Spygliukas;Voveraitės;8801225066;Taip;20;0;0;20
18849;Spygliukas;Voveraitės;8453683673;Ne;6;5;0;11
18850;Spygliukas;Voveraitės;16828631895;Taip;15;0;0;15
18851;Spygliukas;Voveraitės;1045253540;Taip;11;0;0;11
18852;Spygliukas;Voveraitės;1415694208;Taip;0;0;5;5
18853;Spygliukas;Voveraitės;2671842885;Taip;0;6;0;6
18854;Spygliukas;Voveraitės;6460911796;Taip;11;0;0;11
18855;Spygliukas;Giliukų;7271659513;Taip;14;2;0;16
18856;Spygliukas;Giliukų;8708083787;Taip;5;11;0;16
18857;Spygliukas;Giliukų;9413950200;Taip;20;0;0;20
18858;Spygliukas;Giliukų;1664878188;Taip;14;0;0;14
18859;Spygliukas;Giliukų;8604767396;Taip;19;0;0;19
18860;Spygliukas;Giliukų;4634660174;Taip;5;0;4;9
18861;Spygliukas;Giliukų;4368224847;Taip;16;0;0;16
18862;Spygliukas;Giliukų;1333556956;Taip;6;0;2;8
18863;Spygliukas;Giliukų;9316731983;Taip;0;2;0;2
18864;Spygliukas;Giliukų;5012876830;Taip;0;0;8;8
18865;Spygliukas;Giliukų;2315421636;Taip;5;0;0;5
18866;Spygliukas;Giliukų;7125425492;Taip;5;0;1;6
18867;Spygliukas;Giliukų;7928675053;Taip;12;0;0;12
18868;Spygliukas;Giliukų;1974541155;Taip;11;0;3;14
18869;Spygliukas;Giliukų;4505044604;Taip;10;0;0;10
18870;Spygliukas;Giliukų;2989701249;Taip;11;0;1;12
18871;Vieversys;Žirniukai;1149316471;Taip;0;7;0;7
18872;Vieversys;Žirniukai;1728554204;Taip;6;0;3;9
18873;Vieversys;Žirniukai;9612415733;Taip;0;0;10;10
18874;Vieversys;Žirniukai;5917328379;Taip;10;1;1;12
18875;Vieversys;Žirniukai;53977164888;Taip;10;2;0;12
18876;Vieversys;Žirniukai;82594887399;Taip;0;4;0;4
18877;Vieversys;Žirniukai;7500147648;Taip;3;0;1;4
18878;Vieversys;Žirniukai;2621046003;Taip;0;0;7;7
18879;Vieversys;Žirniukai;9835682858;Taip;0;13;0;13
18880;Vieversys;Žirniukai;6596979763;Taip;0;4;0;4
18881;Vieversys;Žirniukai;5286521728;Taip;6;3;0;9
18882;Vieversys;Žirniukai;8038341998;Taip;0;1;0;1
18883;Vieversys;Žirniukai;1247565595;Taip;0;0;1;1
18884;Vieversys;Žirniukai;6720355390;Taip;0;0;5;5
18885;Vieversys;Žirniukai;4313822180;Taip;0;5;0;5
18886;Vieversys;Žirniukai;7812227428;Taip;0;3;0;3
18887;Vieversys;Žirniukai;4455039401;Taip;0;6;0;6
18888;Vieversys;Žirniukai;5810605263;Taip;9;0;0;9
18889;Vieversys;Varpelių;28104354125;Taip;5;4;0;9
18890;Vieversys;Varpelių;38299255111;Taip;3;11;0;14
18891;Vieversys;Varpelių;62353706235;Taip;0;7;0;7
18892;Vieversys;Varpelių;77923009476;Ne;6;0;0;6
18893;Vieversys;Varpelių;45357053527;Taip;0;7;0;7
18894;Vieversys;Varpelių;34168958939;Taip;0;6;0;6
18895;Vieversys;Varpelių;14996772979;Taip;0;4;0;4
18896;Vieversys;Varpelių;23619480101;Taip;0;5;0;5
18897;Vieversys;Varpelių;44390886220;Taip;5;8;0;13
18898;Vieversys;Varpelių;46546501255;Taip;0;2;0;2
18899;Vieversys;Varpelių;82621820592;Ne;0;2;0;2
18900;Vieversys;Varpelių;34243919860;Taip;2;0;0;2
18901;Vieversys;Varpelių;75611111703;Taip;0;1;0;1
18902;Vieversys;Varpelių;7125531057;Taip;1;1;0;2
18903;Vieversys;Varpelių;19269924365;Taip;3;1;0;4
18904;Vieversys;Varpelių;22124989131;Taip;2;0;0;2
18905;Vieversys;Varpelių;47592438021;Taip;9;0;0;9
18906;Vieversys;Varpelių;99472642769;Taip;5;4;0;9
18907;Vieversys;Varpelių;33471460574;Taip;5;4;0;9
18908;Vieversys;Varpelių;69205152313;Taip;5;3;0;8
18909;Vieversys;Varpelių;24253818919;Taip;10;4;0;14
18910;Vieversys;Varpelių;12049674063;Taip;11;1;0;12
18911;Vieversys;Varpelių;27238159965;Taip;0;2;1;3
18912;Vieversys;Kiškučių;30327960835;Taip;0;7;0;7
18913;Vieversys;Kiškučių;39075572706;Taip;7;1;0;8
18914;Vieversys;Kiškučių;96715131735;Taip;12;0;4;16
18915;Vieversys;Kiškučių;64744067804;Taip;0;3;0;3
18916;Vieversys;Kiškučių;14962042306;Taip;7;2;0;9
18917;Vieversys;Kiškučių;66729897399;Taip;0;5;1;6
18918;Vieversys;Kiškučių;1718832864;Taip;0;5;0;5
18919;Vieversys;Kiškučių;1013523504;Taip;0;5;0;5
18920;Vieversys;Kiškučių;2880573300;Taip;0;7;0;7
18921;Vieversys;Kiškučių;27461921981;Taip;4;3;0;7
18922;Vieversys;Kiškučių;1076420513;Taip;0;9;3;12
18923;Vieversys;Kiškučių;9869051482;Taip;3;2;0;5
18924;Vieversys;Kiškučių;1685871173;Taip;2;3;0;5
18925;Vieversys;Kiškučių;6589649248;Taip;0;6;0;6
18926;Vieversys;Kiškučių;6241670100;Taip;9;1;0;10
18927;Vieversys;Kiškučių;9050145547;Taip;8;0;0;8
18928;Vieversys;Kiškučių;9126904852;Taip;6;3;0;9
18929;Vieversys;Kiškučių;70851901929;Taip;8;2;0;10
18930;Vieversys;Kiškučių;81372830000;Taip;0;2;1;3
18931;Vieversys;Kiškučių;32507428250;Taip;0;1;0;1
18932;Vieversys;Kiškučių;55017305306;Taip;6;2;0;8
18933;Vieversys;Kiškučių;7445136223;Taip;1;0;0;1
18934;Vieversys;Pelėdžiukų;8421719030;Taip;8;0;3;11
18935;Vieversys;Pelėdžiukų;77272293257;Taip;0;1;0;1
18936;Vieversys;Pelėdžiukų;94463134058;Taip;0;11;0;11
18937;Vieversys;Pelėdžiukų;5434952733;Taip;11;0;0;11
18938;Vieversys;Pelėdžiukų;7578552471;Taip;5;0;0;5
18939;Vieversys;Pelėdžiukų;2193074123;Taip;9;0;0;9
18940;Vieversys;Pelėdžiukų;6314183312;Taip;6;12;0;18
18941;Vieversys;Pelėdžiukų;7007620994;Taip;3;1;1;5
18942;Vieversys;Pelėdžiukų;9499315463;Taip;12;0;0;12
18943;Vieversys;Pelėdžiukų;9774365819;Taip;15;5;0;20
18944;Vieversys;Pelėdžiukų;9494957750;Taip;6;0;1;7
18945;Vieversys;Pelėdžiukų;2521488728;Taip;11;0;0;11
18946;Vieversys;Pelėdžiukų;6473759470;Taip;11;3;0;14
18947;Vieversys;Pelėdžiukų;1120594293;Taip;5;2;1;8
18948;Vieversys;Pelėdžiukų;1273951001;Taip;0;1;4;5
18949;Vieversys;Pelėdžiukų;48430863473;Taip;8;12;0;20
18950;Vieversys;Pelėdžiukų;50181034746;Taip;15;0;0;15
18951;Vieversys;Pelėdžiukų;1338476746;Taip;0;7;0;7
18952;Vieversys;Pelėdžiukų;1027693153;Taip;20;0;0;20
18953;Vieversys;Pelėdžiukų;5871715452;Taip;11;0;2;13
18954;Vieversys;Pelėdžiukų;7676796264;Taip;0;7;0;7
18955;Vieversys;Pelėdžiukų;9659337657;Taip;11;0;0;11
18956;Vieversys;Pelėdžiukų;3458399180;Taip;16;2;0;18
18957;Vieversys;Saulučių;1541501314;Taip;0;6;0;6
18958;Vieversys;Saulučių;7570842283;Taip;0;12;0;12
18959;Vieversys;Saulučių;77521284935;Ne;9;0;0;9
18960;Vieversys;Saulučių;61390281978;Taip;0;1;5;6
18961;Vieversys;Saulučių;1061337795;Taip;0;1;0;1
18962;Vieversys;Saulučių;9504543902;Taip;14;0;0;14
18963;Vieversys;Saulučių;1015724611;Taip;14;0;0;14
18964;Vieversys;Saulučių;85223909900;Taip;0;16;0;16
18965;Vieversys;Saulučių;63958110408;Ne;0;10;0;10
18966;Vieversys;Saulučių;27991039593;Taip;0;2;2;4
18967;Vieversys;Saulučių;53189421149;Taip;0;2;5;7
18968;Vieversys;Saulučių;75642591987;Taip;5;1;0;6
18969;Vieversys;Saulučių;49209207608;Taip;7;0;0;7
18970;Vieversys;Saulučių;97077298066;Taip;8;0;0;8
18971;Vieversys;Saulučių;99897529822;Taip;0;1;1;2
18972;Vieversys;Saulučių;95352162960;Taip;0;7;0;7
18973;Vieversys;Saulučių;81494754248;Taip;6;8;0;14
18974;Vieversys;Saulučių;12419984038;Taip;0;4;3;7
18975;Vieversys;Saulučių;18608150261;Taip;0;7;0;7
18976;Vieversys;Saulučių;81766053731;Taip;0;1;0;1
18977;Vieversys;Saulučių;67610801335;Taip;2;1;0;3
18978;Vieversys;Kregždučių;55553505459;Taip;0;15;4;19
18979;Vieversys;Kregždučių;16002848795;Taip;0;15;4;19
18980;Vieversys;Kregždučių;1933907389;Taip;3;0;1;4
18981;Vieversys;Kregždučių;1462608187;Taip;0;1;1;2
18982;Vieversys;Kregždučių;2130449373;Taip;8;0;0;8
18983;Vieversys;Kregždučių;44086673096;Taip;0;4;1;5
18984;Vieversys;Kregždučių;89223502405;Taip;14;6;0;20
18985;Vieversys;Kregždučių;41215224179;Taip;11;4;0;15
18986;Vieversys;Kregždučių;938801303;Taip;0;4;0;4
18987;Vieversys;Kregždučių;2141967793;Taip;10;1;0;11
18988;Vieversys;Kregždučių;2128428329;Taip;10;1;0;11
18989;Vieversys;Kregždučių;1190396975;Taip;0;1;0;1
18990;Vieversys;Kregždučių;62465517391;Taip;0;8;0;8
18991;Vieversys;Kregždučių;5123994167;Taip;5;8;0;13
18992;Vieversys;Kregždučių;12524976076;Taip;7;1;0;8
18993;Vieversys;Kregždučių;1300013110;Taip;8;1;0;9
18994;Vieversys;Kregždučių;61101237391;Taip;9;1;0;10
18995;Vieversys;Kregždučių;1716198618;Taip;8;3;0;11
18996;Vieversys;Kregždučių;8213134622;Taip;14;0;1;15
18997;Vieversys;Kregždučių;2879546284;Taip;0;1;2;3
18998;Vieversys;Kregždučių;3839507103;Taip;8;1;0;9
18999;Vieversys;Kregždučių;2511719188;Taip;9;0;0;9
19000;Vieversys;Kregždučių;6077365803;Taip;7;0;0;7
19001;Vieversys;Kregždučių;46624143347;Taip;11;0;0;11
19002;Vieversys;Kregždučių;73657188876;Taip;15;0;0;15
19003;Vieversys;Boružėlių;6236703869;Taip;5;0;0;5
19004;Vieversys;Boružėlių;6116471730;Taip;3;3;0;6
19005;Vieversys;Boružėlių;1815073796;Taip;4;0;0;4
19006;Vieversys;Boružėlių;32630544785;Taip;0;0;2;2
19007;Vieversys;Boružėlių;20960056744;Taip;3;4;3;10
19008;Vieversys;Boružėlių;95472887427;Taip;9;1;0;10
19009;Vieversys;Boružėlių;63262366859;Taip;7;7;0;14
19010;Vieversys;Boružėlių;58287759954;Taip;7;0;1;8
19011;Vieversys;Boružėlių;1580917200;Taip;5;12;0;17
19012;Vieversys;Boružėlių;86213464121;Taip;3;1;0;4
19013;Vieversys;Boružėlių;55764266970;Taip;20;0;0;20
19014;Vieversys;Boružėlių;1588939300;Taip;3;0;0;3
19015;Vieversys;Boružėlių;86119860485;Taip;8;0;0;8
19016;Vieversys;Boružėlių;1028950997;Taip;6;0;1;7
19017;Vieversys;Boružėlių;14574836082;Taip;6;1;0;7
19018;Vieversys;Boružėlių;95886969053;Taip;8;0;1;9
19019;Vieversys;Boružėlių;95891054066;Taip;8;0;0;8
19020;Vieversys;Boružėlių;5197639355;Taip;4;0;0;4
19021;Vieversys;Boružėlių;8744701209;Taip;2;8;0;10
19022;Vieversys;Boružėlių;1700010494;Taip;0;12;0;12
19023;Vieversys;Boružėlių;1715902540;Taip;0;9;0;9
19024;Vieversys;Bitučių;75434941104;Taip;0;2;0;2
19025;Vieversys;Bitučių;25198979253;Taip;0;6;0;6
19026;Vieversys;Bitučių;2034386236;Taip;0;16;0;16
19027;Vieversys;Bitučių;83420473111;Taip;0;9;0;9
19028;Vieversys;Bitučių;26092685300;Taip;0;7;0;7
19029;Vieversys;Bitučių;56670426557;Taip;9;0;0;9
19030;Vieversys;Bitučių;93582609868;Taip;9;0;0;9
19031;Vieversys;Bitučių;22275121492;Taip;5;4;0;9
19032;Vieversys;Bitučių;35144734547;Taip;5;0;0;5
19033;Vieversys;Bitučių;34494816770;Taip;2;0;1;3
19034;Vieversys;Bitučių;27123496741;Taip;5;3;0;8
19035;Vieversys;Bitučių;63139698249;Taip;0;1;0;1
19036;Vieversys;Bitučių;66155667200;Taip;0;0;3;3
19037;Vieversys;Bitučių;68374560306;Taip;0;0;12;12
19038;Vieversys;Bitučių;78901148667;Taip;0;1;0;1
19039;Vieversys;Bitučių;7126970560;Taip;0;4;0;4
19040;Vieversys;Bitučių;61951858540;Taip;0;1;1;2
19041;Vieversys;Bitučių;5157022077;Taip;0;7;0;7
19042;Vieversys;Bitučių;1371669237;Taip;0;11;0;11
19043;Vieversys;Smalsučių;15665213757;Taip;0;9;0;9
19044;Vieversys;Smalsučių;1307701524;Taip;6;3;0;9
19045;Vieversys;Smalsučių;89564962534;Taip;5;1;0;6
19046;Vieversys;Smalsučių;8966153890;Taip;0;1;0;1
19047;Vieversys;Smalsučių;65696183376;Taip;7;0;0;7
19048;Vieversys;Smalsučių;50929651251;Taip;3;3;0;6
19049;Vieversys;Smalsučių;65625227882;Taip;5;0;0;5
19050;Vieversys;Smalsučių;29002693436;Taip;0;0;3;3
19051;Vieversys;Smalsučių;84134333980;Taip;0;3;3;6
19052;Vieversys;Smalsučių;9980447111;Taip;0;1;0;1
19053;Vieversys;Smalsučių;41282339758;Taip;3;3;0;6
19054;Vieversys;Smalsučių;2733479642;Taip;1;0;0;1
19055;Vieversys;Smalsučių;25843076066;Taip;0;5;0;5
19056;Vieversys;Smalsučių;72475350152;Taip;0;4;0;4
19057;Vieversys;Smalsučių;61074394922;Taip;1;0;1;2
19058;Vieversys;Smalsučių;11528430680;Taip;3;4;0;7
19059;Vieversys;Smalsučių;67471794738;Taip;4;1;0;5
19060;Vieversys;Smalsučių;13768739410;Taip;0;6;0;6
19061;Vieversys;Smalsučių;45707453869;Taip;0;4;0;4
19062;Vieversys;Smalsučių;79197759451;Taip;6;2;0;8
19063;Vieversys;Smalsučių;6427430220;Taip;0;4;16;20
19064;Vieversys;Smalsučių;2010825247;Taip;14;5;0;19
19065;Vieversys;Smalsučių;2561825171;Taip;0;0;5;5
19066;Vieversys;Kodėlčiukų;2006826758;Taip;10;1;0;11
19067;Vieversys;Kodėlčiukų;3907748584;Taip;3;0;0;3
19068;Vieversys;Kodėlčiukų;16928192553;Taip;16;4;0;20
19069;Vieversys;Kodėlčiukų;2756075736;Taip;0;4;0;4
19070;Vieversys;Kodėlčiukų;69275621813;Taip;4;8;0;12
19071;Vieversys;Kodėlčiukų;1455615413;Taip;14;0;0;14
19072;Vieversys;Kodėlčiukų;1970088958;Taip;0;8;2;10
19073;Vieversys;Kodėlčiukų;1586720551;Taip;0;0;5;5
19074;Vieversys;Kodėlčiukų;9012978017;Taip;0;7;0;7
19075;Vieversys;Kodėlčiukų;1738313365;Taip;0;0;10;10
19076;Vieversys;Kodėlčiukų;1766638116;Taip;0;0;1;1
19077;Vieversys;Kodėlčiukų;1599787985;Taip;5;0;3;8
19078;Vieversys;Kodėlčiukų;1491424075;Taip;7;0;3;10
19079;Vieversys;Kodėlčiukų;1361494430;Taip;6;0;0;6
19080;Vieversys;Kodėlčiukų;9829388743;Taip;5;9;0;14
19081;Vieversys;Kodėlčiukų;1878278158;Taip;7;0;3;10
19082;Vieversys;Kodėlčiukų;7315438787;Taip;9;0;0;9
19083;Vieversys;Kodėlčiukų;16617102917;Taip;10;0;0;10
19084;Vieversys;Kodėlčiukų;93675768307;Taip;0;2;0;2
19085;Vieversys;Kodėlčiukų;3792076932;Taip;3;0;3;6
19086;Vieversys;Kodėlčiukų;69295745570;Taip;0;0;1;1
19087;Vieversys;NYKŠTUKAI;5769453869;Taip;11;4;0;15
19088;Vieversys;NYKŠTUKAI;5922485482;Taip;0;4;0;4
19089;Vieversys;NYKŠTUKAI;9164615794;Taip;0;10;0;10
19090;Vieversys;NYKŠTUKAI;3684937630;Taip;0;1;0;1
19091;Vieversys;NYKŠTUKAI;6563139211;Taip;2;2;0;4
19092;Vieversys;NYKŠTUKAI;4294676988;Taip;6;0;0;6
19093;Vieversys;NYKŠTUKAI;4835022593;Taip;4;0;0;4
19094;Vieversys;NYKŠTUKAI;4778339658;Taip;9;6;0;15
19095;Vieversys;NYKŠTUKAI;7120329258;Taip;0;4;0;4
19096;Vieversys;NYKŠTUKAI;9387421639;Taip;4;8;0;12
19097;Vieversys;NYKŠTUKAI;8174124875;Taip;8;0;0;8
19098;Vieversys;DRUGELIAI;3405502715;Taip;10;0;0;10
19099;Vieversys;DRUGELIAI;6127272124;Taip;9;0;2;11
19100;Vieversys;DRUGELIAI;5654533451;Taip;5;4;0;9
19101;Vieversys;DRUGELIAI;9972526744;Taip;4;10;0;14
19102;Vieversys;DRUGELIAI;7998100115;Taip;10;2;0;12
19103;Vieversys;DRUGELIAI;7048475906;Taip;14;0;0;14
19104;Vieversys;DRUGELIAI;6031200259;Taip;15;0;0;15
19105;Vieversys;DRUGELIAI;6110034652;Taip;9;0;2;11
19106;Vieversys;DRUGELIAI;7596355010;Taip;0;16;0;16
19107;Vieversys;DRUGELIAI;4072323869;Taip;13;2;0;15
19108;Vieversys;DRUGELIAI;1931955562;Taip;0;0;8;8
19109;Žirmūnėliai;SAULUTĖS;8030469722;Taip;10;0;0;10
19110;Žirmūnėliai;SAULUTĖS;1258769646;Taip;0;4;0;4
19111;Žirmūnėliai;SAULUTĖS;3166454638;Taip;7;0;2;9
19112;Žirmūnėliai;SAULUTĖS;73664204182;Taip;5;1;1;7
19113;Žirmūnėliai;SAULUTĖS;1725143117;Taip;3;1;0;4
19114;Žirmūnėliai;SAULUTĖS;1073135587;Taip;0;15;0;15
19115;Žirmūnėliai;SAULUTĖS;4598761492;Taip;0;8;0;8
19116;Žirmūnėliai;SAULUTĖS;3128190518;Taip;9;4;0;13
19117;Žirmūnėliai;SAULUTĖS;8317328771;Taip;3;4;0;7
19118;Žirmūnėliai;SAULUTĖS;7562464310;Taip;7;4;4;15
19119;Žirmūnėliai;SAULUTĖS;1478039469;Taip;8;0;0;8
19120;Žirmūnėliai;SAULUTĖS;6896145409;Taip;12;2;0;14
19121;Žirmūnėliai;SAULUTĖS;72738770293;Taip;0;2;0;2
19122;Žirmūnėliai;SAULUTĖS;5009619812;Taip;0;4;0;4
19123;Žirmūnėliai;SAULUTĖS;4517290068;Taip;5;2;0;7
19124;Žirmūnėliai;SAULUTĖS;1582563837;Taip;10;0;0;10
19125;Žirmūnėliai;SAULUTĖS;1381923106;Taip;14;0;0;14
19126;Žirmūnėliai;SAULUTĖS;5037669167;Taip;0;14;1;15
19127;Žirmūnėliai;SAULUTĖS;1761284228;Taip;6;0;1;7
19128;Žirmūnėliai;SAULUTĖS;41018224936;Taip;4;6;0;10
19129;Žirmūnėliai;SAULUTĖS;1894070647;Taip;0;4;0;4
19130;Žirmūnėliai;SAULUTĖS;1347664230;Taip;0;19;0;19
19131;Žirmūnėliai;GILIUKAI;37231106844;Taip;5;0;0;5
19132;Žirmūnėliai;GILIUKAI;5673929155;Taip;0;14;0;14
19133;Žirmūnėliai;GILIUKAI;50829749038;Taip;5;2;1;8
19134;Žirmūnėliai;GILIUKAI;68678277635;Taip;9;0;2;11
19135;Žirmūnėliai;GILIUKAI;1401250193;Taip;5;0;0;5
19136;Žirmūnėliai;GILIUKAI;1818060330;Taip;0;5;0;5
19137;Žirmūnėliai;GILIUKAI;1963980356;Taip;0;4;0;4
19138;Žirmūnėliai;GILIUKAI;1302040861;Taip;8;2;0;10
19139;Žirmūnėliai;GILIUKAI;17294365627;Taip;18;0;0;18
19140;Žirmūnėliai;GILIUKAI;99546532431;Taip;0;10;0;10
19141;Žirmūnėliai;GILIUKAI;1816123753;Taip;0;7;0;7
19142;Žirmūnėliai;GILIUKAI;1308593517;Taip;0;5;0;5
19143;Žirmūnėliai;GILIUKAI;53028161711;Taip;0;3;0;3
19144;Žirmūnėliai;GILIUKAI;6578685370;Taip;13;0;0;13
19145;Žirmūnėliai;GILIUKAI;1493536049;Taip;11;1;0;12
19146;Žirmūnėliai;GILIUKAI;1734624632;Taip;10;0;0;10
19147;Žirmūnėliai;GILIUKAI;1626619024;Taip;7;1;0;8
19148;Žirmūnėliai;GILIUKAI;8824743884;Taip;0;2;0;2
19149;Žirmūnėliai;GILIUKAI;1039316424;Taip;5;9;0;14
19150;Žirmūnėliai;GILIUKAI;2117670819;Taip;10;1;0;11
19151;Žirmūnėliai;GILIUKAI;1556389237;Taip;13;0;0;13
19152;Žirmūnėliai;GILIUKAI;1764226619;Taip;8;0;0;8
19153;Žirmūnėliai;DAINORĖLIAI;31231655300;Taip;5;0;13;18
19154;Žirmūnėliai;DAINORĖLIAI;1563132542;Taip;0;10;0;10
19155;Žirmūnėliai;DAINORĖLIAI;1235090013;Taip;8;5;0;13
19156;Žirmūnėliai;DAINORĖLIAI;6274222785;Taip;5;4;0;9
19157;Žirmūnėliai;DAINORĖLIAI;1395294607;Taip;9;0;2;11
19158;Žirmūnėliai;DAINORĖLIAI;7777166572;Taip;0;6;0;6
19159;Žirmūnėliai;DAINORĖLIAI;4136421440;Taip;10;5;0;15
19160;Žirmūnėliai;DAINORĖLIAI;36822027549;Taip;0;0;15;15
19161;Žirmūnėliai;DAINORĖLIAI;22385656372;Taip;0;5;0;5
19162;Žirmūnėliai;DAINORĖLIAI;58158145123;Taip;4;0;1;5
19163;Žirmūnėliai;DAINORĖLIAI;1302022463;Taip;0;7;0;7
19164;Žirmūnėliai;DAINORĖLIAI;1017903291;Taip;0;12;0;12
19165;Žirmūnėliai;DAINORĖLIAI;52524235797;Taip;0;0;1;1
19166;Žirmūnėliai;DAINORĖLIAI;5450253994;Taip;5;0;0;5
19167;Žirmūnėliai;DAINORĖLIAI;97123184267;Taip;0;0;1;1
19168;Žirmūnėliai;DAINORĖLIAI;81408646754;Taip;19;1;0;20
19169;Žirmūnėliai;DAINORĖLIAI;67024451309;Taip;16;0;0;16
19170;Žirmūnėliai;DAINORĖLIAI;87693490164;Taip;14;0;1;15
19171;Žirmūnėliai;DAINORĖLIAI;39347099487;Taip;3;7;0;10
19172;Žirmūnėliai;DAINORĖLIAI;2548081116;Taip;5;0;7;12
19173;Žirmūnėliai;DRUGELIAI;5276699877;Taip;6;4;0;10
19174;Žirmūnėliai;DRUGELIAI;6531982232;Taip;9;0;0;9
19175;Žirmūnėliai;DRUGELIAI;57457297276;Taip;5;3;0;8
19176;Žirmūnėliai;DRUGELIAI;20851917855;Taip;7;7;0;14
19177;Žirmūnėliai;DRUGELIAI;26463655365;Taip;0;1;0;1
19178;Žirmūnėliai;DRUGELIAI;28826938550;Taip;0;6;0;6
19179;Žirmūnėliai;DRUGELIAI;12766765793;Taip;0;12;0;12
19180;Žirmūnėliai;DRUGELIAI;51268874840;Taip;0;1;0;1
19181;Žirmūnėliai;DRUGELIAI;34205058356;Taip;8;0;1;9
19182;Žirmūnėliai;DRUGELIAI;65010448998;Taip;0;5;0;5
19183;Žirmūnėliai;DRUGELIAI;45541156029;Taip;0;6;0;6
19184;Žirmūnėliai;DRUGELIAI;30933761145;Taip;9;1;0;10
19185;Žirmūnėliai;DRUGELIAI;63972399637;Taip;7;0;0;7
19186;Žirmūnėliai;DRUGELIAI;33441696614;Taip;6;0;0;6
19187;Žirmūnėliai;DRUGELIAI;96121856269;Taip;0;3;0;3
19188;Žirmūnėliai;DRUGELIAI;86142962074;Taip;0;4;0;4
19189;Žirmūnėliai;DRUGELIAI;32213803056;Taip;10;1;0;11
19190;Žirmūnėliai;DRUGELIAI;61531418513;Taip;0;4;7;11
19191;Žirmūnėliai;DRUGELIAI;1157270725;Taip;0;15;0;15
19192;Žirmūnėliai;BORUŽIUKAI;78370998321;Taip;0;1;1;2
19193;Žirmūnėliai;BORUŽIUKAI;1829748362;Taip;1;4;1;6
19194;Žirmūnėliai;BORUŽIUKAI;1372276406;Taip;1;4;1;6
19195;Žirmūnėliai;BORUŽIUKAI;1035797918;Taip;14;0;5;19
19196;Žirmūnėliai;BORUŽIUKAI;18304538215;Taip;0;1;0;1
19197;Žirmūnėliai;BORUŽIUKAI;95773705800;Taip;1;1;2;4
19198;Žirmūnėliai;BORUŽIUKAI;8102425956;Taip;0;4;0;4
19199;Žirmūnėliai;BORUŽIUKAI;90766071337;Taip;10;7;0;17
19200;Žirmūnėliai;BORUŽIUKAI;15975463125;Taip;0;14;0;14
19201;Žirmūnėliai;BORUŽIUKAI;1657682030;Taip;2;1;0;3
19202;Žirmūnėliai;BORUŽIUKAI;19381396167;Taip;0;11;0;11
19203;Žirmūnėliai;BORUŽIUKAI;56898425468;Taip;0;8;0;8
19204;Žirmūnėliai;BORUŽIUKAI;50544167833;Taip;10;0;0;10
19205;Žirmūnėliai;BORUŽIUKAI;80136538031;Taip;0;9;0;9
19206;Žirmūnėliai;BORUŽIUKAI;314818952;Taip;0;3;5;8
19207;Žirmūnėliai;BORUŽIUKAI;85416619940;Taip;5;0;0;5
19208;Žirmūnėliai;BORUŽIUKAI;21555650432;Taip;0;5;1;6
19209;Žirmūnėliai;BORUŽIUKAI;74577288891;Taip;6;0;0;6
19210;Žirmūnėliai;BORUŽIUKAI;66321657576;Taip;0;4;0;4
19211;Žirmūnėliai;BORUŽIUKAI;86703668087;Taip;9;5;0;14
19212;Žirmūnėliai;BORUŽIUKAI;53551605972;Taip;0;1;0;1
19213;Žirmūnėliai;BORUŽIUKAI;39102695648;Taip;0;15;0;15
19214;Žirmūnėliai;EŽIUKAI;92309760554;Taip;0;6;0;6
19215;Žirmūnėliai;EŽIUKAI;44456428269;Taip;7;0;0;7
19216;Žirmūnėliai;EŽIUKAI;35616673148;Taip;0;3;0;3
19217;Žirmūnėliai;EŽIUKAI;48862129796;Taip;0;3;0;3
19218;Žirmūnėliai;EŽIUKAI;54806598855;Taip;13;8;0;21
19219;Žirmūnėliai;EŽIUKAI;46197353715;Taip;0;11;0;11
19220;Žirmūnėliai;EŽIUKAI;17545423567;Taip;12;0;1;13
19221;Žirmūnėliai;EŽIUKAI;20369719665;Taip;0;1;0;1
19222;Žirmūnėliai;EŽIUKAI;85930381350;Taip;0;3;0;3
19223;Žirmūnėliai;EŽIUKAI;16233364560;Taip;10;0;0;10
19224;Žirmūnėliai;EŽIUKAI;35378773414;Taip;10;0;0;10
19225;Žirmūnėliai;EŽIUKAI;33734698275;Taip;0;5;5;10
19226;Žirmūnėliai;EŽIUKAI;83168188715;Taip;0;18;0;18
19227;Žirmūnėliai;EŽIUKAI;61198138773;Taip;5;2;0;7
19228;Žirmūnėliai;EŽIUKAI;58752542772;Taip;0;7;0;7
19229;Žirmūnėliai;EŽIUKAI;7492054582;Ne;0;0;1;1
19230;Žirmūnėliai;ŽVIRBLIUKAI;19423526288;Taip;0;9;0;9
19231;Žirmūnėliai;ŽVIRBLIUKAI;62973311453;Taip;0;4;0;4
19232;Žirmūnėliai;ŽVIRBLIUKAI;15705213099;Taip;5;3;0;8
19233;Žirmūnėliai;ŽVIRBLIUKAI;60871701395;Taip;7;0;0;7
19234;Žirmūnėliai;ŽVIRBLIUKAI;30822135334;Taip;9;0;0;9
19235;Žirmūnėliai;ŽVIRBLIUKAI;55413493068;Taip;5;3;0;8
19236;Žirmūnėliai;ŽVIRBLIUKAI;77610647849;Taip;0;4;0;4
19237;Žirmūnėliai;ŽVIRBLIUKAI;39786518345;Taip;5;0;1;6
19238;Žirmūnėliai;ŽVIRBLIUKAI;53003464638;Taip;5;0;0;5
19239;Žirmūnėliai;ŽVIRBLIUKAI;49856210236;Taip;13;3;0;16
19240;Žirmūnėliai;ŽVIRBLIUKAI;1150419333;Taip;6;2;0;8
19241;Žirmūnėliai;ŽVIRBLIUKAI;6262600436;Taip;0;7;2;9
19242;Žirmūnėliai;ŽVIRBLIUKAI;73552867802;Taip;9;0;0;9
19243;Žirmūnėliai;ŽVIRBLIUKAI;1492168972;Taip;8;0;0;8
19244;Žirmūnėliai;ŽVIRBLIUKAI;38316483993;Taip;8;0;0;8
19245;Žirmūnėliai;ŽVIRBLIUKAI;1250060420;Taip;14;0;0;14
19246;Žirmūnėliai;ŽVIRBLIUKAI;1477593223;Taip;5;1;0;6
19247;Žirmūnėliai;ŽVIRBLIUKAI;3896978775;Taip;8;0;0;8
19248;Žirmūnėliai;ŽVIRBLIUKAI;7165846395;Taip;0;2;5;7
19249;Žirmūnėliai;ŽVIRBLIUKAI;1049041500;Taip;6;1;0;7
19250;Žirmūnėliai;ŽVIRBLIUKAI;50088185187;Taip;0;6;0;6
19251;Žirmūnėliai;SPALVELĖS;1634724759;Taip;4;5;0;9
19252;Žirmūnėliai;SPALVELĖS;99980167497;Taip;9;0;0;9
19253;Žirmūnėliai;SPALVELĖS;88436070676;Taip;0;6;7;13
19254;Žirmūnėliai;SPALVELĖS;18266666204;Taip;0;6;0;6
19255;Žirmūnėliai;SPALVELĖS;2538608908;Taip;0;4;0;4
19256;Žirmūnėliai;SPALVELĖS;22592450568;Taip;0;4;0;4
19257;Žirmūnėliai;SPALVELĖS;66100956443;Taip;9;0;5;14
19258;Žirmūnėliai;SPALVELĖS;85286691926;Taip;11;5;0;16
19259;Žirmūnėliai;SPALVELĖS;4986702792;Taip;0;6;3;9
19260;Žirmūnėliai;SPALVELĖS;86501162211;Taip;5;4;0;9
19261;Žirmūnėliai;SPALVELĖS;3691651489;Taip;0;0;14;14
19262;Žirmūnėliai;SPALVELĖS;1120531178;Taip;6;3;0;9
19263;Žirmūnėliai;SPALVELĖS;1273301982;Taip;4;0;1;5
19264;Žirmūnėliai;SPALVELĖS;29952298800;Taip;0;12;2;14
19265;Žirmūnėliai;SPALVELĖS;8348616350;Taip;10;1;0;11
19266;Žirmūnėliai;SPALVELĖS;1080735912;Taip;9;3;0;12
19267;Žirmūnėliai;SPALVELĖS;2127930970;Taip;16;1;0;17
19268;Žirmūnėliai;SPALVELĖS;3150467744;Taip;9;0;1;10
19269;Žirmūnėliai;SPALVELĖS;4710829908;Taip;6;1;0;7
19270;Žirmūnėliai;SPALVELĖS;7918747416;Taip;14;0;0;14
19271;Žirmūnėliai;SPALVELĖS;1865240339;Taip;15;0;0;15
19272;Žirmūnėliai;SPALVELĖS;8339819296;Taip;10;0;0;10
19273;Žirmūnėliai;SPALVELĖS;51723882387;Taip;5;6;1;12
19274;Žirmūnėliai;SPALVELĖS;8308074932;Taip;3;7;0;10
19275;Žirmūnėliai;DEBESĖLIAI;1119678857;Taip;0;14;0;14
19276;Žirmūnėliai;DEBESĖLIAI;37429281370;Taip;2;4;2;8
19277;Žirmūnėliai;DEBESĖLIAI;19044383213;Taip;8;0;0;8
19278;Žirmūnėliai;DEBESĖLIAI;76779474158;Taip;20;0;0;20
19279;Žirmūnėliai;DEBESĖLIAI;18242077086;Taip;0;4;0;4
19280;Žirmūnėliai;DEBESĖLIAI;99393944540;Taip;10;0;0;10
19281;Žirmūnėliai;DEBESĖLIAI;64969220116;Taip;6;13;0;19
19282;Žirmūnėliai;DEBESĖLIAI;1690539251;Taip;0;3;0;3
19283;Žirmūnėliai;DEBESĖLIAI;1542147528;Taip;12;0;0;12
19284;Žirmūnėliai;DEBESĖLIAI;5527904792;Taip;0;20;0;20
19285;Žirmūnėliai;DEBESĖLIAI;6161223611;Taip;8;0;0;8
19286;Žirmūnėliai;DEBESĖLIAI;2263604297;Taip;16;0;0;16
19287;Žirmūnėliai;DEBESĖLIAI;1618573494;Taip;14;3;0;17
19288;Žirmūnėliai;DEBESĖLIAI;5611315994;Taip;9;0;1;10
19289;Žirmūnėliai;DEBESĖLIAI;6337036947;Taip;16;0;0;16
19290;Žirmūnėliai;DEBESĖLIAI;2739395691;Taip;0;18;0;18
19291;Žirmūnėliai;DEBESĖLIAI;7528704460;Taip;9;0;1;10
19292;Žirmūnėliai;DEBESĖLIAI;3006508357;Taip;13;0;0;13
19293;Žirmūnėliai;DEBESĖLIAI;5125341440;Taip;10;0;0;10
19294;Žirmūnėliai;VIŠČIUKAI;6493142538;Taip;5;0;0;5
19295;Žirmūnėliai;VIŠČIUKAI;7892626521;Taip;9;0;0;9
19296;Žirmūnėliai;VIŠČIUKAI;1655437833;Taip;15;0;0;15
19297;Žirmūnėliai;VIŠČIUKAI;8999160836;Taip;11;2;1;14
19298;Žirmūnėliai;VIŠČIUKAI;8209309240;Taip;0;5;0;5
19299;Žirmūnėliai;VIŠČIUKAI;2693415717;Taip;10;0;1;11
19300;Žirmūnėliai;VIŠČIUKAI;8930536051;Taip;11;0;0;11
19301;Žirmūnėliai;VIŠČIUKAI;2837129621;Taip;10;0;3;13
19302;Žirmūnėliai;VIŠČIUKAI;1273684243;Taip;8;0;0;8
19303;Žirmūnėliai;VIŠČIUKAI;2971175236;Taip;10;0;0;10
19304;Žirmūnėliai;VIŠČIUKAI;7953019230;Taip;15;2;0;17
19305;Žirmūnėliai;VIŠČIUKAI;6982109508;Taip;5;0;4;9
19306;Žirmūnėliai;VIŠČIUKAI;6594728970;Taip;12;0;0;12
19307;Žirmūnėliai;VIŠČIUKAI;9478256549;Taip;11;1;0;12
19308;Žirmūnėliai;VIŠČIUKAI;5090067954;Taip;9;0;0;9
19309;Žirmūnėliai;VIŠČIUKAI;7422544482;Taip;4;5;1;10
19310;Žirmūnėliai;VIŠČIUKAI;4336415033;Taip;6;0;1;7
19311;Žirmūnėliai;VIŠČIUKAI;5209700153;Taip;4;0;0;4
19312;Žirmūnėliai;ZUIKUČIŲ;9378860669;Taip;14;0;0;14
19313;Žirmūnėliai;ZUIKUČIŲ;4218266688;Taip;0;0;1;1
19314;Žirmūnėliai;ZUIKUČIŲ;8607934394;Taip;5;2;0;7
19315;Žirmūnėliai;ZUIKUČIŲ;3449815783;Taip;5;0;0;5
19316;Žirmūnėliai;ZUIKUČIŲ;7996709950;Taip;0;7;0;7
19317;Žirmūnėliai;ZUIKUČIŲ;4638575301;Taip;6;4;4;14
19318;Žirmūnėliai;ZUIKUČIŲ;3562689670;Taip;12;5;0;17
19319;Žirmūnėliai;ZUIKUČIŲ;7020486370;Taip;14;0;0;14
19320;Žirmūnėliai;ZUIKUČIŲ;3274576752;Taip;20;0;0;20
19321;Žirmūnėliai;ZUIKUČIŲ;9541122034;Taip;11;0;0;11
19322;Žirmūnėliai;ZUIKUČIŲ;1571242696;Taip;0;1;2;3
19323;Žirmūnėliai;ZUIKUČIŲ;5736502380;Taip;15;0;0;15
19324;Žirmūnėliai;ZUIKUČIŲ;9154874729;Taip;8;0;0;8
19325;Žirmūnėliai;ZUIKUČIŲ;5723289396;Taip;0;0;1;1
19326;Žirmūnėliai;OBUOLIUKAI;9666769523;Taip;19;0;0;19
19327;Žirmūnėliai;OBUOLIUKAI;24877884441;Taip;12;1;0;13
19328;Žirmūnėliai;OBUOLIUKAI;85408994677;Taip;11;0;0;11
19329;Žirmūnėliai;OBUOLIUKAI;2336720944;Taip;0;1;0;1
19330;Žirmūnėliai;OBUOLIUKAI;1110585472;Taip;2;0;2;4
19331;Žirmūnėliai;OBUOLIUKAI;93072181228;Taip;8;0;0;8
19332;Žirmūnėliai;OBUOLIUKAI;1259227112;Taip;11;0;0;11
19333;Žirmūnėliai;OBUOLIUKAI;155054610;Taip;10;0;0;10
19334;Žirmūnėliai;OBUOLIUKAI;89429083939;Taip;8;0;0;8
19335;Žirmūnėliai;OBUOLIUKAI;35353356752;Taip;10;0;0;10
19336;Žirmūnėliai;OBUOLIUKAI;36305353664;Taip;8;0;0;8
19337;Žirmūnėliai;OBUOLIUKAI;4030572434;Taip;0;7;0;7
19338;Žirmūnėliai;OBUOLIUKAI;6758118659;Taip;0;7;0;7
19339;Žirmūnėliai;OBUOLIUKAI;24035212527;Taip;6;1;0;7
19340;Žirmūnėliai;OBUOLIUKAI;53081289792;Taip;6;0;0;6
19341;Žirmūnėliai;OBUOLIUKAI;65907675470;Taip;10;1;6;17
19342;Žirmūnėliai;OBUOLIUKAI;4675716163;Taip;8;0;0;8
19343;Žirmūnėliai;OBUOLIUKAI;2216383670;Taip;14;1;0;15
19344;Žirmūnėliai;OBUOLIUKAI;47645482781;Taip;10;0;0;10
19345;Žirmūnėliai;OBUOLIUKAI;9232201424;Taip;10;1;0;11
19346;Žirmūnėliai;OBUOLIUKAI;9448136354;Taip;9;1;4;14
19347;Dainorėliai;SAULUTĖS;79461209783;Ne;0;6;0;6
19348;Dainorėliai;SAULUTĖS;18741625569;Ne;0;6;0;6
19349;Dainorėliai;SAULUTĖS;98830139164;Taip;7;4;0;11
19350;Dainorėliai;SAULUTĖS;8762386907;Taip;12;0;0;12
19351;Dainorėliai;SAULUTĖS;15654726109;Taip;4;6;0;10
19352;Dainorėliai;SAULUTĖS;10679627657;Taip;0;5;0;5
19353;Dainorėliai;SAULUTĖS;37708779599;Taip;12;0;1;13
19354;Dainorėliai;SAULUTĖS;84424772471;Taip;0;2;1;3
19355;Dainorėliai;SAULUTĖS;98796240124;Taip;11;0;0;11
19356;Dainorėliai;SAULUTĖS;69556449215;Taip;0;6;0;6
19357;Dainorėliai;SAULUTĖS;84084897419;Taip;5;2;0;7
19358;Dainorėliai;SAULUTĖS;34686211072;Taip;0;8;0;8
19359;Dainorėliai;SAULUTĖS;64977015444;Taip;5;3;0;8
19360;Dainorėliai;SAULUTĖS;47323045857;Taip;0;14;0;14
19361;Dainorėliai;SAULUTĖS;18744882489;Taip;0;12;0;12
19362;Dainorėliai;SAULUTĖS;25073134850;Taip;16;0;0;16
19363;Dainorėliai;SAULUTĖS;37660372564;Taip;0;3;0;3
19364;Dainorėliai;SAULUTĖS;84999972369;Taip;0;7;1;8
19365;Dainorėliai;SAULUTĖS;69732047046;Taip;4;5;0;9
19366;Dainorėliai;SAULUTĖS;42491409881;Taip;0;3;0;3
19367;Dainorėliai;SAULUTĖS;13138644060;Taip;4;5;0;9
19368;Dainorėliai;SAULUTĖS;5155175570;Taip;0;2;2;4
19369;Dainorėliai;SAULUTĖS;92644746397;Taip;5;5;1;11
19370;Dainorėliai;SAULUTĖS;2922026996;Taip;5;10;0;15
19371;Dainorėliai;SAULUTĖS;1889037823;Taip;0;4;4;8
19372;Dainorėliai;SAULUTĖS;2441164154;Taip;10;4;0;14
19373;Dainorėliai;VARPELIAI;11506295275;Taip;0;4;0;4
19374;Dainorėliai;VARPELIAI;87242570532;Taip;0;6;0;6
19375;Dainorėliai;VARPELIAI;31902102771;Taip;0;1;0;1
19376;Dainorėliai;VARPELIAI;18233813290;Taip;10;5;0;15
19377;Dainorėliai;VARPELIAI;6176171443;Taip;0;5;0;5
19378;Dainorėliai;VARPELIAI;88781762328;Taip;20;0;0;20
19379;Dainorėliai;VARPELIAI;9319771186;Taip;20;0;0;20
19380;Dainorėliai;VARPELIAI;7822546498;Taip;0;2;0;2
19381;Dainorėliai;VARPELIAI;8719834064;Taip;0;0;11;11
19382;Dainorėliai;VARPELIAI;5693385617;Taip;0;4;6;10
19383;Dainorėliai;VARPELIAI;8267213392;Taip;0;9;1;10
19384;Dainorėliai;VARPELIAI;5959380807;Taip;0;4;3;7
19385;Dainorėliai;VARPELIAI;2938732886;Taip;4;2;0;6
19386;Dainorėliai;VARPELIAI;3183793211;Taip;0;2;4;6
19387;Dainorėliai;VARPELIAI;2797544232;Taip;0;2;1;3
19388;Dainorėliai;VARPELIAI;65467351140;Taip;6;6;0;12
19389;Dainorėliai;VARPELIAI;8521878734;Taip;16;4;0;20
19390;Dainorėliai;VARPELIAI;1928369859;Taip;7;0;0;7
19391;Dainorėliai;VARPELIAI;6909583023;Taip;0;0;1;1
19392;Dainorėliai;VARPELIAI;6430425182;Taip;0;6;3;9
19393;Dainorėliai;VARPELIAI;4269946363;Taip;10;0;7;17
19394;Dainorėliai;VARPELIAI;1088248393;Taip;14;1;0;15
19395;Dainorėliai;ŽIOGELIAI;99597416067;Taip;5;4;0;9
19396;Dainorėliai;ŽIOGELIAI;88201007119;Taip;0;7;0;7
19397;Dainorėliai;ŽIOGELIAI;31267856584;Taip;0;6;0;6
19398;Dainorėliai;ŽIOGELIAI;87717571411;Taip;0;2;0;2
19399;Dainorėliai;ŽIOGELIAI;18936645521;Ne;16;0;0;16
19400;Dainorėliai;ŽIOGELIAI;97947842490;Taip;0;3;0;3
19401;Dainorėliai;ŽIOGELIAI;35528654099;Taip;0;4;0;4
19402;Dainorėliai;ŽIOGELIAI;16780418740;Ne;3;0;0;3
19403;Dainorėliai;ŽIOGELIAI;29132059636;Taip;0;4;0;4
19404;Dainorėliai;ŽIOGELIAI;32573583030;Taip;0;6;0;6
19405;Dainorėliai;ŽIOGELIAI;1470784692;Taip;0;1;0;1
19406;Dainorėliai;ŽIOGELIAI;67124516230;Taip;7;6;0;13
19407;Dainorėliai;ŽIOGELIAI;17358842027;Taip;4;1;0;5
19408;Dainorėliai;ŽIOGELIAI;54344466523;Taip;4;0;8;12
19409;Dainorėliai;ŽIOGELIAI;63211091321;Taip;0;2;1;3
19410;Dainorėliai;ŽIOGELIAI;45577031767;Taip;15;4;0;19
19411;Dainorėliai;ŽIOGELIAI;92157879830;Taip;0;6;3;9
19412;Dainorėliai;ŽIOGELIAI;80499999855;Taip;0;0;1;1
19413;Dainorėliai;ŽIOGELIAI;72073028506;Taip;0;2;3;5
19414;Dainorėliai;ŽIOGELIAI;78002267589;Taip;4;1;0;5
19415;Dainorėliai;ŽIOGELIAI;3761026792;Taip;6;2;4;12
19416;Dainorėliai;DRUGELIAI;65253606353;Taip;11;0;0;11
19417;Dainorėliai;DRUGELIAI;26916172990;Ne;3;0;0;3
19418;Dainorėliai;DRUGELIAI;6411939690;Taip;0;5;0;5
19419;Dainorėliai;DRUGELIAI;50432354832;Taip;1;0;0;1
19420;Dainorėliai;DRUGELIAI;19286303769;Taip;0;2;0;2
19421;Dainorėliai;DRUGELIAI;2483267929;Taip;19;0;0;19
19422;Dainorėliai;DRUGELIAI;1015870220;Taip;13;0;0;13
19423;Dainorėliai;DRUGELIAI;6404337541;Taip;9;0;1;10
19424;Dainorėliai;DRUGELIAI;94480397292;Taip;1;0;3;4
19425;Dainorėliai;DRUGELIAI;53935690864;Taip;7;0;0;7
19426;Dainorėliai;DRUGELIAI;27521381629;Taip;6;0;1;7
19427;Dainorėliai;DRUGELIAI;86187568203;Taip;0;3;0;3
19428;Dainorėliai;DRUGELIAI;5238082419;Taip;13;0;0;13
19429;Dainorėliai;DRUGELIAI;49483881135;Taip;8;0;0;8
19430;Dainorėliai;DRUGELIAI;3789809082;Taip;0;0;5;5
19431;Dainorėliai;DRUGELIAI;1626877066;Taip;4;0;1;5
19432;Dainorėliai;DRUGELIAI;1158895670;Taip;0;2;1;3
19433;Dainorėliai;DRUGELIAI;4087344015;Taip;5;8;0;13
19434;Dainorėliai;DRUGELIAI;3128897752;Taip;4;0;0;4
19435;Dainorėliai;DRUGELIAI;1357413314;Taip;5;1;2;8
19436;Dainorėliai;DRUGELIAI;1515552402;Taip;1;2;0;3
19437;Dainorėliai;"1 klasė";48245075123;Taip;3;5;0;8
19438;Dainorėliai;"1 klasė";5010994621;Taip;0;5;0;5
19439;Dainorėliai;"1 klasė";57618865048;Taip;1;5;0;6
19440;Dainorėliai;"1 klasė";29726515194;Taip;2;5;0;7
19441;Dainorėliai;"1 klasė";26315465923;Taip;1;5;0;6
19442;Dainorėliai;"1 klasė";6203511535;Taip;2;5;0;7
19443;Dainorėliai;"1 klasė";93738984644;Taip;3;5;0;8
19444;Dainorėliai;"1 klasė";81956978417;Taip;0;5;0;5
19445;Dainorėliai;"1 klasė";24048489264;Taip;4;5;0;9
19446;Dainorėliai;"1 klasė";8562371599;Taip;3;5;0;8
19447;Dainorėliai;"1 klasė";19292860218;Taip;6;5;0;11
19448;Dainorėliai;"1 klasė";14664307658;Taip;0;5;0;5
19449;Dainorėliai;"1 klasė";23144978287;Taip;0;5;0;5
19450;Dainorėliai;"1 klasė";77907054102;Taip;0;5;0;5
19451;Dainorėliai;"1 klasė";9447513737;Taip;1;5;0;6
19452;Dainorėliai;"1 klasė";63052774196;Taip;7;5;0;12
19453;Dainorėliai;"1 klasė";65982869126;Taip;0;5;0;5
19454;Dainorėliai;"1 klasė";97182565649;Taip;0;5;0;5
19455;Dainorėliai;"1 klasė";91457137356;Taip;0;5;0;5
19456;Dainorėliai;"1 klasė";13846131820;Taip;0;5;0;5
19457;Dainorėliai;"1 klasė";69409530494;Taip;2;5;0;7
19458;Dainorėliai;"1 klasė";84749521489;Taip;0;5;0;5
19459;Dainorėliai;"1 klasė";57179351170;Taip;3;5;0;8
19460;Dainorėliai;"1 klasė";4773358825;Taip;3;5;0;8
19461;Dainorėliai;"1 klasė";3018657993;Taip;3;5;0;8
19462;Dainorėliai;"2 klasė";8014881349;Taip;1;5;0;6
19463;Dainorėliai;"2 klasė";4309610318;Taip;1;5;0;6
19464;Dainorėliai;"2 klasė";1629229178;Ne;0;5;0;5
19465;Dainorėliai;"2 klasė";7589862952;Taip;0;5;0;5
19466;Dainorėliai;"2 klasė";1734712911;Taip;1;5;0;6
19467;Dainorėliai;"2 klasė";1472986325;Taip;5;5;0;10
19468;Dainorėliai;"2 klasė";6898321145;Taip;0;5;0;5
19469;Dainorėliai;"2 klasė";4642369086;Taip;5;5;0;10
19470;Dainorėliai;"2 klasė";3713835329;Taip;1;5;0;6
19471;Dainorėliai;"2 klasė";5181789063;Taip;1;5;0;6
19472;Dainorėliai;"2 klasė";4792505132;Taip;0;5;0;5
19473;Dainorėliai;"2 klasė";4631981231;Taip;0;5;0;5
19474;Dainorėliai;"2 klasė";2685423821;Taip;5;5;0;10
19475;Dainorėliai;"2 klasė";2991348691;Taip;0;5;0;5
19476;Dainorėliai;"2 klasė";3109138914;Taip;10;5;0;15
19477;Dainorėliai;"2 klasė";6576505338;Ne;1;5;0;6
19478;Dainorėliai;"2 klasė";9028699114;Taip;0;5;0;5
19479;Dainorėliai;"2 klasė";1185255904;Taip;0;5;0;5
19480;Dainorėliai;"2 klasė";9691052273;Taip;0;5;0;5
19481;Dainorėliai;"2 klasė";2135997501;Taip;3;5;0;8
19482;Dainorėliai;"2 klasė";7013545705;Taip;0;5;0;5
19483;Dainorėliai;"2 klasė";6735081184;Taip;0;5;0;5
19484;Dainorėliai;"2 klasė";7332518731;Taip;0;5;0;5
19485;Dainorėliai;"2 klasė";6513001151;Taip;0;5;0;5
19486;Dainorėliai;"2 klasė";47031645815;Taip;0;5;0;5
19487;Dainorėliai;"3 klasė";5468429196;Taip;0;4;0;4
19488;Dainorėliai;"3 klasė";6497830034;Taip;2;4;0;6
19489;Dainorėliai;"3 klasė";4497264004;Taip;3;4;0;7
19490;Dainorėliai;"3 klasė";2704452184;Taip;0;4;0;4
19491;Dainorėliai;"3 klasė";5072041112;Taip;5;4;0;9
19492;Dainorėliai;"3 klasė";2164782968;Ne;10;0;0;10
19493;Dainorėliai;"3 klasė";4275023010;Taip;8;4;0;12
19494;Dainorėliai;"3 klasė";4490125789;Taip;6;4;0;10
19495;Dainorėliai;"3 klasė";1311444933;Taip;0;4;0;4
19496;Dainorėliai;"3 klasė";8569165891;Taip;0;4;0;4
19497;Dainorėliai;"3 klasė";9630477900;Taip;2;4;0;6
19498;Dainorėliai;"3 klasė";2519518637;Taip;0;4;0;4
19499;Dainorėliai;"3 klasė";5177714429;Taip;4;4;0;8
19500;Dainorėliai;"3 klasė";7309477306;Taip;5;4;0;9
19501;Dainorėliai;"3 klasė";3683531357;Taip;5;4;0;9
19502;Dainorėliai;"3 klasė";3053044929;Taip;0;4;0;4
19503;Dainorėliai;"3 klasė";1289801462;Taip;2;4;0;6
19504;Dainorėliai;"3 klasė";7327414673;Taip;0;4;0;4
19505;Dainorėliai;"3 klasė";1347410803;Taip;4;4;0;8
19506;Dainorėliai;"3 klasė";8916859571;Taip;5;4;0;9
19507;Dainorėliai;"4 klasė";8177540512;Taip;0;5;0;5
19508;Dainorėliai;"4 klasė";1682094268;Taip;0;5;0;5
19509;Dainorėliai;"4 klasė";8913783842;Taip;5;5;0;10
19510;Dainorėliai;"4 klasė";1689787684;Taip;7;5;0;12
19511;Dainorėliai;"4 klasė";4956275684;Taip;2;5;0;7
19512;Dainorėliai;"4 klasė";3140143126;Taip;3;5;0;8
19513;Dainorėliai;"4 klasė";7972267725;Taip;3;5;0;8
19514;Dainorėliai;"4 klasė";6647480988;Taip;2;5;0;7
19515;Dainorėliai;"4 klasė";9012668384;Taip;3;5;0;8
19516;Dainorėliai;"4 klasė";3707864997;Taip;3;5;0;8
19517;Dainorėliai;"4 klasė";4557048583;Taip;0;5;0;5
19518;Dainorėliai;"4 klasė";1744536400;Ne;5;5;0;10
19519;Dainorėliai;"4 klasė";2936271822;Taip;0;5;0;5
19520;Dainorėliai;"4 klasė";4825947023;Ne;8;5;0;13
19521;Dainorėliai;"4 klasė";7116837311;Taip;7;5;0;12
19522;Dainorėliai;"4 klasė";1676986825;Taip;6;5;0;11
19523;Dainorėliai;"4 klasė";4853813247;Taip;3;5;0;8
19524;Dainorėliai;"4 klasė";6181648900;Taip;2;5;0;7
19525;Dainorėliai;"4 klasė";7179140869;Taip;2;5;0;7
19526;Dainorėliai;"4 klasė";4182527951;Taip;0;5;0;5
19527;Dainorėliai;"4 klasė";6267160193;Taip;0;5;0;5
19528;Dainorėliai;"4 klasė";4684100461;Taip;0;5;0;5
19529;Dainorėliai;"4 klasė";1175747348;Taip;0;5;0;5
19530;Dainorėliai;"4 klasė";1593283963;Taip;18;1;0;19
19531;Dainorėliai;"4 klasė";8612758782;Taip;8;5;0;13
19532;Lokiukas;BITUTĖS;6758550653;Taip;9;6;0;15
19533;Lokiukas;BITUTĖS;1040288021;Taip;16;3;0;19
19534;Lokiukas;BITUTĖS;1733486244;Taip;16;0;0;16
19535;Lokiukas;BITUTĖS;6336140882;Taip;15;0;2;17
19536;Lokiukas;BITUTĖS;9142262360;Taip;11;3;0;14
19537;Lokiukas;BITUTĖS;8775608581;Taip;10;0;1;11
19538;Lokiukas;BITUTĖS;1752784666;Taip;6;1;0;7
19539;Lokiukas;BITUTĖS;2166382346;Taip;0;2;0;2
19540;Lokiukas;BITUTĖS;7305062511;Taip;7;0;0;7
19541;Lokiukas;BITUTĖS;1025576053;Taip;0;2;0;2
19542;Lokiukas;BITUTĖS;6069516217;Taip;6;4;0;10
19543;Lokiukas;BITUTĖS;7943213321;Taip;0;2;0;2
19544;Lokiukas;BITUTĖS;8915504279;Taip;0;1;0;1
19545;Lokiukas;BITUTĖS;8796640190;Taip;10;2;0;12
19546;Lokiukas;BITUTĖS;5943412920;Taip;0;13;1;14
19547;Lokiukas;BITUTĖS;2885398200;Taip;0;0;1;1
19548;Lokiukas;BITUTĖS;3694653020;Taip;8;0;0;8
19549;Lokiukas;BITUTĖS;7261501131;Taip;15;0;0;15
19550;Lokiukas;BITUTĖS;4379238557;Taip;12;0;0;12
19551;Lokiukas;BITUTĖS;2052174669;Taip;0;2;6;8
19552;Lokiukas;BITUTĖS;8902619265;Taip;6;5;0;11
19553;Lokiukas;"1 B klasė";60370754283;Taip;2;4;0;6
19554;Lokiukas;"1 B klasė";3262579895;Taip;6;4;0;10
19555;Lokiukas;"1 B klasė";17034757778;Taip;11;4;0;15
19556;Lokiukas;"1 B klasė";79301547085;Taip;2;4;0;6
19557;Lokiukas;"1 B klasė";16889795010;Taip;0;20;0;20
19558;Lokiukas;"1 B klasė";18432518932;Taip;1;4;0;5
19559;Lokiukas;"1 B klasė";2004606839;Taip;0;15;0;15
19560;Lokiukas;"1 B klasė";88947878548;Taip;2;4;0;6
19561;Lokiukas;"1 B klasė";45805925058;Taip;7;4;0;11
19562;Lokiukas;"1 B klasė";70028115546;Taip;2;4;0;6
19563;Lokiukas;"1 B klasė";29198900240;Taip;7;4;0;11
19564;Lokiukas;"1 B klasė";10897713744;Taip;0;20;0;20
19565;Lokiukas;"1 B klasė";77441549037;Taip;5;4;0;9
19566;Lokiukas;"1 B klasė";69089214980;Taip;4;4;0;8
19567;Lokiukas;"1 B klasė";17622979450;Taip;8;0;0;8
19568;Lokiukas;"1 B klasė";98289469398;Taip;20;0;0;20
19569;Lokiukas;"1 B klasė";51554951703;Taip;6;0;0;6
19570;Lokiukas;"1 B klasė";45735190114;Taip;0;20;0;20
19571;Lokiukas;"1 B klasė";79597160668;Taip;7;4;0;11
19572;Lokiukas;"1 B klasė";37669645510;Taip;9;4;0;13
19573;Lokiukas;"1 B klasė";15004419516;Taip;10;4;0;14
19574;Lokiukas;"1 B klasė";10240586503;Taip;0;20;0;20
19575;Lokiukas;"1 B klasė";5067673212;Taip;3;4;0;7
19576;Lokiukas;"1 B klasė";66392613629;Taip;12;4;0;16
19577;Lokiukas;"1 B klasė";15445053855;Taip;1;4;0;5
19578;Lokiukas;"1 B klasė";1104333637;Taip;5;4;0;9
19579;Lokiukas;"1 B klasė";35018370441;Taip;1;4;0;5
19580;Lokiukas;"1 B klasė";1716358913;Taip;10;4;0;14
19581;Lokiukas;"1 A klasė";72167964645;Taip;7;4;0;11
19582;Lokiukas;"1 A klasė";67818191566;Taip;0;4;0;4
19583;Lokiukas;"1 A klasė";75613665040;Taip;8;4;0;12
19584;Lokiukas;"1 A klasė";23222644824;Taip;10;4;0;14
19585;Lokiukas;"1 A klasė";52296454506;Taip;2;4;0;6
19586;Lokiukas;"1 A klasė";25058082693;Taip;0;20;0;20
19587;Lokiukas;"1 A klasė";6702448475;Taip;1;4;0;5
19588;Lokiukas;"1 A klasė";42292408557;Taip;6;4;0;10
19589;Lokiukas;"1 A klasė";2143040924;Taip;0;20;0;20
19590;Lokiukas;"1 A klasė";45280536946;Taip;8;4;0;12
19591;Lokiukas;"1 A klasė";82966541165;Taip;0;20;0;20
19592;Lokiukas;"1 A klasė";80180114948;Taip;14;4;0;18
19593;Lokiukas;"1 A klasė";66999644935;Taip;0;20;0;20
19594;Lokiukas;"1 A klasė";43389930516;Taip;0;4;0;4
19595;Lokiukas;"1 A klasė";86623153797;Taip;0;4;0;4
19596;Lokiukas;"1 A klasė";53245573692;Taip;1;4;0;5
19597;Lokiukas;"1 A klasė";14341255985;Taip;7;4;0;11
19598;Lokiukas;"1 A klasė";3206276637;Taip;0;20;0;20
19599;Lokiukas;"1 A klasė";27050402360;Taip;0;4;0;4
19600;Lokiukas;"1 A klasė";38636200254;Ne;7;4;0;11
19601;Lokiukas;"1 A klasė";53544600623;Taip;0;20;0;20
19602;Lokiukas;"1 A klasė";53087036306;Taip;0;20;0;20
19603;Lokiukas;"1 A klasė";5775631777;Ne;4;4;0;8
19604;Lokiukas;"1 A klasė";1143130271;Taip;5;4;0;9
19605;Lokiukas;"1 A klasė";47410036889;Taip;0;4;0;4
19606;Lokiukas;"1 A klasė";79223457439;Taip;1;4;0;5
19607;Lokiukas;GUDRUČIAI;43070670534;Taip;3;4;0;7
19608;Lokiukas;GUDRUČIAI;5198408183;Taip;11;4;0;15
19609;Lokiukas;GUDRUČIAI;88415635113;Taip;4;4;0;8
19610;Lokiukas;GUDRUČIAI;1227430275;Taip;6;4;1;11
19611;Lokiukas;GUDRUČIAI;9747265775;Taip;0;4;0;4
19612;Lokiukas;GUDRUČIAI;95910336503;Taip;0;4;0;4
19613;Lokiukas;GUDRUČIAI;7903535850;Taip;7;4;0;11
19614;Lokiukas;GUDRUČIAI;7497324442;Taip;7;4;1;12
19615;Lokiukas;GUDRUČIAI;93374754851;Taip;5;4;0;9
19616;Lokiukas;GUDRUČIAI;96046361641;Taip;0;4;0;4
19617;Lokiukas;GUDRUČIAI;6628530877;Taip;10;4;0;14
19618;Lokiukas;GUDRUČIAI;25170045140;Taip;3;3;1;7
19619;Lokiukas;GUDRUČIAI;84273668685;Taip;0;4;0;4
19620;Lokiukas;GUDRUČIAI;10948160841;Taip;8;4;0;12
19621;Lokiukas;GUDRUČIAI;4608275224;Taip;0;5;0;5
19622;Lokiukas;GUDRUČIAI;75296600945;Taip;3;1;0;4
19623;Lokiukas;GUDRUČIAI;59840033826;Taip;9;4;0;13
19624;Lokiukas;GUDRUČIAI;1855267362;Taip;10;4;0;14
19625;Lokiukas;BORUŽĖLĖS;1333650630;Ne;0;2;0;2
19626;Lokiukas;BORUŽĖLĖS;67133709394;Taip;20;0;0;20
19627;Lokiukas;BORUŽĖLĖS;66528256040;Taip;3;2;0;5
19628;Lokiukas;BORUŽĖLĖS;4906784415;Taip;0;4;0;4
19629;Lokiukas;BORUŽĖLĖS;36677665098;Taip;0;1;1;2
19630;Lokiukas;BORUŽĖLĖS;1119814512;Taip;5;2;1;8
19631;Lokiukas;BORUŽĖLĖS;1056075876;Taip;5;0;0;5
19632;Lokiukas;BORUŽĖLĖS;52940830874;Taip;10;6;0;16
19633;Lokiukas;BORUŽĖLĖS;1201125655;Taip;0;14;0;14
19634;Lokiukas;BORUŽĖLĖS;82025637099;Taip;0;1;0;1
19635;Lokiukas;BORUŽĖLĖS;131300206;Taip;0;2;0;2
19636;Lokiukas;BORUŽĖLĖS;8846527481;Taip;0;10;0;10
19637;Lokiukas;BORUŽĖLĖS;24601126170;Taip;0;4;0;4
19638;Lokiukas;BORUŽĖLĖS;83528495608;Ne;0;7;0;7
19639;Lokiukas;BORUŽĖLĖS;83086633109;Taip;7;0;0;7
19640;Lokiukas;BORUŽĖLĖS;40082135876;Taip;3;0;2;5
19641;Lokiukas;BORUŽĖLĖS;29396361769;Taip;7;4;0;11
19642;Lokiukas;BORUŽĖLĖS;41809745552;Taip;10;0;0;10
19643;Lokiukas;BORUŽĖLĖS;73515179103;Taip;10;1;0;11
19644;Lokiukas;BORUŽĖLĖS;8240261104;Taip;9;0;0;9
19645;Lokiukas;BORUŽĖLĖS;99183628764;Taip;3;5;0;8
19646;Lokiukas;BORUŽĖLĖS;61807094999;Taip;11;1;0;12
19647;Lokiukas;BORUŽĖLĖS;7495691956;Ne;8;0;0;8
19648;Lokiukas;BORUŽĖLĖS;51059574159;Taip;19;0;0;19
19649;Lokiukas;ANČIUKAI;4617372387;Taip;14;0;0;14
19650;Lokiukas;ANČIUKAI;8630112458;Taip;11;0;0;11
19651;Lokiukas;ANČIUKAI;3744484616;Taip;0;5;0;5
19652;Lokiukas;ANČIUKAI;2625981190;Taip;10;1;0;11
19653;Lokiukas;ANČIUKAI;4442073527;Taip;11;0;2;13
19654;Lokiukas;ANČIUKAI;9307491947;Taip;19;0;0;19
19655;Lokiukas;ANČIUKAI;4849031542;Taip;0;20;0;20
19656;Lokiukas;ANČIUKAI;8286358519;Taip;0;4;0;4
19657;Lokiukas;ANČIUKAI;4585621105;Taip;12;2;0;14
19658;Lokiukas;ANČIUKAI;5522089503;Taip;20;0;0;20
19659;Lokiukas;ANČIUKAI;8576418875;Taip;5;15;0;20
19660;Lokiukas;ANČIUKAI;4858829710;Taip;12;0;0;12
19661;Lokiukas;ANČIUKAI;8329540746;Taip;3;0;0;3
19662;Lokiukas;ANČIUKAI;6869785650;Taip;14;3;0;17
19663;Lokiukas;KODĖLČIUKAI;32506466236;Taip;1;1;0;2
19664;Lokiukas;KODĖLČIUKAI;15406362908;Taip;8;1;0;9
19665;Lokiukas;KODĖLČIUKAI;45122233067;Taip;0;1;0;1
19666;Lokiukas;KODĖLČIUKAI;21802863853;Taip;0;4;0;4
19667;Lokiukas;KODĖLČIUKAI;84682977618;Taip;4;2;0;6
19668;Lokiukas;KODĖLČIUKAI;22979689191;Taip;6;4;0;10
19669;Lokiukas;KODĖLČIUKAI;70730972654;Taip;0;19;0;19
19670;Lokiukas;KODĖLČIUKAI;80754592972;Taip;7;6;0;13
19671;Lokiukas;KODĖLČIUKAI;14903100496;Taip;3;3;0;6
19672;Lokiukas;KODĖLČIUKAI;99706061553;Taip;6;2;0;8
19673;Lokiukas;KODĖLČIUKAI;42138783794;Taip;9;3;0;12
19674;Lokiukas;KODĖLČIUKAI;7785940412;Taip;0;4;0;4
19675;Lokiukas;KODĖLČIUKAI;24099693663;Taip;6;3;0;9
19676;Lokiukas;KODĖLČIUKAI;72092394330;Taip;6;0;0;6
19677;Lokiukas;KODĖLČIUKAI;9413274607;Taip;3;0;0;3
19678;Lokiukas;KODĖLČIUKAI;7324496782;Taip;5;1;0;6
19679;Lokiukas;KODĖLČIUKAI;35769782473;Taip;11;1;0;12
19680;Lokiukas;KODĖLČIUKAI;10811780420;Taip;6;0;0;6
19681;Lokiukas;KODĖLČIUKAI;1151938436;Taip;5;3;0;8
19682;Lokiukas;KODĖLČIUKAI;91855230473;Taip;13;0;1;14
19683;Lokiukas;KODĖLČIUKAI;38531751377;Taip;9;1;0;10
19684;Lokiukas;KODĖLČIUKAI;28796727185;Taip;16;1;0;17
19685;Lokiukas;KODĖLČIUKAI;80793623068;Ne;9;2;0;11
19686;Lokiukas;DRUGELIAI;7942641594;Taip;19;0;0;19
19687;Lokiukas;DRUGELIAI;8568285232;Taip;13;0;0;13
19688;Lokiukas;DRUGELIAI;5453470660;Taip;0;10;0;10
19689;Lokiukas;DRUGELIAI;5879386524;Taip;13;1;0;14
19690;Lokiukas;DRUGELIAI;14605095801;Taip;0;2;0;2
19691;Lokiukas;DRUGELIAI;46838695582;Taip;14;1;0;15
19692;Lokiukas;DRUGELIAI;2642065594;Taip;7;0;0;7
19693;Lokiukas;DRUGELIAI;1626698185;Taip;0;3;0;3
19694;Lokiukas;DRUGELIAI;39222094073;Taip;9;0;0;9
19695;Lokiukas;DRUGELIAI;1695680881;Taip;14;0;0;14
19696;Lokiukas;DRUGELIAI;69364831994;Taip;10;1;0;11
19697;Lokiukas;DRUGELIAI;76969210386;Taip;2;0;1;3
19698;Lokiukas;DRUGELIAI;39975872119;Taip;0;1;0;1
19699;Lokiukas;DRUGELIAI;78106313493;Taip;10;0;0;10
19700;Lokiukas;DRUGELIAI;74169282323;Taip;3;2;0;5
19701;Lokiukas;DRUGELIAI;1625137322;Taip;5;2;0;7
19702;Lokiukas;DRUGELIAI;1381505711;Taip;6;7;0;13
19703;Lokiukas;DRUGELIAI;8452600632;Taip;14;0;0;14
19704;Lokiukas;DRUGELIAI;7386571822;Ne;0;20;0;20
19705;Lokiukas;DRUGELIAI;35890122494;Taip;11;1;0;12
19706;Lokiukas;DRUGELIAI;1210407640;Taip;12;1;0;13
19707;Lokiukas;DRUGELIAI;7591418969;Taip;15;0;0;15
19708;Lokiukas;DRUGELIAI;8036643654;Taip;14;0;0;14
19709;Lokiukas;"2 A klasė";7060929950;Taip;6;4;0;10
19710;Lokiukas;"2 A klasė";8499895935;Taip;0;20;0;20
19711;Lokiukas;"2 A klasė";5737714024;Ne;2;4;0;6
19712;Lokiukas;"2 A klasė";5889819809;Ne;1;4;0;5
19713;Lokiukas;"2 A klasė";6496662759;Taip;10;4;0;14
19714;Lokiukas;"2 A klasė";5700685872;Ne;7;4;0;11
19715;Lokiukas;"2 A klasė";1555365851;Ne;15;0;0;15
19716;Lokiukas;"2 A klasė";2374089307;Taip;8;4;0;12
19717;Lokiukas;"2 A klasė";2607988265;Taip;1;4;0;5
19718;Lokiukas;"2 A klasė";4992275038;Taip;4;4;0;8
19719;Lokiukas;"2 A klasė";1492303633;Taip;7;4;0;11
19720;Lokiukas;"2 A klasė";6856770462;Ne;1;4;0;5
19721;Lokiukas;"2 A klasė";8766212402;Ne;8;4;0;12
19722;Lokiukas;"2 A klasė";5559967651;Taip;14;4;0;18
19723;Lokiukas;"2 A klasė";3528533437;Taip;20;0;0;20
19724;Lokiukas;"2 A klasė";5465758477;Taip;7;4;0;11
19725;Lokiukas;"2 A klasė";7069020705;Taip;1;4;0;5
19726;Lokiukas;"2 A klasė";6129602024;Ne;0;4;0;4
19727;Lokiukas;"2 A klasė";9199283952;Taip;20;0;0;20
19728;Lokiukas;"2 A klasė";8378630091;Taip;2;4;0;6
19729;Lokiukas;"2 A klasė";3138145333;Ne;20;0;0;20
19730;Lokiukas;"2 A klasė";3506723678;Taip;0;20;0;20
19731;Lokiukas;"2 A klasė";4615481025;Ne;1;4;0;5
19732;Lokiukas;"2 A klasė";7553457572;Ne;5;4;0;9
19733;Lokiukas;"2 A klasė";1571404671;Taip;3;4;0;7
19734;Lokiukas;"2 A klasė";1729941577;Taip;1;4;0;5
19735;Lokiukas;"2 B klasė";9114504810;Taip;6;0;0;6
19736;Lokiukas;"2 B klasė";7595514531;Taip;9;0;0;9
19737;Lokiukas;"2 B klasė";7144013238;Taip;0;20;0;20
19738;Lokiukas;"2 B klasė";8235437961;Taip;9;0;0;9
19739;Lokiukas;"2 B klasė";2905935730;Taip;9;0;0;9
19740;Lokiukas;"2 B klasė";8304439625;Taip;9;0;0;9
19741;Lokiukas;"2 B klasė";8954484534;Taip;12;0;0;12
19742;Lokiukas;"2 B klasė";1388342336;Taip;4;0;0;4
19743;Lokiukas;"2 B klasė";4418425219;Taip;5;0;0;5
19744;Lokiukas;"2 B klasė";3364994110;Taip;13;0;0;13
19745;Lokiukas;"2 B klasė";6063796643;Taip;14;0;0;14
19746;Lokiukas;"2 B klasė";6663700618;Taip;4;0;0;4
19747;Lokiukas;"2 B klasė";6151885589;Taip;12;0;0;12
19748;Lokiukas;"2 B klasė";1440437389;Taip;16;0;0;16
19749;Lokiukas;"2 B klasė";2059112380;Taip;10;0;0;10
19750;Lokiukas;"2 B klasė";5745254234;Taip;4;0;0;4
19751;Lokiukas;"2 B klasė";8189433550;Taip;0;20;0;20
19752;Lokiukas;"2 B klasė";5918592397;Taip;4;0;0;4
19753;Lokiukas;"2 B klasė";7722830021;Taip;14;0;0;14
19754;Lokiukas;"2 B klasė";9681048306;Taip;4;0;0;4
19755;Lokiukas;"2 B klasė";1048772300;Taip;4;0;0;4
19756;Lokiukas;"2 B klasė";2021690274;Taip;5;0;0;5
19757;Lokiukas;"2 B klasė";6538311120;Taip;10;0;0;10
19758;Lokiukas;"2 B klasė";8395026474;Taip;9;0;0;9
19759;Lokiukas;"2 B klasė";7439047502;Taip;4;0;0;4
19760;Lokiukas;"2 B klasė";1746819279;Taip;10;0;0;10
19761;Lokiukas;"3 A klasė";2220223549;Taip;0;20;0;20
19762;Lokiukas;"3 A klasė";7349936354;Ne;7;4;0;11
19763;Lokiukas;"3 A klasė";8192834838;Taip;5;4;0;9
19764;Lokiukas;"3 A klasė";7086818828;Taip;5;4;0;9
19765;Lokiukas;"3 A klasė";8959417696;Taip;0;20;0;20
19766;Lokiukas;"3 A klasė";1362995666;Taip;0;4;0;4
19767;Lokiukas;"3 A klasė";4873942674;Taip;3;4;0;7
19768;Lokiukas;"3 A klasė";2745780921;Taip;6;4;0;10
19769;Lokiukas;"3 A klasė";3007573139;Taip;5;4;0;9
19770;Lokiukas;"3 A klasė";5058488696;Taip;11;4;0;15
19771;Lokiukas;"3 A klasė";6008557035;Taip;10;4;0;14
19772;Lokiukas;"3 A klasė";1243245356;Taip;1;4;0;5
19773;Lokiukas;"3 A klasė";9322204885;Taip;5;4;0;9
19774;Lokiukas;"3 A klasė";1822055099;Taip;1;4;0;5
19775;Lokiukas;"3 A klasė";5199360470;Taip;8;4;0;12
19776;Lokiukas;"3 A klasė";5384844998;Taip;0;20;0;20
19777;Lokiukas;"3 A klasė";6353653831;Taip;0;20;0;20
19778;Lokiukas;"3 A klasė";3700837936;Taip;10;4;0;14
19779;Lokiukas;"3 A klasė";6022402998;Taip;8;4;0;12
19780;Lokiukas;"3 A klasė";5942416530;Taip;0;4;0;4
19781;Lokiukas;"3 A klasė";9743363133;Taip;12;4;0;16
19782;Lokiukas;"3 A klasė";2029507962;Taip;5;4;0;9
19783;Lokiukas;"3 A klasė";44496777103;Taip;5;4;0;9
19784;Lokiukas;"3 A klasė";94528954912;Taip;0;4;0;4
19785;Lokiukas;"3 B klasė";9922964495;Taip;7;4;0;11
19786;Lokiukas;"3 B klasė";5562737843;Taip;0;4;0;4
19787;Lokiukas;"3 B klasė";6110849113;Taip;0;20;0;20
19788;Lokiukas;"3 B klasė";8822883914;Taip;0;20;0;20
19789;Lokiukas;"3 B klasė";1860245985;Taip;0;20;0;20
19790;Lokiukas;"3 B klasė";1692231191;Taip;3;4;0;7
19791;Lokiukas;"3 B klasė";4160279615;Taip;4;4;0;8
19792;Lokiukas;"3 B klasė";4368235682;Taip;0;4;0;4
19793;Lokiukas;"3 B klasė";9376247296;Taip;0;4;0;4
19794;Lokiukas;"3 B klasė";7943448919;Taip;0;20;0;20
19795;Lokiukas;"3 B klasė";6270747705;Taip;5;4;0;9
19796;Lokiukas;"3 B klasė";9390626220;Taip;0;20;0;20
19797;Lokiukas;"3 B klasė";4467643205;Taip;5;4;0;9
19798;Lokiukas;"3 B klasė";8175005473;Taip;6;4;0;10
19799;Lokiukas;"3 B klasė";4504812769;Taip;6;4;0;10
19800;Lokiukas;"3 B klasė";6210160161;Taip;5;4;0;9
19801;Lokiukas;"3 B klasė";1727242060;Taip;0;20;0;20
19802;Lokiukas;"3 B klasė";8300861451;Taip;8;4;0;12
19803;Lokiukas;"3 B klasė";7692067948;Taip;0;4;0;4
19804;Lokiukas;"3 B klasė";7728788069;Taip;0;20;0;20
19805;Lokiukas;"3 B klasė";9985555940;Taip;15;4;0;19
19806;Lokiukas;"3 B klasė";4447860405;Taip;3;4;0;7
19807;Lokiukas;"3 B klasė";3823547337;Taip;6;4;0;10
19808;Lokiukas;"3 B klasė";5496591880;Taip;0;20;0;20
19809;Lokiukas;"3 B klasė";1491789191;Taip;0;4;0;4
19810;Lokiukas;"3 B klasė";1419846182;Taip;0;4;0;4
19811;Lokiukas;"3 B klasė";9310088026;Taip;1;4;0;5
19812;Lokiukas;"3 B klasė";1787800667;Taip;4;4;0;8
19813;Lokiukas;"3 B klasė";2284932363;Taip;10;4;0;14
19814;Lokiukas;"4 A klasė";8522739824;Taip;0;20;0;20
19815;Lokiukas;"4 A klasė";6642105064;Taip;5;15;0;20
19816;Lokiukas;"4 A klasė";5852545576;Taip;0;20;0;20
19817;Lokiukas;"4 A klasė";1179863043;Taip;0;20;0;20
19818;Lokiukas;"4 A klasė";4976080351;Taip;4;4;0;8
19819;Lokiukas;"4 A klasė";5300309689;Taip;0;20;0;20
19820;Lokiukas;"4 A klasė";3023836997;Taip;0;20;0;20
19821;Lokiukas;"4 A klasė";6539032697;Ne;0;20;0;20
19822;Lokiukas;"4 A klasė";8651567498;Taip;10;4;0;14
19823;Lokiukas;"4 A klasė";6880671721;Taip;0;20;0;20
19824;Lokiukas;"4 A klasė";2890728780;Taip;0;20;0;20
19825;Lokiukas;"4 A klasė";1275739989;Taip;0;20;0;20
19826;Lokiukas;"4 A klasė";5810597393;Ne;0;20;0;20
19827;Lokiukas;"4 A klasė";3297734813;Taip;0;20;0;20
19828;Lokiukas;"4 A klasė";3216247517;Taip;7;4;0;11
19829;Lokiukas;"4 A klasė";2946985384;Taip;0;20;0;20
19830;Lokiukas;"4 A klasė";4908935009;Taip;4;4;0;8
19831;Lokiukas;"4 A klasė";8585585715;Taip;6;4;0;10
19832;Lokiukas;"4 A klasė";8746221351;Taip;3;4;0;7
19833;Lokiukas;"4 A klasė";7385810354;Taip;10;4;0;14
19834;Lokiukas;"4 A klasė";7202328703;Taip;7;4;0;11
19835;Lokiukas;"4 B klasė";3253826820;Ne;3;4;0;7
19836;Lokiukas;"4 B klasė";8577804440;Taip;5;4;0;9
19837;Lokiukas;"4 B klasė";3401446820;Taip;3;4;0;7
19838;Lokiukas;"4 B klasė";3941060152;Taip;19;0;0;19
19839;Lokiukas;"4 B klasė";6034080022;Taip;9;4;0;13
19840;Lokiukas;"4 B klasė";7802721046;Taip;20;0;0;20
19841;Lokiukas;"4 B klasė";5579944645;Taip;10;4;0;14
19842;Lokiukas;"4 B klasė";1798330886;Taip;9;4;0;13
19843;Lokiukas;"4 B klasė";6827396461;Taip;2;4;0;6
19844;Lokiukas;"4 B klasė";2096424992;Taip;0;20;0;20
19845;Lokiukas;"4 B klasė";7221776688;Taip;20;0;0;20
19846;Lokiukas;"4 B klasė";7010375151;Taip;3;4;0;7
19847;Lokiukas;"4 B klasė";3862533006;Taip;9;4;0;13
19848;Lokiukas;"4 B klasė";8123166445;Ne;9;4;0;13
19849;Lokiukas;"4 B klasė";9742540759;Taip;0;20;0;20
19850;Lokiukas;"4 B klasė";5301990414;Taip;3;4;0;7
19851;Lokiukas;"4 B klasė";4755673524;Taip;10;4;0;14
19852;Lokiukas;"4 B klasė";7851458821;Taip;14;4;0;18
19853;Lokiukas;"4 B klasė";4537888646;Taip;5;4;0;9
19854;Lokiukas;"4 B klasė";9786431252;Taip;2;4;0;6
19855;Lokiukas;"4 B klasė";1956140793;Taip;20;0;0;20
19856;Lokiukas;"4 B klasė";6116726536;Taip;15;4;0;19
19857;Lokiukas;"4 B klasė";3276273861;Taip;2;4;0;6
19858;Lokiukas;"4 B klasė";4648324338;Taip;5;4;0;9
19859;Šaltinėlis;Ančiukų;3011747942;Taip;9;4;0;13
19860;Šaltinėlis;Ančiukų;1811886320;Taip;11;0;0;11
19861;Šaltinėlis;Ančiukų;9769491789;Taip;0;9;0;9
19862;Šaltinėlis;Ančiukų;56396772538;Taip;3;0;0;3
19863;Šaltinėlis;Ančiukų;6462738640;Taip;7;2;0;9
19864;Šaltinėlis;Ančiukų;3493429067;Taip;0;0;2;2
19865;Šaltinėlis;Ančiukų;77872075694;Taip;17;0;0;17
19866;Šaltinėlis;Ančiukų;9218883174;Taip;19;0;0;19
19867;Šaltinėlis;Ančiukų;7133143923;Taip;8;3;0;11
19868;Šaltinėlis;Ančiukų;9820788524;Taip;0;13;0;13
19869;Šaltinėlis;Ančiukų;3691635011;Taip;6;1;0;7
19870;Šaltinėlis;Ančiukų;2630875135;Taip;11;4;0;15
19871;Šaltinėlis;Ančiukų;2973820849;Taip;20;0;0;20
19872;Šaltinėlis;Ančiukų;6487378225;Taip;16;0;1;17
19873;Šaltinėlis;Ančiukų;1464992631;Taip;20;0;0;20
19874;Šaltinėlis;Ančiukų;9274165569;Taip;6;0;0;6
19875;Šaltinėlis;Ančiukų;8500790262;Taip;0;2;0;2
19876;Šaltinėlis;Ančiukų;4332884673;Taip;8;1;0;9
19877;Šaltinėlis;Ančiukų;9362495172;Taip;20;0;0;20
19878;Šaltinėlis;Ančiukų;7737797979;Taip;6;1;0;7
19879;Šaltinėlis;Ančiukų;2646901307;Taip;0;2;0;2
19880;Šaltinėlis;Bitučių;54025577281;Taip;0;10;0;10
19881;Šaltinėlis;Bitučių;6669392157;Taip;0;9;1;10
19882;Šaltinėlis;Bitučių;28956971978;Taip;5;1;0;6
19883;Šaltinėlis;Bitučių;14213856824;Taip;0;4;0;4
19884;Šaltinėlis;Bitučių;80649337160;Taip;0;4;0;4
19885;Šaltinėlis;Bitučių;92958012146;Taip;0;6;0;6
19886;Šaltinėlis;Bitučių;84656960510;Taip;0;1;1;2
19887;Šaltinėlis;Bitučių;83621946293;Taip;0;11;0;11
19888;Šaltinėlis;Bitučių;67808618878;Ne;0;12;0;12
19889;Šaltinėlis;Bitučių;1278910777;Taip;0;6;0;6
19890;Šaltinėlis;Bitučių;9647785988;Taip;0;8;0;8
19891;Šaltinėlis;Bitučių;82671662416;Taip;0;8;0;8
19892;Šaltinėlis;Bitučių;29482180151;Taip;0;5;0;5
19893;Šaltinėlis;Bitučių;54753218491;Taip;0;6;0;6
19894;Šaltinėlis;Bitučių;86029472773;Taip;0;6;0;6
19895;Šaltinėlis;Bitučių;64821172553;Taip;0;6;1;7
19896;Šaltinėlis;Bitučių;25459069972;Ne;0;7;0;7
19897;Šaltinėlis;Bitučių;5056986469;Taip;14;5;0;19
19898;Šaltinėlis;Bitučių;89358384113;Taip;0;5;0;5
19899;Šaltinėlis;Bitučių;4050444191;Taip;0;11;0;11
19900;Šaltinėlis;Bitučių;89093437170;Taip;0;9;0;9
19901;Šaltinėlis;Bitučių;51872331010;Taip;3;1;0;4
19902;Šaltinėlis;Bitučių;5744976843;Taip;0;8;0;8
19903;Šaltinėlis;Saulutės;72372808270;Taip;0;3;0;3
19904;Šaltinėlis;Saulutės;81082410620;Taip;0;1;0;1
19905;Šaltinėlis;Saulutės;70315400705;Taip;11;2;0;13
19906;Šaltinėlis;Saulutės;57847832778;Taip;5;0;0;5
19907;Šaltinėlis;Saulutės;77194317310;Taip;0;9;0;9
19908;Šaltinėlis;Saulutės;74337710550;Taip;7;0;0;7
19909;Šaltinėlis;Saulutės;59164202996;Taip;8;4;0;12
19910;Šaltinėlis;Saulutės;3626545396;Ne;12;7;0;19
19911;Šaltinėlis;Saulutės;95542489944;Taip;0;2;0;2
19912;Šaltinėlis;Saulutės;39088869084;Taip;9;0;0;9
19913;Šaltinėlis;Saulutės;83173349544;Taip;5;6;0;11
19914;Šaltinėlis;Saulutės;19630605543;Taip;3;4;0;7
19915;Šaltinėlis;Saulutės;1220687492;Taip;1;1;0;2
19916;Šaltinėlis;Saulutės;93256161233;Taip;0;3;0;3
19917;Šaltinėlis;Saulutės;3072314714;Taip;0;6;0;6
19918;Šaltinėlis;Saulutės;1924418657;Taip;0;11;0;11
19919;Šaltinėlis;Saulutės;23090033086;Taip;5;8;0;13
19920;Šaltinėlis;Meškiukų;3264138693;Taip;0;6;0;6
19921;Šaltinėlis;Meškiukų;66103457245;Taip;0;0;2;2
19922;Šaltinėlis;Meškiukų;2013810425;Taip;0;2;0;2
19923;Šaltinėlis;Meškiukų;46159500221;Taip;14;0;0;14
19924;Šaltinėlis;Meškiukų;1045163890;Taip;14;0;0;14
19925;Šaltinėlis;Meškiukų;7231645416;Ne;11;0;0;11
19926;Šaltinėlis;Meškiukų;8776976566;Taip;3;0;1;4
19927;Šaltinėlis;Meškiukų;5215769929;Taip;7;0;1;8
19928;Šaltinėlis;Meškiukų;8555517284;Taip;19;0;0;19
19929;Šaltinėlis;Meškiukų;29359826470;Taip;11;0;0;11
19930;Šaltinėlis;Meškiukų;1073305554;Taip;0;8;0;8
19931;Šaltinėlis;Meškiukų;1614411921;Ne;20;0;0;20
19932;Šaltinėlis;Meškiukų;6887838949;Taip;10;0;1;11
19933;Šaltinėlis;Meškiukų;7483928256;Taip;14;0;0;14
19934;Šaltinėlis;Nykštukai;1390316465;Taip;0;7;0;7
19935;Šaltinėlis;Nykštukai;1955018380;Ne;3;6;0;9
19936;Šaltinėlis;Nykštukai;1718488108;Taip;0;5;0;5
19937;Šaltinėlis;Nykštukai;7073644279;Taip;0;0;2;2
19938;Šaltinėlis;Nykštukai;37786438977;Taip;0;11;0;11
19939;Šaltinėlis;Nykštukai;48525545812;Taip;9;2;0;11
19940;Šaltinėlis;Nykštukai;1658370782;Ne;20;0;0;20
19941;Šaltinėlis;Nykštukai;32264290873;Taip;9;2;0;11
19942;Šaltinėlis;Nykštukai;66575684640;Taip;0;8;0;8
19943;Šaltinėlis;Nykštukai;13808708760;Taip;10;1;0;11
19944;Šaltinėlis;Nykštukai;10918276041;Taip;4;0;1;5
19945;Šaltinėlis;Nykštukai;1456486363;Taip;6;5;0;11
19946;Šaltinėlis;Nykštukai;79406746980;Taip;0;5;0;5
19947;Šaltinėlis;Nykštukai;32949623652;Taip;20;0;0;20
19948;Šaltinėlis;Nykštukai;1767635282;Taip;8;0;1;9
19949;Šaltinėlis;Nykštukai;1190394855;Taip;0;4;1;5
19950;Šaltinėlis;Nykštukai;3577137327;Taip;10;3;0;13
19951;Šaltinėlis;Nykštukai;1580090516;Taip;8;0;2;10
19952;Šaltinėlis;Nykštukai;4901977623;Taip;4;3;0;7
19953;Šaltinėlis;Nykštukai;5442943843;Taip;6;4;0;10
19954;Šaltinėlis;Perliukų;17147527171;Taip;8;6;0;14
19955;Šaltinėlis;Perliukų;11083638216;Taip;9;2;0;11
19956;Šaltinėlis;Perliukų;1091056386;Taip;0;2;0;2
19957;Šaltinėlis;Perliukų;52507085619;Taip;0;0;2;2
19958;Šaltinėlis;Perliukų;2146141461;Taip;0;6;0;6
19959;Šaltinėlis;Perliukų;1958647188;Taip;10;8;0;18
19960;Šaltinėlis;Perliukų;1935762293;Taip;5;0;0;5
19961;Šaltinėlis;Perliukų;1583520894;Taip;15;4;0;19
19962;Šaltinėlis;Perliukų;1023238509;Taip;9;0;0;9
19963;Šaltinėlis;Perliukų;84494627465;Taip;0;2;1;3
19964;Šaltinėlis;Perliukų;1130153806;Taip;2;0;2;4
19965;Šaltinėlis;Perliukų;98941037508;Taip;8;4;0;12
19966;Šaltinėlis;Perliukų;1004445904;Taip;0;0;1;1
19967;Šaltinėlis;Perliukų;2125176999;Ne;10;4;1;15
19968;Šaltinėlis;Perliukų;9425353041;Taip;0;8;0;8
19969;Šaltinėlis;Perliukų;526307704;Taip;0;18;0;18
19970;Šaltinėlis;Perliukų;7262120071;Ne;5;6;0;11
19971;Šaltinėlis;Perliukų;6068980312;Taip;7;0;1;8
19972;Šaltinėlis;Perliukų;5869977541;Taip;0;2;6;8
19973;Šaltinėlis;Perliukų;4416064304;Ne;0;0;2;2
19974;Šaltinėlis;BORUŽĖLĖS;9762392403;Taip;19;0;0;19
19975;Šaltinėlis;BORUŽĖLĖS;9522524163;Taip;5;6;7;18
19976;Šaltinėlis;BORUŽĖLĖS;7311831014;Taip;4;6;0;10
19977;Šaltinėlis;BORUŽĖLĖS;5854723120;Taip;17;2;0;19
19978;Šaltinėlis;BORUŽĖLĖS;5833136956;Taip;9;1;0;10
19979;Šaltinėlis;BORUŽĖLĖS;3483756240;Taip;0;0;2;2
19980;Šaltinėlis;BORUŽĖLĖS;6380346298;Taip;11;0;2;13
19981;Šaltinėlis;BORUŽĖLĖS;5799032398;Taip;0;14;0;14
19982;Šaltinėlis;BORUŽĖLĖS;5525740049;Taip;0;8;0;8
19983;Šaltinėlis;BORUŽĖLĖS;5382567842;Taip;10;0;1;11
19984;Šaltinėlis;BORUŽĖLĖS;4681460322;Taip;0;13;0;13
19985;Šaltinėlis;BORUŽĖLĖS;1978469605;Ne;9;0;5;14
19986;Šaltinėlis;BORUŽĖLĖS;7650840990;Taip;3;5;0;8
19987;Šaltinėlis;BORUŽĖLĖS;4430546695;Taip;16;0;0;16
19988;Šaltinėlis;BORUŽĖLĖS;4743907195;Taip;20;0;0;20
19989;Šaltinėlis;1A;86995081866;Taip;0;8;0;8
19990;Šaltinėlis;1A;4587186145;Taip;0;13;0;13
19991;Šaltinėlis;1A;89489007301;Taip;0;20;0;20
19992;Šaltinėlis;1A;66754907606;Taip;0;20;0;20
19993;Šaltinėlis;1A;50972894040;Ne;0;6;0;6
19994;Šaltinėlis;1A;9705941341;Taip;0;20;0;20
19995;Šaltinėlis;1A;36718328105;Taip;0;11;0;11
19996;Šaltinėlis;1A;47045578599;Taip;0;6;0;6
19997;Šaltinėlis;1A;35387543586;Taip;0;9;0;9
19998;Šaltinėlis;1A;40769315138;Taip;0;7;0;7
19999;Šaltinėlis;1A;83657465071;Taip;0;6;0;6
20000;Šaltinėlis;1A;70948186548;Taip;0;8;0;8
20001;Šaltinėlis;1A;62612067151;Taip;0;13;0;13
20002;Šaltinėlis;1A;38496350161;Taip;0;12;0;12
20003;Šaltinėlis;1A;86309198604;Taip;0;14;0;14
20004;Šaltinėlis;1A;29683761586;Ne;0;7;0;7
20005;Šaltinėlis;1A;2323456393;Taip;0;20;0;20
20006;Šaltinėlis;1A;9927833966;Ne;0;7;0;7
20007;Šaltinėlis;1A;56279691365;Taip;0;6;0;6
20008;Šaltinėlis;1A;96133834896;Taip;0;20;0;20
20009;Šaltinėlis;1A;7929809205;Ne;0;9;0;9
20010;Šaltinėlis;1A;7563879445;Taip;0;6;0;6
20011;Šaltinėlis;"2A klasė";4843823058;Ne;0;10;0;10
20012;Šaltinėlis;"2A klasė";7264810605;Ne;0;6;0;6
20013;Šaltinėlis;"2A klasė";6044895102;Ne;0;9;0;9
20014;Šaltinėlis;"2A klasė";8680271000;Ne;0;7;0;7
20015;Šaltinėlis;"2A klasė";1839665658;Ne;0;11;0;11
20016;Šaltinėlis;"2A klasė";2076892804;Ne;0;10;0;10
20017;Šaltinėlis;"2A klasė";7967108692;Ne;0;6;0;6
20018;Šaltinėlis;"2A klasė";7058348243;Ne;0;6;0;6
20019;Šaltinėlis;"2A klasė";5012608633;Ne;0;7;0;7
20020;Šaltinėlis;"2A klasė";8445115141;Ne;0;6;0;6
20021;Šaltinėlis;"2A klasė";7214517805;Ne;0;20;0;20
20022;Šaltinėlis;"2A klasė";6876036723;Ne;0;20;0;20
20023;Šaltinėlis;"2A klasė";9978493148;Ne;0;6;0;6
20024;Šaltinėlis;"2A klasė";6171441011;Ne;0;6;0;6
20025;Šaltinėlis;"2A klasė";1450894955;Ne;0;20;0;20
20026;Šaltinėlis;"2A klasė";8898225999;Ne;0;20;0;20
20027;Šaltinėlis;"2A klasė";92001008485;Taip;0;6;0;6
20028;Šaltinėlis;"2B klasė";3329317171;Ne;0;9;0;9
20029;Šaltinėlis;"2B klasė";2089316824;Ne;0;9;0;9
20030;Šaltinėlis;"2B klasė";5776007602;Ne;0;6;0;6
20031;Šaltinėlis;"2B klasė";7420737103;Ne;0;11;0;11
20032;Šaltinėlis;"2B klasė";4141263000;Ne;0;6;0;6
20033;Šaltinėlis;"2B klasė";5999279571;Ne;0;7;0;7
20034;Šaltinėlis;"2B klasė";7142082502;Ne;0;20;0;20
20035;Šaltinėlis;"2B klasė";3037854361;Ne;0;6;0;6
20036;Šaltinėlis;"2B klasė";8219291385;Ne;0;6;0;6
20037;Šaltinėlis;"2B klasė";3863654037;Ne;0;14;0;14
20038;Šaltinėlis;"2B klasė";8380122669;Ne;0;7;0;7
20039;Šaltinėlis;"2B klasė";6719801285;Ne;0;9;0;9
20040;Šaltinėlis;"2B klasė";49275031765;Taip;0;18;0;18
20041;Šaltinėlis;"2B klasė";82404351290;Taip;0;12;0;12
20042;Šaltinėlis;"2B klasė";1756003648;Taip;0;20;0;20
20043;Šaltinėlis;"2B klasė";2002711790;Taip;0;6;0;6
20044;Šaltinėlis;"3A klasė";2010277249;Ne;0;6;0;6
20045;Šaltinėlis;"3A klasė";3553168020;Ne;0;6;0;6
20046;Šaltinėlis;"3A klasė";9341104954;Ne;0;11;0;11
20047;Šaltinėlis;"3A klasė";8714253922;Ne;0;6;0;6
20048;Šaltinėlis;"3A klasė";6948074305;Ne;0;7;0;7
20049;Šaltinėlis;"3A klasė";6765467361;Ne;0;11;0;11
20050;Šaltinėlis;"3A klasė";9057225956;Ne;0;11;0;11
20051;Šaltinėlis;"3A klasė";8503985429;Ne;0;6;0;6
20052;Šaltinėlis;"3A klasė";6443537515;Ne;0;12;0;12
20053;Šaltinėlis;"3A klasė";2154195956;Ne;0;11;0;11
20054;Šaltinėlis;"3A klasė";3636296862;Ne;0;12;0;12
20055;Šaltinėlis;"3A klasė";4062628468;Ne;0;11;0;11
20056;Šaltinėlis;"3A klasė";4977611599;Ne;0;11;0;11
20057;Šaltinėlis;"3A klasė";47857916979;Taip;0;20;0;20
20058;Šaltinėlis;"3A klasė";57928407025;Ne;0;20;0;20
20059;Šaltinėlis;"3A klasė";24414070672;Ne;0;20;0;20
20060;Šaltinėlis;"3A klasė";4884745983;Taip;0;20;0;20
20061;Šaltinėlis;"4A klasė";9593691923;Ne;0;10;0;10
20062;Šaltinėlis;"4A klasė";6511702530;Ne;0;20;0;20
20063;Šaltinėlis;"4A klasė";4852664619;Ne;0;6;0;6
20064;Šaltinėlis;"4A klasė";5000390873;Ne;0;6;0;6
20065;Šaltinėlis;"4A klasė";4673345747;Ne;0;12;0;12
20066;Šaltinėlis;"4A klasė";2890127126;Ne;0;6;0;6
20067;Šaltinėlis;"4A klasė";6507364244;Ne;0;6;0;6
20068;Šaltinėlis;"4A klasė";6109577947;Ne;0;6;0;6
20069;Šaltinėlis;"4A klasė";7820579483;Ne;0;9;0;9
20070;Šaltinėlis;"4A klasė";6716488827;Ne;0;8;0;8
20071;Šaltinėlis;"4A klasė";8503609901;Ne;0;20;0;20
20072;Šaltinėlis;"4A klasė";5212176791;Ne;0;15;0;15
20073;Šaltinėlis;"4A klasė";6810655952;Ne;0;6;0;6
20074;Šaltinėlis;"4A klasė";4699743123;Ne;0;7;0;7
20075;Šaltinėlis;"4A klasė";4989298444;Ne;0;6;0;6
20076;Šaltinėlis;"4A klasė";5234879459;Ne;0;6;0;6
20077;Šaltinėlis;"4A klasė";7307538614;Ne;0;6;0;6
20078;Šaltinėlis;"4A klasė";1322088652;Ne;0;6;0;6
20079;Šaltinėlis;"4A klasė";9980670695;Ne;0;7;0;7
20080;Šaltinėlis;"4A klasė";5574115620;Ne;0;11;0;11
20081;Šaltinėlis;"4A klasė";1765082898;Taip;0;20;0;20
20082;Šaltinėlis;"4A klasė";5623289398;Taip;0;20;0;20
20083;Šaltinėlis;"4A klasė";2310958087;Taip;0;6;0;6
20084;Šaltinėlis;"4A klasė";8431234082;Taip;0;20;0;20
20085;Šaltinėlis;3B;7917468152;Taip;0;6;0;6
20086;Šaltinėlis;3B;5181754988;Ne;0;11;0;11
20087;Šaltinėlis;3B;2413295020;Ne;0;20;0;20
20088;Šaltinėlis;3B;3680528737;Ne;0;6;0;6
20089;Šaltinėlis;3B;7404225862;Ne;0;6;0;6
20090;Šaltinėlis;3B;4335720836;Ne;0;7;0;7
20091;Šaltinėlis;3B;7121732840;Ne;0;6;0;6
20092;Šaltinėlis;3B;5105961386;Ne;0;11;0;11
20093;Šaltinėlis;3B;7316939619;Ne;0;6;0;6
20094;Šaltinėlis;3B;4543101402;Ne;0;10;0;10
20095;Šaltinėlis;3B;4994088781;Ne;0;6;0;6
20096;Šaltinėlis;3B;1687964284;Ne;0;6;0;6
20097;Šaltinėlis;3B;6381956693;Ne;0;8;0;8
20098;Šaltinėlis;3B;3375856084;Ne;0;6;0;6
20099;Šaltinėlis;3B;9708038079;Ne;0;7;0;7
20100;Šaltinėlis;3B;2160937385;Ne;0;6;0;6
20101;Šaltinėlis;3B;8670777468;Ne;0;6;0;6
20102;Gabijėlė;GANDRIUKŲ;80074896113;Taip;0;4;1;5
20103;Gabijėlė;GANDRIUKŲ;57976186090;Taip;0;2;3;5
20104;Gabijėlė;GANDRIUKŲ;78228886019;Taip;3;5;0;8
20105;Gabijėlė;GANDRIUKŲ;65824488786;Taip;0;15;0;15
20106;Gabijėlė;GANDRIUKŲ;58145931856;Taip;0;7;0;7
20107;Gabijėlė;GANDRIUKŲ;92468615840;Taip;10;4;0;14
20108;Gabijėlė;GANDRIUKŲ;54616199708;Taip;0;2;0;2
20109;Gabijėlė;GANDRIUKŲ;82760473229;Taip;0;5;0;5
20110;Gabijėlė;GANDRIUKŲ;54950294060;Taip;5;4;0;9
20111;Gabijėlė;GANDRIUKŲ;1606787727;Taip;0;10;0;10
20112;Gabijėlė;GANDRIUKŲ;38806631565;Taip;4;5;1;10
20113;Gabijėlė;GANDRIUKŲ;43769142642;Taip;0;4;0;4
20114;Gabijėlė;GANDRIUKŲ;54152752437;Taip;0;4;0;4
20115;Gabijėlė;GANDRIUKŲ;36611753307;Taip;0;5;1;6
20116;Gabijėlė;GANDRIUKŲ;99562533454;Taip;0;6;1;7
20117;Gabijėlė;GANDRIUKŲ;77966124767;Taip;0;5;0;5
20118;Gabijėlė;GANDRIUKŲ;26666095358;Taip;11;0;0;11
20119;Gabijėlė;GANDRIUKŲ;53845659478;Taip;0;2;0;2
20120;Gabijėlė;GANDRIUKŲ;68031503463;Taip;7;2;1;10
20121;Gabijėlė;GANDRIUKŲ;27958163601;Taip;5;2;1;8
20122;Gabijėlė;GANDRIUKŲ;12305494453;Taip;5;2;1;8
20123;Gabijėlė;GANDRIUKŲ;3694438650;Taip;11;2;0;13
20124;Gabijėlė;GANDRIUKŲ;96878883328;Taip;5;0;1;6
20125;Gabijėlė;GANDRIUKŲ;62369588485;Taip;0;2;3;5
20126;Gabijėlė;LAKŠTINGALIUKŲ;94564160237;Taip;0;7;0;7
20127;Gabijėlė;LAKŠTINGALIUKŲ;92624581275;Taip;6;0;0;6
20128;Gabijėlė;LAKŠTINGALIUKŲ;38094271521;Taip;9;0;0;9
20129;Gabijėlė;LAKŠTINGALIUKŲ;87667047750;Taip;0;3;0;3
20130;Gabijėlė;LAKŠTINGALIUKŲ;34977494652;Taip;4;4;0;8
20131;Gabijėlė;LAKŠTINGALIUKŲ;24034107401;Taip;15;0;0;15
20132;Gabijėlė;LAKŠTINGALIUKŲ;57442572439;Taip;0;1;0;1
20133;Gabijėlė;LAKŠTINGALIUKŲ;15974374755;Taip;0;5;3;8
20134;Gabijėlė;LAKŠTINGALIUKŲ;53325200270;Taip;0;1;5;6
20135;Gabijėlė;LAKŠTINGALIUKŲ;44723366493;Taip;0;2;1;3
20136;Gabijėlė;LAKŠTINGALIUKŲ;78764062355;Taip;6;0;0;6
20137;Gabijėlė;LAKŠTINGALIUKŲ;94096115282;Taip;0;2;0;2
20138;Gabijėlė;LAKŠTINGALIUKŲ;80865629865;Taip;0;5;0;5
20139;Gabijėlė;LAKŠTINGALIUKŲ;87107559087;Taip;0;7;0;7
20140;Gabijėlė;LAKŠTINGALIUKŲ;58162540225;Taip;0;5;0;5
20141;Gabijėlė;LAKŠTINGALIUKŲ;49652680743;Taip;0;2;0;2
20142;Gabijėlė;LAKŠTINGALIUKŲ;44981766204;Taip;0;0;1;1
20143;Gabijėlė;LAKŠTINGALIUKŲ;64279008849;Taip;0;2;0;2
20144;Gabijėlė;LAKŠTINGALIUKŲ;45682950511;Taip;5;2;0;7
20145;Gabijėlė;LAKŠTINGALIUKŲ;69244396670;Taip;0;5;2;7
20146;Gabijėlė;LAKŠTINGALIUKŲ;8729544694;Taip;0;1;0;1
20147;Gabijėlė;LAKŠTINGALIUKŲ;48032842307;Taip;5;1;1;7
20148;Gabijėlė;LAKŠTINGALIUKŲ;10026417844;Taip;0;6;0;6
20149;Gabijėlė;LAKŠTINGALIUKŲ;80650155819;Taip;0;1;0;1
20150;Gabijėlė;LAKŠTINGALIUKŲ;3114114973;Taip;2;8;0;10
20151;Gabijėlė;ŽVIRBLIUKŲ;4475530177;Taip;19;0;1;20
20152;Gabijėlė;ŽVIRBLIUKŲ;5743861607;Taip;17;0;0;17
20153;Gabijėlė;ŽVIRBLIUKŲ;7410541320;Taip;0;19;0;19
20154;Gabijėlė;ŽVIRBLIUKŲ;8036572198;Taip;0;18;0;18
20155;Gabijėlė;ŽVIRBLIUKŲ;4493192224;Taip;14;0;0;14
20156;Gabijėlė;ŽVIRBLIUKŲ;2491503656;Taip;0;9;0;9
20157;Gabijėlė;ŽVIRBLIUKŲ;9259964641;Taip;10;0;2;12
20158;Gabijėlė;ŽVIRBLIUKŲ;3268231136;Taip;0;19;0;19
20159;Gabijėlė;ŽVIRBLIUKŲ;8879972953;Taip;15;0;0;15
20160;Gabijėlė;ŽVIRBLIUKŲ;5332825339;Taip;20;0;0;20
20161;Gabijėlė;ŽVIRBLIUKŲ;9627906252;Taip;10;0;0;10
20162;Gabijėlė;ŽVIRBLIUKŲ;1725665169;Taip;3;4;0;7
20163;Gabijėlė;ŽVIRBLIUKŲ;2264669298;Taip;10;0;8;18
20164;Gabijėlė;ŽVIRBLIUKŲ;5942625633;Taip;5;4;0;9
20165;Gabijėlė;ŽVIRBLIUKŲ;7417179112;Taip;6;0;0;6
20166;Gabijėlė;ŽVIRBLIUKŲ;5387026410;Taip;0;0;6;6
20167;Gabijėlė;ŽVIRBLIUKŲ;8292463617;Taip;19;0;0;19
20168;Gabijėlė;GENIUKŲ;3445433386;Taip;0;5;0;5
20169;Gabijėlė;GENIUKŲ;2980295345;Taip;0;2;0;2
20170;Gabijėlė;GENIUKŲ;1862655595;Taip;0;2;0;2
20171;Gabijėlė;GENIUKŲ;7312628876;Taip;11;9;0;20
20172;Gabijėlė;GENIUKŲ;1581688238;Taip;8;2;0;10
20173;Gabijėlė;GENIUKŲ;5301905117;Taip;0;12;0;12
20174;Gabijėlė;GENIUKŲ;3176075887;Taip;6;14;0;20
20175;Gabijėlė;GENIUKŲ;6866641272;Taip;6;0;0;6
20176;Gabijėlė;GENIUKŲ;9972967198;Taip;19;0;0;19
20177;Gabijėlė;GENIUKŲ;8305098808;Taip;19;0;0;19
20178;Gabijėlė;GENIUKŲ;1589534853;Taip;8;1;0;9
20179;Gabijėlė;GENIUKŲ;3020599503;Taip;11;4;0;15
20180;Gabijėlė;GENIUKŲ;4234733280;Taip;9;0;0;9
20181;Gabijėlė;GENIUKŲ;1922979974;Taip;6;0;0;6
20182;Gabijėlė;GENIUKŲ;6482824000;Taip;6;1;0;7
20183;Gabijėlė;GENIUKŲ;5962852108;Taip;15;0;0;15
20184;Gabijėlė;GENIUKŲ;7178676049;Taip;18;0;0;18
20185;Gabijėlė;DAGILIUKŲ;9348393550;Taip;7;5;0;12
20186;Gabijėlė;DAGILIUKŲ;4264925447;Taip;7;5;0;12
20187;Gabijėlė;DAGILIUKŲ;9120107749;Taip;17;0;0;17
20188;Gabijėlė;DAGILIUKŲ;7426579018;Taip;20;0;0;20
20189;Gabijėlė;DAGILIUKŲ;9783343968;Taip;0;0;1;1
20190;Gabijėlė;DAGILIUKŲ;3700639354;Taip;7;0;0;7
20191;Gabijėlė;DAGILIUKŲ;6438144206;Taip;0;0;4;4
20192;Gabijėlė;DAGILIUKŲ;3017939983;Taip;8;0;1;9
20193;Gabijėlė;DAGILIUKŲ;8384795164;Taip;9;0;1;10
20194;Gabijėlė;DAGILIUKŲ;4462129182;Taip;20;0;0;20
20195;Gabijėlė;DAGILIUKŲ;8662914262;Taip;9;3;0;12
20196;Gabijėlė;DAGILIUKŲ;9280283478;Taip;9;1;0;10
20197;Gabijėlė;DAGILIUKŲ;9503639471;Taip;8;0;0;8
20198;Gabijėlė;DAGILIUKŲ;1988597157;Taip;20;0;0;20
20199;Gabijėlė;PELEDŽIUKŲ;94478599707;Taip;0;4;0;4
20200;Gabijėlė;PELEDŽIUKŲ;2067646395;Taip;0;1;0;1
20201;Gabijėlė;PELEDŽIUKŲ;1068556799;Taip;5;2;0;7
20202;Gabijėlė;PELEDŽIUKŲ;1171257945;Taip;3;5;2;10
20203;Gabijėlė;PELEDŽIUKŲ;8044682830;Taip;0;6;0;6
20204;Gabijėlė;PELEDŽIUKŲ;43109352262;Taip;0;1;0;1
20205;Gabijėlė;PELEDŽIUKŲ;1747282196;Taip;0;1;0;1
20206;Gabijėlė;PELEDŽIUKŲ;39679870094;Taip;4;2;1;7
20207;Gabijėlė;PELEDŽIUKŲ;36642141718;Taip;4;2;1;7
20208;Gabijėlė;PELEDŽIUKŲ;1491653325;Taip;0;4;0;4
20209;Gabijėlė;PELEDŽIUKŲ;1608940997;Taip;0;6;0;6
20210;Gabijėlė;PELEDŽIUKŲ;3610392405;Taip;0;0;2;2
20211;Gabijėlė;PELEDŽIUKŲ;4916964663;Taip;2;4;1;7
20212;Gabijėlė;PELEDŽIUKŲ;17443601729;Taip;10;0;1;11
20213;Gabijėlė;PELEDŽIUKŲ;1286307671;Taip;7;3;0;10
20214;Gabijėlė;PELEDŽIUKŲ;8428069167;Taip;0;3;0;3
20215;Gabijėlė;PELEDŽIUKŲ;4726771205;Taip;0;0;10;10
20216;Gabijėlė;PELEDŽIUKŲ;24035160251;Taip;18;0;0;18
20217;Gabijėlė;PELEDŽIUKŲ;38497069329;Taip;0;0;2;2
20218;Gabijėlė;PELEDŽIUKŲ;54948441867;Taip;0;1;0;1
20219;Gabijėlė;PELEDŽIUKŲ;57559227292;Taip;0;1;0;1
20220;Gabijėlė;PELEDŽIUKŲ;8746641978;Taip;0;0;1;1
20221;Gabijėlė;KREGZDŽIUKŲ;84945768423;Taip;11;1;0;12
20222;Gabijėlė;KREGZDŽIUKŲ;41661694634;Taip;15;1;0;16
20223;Gabijėlė;KREGZDŽIUKŲ;1743647754;Taip;10;5;0;15
20224;Gabijėlė;KREGZDŽIUKŲ;79544806044;Taip;0;4;0;4
20225;Gabijėlė;KREGZDŽIUKŲ;34683603878;Taip;7;1;0;8
20226;Gabijėlė;KREGZDŽIUKŲ;13013873198;Taip;10;6;0;16
20227;Gabijėlė;KREGZDŽIUKŲ;91643373754;Taip;0;4;6;10
20228;Gabijėlė;KREGZDŽIUKŲ;7298662616;Taip;0;4;1;5
20229;Gabijėlė;KREGZDŽIUKŲ;5884453557;Taip;0;5;2;7
20230;Gabijėlė;KREGZDŽIUKŲ;61217725255;Taip;0;0;1;1
20231;Gabijėlė;KREGZDŽIUKŲ;53576382572;Taip;10;0;0;10
20232;Gabijėlė;KREGZDŽIUKŲ;2958504770;Taip;6;0;1;7
20233;Gabijėlė;KREGZDŽIUKŲ;16720415967;Taip;5;0;0;5
20234;Gabijėlė;KREGZDŽIUKŲ;34998957585;Taip;9;0;0;9
20235;Gabijėlė;KREGZDŽIUKŲ;1770578935;Taip;0;8;1;9
20236;Gabijėlė;KREGZDŽIUKŲ;1455625997;Taip;12;0;0;12
20237;Gabijėlė;KREGZDŽIUKŲ;1937862725;Taip;9;0;0;9
20238;Gabijėlė;KREGZDŽIUKŲ;25732601952;Taip;0;1;0;1
20239;Gabijėlė;KREGZDŽIUKŲ;1217019582;Taip;11;0;0;11
20240;Gabijėlė;KREGZDŽIUKŲ;46552208567;Taip;5;4;0;9
20241;Gabijėlė;KREGZDŽIUKŲ;62457368692;Taip;5;1;0;6
20242;Gabijėlė;KREGZDŽIUKŲ;26058036933;Taip;1;0;0;1
20243;Gabijėlė;KREGZDŽIUKŲ;84120660883;Taip;1;0;0;1
20244;Gabijėlė;KREGZDŽIUKŲ;36447115547;Taip;12;0;0;12
20245;Gabijėlė;KREGZDŽIUKŲ;69294465170;Taip;0;5;0;5
20246;Gabijėlė;ZYLIUKŲ;20248530233;Taip;0;0;5;5
20247;Gabijėlė;ZYLIUKŲ;25691510343;Taip;0;0;5;5
20248;Gabijėlė;ZYLIUKŲ;84464214049;Taip;0;8;0;8
20249;Gabijėlė;ZYLIUKŲ;62562568076;Ne;0;0;5;5
20250;Gabijėlė;ZYLIUKŲ;89100449385;Taip;0;5;0;5
20251;Gabijėlė;ZYLIUKŲ;1505873499;Taip;0;4;0;4
20252;Gabijėlė;ZYLIUKŲ;1523021309;Taip;4;5;1;10
20253;Gabijėlė;ZYLIUKŲ;32203098792;Taip;0;2;0;2
20254;Gabijėlė;ZYLIUKŲ;1642361191;Taip;0;0;3;3
20255;Gabijėlė;ZYLIUKŲ;67189240970;Taip;0;12;0;12
20256;Gabijėlė;ZYLIUKŲ;1036201997;Taip;5;0;0;5
20257;Gabijėlė;ZYLIUKŲ;1240051312;Taip;0;0;5;5
20258;Gabijėlė;ZYLIUKŲ;60548215051;Taip;10;0;6;16
20259;Gabijėlė;ZYLIUKŲ;64168611850;Taip;0;6;2;8
20260;Gabijėlė;ZYLIUKŲ;1988838165;Taip;0;4;0;4
20261;Gabijėlė;ZYLIUKŲ;7778613039;Taip;0;5;1;6
20262;Gabijėlė;ZYLIUKŲ;1583728977;Taip;10;0;0;10
20263;Gabijėlė;ZYLIUKŲ;31458685084;Taip;0;5;0;5
20264;Gabijėlė;ZYLIUKŲ;16804922682;Taip;0;8;0;8
20265;Gabijėlė;ZYLIUKŲ;1213013384;Taip;0;0;12;12
20266;Gabijėlė;ZYLIUKŲ;2010619186;Taip;0;0;9;9
20267;Gabijėlė;ZYLIUKŲ;1145863002;Taip;0;0;2;2
20268;Gabijėlė;VOLUNGĖLIŲ;1779924073;Taip;9;0;7;16
20269;Gabijėlė;VOLUNGĖLIŲ;4166739739;Taip;0;13;0;13
20270;Gabijėlė;VOLUNGĖLIŲ;1492231030;Taip;0;13;0;13
20271;Gabijėlė;VOLUNGĖLIŲ;1317309811;Taip;0;10;0;10
20272;Gabijėlė;VOLUNGĖLIŲ;1523331860;Taip;0;1;2;3
20273;Gabijėlė;VOLUNGĖLIŲ;21740150080;Taip;0;9;0;9
20274;Gabijėlė;VOLUNGĖLIŲ;5558919097;Taip;2;0;1;3
20275;Gabijėlė;VOLUNGĖLIŲ;92191048844;Taip;0;0;1;1
20276;Gabijėlė;VOLUNGĖLIŲ;9683524530;Taip;11;0;0;11
20277;Gabijėlė;VOLUNGĖLIŲ;46021970332;Taip;6;0;3;9
20278;Gabijėlė;VOLUNGĖLIŲ;8480479946;Taip;3;6;0;9
20279;Gabijėlė;VOLUNGĖLIŲ;13265905500;Taip;14;0;0;14
20280;Gabijėlė;VOLUNGĖLIŲ;43737170074;Taip;6;0;1;7
20281;Gabijėlė;VOLUNGĖLIŲ;1480704497;Taip;0;8;0;8
20282;Gabijėlė;VOLUNGĖLIŲ;1669529717;Taip;0;0;4;4
20283;Gabijėlė;VOLUNGĖLIŲ;5704281727;Taip;0;0;6;6
20284;Gabijėlė;VOLUNGĖLIŲ;95685721388;Taip;0;6;0;6
20285;Gabijėlė;VOLUNGĖLIŲ;29328876924;Taip;10;2;0;12
20286;Gabijėlė;VOLUNGĖLIŲ;76416239647;Taip;9;0;1;10
20287;Gabijėlė;VOLUNGĖLIŲ;2102821834;Taip;5;0;1;6
20288;Gabijėlė;VOLUNGĖLIŲ;43869055555;Ne;10;10;0;20
20289;Gabijėlė;VOLUNGĖLIŲ;6271780003;Taip;6;0;0;6
20290;Gabijėlė;VOLUNGĖLIŲ;2051109865;Taip;3;17;0;20
20291;Gabijėlė;VOLUNGĖLIŲ;4662981914;Taip;20;0;0;20
20292;Gabijėlė;VOLUNGĖLIŲ;64252867351;Taip;0;15;0;15
20293;Gabijėlė;ANČIUKŲ;43123279348;Taip;7;6;0;13
20294;Gabijėlė;ANČIUKŲ;2036978425;Taip;0;0;3;3
20295;Gabijėlė;ANČIUKŲ;5219706067;Taip;5;0;0;5
20296;Gabijėlė;ANČIUKŲ;10796114623;Taip;0;15;0;15
20297;Gabijėlė;ANČIUKŲ;3454412432;Taip;6;0;1;7
20298;Gabijėlė;ANČIUKŲ;4752631976;Taip;7;0;1;8
20299;Gabijėlė;ANČIUKŲ;9822093084;Taip;16;0;0;16
20300;Gabijėlė;ANČIUKŲ;1415184607;Taip;10;0;1;11
20301;Gabijėlė;ANČIUKŲ;85836097485;Taip;14;0;0;14
20302;Gabijėlė;ANČIUKŲ;28017865889;Taip;4;13;0;17
20303;Gabijėlė;ANČIUKŲ;1917587420;Taip;0;16;0;16
20304;Gabijėlė;ANČIUKŲ;1465584524;Taip;12;0;0;12
20305;Gabijėlė;ANČIUKŲ;6198439092;Taip;6;0;1;7
20306;Gabijėlė;ANČIUKŲ;5783373671;Taip;13;0;0;13
20307;Gabijėlė;ANČIUKŲ;7948343328;Taip;0;0;2;2
20308;Gabijėlė;ANČIUKŲ;2052892422;Taip;6;0;5;11
20309;Gabijėlė;ANČIUKŲ;8111239476;Taip;15;0;5;20
20310;Gabijėlė;ANČIUKŲ;6766770793;Taip;0;0;3;3
20311;Gabijėlė;ANČIUKŲ;8778396292;Taip;11;0;3;14
20312;Gabijėlė;ANČIUKŲ;4085049535;Taip;0;18;0;18
20313;Gabijėlė;BALANDŽIUKŲ;9157819780;Taip;0;8;0;8
20314;Gabijėlė;BALANDŽIUKŲ;1045338865;Taip;3;0;3;6
20315;Gabijėlė;BALANDŽIUKŲ;4330624300;Taip;6;0;0;6
20316;Gabijėlė;BALANDŽIUKŲ;33124420723;Taip;0;0;5;5
20317;Gabijėlė;BALANDŽIUKŲ;2097260657;Taip;0;0;3;3
20318;Gabijėlė;BALANDŽIUKŲ;8131229306;Taip;0;0;1;1
20319;Gabijėlė;BALANDŽIUKŲ;8525869648;Taip;0;9;0;9
20320;Gabijėlė;BALANDŽIUKŲ;1010721404;Taip;17;0;0;17
20321;Gabijėlė;BALANDŽIUKŲ;56914218692;Taip;0;0;8;8
20322;Gabijėlė;BALANDŽIUKŲ;2070050969;Taip;6;3;0;9
20323;Gabijėlė;BALANDŽIUKŲ;2260623869;Taip;5;0;9;14
20324;Gabijėlė;BALANDŽIUKŲ;15049855022;Taip;0;2;0;2
20325;Gabijėlė;BALANDŽIUKŲ;2776579713;Taip;3;0;0;3
20326;Gabijėlė;BALANDŽIUKŲ;7977751362;Taip;0;0;2;2
20327;Gabijėlė;BALANDŽIUKŲ;5906952432;Taip;0;0;2;2
20328;Gabijėlė;BALANDŽIUKŲ;9197020006;Taip;0;5;0;5
20329;Gabijėlė;BALANDŽIUKŲ;1615940996;Taip;0;0;1;1
20330;Gabijėlė;VYTURIUKŲ;2059859352;Taip;0;0;1;1
20331;Gabijėlė;VYTURIUKŲ;3484413830;Taip;0;2;0;2
20332;Gabijėlė;VYTURIUKŲ;87868591956;Taip;0;2;0;2
20333;Gabijėlė;VYTURIUKŲ;1859288888;Taip;0;2;4;6
20334;Gabijėlė;VYTURIUKŲ;44322663690;Taip;14;0;2;16
20335;Gabijėlė;VYTURIUKŲ;1479311429;Taip;4;4;0;8
20336;Gabijėlė;VYTURIUKŲ;4765125810;Taip;11;0;0;11
20337;Gabijėlė;VYTURIUKŲ;1219257874;Taip;19;0;0;19
20338;Gabijėlė;VYTURIUKŲ;39269336820;Taip;0;5;0;5
20339;Gabijėlė;VYTURIUKŲ;1829866148;Taip;7;0;0;7
20340;Gabijėlė;VYTURIUKŲ;1949644078;Taip;0;2;0;2
20341;Gabijėlė;VYTURIUKŲ;47989272121;Taip;0;6;0;6
20342;Gabijėlė;VYTURIUKŲ;5736000160;Taip;5;0;0;5
20343;Gabijėlė;VYTURIUKŲ;9320327120;Taip;7;2;0;9
20344;Gabijėlė;VYTURIUKŲ;4632508075;Taip;14;0;0;14
20345;Gabijėlė;VYTURIUKŲ;1426802917;Taip;0;8;3;11
20346;Gabijėlė;VYTURIUKŲ;41212490042;Taip;14;0;0;14
20347;Gabijėlė;VYTURIUKŲ;1852597048;Taip;4;2;0;6
20348;Gabijėlė;VYTURIUKŲ;1287165224;Taip;1;1;0;2
20349;Gabijėlė;VYTURIUKŲ;34609028374;Taip;9;3;0;12
20350;Gabijėlė;VYTURIUKŲ;48342584892;Taip;11;0;1;12
20351;Gabijėlė;VYTURIUKŲ;1185452849;Taip;4;5;0;9
20352;Gabijėlė;VYTURIUKŲ;90520726029;Taip;10;0;0;10
20353;Gabijėlė;VYTURIUKŲ;11048695176;Taip;9;0;0;9
20354;Gabijėlė;VYTURIUKŲ;6492199649;Taip;0;5;0;5
20355;Pilaitukas;BITUTĖS;27134663020;Taip;18;0;0;18
20356;Pilaitukas;BITUTĖS;93292073339;Taip;18;0;0;18
20357;Pilaitukas;BITUTĖS;25872504305;Taip;0;1;1;2
20358;Pilaitukas;BITUTĖS;99558991322;Taip;2;6;1;9
20359;Pilaitukas;BITUTĖS;46467461875;Taip;12;8;0;20
20360;Pilaitukas;BITUTĖS;97868106590;Taip;0;2;0;2
20361;Pilaitukas;BITUTĖS;56237836622;Taip;0;5;0;5
20362;Pilaitukas;BITUTĖS;98123777614;Taip;6;1;0;7
20363;Pilaitukas;BITUTĖS;29035791508;Taip;0;4;1;5
20364;Pilaitukas;BITUTĖS;88894299577;Taip;0;1;0;1
20365;Pilaitukas;BITUTĖS;49882457703;Taip;20;0;0;20
20366;Pilaitukas;BITUTĖS;98876022289;Taip;0;0;2;2
20367;Pilaitukas;BITUTĖS;32580431386;Taip;2;2;0;4
20368;Pilaitukas;BITUTĖS;61458733284;Taip;2;0;3;5
20369;Pilaitukas;BITUTĖS;68262699910;Taip;0;0;1;1
20370;Pilaitukas;BITUTĖS;36677686051;Taip;0;4;1;5
20371;Pilaitukas;BITUTĖS;89335569661;Taip;0;1;2;3
20372;Pilaitukas;BITUTĖS;74933839730;Taip;0;6;0;6
20373;Pilaitukas;BITUTĖS;26318820010;Taip;13;5;0;18
20374;Pilaitukas;BITUTĖS;61725559703;Taip;10;0;0;10
20375;Pilaitukas;BITUTĖS;68819621853;Taip;0;1;0;1
20376;Pilaitukas;BITUTĖS;17314387753;Taip;0;0;3;3
20377;Pilaitukas;BITUTĖS;92116532227;Taip;0;7;1;8
20378;Pilaitukas;BITUTĖS;1854471823;Taip;10;1;0;11
20379;Pilaitukas;BITUTĖS;95753711905;Taip;1;2;0;3
20380;Pilaitukas;ZUIKUČIAI;66377321935;Taip;0;4;1;5
20381;Pilaitukas;ZUIKUČIAI;27233065857;Taip;6;0;0;6
20382;Pilaitukas;ZUIKUČIAI;74367577786;Taip;4;0;0;4
20383;Pilaitukas;ZUIKUČIAI;37415672544;Taip;10;0;1;11
20384;Pilaitukas;ZUIKUČIAI;50368168240;Taip;17;0;0;17
20385;Pilaitukas;ZUIKUČIAI;21795184411;Taip;14;4;0;18
20386;Pilaitukas;ZUIKUČIAI;63470473930;Taip;14;0;0;14
20387;Pilaitukas;ZUIKUČIAI;45165187254;Taip;0;0;3;3
20388;Pilaitukas;ZUIKUČIAI;49542027658;Taip;4;0;1;5
20389;Pilaitukas;ZUIKUČIAI;62992423192;Taip;0;4;1;5
20390;Pilaitukas;ZUIKUČIAI;1707355162;Taip;11;0;0;11
20391;Pilaitukas;ZUIKUČIAI;6913383121;Ne;0;6;2;8
20392;Pilaitukas;ZUIKUČIAI;1824063553;Taip;5;0;1;6
20393;Pilaitukas;ZUIKUČIAI;44413072002;Taip;19;0;0;19
20394;Pilaitukas;ZUIKUČIAI;53049608654;Taip;0;4;6;10
20395;Pilaitukas;ZUIKUČIAI;79398058989;Taip;9;0;1;10
20396;Pilaitukas;ZUIKUČIAI;8441380474;Taip;14;0;0;14
20397;Pilaitukas;ZUIKUČIAI;1286286153;Taip;0;0;4;4
20398;Pilaitukas;ZUIKUČIAI;83886439719;Taip;10;0;0;10
20399;Pilaitukas;ZUIKUČIAI;3723836301;Taip;3;0;1;4
20400;Pilaitukas;ZUIKUČIAI;1896452184;Taip;19;0;0;19
20401;Pilaitukas;ZUIKUČIAI;81347327136;Taip;5;0;0;5
20402;Pilaitukas;ANČIUKAI;5949185075;Taip;11;0;0;11
20403;Pilaitukas;ANČIUKAI;92108889661;Taip;11;0;0;11
20404;Pilaitukas;ANČIUKAI;9724892897;Taip;8;0;1;9
20405;Pilaitukas;ANČIUKAI;36338976218;Taip;0;3;0;3
20406;Pilaitukas;ANČIUKAI;1114477688;Taip;20;0;0;20
20407;Pilaitukas;ANČIUKAI;1512181401;Taip;3;0;1;4
20408;Pilaitukas;ANČIUKAI;3821748678;Taip;19;0;0;19
20409;Pilaitukas;ANČIUKAI;6222888898;Taip;14;0;0;14
20410;Pilaitukas;ANČIUKAI;8319676743;Taip;14;0;0;14
20411;Pilaitukas;ANČIUKAI;4505384039;Taip;12;0;0;12
20412;Pilaitukas;ANČIUKAI;5206439753;Taip;12;2;0;14
20413;Pilaitukas;ANČIUKAI;79485847381;Taip;12;0;0;12
20414;Pilaitukas;ANČIUKAI;5211988291;Taip;17;0;0;17
20415;Pilaitukas;ANČIUKAI;2117570444;Taip;14;0;0;14
20416;Pilaitukas;ANČIUKAI;87760608710;Taip;5;0;14;19
20417;Pilaitukas;ANČIUKAI;7909465673;Taip;19;0;0;19
20418;Pilaitukas;ANČIUKAI;2298935154;Taip;14;0;1;15
20419;Pilaitukas;ANČIUKAI;4694691187;Taip;20;0;0;20
20420;Pilaitukas;ANČIUKAI;9224653856;Taip;20;0;0;20
20421;Pilaitukas;MEŠKIUKAI;57931719105;Taip;11;1;0;12
20422;Pilaitukas;MEŠKIUKAI;14554050141;Taip;7;0;1;8
20423;Pilaitukas;MEŠKIUKAI;9015675095;Taip;1;3;0;4
20424;Pilaitukas;MEŠKIUKAI;2929868229;Taip;6;0;0;6
20425;Pilaitukas;MEŠKIUKAI;1135880899;Taip;8;0;1;9
20426;Pilaitukas;MEŠKIUKAI;4505147961;Taip;0;0;2;2
20427;Pilaitukas;MEŠKIUKAI;9618329726;Taip;11;0;0;11
20428;Pilaitukas;MEŠKIUKAI;6514784647;Taip;6;0;0;6
20429;Pilaitukas;MEŠKIUKAI;9732741366;Taip;5;4;0;9
20430;Pilaitukas;MEŠKIUKAI;4038320896;Taip;11;0;1;12
20431;Pilaitukas;MEŠKIUKAI;3794882532;Taip;5;0;0;5
20432;Pilaitukas;MEŠKIUKAI;18466900688;Taip;17;0;0;17
20433;Pilaitukas;MEŠKIUKAI;2736736697;Taip;19;0;0;19
20434;Pilaitukas;MEŠKIUKAI;3214740183;Taip;5;4;0;9
20435;Pilaitukas;MEŠKIUKAI;39600380611;Taip;6;0;1;7
20436;Pilaitukas;MEŠKIUKAI;5604992163;Taip;0;7;0;7
20437;Pilaitukas;MEŠKIUKAI;9450834035;Taip;0;7;0;7
20438;Pilaitukas;MEŠKIUKAI;5689385925;Taip;3;1;0;4
20439;Pilaitukas;MEŠKIUKAI;1003278169;Taip;17;0;0;17
20440;Pilaitukas;MEŠKIUKAI;6117985788;Taip;0;0;1;1
20441;Pilaitukas;MEŠKIUKAI;9924612250;Taip;0;4;5;9
20442;Pilaitukas;ŽUVYTĖS;93589370424;Taip;5;1;0;6
20443;Pilaitukas;ŽUVYTĖS;49645077501;Taip;0;1;0;1
20444;Pilaitukas;ŽUVYTĖS;10478661553;Taip;7;0;2;9
20445;Pilaitukas;ŽUVYTĖS;4068489824;Taip;5;0;0;5
20446;Pilaitukas;ŽUVYTĖS;87221246739;Taip;8;0;0;8
20447;Pilaitukas;ŽUVYTĖS;81748034503;Taip;5;3;0;8
20448;Pilaitukas;ŽUVYTĖS;44575161837;Taip;5;4;0;9
20449;Pilaitukas;ŽUVYTĖS;16099834356;Taip;3;6;1;10
20450;Pilaitukas;ŽUVYTĖS;83211068266;Taip;3;1;0;4
20451;Pilaitukas;ŽUVYTĖS;75122672596;Taip;5;0;0;5
20452;Pilaitukas;ŽUVYTĖS;32690121215;Taip;5;1;0;6
20453;Pilaitukas;ŽUVYTĖS;20879249256;Taip;0;1;0;1
20454;Pilaitukas;ŽUVYTĖS;7328603850;Taip;4;1;0;5
20455;Pilaitukas;ŽUVYTĖS;61755266054;Taip;6;4;0;10
20456;Pilaitukas;ŽUVYTĖS;63984542506;Taip;5;0;0;5
20457;Pilaitukas;ŽUVYTĖS;95470553230;Taip;19;0;0;19
20458;Pilaitukas;ŽUVYTĖS;93690180882;Taip;5;2;0;7
20459;Pilaitukas;ŽUVYTĖS;7831679444;Taip;0;1;0;1
20460;Pilaitukas;ŽUVYTĖS;86867736047;Taip;0;8;1;9
20461;Pilaitukas;ŽUVYTĖS;26107492404;Taip;0;1;0;1
20462;Pilaitukas;ŽUVYTĖS;20697780436;Ne;3;0;0;3
20463;Pilaitukas;ŽUVYTĖS;54410118765;Taip;0;1;0;1
20464;Pilaitukas;ŽUVYTĖS;17844195687;Taip;12;3;0;15
20465;Pilaitukas;PAUKŠTELIAI;9471549377;Taip;0;4;0;4
20466;Pilaitukas;PAUKŠTELIAI;76405230943;Taip;7;4;0;11
20467;Pilaitukas;PAUKŠTELIAI;63957573208;Taip;0;6;0;6
20468;Pilaitukas;PAUKŠTELIAI;15970261850;Taip;9;0;0;9
20469;Pilaitukas;PAUKŠTELIAI;67100267095;Taip;5;4;0;9
20470;Pilaitukas;PAUKŠTELIAI;98711809989;Taip;19;0;0;19
20471;Pilaitukas;PAUKŠTELIAI;59647179478;Taip;13;0;1;14
20472;Pilaitukas;PAUKŠTELIAI;18957334122;Taip;0;4;4;8
20473;Pilaitukas;PAUKŠTELIAI;50014639216;Taip;0;3;4;7
20474;Pilaitukas;PAUKŠTELIAI;46383254281;Taip;0;1;0;1
20475;Pilaitukas;PAUKŠTELIAI;70243036036;Taip;0;0;4;4
20476;Pilaitukas;PAUKŠTELIAI;61157601075;Taip;0;3;0;3
20477;Pilaitukas;PAUKŠTELIAI;1187929409;Taip;10;5;0;15
20478;Pilaitukas;PAUKŠTELIAI;97891667232;Taip;0;10;1;11
20479;Pilaitukas;PAUKŠTELIAI;41623603103;Taip;12;0;0;12
20480;Pilaitukas;PAUKŠTELIAI;67880125472;Taip;4;1;0;5
20481;Pilaitukas;PAUKŠTELIAI;8978245239;Taip;10;0;0;10
20482;Pilaitukas;PAUKŠTELIAI;89662617221;Taip;0;2;2;4
20483;Pilaitukas;PAUKŠTELIAI;40315977143;Taip;0;14;0;14
20484;Pilaitukas;PAUKŠTELIAI;1836597284;Ne;5;4;1;10
20485;Pilaitukas;PAUKŠTELIAI;86837043817;Taip;0;12;0;12
20486;Pilaitukas;PAUKŠTELIAI;51715261040;Taip;11;0;0;11
20487;Pilaitukas;PAUKŠTELIAI;94197429703;Taip;1;8;0;9
20488;Pilaitukas;BORUŽĖLĖS;98045145204;Taip;7;3;1;11
20489;Pilaitukas;BORUŽĖLĖS;26354100027;Taip;0;0;1;1
20490;Pilaitukas;BORUŽĖLĖS;2145561638;Taip;0;3;0;3
20491;Pilaitukas;BORUŽĖLĖS;14937983736;Taip;5;0;3;8
20492;Pilaitukas;BORUŽĖLĖS;1704733670;Ne;2;0;0;2
20493;Pilaitukas;BORUŽĖLĖS;8693280134;Taip;5;0;10;15
20494;Pilaitukas;BORUŽĖLĖS;2308673826;Taip;0;3;5;8
20495;Pilaitukas;BORUŽĖLĖS;1714711904;Taip;0;10;2;12
20496;Pilaitukas;BORUŽĖLĖS;2436416327;Taip;8;0;0;8
20497;Pilaitukas;BORUŽĖLĖS;2561804291;Taip;5;0;2;7
20498;Pilaitukas;BORUŽĖLĖS;9414846817;Taip;17;0;0;17
20499;Pilaitukas;BORUŽĖLĖS;7156205658;Taip;0;0;5;5
20500;Pilaitukas;BORUŽĖLĖS;95439358242;Ne;4;0;0;4
20501;Pilaitukas;BORUŽĖLĖS;6024861998;Taip;3;9;1;13
20502;Pilaitukas;BORUŽĖLĖS;58416972423;Taip;10;0;0;10
20503;Pilaitukas;BORUŽĖLĖS;1187805506;Taip;0;0;4;4
20504;Pilaitukas;BORUŽĖLĖS;1779631590;Taip;0;7;0;7
20505;Pilaitukas;BORUŽĖLĖS;3198896300;Taip;0;4;0;4
20506;Pilaitukas;DRUGELIAI;70499278669;Taip;0;10;0;10
20507;Pilaitukas;DRUGELIAI;86192743256;Taip;0;5;0;5
20508;Pilaitukas;DRUGELIAI;1126288017;Taip;10;0;2;12
20509;Pilaitukas;DRUGELIAI;89880758183;Taip;9;0;0;9
20510;Pilaitukas;DRUGELIAI;1726899445;Taip;0;0;1;1
20511;Pilaitukas;DRUGELIAI;2032732500;Taip;5;0;0;5
20512;Pilaitukas;DRUGELIAI;1586157196;Taip;11;0;0;11
20513;Pilaitukas;DRUGELIAI;7961518607;Taip;11;4;0;15
20514;Pilaitukas;DRUGELIAI;7082054458;Taip;11;4;0;15
20515;Pilaitukas;DRUGELIAI;1290119150;Taip;12;0;0;12
20516;Pilaitukas;DRUGELIAI;64601938351;Taip;3;3;0;6
20517;Pilaitukas;DRUGELIAI;64496490473;Taip;5;0;0;5
20518;Pilaitukas;DRUGELIAI;93217431744;Taip;10;4;0;14
20519;Pilaitukas;DRUGELIAI;62416017620;Taip;6;5;1;12
20520;Pilaitukas;DRUGELIAI;58250008277;Taip;7;0;2;9
20521;Pilaitukas;DRUGELIAI;38456484551;Taip;9;4;0;13
20522;Pilaitukas;DRUGELIAI;7838787153;Taip;10;4;0;14
20523;Pilaitukas;DRUGELIAI;2613078582;Taip;11;4;1;16
20524;Pilaitukas;DRUGELIAI;9246391309;Taip;5;0;1;6
20525;Pilaitukas;PELIUKAI;89730708991;Taip;5;0;0;5
20526;Pilaitukas;PELIUKAI;71302602535;Taip;3;0;0;3
20527;Pilaitukas;PELIUKAI;28559756114;Taip;0;1;0;1
20528;Pilaitukas;PELIUKAI;54387359229;Taip;15;4;0;19
20529;Pilaitukas;PELIUKAI;29229117661;Taip;6;5;0;11
20530;Pilaitukas;PELIUKAI;15303269615;Taip;14;0;0;14
20531;Pilaitukas;PELIUKAI;12327235652;Ne;5;5;0;10
20532;Pilaitukas;PELIUKAI;26063381713;Taip;20;0;0;20
20533;Pilaitukas;PELIUKAI;90148331957;Taip;7;4;0;11
20534;Pilaitukas;PELIUKAI;89719236172;Taip;0;5;0;5
20535;Pilaitukas;PELIUKAI;49084081967;Taip;9;1;0;10
20536;Pilaitukas;PELIUKAI;3685682772;Taip;9;4;1;14
20537;Pilaitukas;PELIUKAI;25608611239;Taip;14;0;0;14
20538;Pilaitukas;PELIUKAI;54706920576;Taip;19;0;0;19
20539;Pilaitukas;PELIUKAI;8152280709;Taip;9;3;0;12
20540;Pilaitukas;PELIUKAI;1613536796;Taip;15;0;0;15
20541;Pilaitukas;PELIUKAI;42514613325;Taip;20;0;0;20
20542;Pilaitukas;PELIUKAI;1509971492;Taip;20;0;0;20
20543;Pilaitukas;PELIUKAI;1611616941;Taip;5;6;0;11
20544;Pilaitukas;PELIUKAI;1726805610;Taip;8;0;0;8
20545;Pilaitukas;PELIUKAI;68571454940;Taip;4;0;1;5
20546;Pilaitukas;KAČIUKAI;74264627858;Taip;15;5;0;20
20547;Pilaitukas;KAČIUKAI;71072645939;Taip;2;4;0;6
20548;Pilaitukas;KAČIUKAI;70465651068;Taip;3;4;0;7
20549;Pilaitukas;KAČIUKAI;4283157555;Taip;10;9;0;19
20550;Pilaitukas;KAČIUKAI;78293798850;Taip;0;1;0;1
20551;Pilaitukas;KAČIUKAI;90472705680;Taip;8;4;0;12
20552;Pilaitukas;KAČIUKAI;58064353914;Taip;8;0;0;8
20553;Pilaitukas;KAČIUKAI;92823052045;Taip;8;4;1;13
20554;Pilaitukas;KAČIUKAI;82030031331;Taip;3;4;0;7
20555;Pilaitukas;KAČIUKAI;7032684121;Taip;11;0;0;11
20556;Pilaitukas;KAČIUKAI;91980974377;Taip;3;4;0;7
20557;Pilaitukas;KAČIUKAI;28902841059;Taip;12;0;0;12
20558;Pilaitukas;KAČIUKAI;2045735700;Taip;10;4;0;14
20559;Pilaitukas;KAČIUKAI;78048449266;Taip;7;0;0;7
20560;Pilaitukas;KAČIUKAI;82688660737;Taip;11;4;0;15
20561;Pilaitukas;KAČIUKAI;1508672511;Taip;1;0;0;1
20562;Pilaitukas;KAČIUKAI;4348058482;Taip;5;5;0;10
20563;Pilaitukas;KAČIUKAI;1056269188;Taip;5;0;0;5
20564;Pilaitukas;KAČIUKAI;34346418650;Taip;6;14;0;20
20565;Pilaitukas;KAČIUKAI;9496336005;Taip;8;2;0;10
20566;Pilaitukas;KAČIUKAI;6069797837;Taip;19;0;0;19
20567;Pilaitukas;SAULUTĖS;6646474196;Taip;20;0;0;20
20568;Pilaitukas;SAULUTĖS;9414051187;Taip;20;0;0;20
20569;Pilaitukas;SAULUTĖS;3037850837;Taip;13;0;1;14
20570;Pilaitukas;SAULUTĖS;4745358362;Taip;14;1;0;15
20571;Pilaitukas;SAULUTĖS;1677962644;Taip;14;1;0;15
20572;Pilaitukas;SAULUTĖS;7568744500;Taip;19;0;0;19
20573;Pilaitukas;SAULUTĖS;5407354218;Taip;11;3;0;14
20574;Pilaitukas;SAULUTĖS;6525191057;Taip;4;0;2;6
20575;Pilaitukas;SAULUTĖS;6838035491;Taip;4;0;1;5
20576;Pilaitukas;SAULUTĖS;3483758882;Taip;5;0;0;5
20577;Pilaitukas;SAULUTĖS;7853910193;Taip;14;0;0;14
20578;Pilaitukas;SAULUTĖS;5710747769;Taip;15;0;0;15
20579;Pilaitukas;SAULUTĖS;9974310580;Taip;15;0;0;15
20580;Pilaitukas;SAULUTĖS;9126553732;Taip;18;0;0;18
20581;Pilaitukas;SAULUTĖS;7438112270;Taip;16;0;1;17
20582;Pilaitukas;SAULUTĖS;7594484959;Taip;13;1;0;14
20583;Pilaitukas;MENULIUKAI;2406183145;Taip;11;0;0;11
20584;Pilaitukas;MENULIUKAI;2379660463;Taip;11;0;0;11
20585;Pilaitukas;MENULIUKAI;2862447956;Taip;4;2;0;6
20586;Pilaitukas;MENULIUKAI;8727175656;Taip;4;2;0;6
20587;Pilaitukas;MENULIUKAI;5353687011;Taip;19;0;0;19
20588;Pilaitukas;MENULIUKAI;9988041515;Taip;17;0;0;17
20589;Pilaitukas;MENULIUKAI;9108428738;Taip;17;0;0;17
20590;Pilaitukas;MENULIUKAI;1585341963;Taip;9;0;0;9
20591;Pilaitukas;MENULIUKAI;9260893320;Taip;4;0;0;4
20592;Pilaitukas;MENULIUKAI;4623818227;Taip;9;0;0;9
20593;Pilaitukas;MENULIUKAI;5640802570;Taip;13;0;0;13
20594;Pilaitukas;MENULIUKAI;9878890346;Taip;4;0;0;4
20595;Pilaitukas;MENULIUKAI;7334494990;Taip;19;0;0;19
20596;Pilaitukas;MENULIUKAI;8207194955;Taip;15;0;0;15
20597;Pilaitukas;MENULIUKAI;1607454890;Taip;15;0;0;15
20598;Pilaitukas;MENULIUKAI;6102253106;Taip;7;0;2;9
20599;Pilaitukas;ĖŽIUKAI;9793278788;Taip;0;1;0;1
20600;Pilaitukas;ĖŽIUKAI;5740951665;Taip;16;4;0;20
20601;Pilaitukas;ĖŽIUKAI;6308557885;Taip;17;0;0;17
20602;Pilaitukas;ĖŽIUKAI;6514731102;Taip;18;0;1;19
20603;Pilaitukas;ĖŽIUKAI;4591799893;Taip;17;0;1;18
20604;Pilaitukas;ĖŽIUKAI;9653647227;Taip;10;0;6;16
20605;Pilaitukas;ĖŽIUKAI;5326689274;Taip;10;0;6;16
20606;Pilaitukas;ĖŽIUKAI;3541354283;Taip;10;3;0;13
20607;Pilaitukas;ĖŽIUKAI;5988165204;Taip;6;0;2;8
20608;Pilaitukas;ĖŽIUKAI;4082490488;Taip;10;0;2;12
20609;Pilaitukas;ĖŽIUKAI;1729494874;Taip;0;4;1;5
20610;Pilaitukas;ĖŽIUKAI;2242454299;Taip;4;0;0;4
20611;Pilaitukas;ĖŽIUKAI;3345387791;Taip;7;0;0;7
20612;Pilaitukas;ĖŽIUKAI;3913169122;Taip;9;0;0;9
20613;Pilaitukas;ĖŽIUKAI;7342388716;Taip;0;5;4;9
20614;Pilaitukas;ĖŽIUKAI;1253300093;Taip;6;0;3;9
20615;Pilaitukas;ĖŽIUKAI;9038324313;Taip;14;0;0;14
20616;"Naujųjų verkių";Lopšelinė;1023447413;Taip;7;0;0;7
20617;"Naujųjų verkių";Lopšelinė;9840473841;Taip;4;0;0;4
20618;"Naujųjų verkių";Lopšelinė;63932903598;Taip;4;0;0;4
20619;"Naujųjų verkių";Lopšelinė;89540088936;Taip;0;1;0;1
20620;"Naujųjų verkių";Lopšelinė;3572188688;Taip;11;0;1;12
20621;"Naujųjų verkių";Lopšelinė;7872515649;Taip;20;0;0;20
20622;"Naujųjų verkių";Lopšelinė;9200073539;Taip;11;0;0;11
20623;"Naujųjų verkių";Lopšelinė;8429923120;Taip;4;2;0;6
20624;"Naujųjų verkių";Lopšelinė;1693323032;Taip;13;0;0;13
20625;"Naujųjų verkių";Lopšelinė;1536075084;Taip;4;0;0;4
20626;"Naujųjų verkių";Lopšelinė;7010430969;Taip;11;0;0;11
20627;"Naujųjų verkių";Lopšelinė;9462019924;Taip;0;8;0;8
20628;"Naujųjų verkių";Lopšelinė;7734802846;Taip;0;10;0;10
20629;"Naujųjų verkių";Darželinė;58681184744;Taip;0;2;0;2
20630;"Naujųjų verkių";Darželinė;52116449181;Taip;0;5;0;5
20631;"Naujųjų verkių";Darželinė;31334483791;Taip;0;2;0;2
20632;"Naujųjų verkių";Darželinė;64888070188;Taip;0;4;0;4
20633;"Naujųjų verkių";Darželinė;24725257127;Taip;4;0;0;4
20634;"Naujųjų verkių";Darželinė;12970840107;Taip;10;0;2;12
20635;"Naujųjų verkių";Darželinė;91710448735;Taip;11;0;0;11
20636;"Naujųjų verkių";Darželinė;70974231925;Taip;0;3;0;3
20637;"Naujųjų verkių";Darželinė;96956603806;Taip;4;0;0;4
20638;"Naujųjų verkių";Darželinė;52323041708;Taip;5;0;0;5
20639;"Naujųjų verkių";Darželinė;2636744220;Taip;0;4;0;4
20640;"Naujųjų verkių";Darželinė;45101251137;Taip;0;6;0;6
20641;"Naujųjų verkių";Darželinė;1321551506;Taip;0;7;0;7
20642;"Naujųjų verkių";Darželinė;1061601585;Taip;0;4;0;4
20643;"Naujųjų verkių";Darželinė;4727762605;Taip;0;10;0;10
20644;"Naujųjų verkių";Darželinė;19360482785;Taip;0;9;0;9
20645;"Naujųjų verkių";Darželinė;49937307547;Taip;0;20;0;20
20646;Švelnukas;Pelėdžiukai;97312326369;Taip;4;3;0;7
20647;Švelnukas;Pelėdžiukai;35501839416;Taip;0;0;1;1
20648;Švelnukas;Pelėdžiukai;1102317067;Taip;8;0;1;9
20649;Švelnukas;Pelėdžiukai;54159329795;Taip;0;4;0;4
20650;Švelnukas;Pelėdžiukai;56353311492;Taip;10;0;8;18
20651;Švelnukas;Pelėdžiukai;23911831780;Taip;0;1;0;1
20652;Švelnukas;Pelėdžiukai;73720184241;Taip;0;5;0;5
20653;Švelnukas;Pelėdžiukai;94832155557;Taip;0;0;20;20
20654;Švelnukas;Pelėdžiukai;1398812288;Taip;7;0;0;7
20655;Švelnukas;Pelėdžiukai;4006769867;Taip;0;4;0;4
20656;Švelnukas;Pelėdžiukai;39249642586;Taip;0;0;1;1
20657;Švelnukas;Pelėdžiukai;81569596159;Taip;0;5;1;6
20658;Švelnukas;Pelėdžiukai;12011187563;Taip;0;0;1;1
20659;Švelnukas;Pelėdžiukai;72764312386;Taip;11;0;0;11
20660;Švelnukas;Pelėdžiukai;59229958089;Taip;20;0;0;20
20661;Švelnukas;Pelėdžiukai;57026029080;Taip;7;5;0;12
20662;Švelnukas;Pelėdžiukai;30679686753;Taip;0;6;3;9
20663;Švelnukas;Pelėdžiukai;32473329970;Taip;9;2;0;11
20664;Švelnukas;Pelėdžiukai;50326830712;Taip;6;0;2;8
20665;Švelnukas;Pelėdžiukai;16880708270;Taip;11;1;0;12
20666;Švelnukas;Pelėdžiukai;19279790066;Taip;4;0;0;4
20667;Švelnukas;Pelėdžiukai;76470453844;Taip;4;0;0;4
20668;Švelnukas;Pelėdžiukai;88430357193;Taip;0;0;2;2
20669;Švelnukas;Pelėdžiukai;52477782880;Taip;10;0;0;10
20670;Švelnukas;Pelėdžiukai;2123115761;Taip;20;0;0;20
20671;Švelnukas;Ežiukai;62376594516;Taip;5;1;0;6
20672;Švelnukas;Ežiukai;65123682919;Taip;0;4;0;4
20673;Švelnukas;Ežiukai;59113412340;Ne;0;10;0;10
20674;Švelnukas;Ežiukai;95227249637;Taip;0;8;0;8
20675;Švelnukas;Ežiukai;68248605297;Taip;0;4;0;4
20676;Švelnukas;Ežiukai;94799905208;Taip;6;4;0;10
20677;Švelnukas;Ežiukai;41867077386;Taip;0;0;1;1
20678;Švelnukas;Ežiukai;64192510147;Taip;1;0;0;1
20679;Švelnukas;Ežiukai;41365412569;Taip;0;5;0;5
20680;Švelnukas;Ežiukai;55258226673;Taip;1;10;1;12
20681;Švelnukas;Ežiukai;25374873288;Taip;6;0;2;8
20682;Švelnukas;Ežiukai;6670022613;Taip;0;0;1;1
20683;Švelnukas;Ežiukai;68667782880;Taip;9;0;1;10
20684;Švelnukas;Ežiukai;15308444101;Taip;7;5;2;14
20685;Švelnukas;Ežiukai;6282389058;Taip;5;0;1;6
20686;Švelnukas;Ežiukai;5175035623;Taip;1;0;0;1
20687;Švelnukas;Ežiukai;84293714890;Taip;5;0;0;5
20688;Švelnukas;Ežiukai;1755384216;Taip;5;0;7;12
20689;Švelnukas;Ežiukai;23795609183;Taip;5;0;1;6
20690;Švelnukas;Ežiukai;31881188589;Taip;5;1;0;6
20691;Švelnukas;Švelnukai;50827155608;Taip;0;5;0;5
20692;Švelnukas;Švelnukai;67100479000;Taip;8;0;0;8
20693;Švelnukas;Švelnukai;37816683435;Taip;7;0;0;7
20694;Švelnukas;Švelnukai;35140428714;Taip;6;4;0;10
20695;Švelnukas;Švelnukai;6143538084;Taip;0;1;3;4
20696;Švelnukas;Švelnukai;16527728167;Taip;3;4;0;7
20697;Švelnukas;Švelnukai;55308151865;Taip;6;0;0;6
20698;Švelnukas;Švelnukai;58209041919;Taip;0;4;0;4
20699;Švelnukas;Švelnukai;2637595842;Taip;6;1;0;7
20700;Švelnukas;Švelnukai;75449064275;Taip;4;2;0;6
20701;Švelnukas;Švelnukai;64875997364;Taip;0;3;0;3
20702;Švelnukas;Švelnukai;32133621075;Taip;0;5;0;5
20703;Švelnukas;Švelnukai;94946505347;Taip;5;2;0;7
20704;Švelnukas;Švelnukai;96723762013;Taip;0;5;0;5
20705;Švelnukas;Švelnukai;25672016811;Ne;6;11;0;17
20706;Švelnukas;Švelnukai;52909536851;Taip;0;0;2;2
20707;Švelnukas;Švelnukai;80109886791;Taip;0;0;2;2
20708;Švelnukas;Švelnukai;84455755281;Taip;0;2;0;2
20709;Švelnukas;Švelnukai;94117802668;Taip;5;0;1;6
20710;Švelnukas;Švelnukai;1795843646;Ne;0;11;0;11
20711;Švelnukas;Boružiukai;1951447127;Taip;0;14;0;14
20712;Švelnukas;Boružiukai;8681264696;Taip;9;1;0;10
20713;Švelnukas;Boružiukai;4711482287;Taip;8;0;5;13
20714;Švelnukas;Boružiukai;8510195634;Taip;6;0;0;6
20715;Švelnukas;Boružiukai;3849957906;Taip;0;0;1;1
20716;Švelnukas;Boružiukai;5550841477;Taip;16;0;0;16
20717;Švelnukas;Boružiukai;5974324302;Taip;5;0;5;10
20718;Švelnukas;Boružiukai;9722532034;Taip;7;0;5;12
20719;Švelnukas;Boružiukai;2400781175;Taip;10;0;0;10
20720;Švelnukas;Boružiukai;1264256177;Taip;20;0;0;20
20721;Švelnukas;Boružiukai;6607578153;Taip;11;0;2;13
20722;Švelnukas;Boružiukai;8847738918;Taip;11;9;0;20
20723;Švelnukas;Boružiukai;1332533332;Taip;6;0;8;14
20724;Švelnukas;Boružiukai;8787505507;Taip;0;6;0;6
20725;Švelnukas;Boružiukai;4134678301;Taip;16;0;0;16
20726;Švelnukas;Boružiukai;8458233793;Taip;4;0;2;6
20727;Švelnukas;Boružiukai;7967996032;Taip;7;0;0;7
20728;Švelnukas;Smalsučiai;76418408780;Taip;0;4;0;4
20729;Švelnukas;Smalsučiai;82202942341;Taip;0;5;0;5
20730;Švelnukas;Smalsučiai;63394075248;Taip;0;6;0;6
20731;Švelnukas;Smalsučiai;53619702326;Taip;5;1;0;6
20732;Švelnukas;Smalsučiai;1183982303;Taip;0;5;0;5
20733;Švelnukas;Smalsučiai;74759523550;Taip;0;1;0;1
20734;Švelnukas;Smalsučiai;87770765141;Taip;13;0;1;14
20735;Švelnukas;Smalsučiai;47645479348;Taip;0;6;0;6
20736;Švelnukas;Smalsučiai;19117783391;Taip;0;0;1;1
20737;Švelnukas;Smalsučiai;26077395334;Taip;8;7;0;15
20738;Švelnukas;Smalsučiai;15711256627;Taip;0;7;0;7
20739;Švelnukas;Smalsučiai;76563731138;Taip;0;7;0;7
20740;Švelnukas;Smalsučiai;3388721433;Taip;0;1;0;1
20741;Švelnukas;Smalsučiai;1742714140;Taip;15;1;0;16
20742;Švelnukas;Smalsučiai;54425041280;Taip;0;7;2;9
20743;Švelnukas;Smalsučiai;91569132037;Taip;0;13;0;13
20744;Švelnukas;Smalsučiai;34570338962;Taip;20;0;0;20
20745;Švelnukas;Smalsučiai;78611632021;Taip;0;10;0;10
20746;Švelnukas;Smalsučiai;15774114007;Taip;10;0;2;12
20747;Švelnukas;Smalsučiai;26312856720;Taip;5;0;1;6
20748;Švelnukas;Nykštukai;5518267134;Taip;9;0;0;9
20749;Švelnukas;Nykštukai;1293700097;Taip;3;1;1;5
20750;Švelnukas;Nykštukai;8221642452;Taip;0;0;1;1
20751;Švelnukas;Nykštukai;2141519946;Taip;0;2;0;2
20752;Švelnukas;Nykštukai;8771953161;Taip;0;1;4;5
20753;Švelnukas;Nykštukai;5327209876;Taip;10;0;0;10
20754;Švelnukas;Nykštukai;2282356211;Taip;6;4;0;10
20755;Švelnukas;Nykštukai;4697253853;Taip;6;0;3;9
20756;Švelnukas;Nykštukai;7387060610;Taip;0;4;0;4
20757;Švelnukas;Nykštukai;1762528313;Taip;0;4;11;15
20758;Švelnukas;Nykštukai;7380948648;Taip;5;0;0;5
20759;Švelnukas;Nykštukai;3473146893;Taip;5;0;0;5
20760;Švelnukas;Nykštukai;3370028567;Taip;9;0;0;9
20761;Švelnukas;Nykštukai;62969317035;Taip;5;0;0;5
20762;Švelnukas;Nykštukai;6633233824;Taip;9;0;0;9
20763;Švelnukas;Nykštukai;2106591525;Taip;17;0;0;17
20764;Švelnukas;Nykštukai;93497358197;Taip;0;2;0;2
20765;Švelnukas;Nykštukai;2971380970;Taip;6;1;0;7
20766;Švelnukas;Nykštukai;3389897065;Taip;6;1;0;7
20767;Švelnukas;Nykštukai;4302735157;Taip;14;0;0;14
20768;Švelnukas;Nykštukai;2785396019;Taip;5;1;2;8
20769;Švelnukas;Nykštukai;6195335543;Taip;0;0;10;10
20770;Boružėlė;"Nykštukai gudručiai";16750834044;Taip;5;0;0;5
20771;Boružėlė;"Nykštukai gudručiai";17133057179;Taip;13;5;0;18
20772;Boružėlė;"Nykštukai gudručiai";48975225740;Taip;9;0;0;9
20773;Boružėlė;"Nykštukai gudručiai";61157651941;Ne;13;0;0;13
20774;Boružėlė;"Nykštukai gudručiai";89164129422;Taip;0;4;0;4
20775;Boružėlė;"Nykštukai gudručiai";61086657300;Taip;5;1;0;6
20776;Boružėlė;"Nykštukai gudručiai";27819440058;Taip;0;5;0;5
20777;Boružėlė;"Nykštukai gudručiai";62849453206;Taip;6;12;0;18
20778;Boružėlė;"Nykštukai gudručiai";650307889;Taip;10;2;0;12
20779;Boružėlė;"Nykštukai gudručiai";90752643228;Taip;5;5;0;10
20780;Boružėlė;"Nykštukai gudručiai";91349343635;Taip;9;0;0;9
20781;Boružėlė;"Nykštukai gudručiai";52470353273;Taip;20;0;0;20
20782;Boružėlė;"Nykštukai gudručiai";38216036757;Taip;14;0;0;14
20783;Boružėlė;"Nykštukai gudručiai";3659004986;Taip;8;0;0;8
20784;Boružėlė;"Nykštukai gudručiai";28726593347;Taip;0;0;20;20
20785;Boružėlė;"Nykštukai gudručiai";47122226309;Taip;8;0;0;8
20786;Boružėlė;"Nykštukai gudručiai";13957276157;Taip;9;0;0;9
20787;Boružėlė;"Nykštukai gudručiai";29807061047;Taip;5;0;0;5
20788;Boružėlė;"Nykštukai gudručiai";55985459125;Ne;8;2;0;10
20789;Boružėlė;"Nykštukai gudručiai";68875252308;Taip;4;0;0;4
20790;Boružėlė;"Nykštukai gudručiai";22491205325;Taip;4;3;2;9
20791;Boružėlė;"Nykštukai gudručiai";229765248;Taip;0;1;0;1
20792;Boružėlė;"Nykštukai gudručiai";16899340397;Taip;0;6;3;9
20793;Boružėlė;"Nykštukai gudručiai";82591189080;Taip;9;0;0;9
20794;Boružėlė;"Nykštukai gudručiai";5105514215;Taip;6;3;0;9
20795;Boružėlė;"Nykštukai gudručiai";64502791927;Taip;10;0;0;10
20796;Boružėlė;"Nykštukai gudručiai";95194187600;Taip;9;3;0;12
20797;Boružėlė;"Nykštukai gudručiai";37447518757;Taip;0;20;0;20
20798;Boružėlė;"Saulės zuikučiai";19859029063;Taip;0;10;4;14
20799;Boružėlė;"Saulės zuikučiai";92386016898;Taip;0;1;0;1
20800;Boružėlė;"Saulės zuikučiai";32378073529;Taip;0;8;4;12
20801;Boružėlė;"Saulės zuikučiai";69391016485;Taip;3;4;0;7
20802;Boružėlė;"Saulės zuikučiai";65182491064;Taip;0;5;2;7
20803;Boružėlė;"Saulės zuikučiai";31002497704;Taip;0;6;0;6
20804;Boružėlė;"Saulės zuikučiai";24149763183;Taip;5;10;1;16
20805;Boružėlė;"Saulės zuikučiai";8746617807;Taip;13;0;0;13
20806;Boružėlė;"Saulės zuikučiai";25311512878;Taip;0;1;0;1
20807;Boružėlė;"Saulės zuikučiai";34268210765;Taip;0;6;0;6
20808;Boružėlė;"Saulės zuikučiai";85800258410;Taip;0;14;2;16
20809;Boružėlė;"Saulės zuikučiai";5636816841;Taip;0;8;0;8
20810;Boružėlė;"Saulės zuikučiai";90270691161;Taip;0;1;0;1
20811;Boružėlė;"Saulės zuikučiai";92488927896;Taip;0;1;0;1
20812;Boružėlė;"Saulės zuikučiai";52262961972;Taip;0;4;0;4
20813;Boružėlė;"Saulės zuikučiai";59772973857;Taip;12;0;0;12
20814;Boružėlė;"Saulės zuikučiai";44064549128;Taip;0;1;0;1
20815;Boružėlė;"Saulės zuikučiai";39495849527;Ne;6;0;0;6
20816;Boružėlė;"Saulės zuikučiai";21573376804;Taip;0;1;0;1
20817;Boružėlė;"Saulės zuikučiai";44480055238;Taip;0;2;0;2
20818;Boružėlė;"Saulės zuikučiai";33333115262;Taip;0;0;1;1
20819;Boružėlė;Gėlytės;4023646693;Taip;16;0;0;16
20820;Boružėlė;Gėlytės;1259739396;Taip;1;5;0;6
20821;Boružėlė;Gėlytės;51321138507;Taip;5;0;10;15
20822;Boružėlė;Gėlytės;62298785353;Taip;6;2;2;10
20823;Boružėlė;Gėlytės;84087304104;Taip;6;0;0;6
20824;Boružėlė;Gėlytės;28968535453;Taip;0;6;4;10
20825;Boružėlė;Gėlytės;11785706048;Taip;9;1;0;10
20826;Boružėlė;Gėlytės;41726574939;Taip;15;1;0;16
20827;Boružėlė;Gėlytės;81433480408;Taip;14;2;0;16
20828;Boružėlė;Gėlytės;51923600458;Taip;4;0;0;4
20829;Boružėlė;Gėlytės;77207874939;Taip;9;9;0;18
20830;Boružėlė;Gėlytės;60999303687;Taip;0;1;0;1
20831;Boružėlė;Gėlytės;86742600111;Taip;0;2;1;3
20832;Boružėlė;Gėlytės;69393873241;Taip;0;4;0;4
20833;Boružėlė;Gėlytės;40388424785;Taip;3;1;0;4
20834;Boružėlė;Gėlytės;54530233692;Taip;20;0;0;20
20835;Boružėlė;Gėlytės;33639051694;Taip;2;0;0;2
20836;Boružėlė;Gėlytės;33266635443;Taip;16;0;0;16
20837;Boružėlė;Gėlytės;3118969668;Taip;0;6;0;6
20838;Boružėlė;Gėlytės;57842027470;Taip;14;2;0;16
20839;Boružėlė;Gėlytės;56693699464;Taip;5;4;0;9
20840;Boružėlė;Gėlytės;1010790194;Taip;10;2;0;12
20841;Boružėlė;Gėlytės;1813949172;Taip;11;0;0;11
20842;Boružėlė;Gėlytės;9148646597;Taip;11;0;0;11
20843;Boružėlė;Gėlytės;5306841409;Taip;12;0;0;12
20844;Boružėlė;Smalsutis;5129244830;Taip;13;1;0;14
20845;Boružėlė;Smalsutis;6927100979;Taip;20;0;0;20
20846;Boružėlė;Smalsutis;2887130633;Taip;8;0;0;8
20847;Boružėlė;Smalsutis;5267216044;Taip;0;19;0;19
20848;Boružėlė;Smalsutis;5708558321;Taip;16;0;0;16
20849;Boružėlė;Smalsutis;6484173786;Taip;12;0;0;12
20850;Boružėlė;Smalsutis;6742157071;Taip;8;0;0;8
20851;Boružėlė;Smalsutis;2132904457;Taip;20;0;0;20
20852;Boružėlė;Smalsutis;77513300382;Taip;0;2;0;2
20853;Boružėlė;Smalsutis;39553430808;Taip;7;0;0;7
20854;Boružėlė;Smalsutis;4958704459;Taip;0;3;0;3
20855;Boružėlė;Smalsutis;5618586722;Taip;0;6;0;6
20856;Boružėlė;Smalsutis;8493908653;Taip;5;1;0;6
20857;Boružėlė;Smalsutis;2447148171;Taip;3;2;0;5
20858;Boružėlė;Drugeliai;22364321459;Taip;0;4;0;4
20859;Boružėlė;Drugeliai;92489123105;Taip;1;9;0;10
20860;Boružėlė;Drugeliai;62673076395;Taip;7;7;1;15
20861;Boružėlė;Drugeliai;7846729818;Taip;1;9;0;10
20862;Boružėlė;Drugeliai;17934430709;Taip;0;7;2;9
20863;Boružėlė;Drugeliai;2832927610;Taip;3;5;0;8
20864;Boružėlė;Drugeliai;34848596097;Taip;0;1;0;1
20865;Boružėlė;Drugeliai;91514253954;Ne;0;1;1;2
20866;Boružėlė;Drugeliai;60850304458;Taip;1;8;2;11
20867;Boružėlė;Drugeliai;61687966416;Ne;1;15;0;16
20868;Boružėlė;Drugeliai;64005720465;Ne;4;1;0;5
20869;Boružėlė;Drugeliai;1317543345;Taip;0;2;0;2
20870;Boružėlė;Drugeliai;87323054466;Taip;11;0;0;11
20871;Boružėlė;Drugeliai;89040863632;Taip;19;0;0;19
20872;Boružėlė;Drugeliai;98019366092;Taip;0;8;0;8
20873;Boružėlė;Drugeliai;38702331698;Taip;0;6;0;6
20874;Boružėlė;Drugeliai;39872094732;Taip;0;1;0;1
20875;Boružėlė;Drugeliai;51684663458;Taip;0;7;7;14
20876;Boružėlė;Drugeliai;4219138834;Ne;0;4;0;4
20877;Boružėlė;Drugeliai;88659085306;Taip;14;0;0;14
20878;Boružėlė;Drugeliai;68002181211;Taip;4;6;1;11
20879;Boružėlė;Drugeliai;56479442138;Taip;9;2;1;12
20880;Boružėlė;Vyturėliai;1913540317;Taip;0;6;0;6
20881;Boružėlė;Vyturėliai;1950269258;Taip;0;16;0;16
20882;Boružėlė;Vyturėliai;1591582954;Taip;13;3;0;16
20883;Boružėlė;Vyturėliai;9180459278;Taip;5;1;5;11
20884;Boružėlė;Vyturėliai;3322567969;Taip;0;7;0;7
20885;Boružėlė;Vyturėliai;1718509953;Taip;0;6;0;6
20886;Boružėlė;Vyturėliai;8311383437;Taip;2;1;17;20
20887;Boružėlė;Vyturėliai;7534482245;Taip;0;1;19;20
20888;Boružėlė;Vyturėliai;3310676316;Taip;5;0;0;5
20889;Boružėlė;Vyturėliai;87834777247;Taip;17;0;0;17
20890;Boružėlė;Vyturėliai;50071056728;Taip;9;10;0;19
20891;Boružėlė;Vyturėliai;43300167107;Taip;0;8;0;8
20892;Boružėlė;Vyturėliai;2098408445;Taip;5;2;0;7
20893;Boružėlė;Vyturėliai;8706461730;Taip;11;4;0;15
20894;Boružėlė;Vyturėliai;5337704114;Taip;0;2;0;2
20895;Boružėlė;Vyturėliai;7136428795;Taip;4;3;0;7
20896;Boružėlė;Vyturėliai;8146684259;Taip;5;12;0;17
20897;Boružėlė;Vyturėliai;8225622711;Taip;0;1;0;1
20898;Boružėlė;Vyturėliai;67504667512;Taip;9;0;0;9
20899;Boružėlė;Vyturėliai;9150703371;Taip;5;1;0;6
20900;Boružėlė;Žvaigždutės;44535075266;Taip;0;2;5;7
20901;Boružėlė;Žvaigždutės;38045035880;Taip;0;1;0;1
20902;Boružėlė;Žvaigždutės;43607170469;Taip;0;2;0;2
20903;Boružėlė;Žvaigždutės;52277326311;Taip;1;1;0;2
20904;Boružėlė;Žvaigždutės;59496159689;Taip;5;1;0;6
20905;Boružėlė;Žvaigždutės;57677692109;Taip;4;8;2;14
20906;Boružėlė;Žvaigždutės;11257181283;Taip;0;6;0;6
20907;Boružėlė;Žvaigždutės;71560111993;Taip;0;1;0;1
20908;Boružėlė;Žvaigždutės;55597294544;Taip;4;14;0;18
20909;Boružėlė;Žvaigždutės;56257835408;Taip;4;10;0;14
20910;Boružėlė;Žvaigždutės;14720838994;Taip;0;0;1;1
20911;Boružėlė;Žvaigždutės;59360834739;Taip;8;1;0;9
20912;Boružėlė;Žvaigždutės;24931251062;Taip;0;1;0;1
20913;Boružėlė;Žvaigždutės;75023176711;Taip;0;14;2;16
20914;Boružėlė;Žvaigždutės;73627228099;Taip;0;1;0;1
20915;Boružėlė;Žvaigždutės;53465974644;Taip;14;0;0;14
20916;Boružėlė;Žvaigždutės;18917842445;Taip;5;9;0;14
20917;Boružėlė;Ąžuoliukai;5774358876;Taip;10;4;0;14
20918;Boružėlė;Ąžuoliukai;4519645340;Taip;14;0;0;14
20919;Boružėlė;Ąžuoliukai;24315678618;Taip;0;9;0;9
20920;Boružėlė;Ąžuoliukai;4994696176;Taip;0;1;0;1
20921;Boružėlė;Ąžuoliukai;5138737297;Taip;2;3;0;5
20922;Boružėlė;Ąžuoliukai;2618814096;Taip;6;7;0;13
20923;Boružėlė;Ąžuoliukai;6439902117;Taip;0;1;0;1
20924;Boružėlė;Ąžuoliukai;3040376382;Taip;0;18;0;18
20925;Boružėlė;Ąžuoliukai;3912668735;Taip;6;0;0;6
20926;Boružėlė;Ąžuoliukai;3840860155;Taip;2;8;0;10
20927;Boružėlė;Ąžuoliukai;3869817904;Taip;12;1;0;13
20928;Boružėlė;Ąžuoliukai;7722277859;Taip;8;3;0;11
20929;Boružėlė;Ąžuoliukai;6954794465;Taip;6;2;0;8
20930;Boružėlė;Ąžuoliukai;6545116373;Taip;0;14;0;14
20931;Boružėlė;Ąžuoliukai;5832223872;Taip;0;13;0;13
20932;Boružėlė;Ąžuoliukai;3695411422;Taip;16;0;0;16
20933;Boružėlė;Ąžuoliukai;1143453501;Taip;19;0;0;19
20934;Boružėlė;Ąžuoliukai;5490593122;Taip;10;0;0;10
20935;Boružėlė;Ąžuoliukai;5148410392;Taip;14;0;0;14
20936;Boružėlė;Ąžuoliukai;76222777017;Taip;5;0;0;5
20937;Boružėlė;Ąžuoliukai;45181369655;Taip;0;4;0;4
20938;Boružėlė;Ąžuoliukai;2077228543;Taip;8;0;0;8
20939;Boružėlė;Ąžuoliukai;6022191251;Taip;0;9;0;9
20940;Boružėlė;Saulutės;55049551150;Taip;0;1;0;1
20941;Boružėlė;Saulutės;1311485296;Taip;5;2;0;7
20942;Boružėlė;Saulutės;64389558278;Taip;0;1;0;1
20943;Boružėlė;Saulutės;46425201501;Taip;3;3;0;6
20944;Boružėlė;Saulutės;1399195259;Taip;3;17;0;20
20945;Boružėlė;Saulutės;72321159041;Taip;0;4;0;4
20946;Boružėlė;Saulutės;1247185819;Taip;9;1;0;10
20947;Boružėlė;Saulutės;1910653135;Taip;0;10;5;15
20948;Boružėlė;Saulutės;1527135537;Taip;3;2;0;5
20949;Boružėlė;Saulutės;8814486475;Taip;0;8;0;8
20950;Boružėlė;Saulutės;48414697489;Taip;5;4;0;9
20951;Boružėlė;Saulutės;3004650727;Taip;6;0;0;6
20952;Boružėlė;Saulutės;4567360023;Taip;7;1;0;8
20953;Boružėlė;Saulutės;96500755145;Ne;19;0;0;19
20954;Boružėlė;Saulutės;1506999888;Taip;0;9;0;9
20955;Boružėlė;Saulutės;2402968573;Taip;0;9;0;9
20956;Boružėlė;Saulutės;2690216341;Taip;10;6;0;16
20957;Boružėlė;Saulutės;1456577285;Taip;0;1;0;1
20958;Boružėlė;Saulutės;8659850691;Taip;0;3;0;3
20959;Boružėlė;Saulutės;4562962568;Taip;0;3;0;3
20960;Boružėlė;Saulutės;64347371263;Taip;0;8;1;9
20961;Boružėlė;Saulutės;28382049716;Taip;11;0;0;11
20962;Boružėlė;Saulutės;1750151078;Taip;0;10;0;10
20963;Boružėlė;Ežiukai;1637965530;Taip;7;1;0;8
20964;Boružėlė;Ežiukai;80490841186;Taip;0;0;3;3
20965;Boružėlė;Ežiukai;9645420240;Taip;0;2;0;2
20966;Boružėlė;Ežiukai;97765175729;Taip;8;3;0;11
20967;Boružėlė;Ežiukai;9436674675;Taip;0;3;0;3
20968;Boružėlė;Ežiukai;58923894463;Taip;13;6;0;19
20969;Boružėlė;Ežiukai;27456755162;Taip;6;6;7;19
20970;Boružėlė;Ežiukai;1339605077;Taip;0;7;0;7
20971;Boružėlė;Ežiukai;80239337645;Taip;0;2;1;3
20972;Boružėlė;Ežiukai;1007058344;Taip;0;6;0;6
20973;Boružėlė;Ežiukai;86859788504;Taip;0;12;0;12
20974;Boružėlė;Ežiukai;2138048547;Taip;19;0;0;19
20975;Boružėlė;Ežiukai;1431869021;Taip;15;0;0;15
20976;Boružėlė;Ežiukai;1474967056;Taip;10;6;0;16
20977;Boružėlė;Ežiukai;1732533643;Taip;0;4;0;4
20978;Boružėlė;Ežiukai;62548032852;Taip;6;1;0;7
20979;Boružėlė;Ežiukai;17258743024;Taip;0;4;0;4
20980;Boružėlė;Ežiukai;31109596405;Taip;10;6;0;16
20981;Boružėlė;Ežiukai;3702413611;Taip;5;0;1;6
20982;Boružėlė;Ežiukai;49403734292;Taip;14;0;0;14
20983;Boružėlė;Ežiukai;46486992436;Taip;9;0;0;9
20984;Boružėlė;Ežiukai;39704329817;Ne;14;0;0;14
20985;Boružėlė;Ežiukai;61932744418;Taip;1;4;0;5
20986;Boružėlė;Ežiukai;1459630343;Taip;6;4;0;10
20987;Boružėlė;Ežiukai;8266904750;Taip;0;2;0;2
20988;Boružėlė;Ežiukai;80378241169;Taip;0;1;0;1
20989;Boružėlė;Ežiukai;73347816357;Taip;0;1;0;1
20990;Boružėlė;Boružiukai;3140264242;Taip;0;1;0;1
20991;Boružėlė;Boružiukai;7901880926;Taip;5;2;0;7
20992;Boružėlė;Boružiukai;9720535449;Taip;1;2;0;3
20993;Boružėlė;Boružiukai;6435556131;Taip;1;2;1;4
20994;Boružėlė;Boružiukai;1583223569;Taip;13;0;0;13
20995;Boružėlė;Boružiukai;3955841578;Taip;13;1;0;14
20996;Boružėlė;Boružiukai;8259586236;Taip;13;0;0;13
20997;Boružėlė;Boružiukai;1663216529;Taip;0;1;0;1
20998;Boružėlė;Boružiukai;9271331800;Taip;1;19;0;20
20999;Boružėlė;Boružiukai;9838823214;Taip;6;12;0;18
21000;Boružėlė;Boružiukai;5298170118;Taip;5;4;0;9
21001;Boružėlė;Boružiukai;7825636053;Taip;0;5;0;5
21002;Boružėlė;Boružiukai;6293878183;Taip;5;2;0;7
21003;Boružėlė;Boružiukai;6242220139;Taip;6;4;0;10
21004;Boružėlė;Boružiukai;5274016839;Taip;11;0;0;11
21005;Boružėlė;Boružiukai;6972646373;Taip;0;2;0;2
21006;Boružėlė;Boružiukai;7216558291;Taip;9;0;0;9
21007;Boružėlė;Nykštukai;9913813461;Taip;14;1;0;15
21008;Boružėlė;Nykštukai;6049501362;Taip;20;0;0;20
21009;Boružėlė;Nykštukai;8683282162;Taip;0;5;0;5
21010;Boružėlė;Nykštukai;8141240094;Taip;13;2;0;15
21011;Boružėlė;Nykštukai;5187411500;Taip;12;0;0;12
21012;Boružėlė;Nykštukai;1130980139;Taip;0;2;0;2
21013;Boružėlė;Nykštukai;2087238951;Taip;6;0;0;6
21014;Boružėlė;Nykštukai;4999277693;Taip;15;0;0;15
21015;Boružėlė;Nykštukai;6463583187;Taip;9;1;0;10
21016;Boružėlė;Nykštukai;4509233532;Taip;10;1;0;11
21017;Boružėlė;Nykštukai;3136028536;Taip;14;0;0;14
21018;Boružėlė;Nykštukai;6724101421;Taip;0;2;0;2
21019;Boružėlė;Nykštukai;2211576663;Taip;5;4;0;9
21020;Boružėlė;Nykštukai;1559001916;Taip;11;2;0;13
21021;Boružėlė;Nykštukai;3129825206;Taip;0;1;0;1
21022;Boružėlė;Nykštukai;3952645542;Taip;20;0;0;20
21023;Boružėlė;Nykštukai;4233602822;Taip;5;0;0;5
21024;Boružėlė;Nykštukai;6990311896;Taip;15;0;0;15
21025;Žaliakalnio;Drugeliai;13682689553;Taip;0;7;2;9
21026;Žaliakalnio;Drugeliai;27904847662;Ne;0;6;0;6
21027;Žaliakalnio;Drugeliai;46069159390;Taip;0;11;0;11
21028;Žaliakalnio;Drugeliai;86878699666;Taip;5;7;0;12
21029;Žaliakalnio;Drugeliai;31358267062;Ne;0;9;0;9
21030;Žaliakalnio;Drugeliai;66587671546;Taip;2;8;0;10
21031;Žaliakalnio;Drugeliai;25885672997;Ne;5;12;1;18
21032;Žaliakalnio;Drugeliai;95162958789;Taip;0;10;0;10
21033;Žaliakalnio;Drugeliai;32706729925;Taip;0;7;0;7
21034;Žaliakalnio;Drugeliai;66150716129;Taip;0;12;0;12
21035;Žaliakalnio;Drugeliai;25938547290;Taip;9;6;0;15
21036;Žaliakalnio;Drugeliai;6781426791;Taip;3;8;0;11
21037;Žaliakalnio;Drugeliai;2049672202;Taip;0;9;0;9
21038;Žaliakalnio;Drugeliai;7563809721;Taip;0;12;0;12
21039;Žaliakalnio;Drugeliai;3711311672;Taip;0;12;0;12
21040;Žaliakalnio;Drugeliai;94833433433;Taip;0;4;0;4
21041;Žaliakalnio;Boružėlių;82492655622;Taip;0;8;0;8
21042;Žaliakalnio;Boružėlių;42466567091;Taip;14;0;0;14
21043;Žaliakalnio;Boružėlių;47810583989;Taip;0;6;1;7
21044;Žaliakalnio;Boružėlių;33301958715;Taip;0;17;0;17
21045;Žaliakalnio;Boružėlių;3965607452;Ne;0;7;0;7
21046;Žaliakalnio;Boružėlių;75317286407;Taip;0;6;1;7
21047;Žaliakalnio;Boružėlių;1743047570;Taip;0;6;0;6
21048;Žaliakalnio;Boružėlių;4250791818;Taip;0;11;0;11
21049;Žaliakalnio;Boružėlių;93570287071;Ne;0;7;0;7
21050;Žaliakalnio;Boružėlių;1083342257;Taip;0;12;0;12
21051;Žaliakalnio;Boružėlių;46244764767;Ne;0;13;0;13
21052;Žaliakalnio;Boružėlių;75758855114;Taip;3;8;2;13
21053;Žaliakalnio;Boružėlių;50460143975;Taip;0;7;2;9
21054;Žaliakalnio;Boružėlių;91780252395;Ne;0;15;0;15
21055;Žaliakalnio;Boružėlių;60736665152;Taip;0;15;0;15
21056;Žaliakalnio;Boružėlių;82839531225;Taip;0;8;0;8
21057;Žaliakalnio;Zuikučiai;1592051491;Taip;0;11;0;11
21058;Žaliakalnio;Zuikučiai;6088333997;Taip;15;0;0;15
21059;Žaliakalnio;Zuikučiai;2621828772;Taip;0;5;0;5
21060;Žaliakalnio;Zuikučiai;2673619031;Taip;0;13;0;13
21061;Žaliakalnio;Zuikučiai;5843314345;Taip;0;14;0;14
21062;Žaliakalnio;Zuikučiai;7447278960;Taip;0;13;0;13
21063;Žaliakalnio;Zuikučiai;2180165053;Taip;0;6;0;6
21064;Žaliakalnio;Zuikučiai;6823528666;Taip;20;0;0;20
21065;Žaliakalnio;Zuikučiai;3509064089;Taip;0;4;0;4
21066;Žaliakalnio;Zuikučiai;7000429934;Taip;5;7;0;12
21067;Žaliakalnio;Zuikučiai;5730610895;Taip;0;13;0;13
21068;Žaliakalnio;Zuikučiai;6881070397;Taip;0;13;0;13
21069;Žaliakalnio;Zuikučiai;8209559343;Taip;5;10;0;15
21070;Žaliakalnio;Zuikučiai;3835667120;Taip;0;12;0;12
21071;Žaliakalnio;Zuikučiai;5422289286;Taip;0;14;0;14
21072;Žaliakalnio;Zuikučiai;9799056285;Taip;0;7;0;7
21073;Žaliakalnio;Zuikučiai;1321592040;Taip;0;9;0;9
21074;Žaliakalnio;Zuikučiai;8298313285;Taip;0;6;0;6
21075;Žaliakalnio;Zuikučiai;9331287916;Taip;0;17;0;17
21076;Žaliakalnio;Zuikučiai;6726832258;Taip;0;8;0;8
21077;Žaliakalnio;Bitutė;23692122313;Ne;0;9;0;9
21078;Žaliakalnio;Bitutė;5761499050;Taip;5;14;0;19
21079;Žaliakalnio;Bitutė;47735728560;Taip;5;12;0;17
21080;Žaliakalnio;Bitutė;1581365258;Taip;5;5;0;10
21081;Žaliakalnio;Bitutė;1902477771;Taip;14;1;0;15
21082;Žaliakalnio;Bitutė;26003637304;Taip;0;17;0;17
21083;Žaliakalnio;Bitutė;1673236492;Taip;9;6;0;15
21084;Žaliakalnio;Bitutė;56222558457;Taip;3;9;0;12
21085;Žaliakalnio;Bitutė;46360583256;Taip;4;9;0;13
21086;Žaliakalnio;Bitutė;1027036769;Ne;19;1;0;20
21087;Žaliakalnio;Bitutė;2059763621;Taip;0;6;0;6
21088;Žaliakalnio;Bitutė;21032761681;Taip;9;6;0;15
21089;Žaliakalnio;Bitutė;1275007023;Taip;0;14;0;14
21090;Žaliakalnio;Bitutė;1142844672;Taip;0;20;0;20
21091;Žaliakalnio;Bitutė;1447567627;Taip;0;20;0;20
21092;Žaliakalnio;Bitutė;1919996835;Taip;0;11;0;11
21093;Žaliakalnio;Bitutė;1113616994;Taip;0;6;0;6
21094;Žaliakalnio;Bitutė;1824370122;Taip;0;14;0;14
21095;Žaliakalnio;Bitutė;64628389691;Taip;14;0;0;14
21096;Žaliakalnio;Bitutė;1909837418;Ne;19;1;0;20
21097;Žaliakalnio;Bitutė;56508324349;Taip;0;16;0;16
21098;Žaliakalnio;Bitutė;52109524827;Taip;0;18;0;18
21099;Žaliakalnio;Nykštukų;9057678671;Ne;0;6;0;6
21100;Žaliakalnio;Nykštukų;8640423692;Taip;0;6;0;6
21101;Žaliakalnio;Nykštukų;19192494119;Taip;0;12;0;12
21102;Žaliakalnio;Nykštukų;91524700281;Taip;5;12;0;17
21103;Žaliakalnio;Nykštukų;6560740320;Taip;0;11;0;11
21104;Žaliakalnio;Nykštukų;1932906021;Taip;0;10;0;10
21105;Žaliakalnio;Nykštukų;1753760382;Taip;0;11;0;11
21106;Žaliakalnio;Nykštukų;61215164827;Taip;0;7;0;7
21107;Žaliakalnio;Nykštukų;4936664829;Taip;0;5;0;5
21108;Žaliakalnio;Nykštukų;1657390839;Taip;6;7;0;13
21109;Žaliakalnio;Nykštukų;2655227703;Taip;6;9;0;15
21110;Žaliakalnio;Nykštukų;8085215871;Taip;0;14;0;14
21111;Žaliakalnio;Nykštukų;8469042778;Taip;6;6;0;12
21112;Žaliakalnio;Nykštukų;41844570217;Ne;0;15;0;15
21113;Žaliakalnio;Nykštukų;6638075273;Ne;5;15;0;20
21114;Žaliakalnio;Nykštukų;21744638321;Taip;7;6;0;13
21115;Žaliakalnio;Nykštukų;1514982516;Taip;20;0;0;20
21116;Žaliakalnio;Nykštukų;9918175249;Ne;5;15;0;20
21117;Žaliakalnio;Nykštukų;1497932659;Ne;0;5;0;5
21118;Žaliakalnio;Nykštukų;5946168564;Ne;0;11;0;11
21119;Žaliakalnio;ŽIOGELIAI;2607433844;Taip;8;2;0;10
21120;Žaliakalnio;ŽIOGELIAI;2432935088;Ne;5;15;0;20
21121;Žaliakalnio;ŽIOGELIAI;7862756576;Ne;5;9;0;14
21122;Žaliakalnio;ŽIOGELIAI;3058369504;Ne;0;9;0;9
21123;Žaliakalnio;ŽIOGELIAI;38025903441;Taip;0;6;0;6
21124;Žaliakalnio;ŽIOGELIAI;96127127960;Taip;2;5;0;7
21125;Žaliakalnio;ŽIOGELIAI;15344653714;Taip;0;12;0;12
21126;Žaliakalnio;ŽIOGELIAI;69892069029;Taip;0;12;0;12
21127;Žaliakalnio;ŽIOGELIAI;1589546605;Taip;5;9;0;14
21128;Žaliakalnio;ŽIOGELIAI;1012597457;Taip;10;8;0;18
21129;Žaliakalnio;ŽIOGELIAI;24900419959;Taip;0;13;0;13
21130;Žaliakalnio;ŽIOGELIAI;1357321617;Taip;0;9;0;9
21131;Žaliakalnio;ŽIOGELIAI;98394011032;Ne;0;5;0;5
21132;Žaliakalnio;ŽIOGELIAI;1967580906;Ne;7;5;0;12
21133;Žaliakalnio;ŽIOGELIAI;19165022144;Taip;0;5;0;5
21134;Žaliakalnio;ŽIOGELIAI;55967554391;Taip;0;7;0;7
21135;Žaliakalnio;ŽIOGELIAI;6919074533;Taip;0;6;0;6
21136;Žaliakalnio;ŽIOGELIAI;44058368949;Ne;0;5;0;5
21137;Volungė;Bitutės;2549910818;Ne;0;1;13;14
21138;Volungė;Bitutės;47050212421;Taip;0;6;1;7
21139;Volungė;Bitutės;12723194236;Ne;0;0;4;4
21140;Volungė;Bitutės;13542355518;Taip;0;14;0;14
21141;Volungė;Bitutės;82311993400;Taip;9;1;0;10
21142;Volungė;Bitutės;36063217784;Taip;0;0;3;3
21143;Volungė;Bitutės;1437653430;Ne;10;0;1;11
21144;Volungė;Bitutės;86020309344;Taip;16;0;1;17
21145;Volungė;Bitutės;1452196930;Taip;6;0;2;8
21146;Volungė;Bitutės;1046956717;Ne;0;0;3;3
21147;Volungė;Bitutės;18885218232;Taip;0;5;4;9
21148;Volungė;Bitutės;1213909538;Taip;5;5;0;10
21149;Volungė;Bitutės;1900962235;Taip;0;9;0;9
21150;Volungė;Bitutės;53305676926;Taip;4;9;0;13
21151;Volungė;Bitutės;1173228172;Taip;14;0;0;14
21152;Volungė;Bitutės;54390741416;Taip;0;3;0;3
21153;Volungė;Bitutės;1433101716;Ne;9;0;0;9
21154;Volungė;Bitutės;1234100483;Taip;17;0;0;17
21155;Volungė;Bitutės;63185257654;Taip;0;7;0;7
21156;Volungė;Bitutės;1938817757;Ne;5;0;1;6
21157;Volungė;Bitutės;1601358808;Taip;6;0;2;8
21158;Volungė;Bitutės;1605974968;Taip;8;0;1;9
21159;Volungė;Boružiukai;29221149335;Taip;11;0;0;11
21160;Volungė;Boružiukai;1044330259;Taip;1;3;1;5
21161;Volungė;Boružiukai;3924673024;Taip;0;0;3;3
21162;Volungė;Boružiukai;74451460970;Taip;4;2;0;6
21163;Volungė;Boružiukai;50076033275;Taip;0;0;3;3
21164;Volungė;Boružiukai;28521139566;Ne;9;5;0;14
21165;Volungė;Boružiukai;96547780998;Taip;6;3;0;9
21166;Volungė;Boružiukai;64735215987;Taip;0;13;0;13
21167;Volungė;Boružiukai;33643259323;Taip;0;20;0;20
21168;Volungė;Boružiukai;32259897897;Taip;5;1;0;6
21169;Volungė;Boružiukai;15495903063;Ne;10;2;1;13
21170;Volungė;Boružiukai;63789721631;Taip;0;0;2;2
21171;Volungė;Boružiukai;92516817330;Taip;7;0;0;7
21172;Volungė;Boružiukai;19870362159;Taip;0;0;1;1
21173;Volungė;Boružiukai;1699471816;Taip;20;0;0;20
21174;Volungė;Boružiukai;1695388167;Taip;14;1;1;16
21175;Volungė;Žvirbliukai;1862673253;Taip;9;0;1;10
21176;Volungė;Žvirbliukai;87185412767;Ne;12;2;1;15
21177;Volungė;Žvirbliukai;38549010202;Taip;0;0;10;10
21178;Volungė;Žvirbliukai;33864104545;Taip;0;0;14;14
21179;Volungė;Žvirbliukai;51999447522;Taip;9;0;2;11
21180;Volungė;Žvirbliukai;33437446320;Taip;4;0;3;7
21181;Volungė;Žvirbliukai;1673755671;Taip;0;0;4;4
21182;Volungė;Žvirbliukai;58770101384;Taip;0;0;20;20
21183;Volungė;Žvirbliukai;77965211614;Taip;0;0;20;20
21184;Volungė;Žvirbliukai;54054647743;Taip;8;5;1;14
21185;Volungė;Žvirbliukai;1866419277;Taip;0;0;2;2
21186;Volungė;Žvirbliukai;1400614987;Taip;0;0;4;4
21187;Volungė;Žvirbliukai;1002996169;Taip;0;9;0;9
21188;Volungė;Žvirbliukai;57009443613;Taip;5;0;6;11
21189;Volungė;Žvirbliukai;1177104323;Taip;0;0;18;18
21190;Volungė;Žvirbliukai;7623915697;Taip;0;0;13;13
21191;Volungė;Žvirbliukai;6426464927;Taip;0;11;0;11
21192;Volungė;Žiogeliai;1921353660;Taip;1;0;2;3
21193;Volungė;Žiogeliai;20829614346;Taip;10;8;0;18
21194;Volungė;Žiogeliai;6453272974;Taip;6;0;6;12
21195;Volungė;Žiogeliai;50525901200;Taip;7;0;0;7
21196;Volungė;Žiogeliai;1766449043;Taip;0;0;5;5
21197;Volungė;Žiogeliai;16359638255;Taip;0;11;0;11
21198;Volungė;Žiogeliai;4472358109;Taip;0;0;11;11
21199;Volungė;Žiogeliai;99572426508;Taip;0;0;4;4
21200;Volungė;Žiogeliai;18572342676;Taip;17;0;0;17
21201;Volungė;Žiogeliai;1574141255;Taip;0;3;4;7
21202;Volungė;Žiogeliai;83169035513;Taip;0;0;5;5
21203;Volungė;Žiogeliai;52112359999;Taip;14;0;0;14
21204;Volungė;Žiogeliai;55892369610;Taip;10;0;0;10
21205;Volungė;Žiogeliai;1776413826;Taip;1;0;3;4
21206;Volungė;Žiogeliai;73555360631;Ne;5;6;3;14
21207;Volungė;Žiogeliai;71074516561;Taip;11;0;3;14
21208;Volungė;Žiogeliai;11298375135;Taip;10;0;3;13
21209;Volungė;Žiogeliai;55920793056;Taip;10;0;3;13
21210;Volungė;Žiogeliai;1812871720;Taip;0;0;14;14
21211;Volungė;Žiogeliai;23806383679;Taip;0;5;10;15
21212;Volungė;Pelėdžiukai;1032406917;Taip;0;7;0;7
21213;Volungė;Pelėdžiukai;2106837525;Taip;13;0;2;15
21214;Volungė;Pelėdžiukai;1105647976;Taip;17;0;0;17
21215;Volungė;Pelėdžiukai;1705153224;Taip;10;0;5;15
21216;Volungė;Pelėdžiukai;2048619311;Taip;0;20;0;20
21217;Volungė;Pelėdžiukai;1205393441;Taip;10;0;0;10
21218;Volungė;Pelėdžiukai;3675279848;Taip;0;0;10;10
21219;Volungė;Pelėdžiukai;9097775073;Taip;18;0;0;18
21220;Volungė;Pelėdžiukai;1938717633;Taip;8;3;0;11
21221;Volungė;Pelėdžiukai;56766828567;Taip;0;0;1;1
21222;Volungė;Pelėdžiukai;6977873198;Taip;9;0;0;9
21223;Volungė;Pelėdžiukai;1917593287;Taip;14;0;0;14
21224;Volungė;Pelėdžiukai;2558681375;Taip;4;0;0;4
21225;Volungė;Pelėdžiukai;85731265908;Taip;5;1;5;11
21226;Volungė;Pelėdžiukai;1861218588;Taip;0;0;7;7
21227;Volungė;Pelėdžiukai;5483140534;Taip;5;0;0;5
21228;Volungė;Pelėdžiukai;8236836742;Taip;0;0;1;1
21229;Volungė;Pelėdžiukai;1158253769;Taip;5;0;1;6
21230;Volungė;Pelėdžiukai;3632828615;Taip;5;0;1;6
21231;Volungė;Drugeliai;2111319986;Taip;0;0;3;3
21232;Volungė;Drugeliai;1742777458;Taip;0;0;3;3
21233;Volungė;Drugeliai;2139675610;Taip;5;1;2;8
21234;Volungė;Drugeliai;1752357091;Taip;0;0;1;1
21235;Volungė;Drugeliai;1974360497;Taip;0;0;2;2
21236;Volungė;Drugeliai;86769531194;Taip;8;0;0;8
21237;Volungė;Drugeliai;86784613109;Taip;5;0;7;12
21238;Volungė;Drugeliai;3803129970;Taip;19;0;0;19
21239;Volungė;Drugeliai;1333045175;Taip;0;0;17;17
21240;Volungė;Drugeliai;1173302471;Taip;0;20;0;20
21241;Volungė;Drugeliai;1900204936;Taip;9;2;0;11
21242;Volungė;Drugeliai;1333755594;Taip;0;0;3;3
21243;Volungė;Drugeliai;1731981819;Taip;20;0;0;20
21244;Volungė;Drugeliai;44878463386;Taip;4;6;0;10
21245;Volungė;Drugeliai;2763686861;Taip;8;0;0;8
21246;Volungė;Drugeliai;19340864795;Taip;0;12;0;12
21247;Volungė;Drugeliai;3155184296;Taip;9;3;2;14
21248;Volungė;Drugeliai;7075466773;Taip;20;0;0;20
21249;Volungė;Drugeliai;1291153830;Taip;0;13;0;13
21250;Volungė;Drugeliai;1167124464;Taip;10;2;1;13
21251;Volungė;"SKRUZDĖLIUKAI ";8174587725;Taip;10;0;10;20
21252;Volungė;"SKRUZDĖLIUKAI ";7521910384;Taip;0;2;3;5
21253;Volungė;"SKRUZDĖLIUKAI ";5240126123;Taip;0;0;7;7
21254;Volungė;"SKRUZDĖLIUKAI ";8268202101;Taip;3;4;4;11
21255;Volungė;"SKRUZDĖLIUKAI ";2566901599;Taip;0;0;3;3
21256;Volungė;"SKRUZDĖLIUKAI ";3215314804;Taip;3;0;6;9
21257;Volungė;"SKRUZDĖLIUKAI ";7281448136;Taip;0;2;0;2
21258;Volungė;"SKRUZDĖLIUKAI ";2420242319;Taip;0;0;13;13
21259;Volungė;"SKRUZDĖLIUKAI ";1120682487;Taip;5;0;8;13
21260;Volungė;"SKRUZDĖLIUKAI ";8963841949;Taip;0;1;3;4
21261;Volungė;"SKRUZDĖLIUKAI ";1366066359;Taip;0;0;2;2
21262;Volungė;"SKRUZDĖLIUKAI ";9068889427;Taip;6;0;2;8
21263;Volungė;"SKRUZDĖLIUKAI ";6565522808;Taip;5;0;0;5
21264;Volungė;"SKRUZDĖLIUKAI ";1225378067;Taip;0;0;3;3
21265;Volungė;"SKRUZDĖLIUKAI ";3356901662;Taip;19;0;0;19
21266;Volungė;"SKRUZDĖLIUKAI ";9082860913;Taip;0;0;3;3
21267;Volungė;"SKRUZDĖLIUKAI ";7973680488;Taip;5;0;1;6
21268;Volungė;"SKRUZDĖLIUKAI ";9629567682;Taip;14;0;0;14
21269;Volungė;"SKRUZDĖLIUKAI ";2187800215;Taip;5;0;0;5
21270;Volungė;"SKRUZDĖLIUKAI ";3814647332;Taip;5;4;8;17
21271;Volungė;Zylutės;8784150784;Taip;10;2;0;12
21272;Volungė;Zylutės;7965601199;Taip;9;0;1;10
21273;Volungė;Zylutės;8287344195;Taip;7;10;0;17
21274;Volungė;Zylutės;5710662590;Taip;0;20;0;20
21275;Volungė;Zylutės;1528289101;Taip;1;11;0;12
21276;Volungė;Zylutės;1642961608;Taip;0;20;0;20
21277;Volungė;Zylutės;4839484528;Taip;9;0;6;15
21278;Volungė;Zylutės;9188994935;Taip;15;0;1;16
21279;Volungė;Zylutės;8285309230;Taip;0;20;0;20
21280;Volungė;Zylutės;7149986415;Taip;0;4;0;4
21281;Volungė;Zylutės;5174427959;Taip;5;0;9;14
21282;Volungė;Zylutės;7867741556;Taip;0;20;0;20
21283;Volungė;Zylutės;3430719834;Taip;5;0;3;8
21284;Volungė;Zylutės;8459167833;Taip;0;0;2;2
21285;Volungė;Zylutės;6028582927;Taip;11;0;1;12
21286;Volungė;Zylutės;2547777148;Taip;20;0;0;20
21287;Giliukas;SMALSUČIAI;84750777858;Taip;15;0;0;15
21288;Giliukas;SMALSUČIAI;4145860286;Taip;0;2;1;3
21289;Giliukas;SMALSUČIAI;1869027087;Taip;3;1;0;4
21290;Giliukas;SMALSUČIAI;80254838594;Taip;0;20;0;20
21291;Giliukas;SMALSUČIAI;4163391813;Taip;0;20;0;20
21292;Giliukas;SMALSUČIAI;1431811346;Taip;10;1;0;11
21293;Giliukas;SMALSUČIAI;1910800137;Taip;3;2;0;5
21294;Giliukas;SMALSUČIAI;8284364049;Taip;9;1;0;10
21295;Giliukas;SMALSUČIAI;1733875411;Taip;0;3;0;3
21296;Giliukas;SMALSUČIAI;2617670085;Taip;0;18;0;18
21297;Giliukas;SMALSUČIAI;51201920656;Taip;9;0;0;9
21298;Giliukas;SMALSUČIAI;1771662094;Taip;0;2;3;5
21299;Giliukas;SMALSUČIAI;60766023175;Taip;7;0;0;7
21300;Giliukas;SMALSUČIAI;50289768374;Taip;0;20;0;20
21301;Giliukas;SMALSUČIAI;76716908362;Taip;10;0;0;10
21302;Giliukas;SMALSUČIAI;7223355423;Taip;0;8;0;8
21303;Giliukas;SMALSUČIAI;1649456516;Taip;19;0;0;19
21304;Giliukas;SMALSUČIAI;51723671912;Taip;7;2;0;9
21305;Giliukas;SMALSUČIAI;1665908531;Taip;3;2;0;5
21306;Giliukas;SMALSUČIAI;1969508164;Ne;0;2;0;2
21307;Giliukas;SMALSUČIAI;1624952768;Taip;6;2;1;9
21308;Giliukas;GUDRUČIAI;47667170356;Taip;0;5;0;5
21309;Giliukas;GUDRUČIAI;44324261160;Taip;0;20;0;20
21310;Giliukas;GUDRUČIAI;2051045114;Taip;0;20;0;20
21311;Giliukas;GUDRUČIAI;1524900421;Taip;0;2;0;2
21312;Giliukas;GUDRUČIAI;20294403486;Taip;0;1;0;1
21313;Giliukas;GUDRUČIAI;13047826874;Taip;0;2;1;3
21314;Giliukas;GUDRUČIAI;45976793843;Taip;0;0;2;2
21315;Giliukas;GUDRUČIAI;12968687849;Taip;1;0;0;1
21316;Giliukas;GUDRUČIAI;96391124646;Taip;0;2;0;2
21317;Giliukas;GUDRUČIAI;77697629121;Taip;5;0;3;8
21318;Giliukas;GUDRUČIAI;25587077047;Taip;0;4;0;4
21319;Giliukas;GUDRUČIAI;135044370;Taip;0;6;0;6
21320;Giliukas;GUDRUČIAI;41761163148;Taip;3;0;1;4
21321;Giliukas;GUDRUČIAI;9254755937;Ne;0;8;0;8
21322;Giliukas;GUDRUČIAI;34919241837;Taip;0;2;0;2
21323;Giliukas;GUDRUČIAI;13279159942;Taip;6;4;0;10
21324;Giliukas;GUDRUČIAI;65254984026;Taip;0;1;0;1
21325;Giliukas;GUDRUČIAI;13946513947;Taip;0;0;2;2
21326;Giliukas;GUDRUČIAI;41666529831;Ne;6;8;6;20
21327;Giliukas;GUDRUČIAI;26006763829;Taip;0;1;0;1
21328;Giliukas;GUDRUČIAI;9455477992;Taip;0;20;0;20
21329;Giliukas;GUDRUČIAI;1203715568;Taip;0;1;0;1
21330;Giliukas;GUDRUČIAI;2157057125;Taip;0;20;0;20
21331;Giliukas;ŠNEKUČIAI;1463748654;Taip;5;4;0;9
21332;Giliukas;ŠNEKUČIAI;1289574961;Taip;0;1;0;1
21333;Giliukas;ŠNEKUČIAI;9461909264;Taip;5;0;0;5
21334;Giliukas;ŠNEKUČIAI;34155615138;Taip;3;4;2;9
21335;Giliukas;ŠNEKUČIAI;14318411597;Taip;11;1;0;12
21336;Giliukas;ŠNEKUČIAI;5798980878;Taip;0;4;0;4
21337;Giliukas;ŠNEKUČIAI;2006450088;Taip;1;0;0;1
21338;Giliukas;ŠNEKUČIAI;89954209937;Taip;5;7;0;12
21339;Giliukas;ŠNEKUČIAI;40373221046;Taip;0;2;1;3
21340;Giliukas;ŠNEKUČIAI;8575067944;Taip;14;0;0;14
21341;Giliukas;ŠNEKUČIAI;26109227683;Taip;0;0;1;1
21342;Giliukas;ŠNEKUČIAI;4053376466;Taip;10;2;1;13
21343;Giliukas;ŠNEKUČIAI;1406371374;Taip;19;0;0;19
21344;Giliukas;ŠNEKUČIAI;10326073797;Taip;16;4;0;20
21345;Giliukas;ŠNEKUČIAI;7732836522;Taip;16;0;0;16
21346;Giliukas;ŠNEKUČIAI;5914236976;Taip;0;0;20;20
21347;Giliukas;ŠNEKUČIAI;9225515816;Taip;0;1;0;1
21348;Giliukas;ŠNEKUČIAI;6453425490;Taip;9;0;0;9
21349;Giliukas;ŠNEKUČIAI;1190611675;Taip;8;1;0;9
21350;Giliukas;ŠNEKUČIAI;9747155435;Taip;0;20;0;20
21351;Giliukas;ŠNEKUČIAI;6154379463;Taip;0;20;0;20
21352;Giliukas;PABIRUČIAI;9401247559;Taip;4;4;0;8
21353;Giliukas;PABIRUČIAI;6384202904;Taip;8;0;0;8
21354;Giliukas;PABIRUČIAI;3691791222;Taip;4;0;0;4
21355;Giliukas;PABIRUČIAI;24030146209;Taip;0;20;0;20
21356;Giliukas;PABIRUČIAI;3847358328;Taip;0;8;0;8
21357;Giliukas;PABIRUČIAI;9693949103;Taip;0;1;0;1
21358;Giliukas;PABIRUČIAI;1890147760;Taip;0;20;0;20
21359;Giliukas;PABIRUČIAI;1469477982;Taip;15;0;0;15
21360;Giliukas;PABIRUČIAI;3983555939;Taip;14;0;0;14
21361;Giliukas;PABIRUČIAI;7780118692;Taip;4;2;0;6
21362;Giliukas;PABIRUČIAI;2951628295;Taip;12;1;0;13
21363;Giliukas;PABIRUČIAI;5994213515;Taip;0;20;0;20
21364;Giliukas;PABIRUČIAI;5787041097;Taip;20;0;0;20
21365;Giliukas;PABIRUČIAI;4854370266;Taip;0;6;0;6
21366;Giliukas;PABIRUČIAI;4987348316;Taip;0;2;0;2
21367;Giliukas;PABIRUČIAI;7159681896;Taip;1;0;0;1
21368;Giliukas;PABIRUČIAI;4916844983;Taip;11;3;0;14
21369;"Lazdynų mokykla";Drugeliai;10453975773;Taip;0;7;0;7
21370;"Lazdynų mokykla";Drugeliai;1246702054;Taip;6;0;0;6
21371;"Lazdynų mokykla";Drugeliai;93091209041;Taip;5;8;1;14
21372;"Lazdynų mokykla";Drugeliai;89878430155;Taip;0;1;2;3
21373;"Lazdynų mokykla";Drugeliai;43541072654;Taip;10;3;0;13
21374;"Lazdynų mokykla";Drugeliai;1117304239;Taip;6;1;1;8
21375;"Lazdynų mokykla";Drugeliai;9890308887;Taip;20;0;0;20
21376;"Lazdynų mokykla";Drugeliai;2079967590;Taip;5;0;0;5
21377;"Lazdynų mokykla";Drugeliai;9380814933;Taip;5;5;1;11
21378;"Lazdynų mokykla";Drugeliai;6209271043;Taip;9;1;0;10
21379;"Lazdynų mokykla";Drugeliai;7154882168;Taip;0;20;0;20
21380;"Lazdynų mokykla";Drugeliai;28132502877;Taip;5;6;1;12
21381;"Lazdynų mokykla";Drugeliai;6835150864;Taip;13;1;0;14
21382;"Lazdynų mokykla";Drugeliai;7772177095;Taip;4;0;0;4
21383;"Lazdynų mokykla";Drugeliai;9449948668;Taip;10;2;0;12
21384;"Lazdynų mokykla";Drugeliai;4520091712;Taip;0;0;1;1
21385;"Lazdynų mokykla";Drugeliai;3711708570;Ne;19;0;0;19
21386;"Lazdynų mokykla";Zuikučiai;1837465174;Taip;5;9;0;14
21387;"Lazdynų mokykla";Zuikučiai;1065999533;Taip;9;2;0;11
21388;"Lazdynų mokykla";Zuikučiai;5613360688;Taip;6;9;1;16
21389;"Lazdynų mokykla";Zuikučiai;40995112936;Taip;14;0;0;14
21390;"Lazdynų mokykla";Zuikučiai;9591838054;Taip;8;7;0;15
21391;"Lazdynų mokykla";Zuikučiai;8847547438;Ne;15;0;0;15
21392;"Lazdynų mokykla";Zuikučiai;6615724604;Taip;14;0;0;14
21393;"Lazdynų mokykla";Zuikučiai;9386629495;Taip;14;1;0;15
21394;"Lazdynų mokykla";Zuikučiai;1817040419;Taip;4;0;0;4
21395;"Lazdynų mokykla";Zuikučiai;1910670134;Taip;0;5;0;5
21396;"Lazdynų mokykla";Zuikučiai;25106446270;Taip;6;1;0;7
21397;"Lazdynų mokykla";Zuikučiai;9123178095;Taip;5;9;0;14
21398;"Lazdynų mokykla";Zuikučiai;8152577445;Taip;0;0;1;1
21399;"Lazdynų mokykla";Zuikučiai;6848743350;Taip;10;0;0;10
21400;"Lazdynų mokykla";Zuikučiai;1365362641;Taip;8;0;0;8
21401;"Lazdynų mokykla";Zuikučiai;3435025978;Taip;0;17;0;17
21402;"Lazdynų mokykla";Zuikučiai;7549389699;Ne;15;0;0;15
21403;"Lazdynų mokykla";RUPG;14305754762;Taip;3;1;0;4
21404;"Lazdynų mokykla";RUPG;40990471173;Taip;5;11;0;16
21405;"Lazdynų mokykla";RUPG;36268808517;Taip;0;20;0;20
21406;"Lazdynų mokykla";RUPG;4867721872;Taip;9;4;0;13
21407;"Lazdynų mokykla";RUPG;9840858941;Taip;2;4;0;6
21408;"Lazdynų mokykla";RUPG;3702185382;Taip;0;4;3;7
21409;"Lazdynų mokykla";RUPG;12946825485;Taip;3;6;0;9
21410;"Lazdynų mokykla";RUPG;33658230571;Taip;0;1;0;1
21411;"Lazdynų mokykla";RUPG;62603312655;Taip;2;4;4;10
21412;"Lazdynų mokykla";RUPG;2010518086;Ne;0;8;0;8
21413;"Lazdynų mokykla";RUPG;9341499222;Taip;15;4;0;19
21414;"Lazdynų mokykla";RUPG;85389197930;Taip;0;4;2;6
21415;"Lazdynų mokykla";PG;47639960564;Taip;0;1;0;1
21416;"Lazdynų mokykla";PG;8081211948;Taip;10;5;0;15
21417;"Lazdynų mokykla";PG;28609993291;Taip;6;1;0;7
21418;"Lazdynų mokykla";PG;72136845605;Taip;20;0;0;20
21419;"Lazdynų mokykla";PG;1422035829;Taip;0;6;2;8
21420;"Lazdynų mokykla";PG;7042064449;Taip;5;2;0;7
21421;"Lazdynų mokykla";PG;9770196122;Taip;1;0;1;2
21422;"Lazdynų mokykla";PG;87269519104;Taip;0;6;3;9
21423;"Lazdynų mokykla";PG;32859635045;Taip;0;15;0;15
21424;"„Atžalyno” mokykla-darželis";Giliukai;20731737855;Taip;0;4;8;12
21425;"„Atžalyno” mokykla-darželis";Giliukai;4689820608;Taip;0;4;0;4
21426;"„Atžalyno” mokykla-darželis";Giliukai;96760511860;Taip;5;4;0;9
21427;"„Atžalyno” mokykla-darželis";Giliukai;43653378110;Taip;5;4;0;9
21428;"„Atžalyno” mokykla-darželis";Giliukai;11283726979;Taip;10;2;0;12
21429;"„Atžalyno” mokykla-darželis";Giliukai;79370702446;Taip;10;2;0;12
21430;"„Atžalyno” mokykla-darželis";Giliukai;5473807824;Taip;3;4;0;7
21431;"„Atžalyno” mokykla-darželis";Giliukai;812540977;Taip;0;1;0;1
21432;"„Atžalyno” mokykla-darželis";Giliukai;16939194895;Taip;10;4;1;15
21433;"„Atžalyno” mokykla-darželis";Giliukai;72842885611;Taip;3;0;0;3
21434;"„Atžalyno” mokykla-darželis";Giliukai;1360239148;Taip;1;6;0;7
21435;"„Atžalyno” mokykla-darželis";Giliukai;2561427539;Ne;8;4;0;12
21436;"„Atžalyno” mokykla-darželis";Giliukai;21100054429;Taip;6;6;0;12
21437;"„Atžalyno” mokykla-darželis";Giliukai;75040764923;Taip;0;4;0;4
21438;"„Atžalyno” mokykla-darželis";Giliukai;9526480686;Taip;0;7;0;7
21439;"„Atžalyno” mokykla-darželis";Giliukai;24475539554;Taip;5;0;0;5
21440;"„Atžalyno” mokykla-darželis";Giliukai;63188100368;Taip;0;2;3;5
21441;"„Atžalyno” mokykla-darželis";Giliukai;24751884646;Taip;5;4;1;10
21442;"„Atžalyno” mokykla-darželis";Giliukai;94861364423;Taip;0;5;0;5
21443;"„Atžalyno” mokykla-darželis";Giliukai;8477084613;Taip;0;6;0;6
21444;"„Atžalyno” mokykla-darželis";Giliukai;9671080677;Taip;10;4;0;14
21445;"„Atžalyno” mokykla-darželis";Riešutėliai;62142172359;Taip;20;0;0;20
21446;"„Atžalyno” mokykla-darželis";Riešutėliai;3632328378;Taip;9;0;0;9
21447;"„Atžalyno” mokykla-darželis";Riešutėliai;31330839773;Taip;10;8;0;18
21448;"„Atžalyno” mokykla-darželis";Riešutėliai;1035650951;Taip;6;6;0;12
21449;"„Atžalyno” mokykla-darželis";Riešutėliai;27965090417;Ne;0;11;0;11
21450;"„Atžalyno” mokykla-darželis";Riešutėliai;4309031068;Ne;0;7;3;10
21451;"„Atžalyno” mokykla-darželis";Riešutėliai;6177714133;Taip;12;0;0;12
21452;"„Atžalyno” mokykla-darželis";Riešutėliai;1298900423;Taip;0;7;2;9
21453;"„Atžalyno” mokykla-darželis";Riešutėliai;64311414937;Taip;3;7;0;10
21454;"„Atžalyno” mokykla-darželis";Riešutėliai;2172405172;Ne;0;4;1;5
21455;"„Atžalyno” mokykla-darželis";Riešutėliai;23426260453;Taip;0;7;0;7
21456;"„Atžalyno” mokykla-darželis";Riešutėliai;9783561315;Taip;0;8;0;8
21457;"„Atžalyno” mokykla-darželis";Riešutėliai;79970541004;Taip;8;4;1;13
21458;"„Atžalyno” mokykla-darželis";Riešutėliai;94770065539;Taip;0;6;0;6
21459;"„Atžalyno” mokykla-darželis";Riešutėliai;79939366466;Taip;5;7;0;12
21460;"„Atžalyno” mokykla-darželis";Riešutėliai;78155776901;Taip;16;0;0;16
21461;"„Atžalyno” mokykla-darželis";Riešutėliai;10955918317;Taip;5;4;0;9
21462;"„Atžalyno” mokykla-darželis";Riešutėliai;19312623259;Taip;0;6;0;6
21463;"„Atžalyno” mokykla-darželis";Riešutėliai;5921479520;Taip;20;0;0;20
21464;"Vilniaus Emilijos Pliaterytės progimnazija";PELĖDŽIUKAI;1475766630;Taip;0;20;0;20
21465;"Vilniaus Emilijos Pliaterytės progimnazija";PELĖDŽIUKAI;6025990670;Taip;6;0;2;8
21466;"Vilniaus Emilijos Pliaterytės progimnazija";PELĖDŽIUKAI;1758561647;Taip;13;0;0;13
21467;"Vilniaus Emilijos Pliaterytės progimnazija";PELĖDŽIUKAI;11101488283;Taip;9;0;0;9
21468;"Vilniaus Emilijos Pliaterytės progimnazija";PELĖDŽIUKAI;1551926849;Taip;5;4;0;9
21469;"Vilniaus Emilijos Pliaterytės progimnazija";PELĖDŽIUKAI;9980215936;Ne;0;3;1;4
21470;"Vilniaus Emilijos Pliaterytės progimnazija";PELĖDŽIUKAI;6406833864;Taip;0;8;0;8
21471;"Vilniaus Emilijos Pliaterytės progimnazija";PELĖDŽIUKAI;3049460994;Taip;3;0;3;6
21472;"Vilniaus Emilijos Pliaterytės progimnazija";PELĖDŽIUKAI;2450382256;Taip;6;0;1;7
21473;"Vilniaus Emilijos Pliaterytės progimnazija";PELĖDŽIUKAI;7540156488;Taip;9;7;0;16
21474;"Vilniaus Emilijos Pliaterytės progimnazija";PELĖDŽIUKAI;4146983741;Taip;7;1;1;9
21475;"Vilniaus Emilijos Pliaterytės progimnazija";PELĖDŽIUKAI;9886869275;Taip;0;0;1;1
21476;"Vilniaus Emilijos Pliaterytės progimnazija";PELĖDŽIUKAI;63585262568;Taip;9;0;0;9
21477;"Vilniaus Emilijos Pliaterytės progimnazija";PELĖDŽIUKAI;1412529910;Taip;0;4;0;4
21478;"Vilniaus Emilijos Pliaterytės progimnazija";PELĖDŽIUKAI;8202177756;Taip;6;0;3;9
21479;"Vilniaus Emilijos Pliaterytės progimnazija";PELĖDŽIUKAI;1362468297;Ne;11;3;0;14
21480;"Vilniaus Emilijos Pliaterytės progimnazija";PELĖDŽIUKAI;96590022188;Taip;0;0;2;2
21481;"Vilniaus Emilijos Pliaterytės progimnazija";PELĖDŽIUKAI;2787942076;Taip;0;5;0;5
21482;"Vilniaus Emilijos Pliaterytės progimnazija";PELĖDŽIUKAI;15309143797;Taip;3;0;0;3
21483;"Vilniaus Emilijos Pliaterytės progimnazija";BITUTĖS;1266987365;Taip;0;5;0;5
21484;"Vilniaus Emilijos Pliaterytės progimnazija";BITUTĖS;1381033889;Taip;0;3;3;6
21485;"Vilniaus Emilijos Pliaterytės progimnazija";BITUTĖS;4569189295;Taip;5;4;0;9
21486;"Vilniaus Emilijos Pliaterytės progimnazija";BITUTĖS;48399220211;Taip;16;0;0;16
21487;"Vilniaus Emilijos Pliaterytės progimnazija";BITUTĖS;2514450574;Taip;0;6;2;8
21488;"Vilniaus Emilijos Pliaterytės progimnazija";BITUTĖS;16065326151;Taip;3;6;4;13
21489;"Vilniaus Emilijos Pliaterytės progimnazija";BITUTĖS;21354424968;Taip;20;0;0;20
21490;"Vilniaus Emilijos Pliaterytės progimnazija";BITUTĖS;9056362645;Taip;0;15;0;15
21491;"Vilniaus Emilijos Pliaterytės progimnazija";BITUTĖS;39510115701;Ne;10;4;0;14
21492;"Vilniaus Emilijos Pliaterytės progimnazija";BITUTĖS;6725344622;Taip;5;6;1;12
21493;"Vilniaus Emilijos Pliaterytės progimnazija";BITUTĖS;6010639117;Taip;10;5;0;15
21494;"Vilniaus Emilijos Pliaterytės progimnazija";BITUTĖS;9725646179;Taip;10;4;5;19
21495;"Vilniaus Emilijos Pliaterytės progimnazija";BITUTĖS;1601646622;Taip;11;0;0;11
21496;"Vilniaus Emilijos Pliaterytės progimnazija";BITUTĖS;4795999477;Ne;0;6;4;10
21497;"Vilniaus Emilijos Pliaterytės progimnazija";BITUTĖS;9872199634;Taip;3;4;0;7
21498;"Vilniaus Emilijos Pliaterytės progimnazija";BITUTĖS;6105675285;Ne;0;4;3;7
21499;"Vilniaus Emilijos Pliaterytės progimnazija";BITUTĖS;2149264761;Taip;5;4;8;17
21500;"Vilniaus Emilijos Pliaterytės progimnazija";BITUTĖS;9328626733;Taip;6;2;0;8
21501;"Vilniaus Emilijos Pliaterytės progimnazija";BITUTĖS;1212916505;Taip;5;4;0;9
21502;"Vilniaus Emilijos Pliaterytės progimnazija";BITUTĖS;61614055656;Taip;0;11;1;12
21503;"Vilniaus Emilijos Pliaterytės progimnazija";BITUTĖS;3740838674;Taip;11;6;3;20
21504;"Vilniaus Emilijos Pliaterytės progimnazija";BITUTĖS;2046056078;Taip;7;1;0;8
21505;"Vilniaus Emilijos Pliaterytės progimnazija";BITUTĖS;1323653656;Taip;5;4;0;9
21506;"Vilniaus Emilijos Pliaterytės progimnazija";BITUTĖS;5322173245;Taip;5;4;0;9
21507;"Vilniaus Emilijos Pliaterytės progimnazija";BITUTĖS;3416526776;Taip;10;4;2;16
21508;"Vilniaus Karaliaus Mindaugo pagrindinė mokykla";"NAUJA 1";1450039671;Taip;9;0;0;9
21509;"Vilniaus Karaliaus Mindaugo pagrindinė mokykla";"NAUJA 1";1823039323;Taip;0;0;1;1
21510;"Vilniaus Karaliaus Mindaugo pagrindinė mokykla";"NAUJA 1";8096536272;Ne;7;0;0;7
21511;"Vilniaus Karaliaus Mindaugo pagrindinė mokykla";"NAUJA 1";7596203918;Taip;20;0;0;20
21512;"Vilniaus Karaliaus Mindaugo pagrindinė mokykla";"NAUJA 1";3680257542;Ne;0;0;10;10
21513;"Vilniaus Karaliaus Mindaugo pagrindinė mokykla";"NAUJA 1";3447871828;Taip;6;0;0;6
21514;"Vilniaus Karaliaus Mindaugo pagrindinė mokykla";"NAUJA 1";10083948781;Taip;0;1;1;2
21515;"Vilniaus Karaliaus Mindaugo pagrindinė mokykla";"NAUJA 1";1401502095;Taip;13;0;1;14
21516;"Vilniaus Karaliaus Mindaugo pagrindinė mokykla";"NAUJA 1";1257750782;Taip;9;0;0;9
21517;"Vilniaus Karaliaus Mindaugo pagrindinė mokykla";"NAUJA 1";1969208564;Ne;0;0;4;4
21518;"Vilniaus Karaliaus Mindaugo pagrindinė mokykla";"NAUJA 1";1860540266;Taip;0;0;17;17
21519;"Vilniaus Karaliaus Mindaugo pagrindinė mokykla";"NAUJA 1";47224065699;Taip;0;0;1;1
21520;"Vilniaus Karaliaus Mindaugo pagrindinė mokykla";"NAUJA 1";9555191234;Taip;0;0;18;18
21521;"Vilniaus Karaliaus Mindaugo pagrindinė mokykla";"NAUJA 1";18362159086;Taip;10;1;1;12
21522;"Vilniaus Karaliaus Mindaugo pagrindinė mokykla";"NAUJA 1";9136681731;Taip;11;0;2;13
21523;"Vilniaus Karaliaus Mindaugo pagrindinė mokykla";"NAUJA 2";6139759777;Taip;0;0;3;3
21524;"Vilniaus Karaliaus Mindaugo pagrindinė mokykla";"NAUJA 2";1244335689;Ne;10;0;5;15
21525;"Vilniaus Karaliaus Mindaugo pagrindinė mokykla";"NAUJA 2";30247081871;Taip;0;0;2;2
21526;"Vilniaus Karaliaus Mindaugo pagrindinė mokykla";"NAUJA 2";22190489474;Taip;5;0;1;6
21527;"Vilniaus Karaliaus Mindaugo pagrindinė mokykla";"NAUJA 2";52007245002;Taip;0;0;7;7
21528;"Vilniaus Karaliaus Mindaugo pagrindinė mokykla";"NAUJA 2";1739513728;Taip;0;0;1;1
21529;"Vilniaus Karaliaus Mindaugo pagrindinė mokykla";"NAUJA 2";1109246994;Taip;11;0;0;11
21530;"Vilniaus Karaliaus Mindaugo pagrindinė mokykla";"NAUJA 2";42856875754;Taip;5;0;3;8
21531;"Vilniaus Karaliaus Mindaugo pagrindinė mokykla";"NAUJA 2";66357034848;Taip;0;5;7;12
21532;"Vilniaus Karaliaus Mindaugo pagrindinė mokykla";"NAUJA 2";9926365944;Taip;15;3;0;18
21533;"Vilniaus Karaliaus Mindaugo pagrindinė mokykla";"NAUJA 2";1929070821;Taip;5;0;4;9
21534;"Vilniaus Karaliaus Mindaugo pagrindinė mokykla";"NAUJA 2";34474268952;Taip;0;0;11;11
21535;"Vilniaus Karaliaus Mindaugo pagrindinė mokykla";"NAUJA 2";51014054575;Taip;0;0;2;2
21536;"Vilniaus Karaliaus Mindaugo pagrindinė mokykla";"NAUJA 2";1774272972;Taip;2;0;17;19
21537;"Vilniaus Karaliaus Mindaugo pagrindinė mokykla";"NAUJA 2";6408313774;Taip;0;0;2;2
21538;"Vilniaus Karaliaus Mindaugo pagrindinė mokykla";"NAUJA 2";1161763218;Taip;0;0;3;3
21539;"Vilniaus Karaliaus Mindaugo pagrindinė mokykla";"NAUJA 2";2941071757;Taip;0;6;1;7
21540;"Vilniaus Karaliaus Mindaugo pagrindinė mokykla";"NAUJA 2";7501280559;Taip;0;0;4;4
21541;"Vilniaus Karaliaus Mindaugo pagrindinė mokykla";"NAUJA 2";66035912812;Ne;5;0;4;9
21542;"Vilniaus Karaliaus Mindaugo pagrindinė mokykla";"NAUJA 2";45248429076;Taip;8;0;0;8
21543;"Vilniaus Karaliaus Mindaugo pagrindinė mokykla";"NAUJA 2";3763454607;Taip;4;0;0;4
21544;"Vilniaus Karaliaus Mindaugo pagrindinė mokykla";"NAUJA 3";76067902652;Taip;5;1;5;11
21545;"Vilniaus Karaliaus Mindaugo pagrindinė mokykla";"NAUJA 3";22824695222;Taip;0;13;0;13
21546;"Vilniaus Karaliaus Mindaugo pagrindinė mokykla";"NAUJA 3";15620943297;Taip;0;5;0;5
21547;"Vilniaus Karaliaus Mindaugo pagrindinė mokykla";"NAUJA 3";29462854972;Ne;1;6;0;7
21548;"Vilniaus Karaliaus Mindaugo pagrindinė mokykla";"NAUJA 3";46789173270;Ne;0;6;1;7
21549;"Vilniaus Karaliaus Mindaugo pagrindinė mokykla";"NAUJA 3";97658239591;Ne;0;0;4;4
21550;"Vilniaus Karaliaus Mindaugo pagrindinė mokykla";"NAUJA 3";93362540292;Taip;2;9;0;11
21551;"Vilniaus Karaliaus Mindaugo pagrindinė mokykla";"NAUJA 3";39314644760;Taip;2;5;0;7
21552;"Vilniaus Karaliaus Mindaugo pagrindinė mokykla";"NAUJA 3";63005020529;Taip;12;0;0;12
21553;"Vilniaus Karaliaus Mindaugo pagrindinė mokykla";"NAUJA 3";69875233191;Taip;12;3;0;15
21554;"Vilniaus Karaliaus Mindaugo pagrindinė mokykla";"NAUJA 3";81435594438;Taip;12;0;1;13
21555;"Vilniaus Karaliaus Mindaugo pagrindinė mokykla";"NAUJA 3";1933781186;Ne;0;6;0;6
21556;"Vilniaus Karaliaus Mindaugo pagrindinė mokykla";"NAUJA 3";5728013837;Taip;10;0;6;16
21557;"Vilniaus Karaliaus Mindaugo pagrindinė mokykla";"NAUJA 3";14289501964;Taip;8;0;0;8
21558;"Vilniaus Karaliaus Mindaugo pagrindinė mokykla";"NAUJA 3";29504643080;Taip;0;0;7;7
21559;"Vilniaus Karaliaus Mindaugo pagrindinė mokykla";"NAUJA 3";23714493433;Taip;14;0;5;19
21560;"Vilniaus Karaliaus Mindaugo pagrindinė mokykla";"NAUJA 3";1480855516;Taip;1;0;2;3
21561;"Vilniaus Karaliaus Mindaugo pagrindinė mokykla";"NAUJA 3";82128363155;Taip;6;1;0;7
21562;"Vilniaus Karaliaus Mindaugo pagrindinė mokykla";"NAUJA 3";3974287828;Ne;2;0;5;7
21563;"Vilniaus Baltupių progimnazija";Kodėlčiukai;39367902407;Taip;2;5;0;7
21564;"Vilniaus Baltupių progimnazija";Kodėlčiukai;54861855254;Taip;2;1;1;4
21565;"Vilniaus Baltupių progimnazija";Kodėlčiukai;14007025976;Taip;3;1;0;4
21566;"Vilniaus Baltupių progimnazija";Kodėlčiukai;71242132208;Taip;10;4;0;14
21567;"Vilniaus Baltupių progimnazija";Kodėlčiukai;32755901956;Taip;6;6;0;12
21568;"Vilniaus Baltupių progimnazija";Kodėlčiukai;85383004980;Taip;0;1;0;1
21569;"Vilniaus Baltupių progimnazija";Kodėlčiukai;39643159605;Taip;7;4;0;11
21570;"Vilniaus Baltupių progimnazija";Kodėlčiukai;44658552984;Taip;4;4;0;8
21571;"Vilniaus Baltupių progimnazija";Kodėlčiukai;55625325952;Taip;0;5;0;5
21572;"Vilniaus Baltupių progimnazija";Kodėlčiukai;29812449566;Taip;0;2;0;2
21573;"Vilniaus Baltupių progimnazija";Kodėlčiukai;16355778437;Taip;10;4;0;14
21574;"Vilniaus Baltupių progimnazija";Kodėlčiukai;41941052897;Taip;15;5;0;20
21575;"Vilniaus Baltupių progimnazija";Kodėlčiukai;43948925208;Taip;6;4;0;10
21576;"Vilniaus Baltupių progimnazija";Kodėlčiukai;9561915342;Taip;7;6;0;13
21577;"Vilniaus Baltupių progimnazija";Kodėlčiukai;41791737317;Taip;7;5;0;12
21578;"Vilniaus Baltupių progimnazija";Kodėlčiukai;69400709859;Taip;8;5;0;13
21579;"Vilniaus Baltupių progimnazija";Kodėlčiukai;10510784037;Taip;0;1;0;1
21580;"Vilniaus Baltupių progimnazija";Kodėlčiukai;43266943346;Taip;0;4;0;4
21581;"Vilniaus Baltupių progimnazija";Smalsučiai;6378279947;Taip;0;9;0;9
21582;"Vilniaus Baltupių progimnazija";Smalsučiai;98879417665;Taip;0;1;5;6
21583;"Vilniaus Baltupių progimnazija";Smalsučiai;72920136125;Taip;1;4;0;5
21584;"Vilniaus Baltupių progimnazija";Smalsučiai;6691656559;Taip;0;1;0;1
21585;"Vilniaus Baltupių progimnazija";Smalsučiai;26377121363;Taip;1;1;1;3
21586;"Vilniaus Baltupių progimnazija";Smalsučiai;54374237984;Taip;6;1;2;9
21587;"Vilniaus Baltupių progimnazija";Smalsučiai;44112608775;Taip;0;5;3;8
21588;"Vilniaus Baltupių progimnazija";Smalsučiai;14961029346;Taip;0;8;0;8
21589;"Vilniaus Baltupių progimnazija";Smalsučiai;55042661269;Taip;0;5;0;5
21590;"Vilniaus Baltupių progimnazija";Smalsučiai;28741416383;Taip;0;3;0;3
21591;"Vilniaus Baltupių progimnazija";Smalsučiai;34661197670;Taip;0;4;1;5
21592;"Vilniaus Baltupių progimnazija";Smalsučiai;85563395776;Taip;0;11;0;11
21593;"Vilniaus Baltupių progimnazija";Smalsučiai;88349018506;Taip;0;1;0;1
21594;"Vilniaus Baltupių progimnazija";Smalsučiai;1474110400;Taip;0;1;3;4
21595;"Vilniaus Baltupių progimnazija";Smalsučiai;58618032928;Taip;4;5;1;10
21596;"Vilniaus Baltupių progimnazija";Smalsučiai;29830293532;Taip;0;1;0;1
21597;"Vilniaus Baltupių progimnazija";Smalsučiai;8033817151;Taip;5;4;0;9
21598;"Vilniaus Baltupių progimnazija";Smalsučiai;1377633427;Ne;6;5;1;12
21599;"Vilniaus Baltupių progimnazija";Svajokliai;77443527742;Taip;0;5;2;7
21600;"Vilniaus Baltupių progimnazija";Svajokliai;1124861465;Taip;0;2;2;4
21601;"Vilniaus Baltupių progimnazija";Svajokliai;2783585739;Taip;0;4;0;4
21602;"Vilniaus Baltupių progimnazija";Svajokliai;84147129210;Taip;0;4;1;5
21603;"Vilniaus Baltupių progimnazija";Svajokliai;99951182202;Taip;5;5;0;10
21604;"Vilniaus Baltupių progimnazija";Svajokliai;44197089077;Taip;0;5;14;19
21605;"Vilniaus Baltupių progimnazija";Svajokliai;10296915277;Taip;0;4;10;14
21606;"Vilniaus Baltupių progimnazija";Svajokliai;6141821323;Taip;6;4;0;10
21607;"Vilniaus Baltupių progimnazija";Svajokliai;9897957182;Taip;0;4;5;9
21608;"Vilniaus Baltupių progimnazija";Svajokliai;6836526948;Taip;0;8;8;16
21609;"Vilniaus Baltupių progimnazija";Svajokliai;50679337916;Taip;0;4;0;4
21610;"Vilniaus Baltupių progimnazija";Svajokliai;86159748827;Taip;9;4;0;13
21611;"Vilniaus Baltupių progimnazija";Svajokliai;7315821989;Taip;6;4;0;10
21612;"Vilniaus Baltupių progimnazija";Svajokliai;85006202845;Taip;0;4;8;12
21613;"Vilniaus Baltupių progimnazija";Svajokliai;73329089772;Taip;11;4;0;15
21614;"Vilniaus Baltupių progimnazija";Svajokliai;53079636572;Ne;10;5;4;19
21615;"Vilniaus Baltupių progimnazija";Svajokliai;5165936773;Taip;0;5;1;6
21616;"Vilniaus Baltupių progimnazija";Svajokliai;3555057263;Taip;0;20;0;20
21617;"Vilniaus Baltupių progimnazija";Žiniukai;4438092778;Taip;0;1;0;1
21618;"Vilniaus Baltupių progimnazija";Žiniukai;49864549520;Ne;0;4;0;4
21619;"Vilniaus Baltupių progimnazija";Žiniukai;45338766326;Taip;7;4;0;11
21620;"Vilniaus Baltupių progimnazija";Žiniukai;7172910408;Taip;5;4;1;10
21621;"Vilniaus Baltupių progimnazija";Žiniukai;83439477631;Taip;2;0;0;2
21622;"Vilniaus Baltupių progimnazija";Žiniukai;96970348855;Taip;3;0;0;3
21623;"Vilniaus Baltupių progimnazija";Žiniukai;22749485803;Taip;0;2;2;4
21624;"Vilniaus Baltupių progimnazija";Žiniukai;21356492489;Taip;0;4;0;4
21625;"Vilniaus Baltupių progimnazija";Žiniukai;66442714295;Taip;0;7;0;7
21626;"Vilniaus Baltupių progimnazija";Žiniukai;69737288391;Taip;0;6;0;6
21627;"Vilniaus Baltupių progimnazija";Žiniukai;23763005302;Taip;5;4;0;9
21628;"Vilniaus Baltupių progimnazija";Žiniukai;5703301527;Taip;6;3;0;9
21629;"Vilniaus Baltupių progimnazija";Žiniukai;59153301160;Taip;0;4;1;5
21630;"Vilniaus Baltupių progimnazija";Žiniukai;7935037685;Taip;2;4;1;7
21631;"Vilniaus Baltupių progimnazija";Žiniukai;3909042390;Taip;5;4;2;11
21632;"Vilniaus Baltupių progimnazija";Žiniukai;6434969626;Taip;0;12;0;12
21633;"Vilniaus Baltupių progimnazija";Žiniukai;52985512945;Taip;0;5;0;5
21634;"Vilniaus Levo Karsavimo vidurinė mokykla";"Priešmokyklinukai A";14440714117;Taip;10;1;1;12
21635;"Vilniaus Levo Karsavimo vidurinė mokykla";"Priešmokyklinukai A";82502598495;Taip;0;7;1;8
21636;"Vilniaus Levo Karsavimo vidurinė mokykla";"Priešmokyklinukai A";93157311332;Taip;15;0;0;15
21637;"Vilniaus Levo Karsavimo vidurinė mokykla";"Priešmokyklinukai A";28093592809;Taip;0;1;1;2
21638;"Vilniaus Levo Karsavimo vidurinė mokykla";"Priešmokyklinukai A";70364015727;Taip;7;0;0;7
21639;"Vilniaus Levo Karsavimo vidurinė mokykla";"Priešmokyklinukai A";4273890878;Taip;0;1;0;1
21640;"Vilniaus Levo Karsavimo vidurinė mokykla";"Priešmokyklinukai A";77019635269;Taip;10;2;0;12
21641;"Vilniaus Levo Karsavimo vidurinė mokykla";"Priešmokyklinukai A";57354627123;Taip;0;1;0;1
21642;"Vilniaus Levo Karsavimo vidurinė mokykla";"Priešmokyklinukai A";15574258138;Taip;0;1;0;1
21643;"Vilniaus Levo Karsavimo vidurinė mokykla";"Priešmokyklinukai A";7147965267;Taip;0;20;0;20
21644;"Vilniaus Levo Karsavimo vidurinė mokykla";"Priešmokyklinukai A";58496565193;Taip;5;1;1;7
21645;"Vilniaus Levo Karsavimo vidurinė mokykla";"Priešmokyklinukai A";25498748126;Ne;7;0;0;7
21646;"Vilniaus Levo Karsavimo vidurinė mokykla";"Priešmokyklinukai A";77438050638;Taip;11;1;0;12
21647;"Vilniaus Levo Karsavimo vidurinė mokykla";"Priešmokyklinukai A";36430214688;Taip;0;3;0;3
21648;"Vilniaus Levo Karsavimo vidurinė mokykla";"Priešmokyklinukai A";94004273598;Taip;0;4;0;4
21649;"Vilniaus Levo Karsavimo vidurinė mokykla";"Priešmokyklinukai A";1371307111;Taip;8;0;1;9
21650;"Vilniaus Levo Karsavimo vidurinė mokykla";"Priešmokyklinukai b";90184376409;Taip;10;2;0;12
21651;"Vilniaus Levo Karsavimo vidurinė mokykla";"Priešmokyklinukai b";6151061931;Taip;2;1;3;6
21652;"Vilniaus Levo Karsavimo vidurinė mokykla";"Priešmokyklinukai b";1938391715;Taip;0;10;0;10
21653;"Vilniaus Levo Karsavimo vidurinė mokykla";"Priešmokyklinukai b";66160874700;Taip;0;1;0;1
21654;"Vilniaus Levo Karsavimo vidurinė mokykla";"Priešmokyklinukai b";38820365517;Taip;10;1;0;11
21655;"Vilniaus Levo Karsavimo vidurinė mokykla";"Priešmokyklinukai b";22149054613;Taip;0;3;0;3
21656;"Vilniaus Levo Karsavimo vidurinė mokykla";"Priešmokyklinukai b";2531327145;Taip;0;1;0;1
21657;"Vilniaus Levo Karsavimo vidurinė mokykla";"Priešmokyklinukai b";78913604764;Taip;0;3;0;3
21658;"Vilniaus Levo Karsavimo vidurinė mokykla";"Priešmokyklinukai b";89656947611;Taip;14;0;0;14
21659;"Vilniaus Levo Karsavimo vidurinė mokykla";"Priešmokyklinukai b";56625898576;Taip;0;1;1;2
21660;"Vilniaus Levo Karsavimo vidurinė mokykla";"Priešmokyklinukai b";66998252884;Taip;0;8;0;8
21661;"Vilniaus Levo Karsavimo vidurinė mokykla";"Priešmokyklinukai b";30728353672;Ne;0;1;1;2
21662;"Vilniaus Levo Karsavimo vidurinė mokykla";"Priešmokyklinukai b";31278810938;Taip;0;1;0;1
21663;"Vilniaus Levo Karsavimo vidurinė mokykla";"Priešmokyklinukai b";3893943727;Ne;7;0;3;10
21664;"Vilniaus Levo Karsavimo vidurinė mokykla";"Priešmokyklinukai b";51125720677;Taip;0;6;0;6
21665;"Vilniaus Liepkalnio Pagrindinė Mokykla";Bitutės;85942649944;Taip;0;4;4;8
21666;"Vilniaus Liepkalnio Pagrindinė Mokykla";Bitutės;15384883293;Taip;0;4;1;5
21667;"Vilniaus Liepkalnio Pagrindinė Mokykla";Bitutės;41301452936;Ne;0;4;1;5
21668;"Vilniaus Liepkalnio Pagrindinė Mokykla";Bitutės;68347661358;Taip;0;4;0;4
21669;"Vilniaus Liepkalnio Pagrindinė Mokykla";Bitutės;4437933849;Taip;0;4;1;5
21670;"Vilniaus Liepkalnio Pagrindinė Mokykla";Bitutės;4760866352;Taip;0;4;0;4
21671;"Vilniaus Liepkalnio Pagrindinė Mokykla";Bitutės;70408565216;Ne;0;4;3;7
21672;"Vilniaus Liepkalnio Pagrindinė Mokykla";Bitutės;11323385715;Taip;0;4;0;4
21673;"Vilniaus Liepkalnio Pagrindinė Mokykla";Bitutės;2118993423;Taip;5;4;2;11
21674;"Vilniaus Liepkalnio Pagrindinė Mokykla";Bitutės;53619465080;Taip;0;4;1;5
21675;"Vilniaus Liepkalnio Pagrindinė Mokykla";Bitutės;5991259497;Taip;0;4;3;7
21676;"Vilniaus Liepkalnio Pagrindinė Mokykla";Bitutės;52218753980;Taip;6;4;0;10
21677;"Vilniaus Liepkalnio Pagrindinė Mokykla";Bitutės;3007372384;Taip;0;21;0;21
21678;"Vilniaus Liepkalnio Pagrindinė Mokykla";Bitutės;4972232696;Taip;0;21;0;21
21679;"Vilniaus Liepkalnio Pagrindinė Mokykla";Bitutės;7760450278;Ne;0;4;6;10
21680;"Vilniaus Pranciškaus Skorinos gimnazija";Saulytė;8111363055;Taip;0;7;0;7
21681;"Vilniaus Pranciškaus Skorinos gimnazija";Saulytė;2930371388;Taip;2;5;0;7
21682;"Vilniaus Pranciškaus Skorinos gimnazija";Saulytė;70791039097;Ne;0;8;0;8
21683;"Vilniaus Pranciškaus Skorinos gimnazija";Saulytė;8632571006;Taip;4;7;1;12
21684;"Vilniaus Pranciškaus Skorinos gimnazija";Saulytė;66664410121;Taip;0;7;0;7
21685;"Vilniaus Pranciškaus Skorinos gimnazija";Saulytė;3790508177;Taip;8;6;0;14
21686;"Vilniaus Pranciškaus Skorinos gimnazija";Saulytė;27125411489;Taip;10;5;0;15
21687;"Vilniaus Pranciškaus Skorinos gimnazija";Saulytė;72738955088;Taip;0;10;0;10
21688;"Vilniaus Pranciškaus Skorinos gimnazija";Saulytė;67729297941;Ne;0;8;0;8
21689;"Vilniaus Pranciškaus Skorinos gimnazija";Saulytė;2386940016;Taip;12;5;0;17
21690;"Vilniaus Pranciškaus Skorinos gimnazija";Saulytė;1483885253;Taip;12;5;0;17
21691;"Vilniaus Pranciškaus Skorinos gimnazija";Saulytė;4909904794;Taip;10;5;0;15
21692;"Vilniaus Pranciškaus Skorinos gimnazija";Saulytė;4666237893;Taip;0;6;0;6
21693;"Vilniaus Pranciškaus Skorinos gimnazija";Saulytė;87925810917;Taip;3;6;0;9
21694;"Vilniaus Pranciškaus Skorinos gimnazija";Saulytė;9701472893;Taip;10;13;0;23
21695;"Vilniaus Pranciškaus Skorinos gimnazija";Saulytė;31343765777;Taip;8;5;0;13
21696;"Vilniaus Pranciškaus Skorinos gimnazija";Saulytė;55421475688;Taip;7;5;0;12
21697;"Vilniaus Pranciškaus Skorinos gimnazija";Saulytė;55086628871;Taip;5;5;0;10
21698;"Vilniaus Simono Konarskio vidurinės mokykla";"1 gr.";9759567795;Taip;5;4;0;9
21699;"Vilniaus Simono Konarskio vidurinės mokykla";"1 gr.";40561567890;Taip;6;4;0;10
21700;"Vilniaus Simono Konarskio vidurinės mokykla";"1 gr.";5884520114;Ne;0;4;0;4
21701;"Vilniaus Simono Konarskio vidurinės mokykla";"1 gr.";3165852410;Ne;10;4;0;14
21702;"Vilniaus Simono Konarskio vidurinės mokykla";"1 gr.";9585599736;Taip;12;4;0;16
21703;"Vilniaus Simono Konarskio vidurinės mokykla";"1 gr.";38075556139;Taip;0;4;0;4
21704;"Vilniaus Simono Konarskio vidurinės mokykla";"1 gr.";90764462777;Taip;0;4;0;4
21705;"Vilniaus Simono Konarskio vidurinės mokykla";"1 gr.";15628069778;Taip;5;4;0;9
21706;"Vilniaus Simono Konarskio vidurinės mokykla";"1 gr.";59785459193;Taip;0;4;0;4
21707;"Vilniaus Simono Konarskio vidurinės mokykla";"1 gr.";8708972546;Taip;12;4;0;16
21708;"Vilniaus Simono Konarskio vidurinės mokykla";"1 gr.";78809378214;Taip;0;4;0;4
21709;"Vilniaus Simono Konarskio vidurinės mokykla";"1 gr.";5553972538;Taip;0;4;0;4
21710;"Vilniaus Simono Konarskio vidurinės mokykla";"1 gr.";37201396276;Taip;0;4;0;4
21711;"Vilniaus Simono Konarskio vidurinės mokykla";"1 gr.";77024512167;Taip;0;4;0;4
21712;"Vilniaus Simono Konarskio vidurinės mokykla";"1 gr.";8786280855;Taip;7;4;0;11
21713;"Vilniaus Simono Konarskio vidurinės mokykla";"1 gr.";7881088760;Taip;0;4;0;4
21714;"Vilniaus Trakų Vokės gimnazija";Priešmokyklinė;86951309976;Taip;0;0;1;1
21715;"Vilniaus Trakų Vokės gimnazija";Priešmokyklinė;58787126706;Taip;0;1;0;1
21716;"Vilniaus Trakų Vokės gimnazija";Priešmokyklinė;68332465021;Taip;0;0;2;2
21717;"Vilniaus Trakų Vokės gimnazija";Priešmokyklinė;89375639444;Taip;0;0;5;5
21718;"Vilniaus Trakų Vokės gimnazija";Priešmokyklinė;1680721429;Taip;0;0;2;2
21719;"Vilniaus Trakų Vokės gimnazija";Priešmokyklinė;49306819367;Taip;5;0;1;6
21720;"Vilniaus Trakų Vokės gimnazija";Priešmokyklinė;86317439855;Taip;2;0;2;4
21721;"Vilniaus Trakų Vokės gimnazija";Priešmokyklinė;5104422489;Taip;5;0;3;8
21722;"Vilniaus Trakų Vokės gimnazija";Priešmokyklinė;80454463606;Taip;0;0;5;5
21723;"Vilniaus Trakų Vokės gimnazija";Priešmokyklinė;63420742280;Taip;0;5;0;5
21724;"Vilniaus Trakų Vokės gimnazija";Priešmokyklinė;3795096854;Taip;0;0;4;4
21725;"Vilniaus Trakų Vokės gimnazija";Priešmokyklinė;55269223931;Taip;0;0;5;5
21726;"Vilniaus Trakų Vokės gimnazija";Priešmokyklinė;30728775392;Taip;4;0;2;6
21727;"Vilniaus Trakų Vokės gimnazija";Priešmokyklinė;93253698828;Taip;0;0;2;2
21728;"Vilniaus Trakų Vokės gimnazija";Priešmokyklinė;13225336236;Ne;3;0;1;4
21729;"Vilniaus Trakų Vokės gimnazija";Priešmokyklinė;28771899278;Taip;14;0;0;14
21730;"Vilniaus Trakų Vokės gimnazija";Priešmokyklinė;98169988178;Taip;7;2;0;9
21731;"Vilniaus Trakų Vokės gimnazija";Priešmokyklinė;6066619225;Taip;0;0;1;1
21732;"Vilniaus Trakų Vokės gimnazija";Priešmokyklinė;45478578368;Taip;0;0;1;1
21733;"Vilniaus Trakų Vokės gimnazija";Priešmokyklinė;1591065244;Ne;20;0;0;20
21734;"Vilniaus Trakų Vokės gimnazija";Priešmokyklinė;50146560386;Taip;14;0;0;14
21735;"Vilniaus Trakų Vokės gimnazija";Priešmokyklinė;1442702945;Ne;7;6;2;15
21736;"Vilniaus Trakų Vokės gimnazija";Priešmokyklinė;53040741124;Taip;3;0;4;7
21737;"Vilniaus Trakų Vokės gimnazija";Priešmokyklinė;2981889811;Taip;0;7;0;7
21738;"Vilniaus Trakų Vokės gimnazija";Priešmokyklinė;3385439676;Ne;0;5;3;8
21739;"Vilniaus Trakų Vokės gimnazija";Priešmokyklinė;1007914987;Taip;9;0;6;15
21740;"Vilniaus Ryto progimnazija";Pelėdžiukai;77616936203;Taip;0;12;0;12
21741;"Vilniaus Ryto progimnazija";Pelėdžiukai;46769165231;Taip;11;1;0;12
21742;"Vilniaus Ryto progimnazija";Pelėdžiukai;28398691896;Taip;6;0;0;6
21743;"Vilniaus Ryto progimnazija";Pelėdžiukai;2996573491;Taip;0;1;4;5
21744;"Vilniaus Ryto progimnazija";Pelėdžiukai;93318150080;Taip;5;5;0;10
21745;"Vilniaus Ryto progimnazija";Pelėdžiukai;74152625458;Taip;5;5;0;10
21746;"Vilniaus Ryto progimnazija";Pelėdžiukai;70966482681;Taip;8;4;0;12
21747;"Vilniaus Ryto progimnazija";Pelėdžiukai;25811599893;Taip;0;2;0;2
21748;"Vilniaus Ryto progimnazija";Pelėdžiukai;1111912449;Taip;6;6;6;18
21749;"Vilniaus Ryto progimnazija";Pelėdžiukai;35385279640;Taip;5;2;0;7
21750;"Vilniaus Ryto progimnazija";Pelėdžiukai;21161267468;Taip;5;1;0;6
21751;"Vilniaus Ryto progimnazija";Pelėdžiukai;52832815165;Taip;0;0;2;2
21752;"Vilniaus Ryto progimnazija";Pelėdžiukai;45286443222;Taip;10;1;0;11
21753;"Vilniaus Ryto progimnazija";Pelėdžiukai;77347859694;Taip;14;0;0;14
21754;"Vilniaus Ryto progimnazija";Pelėdžiukai;3654128216;Taip;10;4;0;14
21755;"Vilniaus Ryto progimnazija";Pelėdžiukai;69867478315;Taip;8;4;0;12
21756;"Vilniaus Ryto progimnazija";Pelėdžiukai;22781042300;Taip;0;5;0;5
21757;"Vilniaus Ryto progimnazija";Geniukai;5924137896;Taip;0;2;9;11
21758;"Vilniaus Ryto progimnazija";Geniukai;31810296440;Taip;3;4;0;7
21759;"Vilniaus Ryto progimnazija";Geniukai;94678313037;Taip;6;4;7;17
21760;"Vilniaus Ryto progimnazija";Geniukai;6335949785;Taip;5;4;2;11
21761;"Vilniaus Ryto progimnazija";Geniukai;5424411985;Taip;10;4;1;15
21762;"Vilniaus Ryto progimnazija";Geniukai;1600034296;Taip;0;4;4;8
21763;"Vilniaus Ryto progimnazija";Geniukai;7732952505;Taip;0;4;3;7
21764;"Vilniaus Ryto progimnazija";Geniukai;8318898575;Ne;0;4;2;6
21765;"Vilniaus Ryto progimnazija";Geniukai;1865302246;Taip;0;4;3;7
21766;"Vilniaus Ryto progimnazija";Geniukai;4177104288;Taip;2;4;4;10
21767;"Vilniaus Ryto progimnazija";Geniukai;46953361076;Taip;0;4;2;6
21768;"Vilniaus Salininkų gimnazija";"Priešmokyklinė A";1394788152;Taip;6;9;0;15
21769;"Vilniaus Salininkų gimnazija";"Priešmokyklinė A";70212262471;Taip;0;2;0;2
21770;"Vilniaus Salininkų gimnazija";"Priešmokyklinė A";77895776678;Taip;0;1;1;2
21771;"Vilniaus Salininkų gimnazija";"Priešmokyklinė A";92807961547;Taip;4;1;0;5
21772;"Vilniaus Salininkų gimnazija";"Priešmokyklinė A";1263382031;Taip;0;4;0;4
21773;"Vilniaus Salininkų gimnazija";"Priešmokyklinė A";50041849206;Taip;0;5;0;5
21774;"Vilniaus Salininkų gimnazija";"Priešmokyklinė A";9898078093;Taip;6;5;0;11
21775;"Vilniaus Salininkų gimnazija";"Priešmokyklinė A";1540549473;Taip;0;4;0;4
21776;"Vilniaus Salininkų gimnazija";"Priešmokyklinė A";72769378676;Taip;0;10;0;10
21777;"Vilniaus Salininkų gimnazija";"Priešmokyklinė A";12284569395;Taip;0;1;0;1
21778;"Vilniaus Salininkų gimnazija";"Priešmokyklinė A";67687224119;Taip;0;2;1;3
21779;"Vilniaus Salininkų gimnazija";"Priešmokyklinė A";49134796971;Ne;0;5;0;5
21780;"Vilniaus Salininkų gimnazija";"Priešmokyklinė A";18097700548;Taip;0;5;1;6
21781;"Vilniaus Salininkų gimnazija";"Priešmokyklinė A";85552015560;Taip;0;7;0;7
21782;"Vilniaus Salininkų gimnazija";"Priešmokyklinė A";18610156473;Taip;0;6;0;6
21783;"Vilniaus Salininkų gimnazija";"Priešmokyklinė A";43805658510;Taip;0;5;0;5
21784;"Vilniaus Salininkų gimnazija";"Priešmokyklinė A";20709806421;Taip;0;5;1;6
21785;"Vilniaus Salininkų gimnazija";"Priešmokyklinė A";1011097163;Taip;0;0;1;1
21786;"Vilniaus Salininkų gimnazija";"Priešmokyklinė A";43256013546;Taip;0;5;0;5
21787;"Vilniaus Salininkų gimnazija";"Priešmokyklinė A";7344435191;Taip;0;5;2;7
21788;"Vilniaus Salininkų gimnazija";"Priešmokyklinė A";34881195086;Taip;11;5;1;17
21789;"Vilniaus Spindulio pagrindinė mokykla";PM3;22030335700;Taip;0;1;3;4
21790;"Vilniaus Spindulio pagrindinė mokykla";PM3;8795608401;Taip;10;3;2;15
21791;"Vilniaus Spindulio pagrindinė mokykla";PM3;6726572241;Taip;0;1;0;1
21792;"Vilniaus Spindulio pagrindinė mokykla";PM3;2103735244;Ne;0;4;4;8
21793;"Vilniaus Spindulio pagrindinė mokykla";PM3;50072501914;Taip;0;0;1;1
21794;"Vilniaus Spindulio pagrindinė mokykla";PM3;41136453710;Taip;0;20;0;20
21795;"Vilniaus Spindulio pagrindinė mokykla";PM3;17630756294;Taip;0;9;1;10
21796;"Vilniaus Spindulio pagrindinė mokykla";PM3;54486099400;Ne;0;7;0;7
21797;"Vilniaus Spindulio pagrindinė mokykla";PM3;7514187959;Taip;0;4;2;6
21798;"Vilniaus Spindulio pagrindinė mokykla";PM3;5781921709;Taip;0;20;0;20
21799;"Vilniaus Spindulio pagrindinė mokykla";PM3;8810423103;Ne;0;4;2;6
21800;"Vilniaus Spindulio pagrindinė mokykla";PM3;99658181383;Taip;0;20;0;20
21801;"Vilniaus Spindulio pagrindinė mokykla";PM3;1284623590;Taip;10;4;0;14
21802;"Vilniaus Spindulio pagrindinė mokykla";PM3;17822017066;Taip;5;1;1;7
21803;"Vilniaus Spindulio pagrindinė mokykla";PM3;33144992509;Taip;0;0;2;2
21804;"Vilniaus Spindulio pagrindinė mokykla";PM3;2917212490;Taip;10;4;2;16
21805;"Vilniaus Spindulio pagrindinė mokykla";PM3;88363839374;Taip;0;20;0;20
21806;"Vilniaus Spindulio pagrindinė mokykla";PM3;1894317616;Taip;10;4;1;15
21807;"Vilniaus Spindulio pagrindinė mokykla";PM3;8898033177;Taip;0;3;1;4
21808;"Vilniaus Spindulio pagrindinė mokykla";PM3;14135715855;Taip;0;1;0;1
21809;"Vilniaus Spindulio pagrindinė mokykla";PM2;27440263748;Taip;0;6;0;6
21810;"Vilniaus Spindulio pagrindinė mokykla";PM2;51690968594;Taip;6;1;2;9
21811;"Vilniaus Spindulio pagrindinė mokykla";PM2;43845081378;Taip;3;1;0;4
21812;"Vilniaus Spindulio pagrindinė mokykla";PM2;27893322293;Taip;0;1;1;2
21813;"Vilniaus Spindulio pagrindinė mokykla";PM2;48405198914;Taip;9;4;4;17
21814;"Vilniaus Spindulio pagrindinė mokykla";PM2;18833749556;Ne;1;4;0;5
21815;"Vilniaus Spindulio pagrindinė mokykla";PM2;1848422504;Taip;0;5;3;8
21816;"Vilniaus Spindulio pagrindinė mokykla";PM2;79405143301;Taip;0;1;2;3
21817;"Vilniaus Spindulio pagrindinė mokykla";PM2;52558402241;Ne;5;2;0;7
21818;"Vilniaus Spindulio pagrindinė mokykla";PM2;19400591566;Taip;8;0;0;8
21819;"Vilniaus Spindulio pagrindinė mokykla";PM2;1681147196;Taip;0;2;0;2
21820;"Vilniaus Spindulio pagrindinė mokykla";PM2;3743948734;Taip;0;5;3;8
21821;"Vilniaus Spindulio pagrindinė mokykla";PM2;522862985;Taip;7;0;0;7
21822;"Vilniaus Spindulio pagrindinė mokykla";PM2;1973616698;Taip;5;0;0;5
21823;"Vilniaus Spindulio pagrindinė mokykla";PM2;98043756261;Taip;0;4;0;4
21824;"Vilniaus Spindulio pagrindinė mokykla";PM2;22505400502;Taip;0;2;7;9
21825;"Vilniaus Spindulio pagrindinė mokykla";PM2;73482318690;Taip;5;4;0;9
21826;"Vilniaus Spindulio pagrindinė mokykla";PM2;87635746750;Taip;5;3;0;8
21827;"Vilniaus Spindulio pagrindinė mokykla";PM2;67686277420;Taip;5;4;1;10
21828;"Vilniaus Spindulio pagrindinė mokykla";PM1;98100269824;Taip;5;0;0;5
21829;"Vilniaus Spindulio pagrindinė mokykla";PM1;1598726987;Taip;0;2;0;2
21830;"Vilniaus Spindulio pagrindinė mokykla";PM1;58307494214;Taip;0;2;0;2
21831;"Vilniaus Spindulio pagrindinė mokykla";PM1;41169357305;Taip;5;4;0;9
21832;"Vilniaus Spindulio pagrindinė mokykla";PM1;58599577293;Taip;0;6;0;6
21833;"Vilniaus Spindulio pagrindinė mokykla";PM1;11041001881;Taip;6;4;0;10
21834;"Vilniaus Spindulio pagrindinė mokykla";PM1;50503204807;Ne;0;2;0;2
21835;"Vilniaus Spindulio pagrindinė mokykla";PM1;87462575095;Ne;0;8;0;8
21836;"Vilniaus Spindulio pagrindinė mokykla";PM1;84379794486;Taip;0;6;0;6
21837;"Vilniaus Spindulio pagrindinė mokykla";PM1;56969518152;Taip;6;1;0;7
21838;"Vilniaus Spindulio pagrindinė mokykla";PM1;58418836409;Taip;0;1;0;1
21839;"Vilniaus Spindulio pagrindinė mokykla";PM1;5245636522;Ne;2;1;0;3
21840;"Vilniaus Spindulio pagrindinė mokykla";PM1;96702943483;Taip;0;11;0;11
21841;"Vilniaus Spindulio pagrindinė mokykla";PM1;1365783673;Taip;0;5;0;5
21842;"Vilniaus Spindulio pagrindinė mokykla";PM1;4290344470;Taip;3;4;0;7
21843;"Vilniaus Spindulio pagrindinė mokykla";PM1;88078071669;Taip;0;4;0;4
21844;"Vilniaus Spindulio pagrindinė mokykla";PM1;48909433610;Taip;6;1;0;7
21845;"Vilniaus Spindulio pagrindinė mokykla";PM1;35360386686;Taip;4;3;0;7
21846;"Vilniaus Spindulio pagrindinė mokykla";PM1;22999687853;Taip;5;0;0;5
21847;"Vilniaus Spindulio pagrindinė mokykla";PM1;66762368813;Taip;0;4;0;4
21848;"Vilniaus Spindulio pagrindinė mokykla";PM1;64966809812;Taip;0;3;0;3
21849;"Vilniaus Vladislavo Sirokomlės vidurinė mokykla";Nykštukai;5907733019;Taip;0;4;2;6
21850;"Vilniaus Vladislavo Sirokomlės vidurinė mokykla";Nykštukai;55996765657;Taip;3;4;0;7
21851;"Vilniaus Vladislavo Sirokomlės vidurinė mokykla";Nykštukai;29678276716;Taip;0;4;0;4
21852;"Vilniaus Vladislavo Sirokomlės vidurinė mokykla";Nykštukai;33995576904;Taip;0;4;0;4
21853;"Vilniaus Vladislavo Sirokomlės vidurinė mokykla";Nykštukai;1147411049;Taip;0;4;2;6
21854;"Vilniaus Vladislavo Sirokomlės vidurinė mokykla";Nykštukai;24628844486;Taip;0;24;0;24
21855;"Vilniaus Vladislavo Sirokomlės vidurinė mokykla";Nykštukai;67322017045;Taip;0;4;0;4
21856;"Vilniaus Vladislavo Sirokomlės vidurinė mokykla";Nykštukai;1288513624;Taip;0;4;0;4
21857;"Vilniaus Vladislavo Sirokomlės vidurinė mokykla";Nykštukai;75293895773;Taip;0;4;1;5
21858;"Vilniaus Vladislavo Sirokomlės vidurinė mokykla";Nykštukai;19225308100;Taip;0;24;0;24
21859;"Vilniaus Vladislavo Sirokomlės vidurinė mokykla";Nykštukai;54815489159;Taip;0;7;0;7
21860;"Vilniaus Vladislavo Sirokomlės vidurinė mokykla";Nykštukai;78888983611;Taip;0;4;1;5
21861;"Vilniaus Vladislavo Sirokomlės vidurinė mokykla";Nykštukai;95872052773;Taip;0;4;3;7
21862;"Vilniaus Vladislavo Sirokomlės vidurinė mokykla";Nykštukai;9991093616;Taip;10;4;2;16
21863;"Vilniaus Vladislavo Sirokomlės vidurinė mokykla";Nykštukai;86336781386;Taip;0;24;0;24
21864;"Vilniaus Vladislavo Sirokomlės vidurinė mokykla";Smurfai;2896777542;Taip;0;24;0;24
21865;"Vilniaus Vladislavo Sirokomlės vidurinė mokykla";Smurfai;1649779105;Taip;0;4;0;4
21866;"Vilniaus Vladislavo Sirokomlės vidurinė mokykla";Smurfai;23540725045;Taip;0;4;0;4
21867;"Vilniaus Vladislavo Sirokomlės vidurinė mokykla";Smurfai;94242891208;Taip;0;24;0;24
21868;"Vilniaus Vladislavo Sirokomlės vidurinė mokykla";Smurfai;42097592326;Ne;12;8;0;20
21869;"Vilniaus Vladislavo Sirokomlės vidurinė mokykla";Smurfai;5042045981;Taip;5;4;0;9
21870;"Vilniaus Vladislavo Sirokomlės vidurinė mokykla";Smurfai;9509140514;Taip;5;5;0;10
21871;"Vilniaus Vladislavo Sirokomlės vidurinė mokykla";Smurfai;86662025175;Taip;0;4;0;4
21872;"Vilniaus Vladislavo Sirokomlės vidurinė mokykla";Smurfai;4227711744;Taip;0;24;0;24
21873;"Vilniaus Vladislavo Sirokomlės vidurinė mokykla";Smurfai;1464969756;Taip;10;4;4;18
21874;"Vilniaus Vladislavo Sirokomlės vidurinė mokykla";Smurfai;1087544768;Taip;0;24;0;24
21875;"Vilniaus Vladislavo Sirokomlės vidurinė mokykla";Smurfai;2272950944;Taip;5;5;0;10
21876;"Vilniaus Vladislavo Sirokomlės vidurinė mokykla";Smurfai;1804439867;Ne;0;4;0;4
21877;"Vilniaus Vladislavo Sirokomlės vidurinė mokykla";Smurfai;4742282433;Taip;5;4;5;14
21878;"Vilniaus „Pelėdos” pradinė mokykla";Bitutės;2071487643;Taip;4;8;0;12
21879;"Vilniaus „Pelėdos” pradinė mokykla";Bitutės;69163458316;Taip;5;1;0;6
21880;"Vilniaus „Pelėdos” pradinė mokykla";Bitutės;6832201394;Taip;0;8;0;8
21881;"Vilniaus „Pelėdos” pradinė mokykla";Bitutės;65445450194;Taip;5;1;2;8
21882;"Vilniaus „Pelėdos” pradinė mokykla";Bitutės;6652853494;Ne;0;1;9;10
21883;"Vilniaus „Pelėdos” pradinė mokykla";Bitutės;22352755573;Taip;0;1;1;2
21884;"Vilniaus „Pelėdos” pradinė mokykla";Bitutės;41693125052;Taip;0;9;0;9
21885;"Vilniaus „Pelėdos” pradinė mokykla";Bitutės;4748207005;Taip;5;6;0;11
21886;"Vilniaus „Pelėdos” pradinė mokykla";Bitutės;95143505795;Taip;5;3;0;8
21887;"Vilniaus „Pelėdos” pradinė mokykla";Bitutės;35501298377;Taip;0;5;0;5
21888;"Vilniaus „Pelėdos” pradinė mokykla";Bitutės;96374638070;Taip;10;0;0;10
21889;"Vilniaus „Pelėdos” pradinė mokykla";Bitutės;33465555087;Taip;0;1;0;1
21890;"Vilniaus „Pelėdos” pradinė mokykla";Bitutės;75354210275;Taip;0;8;0;8
21891;"Vilniaus „Pelėdos” pradinė mokykla";Bitutės;42360927832;Taip;4;7;0;11
21892;"Vilniaus „Pelėdos” pradinė mokykla";Bitutės;6900693954;Taip;5;1;0;6
21893;"Vilniaus „Pelėdos” pradinė mokykla";Bitutės;42778766894;Taip;10;0;0;10
21894;"Vilniaus „Pelėdos” pradinė mokykla";Bitutės;1269674740;Taip;0;5;3;8
21895;"Vilniaus „Pelėdos” pradinė mokykla";Bitutės;54002272670;Taip;10;1;0;11
21896;"Vilniaus „Pelėdos” pradinė mokykla";Bitutės;45993070238;Taip;0;1;0;1
21897;"Vilniaus „Pelėdos” pradinė mokykla";Bitutės;9108397707;Taip;0;2;2;4
21898;"Vilniaus „Pelėdos” pradinė mokykla";Bitutės;59056959064;Taip;0;3;0;3
21899;"Vilniaus „Pelėdos” pradinė mokykla";Bitutės;96481283521;Taip;9;0;0;9
21900;"Vilniaus „Pelėdos” pradinė mokykla";Boružėlės;30916402061;Taip;0;0;20;20
21901;"Vilniaus „Pelėdos” pradinė mokykla";Boružėlės;33487848367;Taip;10;0;0;10
21902;"Vilniaus „Pelėdos” pradinė mokykla";Boružėlės;4489830831;Ne;0;0;12;12
21903;"Vilniaus „Pelėdos” pradinė mokykla";Boružėlės;53188954130;Taip;6;0;0;6
21904;"Vilniaus „Pelėdos” pradinė mokykla";Boružėlės;22444416208;Taip;2;0;2;4
21905;"Vilniaus „Pelėdos” pradinė mokykla";Boružėlės;12734259561;Taip;0;1;0;1
21906;"Vilniaus „Pelėdos” pradinė mokykla";Boružėlės;79520961509;Taip;0;1;1;2
21907;"Vilniaus „Pelėdos” pradinė mokykla";Boružėlės;7162837286;Taip;5;0;9;14
21908;"Vilniaus „Pelėdos” pradinė mokykla";Boružėlės;46876861220;Taip;0;6;0;6
21909;"Vilniaus „Pelėdos” pradinė mokykla";Boružėlės;1602745529;Taip;0;1;0;1
21910;"Vilniaus „Pelėdos” pradinė mokykla";Boružėlės;71191048199;Taip;0;4;0;4
21911;"Vilniaus „Pelėdos” pradinė mokykla";Boružėlės;48135022147;Taip;9;0;1;10
21912;"Vilniaus „Pelėdos” pradinė mokykla";Boružėlės;78123951465;Taip;0;0;1;1
21913;"Vilniaus „Pelėdos” pradinė mokykla";Boružėlės;63082461930;Ne;0;0;1;1
21914;"Vilniaus „Pelėdos” pradinė mokykla";Boružėlės;21037883651;Taip;6;1;3;10
21915;"Vilniaus „Pelėdos” pradinė mokykla";Boružėlės;4532680677;Taip;9;0;0;9
21916;"Vilniaus „Pelėdos” pradinė mokykla";Boružėlės;4103101479;Taip;3;6;0;9
21917;"Vilniaus „Pelėdos” pradinė mokykla";Boružėlės;89825498541;Taip;0;11;0;11
21918;"Vilniaus „Pelėdos” pradinė mokykla";Boružėlės;91937671865;Taip;20;0;0;20
21919;"Vilniaus „Pelėdos” pradinė mokykla";Boružėlės;10329586004;Taip;5;0;0;5
21920;"Vilniaus „Pelėdos” pradinė mokykla";Boružėlės;14503455095;Taip;0;0;1;1
21921;"Vilniaus Joachimo Lelevelio vidurinė mokykla";0A;48625188486;Taip;0;4;0;4
21922;"Vilniaus Joachimo Lelevelio vidurinė mokykla";0A;30530145422;Taip;10;4;2;16
21923;"Vilniaus Joachimo Lelevelio vidurinė mokykla";0A;77637136134;Taip;10;4;0;14
21924;"Vilniaus Joachimo Lelevelio vidurinė mokykla";0A;22182253769;Taip;10;4;0;14
21925;"Vilniaus Joachimo Lelevelio vidurinė mokykla";0A;22490145919;Taip;5;5;0;10
21926;"Vilniaus Joachimo Lelevelio vidurinė mokykla";0A;79489468964;Ne;12;5;0;17
21927;"Vilniaus Joachimo Lelevelio vidurinė mokykla";0A;1139560173;Taip;10;4;2;16
21928;"Vilniaus Joachimo Lelevelio vidurinė mokykla";0A;29594212376;Taip;0;4;1;5
21929;"Vilniaus Joachimo Lelevelio vidurinė mokykla";0A;37558958175;Taip;12;4;0;16
21930;"Vilniaus Joachimo Lelevelio vidurinė mokykla";0A;37117140680;Taip;0;5;0;5
21931;"Vilniaus Joachimo Lelevelio vidurinė mokykla";0A;1387685923;Ne;5;4;2;11
21932;"Vilniaus Joachimo Lelevelio vidurinė mokykla";0A;2854451964;Taip;10;6;0;16
21933;"Vilniaus Joachimo Lelevelio vidurinė mokykla";0A;2628030884;Ne;0;4;0;4
21934;"Vilniaus Joachimo Lelevelio vidurinė mokykla";0A;6690564929;Taip;5;4;0;9
21935;"Vilniaus Joachimo Lelevelio vidurinė mokykla";0A;87447355522;Taip;0;6;0;6
21936;"Vilniaus Joachimo Lelevelio vidurinė mokykla";0A;9406527428;Ne;7;4;3;14
21937;"Vilniaus Joachimo Lelevelio vidurinė mokykla";0A;82446674090;Taip;5;4;0;9
21938;"Vilniaus Joachimo Lelevelio vidurinė mokykla";0A;6764953389;Taip;5;4;1;10
21939;"Vilniaus Joachimo Lelevelio vidurinė mokykla";0A;6406533101;Taip;10;4;0;14
21940;"Vilniaus Joachimo Lelevelio vidurinė mokykla";0B;38745665842;Taip;8;4;0;12
21941;"Vilniaus Joachimo Lelevelio vidurinė mokykla";0B;8972073812;Taip;4;4;0;8
21942;"Vilniaus Joachimo Lelevelio vidurinė mokykla";0B;83279104490;Taip;7;4;0;11
21943;"Vilniaus Joachimo Lelevelio vidurinė mokykla";0B;23254881487;Taip;0;4;0;4
21944;"Vilniaus Joachimo Lelevelio vidurinė mokykla";0B;67336376881;Taip;10;5;0;15
21945;"Vilniaus Joachimo Lelevelio vidurinė mokykla";0B;9032277414;Taip;10;4;2;16
21946;"Vilniaus Joachimo Lelevelio vidurinė mokykla";0B;1228880375;Taip;5;4;0;9
21947;"Vilniaus Joachimo Lelevelio vidurinė mokykla";0B;3392530766;Taip;3;7;0;10
21948;"Vilniaus Joachimo Lelevelio vidurinė mokykla";0B;52675265822;Taip;0;4;4;8
21949;"Vilniaus Joachimo Lelevelio vidurinė mokykla";0B;80290130560;Taip;0;8;0;8
21950;"Vilniaus Joachimo Lelevelio vidurinė mokykla";0B;37365823648;Ne;0;11;1;12
21951;"Vilniaus Joachimo Lelevelio vidurinė mokykla";0B;20323559123;Taip;10;4;1;15
21952;"Vilniaus Joachimo Lelevelio vidurinė mokykla";0B;1992741773;Taip;0;4;0;4
21953;"Vilniaus Joachimo Lelevelio vidurinė mokykla";0B;94980538706;Taip;0;10;5;15
21954;"Vilniaus Joachimo Lelevelio vidurinė mokykla";0B;9917295097;Taip;3;14;0;17
21955;"Vilniaus Joachimo Lelevelio vidurinė mokykla";0B;3385391317;Taip;0;22;0;22
21956;"Vilniaus Joachimo Lelevelio vidurinė mokykla";0B;6777530638;Taip;0;4;6;10
21957;"Vilniaus Joachimo Lelevelio vidurinė mokykla";0B;3507030971;Taip;0;4;6;10
21958;"Vilniaus Joachimo Lelevelio vidurinė mokykla";0B;8900287515;Taip;0;4;3;7
21959;"Vilniaus Joachimo Lelevelio vidurinė mokykla";0B;78820258664;Taip;6;10;0;16
21960;"Vilniaus Joachimo Lelevelio vidurinė mokykla";0B;32468645385;Taip;0;22;0;22
21961;"Vilniaus Joachimo Lelevelio vidurinė mokykla";0B;46936589086;Taip;3;4;1;8
21962;"Vilniaus Joachimo Lelevelio vidurinė mokykla";0C;7785594191;Taip;0;8;0;8
21963;"Vilniaus Joachimo Lelevelio vidurinė mokykla";0C;543596002;Taip;3;4;0;7
21964;"Vilniaus Joachimo Lelevelio vidurinė mokykla";0C;64132212674;Taip;3;4;0;7
21965;"Vilniaus Joachimo Lelevelio vidurinė mokykla";0C;63270263063;Taip;0;8;0;8
21966;"Vilniaus Joachimo Lelevelio vidurinė mokykla";0C;77834846979;Taip;0;20;0;20
21967;"Vilniaus Joachimo Lelevelio vidurinė mokykla";0C;86242023109;Taip;3;4;0;7
21968;"Vilniaus Joachimo Lelevelio vidurinė mokykla";0C;10836076854;Taip;5;4;0;9
21969;"Vilniaus Joachimo Lelevelio vidurinė mokykla";0C;4064562873;Taip;0;4;3;7
21970;"Vilniaus Joachimo Lelevelio vidurinė mokykla";0C;7474239709;Taip;0;22;0;22
21971;"Vilniaus Juzefo Ignacijaus Kraševskio gimnazija";Priešmokyklinė;3992602769;Ne;0;1;4;5
21972;"Vilniaus Juzefo Ignacijaus Kraševskio gimnazija";Priešmokyklinė;1636593104;Taip;0;1;4;5
21973;"Vilniaus Juzefo Ignacijaus Kraševskio gimnazija";Priešmokyklinė;96528175390;Taip;0;1;5;6
21974;"Vilniaus Juzefo Ignacijaus Kraševskio gimnazija";Priešmokyklinė;2386972224;Taip;0;4;0;4
21975;"Vilniaus Juzefo Ignacijaus Kraševskio gimnazija";Priešmokyklinė;87397764928;Taip;0;1;0;1
21976;"Vilniaus Juzefo Ignacijaus Kraševskio gimnazija";Priešmokyklinė;7947779677;Taip;10;1;4;15
21977;"Vilniaus Juzefo Ignacijaus Kraševskio gimnazija";Priešmokyklinė;7348967815;Taip;0;1;7;8
21978;"Vilniaus Juzefo Ignacijaus Kraševskio gimnazija";Priešmokyklinė;91109920216;Taip;0;1;5;6
21979;"Vilniaus Juzefo Ignacijaus Kraševskio gimnazija";Priešmokyklinė;18683776970;Taip;0;1;0;1
21980;"Vilniaus Juzefo Ignacijaus Kraševskio gimnazija";Priešmokyklinė;45246620717;Taip;0;6;0;6
21981;"Vilniaus Juzefo Ignacijaus Kraševskio gimnazija";Priešmokyklinė;3286294868;Ne;0;1;12;13
21982;"Vilniaus Juzefo Ignacijaus Kraševskio gimnazija";Priešmokyklinė;3025885967;Ne;10;4;5;19
21983;"Vilniaus Juzefo Ignacijaus Kraševskio gimnazija";Priešmokyklinė;13035175969;Taip;0;10;0;10
21984;"Vilniaus Juzefo Ignacijaus Kraševskio gimnazija";Priešmokyklinė;1744052084;Ne;0;4;7;11
21985;"Vilniaus Juzefo Ignacijaus Kraševskio gimnazija";Priešmokyklinė;3454973035;Taip;0;7;0;7
21986;"Vilniaus Juzefo Ignacijaus Kraševskio gimnazija";Priešmokyklinė;9640287886;Ne;0;1;13;14
21987;"Vilniaus Juzefo Ignacijaus Kraševskio gimnazija";Priešmokyklinė;17989172493;Ne;0;8;0;8
21988;"Vilniaus Juzefo Ignacijaus Kraševskio gimnazija";Priešmokyklinė;7866325130;Taip;7;4;0;11
21989;"Vilniaus Jono Pauliaus II progimnazija";Bitutės;2221329657;Taip;1;4;2;7
21990;"Vilniaus Jono Pauliaus II progimnazija";Bitutės;1787688071;Taip;0;4;2;6
21991;"Vilniaus Jono Pauliaus II progimnazija";Bitutės;74095271790;Taip;0;4;2;6
21992;"Vilniaus Jono Pauliaus II progimnazija";Bitutės;75018613955;Taip;0;4;4;8
21993;"Vilniaus Jono Pauliaus II progimnazija";Bitutės;41958962804;Taip;5;5;0;10
21994;"Vilniaus Jono Pauliaus II progimnazija";Bitutės;5290505392;Taip;0;4;2;6
21995;"Vilniaus Jono Pauliaus II progimnazija";Bitutės;62687105812;Taip;0;10;0;10
21996;"Vilniaus Jono Pauliaus II progimnazija";Bitutės;50802361323;Ne;0;5;0;5
21997;"Vilniaus Jono Pauliaus II progimnazija";Bitutės;1051397178;Taip;15;4;0;19
21998;"Vilniaus Jono Pauliaus II progimnazija";Bitutės;18366436287;Taip;0;7;0;7
21999;"Vilniaus Jono Pauliaus II progimnazija";Bitutės;98525894524;Taip;0;11;0;11
22000;"Vilniaus Jono Pauliaus II progimnazija";Bitutės;66886951759;Taip;7;5;0;12
22001;"Vilniaus Jono Pauliaus II progimnazija";Bitutės;1678282458;Taip;0;4;0;4
22002;"Vilniaus Jono Pauliaus II progimnazija";Bitutės;23410902042;Taip;0;5;0;5
22003;"Vilniaus Jono Pauliaus II progimnazija";Bitutės;38208558755;Taip;15;4;0;19
22004;"Vilniaus Jono Pauliaus II progimnazija";Bitutės;1498711260;Taip;10;5;0;15
22005;"Vilniaus Jono Pauliaus II progimnazija";Bitutės;94323422162;Taip;0;4;2;6
22006;"Vilniaus Jono Pauliaus II progimnazija";Bitutės;6373945450;Taip;5;6;0;11
22007;"Vilniaus Jono Pauliaus II progimnazija";Bitutės;1834961037;Taip;7;4;0;11
22008;"Vilniaus Jono Pauliaus II progimnazija";Bitutės;7289945805;Ne;0;5;0;5
22009;"Vilniaus Jono Pauliaus II progimnazija";Bitutės;52202199212;Taip;5;4;0;9
22010;"Vilniaus Jono Pauliaus II progimnazija";Nykštukai;56882212708;Taip;0;4;0;4
22011;"Vilniaus Jono Pauliaus II progimnazija";Nykštukai;84864692736;Taip;5;5;0;10
22012;"Vilniaus Jono Pauliaus II progimnazija";Nykštukai;19330722623;Taip;4;4;0;8
22013;"Vilniaus Jono Pauliaus II progimnazija";Nykštukai;41798150203;Taip;0;20;0;20
22014;"Vilniaus Jono Pauliaus II progimnazija";Nykštukai;1497044775;Taip;0;20;0;20
22015;"Vilniaus Jono Pauliaus II progimnazija";Nykštukai;18174475384;Taip;5;6;1;12
22016;"Vilniaus Jono Pauliaus II progimnazija";Nykštukai;29793632667;Taip;6;4;0;10
22017;"Vilniaus Jono Pauliaus II progimnazija";Nykštukai;2067239710;Taip;0;11;0;11
22018;"Vilniaus Jono Pauliaus II progimnazija";Nykštukai;95238329605;Taip;0;4;0;4
22019;"Vilniaus Jono Pauliaus II progimnazija";Nykštukai;66947843128;Taip;0;4;0;4
22020;"Vilniaus Jono Pauliaus II progimnazija";Nykštukai;96241985330;Taip;3;5;0;8
22021;"Vilniaus Jono Pauliaus II progimnazija";Nykštukai;98624493006;Taip;6;1;0;7
22022;"Vilniaus Jono Pauliaus II progimnazija";Nykštukai;1538884930;Taip;0;4;0;4
22023;"Vilniaus Jono Pauliaus II progimnazija";Nykštukai;97057444920;Taip;0;6;1;7
22024;"Vilniaus Jono Pauliaus II progimnazija";Nykštukai;58033050070;Taip;0;7;0;7
22025;"Vilniaus Jono Pauliaus II progimnazija";Nykštukai;5744439022;Taip;0;6;1;7
22026;"Vilniaus Jono Pauliaus II progimnazija";Nykštukai;30095924180;Taip;8;4;0;12
22027;"Vilniaus Jono Pauliaus II progimnazija";Nykštukai;17663780748;Taip;0;6;0;6
22028;"Vilniaus Jono Pauliaus II progimnazija";Nykštukai;33970738232;Taip;0;6;3;9
22029;"Vilniaus Jono Pauliaus II progimnazija";Nykštukai;28504232181;Taip;9;4;0;13
22030;"Vilniaus Jono Pauliaus II progimnazija";Nykštukai;65927108137;Taip;5;4;0;9
22031;"Vilniaus Jono Pauliaus II progimnazija";Nykštukai;5282646148;Ne;15;0;0;15
22032;"Vilniaus Jono Pauliaus II progimnazija";Nykštukai;29750547072;Taip;0;4;0;4
22033;"Vilniaus Jono Pauliaus II progimnazija";Nykštukai;6636967120;Taip;0;6;3;9
22034;"Vilniaus Jono Pauliaus II progimnazija";Nykštukai;76004865730;Taip;10;5;0;15
22035;"Vilniaus Jono Pauliaus II progimnazija";Nykštukai;1681910702;Taip;0;20;0;20
22036;"Vilniaus Jono Pauliaus II progimnazija";Spindulėlis;86349879099;Taip;0;9;1;10
22037;"Vilniaus Jono Pauliaus II progimnazija";Spindulėlis;71621781260;Taip;12;4;0;16
22038;"Vilniaus Jono Pauliaus II progimnazija";Spindulėlis;40232303318;Taip;0;4;0;4
22039;"Vilniaus Jono Pauliaus II progimnazija";Spindulėlis;18772270293;Taip;0;4;0;4
22040;"Vilniaus Jono Pauliaus II progimnazija";Spindulėlis;2092126666;Taip;0;4;0;4
22041;"Vilniaus Jono Pauliaus II progimnazija";Spindulėlis;18296155488;Taip;0;9;0;9
22042;"Vilniaus Jono Pauliaus II progimnazija";Spindulėlis;82826774977;Taip;0;9;0;9
22043;"Vilniaus Jono Pauliaus II progimnazija";Spindulėlis;13277721739;Taip;10;4;1;15
22044;"Vilniaus Jono Pauliaus II progimnazija";Spindulėlis;27320886907;Taip;9;4;0;13
22045;"Vilniaus Jono Pauliaus II progimnazija";Spindulėlis;90544626686;Ne;0;4;0;4
22046;"Vilniaus Jono Pauliaus II progimnazija";Spindulėlis;50461103065;Taip;10;4;0;14
22047;"Vilniaus Jono Pauliaus II progimnazija";Spindulėlis;23815562807;Taip;0;4;0;4
22048;"Vilniaus Jono Pauliaus II progimnazija";Spindulėlis;9433070239;Taip;0;4;0;4
22049;"Vilniaus Jono Pauliaus II progimnazija";Spindulėlis;14763149919;Taip;10;4;0;14
22050;"Vilniaus Jono Pauliaus II progimnazija";Spindulėlis;13620421173;Ne;0;4;1;5
22051;"Vilniaus Jono Pauliaus II progimnazija";Spindulėlis;68654751373;Taip;0;4;1;5
22052;"Vilniaus Jono Pauliaus II progimnazija";Spindulėlis;71644061437;Taip;10;4;1;15
22053;"Vilniaus Jono Pauliaus II progimnazija";Spindulėlis;9413926262;Ne;0;24;0;24
22054;"Vilniaus Jono Pauliaus II progimnazija";Spindulėlis;1881484420;Ne;0;4;0;4
22055;"Vilniaus Jono Pauliaus II progimnazija";Žiniukai;18666752189;Taip;0;4;1;5
22056;"Vilniaus Jono Pauliaus II progimnazija";Žiniukai;85578252258;Ne;4;4;0;8
22057;"Vilniaus Jono Pauliaus II progimnazija";Žiniukai;16243269254;Taip;0;12;0;12
22058;"Vilniaus Jono Pauliaus II progimnazija";Žiniukai;2268141397;Taip;0;10;0;10
22059;"Vilniaus Jono Pauliaus II progimnazija";Žiniukai;15095928335;Taip;9;4;0;13
22060;"Vilniaus Jono Pauliaus II progimnazija";Žiniukai;97421699352;Taip;0;4;0;4
22061;"Vilniaus Jono Pauliaus II progimnazija";Žiniukai;87167492911;Taip;5;5;0;10
22062;"Vilniaus Jono Pauliaus II progimnazija";Žiniukai;86166153049;Ne;0;8;0;8
22063;"Vilniaus Jono Pauliaus II progimnazija";Žiniukai;23756278273;Taip;0;6;0;6
22064;"Vilniaus Jono Pauliaus II progimnazija";Žiniukai;76860078254;Taip;5;4;0;9
22065;"Vilniaus Jono Pauliaus II progimnazija";Žiniukai;59698476683;Taip;5;4;0;9
22066;"Vilniaus Jono Pauliaus II progimnazija";Žiniukai;1265276800;Taip;10;4;0;14
22067;"Vilniaus Jono Pauliaus II progimnazija";Žiniukai;52145954352;Taip;0;4;3;7
22068;"Vilniaus Jono Pauliaus II progimnazija";Žiniukai;13144507021;Taip;5;4;0;9
22069;"Vilniaus Jono Pauliaus II progimnazija";Žiniukai;2145527582;Ne;0;7;0;7
22070;"Vilniaus Jono Pauliaus II progimnazija";Žiniukai;74531978509;Taip;0;5;0;5
22071;"Vilniaus Jono Pauliaus II progimnazija";Žiniukai;45823285175;Taip;5;4;0;9
22072;"Vilniaus Jono Pauliaus II progimnazija";Žiniukai;63967215708;Taip;7;4;0;11
22073;"Vilniaus Jono Pauliaus II progimnazija";Žiniukai;88089833901;Ne;0;4;0;4
22074;"Vilniaus Jono Pauliaus II progimnazija";Žiniukai;71421862891;Taip;10;4;0;14
22075;"Vilniaus Jono Pauliaus II progimnazija";Žiniukai;94546685371;Taip;0;8;0;8
22076;"Vilniaus Jono Pauliaus II progimnazija";Žiniukai;1883620780;Taip;0;4;0;4
22077;"Vilniaus Jono Pauliaus II progimnazija";Žiniukai;64083158642;Taip;11;0;0;11
22078;"Vilniaus Senamiesčio vidurinė mokykla";PG1;1059396976;Taip;0;4;0;4
22079;"Vilniaus Senamiesčio vidurinė mokykla";PG1;2094485999;Taip;0;4;0;4
22080;"Vilniaus Senamiesčio vidurinė mokykla";PG1;4793402013;Taip;0;4;0;4
22081;"Vilniaus Senamiesčio vidurinė mokykla";PG1;30428486005;Ne;0;4;0;4
22082;"Vilniaus Senamiesčio vidurinė mokykla";PG1;1369622524;Taip;0;23;0;23
22083;"Vilniaus Senamiesčio vidurinė mokykla";PG1;56224529599;Ne;0;4;0;4
22084;"Vilniaus Senamiesčio vidurinė mokykla";PG1;65977368065;Taip;0;10;0;10
22085;"Vilniaus Senamiesčio vidurinė mokykla";PG1;54923779499;Taip;0;11;0;11
22086;"Vilniaus Senamiesčio vidurinė mokykla";PG1;5575633653;Taip;3;4;0;7
22087;"Vilniaus Senamiesčio vidurinė mokykla";PG1;1813072867;Taip;0;4;0;4
22088;"Vilniaus Senamiesčio vidurinė mokykla";PG1;7764171885;Taip;1;4;1;6
22089;"Vilniaus Senamiesčio vidurinė mokykla";PG1;152363521;Taip;0;23;0;23
