Nr.;"Darželio pavadinimas";"Grupės pavadinimas";"Vaiko Identifikacinis Nr.";"Deklaruotas mieste";"Pateisintos dėl ligos";"Pateisintos dėl kitų priežasčių";"Nepateisintos dienos";"Praleistos dienos Viso"
1;Aitvaras;"VIJURKAI (ALERG.)";8610723991;Taip;0;3;0;3
2;Aitvaras;"VIJURKAI (ALERG.)";82386048619;Taip;0;5;4;9
3;Aitvaras;"VIJURKAI (ALERG.)";86008218554;Taip;5;1;0;6
4;Aitvaras;"VIJURKAI (ALERG.)";9065712699;Taip;0;7;0;7
5;Aitvaras;"VIJURKAI (ALERG.)";63345306760;Taip;2;0;0;2
6;Aitvaras;"VIJURKAI (ALERG.)";84623684490;Taip;0;1;0;1
7;Aitvaras;"VIJURKAI (ALERG.)";16402806518;Taip;0;0;1;1
8;Aitvaras;"VIJURKAI (ALERG.)";74266054705;Taip;0;0;1;1
9;Aitvaras;"VIJURKAI (ALERG.)";40455080945;Taip;0;9;0;9
10;Aitvaras;"VIJURKAI (ALERG.)";1156348512;Taip;4;1;0;5
11;Aitvaras;"VIJURKAI (ALERG.)";3724722474;Taip;0;4;0;4
12;Aitvaras;"VIJURKAI (ALERG.)";15430509460;Taip;7;5;0;12
13;Aitvaras;"VIJURKAI (ALERG.)";1795308718;Taip;16;1;0;17
14;Aitvaras;"VIJURKAI (ALERG.)";1130945040;Taip;0;5;0;5
15;Aitvaras;"VIJURKAI (ALERG.)";33729670803;Taip;0;5;1;6
16;Aitvaras;"SMALSUČIAI (ALERG.)";1396233353;Taip;0;11;0;11
17;Aitvaras;"SMALSUČIAI (ALERG.)";7062437676;Taip;2;2;0;4
18;Aitvaras;"SMALSUČIAI (ALERG.)";19974574043;Taip;2;2;0;4
19;Aitvaras;"SMALSUČIAI (ALERG.)";8756767379;Taip;5;0;0;5
20;Aitvaras;"SMALSUČIAI (ALERG.)";28583194438;Taip;0;6;0;6
21;Aitvaras;"SMALSUČIAI (ALERG.)";23092799474;Taip;0;6;0;6
22;Aitvaras;"SMALSUČIAI (ALERG.)";1286577536;Taip;5;0;1;6
23;Aitvaras;"SMALSUČIAI (ALERG.)";63572158244;Taip;0;4;0;4
24;Aitvaras;"SMALSUČIAI (ALERG.)";2259914595;Taip;4;1;0;5
25;Aitvaras;"SMALSUČIAI (ALERG.)";65184449922;Taip;11;0;1;12
26;Aitvaras;"SMALSUČIAI (ALERG.)";35989222658;Taip;0;5;0;5
27;Aitvaras;"SMALSUČIAI (ALERG.)";38025877986;Taip;5;7;1;13
28;Aitvaras;"SMALSUČIAI (ALERG.)";2758970705;Taip;0;2;1;3
29;Aitvaras;"SMALSUČIAI (ALERG.)";64844875547;Taip;0;7;0;7
30;Aitvaras;"SMALSUČIAI (ALERG.)";909566870;Taip;0;6;0;6
31;Aitvaras;"SMALSUČIAI (ALERG.)";40103691282;Taip;0;1;0;1
32;Aitvaras;"SMALSUČIAI (ALERG.)";91112093978;Taip;0;7;0;7
33;Aitvaras;PADAUŽIUKAI;891634233;Taip;7;8;0;15
34;Aitvaras;PADAUŽIUKAI;37239090522;Taip;5;0;1;6
35;Aitvaras;PADAUŽIUKAI;51360850840;Taip;5;1;3;9
36;Aitvaras;PADAUŽIUKAI;8487865580;Taip;6;14;0;20
37;Aitvaras;PADAUŽIUKAI;83870816281;Taip;0;5;0;5
38;Aitvaras;PADAUŽIUKAI;18199282002;Taip;2;0;3;5
39;Aitvaras;PADAUŽIUKAI;98187921839;Taip;10;5;0;15
40;Aitvaras;PADAUŽIUKAI;76493460153;Taip;0;6;0;6
41;Aitvaras;PADAUŽIUKAI;23252314829;Taip;0;0;1;1
42;Aitvaras;PADAUŽIUKAI;2910005555;Taip;3;6;0;9
43;Aitvaras;PADAUŽIUKAI;18037655336;Taip;0;5;0;5
44;Aitvaras;PADAUŽIUKAI;7240754055;Taip;0;6;0;6
45;Aitvaras;PADAUŽIUKAI;44035041676;Taip;0;5;0;5
46;Aitvaras;PADAUŽIUKAI;53743278288;Taip;0;1;1;2
47;Aitvaras;PADAUŽIUKAI;80728374682;Taip;0;0;1;1
48;Aitvaras;PADAUŽIUKAI;57489495125;Taip;0;2;0;2
49;Aitvaras;PADAUŽIUKAI;22518124043;Taip;0;0;4;4
50;Aitvaras;PADAUŽIUKAI;86739069318;Taip;0;1;0;1
51;Aitvaras;PADAUŽIUKAI;33594031405;Taip;8;1;0;9
52;Aitvaras;"AITVARIUKAI (ALERG.)";37391225613;Taip;3;5;0;8
53;Aitvaras;"AITVARIUKAI (ALERG.)";76280361479;Taip;0;7;2;9
54;Aitvaras;"AITVARIUKAI (ALERG.)";36359228257;Taip;10;5;0;15
55;Aitvaras;"AITVARIUKAI (ALERG.)";2674192321;Taip;13;0;0;13
56;Aitvaras;"AITVARIUKAI (ALERG.)";13670186807;Taip;20;0;0;20
57;Aitvaras;"AITVARIUKAI (ALERG.)";31074942686;Taip;10;6;0;16
58;Aitvaras;"AITVARIUKAI (ALERG.)";12962784212;Ne;5;6;0;11
59;Aitvaras;"AITVARIUKAI (ALERG.)";1542575012;Taip;15;1;0;16
60;Aitvaras;"AITVARIUKAI (ALERG.)";1223627682;Taip;10;0;0;10
61;Aitvaras;"AITVARIUKAI (ALERG.)";3471031093;Taip;10;3;0;13
62;Aitvaras;"AITVARIUKAI (ALERG.)";9810370596;Taip;8;0;1;9
63;Aitvaras;"AITVARIUKAI (ALERG.)";34735287315;Taip;11;4;1;16
64;Aitvaras;"AITVARIUKAI (ALERG.)";4833313373;Taip;0;5;0;5
65;Aitvaras;"AITVARIUKAI (ALERG.)";84919478493;Taip;15;0;0;15
66;Aitvaras;"AITVARIUKAI (ALERG.)";9745864667;Taip;0;17;0;17
67;Aitvaras;"AITVARIUKAI (ALERG.)";5389627560;Taip;5;0;0;5
68;Aitvaras;"AITVARIUKAI (ALERG.)";5956333024;Taip;3;1;0;4
69;Aitvaras;"AITVARIUKAI (ALERG.)";1636794584;Taip;15;1;0;16
70;Aitvaras;"AITVARIUKAI (ALERG.)";2953536545;Taip;9;6;0;15
71;Aitvaras;"AITVARIUKAI (ALERG.)";3535659630;Taip;10;2;0;12
72;Aitvaras;"AITVARIUKAI (ALERG.)";3488467265;Taip;0;3;0;3
73;Aitvaras;"AITVARIUKAI (ALERG.)";2566375128;Taip;5;0;0;5
74;Aitvaras;"AITVARIUKAI (ALERG.)";6356432078;Taip;11;0;0;11
75;Aitvaras;"SAULĖS ZUIKUČIAI  (ALERG.)";1019661577;Taip;0;5;0;5
76;Aitvaras;"SAULĖS ZUIKUČIAI  (ALERG.)";55369747065;Taip;5;0;2;7
77;Aitvaras;"SAULĖS ZUIKUČIAI  (ALERG.)";5204534227;Taip;0;0;1;1
78;Aitvaras;"SAULĖS ZUIKUČIAI  (ALERG.)";89623351867;Taip;0;0;1;1
79;Aitvaras;"SAULĖS ZUIKUČIAI  (ALERG.)";837021325;Taip;0;3;0;3
80;Aitvaras;"SAULĖS ZUIKUČIAI  (ALERG.)";1207249857;Taip;3;7;1;11
81;Aitvaras;"SAULĖS ZUIKUČIAI  (ALERG.)";30174058452;Taip;2;1;0;3
82;Aitvaras;"SAULĖS ZUIKUČIAI  (ALERG.)";24247118884;Taip;0;1;0;1
83;Aitvaras;"SAULĖS ZUIKUČIAI  (ALERG.)";1516018865;Taip;0;4;0;4
84;Aitvaras;"SAULĖS ZUIKUČIAI  (ALERG.)";1011446683;Taip;10;0;5;15
85;Aitvaras;"SAULĖS ZUIKUČIAI  (ALERG.)";1872130301;Taip;5;1;0;6
86;Aitvaras;"SAULĖS ZUIKUČIAI  (ALERG.)";6745376381;Taip;0;0;4;4
87;Aitvaras;"SAULĖS ZUIKUČIAI  (ALERG.)";3433178644;Taip;0;6;0;6
88;Aitvaras;"SAULĖS ZUIKUČIAI  (ALERG.)";69352006024;Taip;0;10;0;10
89;Aitvaras;"SAULĖS ZUIKUČIAI  (ALERG.)";2083332491;Taip;5;1;0;6
90;Aitvaras;"SAULĖS ZUIKUČIAI  (ALERG.)";61721665912;Taip;0;7;3;10
91;Aitvaras;"SAULĖS ZUIKUČIAI  (ALERG.)";6238828251;Taip;0;1;1;2
92;Aitvaras;"SAULĖS ZUIKUČIAI  (ALERG.)";99037281876;Taip;0;1;0;1
93;Aitvaras;"ŽEMYNUKAI (ALERG.)";1301667420;Taip;0;12;0;12
94;Aitvaras;"ŽEMYNUKAI (ALERG.)";47686798724;Taip;13;2;0;15
95;Aitvaras;"ŽEMYNUKAI (ALERG.)";94080483856;Taip;0;1;2;3
96;Aitvaras;"ŽEMYNUKAI (ALERG.)";1621302802;Taip;0;7;0;7
97;Aitvaras;"ŽEMYNUKAI (ALERG.)";7592535089;Taip;20;0;0;20
98;Aitvaras;"ŽEMYNUKAI (ALERG.)";5083382326;Taip;13;1;0;14
99;Aitvaras;"ŽEMYNUKAI (ALERG.)";3001619281;Taip;10;6;0;16
100;Aitvaras;"ŽEMYNUKAI (ALERG.)";4708741626;Taip;0;4;0;4
101;Aitvaras;"ŽEMYNUKAI (ALERG.)";85826303673;Taip;6;3;0;9
102;Aitvaras;"ŽEMYNUKAI (ALERG.)";44139920757;Taip;0;6;0;6
103;Aitvaras;"ŽEMYNUKAI (ALERG.)";9845539641;Taip;14;1;0;15
104;Aitvaras;"ŽEMYNUKAI (ALERG.)";1600657305;Taip;0;9;0;9
105;Aitvaras;"ŽEMYNUKAI (ALERG.)";1652681820;Taip;7;1;2;10
106;Aitvaras;"ŽEMYNUKAI (ALERG.)";6166757095;Taip;5;1;0;6
107;Aitvaras;"ŽEMYNUKAI (ALERG.)";1201862001;Taip;0;4;7;11
108;Aitvaras;"ŽEMYNUKAI (ALERG.)";5595233402;Taip;11;0;0;11
109;Aitvaras;"ŽEMYNUKAI (ALERG.)";2650483861;Taip;6;0;0;6
110;Aitvaras;"ŽEMYNUKAI (ALERG.)";5922357091;Taip;4;0;2;6
111;Aitvaras;"ŽEMYNUKAI (ALERG.)";4868552034;Taip;0;5;0;5
112;Aitvaras;"ŽEMYNUKAI (ALERG.)";8970519668;Taip;0;4;1;5
113;Aitvaras;"ŽEMYNUKAI (ALERG.)";84922258988;Taip;15;0;0;15
114;Aitvaras;"ŽEMYNUKAI (ALERG.)";1494094426;Taip;0;17;0;17
115;Aitvaras;"LINKSMUČIAI (ALERG.)";5238819066;Taip;15;0;0;15
116;Aitvaras;"LINKSMUČIAI (ALERG.)";7109001184;Taip;5;0;0;5
117;Aitvaras;"LINKSMUČIAI (ALERG.)";5378212904;Taip;20;0;0;20
118;Aitvaras;"LINKSMUČIAI (ALERG.)";3655710511;Taip;0;15;0;15
119;Aitvaras;"LINKSMUČIAI (ALERG.)";1091372798;Taip;0;7;0;7
120;Aitvaras;"LINKSMUČIAI (ALERG.)";6572235324;Taip;15;1;0;16
121;Aitvaras;"LINKSMUČIAI (ALERG.)";8666824607;Taip;3;0;3;6
122;Aitvaras;"LINKSMUČIAI (ALERG.)";5612991255;Taip;20;0;0;20
123;Aitvaras;"LINKSMUČIAI (ALERG.)";5330618557;Taip;12;0;0;12
124;Aitvaras;"LINKSMUČIAI (ALERG.)";5504431748;Taip;11;0;0;11
125;Aitvaras;"LINKSMUČIAI (ALERG.)";8206046301;Taip;16;0;1;17
126;Aitvaras;"LINKSMUČIAI (ALERG.)";4480921300;Taip;11;0;2;13
127;Aitvaras;"LINKSMUČIAI (ALERG.)";8178703988;Taip;7;0;7;14
128;Aitvaras;"LINKSMUČIAI (ALERG.)";1532588441;Taip;10;2;0;12
129;Aitvaras;"LINKSMUČIAI (ALERG.)";7260577885;Taip;0;4;0;4
130;Aitvaras;"LINKSMUČIAI (ALERG.)";1599183050;Taip;10;0;0;10
131;Aitvaras;"LINKSMUČIAI (ALERG.)";3944373116;Taip;5;1;1;7
132;Aitvaras;"LINKSMUČIAI (ALERG.)";1115202169;Taip;15;0;0;15
133;Aitvaras;"LINKSMUČIAI (ALERG.)";7029464687;Taip;15;0;0;15
134;Aitvaras;"LINKSMUČIAI (ALERG.)";4613894944;Taip;11;0;0;11
135;Aitvaras;"LINKSMUČIAI (ALERG.)";2760970218;Taip;8;1;0;9
136;Aitvaras;"LINKSMUČIAI (ALERG.)";4120515569;Taip;5;0;0;5
137;Aitvaras;NAMINUKAI;40344230133;Taip;0;0;2;2
138;Aitvaras;NAMINUKAI;1493048970;Taip;20;0;0;20
139;Aitvaras;NAMINUKAI;1306408890;Taip;0;2;0;2
140;Aitvaras;NAMINUKAI;59572108690;Taip;5;0;2;7
141;Aitvaras;NAMINUKAI;74628671065;Taip;0;5;7;12
142;Aitvaras;NAMINUKAI;70367340825;Taip;0;0;3;3
143;Aitvaras;NAMINUKAI;62126044317;Taip;0;12;0;12
144;Aitvaras;NAMINUKAI;1790437467;Taip;12;2;0;14
145;Aitvaras;NAMINUKAI;46021715174;Taip;0;0;2;2
146;Aitvaras;NAMINUKAI;85560586048;Taip;16;0;0;16
147;Aitvaras;NAMINUKAI;26906648835;Taip;5;5;0;10
148;Aitvaras;NAMINUKAI;1681260995;Taip;6;0;0;6
149;Aitvaras;NAMINUKAI;42556460388;Taip;0;5;0;5
150;Aitvaras;NAMINUKAI;54496602809;Taip;0;11;4;15
151;Aitvaras;NAMINUKAI;1487264184;Taip;0;0;7;7
152;Aitvaras;NAMINUKAI;97382092851;Taip;8;2;0;10
153;Aitvaras;NAMINUKAI;1886917840;Taip;0;4;0;4
154;Aitvaras;NAMINUKAI;52679806772;Taip;5;0;0;5
155;Aitvaras;NAMINUKAI;1500548803;Taip;5;2;0;7
156;Aitvaras;NAMINUKAI;5103057090;Taip;10;2;0;12
157;Aitvaras;NAMINUKAI;3836513736;Taip;8;0;3;11
158;Aitvaras;ŠELMIAI;9332771711;Taip;15;0;0;15
159;Aitvaras;ŠELMIAI;6550426644;Taip;7;8;0;15
160;Aitvaras;ŠELMIAI;58780461337;Taip;4;1;0;5
161;Aitvaras;ŠELMIAI;1116271183;Taip;6;2;0;8
162;Aitvaras;ŠELMIAI;44046627149;Taip;6;0;0;6
163;Aitvaras;ŠELMIAI;43711349817;Taip;10;2;1;13
164;Aitvaras;ŠELMIAI;7469656671;Taip;13;0;0;13
165;Aitvaras;ŠELMIAI;2408952971;Taip;11;0;0;11
166;Aitvaras;ŠELMIAI;47875842134;Taip;9;1;0;10
167;Aitvaras;ŠELMIAI;40799643122;Taip;5;6;0;11
168;Aitvaras;ŠELMIAI;8784628567;Taip;4;0;0;4
169;Aitvaras;ŠELMIAI;2601983670;Taip;5;0;0;5
170;Aitvaras;ŠELMIAI;1387254053;Taip;0;0;5;5
171;Aitvaras;ŠELMIAI;8503279655;Taip;0;6;0;6
172;Aitvaras;ŠELMIAI;1105354193;Taip;0;3;0;3
173;Aitvaras;ŠELMIAI;2034293999;Taip;17;0;0;17
174;Aitvaras;ŠELMIAI;2804106417;Taip;10;1;0;11
175;Aitvaras;ŠELMIAI;2711888522;Taip;9;1;0;10
176;Aitvaras;ŠELMIAI;1996524718;Taip;9;1;2;12
177;Aitvaras;ŠELMIAI;4110585744;Taip;0;6;0;6
178;Aitvaras;ŠELMIAI;6010324894;Taip;13;0;1;14
179;Aitvaras;KODĖLČIUKAI;403821197;Taip;0;6;0;6
180;Aitvaras;KODĖLČIUKAI;64683090780;Taip;5;1;0;6
181;Aitvaras;KODĖLČIUKAI;87846069433;Taip;5;5;0;10
182;Aitvaras;KODĖLČIUKAI;12216502128;Taip;3;7;0;10
183;Aitvaras;KODĖLČIUKAI;46998364516;Taip;4;5;0;9
184;Aitvaras;KODĖLČIUKAI;45833790181;Taip;0;7;0;7
185;Aitvaras;KODĖLČIUKAI;89194677727;Taip;10;3;0;13
186;Aitvaras;KODĖLČIUKAI;24017694836;Taip;11;1;1;13
187;Aitvaras;KODĖLČIUKAI;64205113506;Taip;0;6;0;6
188;Aitvaras;KODĖLČIUKAI;54438500410;Taip;0;4;0;4
189;Aitvaras;KODĖLČIUKAI;25117529505;Taip;0;3;0;3
190;Aitvaras;KODĖLČIUKAI;2136550853;Taip;10;4;2;16
191;Aitvaras;KODĖLČIUKAI;75662895254;Taip;0;1;0;1
192;Aitvaras;KODĖLČIUKAI;1355296093;Taip;3;5;0;8
193;Aitvaras;KODĖLČIUKAI;1850900990;Taip;9;3;0;12
194;Aitvaras;KODĖLČIUKAI;30517554931;Taip;0;5;0;5
195;Aitvaras;KODĖLČIUKAI;2092431875;Taip;0;4;7;11
196;Aitvaras;KODĖLČIUKAI;1371102633;Taip;0;7;0;7
197;Aitvaras;KODĖLČIUKAI;1641140396;Taip;18;0;0;18
198;Aitvaras;KODĖLČIUKAI;9649742132;Taip;10;10;0;20
199;Aitvaras;KODĖLČIUKAI;1315081684;Taip;16;0;0;16
200;Aitvaras;PABIRUČIAI;1288810999;Taip;0;0;3;3
201;Aitvaras;PABIRUČIAI;3178965623;Taip;0;2;0;2
202;Aitvaras;PABIRUČIAI;8065540507;Taip;15;0;1;16
203;Aitvaras;PABIRUČIAI;6501943902;Taip;5;0;7;12
204;Aitvaras;PABIRUČIAI;3101015381;Taip;1;0;0;1
205;Aitvaras;PABIRUČIAI;4350590529;Taip;1;0;0;1
206;Aitvaras;PABIRUČIAI;7777235021;Taip;15;0;1;16
207;Aitvaras;PABIRUČIAI;5641224483;Taip;0;2;0;2
208;Aitvaras;PABIRUČIAI;1830134108;Taip;0;11;0;11
209;Aitvaras;PABIRUČIAI;8121858940;Taip;2;0;1;3
210;Aitvaras;PABIRUČIAI;2452780076;Taip;5;0;0;5
211;Aitvaras;PABIRUČIAI;5905456814;Taip;7;0;0;7
212;Aitvaras;PABIRUČIAI;1761446849;Taip;5;0;0;5
213;Aitvaras;PABIRUČIAI;6739827530;Taip;11;5;0;16
214;Aitvaras;PABIRUČIAI;2807595769;Taip;0;7;0;7
215;Aitvaras;PABIRUČIAI;1252145346;Taip;7;10;1;18
216;Aitvaras;PABIRUČIAI;8439586875;Taip;0;2;0;2
217;Aitvaras;PABIRUČIAI;8043062737;Taip;17;0;1;18
218;Aitvaras;"SVAJOKLIAI  (ALERG.)";5770779699;Taip;6;0;0;6
219;Aitvaras;"SVAJOKLIAI  (ALERG.)";2159901439;Taip;9;0;0;9
220;Aitvaras;"SVAJOKLIAI  (ALERG.)";1553462849;Taip;10;4;0;14
221;Aitvaras;"SVAJOKLIAI  (ALERG.)";8366627546;Taip;9;3;0;12
222;Aitvaras;"SVAJOKLIAI  (ALERG.)";1398792964;Taip;4;2;0;6
223;Aitvaras;"SVAJOKLIAI  (ALERG.)";1834535594;Taip;17;0;0;17
224;Aitvaras;"SVAJOKLIAI  (ALERG.)";7083046536;Taip;17;0;0;17
225;Aitvaras;"SVAJOKLIAI  (ALERG.)";3716313515;Taip;4;6;0;10
226;Aitvaras;"SVAJOKLIAI  (ALERG.)";1606267845;Taip;0;10;1;11
227;Aitvaras;"SVAJOKLIAI  (ALERG.)";5856250605;Taip;17;0;0;17
228;Aitvaras;"SVAJOKLIAI  (ALERG.)";2004112424;Taip;7;9;0;16
229;Aitvaras;"SVAJOKLIAI  (ALERG.)";6084096300;Taip;0;2;0;2
230;Aitvaras;"SVAJOKLIAI  (ALERG.)";5750154036;Taip;14;3;0;17
231;Aitvaras;"SVAJOKLIAI  (ALERG.)";6201118021;Taip;8;5;0;13
232;Aitvaras;"SVAJOKLIAI  (ALERG.)";1773366241;Taip;11;0;0;11
233;Aitvaras;"SVAJOKLIAI  (ALERG.)";1940545723;Taip;5;3;0;8
234;Aitvaras;"SVAJOKLIAI  (ALERG.)";3133031845;Taip;15;0;0;15
235;Aitvaras;"SVAJOKLIAI  (ALERG.)";1481849611;Taip;10;0;0;10
236;Aitvaras;"SVAJOKLIAI  (ALERG.)";1090979323;Taip;0;7;0;7
237;Aitvaras;"SVAJOKLIAI  (ALERG.)";1879540041;Taip;5;6;0;11
238;Aitvaras;"SVAJOKLIAI  (ALERG.)";1347364985;Taip;5;0;4;9
239;Aitvaras;"SVAJOKLIAI  (ALERG.)";5425259260;Taip;12;3;0;15
240;Atžalėlės;Gėlytės;28219993536;Taip;0;2;0;2
241;Atžalėlės;Gėlytės;63065430971;Taip;0;1;2;3
242;Atžalėlės;Gėlytės;42516348711;Ne;0;4;5;9
243;Atžalėlės;Gėlytės;91973899274;Taip;0;5;0;5
244;Atžalėlės;Gėlytės;67614970563;Taip;0;9;0;9
245;Atžalėlės;Gėlytės;23898319471;Ne;0;5;1;6
246;Atžalėlės;Gėlytės;92549162266;Ne;0;4;0;4
247;Atžalėlės;Gėlytės;46113919448;Taip;9;4;3;16
248;Atžalėlės;Gėlytės;28334054013;Taip;0;1;5;6
249;Atžalėlės;Gėlytės;84635439691;Taip;7;0;0;7
250;Atžalėlės;Gėlytės;20861477621;Taip;0;4;0;4
251;Atžalėlės;Gėlytės;5980426022;Ne;6;4;1;11
252;Atžalėlės;Gėlytės;6248765693;Taip;0;3;3;6
253;Atžalėlės;Gėlytės;74767205037;Taip;6;2;2;10
254;Atžalėlės;Gėlytės;45220122220;Taip;3;0;0;3
255;Atžalėlės;Gėlytės;13645371813;Taip;0;1;0;1
256;Atžalėlės;Gėlytės;16280202740;Taip;3;5;0;8
257;Atžalėlės;Gėlytės;67950853185;Taip;0;5;0;5
258;Atžalėlės;Gėlytės;95195013544;Taip;0;6;0;6
259;Atžalėlės;Gėlytės;74821213130;Taip;0;1;0;1
260;Atžalėlės;Gėlytės;2004639307;Taip;0;5;0;5
261;Atžalėlės;Gėlytės;7157406678;Taip;0;5;2;7
262;Atžalėlės;Gėlytės;98084870071;Taip;0;5;2;7
263;Atžalėlės;Drugeliai;4643154006;Taip;7;0;0;7
264;Atžalėlės;Drugeliai;6903666624;Taip;0;17;0;17
265;Atžalėlės;Drugeliai;4902947406;Taip;0;1;3;4
266;Atžalėlės;Drugeliai;6570245757;Taip;0;0;3;3
267;Atžalėlės;Drugeliai;9491132884;Taip;0;1;1;2
268;Atžalėlės;Drugeliai;6132569107;Taip;2;0;0;2
269;Atžalėlės;Drugeliai;2315790531;Taip;10;0;0;10
270;Atžalėlės;Drugeliai;6782007470;Taip;0;9;0;9
271;Atžalėlės;Drugeliai;8393217418;Taip;0;0;1;1
272;Atžalėlės;Drugeliai;1805496887;Taip;0;20;0;20
273;Atžalėlės;Drugeliai;5417971068;Taip;0;5;1;6
274;Atžalėlės;Drugeliai;9463215947;Taip;0;1;0;1
275;Atžalėlės;Drugeliai;7953922166;Taip;0;9;0;9
276;Atžalėlės;Drugeliai;5147078840;Taip;0;2;0;2
277;Atžalėlės;Drugeliai;9222670655;Taip;0;5;0;5
278;Atžalėlės;Drugeliai;77261118958;Taip;0;5;1;6
279;Atžalėlės;Drugeliai;1429493246;Taip;0;4;0;4
280;Atžalėlės;Drugeliai;6114426973;Taip;20;0;0;20
281;Atžalėlės;Drugeliai;1456979448;Taip;0;7;0;7
282;Atžalėlės;Drugeliai;4884599397;Taip;11;5;4;20
283;Atžalėlės;Drugeliai;8718036014;Taip;11;5;4;20
284;Atžalėlės;Drugeliai;3571134734;Taip;11;4;0;15
285;Atžalėlės;Gandriukai;28910361902;Taip;0;10;0;10
286;Atžalėlės;Gandriukai;93452036571;Taip;0;5;0;5
287;Atžalėlės;Gandriukai;4483002806;Taip;0;11;0;11
288;Atžalėlės;Gandriukai;16442821393;Taip;0;5;0;5
289;Atžalėlės;Gandriukai;87334806437;Taip;0;1;0;1
290;Atžalėlės;Gandriukai;1204800605;Taip;0;5;0;5
291;Atžalėlės;Gandriukai;1074259644;Taip;0;10;0;10
292;Atžalėlės;Gandriukai;66107666615;Taip;4;0;0;4
293;Atžalėlės;Gandriukai;2124150483;Taip;0;2;0;2
294;Atžalėlės;Gandriukai;63867153552;Taip;5;0;0;5
295;Atžalėlės;Gandriukai;87567915519;Taip;0;2;0;2
296;Atžalėlės;Gandriukai;82049064201;Taip;0;0;2;2
297;Atžalėlės;Gandriukai;78120202936;Taip;0;1;0;1
298;Atžalėlės;Gandriukai;1011601294;Taip;0;5;0;5
299;Atžalėlės;Gandriukai;1299048195;Taip;5;6;0;11
300;Atžalėlės;Gandriukai;80500800894;Taip;5;0;4;9
301;Atžalėlės;Gandriukai;519493490;Taip;0;4;0;4
302;Atžalėlės;Gandriukai;82777644548;Taip;0;5;3;8
303;Atžalėlės;Gandriukai;23453799177;Taip;0;13;0;13
304;Atžalėlės;Gandriukai;78664848612;Taip;0;7;0;7
305;Atžalėlės;Voveriukai;21599916055;Taip;0;5;0;5
306;Atžalėlės;Voveriukai;52803011399;Taip;0;0;2;2
307;Atžalėlės;Voveriukai;1447259034;Taip;0;9;0;9
308;Atžalėlės;Voveriukai;64596277701;Taip;12;5;0;17
309;Atžalėlės;Voveriukai;84392505831;Taip;17;1;0;18
310;Atžalėlės;Voveriukai;3379307367;Taip;0;4;0;4
311;Atžalėlės;Voveriukai;62325712598;Taip;5;0;1;6
312;Atžalėlės;Voveriukai;1312772153;Taip;0;5;1;6
313;Atžalėlės;Voveriukai;53559306492;Taip;0;8;0;8
314;Atžalėlės;Voveriukai;2488405485;Taip;0;1;0;1
315;Atžalėlės;Voveriukai;39714182342;Taip;0;7;0;7
316;Atžalėlės;Voveriukai;6975941393;Taip;0;1;0;1
317;Atžalėlės;Voveriukai;1865339755;Taip;0;0;7;7
318;Atžalėlės;Voveriukai;8138683218;Taip;0;2;0;2
319;Atžalėlės;Voveriukai;4467364336;Taip;0;3;0;3
320;Atžalėlės;Voveriukai;1804802235;Taip;15;0;0;15
321;Atžalėlės;Voveriukai;1316154666;Taip;6;1;1;8
322;Atžalėlės;Voveriukai;9699811980;Taip;0;8;0;8
323;Atžalėlės;Voveriukai;8847754477;Taip;0;14;0;14
324;Atžalėlės;Voveriukai;7689394485;Taip;4;2;7;13
325;Atžalėlės;Žirniukai;4098210138;Taip;0;5;3;8
326;Atžalėlės;Žirniukai;1500456945;Taip;0;3;3;6
327;Atžalėlės;Žirniukai;1450609695;Taip;0;3;0;3
328;Atžalėlės;Žirniukai;1844980319;Taip;5;6;4;15
329;Atžalėlės;Žirniukai;5997958773;Taip;6;6;2;14
330;Atžalėlės;Žirniukai;6177038838;Taip;8;1;1;10
331;Atžalėlės;Žirniukai;1722233272;Taip;9;8;0;17
332;Atžalėlės;Žirniukai;5310990513;Taip;0;5;0;5
333;Atžalėlės;Žirniukai;8524244526;Taip;20;0;0;20
334;Atžalėlės;Žirniukai;1704679306;Taip;8;2;1;11
335;Atžalėlės;Žirniukai;7702502252;Taip;5;10;0;15
336;Atžalėlės;Žirniukai;9189223222;Taip;8;5;1;14
337;Atžalėlės;Žirniukai;3283415814;Taip;10;5;0;15
338;Atžalėlės;Žirniukai;1146492807;Taip;0;0;4;4
339;Atžalėlės;Žirniukai;5897022357;Taip;15;0;3;18
340;Atžalėlės;Žirniukai;3870758086;Taip;2;5;0;7
341;Atžalėlės;Žirniukai;7356877676;Taip;0;4;0;4
342;Atžalėlės;Ežiukai;5432433423;Taip;0;7;0;7
343;Atžalėlės;Ežiukai;8819893830;Taip;2;9;0;11
344;Atžalėlės;Ežiukai;8695865604;Taip;3;13;0;16
345;Atžalėlės;Ežiukai;4284673729;Taip;10;0;0;10
346;Atžalėlės;Ežiukai;1431197358;Taip;15;0;0;15
347;Atžalėlės;Ežiukai;4177753994;Taip;0;1;1;2
348;Atžalėlės;Ežiukai;5742471497;Taip;20;0;0;20
349;Atžalėlės;Ežiukai;2385614957;Taip;0;0;2;2
350;Atžalėlės;Ežiukai;9715625283;Taip;6;5;9;20
351;Atžalėlės;Ežiukai;6202250600;Taip;15;0;5;20
352;Atžalėlės;Ežiukai;6024189665;Taip;5;0;5;10
353;Atžalėlės;Ežiukai;4238773173;Taip;15;0;2;17
354;Atžalėlės;Ežiukai;2131592139;Taip;0;4;0;4
355;Atžalėlės;Ežiukai;8201582382;Taip;0;5;4;9
356;Atžalėlės;Ežiukai;4362058013;Taip;0;5;4;9
357;Atžalėlės;Ežiukai;3191066669;Taip;5;5;0;10
358;Atžalėlės;Ežiukai;1137741059;Taip;5;0;0;5
359;Atžalėlės;Paukšteliai;77693032830;Ne;5;7;0;12
360;Atžalėlės;Paukšteliai;99097316080;Taip;0;1;2;3
361;Atžalėlės;Paukšteliai;1576891322;Taip;0;5;3;8
362;Atžalėlės;Paukšteliai;18833055728;Taip;0;2;0;2
363;Atžalėlės;Paukšteliai;72360139252;Taip;9;8;0;17
364;Atžalėlės;Paukšteliai;54417643140;Taip;0;5;0;5
365;Atžalėlės;Paukšteliai;91411809951;Taip;0;2;0;2
366;Atžalėlės;Paukšteliai;88525056192;Taip;0;1;3;4
367;Atžalėlės;Paukšteliai;1046971571;Taip;10;5;0;15
368;Atžalėlės;Paukšteliai;50283267330;Taip;0;1;1;2
369;Atžalėlės;Paukšteliai;90664899396;Taip;6;10;0;16
370;Atžalėlės;Paukšteliai;35472285094;Taip;0;5;1;6
371;Atžalėlės;Paukšteliai;93762990685;Taip;3;5;0;8
372;Atžalėlės;Paukšteliai;42752976301;Taip;0;0;5;5
373;Atžalėlės;Paukšteliai;27330226432;Taip;5;1;4;10
374;Atžalėlės;Paukšteliai;57459192709;Taip;20;0;0;20
375;Atžalėlės;Paukšteliai;5438129052;Taip;5;0;6;11
376;Atžalėlės;Paukšteliai;1772202805;Taip;0;5;0;5
377;Atžalėlės;Meškiukai;26878092629;Taip;0;13;0;13
378;Atžalėlės;Meškiukai;1083996834;Taip;0;18;0;18
379;Atžalėlės;Meškiukai;53385285795;Taip;6;5;1;12
380;Atžalėlės;Meškiukai;91094623082;Taip;4;8;0;12
381;Atžalėlės;Meškiukai;52163840804;Taip;5;2;1;8
382;Atžalėlės;Meškiukai;97667536161;Taip;0;7;0;7
383;Atžalėlės;Meškiukai;32165722689;Taip;0;4;0;4
384;Atžalėlės;Meškiukai;59994970570;Taip;0;5;10;15
385;Atžalėlės;Meškiukai;83433461267;Taip;0;15;0;15
386;Atžalėlės;Meškiukai;78909909613;Taip;0;5;0;5
387;Atžalėlės;Meškiukai;46263888918;Taip;4;4;0;8
388;Atžalėlės;Meškiukai;7315734265;Taip;7;1;1;9
389;Atžalėlės;Meškiukai;30776087985;Taip;16;0;1;17
390;Atžalėlės;Meškiukai;939302682;Taip;5;2;0;7
391;Atžalėlės;Meškiukai;40388417436;Taip;2;5;0;7
392;Atžalėlės;Meškiukai;45860181171;Taip;0;8;0;8
393;Atžalėlės;Meškiukai;1512766841;Taip;0;5;1;6
394;Atžalėlės;Meškiukai;76280495364;Taip;0;8;0;8
395;Atžalėlės;Meškiukai;1448431632;Taip;0;10;0;10
396;Atžalėlės;Meškiukai;4702130326;Taip;0;2;0;2
397;Aušrelė;PASAKIUKAI;94997479625;Taip;0;5;0;5
398;Aušrelė;PASAKIUKAI;66290556450;Taip;0;6;0;6
399;Aušrelė;PASAKIUKAI;83702416388;Ne;0;2;0;2
400;Aušrelė;PASAKIUKAI;9759865004;Ne;0;6;1;7
401;Aušrelė;PASAKIUKAI;1552951030;Taip;1;5;0;6
402;Aušrelė;PASAKIUKAI;73000891950;Taip;0;5;0;5
403;Aušrelė;PASAKIUKAI;93192830033;Taip;0;2;0;2
404;Aušrelė;PASAKIUKAI;31870837550;Taip;0;6;3;9
405;Aušrelė;PASAKIUKAI;89564834407;Taip;0;5;0;5
406;Aušrelė;PASAKIUKAI;4475401842;Taip;5;6;0;11
407;Aušrelė;PASAKIUKAI;2771851348;Taip;0;9;0;9
408;Aušrelė;PASAKIUKAI;4988271727;Taip;10;0;2;12
409;Aušrelė;PASAKIUKAI;5713243418;Taip;6;1;1;8
410;Aušrelė;PASAKIUKAI;41231905740;Ne;0;6;0;6
411;Aušrelė;PASAKIUKAI;58007820848;Taip;0;5;2;7
412;Aušrelė;PASAKIUKAI;4631390072;Taip;0;6;0;6
413;Aušrelė;PASAKIUKAI;9221298641;Taip;0;4;0;4
414;Aušrelė;PASAKIUKAI;30654971590;Taip;0;5;0;5
415;Aušrelė;PASAKIUKAI;1496680911;Taip;3;9;0;12
416;Aušrelė;BORUŽĖLĖS;87964799762;Taip;0;12;0;12
417;Aušrelė;BORUŽĖLĖS;61325054660;Taip;0;20;0;20
418;Aušrelė;BORUŽĖLĖS;83835736230;Taip;0;6;0;6
419;Aušrelė;BORUŽĖLĖS;59306871998;Taip;4;4;0;8
420;Aušrelė;BORUŽĖLĖS;48228818029;Taip;9;11;0;20
421;Aušrelė;BORUŽĖLĖS;1392484369;Taip;0;5;8;13
422;Aušrelė;BORUŽĖLĖS;4180888362;Taip;3;7;0;10
423;Aušrelė;BORUŽĖLĖS;20968351121;Taip;8;1;0;9
424;Aušrelė;BORUŽĖLĖS;18340420698;Taip;0;12;1;13
425;Aušrelė;BORUŽĖLĖS;82713803790;Taip;0;3;0;3
426;Aušrelė;BORUŽĖLĖS;1380454183;Taip;0;0;1;1
427;Aušrelė;BORUŽĖLĖS;1155372704;Taip;0;0;9;9
428;Aušrelė;BORUŽĖLĖS;48794175299;Taip;3;0;0;3
429;Aušrelė;BORUŽĖLĖS;1578867221;Taip;0;0;3;3
430;Aušrelė;BORUŽĖLĖS;58941591666;Taip;0;9;0;9
431;Aušrelė;BORUŽĖLĖS;93138986438;Taip;0;3;0;3
432;Aušrelė;BORUŽĖLĖS;1985405666;Taip;0;2;0;2
433;Aušrelė;BORUŽĖLĖS;26547524160;Taip;0;10;0;10
434;Aušrelė;BORUŽĖLĖS;9818954496;Taip;0;5;2;7
435;Aušrelė;BORUŽĖLĖS;6109287607;Taip;0;5;0;5
436;Aušrelė;SMALSUČIAI;76459345433;Ne;0;6;0;6
437;Aušrelė;SMALSUČIAI;17931731597;Taip;0;2;0;2
438;Aušrelė;SMALSUČIAI;74365190360;Taip;0;6;0;6
439;Aušrelė;SMALSUČIAI;1951435363;Taip;0;2;0;2
440;Aušrelė;SMALSUČIAI;3392276890;Taip;0;7;0;7
441;Aušrelė;SMALSUČIAI;14080739740;Taip;0;11;0;11
442;Aušrelė;SMALSUČIAI;73050137188;Taip;0;5;0;5
443;Aušrelė;SMALSUČIAI;49563719275;Taip;0;2;1;3
444;Aušrelė;SMALSUČIAI;7859894371;Taip;0;13;0;13
445;Aušrelė;SMALSUČIAI;1883795851;Taip;0;4;1;5
446;Aušrelė;SMALSUČIAI;68223308125;Ne;0;3;5;8
447;Aušrelė;SMALSUČIAI;90185478786;Taip;0;8;0;8
448;Aušrelė;SMALSUČIAI;95035102498;Taip;0;4;3;7
449;Aušrelė;SMALSUČIAI;26235102809;Taip;0;5;0;5
450;Aušrelė;SMALSUČIAI;42158121278;Taip;5;0;1;6
451;Aušrelė;SMALSUČIAI;78823564616;Taip;0;15;0;15
452;Aušrelė;SMALSUČIAI;1944021609;Taip;0;4;0;4
453;Aušrelė;SMALSUČIAI;1322089393;Taip;0;9;0;9
454;Aušrelė;KODĖLČIUKAI;12032618723;Taip;0;5;0;5
455;Aušrelė;KODĖLČIUKAI;75580617180;Taip;0;8;0;8
456;Aušrelė;KODĖLČIUKAI;24202090947;Taip;0;6;0;6
457;Aušrelė;KODĖLČIUKAI;50864528673;Ne;5;5;0;10
458;Aušrelė;KODĖLČIUKAI;76302896259;Taip;0;14;0;14
459;Aušrelė;KODĖLČIUKAI;2427329184;Taip;8;6;0;14
460;Aušrelė;KODĖLČIUKAI;24201363476;Taip;7;8;0;15
461;Aušrelė;KODĖLČIUKAI;39887348225;Taip;0;6;0;6
462;Aušrelė;KODĖLČIUKAI;46259963888;Taip;0;2;0;2
463;Aušrelė;KODĖLČIUKAI;63497657826;Taip;0;1;0;1
464;Aušrelė;KODĖLČIUKAI;36096756485;Taip;0;4;0;4
465;Aušrelė;KODĖLČIUKAI;1058114795;Taip;5;1;0;6
466;Aušrelė;KODĖLČIUKAI;19415824416;Taip;0;2;0;2
467;Aušrelė;KODĖLČIUKAI;4476948928;Taip;0;1;0;1
468;Aušrelė;KODĖLČIUKAI;44971525276;Taip;0;6;0;6
469;Aušrelė;KODĖLČIUKAI;26185247513;Taip;0;20;0;20
470;Aušrelė;PELĖDŽIUKAI;34891640909;Taip;5;4;0;9
471;Aušrelė;PELĖDŽIUKAI;1792774415;Taip;4;5;0;9
472;Aušrelė;PELĖDŽIUKAI;5955421544;Ne;0;11;0;11
473;Aušrelė;PELĖDŽIUKAI;31441512644;Taip;6;3;0;9
474;Aušrelė;PELĖDŽIUKAI;2030362509;Taip;0;14;0;14
475;Aušrelė;PELĖDŽIUKAI;1296552763;Taip;5;4;0;9
476;Aušrelė;PELĖDŽIUKAI;1160772086;Taip;0;11;0;11
477;Aušrelė;PELĖDŽIUKAI;1352195876;Taip;4;0;0;4
478;Aušrelė;PELĖDŽIUKAI;1599595256;Taip;10;4;0;14
479;Aušrelė;PELĖDŽIUKAI;1539176090;Taip;0;5;0;5
480;Aušrelė;PELĖDŽIUKAI;1868818387;Taip;0;0;1;1
481;Aušrelė;PELĖDŽIUKAI;6909708079;Taip;0;12;0;12
482;Aušrelė;PELĖDŽIUKAI;1506444915;Taip;5;6;0;11
483;Aušrelė;PELĖDŽIUKAI;5304765447;Taip;0;5;0;5
484;Aušrelė;PELĖDŽIUKAI;85739624682;Taip;5;3;0;8
485;Aušrelė;AITVARIUKAI;49583107808;Taip;7;5;0;12
486;Aušrelė;AITVARIUKAI;2045076279;Taip;5;4;0;9
487;Aušrelė;AITVARIUKAI;1153416324;Taip;0;20;0;20
488;Aušrelė;AITVARIUKAI;1340754039;Taip;0;20;0;20
489;Aušrelė;AITVARIUKAI;42721248496;Taip;0;1;0;1
490;Aušrelė;AITVARIUKAI;79695989966;Taip;0;13;0;13
491;Aušrelė;AITVARIUKAI;1045290039;Taip;0;13;0;13
492;Aušrelė;AITVARIUKAI;1511069809;Taip;0;10;0;10
493;Aušrelė;AITVARIUKAI;51119593813;Taip;0;3;0;3
494;Aušrelė;AITVARIUKAI;5813735533;Taip;3;0;1;4
495;Aušrelė;AITVARIUKAI;18117725053;Taip;0;10;0;10
496;Aušrelė;AITVARIUKAI;1036752305;Taip;0;20;0;20
497;Aušrelė;AITVARIUKAI;27629722512;Taip;0;7;0;7
498;Aušrelė;AITVARIUKAI;1830501248;Taip;7;4;0;11
499;Aušrelė;AITVARIUKAI;65369497777;Taip;7;13;0;20
500;Aušrelė;AITVARIUKAI;1388327674;Taip;0;0;2;2
501;Aušrelė;AITVARIUKAI;1750555187;Taip;2;5;0;7
502;Aušrelė;AITVARIUKAI;8221635058;Taip;3;5;0;8
503;Aušrelė;AITVARIUKAI;1163757003;Taip;0;15;0;15
504;Aušrelė;AITVARIUKAI;4865289474;Taip;20;0;0;20
505;Aušrelė;BITUTĖS;2096291405;Taip;0;6;0;6
506;Aušrelė;BITUTĖS;6519246290;Taip;0;13;0;13
507;Aušrelė;BITUTĖS;7915176432;Taip;0;5;0;5
508;Aušrelė;BITUTĖS;2085252423;Taip;0;7;0;7
509;Aušrelė;BITUTĖS;1039658170;Taip;0;7;0;7
510;Aušrelė;BITUTĖS;7887450828;Taip;4;7;0;11
511;Aušrelė;BITUTĖS;1666951645;Taip;0;2;0;2
512;Aušrelė;BITUTĖS;1372660806;Taip;0;3;0;3
513;Aušrelė;BITUTĖS;1958425979;Taip;0;15;0;15
514;Aušrelė;BITUTĖS;59219298991;Taip;0;6;0;6
515;Aušrelė;BITUTĖS;72441793163;Taip;0;18;0;18
516;Aušrelė;ŽIRNIUKAI;6761263775;Taip;0;6;1;7
517;Aušrelė;ŽIRNIUKAI;3015028879;Taip;0;6;0;6
518;Aušrelė;ŽIRNIUKAI;8503309819;Taip;15;0;0;15
519;Aušrelė;ŽIRNIUKAI;3553233149;Taip;10;1;0;11
520;Aušrelė;ŽIRNIUKAI;2827216981;Taip;0;3;0;3
521;Aušrelė;ŽIRNIUKAI;2852596989;Taip;0;10;10;20
522;Aušrelė;ŽIRNIUKAI;7930717076;Taip;5;1;0;6
523;Aušrelė;ŽIRNIUKAI;4942168388;Taip;0;10;3;13
524;Aušrelė;ŽIRNIUKAI;2266390402;Taip;7;5;0;12
525;Aušrelė;ŽIRNIUKAI;8032661062;Taip;0;1;2;3
526;Aušrelė;ŽIRNIUKAI;4262596104;Taip;4;3;0;7
527;Aušrelė;ŽIRNIUKAI;2390128933;Taip;0;6;0;6
528;Aušrelė;ŽIRNIUKAI;9443641849;Taip;8;2;0;10
529;Aušrelė;ŽIRNIUKAI;1556010005;Taip;13;0;0;13
530;Aušrelė;ŽIRNIUKAI;7609339123;Taip;9;5;0;14
531;Aušrelė;ŽIRNIUKAI;7070013052;Taip;5;0;0;5
532;Aušrelė;GRYBUKAI;6002434911;Taip;0;4;0;4
533;Aušrelė;GRYBUKAI;4288695809;Taip;5;2;0;7
534;Aušrelė;GRYBUKAI;3807967685;Taip;15;0;0;15
535;Aušrelė;GRYBUKAI;7327544406;Taip;0;1;0;1
536;Aušrelė;GRYBUKAI;5046027475;Taip;0;5;0;5
537;Aušrelė;GRYBUKAI;9566144610;Taip;5;0;0;5
538;Aušrelė;GRYBUKAI;3320399046;Taip;8;0;0;8
539;Aušrelė;GRYBUKAI;7723159748;Taip;10;5;0;15
540;Aušrelė;GRYBUKAI;7367268748;Taip;10;5;1;16
541;Aušrelė;GRYBUKAI;6109859056;Taip;15;5;0;20
542;Aušrelė;GRYBUKAI;3581155949;Taip;5;0;0;5
543;Aušrelė;GRYBUKAI;2030555139;Taip;4;13;0;17
544;Aušrelė;GRYBUKAI;8338569001;Taip;5;1;0;6
545;Aušrelė;GRYBUKAI;6186758486;Taip;5;5;0;10
546;Aušrelė;DRUGELIAI;1502146844;Taip;5;1;0;6
547;Aušrelė;DRUGELIAI;1408751702;Taip;0;19;0;19
548;Aušrelė;DRUGELIAI;6604681536;Taip;0;12;0;12
549;Aušrelė;DRUGELIAI;4146051969;Taip;0;13;0;13
550;Aušrelė;DRUGELIAI;5055972872;Taip;6;7;0;13
551;Aušrelė;DRUGELIAI;2974714806;Taip;0;17;0;17
552;Aušrelė;DRUGELIAI;5935579452;Taip;0;9;0;9
553;Aušrelė;DRUGELIAI;8960462835;Taip;7;5;0;12
554;Aušrelė;DRUGELIAI;7682402576;Taip;0;7;0;7
555;Aušrelė;DRUGELIAI;5478028396;Taip;12;1;0;13
556;Aušrelė;DRUGELIAI;8372554796;Taip;0;6;0;6
557;Aušrelė;DRUGELIAI;8230362307;Taip;0;5;0;5
558;Aušrelė;DRUGELIAI;2751501830;Taip;0;5;0;5
559;Aušrelė;DRUGELIAI;1327431679;Taip;0;20;0;20
560;Aušrelė;DRUGELIAI;9555255381;Ne;15;1;0;16
561;Aušrelė;DRUGELIAI;9440600785;Taip;0;9;0;9
562;Aušrelė;DRUGELIAI;6037757548;Taip;0;9;0;9
563;Aušrelė;DRUGELIAI;8341539501;Taip;5;0;0;5
564;Aušrelė;DRUGELIAI;6995749373;Taip;6;0;0;6
565;Aušrelė;NYKŠTUKAI;7861208185;Taip;5;0;0;5
566;Aušrelė;NYKŠTUKAI;6886505025;Taip;0;5;0;5
567;Aušrelė;NYKŠTUKAI;6673034329;Taip;15;1;0;16
568;Aušrelė;NYKŠTUKAI;3206495858;Taip;5;0;0;5
569;Aušrelė;NYKŠTUKAI;8243716759;Taip;0;7;0;7
570;Aušrelė;NYKŠTUKAI;5777214701;Taip;10;1;0;11
571;Aušrelė;NYKŠTUKAI;3165692699;Taip;0;5;0;5
572;Aušrelė;NYKŠTUKAI;91282753561;Taip;0;8;0;8
573;Aušrelė;NYKŠTUKAI;4306578299;Taip;8;5;0;13
574;Aušrelė;NYKŠTUKAI;6084682084;Taip;0;5;0;5
575;Aušrelė;NYKŠTUKAI;3682523696;Taip;8;0;0;8
576;Aušrelė;NYKŠTUKAI;1928260563;Taip;0;5;0;5
577;Aušrelė;NYKŠTUKAI;6277405405;Taip;0;11;0;11
578;Aušrelė;NYKŠTUKAI;1543314096;Taip;7;2;0;9
579;Aušrelė;NYKŠTUKAI;1549962200;Taip;0;4;0;4
580;Aušrelė;NYKŠTUKAI;2626569015;Taip;0;10;0;10
581;Aušrelė;NYKŠTUKAI;2574681867;Taip;2;5;0;7
582;Beržynėlis;SVIRPLIUKAI;29356394553;Taip;3;4;0;7
583;Beržynėlis;SVIRPLIUKAI;45685658789;Taip;1;2;0;3
584;Beržynėlis;SVIRPLIUKAI;74856278886;Taip;9;1;0;10
585;Beržynėlis;SVIRPLIUKAI;1207208151;Taip;10;0;0;10
586;Beržynėlis;SVIRPLIUKAI;6690309946;Taip;9;0;0;9
587;Beržynėlis;SVIRPLIUKAI;1895493234;Taip;3;2;0;5
588;Beržynėlis;SVIRPLIUKAI;1583090840;Taip;14;1;0;15
589;Beržynėlis;SVIRPLIUKAI;7289803632;Taip;10;2;0;12
590;Beržynėlis;SVIRPLIUKAI;1682929565;Taip;3;0;0;3
591;Beržynėlis;SVIRPLIUKAI;1612137286;Taip;9;0;0;9
592;Beržynėlis;SVIRPLIUKAI;71505149611;Taip;14;0;0;14
593;Beržynėlis;SVIRPLIUKAI;1395819329;Taip;5;0;1;6
594;Beržynėlis;SVIRPLIUKAI;7248602510;Taip;7;0;0;7
595;Beržynėlis;SVIRPLIUKAI;3641421009;Taip;12;0;0;12
596;Beržynėlis;SVIRPLIUKAI;9566341884;Taip;0;2;0;2
597;Beržynėlis;SVIRPLIUKAI;3278699117;Taip;1;7;0;8
598;Beržynėlis;SVIRPLIUKAI;1838631438;Taip;7;0;0;7
599;Beržynėlis;SVIRPLIUKAI;1639928056;Taip;9;2;0;11
600;Beržynėlis;SVIRPLIUKAI;2681482042;Taip;4;0;0;4
601;Beržynėlis;SVIRPLIUKAI;1136091326;Taip;9;0;0;9
602;Beržynėlis;SVIRPLIUKAI;1516309509;Taip;7;1;0;8
603;Beržynėlis;SVIRPLIUKAI;6395436937;Taip;7;3;0;10
604;Beržynėlis;PELEDŽIUKAI;2121542860;Taip;0;2;9;11
605;Beržynėlis;PELEDŽIUKAI;62077677157;Taip;5;0;0;5
606;Beržynėlis;PELEDŽIUKAI;65579212579;Taip;0;5;3;8
607;Beržynėlis;PELEDŽIUKAI;38733472229;Taip;0;2;2;4
608;Beržynėlis;PELEDŽIUKAI;47133099427;Taip;4;1;0;5
609;Beržynėlis;PELEDŽIUKAI;83976497862;Taip;0;5;0;5
610;Beržynėlis;PELEDŽIUKAI;10345838607;Ne;5;3;0;8
611;Beržynėlis;PELEDŽIUKAI;85094175778;Taip;4;0;0;4
612;Beržynėlis;PELEDŽIUKAI;90464109575;Taip;5;6;0;11
613;Beržynėlis;PELEDŽIUKAI;12603200766;Taip;0;6;0;6
614;Beržynėlis;PELEDŽIUKAI;26390520766;Ne;0;6;0;6
615;Beržynėlis;PELEDŽIUKAI;38966821601;Taip;0;12;0;12
616;Beržynėlis;PELEDŽIUKAI;98803060215;Taip;5;0;5;10
617;Beržynėlis;PELEDŽIUKAI;70579719662;Taip;9;5;0;14
618;Beržynėlis;PELEDŽIUKAI;18199829748;Ne;0;0;1;1
619;Beržynėlis;PELEDŽIUKAI;62599537262;Taip;0;0;3;3
620;Beržynėlis;PELEDŽIUKAI;50307051477;Taip;0;0;1;1
621;Beržynėlis;PELEDŽIUKAI;45266242827;Taip;6;0;0;6
622;Beržynėlis;PELEDŽIUKAI;29838611902;Taip;0;3;0;3
623;Beržynėlis;PELEDŽIUKAI;32134295447;Taip;0;6;0;6
624;Beržynėlis;PELEDŽIUKAI;35916710802;Taip;0;5;0;5
625;Beržynėlis;ŽIOGELIAI;73555363332;Taip;0;11;0;11
626;Beržynėlis;ŽIOGELIAI;9737673167;Taip;5;0;2;7
627;Beržynėlis;ŽIOGELIAI;50686761208;Ne;17;0;0;17
628;Beržynėlis;ŽIOGELIAI;11586645391;Taip;0;0;1;1
629;Beržynėlis;ŽIOGELIAI;19892724367;Taip;13;2;0;15
630;Beržynėlis;ŽIOGELIAI;46844790286;Taip;5;0;0;5
631;Beržynėlis;ŽIOGELIAI;23484694902;Taip;3;5;0;8
632;Beržynėlis;ŽIOGELIAI;6082843533;Taip;0;6;0;6
633;Beržynėlis;ŽIOGELIAI;13290088644;Taip;0;3;0;3
634;Beržynėlis;ŽIOGELIAI;48258183822;Taip;17;0;0;17
635;Beržynėlis;ŽIOGELIAI;87966535672;Taip;0;2;0;2
636;Beržynėlis;ŽIOGELIAI;48768116923;Taip;5;0;0;5
637;Beržynėlis;ŽIOGELIAI;80418262829;Taip;1;7;0;8
638;Beržynėlis;ŽIOGELIAI;69508373227;Taip;0;16;0;16
639;Beržynėlis;ŽIOGELIAI;59717323779;Ne;0;6;0;6
640;Beržynėlis;ŽIOGELIAI;6002421623;Ne;0;17;0;17
641;Beržynėlis;ŽIOGELIAI;69893760439;Taip;10;1;0;11
642;Beržynėlis;ŽIOGELIAI;1893270997;Taip;5;2;0;7
643;Beržynėlis;ŽIOGELIAI;9035951859;Taip;0;2;3;5
644;Beržynėlis;ŽIOGELIAI;5114301953;Taip;0;13;0;13
645;Beržynėlis;ŽVIRBLIUKAI;7520394353;Taip;0;7;0;7
646;Beržynėlis;ŽVIRBLIUKAI;95544821432;Taip;0;7;1;8
647;Beržynėlis;ŽVIRBLIUKAI;1426962644;Taip;0;7;2;9
648;Beržynėlis;ŽVIRBLIUKAI;1527942602;Taip;0;7;0;7
649;Beržynėlis;ŽVIRBLIUKAI;1910024785;Taip;20;0;0;20
650;Beržynėlis;ŽVIRBLIUKAI;1367442186;Taip;10;0;0;10
651;Beržynėlis;ŽVIRBLIUKAI;1464556813;Taip;0;10;0;10
652;Beržynėlis;ŽVIRBLIUKAI;1945230630;Taip;16;0;0;16
653;Beržynėlis;ŽVIRBLIUKAI;1466742506;Taip;0;8;1;9
654;Beržynėlis;ŽVIRBLIUKAI;1578089280;Taip;0;5;0;5
655;Beržynėlis;ŽVIRBLIUKAI;96946855305;Taip;0;14;0;14
656;Beržynėlis;ŽVIRBLIUKAI;87592204193;Taip;0;8;0;8
657;Beržynėlis;ŽVIRBLIUKAI;62962970458;Taip;12;5;0;17
658;Beržynėlis;ŽVIRBLIUKAI;17743947386;Taip;0;6;0;6
659;Beržynėlis;ŽVIRBLIUKAI;80762814965;Taip;0;0;10;10
660;Beržynėlis;ŽVIRBLIUKAI;30539063473;Taip;5;0;0;5
661;Beržynėlis;ŽVIRBLIUKAI;1885972165;Taip;10;0;0;10
662;Beržynėlis;ŽVIRBLIUKAI;75283423384;Taip;4;1;0;5
663;Beržynėlis;ŽVIRBLIUKAI;81022321678;Taip;5;0;1;6
664;Beržynėlis;ŽVIRBLIUKAI;1391844432;Taip;12;2;1;15
665;Beržynėlis;ŽVIRBLIUKAI;1014895926;Taip;12;2;1;15
666;Beržynėlis;ŽIRNIUKAI;6334152631;Taip;15;3;0;18
667;Beržynėlis;ŽIRNIUKAI;2971686368;Taip;5;0;0;5
668;Beržynėlis;ŽIRNIUKAI;8591800387;Taip;6;0;0;6
669;Beržynėlis;ŽIRNIUKAI;7589778533;Taip;0;3;0;3
670;Beržynėlis;ŽIRNIUKAI;4577837021;Taip;20;0;0;20
671;Beržynėlis;ŽIRNIUKAI;5473666098;Taip;0;3;0;3
672;Beržynėlis;ŽIRNIUKAI;6739927917;Taip;5;0;0;5
673;Beržynėlis;ŽIRNIUKAI;9503352345;Taip;11;0;0;11
674;Beržynėlis;ŽIRNIUKAI;5189335842;Taip;15;4;0;19
675;Beržynėlis;ŽIRNIUKAI;6293884233;Taip;5;0;0;5
676;Beržynėlis;ŽIRNIUKAI;4270889499;Taip;4;0;0;4
677;Beržynėlis;ŽIRNIUKAI;3209966996;Taip;4;5;0;9
678;Beržynėlis;ŽIRNIUKAI;6218165554;Taip;5;0;0;5
679;Beržynėlis;VIŠČIUKAI;9996171088;Taip;7;2;0;9
680;Beržynėlis;VIŠČIUKAI;8688852668;Taip;0;1;0;1
681;Beržynėlis;VIŠČIUKAI;3149966189;Taip;0;0;2;2
682;Beržynėlis;VIŠČIUKAI;6713134631;Taip;1;1;0;2
683;Beržynėlis;VIŠČIUKAI;5593146590;Taip;1;1;0;2
684;Beržynėlis;VIŠČIUKAI;9540292311;Taip;5;0;0;5
685;Beržynėlis;VIŠČIUKAI;8297427176;Taip;0;2;1;3
686;Beržynėlis;VIŠČIUKAI;1325972861;Taip;0;7;0;7
687;Beržynėlis;VIŠČIUKAI;4035764376;Taip;13;1;0;14
688;Beržynėlis;VIŠČIUKAI;5308596559;Taip;15;3;0;18
689;Beržynėlis;VIŠČIUKAI;8881566865;Taip;6;0;2;8
690;Beržynėlis;VIŠČIUKAI;5194416351;Taip;7;2;0;9
691;Beržynėlis;VIŠČIUKAI;9754455116;Taip;10;5;0;15
692;Beržynėlis;VIŠČIUKAI;5069929376;Taip;9;0;9;18
693;Bildukas;"Svetliački savaitinė";39959905586;Taip;0;10;0;10
694;Bildukas;"Svetliački savaitinė";40673143772;Taip;0;2;0;2
695;Bildukas;"Svetliački savaitinė";51199543540;Taip;0;7;3;10
696;Bildukas;"Svetliački savaitinė";10255936371;Taip;5;3;1;9
697;Bildukas;"Svetliački savaitinė";1882022060;Taip;15;5;0;20
698;Bildukas;"Svetliački savaitinė";80327840821;Taip;6;0;6;12
699;Bildukas;"Svetliački savaitinė";96874940646;Taip;5;3;1;9
700;Bildukas;"Svetliački savaitinė";27240409925;Taip;10;5;0;15
701;Bildukas;"Svetliački savaitinė";6441340680;Taip;0;8;0;8
702;Bildukas;"Svetliački savaitinė";5968419467;Taip;0;7;0;7
703;Bildukas;"Svetliački savaitinė";1029617146;Taip;3;3;0;6
704;Bildukas;"Svetliački savaitinė";1643122874;Taip;8;5;0;13
705;Bildukas;"Svetliački savaitinė";8968652761;Taip;0;2;0;2
706;Bildukas;"Svetliački savaitinė";70033583066;Taip;0;9;0;9
707;Bildukas;"Svetliački savaitinė";75301544496;Taip;5;0;0;5
708;Bildukas;"Svetliački savaitinė";1023163775;Ne;15;3;0;18
709;Bildukas;"Svetliački savaitinė";13885215871;Taip;6;0;0;6
710;Bildukas;"Svetliački savaitinė";25050688839;Ne;2;11;0;13
711;Bildukas;"Svetliački savaitinė";57163941360;Taip;0;6;0;6
712;Bildukas;"Svetliački savaitinė";49294883079;Ne;0;1;0;1
713;Bildukas;"Svetliački savaitinė";9535522910;Ne;0;4;3;7
714;Bildukas;"Svetliački savaitinė";1183272346;Taip;0;2;0;2
715;Bildukas;"Svetliački savaitinė";1165636981;Taip;6;1;0;7
716;Bildukas;"Zaičiata savaitinė ( keli alergiški vaikai)";9229489686;Taip;0;0;7;7
717;Bildukas;"Zaičiata savaitinė ( keli alergiški vaikai)";3531285331;Taip;0;6;7;13
718;Bildukas;"Zaičiata savaitinė ( keli alergiški vaikai)";3654667879;Taip;7;5;0;12
719;Bildukas;"Zaičiata savaitinė ( keli alergiški vaikai)";2091204077;Taip;0;9;0;9
720;Bildukas;"Zaičiata savaitinė ( keli alergiški vaikai)";1047459617;Taip;0;3;0;3
721;Bildukas;"Zaičiata savaitinė ( keli alergiški vaikai)";8382899180;Taip;15;0;0;15
722;Bildukas;"Zaičiata savaitinė ( keli alergiški vaikai)";1486878343;Taip;15;0;0;15
723;Bildukas;"Zaičiata savaitinė ( keli alergiški vaikai)";9756326725;Taip;11;5;1;17
724;Bildukas;"Zaičiata savaitinė ( keli alergiški vaikai)";5794471794;Taip;8;3;0;11
725;Bildukas;"Zaičiata savaitinė ( keli alergiški vaikai)";4392299046;Taip;15;0;2;17
726;Bildukas;"Zaičiata savaitinė ( keli alergiški vaikai)";9835391223;Taip;20;0;0;20
727;Bildukas;"Zaičiata savaitinė ( keli alergiški vaikai)";9156801640;Taip;6;7;0;13
728;Bildukas;"Zaičiata savaitinė ( keli alergiški vaikai)";4112888719;Taip;0;5;5;10
729;Bildukas;Gnomiki;1125206576;Taip;0;18;0;18
730;Bildukas;Gnomiki;7898746258;Taip;5;0;0;5
731;Bildukas;Gnomiki;1376514473;Taip;0;13;1;14
732;Bildukas;Gnomiki;4014493868;Taip;5;12;0;17
733;Bildukas;Gnomiki;4623727349;Taip;20;0;0;20
734;Bildukas;Gnomiki;4377803110;Taip;0;2;0;2
735;Bildukas;Gnomiki;5217751936;Taip;12;7;0;19
736;Bildukas;Gnomiki;9569296370;Taip;15;0;2;17
737;Bildukas;Gnomiki;6548776238;Taip;0;0;20;20
738;Bildukas;Gnomiki;6388514464;Taip;5;12;0;17
739;Bildukas;Gnomiki;3226370339;Taip;0;1;6;7
740;Bildukas;Zvonočki;1475108434;Taip;7;1;2;10
741;Bildukas;Zvonočki;60443994539;Ne;0;5;5;10
742;Bildukas;Zvonočki;4866401336;Taip;0;4;0;4
743;Bildukas;Zvonočki;12186791267;Taip;10;2;0;12
744;Bildukas;Zvonočki;16923577010;Ne;4;1;0;5
745;Bildukas;Zvonočki;84771452636;Ne;0;6;2;8
746;Bildukas;Zvonočki;1180357950;Taip;5;6;1;12
747;Bildukas;Zvonočki;99302309410;Taip;7;5;0;12
748;Bildukas;Zvonočki;52281960273;Taip;10;0;0;10
749;Bildukas;Zvonočki;48069555680;Taip;20;0;0;20
750;Bildukas;Zvonočki;82932493433;Taip;10;8;0;18
751;Bildukas;Zvonočki;1409708149;Taip;0;10;1;11
752;Bildukas;Zvonočki;91777282521;Taip;0;11;0;11
753;Bildukas;Zvonočki;1713133196;Taip;0;0;5;5
754;Bildukas;Zvonočki;1956741726;Taip;13;0;0;13
755;Bildukas;Zvonočki;1234033395;Ne;5;0;0;5
756;Bildukas;Zvonočki;9575263475;Taip;7;0;0;7
757;Bildukas;Zvonočki;4404602365;Taip;6;6;0;12
758;Birutės;SKRUZDELIUKŲ;83624863787;Taip;0;6;0;6
759;Birutės;SKRUZDELIUKŲ;29496817352;Taip;0;2;0;2
760;Birutės;SKRUZDELIUKŲ;8361780904;Taip;0;5;0;5
761;Birutės;SKRUZDELIUKŲ;78964625621;Taip;1;5;0;6
762;Birutės;SKRUZDELIUKŲ;99346448051;Taip;2;5;0;7
763;Birutės;SKRUZDELIUKŲ;19076257808;Taip;3;0;0;3
764;Birutės;SKRUZDELIUKŲ;85127282520;Taip;8;0;0;8
765;Birutės;SKRUZDELIUKŲ;99534190736;Taip;0;1;0;1
766;Birutės;SKRUZDELIUKŲ;64883674106;Taip;2;5;0;7
767;Birutės;SKRUZDELIUKŲ;82541767644;Taip;0;0;1;1
768;Birutės;SKRUZDELIUKŲ;92392234959;Taip;10;2;0;12
769;Birutės;SKRUZDELIUKŲ;83120545528;Taip;0;5;0;5
770;Birutės;SKRUZDELIUKŲ;5948430712;Taip;7;0;0;7
771;Birutės;SKRUZDELIUKŲ;1227083798;Taip;0;5;0;5
772;Birutės;SKRUZDELIUKŲ;19555366863;Taip;5;5;0;10
773;Birutės;SKRUZDELIUKŲ;1517824834;Taip;0;5;0;5
774;Birutės;SKRUZDELIUKŲ;43601620086;Taip;0;9;4;13
775;Birutės;SKRUZDELIUKŲ;66276243365;Taip;0;5;0;5
776;Birutės;SKRUZDELIUKŲ;5360951559;Ne;6;0;0;6
777;Birutės;SKRUZDELIUKŲ;1123582705;Taip;14;0;0;14
778;Birutės;BITUČIŲ;7678475961;Ne;5;0;0;5
779;Birutės;BITUČIŲ;1599159924;Taip;8;0;1;9
780;Birutės;BITUČIŲ;4427232735;Taip;0;0;5;5
781;Birutės;BITUČIŲ;33770983649;Taip;0;16;1;17
782;Birutės;BITUČIŲ;87693588654;Taip;3;4;0;7
783;Birutės;BITUČIŲ;2975442228;Taip;20;0;0;20
784;Birutės;BITUČIŲ;5770026060;Taip;2;0;0;2
785;Birutės;BITUČIŲ;98391790116;Taip;10;0;2;12
786;Birutės;BITUČIŲ;5947971037;Taip;0;4;0;4
787;Birutės;BITUČIŲ;3870702348;Taip;0;0;1;1
788;Birutės;BITUČIŲ;7149060118;Taip;9;1;0;10
789;Birutės;BITUČIŲ;1064449916;Taip;0;1;0;1
790;Birutės;BITUČIŲ;3436637062;Taip;5;0;0;5
791;Birutės;BITUČIŲ;6748290604;Taip;0;0;2;2
792;Birutės;BITUČIŲ;9769645272;Taip;13;0;0;13
793;Birutės;BITUČIŲ;7237104750;Taip;0;5;0;5
794;Birutės;BITUČIŲ;8465645434;Taip;6;0;3;9
795;Birutės;BITUČIŲ;6006110601;Taip;3;0;1;4
796;Birutės;BITUČIŲ;9722922540;Taip;5;5;0;10
797;Birutės;BITUČIŲ;5018151097;Taip;17;0;0;17
798;Birutės;BITUČIŲ;6115354862;Taip;20;0;0;20
799;Birutės;BITUČIŲ;7386694567;Taip;8;0;2;10
800;Birutės;BITUČIŲ;7856891698;Taip;0;1;0;1
801;Birutės;BORUŽIUKAI;40376432941;Taip;0;6;0;6
802;Birutės;BORUŽIUKAI;83627433055;Taip;0;2;1;3
803;Birutės;BORUŽIUKAI;44098551169;Taip;5;4;6;15
804;Birutės;BORUŽIUKAI;1228407191;Taip;10;0;0;10
805;Birutės;BORUŽIUKAI;76900751891;Taip;6;1;0;7
806;Birutės;BORUŽIUKAI;78441249067;Taip;0;16;0;16
807;Birutės;BORUŽIUKAI;1735549924;Taip;12;0;1;13
808;Birutės;BORUŽIUKAI;1427891290;Taip;0;10;0;10
809;Birutės;BORUŽIUKAI;44844176536;Taip;0;4;0;4
810;Birutės;BORUŽIUKAI;81284166606;Taip;3;1;0;4
811;Birutės;BORUŽIUKAI;2014751710;Ne;4;0;0;4
812;Birutės;BORUŽIUKAI;22452517583;Taip;0;5;0;5
813;Birutės;BORUŽIUKAI;9450257904;Taip;14;2;0;16
814;Birutės;BORUŽIUKAI;1473662465;Taip;0;0;9;9
815;Birutės;BORUŽIUKAI;1596098119;Taip;5;0;0;5
816;Birutės;BORUŽIUKAI;60466633757;Taip;17;0;2;19
817;Birutės;BORUŽIUKAI;4217246188;Taip;10;10;0;20
818;Birutės;BORUŽIUKAI;70370187632;Taip;0;1;0;1
819;Birutės;DRUGELIAI;1884820602;Taip;6;1;0;7
820;Birutės;DRUGELIAI;77244600491;Taip;10;0;0;10
821;Birutės;DRUGELIAI;49162494334;Taip;11;2;0;13
822;Birutės;DRUGELIAI;22036269009;Taip;16;1;0;17
823;Birutės;DRUGELIAI;3213573357;Taip;12;0;0;12
824;Birutės;DRUGELIAI;6601619845;Taip;10;0;1;11
825;Birutės;DRUGELIAI;6880300182;Taip;7;0;0;7
826;Birutės;DRUGELIAI;23540610503;Taip;0;1;0;1
827;Birutės;DRUGELIAI;3490951066;Taip;0;2;0;2
828;Birutės;DRUGELIAI;1163666527;Taip;0;0;3;3
829;Birutės;DRUGELIAI;32780299044;Taip;13;0;0;13
830;Birutės;DRUGELIAI;1346957081;Taip;16;0;0;16
831;Birutės;DRUGELIAI;88939598407;Taip;7;5;0;12
832;Birutės;DRUGELIAI;1950295916;Taip;5;7;0;12
833;Birutės;DRUGELIAI;5272792732;Taip;10;0;2;12
834;Birutės;DRUGELIAI;9886554192;Ne;9;0;0;9
835;Birutės;DRUGELIAI;9662009307;Taip;20;0;0;20
836;Birutės;DRUGELIAI;32821891070;Taip;20;0;0;20
837;Birutės;DRUGELIAI;3682136019;Ne;2;0;3;5
838;Birutės;DRUGELIAI;53416654439;Taip;10;4;0;14
839;Bitutė;Aitvariukų;6674923740;Taip;0;2;0;2
840;Bitutė;Aitvariukų;8394685672;Taip;12;1;0;13
841;Bitutė;Aitvariukų;3796188100;Taip;7;0;0;7
842;Bitutė;Aitvariukų;1564763789;Taip;0;2;0;2
843;Bitutė;Aitvariukų;1846974702;Taip;6;4;1;11
844;Bitutė;Aitvariukų;1162903905;Taip;4;0;0;4
845;Bitutė;Aitvariukų;1560715159;Taip;10;7;0;17
846;Bitutė;Aitvariukų;7456328992;Taip;9;2;0;11
847;Bitutė;Aitvariukų;2518730247;Taip;10;7;0;17
848;Bitutė;Aitvariukų;5810344229;Taip;4;5;0;9
849;Bitutė;Aitvariukų;5895868876;Taip;5;2;1;8
850;Bitutė;Aitvariukų;8743734366;Taip;4;8;0;12
851;Bitutė;Aitvariukų;7036780275;Taip;20;0;0;20
852;Bitutė;Aitvariukų;2804203556;Taip;13;1;2;16
853;Bitutė;Aitvariukų;5455919343;Taip;0;3;2;5
854;Bitutė;Aitvariukų;6737174004;Taip;0;15;0;15
855;Bitutė;Aitvariukų;3432065233;Taip;4;2;0;6
856;Bitutė;Aitvariukų;5679397165;Taip;5;8;0;13
857;Bitutė;Ežiukų;78233050805;Taip;4;7;0;11
858;Bitutė;Ežiukų;25827361426;Taip;0;5;2;7
859;Bitutė;Ežiukų;43167655810;Taip;5;0;0;5
860;Bitutė;Ežiukų;38137764071;Taip;0;12;0;12
861;Bitutė;Ežiukų;40949937934;Taip;0;5;0;5
862;Bitutė;Ežiukų;67601917966;Taip;0;5;0;5
863;Bitutė;Ežiukų;89380579477;Taip;1;3;1;5
864;Bitutė;Ežiukų;99245885176;Taip;0;5;0;5
865;Bitutė;Ežiukų;63533171001;Taip;5;1;5;11
866;Bitutė;Ežiukų;75254163778;Taip;10;6;0;16
867;Bitutė;Ežiukų;21280284948;Taip;0;5;0;5
868;Bitutė;Ežiukų;1262030751;Taip;11;3;1;15
869;Bitutė;Ežiukų;57841590670;Taip;5;5;0;10
870;Bitutė;Ežiukų;56287634684;Taip;6;5;0;11
871;Bitutė;Ežiukų;4315172747;Taip;3;0;0;3
872;Bitutė;Ežiukų;9838379838;Taip;5;11;0;16
873;Bitutė;Ežiukų;42098027592;Taip;2;7;0;9
874;Bitutė;Ežiukų;17953339860;Taip;0;7;0;7
875;Bitutė;Žvirbliukų;5513662035;Taip;0;5;0;5
876;Bitutė;Žvirbliukų;76504719475;Taip;13;0;0;13
877;Bitutė;Žvirbliukų;96246198900;Taip;0;1;0;1
878;Bitutė;Žvirbliukų;40578882341;Taip;5;5;0;10
879;Bitutė;Žvirbliukų;73214901448;Taip;0;4;2;6
880;Bitutė;Žvirbliukų;239058855;Taip;0;0;5;5
881;Bitutė;Žvirbliukų;94263857872;Taip;5;3;0;8
882;Bitutė;Žvirbliukų;4311138099;Taip;5;0;8;13
883;Bitutė;Žvirbliukų;87682328632;Taip;15;1;0;16
884;Bitutė;Žvirbliukų;93097026538;Taip;0;0;1;1
885;Bitutė;Žvirbliukų;2004079473;Taip;0;8;2;10
886;Bitutė;Žvirbliukų;2045667491;Taip;0;8;2;10
887;Bitutė;Žvirbliukų;1342209916;Taip;0;1;0;1
888;Bitutė;Žvirbliukų;1799005979;Taip;0;0;2;2
889;Bitutė;Žvirbliukų;1235354320;Taip;0;5;0;5
890;Bitutė;Žvirbliukų;1086803168;Taip;5;11;0;16
891;Bitutė;Žvirbliukų;54838528906;Taip;0;5;1;6
892;Bitutė;Žvirbliukų;5365203210;Taip;0;1;0;1
893;Bitutė;Žvirbliukų;13826670333;Taip;0;0;1;1
894;Bitutė;Gandriukų;3966405515;Taip;1;4;0;5
895;Bitutė;Gandriukų;7514115839;Taip;0;1;0;1
896;Bitutė;Gandriukų;51971919596;Taip;0;5;0;5
897;Bitutė;Gandriukų;1344880094;Taip;0;9;0;9
898;Bitutė;Gandriukų;98415490683;Taip;0;12;0;12
899;Bitutė;Gandriukų;23567520688;Taip;10;0;0;10
900;Bitutė;Gandriukų;81321203386;Taip;10;0;0;10
901;Bitutė;Gandriukų;11791642887;Taip;0;1;0;1
902;Bitutė;Gandriukų;79414646688;Taip;0;5;4;9
903;Bitutė;Gandriukų;53324014378;Taip;8;3;2;13
904;Bitutė;Gandriukų;93924466303;Taip;0;6;0;6
905;Bitutė;Gandriukų;85983344716;Taip;2;6;0;8
906;Bitutė;Gandriukų;2144684074;Taip;0;1;0;1
907;Bitutė;Gandriukų;27322436232;Taip;0;5;0;5
908;Bitutė;Gandriukų;69158292877;Taip;0;12;0;12
909;Bitutė;Gandriukų;12362142191;Taip;0;5;0;5
910;Bitutė;Gandriukų;66620895469;Taip;0;8;0;8
911;Bitutė;Gandriukų;1131101584;Taip;0;2;5;7
912;Bitutė;Pelėdžiukai;33881269329;Taip;0;3;0;3
913;Bitutė;Pelėdžiukai;72420328957;Taip;3;6;0;9
914;Bitutė;Pelėdžiukai;67449612148;Taip;0;1;0;1
915;Bitutė;Pelėdžiukai;1947476206;Taip;0;1;0;1
916;Bitutė;Pelėdžiukai;7262132445;Taip;0;5;2;7
917;Bitutė;Pelėdžiukai;69535700910;Taip;0;2;0;2
918;Bitutė;Pelėdžiukai;6951613601;Taip;5;5;1;11
919;Bitutė;Pelėdžiukai;44798518501;Taip;8;5;0;13
920;Bitutė;Pelėdžiukai;83983037344;Taip;0;2;0;2
921;Bitutė;Pelėdžiukai;70745977571;Taip;0;5;0;5
922;Bitutė;Pelėdžiukai;28682412356;Taip;0;5;0;5
923;Bitutė;Pelėdžiukai;63918223424;Taip;0;9;0;9
924;Bitutė;Pelėdžiukai;3850772845;Taip;0;1;0;1
925;Bitutė;Pelėdžiukai;1347785713;Taip;0;1;0;1
926;Bitutė;Pelėdžiukai;28604993900;Taip;9;0;0;9
927;Bitutė;Pelėdžiukai;82195110042;Taip;0;7;0;7
928;Bitutė;Pelėdžiukai;1915447382;Ne;0;1;0;1
929;Bitutė;Pelėdžiukai;53488410946;Taip;0;3;0;3
930;Bitutė;Pelėdžiukai;68998683110;Taip;0;5;3;8
931;Bitutė;Boružėlių;8519978626;Taip;2;1;2;5
932;Bitutė;Boružėlių;6586888742;Taip;0;10;1;11
933;Bitutė;Boružėlių;5783154071;Taip;1;8;0;9
934;Bitutė;Boružėlių;6052204491;Taip;2;0;0;2
935;Bitutė;Boružėlių;37105491775;Taip;15;0;5;20
936;Bitutė;Boružėlių;50869152455;Taip;3;5;0;8
937;Bitutė;Boružėlių;1783776913;Taip;0;1;4;5
938;Bitutė;Boružėlių;9683582019;Taip;0;0;2;2
939;Bitutė;Boružėlių;7352524951;Taip;5;9;0;14
940;Bitutė;Boružėlių;27144303911;Taip;11;0;0;11
941;Bitutė;Boružėlių;1802887869;Taip;7;2;2;11
942;Bitutė;Boružėlių;51054491845;Taip;8;1;2;11
943;Bitutė;Boružėlių;5653055907;Taip;5;3;3;11
944;Bitutė;Boružėlių;1809034174;Taip;18;0;0;18
945;Bitutė;Boružėlių;5644789669;Taip;11;0;0;11
946;Bitutė;Boružėlių;2350260809;Taip;15;0;1;16
947;Bitutė;Boružėlių;3980455738;Taip;0;10;0;10
948;Bitutė;Boružėlių;6678928989;Taip;10;2;2;14
949;Bitutė;Šokliukų;2775304620;Taip;9;2;0;11
950;Bitutė;Šokliukų;22504941477;Taip;6;0;0;6
951;Bitutė;Šokliukų;84694903978;Taip;0;5;0;5
952;Bitutė;Šokliukų;1385876629;Taip;5;1;1;7
953;Bitutė;Šokliukų;4054959628;Taip;0;2;0;2
954;Bitutė;Šokliukų;2104500642;Taip;0;7;0;7
955;Bitutė;Šokliukų;71957147569;Taip;0;2;0;2
956;Bitutė;Šokliukų;74038944722;Taip;0;6;0;6
957;Bitutė;Šokliukų;9314363274;Taip;0;20;0;20
958;Bitutė;Šokliukų;1703630417;Taip;8;3;0;11
959;Bitutė;Šokliukų;80788107109;Taip;0;0;1;1
960;Bitutė;Šokliukų;14787330368;Taip;4;1;0;5
961;Bitutė;Šokliukų;11128936533;Taip;0;1;3;4
962;Bitutė;Šokliukų;26573486858;Taip;3;0;0;3
963;Bitutė;Šokliukų;1709788155;Taip;0;2;1;3
964;Bitutė;Šokliukų;6591291681;Taip;0;1;0;1
965;Bitutė;Šokliukų;86636444738;Taip;0;9;0;9
966;Bitutė;Šokliukų;1956718350;Taip;0;0;4;4
967;Bitutė;Drugelių;1861373542;Taip;0;5;0;5
968;Bitutė;Drugelių;57770829048;Taip;0;2;0;2
969;Bitutė;Drugelių;56620848568;Taip;5;9;0;14
970;Bitutė;Drugelių;7236048627;Taip;8;0;0;8
971;Bitutė;Drugelių;2049938111;Taip;1;0;0;1
972;Bitutė;Drugelių;58668298206;Taip;9;3;0;12
973;Bitutė;Drugelių;1863634233;Taip;10;0;0;10
974;Bitutė;Drugelių;9550491607;Taip;3;9;0;12
975;Bitutė;Drugelių;48695762145;Taip;0;1;0;1
976;Bitutė;Drugelių;3982159333;Taip;7;2;4;13
977;Bitutė;Drugelių;29300327608;Taip;2;5;0;7
978;Bitutė;Drugelių;50605497381;Taip;0;11;0;11
979;Bitutė;Drugelių;1030677273;Taip;0;8;0;8
980;Bitutė;Drugelių;92700808654;Ne;3;0;0;3
981;Bitutė;Drugelių;3319657847;Taip;6;0;2;8
982;Bitutė;Kiškučių;1926912966;Taip;9;4;2;15
983;Bitutė;Kiškučių;41598049089;Taip;0;6;0;6
984;Bitutė;Kiškučių;20823074269;Taip;5;0;3;8
985;Bitutė;Kiškučių;2004589442;Taip;3;9;0;12
986;Bitutė;Kiškučių;1514919519;Taip;0;6;0;6
987;Bitutė;Kiškučių;2007360730;Taip;0;1;0;1
988;Bitutė;Kiškučių;1756799209;Taip;0;5;3;8
989;Bitutė;Kiškučių;7858925572;Taip;0;3;2;5
990;Bitutė;Kiškučių;1946893053;Taip;0;8;0;8
991;Bitutė;Kiškučių;20308800957;Taip;0;5;0;5
992;Bitutė;Kiškučių;39963735248;Taip;1;0;0;1
993;Bitutė;Kiškučių;55394933894;Taip;0;11;0;11
994;Bitutė;Kiškučių;34076798361;Taip;0;5;5;10
995;Bitutė;Kiškučių;83034164893;Taip;0;6;0;6
996;Bitutė;Kiškučių;28698703670;Taip;0;5;0;5
997;Bitutė;Kiškučių;51014007755;Taip;0;9;0;9
998;Bitutė;Kiškučių;85845989245;Taip;0;5;0;5
999;Bitutė;Kiškučių;23952001143;Taip;2;6;0;8
1000;Bitutė;Kiškučių;55763538285;Taip;0;0;10;10
1001;Bitutė;Kiškučių;55722176820;Taip;0;11;0;11
1002;Bitutė;Kiškučių;16096919364;Ne;0;7;0;7
1003;Bitutė;"Viščiukų ";3723040682;Taip;0;6;0;6
1004;Bitutė;"Viščiukų ";3804171750;Taip;0;3;0;3
1005;Bitutė;"Viščiukų ";8545377054;Taip;0;2;0;2
1006;Bitutė;"Viščiukų ";5406667195;Taip;0;8;0;8
1007;Bitutė;"Viščiukų ";4458990772;Taip;0;5;3;8
1008;Bitutė;"Viščiukų ";7113693496;Taip;5;0;5;10
1009;Bitutė;"Viščiukų ";8186706520;Taip;0;20;0;20
1010;Bitutė;"Viščiukų ";6044969600;Taip;10;4;0;14
1011;Bitutė;"Viščiukų ";9602659259;Taip;17;0;0;17
1012;Bitutė;"Viščiukų ";2190439190;Taip;5;0;0;5
1013;Bitutė;"Viščiukų ";9855080887;Taip;0;4;0;4
1014;Bitutė;"Viščiukų ";4177331531;Taip;9;2;0;11
1015;Bitutė;"Viščiukų ";2483462846;Taip;10;6;0;16
1016;Bitutė;"Viščiukų ";2886154457;Taip;0;0;1;1
1017;Bitutė;"Viščiukų ";7678106084;Taip;0;1;0;1
1018;Bitutė;"Skruzdėliukai ";37364063140;Taip;0;5;0;5
1019;Bitutė;"Skruzdėliukai ";95252521365;Taip;10;0;0;10
1020;Bitutė;"Skruzdėliukai ";1590580158;Taip;0;7;0;7
1021;Bitutė;"Skruzdėliukai ";5910842956;Taip;10;0;0;10
1022;Bitutė;"Skruzdėliukai ";1913421864;Taip;0;14;0;14
1023;Bitutė;"Skruzdėliukai ";38436660859;Taip;0;5;1;6
1024;Bitutė;"Skruzdėliukai ";2031043488;Taip;0;8;0;8
1025;Bitutė;"Skruzdėliukai ";55469634385;Taip;0;6;2;8
1026;Bitutė;"Skruzdėliukai ";1130379531;Taip;5;5;0;10
1027;Bitutė;"Skruzdėliukai ";87960363246;Taip;0;0;1;1
1028;Bitutė;"Skruzdėliukai ";1064809221;Taip;20;0;0;20
1029;Bitutė;"Skruzdėliukai ";1521753712;Taip;20;0;0;20
1030;Bitutė;"Skruzdėliukai ";1307910515;Taip;0;1;3;4
1031;Bitutė;"Skruzdėliukai ";2311037144;Taip;0;2;0;2
1032;Bitutė;"Skruzdėliukai ";41659768159;Taip;8;5;1;14
1033;Bitutė;"Skruzdėliukai ";1878172874;Taip;4;0;0;4
1034;Bitutė;"Skruzdėliukai ";5886190377;Taip;5;3;0;8
1035;Bitutė;"Skruzdėliukai ";61233878620;Taip;17;0;0;17
1036;Bitutė;"Nykštukų ";1733189730;Taip;0;6;0;6
1037;Bitutė;"Nykštukų ";2740656695;Taip;15;0;0;15
1038;Bitutė;"Nykštukų ";4764586168;Taip;14;3;0;17
1039;Bitutė;"Nykštukų ";5126303823;Taip;9;0;2;11
1040;Bitutė;"Nykštukų ";1904108612;Taip;0;2;1;3
1041;Bitutė;"Nykštukų ";5109258680;Taip;0;0;3;3
1042;Bitutė;"Nykštukų ";1423694056;Taip;5;0;0;5
1043;Bitutė;"Nykštukų ";2812580726;Taip;0;1;4;5
1044;Bitutė;"Nykštukų ";1662815358;Taip;5;0;1;6
1045;Bitutė;"Nykštukų ";9966437881;Taip;14;0;0;14
1046;Bitutė;"Nykštukų ";6169426273;Taip;8;5;1;14
1047;Bitutė;"Nykštukų ";9166624750;Taip;20;0;0;20
1048;Coliukė;DRUGELIAI;4408284518;Taip;0;15;0;15
1049;Coliukė;DRUGELIAI;3919482569;Taip;8;5;0;13
1050;Coliukė;DRUGELIAI;3346269598;Taip;6;0;2;8
1051;Coliukė;DRUGELIAI;1600495468;Taip;11;3;0;14
1052;Coliukė;DRUGELIAI;9183391434;Taip;5;3;0;8
1053;Coliukė;DRUGELIAI;2159103903;Taip;0;4;0;4
1054;Coliukė;DRUGELIAI;1458763954;Taip;14;0;0;14
1055;Coliukė;DRUGELIAI;7920728387;Taip;7;9;0;16
1056;Coliukė;DRUGELIAI;6972921877;Taip;20;0;0;20
1057;Coliukė;DRUGELIAI;6860757091;Taip;0;5;0;5
1058;Coliukė;DRUGELIAI;6011110970;Ne;0;1;0;1
1059;Coliukė;DRUGELIAI;1968467455;Taip;5;1;0;6
1060;Coliukė;DRUGELIAI;1240946719;Taip;0;10;0;10
1061;Coliukė;DRUGELIAI;4645245689;Taip;16;0;0;16
1062;Coliukė;DRUGELIAI;1882520335;Taip;5;0;0;5
1063;Coliukė;DRUGELIAI;8517128464;Taip;2;5;0;7
1064;Coliukė;DRUGELIAI;1328505569;Ne;0;8;0;8
1065;Coliukė;DRUGELIAI;5678858566;Taip;10;3;0;13
1066;Coliukė;BITUTĖS;53223262449;Ne;15;1;0;16
1067;Coliukė;BITUTĖS;2006601280;Taip;0;5;0;5
1068;Coliukė;BITUTĖS;44291325944;Taip;0;5;0;5
1069;Coliukė;BITUTĖS;50210836203;Taip;0;3;0;3
1070;Coliukė;BITUTĖS;8017702268;Ne;0;6;0;6
1071;Coliukė;BITUTĖS;30220840133;Ne;0;6;0;6
1072;Coliukė;BITUTĖS;58282533952;Ne;11;9;0;20
1073;Coliukė;BITUTĖS;41174692847;Taip;0;7;0;7
1074;Coliukė;BITUTĖS;93361426448;Taip;5;6;0;11
1075;Coliukė;BITUTĖS;69258022561;Taip;0;12;0;12
1076;Coliukė;BITUTĖS;82989338835;Taip;0;6;0;6
1077;Coliukė;BITUTĖS;37161702858;Taip;0;5;0;5
1078;Coliukė;BITUTĖS;77967081365;Taip;0;5;0;5
1079;Coliukė;BITUTĖS;77204026281;Taip;2;13;0;15
1080;Coliukė;BITUTĖS;25298531632;Taip;5;5;0;10
1081;Coliukė;BITUTĖS;1199350941;Taip;0;15;0;15
1082;Coliukė;BITUTĖS;1960898805;Taip;0;8;0;8
1083;Coliukė;BITUTĖS;58421006265;Taip;0;8;0;8
1084;Coliukė;BITUTĖS;6926730624;Taip;0;3;0;3
1085;Coliukė;BITUTĖS;8457120425;Taip;3;0;0;3
1086;Coliukė;BITUTĖS;9311775782;Taip;0;20;0;20
1087;Coliukė;BITUTĖS;36554487034;Taip;1;5;0;6
1088;Coliukė;BITUTĖS;1423711475;Taip;8;1;0;9
1089;Coliukė;BITUTĖS;2002555659;Taip;11;9;0;20
1090;Coliukė;VABALIUKAI;43033055985;Taip;0;4;0;4
1091;Coliukė;VABALIUKAI;72663090608;Taip;10;0;0;10
1092;Coliukė;VABALIUKAI;62876576078;Taip;0;6;0;6
1093;Coliukė;VABALIUKAI;51782207208;Taip;0;10;0;10
1094;Coliukė;VABALIUKAI;26012978171;Taip;15;5;0;20
1095;Coliukė;VABALIUKAI;18718511212;Taip;0;7;0;7
1096;Coliukė;VABALIUKAI;26698840369;Taip;0;16;0;16
1097;Coliukė;VABALIUKAI;78760440826;Taip;10;8;0;18
1098;Coliukė;VABALIUKAI;1556841186;Taip;9;2;1;12
1099;Coliukė;VABALIUKAI;6025281817;Taip;0;7;0;7
1100;Coliukė;VABALIUKAI;22951260339;Taip;0;6;0;6
1101;Coliukė;VABALIUKAI;33158793202;Taip;0;4;0;4
1102;Coliukė;VABALIUKAI;33587152454;Taip;10;4;0;14
1103;Coliukė;VABALIUKAI;82064520362;Taip;9;1;0;10
1104;Coliukė;VABALIUKAI;57504928606;Taip;10;7;0;17
1105;Coliukė;VABALIUKAI;1654628972;Taip;2;2;0;4
1106;Coliukė;VABALIUKAI;5944299310;Taip;0;6;0;6
1107;Coliukė;VABALIUKAI;4649987214;Taip;9;1;0;10
1108;Coliukė;VABALIUKAI;5672562299;Taip;17;0;0;17
1109;Coliukė;VABALIUKAI;63258983714;Taip;4;1;0;5
1110;Coliukė;VABALIUKAI;99200764707;Taip;0;0;1;1
1111;Coliukė;VABALIUKAI;1476750428;Taip;13;2;0;15
1112;Coliukė;VABALIUKAI;6775470024;Taip;17;0;0;17
1113;Coliukė;VABALIUKAI;8323242104;Taip;0;8;0;8
1114;Coliukė;NYKŠTUKAI;1659532709;Taip;17;2;0;19
1115;Coliukė;NYKŠTUKAI;88866481329;Taip;0;6;0;6
1116;Coliukė;NYKŠTUKAI;1812071213;Taip;15;0;0;15
1117;Coliukė;NYKŠTUKAI;43313407836;Taip;7;0;1;8
1118;Coliukė;NYKŠTUKAI;3738703854;Taip;5;4;0;9
1119;Coliukė;NYKŠTUKAI;1997515382;Taip;6;3;1;10
1120;Coliukė;NYKŠTUKAI;1625018276;Taip;0;12;0;12
1121;Coliukė;NYKŠTUKAI;1267427191;Taip;2;0;0;2
1122;Coliukė;NYKŠTUKAI;1963122314;Taip;18;0;0;18
1123;Coliukė;NYKŠTUKAI;4917899323;Taip;5;7;0;12
1124;Coliukė;NYKŠTUKAI;4747481676;Taip;0;5;0;5
1125;Coliukė;NYKŠTUKAI;83027842354;Taip;10;1;0;11
1126;Coliukė;NYKŠTUKAI;2168987649;Taip;7;0;1;8
1127;Coliukė;NYKŠTUKAI;2684151591;Taip;12;6;0;18
1128;Coliukė;NYKŠTUKAI;4499924331;Taip;8;2;0;10
1129;Coliukė;NYKŠTUKAI;4806478786;Taip;8;0;0;8
1130;Coliukė;NYKŠTUKAI;7566429633;Taip;0;8;0;8
1131;Coliukė;NYKŠTUKAI;9542366183;Taip;17;0;0;17
1132;Coliukė;NYKŠTUKAI;7670166244;Taip;0;12;0;12
1133;Coliukė;NYKŠTUKAI;1166820133;Taip;14;0;0;14
1134;Coliukė;GĖLYTĖS;8835394030;Taip;0;8;0;8
1135;Coliukė;GĖLYTĖS;3427704550;Taip;0;10;0;10
1136;Coliukė;GĖLYTĖS;7248705010;Taip;5;2;1;8
1137;Coliukė;GĖLYTĖS;1318558913;Taip;0;16;0;16
1138;Coliukė;GĖLYTĖS;4022408510;Taip;1;5;0;6
1139;Coliukė;GĖLYTĖS;3318808813;Taip;20;0;0;20
1140;Coliukė;GĖLYTĖS;4498253271;Taip;4;5;3;12
1141;Coliukė;GĖLYTĖS;3323738649;Taip;5;0;0;5
1142;Coliukė;GĖLYTĖS;9331485675;Taip;0;5;15;20
1143;Coliukė;GĖLYTĖS;8149118599;Taip;10;0;0;10
1144;Coliukė;GĖLYTĖS;8209209881;Taip;9;5;2;16
1145;Coliukė;GĖLYTĖS;9885547263;Taip;10;0;1;11
1146;Coliukė;GĖLYTĖS;5139645108;Taip;8;6;0;14
1147;Coliukė;"BORUŽĖLĖS (SPEC.)";1988394967;Taip;12;2;0;14
1148;Coliukė;"BORUŽĖLĖS (SPEC.)";6795666500;Taip;0;3;0;3
1149;Coliukė;"BORUŽĖLĖS (SPEC.)";1477621127;Ne;7;0;0;7
1150;Coliukė;"BORUŽĖLĖS (SPEC.)";3746858489;Taip;5;4;0;9
1151;Coliukė;"BORUŽĖLĖS (SPEC.)";3101380476;Taip;15;0;0;15
1152;Coliukė;"BORUŽĖLĖS (SPEC.)";92299314212;Taip;0;5;1;6
1153;Coliukė;"BORUŽĖLĖS (SPEC.)";2080118127;Taip;10;3;0;13
1154;Coliukė;"BORUŽĖLĖS (SPEC.)";8070499557;Taip;10;0;5;15
1155;Coliukė;"BORUŽĖLĖS (SPEC.)";2617816991;Taip;9;0;0;9
1156;Coliukė;"BORUŽĖLĖS (SPEC.)";9368334915;Taip;14;0;0;14
1157;Coliukė;"BORUŽĖLĖS (SPEC.)";1233731506;Taip;9;0;0;9
1158;Coliukė;"BORUŽĖLĖS (SPEC.)";1644303265;Taip;7;4;0;11
1159;Coliukė;"BORUŽĖLĖS (SPEC.)";60578936717;Taip;5;9;0;14
1160;Čiauškutis;BITUTĖS;78373250443;Taip;10;1;0;11
1161;Čiauškutis;BITUTĖS;7755428393;Taip;0;1;0;1
1162;Čiauškutis;BITUTĖS;3499391608;Taip;7;0;0;7
1163;Čiauškutis;BITUTĖS;1443155220;Taip;1;11;0;12
1164;Čiauškutis;BITUTĖS;2012201854;Taip;5;0;4;9
1165;Čiauškutis;BITUTĖS;38387916428;Taip;12;0;3;15
1166;Čiauškutis;BITUTĖS;1804509009;Taip;10;0;2;12
1167;Čiauškutis;BITUTĖS;22717947028;Taip;0;6;0;6
1168;Čiauškutis;BITUTĖS;3917667527;Taip;12;0;1;13
1169;Čiauškutis;BITUTĖS;4600623461;Taip;0;7;0;7
1170;Čiauškutis;BITUTĖS;27158851138;Taip;0;7;0;7
1171;Čiauškutis;BITUTĖS;8030685444;Taip;0;3;0;3
1172;Čiauškutis;ŽVIRBLIUKAI;1301573542;Taip;0;0;1;1
1173;Čiauškutis;ŽVIRBLIUKAI;2044220236;Taip;0;5;3;8
1174;Čiauškutis;ŽVIRBLIUKAI;5900996969;Taip;7;0;0;7
1175;Čiauškutis;ŽVIRBLIUKAI;6170362846;Taip;0;7;6;13
1176;Čiauškutis;ŽVIRBLIUKAI;1036358147;Taip;5;3;2;10
1177;Čiauškutis;ŽVIRBLIUKAI;9072764004;Taip;0;0;6;6
1178;Čiauškutis;SAULUTĖS;4267461379;Taip;0;1;1;2
1179;Čiauškutis;SAULUTĖS;60189459128;Taip;9;0;0;9
1180;Čiauškutis;SAULUTĖS;9140042522;Taip;0;9;0;9
1181;Čiauškutis;SAULUTĖS;2976888531;Taip;0;14;0;14
1182;Čiauškutis;SAULUTĖS;1798962981;Taip;8;1;0;9
1183;Čiauškutis;SAULUTĖS;4248760802;Taip;1;4;0;5
1184;Čiauškutis;SAULUTĖS;6279678482;Taip;0;1;0;1
1185;Čiauškutis;SAULUTĖS;35965163532;Taip;0;5;0;5
1186;Čiauškutis;SAULUTĖS;2312273972;Taip;0;18;0;18
1187;Čiauškutis;EŽIUKAI;1624692126;Taip;13;0;0;13
1188;Čiauškutis;EŽIUKAI;30738331224;Taip;0;1;0;1
1189;Čiauškutis;EŽIUKAI;32462147501;Taip;0;5;3;8
1190;Čiauškutis;EŽIUKAI;20874037407;Taip;5;0;1;6
1191;Čiauškutis;EŽIUKAI;54848304991;Taip;1;0;2;3
1192;Čiauškutis;EŽIUKAI;1437126272;Taip;6;0;0;6
1193;Čiauškutis;EŽIUKAI;3653044274;Taip;0;0;1;1
1194;Čiauškutis;EŽIUKAI;1824372731;Taip;0;3;1;4
1195;Čiauškutis;EŽIUKAI;1960094598;Taip;0;5;2;7
1196;Čiauškutis;EŽIUKAI;1575387912;Taip;0;8;1;9
1197;Čiauškutis;EŽIUKAI;37100318588;Taip;0;0;3;3
1198;Čiauškutis;EŽIUKAI;32956407401;Taip;0;15;0;15
1199;Čiauškutis;DRUGELIAI;1332686904;Taip;0;4;0;4
1200;Čiauškutis;DRUGELIAI;1404146538;Taip;0;0;4;4
1201;Čiauškutis;DRUGELIAI;8974089037;Taip;2;0;0;2
1202;Čiauškutis;DRUGELIAI;1417978731;Taip;5;0;7;12
1203;Čiauškutis;DRUGELIAI;7011763860;Taip;3;0;0;3
1204;Čiauškutis;DRUGELIAI;1503190001;Taip;0;1;0;1
1205;Čiauškutis;DRUGELIAI;55539901360;Taip;8;0;1;9
1206;Čiauškutis;DRUGELIAI;45303538716;Taip;10;0;0;10
1207;Čiauškutis;DRUGELIAI;8375416027;Taip;6;0;1;7
1208;Čiauškutis;DRUGELIAI;1480363762;Taip;5;0;0;5
1209;Čiauškutis;DRUGELIAI;88294995405;Taip;7;0;0;7
1210;Čiauškutis;GENELIAI;3888278518;Taip;1;0;2;3
1211;Čiauškutis;GENELIAI;4442345827;Taip;7;0;2;9
1212;Čiauškutis;GENELIAI;6476417522;Taip;5;0;0;5
1213;Čiauškutis;GENELIAI;9679979305;Taip;11;0;4;15
1214;Čiauškutis;GENELIAI;76993441149;Taip;0;4;1;5
1215;Čiauškutis;GENELIAI;48375767334;Taip;6;0;0;6
1216;Čiauškutis;GENELIAI;34341858813;Taip;10;0;0;10
1217;Čiauškutis;GENELIAI;29844230217;Taip;0;7;0;7
1218;Čiauškutis;GENELIAI;47866559654;Taip;5;3;0;8
1219;Čiauškutis;GENELIAI;1330717109;Taip;9;0;0;9
1220;Čiauškutis;LINKSMUČIAI;3127896063;Ne;0;5;0;5
1221;Čiauškutis;LINKSMUČIAI;1691137830;Taip;0;1;2;3
1222;Čiauškutis;LINKSMUČIAI;75421786315;Taip;0;0;2;2
1223;Čiauškutis;LINKSMUČIAI;70507237430;Taip;0;1;4;5
1224;Čiauškutis;LINKSMUČIAI;65948673886;Taip;0;3;0;3
1225;Čiauškutis;LINKSMUČIAI;5587488205;Taip;0;1;2;3
1226;Čiauškutis;LINKSMUČIAI;32426102534;Taip;0;6;3;9
1227;Čiauškutis;LINKSMUČIAI;9722014294;Taip;4;5;3;12
1228;Čiauškutis;LINKSMUČIAI;54471558189;Taip;0;1;3;4
1229;Čiauškutis;LINKSMUČIAI;13187502295;Taip;0;1;0;1
1230;Čiauškutis;LINKSMUČIAI;1452900014;Taip;0;1;0;1
1231;Čiauškutis;LINKSMUČIAI;2049302005;Taip;0;1;0;1
1232;Čiauškutis;KIŠKUČIAI;1380571576;Taip;12;6;0;18
1233;Čiauškutis;KIŠKUČIAI;4817007142;Taip;7;0;1;8
1234;Čiauškutis;KIŠKUČIAI;2019831231;Taip;0;3;1;4
1235;Čiauškutis;KIŠKUČIAI;9603569117;Taip;7;0;0;7
1236;Čiauškutis;KIŠKUČIAI;1474355889;Taip;2;3;1;6
1237;Čiauškutis;KIŠKUČIAI;26779062894;Taip;0;3;5;8
1238;Čiauškutis;KIŠKUČIAI;1109018212;Taip;7;0;0;7
1239;Čiauškutis;KIŠKUČIAI;72264057427;Taip;0;8;0;8
1240;Čiauškutis;KIŠKUČIAI;8808041204;Taip;0;1;0;1
1241;Čiauškutis;KIŠKUČIAI;8884708945;Taip;12;0;1;13
1242;Čiauškutis;KIŠKUČIAI;2099735647;Taip;6;4;1;11
1243;Čiauškutis;LAPIUKAI;67405154291;Taip;0;0;1;1
1244;Čiauškutis;LAPIUKAI;1486206292;Taip;5;0;0;5
1245;Čiauškutis;LAPIUKAI;1719875491;Taip;0;0;3;3
1246;Čiauškutis;LAPIUKAI;1849532875;Ne;5;6;0;11
1247;Čiauškutis;LAPIUKAI;60265156684;Taip;5;0;2;7
1248;Čiauškutis;LAPIUKAI;1938531597;Ne;0;1;0;1
1249;Čiauškutis;MEŠKUČIAI;17168092727;Taip;1;0;0;1
1250;Čiauškutis;MEŠKUČIAI;6193581306;Taip;0;4;0;4
1251;Čiauškutis;MEŠKUČIAI;1923832961;Taip;10;5;0;15
1252;Čiauškutis;MEŠKUČIAI;95088279233;Taip;0;5;2;7
1253;Čiauškutis;MEŠKUČIAI;4341825486;Taip;0;1;0;1
1254;Čiauškutis;PELĖDŽIUKAI;7060197354;Taip;10;7;0;17
1255;Čiauškutis;PELĖDŽIUKAI;7961309940;Taip;10;2;1;13
1256;Čiauškutis;PELĖDŽIUKAI;8728572783;Taip;7;3;0;10
1257;Čiauškutis;PELĖDŽIUKAI;1253449294;Taip;3;4;1;8
1258;Čiauškutis;PELĖDŽIUKAI;82575455120;Taip;11;0;0;11
1259;Čiauškutis;PELĖDŽIUKAI;6165710260;Taip;10;0;0;10
1260;Čiauškutis;PELĖDŽIUKAI;1546096184;Taip;12;0;0;12
1261;Čiauškutis;PELĖDŽIUKAI;4135020826;Taip;7;5;0;12
1262;Čiauškutis;PELĖDŽIUKAI;1422589887;Taip;5;0;0;5
1263;Čiauškutis;PELĖDŽIUKAI;30480486366;Taip;10;0;0;10
1264;Čiauškutis;PELĖDŽIUKAI;70690874267;Taip;5;0;0;5
1265;Čiauškutis;NYKŠTUKAI;6258150407;Taip;5;9;0;14
1266;Čiauškutis;NYKŠTUKAI;1778900145;Taip;15;5;0;20
1267;Čiauškutis;NYKŠTUKAI;4898534899;Taip;9;0;0;9
1268;Čiauškutis;NYKŠTUKAI;3965479551;Taip;0;3;0;3
1269;Čiauškutis;NYKŠTUKAI;8896526358;Taip;0;2;0;2
1270;Čiauškutis;NYKŠTUKAI;7367933940;Taip;0;1;0;1
1271;Čiauškutis;NYKŠTUKAI;8346845876;Taip;11;0;0;11
1272;Delfinukas;Boružėlių;1293348150;Taip;4;0;0;4
1273;Delfinukas;Boružėlių;6531930806;Taip;5;0;0;5
1274;Delfinukas;Boružėlių;8076961367;Taip;0;2;3;5
1275;Delfinukas;Boružėlių;8439204095;Taip;7;0;0;7
1276;Delfinukas;Boružėlių;5783537897;Taip;10;0;1;11
1277;Delfinukas;Boružėlių;4989239822;Taip;6;0;1;7
1278;Delfinukas;Boružėlių;7638190553;Taip;3;0;3;6
1279;Delfinukas;Boružėlių;2010703982;Taip;0;3;0;3
1280;Delfinukas;Boružėlių;8728791932;Taip;12;0;0;12
1281;Delfinukas;Boružėlių;5794346039;Taip;8;0;1;9
1282;Delfinukas;Boružėlių;1153948822;Taip;0;5;0;5
1283;Delfinukas;Boružėlių;2784942324;Taip;13;0;0;13
1284;Delfinukas;Boružėlių;6700068320;Taip;5;3;1;9
1285;Delfinukas;Boružėlių;7277680544;Taip;14;0;0;14
1286;Delfinukas;Boružėlių;9099945815;Taip;0;1;0;1
1287;Delfinukas;Boružėlių;1212995285;Taip;6;2;0;8
1288;Delfinukas;Saulytės;65798709244;Taip;14;0;0;14
1289;Delfinukas;Saulytės;76643778833;Taip;3;5;0;8
1290;Delfinukas;Saulytės;35058841521;Taip;10;10;0;20
1291;Delfinukas;Saulytės;9918028862;Taip;9;0;0;9
1292;Delfinukas;Saulytės;1260108624;Taip;2;0;0;2
1293;Delfinukas;Saulytės;79934072325;Taip;0;5;0;5
1294;Delfinukas;Saulytės;2096874518;Taip;0;5;0;5
1295;Delfinukas;Saulytės;5912904296;Taip;9;5;0;14
1296;Delfinukas;Saulytės;2009324145;Taip;0;7;2;9
1297;Delfinukas;Saulytės;27140729689;Taip;3;7;0;10
1298;Delfinukas;Saulytės;46847640903;Taip;11;0;0;11
1299;Delfinukas;Saulytės;4142864015;Taip;0;2;0;2
1300;Delfinukas;Saulytės;86601289023;Taip;5;5;0;10
1301;Delfinukas;Saulytės;16785309188;Taip;0;7;0;7
1302;Delfinukas;Saulytės;34563800372;Taip;0;7;0;7
1303;Delfinukas;Saulytės;2074439295;Taip;3;0;0;3
1304;Delfinukas;Saulytės;1364873935;Taip;3;1;0;4
1305;Delfinukas;Saulytės;1939499375;Taip;10;1;0;11
1306;Delfinukas;Saulytės;1813240176;Taip;8;0;4;12
1307;Delfinukas;Pelėdžiukų;9520598359;Taip;10;2;0;12
1308;Delfinukas;Pelėdžiukų;5018815345;Taip;0;0;20;20
1309;Delfinukas;Pelėdžiukų;8938997208;Taip;0;0;20;20
1310;Delfinukas;Pelėdžiukų;6572690788;Taip;0;6;0;6
1311;Delfinukas;Pelėdžiukų;7487111570;Taip;0;2;0;2
1312;Delfinukas;Pelėdžiukų;4631456002;Taip;0;0;2;2
1313;Delfinukas;Pelėdžiukų;3397350274;Taip;0;5;0;5
1314;Delfinukas;Pelėdžiukų;3804996594;Taip;8;0;2;10
1315;Delfinukas;Pelėdžiukų;1136182876;Taip;0;1;0;1
1316;Delfinukas;Pelėdžiukų;7873373923;Taip;3;0;2;5
1317;Delfinukas;Pelėdžiukų;8936645508;Taip;0;4;0;4
1318;Delfinukas;Pelėdžiukų;2066127119;Taip;7;0;0;7
1319;Delfinukas;Pelėdžiukų;2869506388;Taip;5;2;0;7
1320;Delfinukas;Pelėdžiukų;6844500395;Taip;0;2;0;2
1321;Delfinukas;Pelėdžiukų;9074294473;Taip;0;0;7;7
1322;Delfinukas;Pelėdžiukų;8227660508;Taip;12;0;0;12
1323;Delfinukas;Varliukų;1153333591;Taip;0;2;0;2
1324;Delfinukas;Varliukų;1091165849;Taip;0;1;0;1
1325;Delfinukas;Varliukų;1421633312;Taip;5;1;0;6
1326;Delfinukas;Varliukų;1454101129;Taip;0;2;0;2
1327;Delfinukas;Varliukų;1251961268;Taip;0;3;0;3
1328;Delfinukas;Varliukų;1789047913;Taip;0;12;0;12
1329;Delfinukas;Varliukų;9347513042;Taip;0;5;0;5
1330;Delfinukas;Varliukų;8875479631;Taip;0;13;0;13
1331;Delfinukas;Varliukų;3344476309;Taip;13;1;0;14
1332;Delfinukas;Varliukų;3955783379;Taip;14;0;0;14
1333;Delfinukas;Varliukų;3489297719;Taip;0;6;0;6
1334;Delfinukas;Varliukų;1948438336;Taip;0;2;1;3
1335;Delfinukas;Varliukų;9266646602;Taip;20;0;0;20
1336;Delfinukas;Varliukų;3674481373;Taip;5;8;0;13
1337;Delfinukas;Varpelių;1201971467;Taip;3;6;0;9
1338;Delfinukas;Varpelių;16192036601;Ne;7;6;0;13
1339;Delfinukas;Varpelių;17472648959;Taip;0;6;0;6
1340;Delfinukas;Varpelių;73187227229;Taip;0;3;0;3
1341;Delfinukas;Varpelių;89455376961;Taip;5;0;0;5
1342;Delfinukas;Varpelių;62769117892;Taip;0;12;0;12
1343;Delfinukas;Varpelių;70985723823;Ne;0;13;0;13
1344;Delfinukas;Varpelių;8855690221;Taip;13;6;0;19
1345;Delfinukas;Varpelių;3093606855;Taip;8;0;0;8
1346;Delfinukas;Varpelių;6393090675;Taip;11;2;0;13
1347;Delfinukas;Varpelių;1268754720;Taip;0;12;0;12
1348;Delfinukas;Varpelių;1959331544;Taip;10;0;0;10
1349;Delfinukas;Varpelių;3718612458;Taip;10;1;0;11
1350;Delfinukas;Varpelių;43859975789;Taip;5;0;0;5
1351;Delfinukas;Varpelių;2531571615;Taip;0;1;0;1
1352;Delfinukas;Varpelių;91028452879;Taip;0;6;0;6
1353;Delfinukas;Varpelių;1325054642;Taip;0;9;0;9
1354;Delfinukas;Varpelių;7163839896;Taip;0;7;4;11
1355;Delfinukas;Varpelių;7493037613;Taip;0;7;2;9
1356;Delfinukas;Varpelių;4239224971;Taip;7;5;0;12
1357;Delfinukas;Varpelių;1650166115;Taip;15;0;0;15
1358;Delfinukas;Delfinukai;5093418481;Taip;0;2;0;2
1359;Delfinukas;Delfinukai;6190642132;Taip;6;4;0;10
1360;Delfinukas;Delfinukai;17266052771;Taip;3;6;0;9
1361;Delfinukas;Delfinukai;57676205527;Taip;0;6;0;6
1362;Delfinukas;Delfinukai;71523999168;Taip;0;6;0;6
1363;Delfinukas;Delfinukai;46276990963;Taip;9;0;0;9
1364;Delfinukas;Delfinukai;7528505426;Taip;5;5;0;10
1365;Delfinukas;Delfinukai;7509276953;Taip;0;1;0;1
1366;Delfinukas;Delfinukai;6561536457;Taip;5;0;0;5
1367;Delfinukas;Delfinukai;29449834997;Taip;0;0;20;20
1368;Delfinukas;Delfinukai;1188049956;Taip;4;0;0;4
1369;Delfinukas;Delfinukai;545765924;Taip;13;0;0;13
1370;Delfinukas;Delfinukai;1517834246;Taip;4;0;0;4
1371;Delfinukas;Delfinukai;1430155044;Taip;0;1;0;1
1372;Delfinukas;Delfinukai;7886801955;Taip;0;0;20;20
1373;Delfinukas;Delfinukai;1160537966;Taip;18;0;0;18
1374;Delfinukas;Delfinukai;4405301567;Taip;0;0;3;3
1375;Delfinukas;Delfinukai;26626004000;Taip;0;0;20;20
1376;Delfinukas;Drugeliai;83704349624;Taip;0;7;1;8
1377;Delfinukas;Drugeliai;86042798636;Taip;0;0;10;10
1378;Delfinukas;Drugeliai;74847760830;Taip;0;2;0;2
1379;Delfinukas;Drugeliai;35812802830;Taip;4;12;0;16
1380;Delfinukas;Drugeliai;2960662435;Taip;0;6;0;6
1381;Delfinukas;Drugeliai;11940207202;Taip;5;1;0;6
1382;Delfinukas;Drugeliai;94713648240;Taip;5;0;0;5
1383;Delfinukas;Drugeliai;2402204674;Taip;6;2;0;8
1384;Delfinukas;Drugeliai;9168812609;Taip;0;6;7;13
1385;Delfinukas;Drugeliai;5024726028;Taip;0;2;11;13
1386;Delfinukas;Drugeliai;88370692635;Taip;6;0;0;6
1387;Delfinukas;Drugeliai;1829816692;Taip;0;19;0;19
1388;Delfinukas;Drugeliai;4435982727;Taip;0;0;10;10
1389;Delfinukas;Drugeliai;2402524470;Taip;8;1;0;9
1390;Delfinukas;Drugeliai;2135364149;Taip;0;1;0;1
1391;Delfinukas;Drugeliai;33466088300;Taip;0;2;0;2
1392;Delfinukas;Drugeliai;8782782031;Taip;0;4;0;4
1393;Delfinukas;Žuvytės;31776667512;Taip;0;2;0;2
1394;Delfinukas;Žuvytės;47377556072;Taip;10;5;0;15
1395;Delfinukas;Žuvytės;82176273307;Ne;10;5;0;15
1396;Delfinukas;Žuvytės;53152433196;Taip;0;7;0;7
1397;Delfinukas;Žuvytės;29959372638;Taip;0;5;0;5
1398;Delfinukas;Žuvytės;21095307036;Taip;0;0;20;20
1399;Delfinukas;Žuvytės;94392092103;Ne;11;0;0;11
1400;Delfinukas;Žuvytės;57461575212;Taip;0;5;10;15
1401;Delfinukas;Žuvytės;3310208029;Taip;0;13;0;13
1402;Delfinukas;Žuvytės;1693121016;Taip;0;9;0;9
1403;Delfinukas;Žuvytės;82936702613;Taip;0;0;3;3
1404;Delfinukas;Žuvytės;31006890017;Taip;10;0;0;10
1405;Delfinukas;Žuvytės;49489087212;Taip;3;0;0;3
1406;Delfinukas;Žuvytės;29649846186;Taip;0;2;0;2
1407;Delfinukas;Žuvytės;24363585231;Taip;15;0;0;15
1408;Delfinukas;Žuvytės;9330213866;Taip;0;1;0;1
1409;Delfinukas;Žuvytės;30064453011;Taip;0;17;0;17
1410;Delfinukas;Žuvytės;1238188049;Taip;1;2;2;5
1411;Delfinukas;Žuvytės;2141617594;Taip;0;7;0;7
1412;Delfinukas;Žuvytės;59541249199;Taip;15;5;0;20
1413;Delfinukas;Delfinai;8335398345;Taip;5;0;0;5
1414;Delfinukas;Delfinai;37530814188;Taip;7;1;0;8
1415;Delfinukas;Delfinai;1435104895;Taip;0;1;0;1
1416;Delfinukas;Delfinai;1876110301;Taip;14;0;0;14
1417;Delfinukas;Delfinai;1101237825;Taip;0;1;7;8
1418;Delfinukas;Delfinai;11528618044;Taip;0;7;0;7
1419;Delfinukas;Delfinai;26554152266;Taip;5;0;0;5
1420;Delfinukas;Delfinai;51442842468;Taip;3;3;0;6
1421;Delfinukas;Delfinai;84024727184;Taip;0;3;0;3
1422;Delfinukas;Delfinai;1382754985;Taip;0;2;2;4
1423;Delfinukas;Delfinai;1515422367;Taip;0;5;1;6
1424;Delfinukas;Delfinai;71828460624;Taip;0;7;0;7
1425;Delfinukas;Delfinai;4549364929;Taip;5;0;0;5
1426;Delfinukas;Delfinai;4497323553;Taip;5;0;0;5
1427;Delfinukas;Delfinai;83920976768;Taip;11;0;0;11
1428;Delfinukas;Delfinai;1963422247;Taip;0;2;0;2
1429;Delfinukas;Delfinai;9821969586;Taip;7;1;0;8
1430;Delfinukas;Delfinai;4569691896;Taip;12;1;0;13
1431;Delfinukas;Paukšteliai;6047881184;Taip;10;0;0;10
1432;Delfinukas;Paukšteliai;8038737019;Taip;0;0;7;7
1433;Delfinukas;Paukšteliai;9628317328;Taip;8;5;0;13
1434;Delfinukas;Paukšteliai;5797308373;Taip;6;2;0;8
1435;Delfinukas;Paukšteliai;5241426445;Taip;11;1;0;12
1436;Delfinukas;Paukšteliai;8099120371;Taip;0;0;20;20
1437;Delfinukas;Paukšteliai;3108430680;Taip;3;0;0;3
1438;Delfinukas;Paukšteliai;7663934825;Taip;10;2;0;12
1439;Delfinukas;Paukšteliai;2382077576;Taip;3;5;0;8
1440;Delfinukas;Paukšteliai;1200205376;Taip;5;5;0;10
1441;Delfinukas;Paukšteliai;4347116918;Taip;0;0;20;20
1442;Delfinukas;Paukšteliai;1922513830;Taip;12;3;0;15
1443;Delfinukas;Paukšteliai;7629622746;Taip;0;0;3;3
1444;Delfinukas;Paukšteliai;8335034956;Taip;20;0;0;20
1445;Delfinukas;Paukšteliai;6337962165;Taip;0;0;20;20
1446;Delfinukas;Kiškučiai;7766292005;Taip;0;8;0;8
1447;Delfinukas;Kiškučiai;98742243823;Taip;0;7;0;7
1448;Delfinukas;Kiškučiai;1498120150;Taip;6;2;0;8
1449;Delfinukas;Kiškučiai;1767369189;Taip;12;1;0;13
1450;Delfinukas;Kiškučiai;1495145663;Taip;4;3;0;7
1451;Delfinukas;Kiškučiai;1301231548;Taip;20;0;0;20
1452;Delfinukas;Kiškučiai;1613911039;Taip;0;4;1;5
1453;Delfinukas;Kiškučiai;1477374660;Taip;6;0;0;6
1454;Delfinukas;Kiškučiai;2993704795;Taip;0;1;0;1
1455;Delfinukas;Kiškučiai;1487082744;Taip;0;6;1;7
1456;Delfinukas;Kiškučiai;2063259303;Taip;5;8;0;13
1457;Delfinukas;Kiškučiai;96861425670;Taip;0;2;0;2
1458;Delfinukas;Kiškučiai;60320557464;Taip;7;1;2;10
1459;Delfinukas;Kiškučiai;1594700604;Taip;0;13;0;13
1460;Drevinukas;ZUIKUČIAI;8180027849;Taip;5;0;2;7
1461;Drevinukas;ZUIKUČIAI;5686116320;Taip;0;0;1;1
1462;Drevinukas;ZUIKUČIAI;85288014888;Taip;0;6;0;6
1463;Drevinukas;ZUIKUČIAI;56028675283;Taip;10;0;0;10
1464;Drevinukas;ZUIKUČIAI;2070374746;Taip;0;0;1;1
1465;Drevinukas;ZUIKUČIAI;16952164778;Taip;10;0;2;12
1466;Drevinukas;ZUIKUČIAI;7632515230;Taip;0;0;4;4
1467;Drevinukas;ZUIKUČIAI;1019214451;Taip;3;0;0;3
1468;Drevinukas;ZUIKUČIAI;9803670483;Taip;6;0;1;7
1469;Drevinukas;ZUIKUČIAI;5046355276;Taip;10;0;0;10
1470;Drevinukas;ZUIKUČIAI;8661862777;Taip;10;5;0;15
1471;Drevinukas;ZUIKUČIAI;2074070030;Taip;2;5;0;7
1472;Drevinukas;ZUIKUČIAI;6304169257;Taip;5;0;4;9
1473;Drevinukas;ZUIKUČIAI;3657451903;Taip;10;0;0;10
1474;Drevinukas;ZUIKUČIAI;1987939679;Taip;0;0;14;14
1475;Drevinukas;ZUIKUČIAI;1123115847;Taip;0;5;5;10
1476;Drevinukas;ZUIKUČIAI;9336227821;Taip;8;0;0;8
1477;Drevinukas;ZUIKUČIAI;6425268903;Taip;0;6;7;13
1478;Drevinukas;AŽUOLIUKŲ;37485364300;Taip;0;0;5;5
1479;Drevinukas;AŽUOLIUKŲ;4980076288;Taip;10;10;0;20
1480;Drevinukas;AŽUOLIUKŲ;64560340218;Taip;15;1;0;16
1481;Drevinukas;AŽUOLIUKŲ;17456144256;Taip;0;5;0;5
1482;Drevinukas;AŽUOLIUKŲ;3066586415;Taip;0;0;4;4
1483;Drevinukas;AŽUOLIUKŲ;1250033881;Taip;0;1;5;6
1484;Drevinukas;AŽUOLIUKŲ;74690633233;Taip;0;5;0;5
1485;Drevinukas;AŽUOLIUKŲ;1798044901;Taip;0;0;5;5
1486;Drevinukas;AŽUOLIUKŲ;73923305630;Taip;8;0;2;10
1487;Drevinukas;AŽUOLIUKŲ;29000633056;Taip;0;0;2;2
1488;Drevinukas;AŽUOLIUKŲ;96655135353;Taip;0;5;0;5
1489;Drevinukas;AŽUOLIUKŲ;1254845545;Taip;0;5;0;5
1490;Drevinukas;AŽUOLIUKŲ;46006802320;Taip;0;5;0;5
1491;Drevinukas;AŽUOLIUKŲ;49704496121;Taip;7;0;1;8
1492;Drevinukas;AŽUOLIUKŲ;1978599912;Taip;0;1;1;2
1493;Drevinukas;AŽUOLIUKŲ;9657606451;Taip;0;7;0;7
1494;Drevinukas;AŽUOLIUKŲ;4150306697;Taip;0;7;0;7
1495;Drevinukas;AŽUOLIUKŲ;71447591085;Taip;20;0;0;20
1496;Drevinukas;AŽUOLIUKŲ;2483043689;Taip;0;5;1;6
1497;Drevinukas;PELĖDŽIUKAI;4694536057;Taip;0;3;1;4
1498;Drevinukas;PELĖDŽIUKAI;3114995856;Taip;0;0;1;1
1499;Drevinukas;PELĖDŽIUKAI;67211396910;Taip;0;5;0;5
1500;Drevinukas;PELĖDŽIUKAI;49359528680;Taip;5;0;0;5
1501;Drevinukas;PELĖDŽIUKAI;98918406807;Taip;0;4;1;5
1502;Drevinukas;PELĖDŽIUKAI;13716365912;Taip;5;5;1;11
1503;Drevinukas;PELĖDŽIUKAI;51830569951;Taip;0;3;0;3
1504;Drevinukas;PELĖDŽIUKAI;24866634007;Taip;0;2;4;6
1505;Drevinukas;PELĖDŽIUKAI;54578654099;Taip;0;2;0;2
1506;Drevinukas;PELĖDŽIUKAI;62264151217;Taip;0;7;0;7
1507;Drevinukas;PELĖDŽIUKAI;53607306428;Taip;6;1;0;7
1508;Drevinukas;PELĖDŽIUKAI;45489453961;Ne;0;5;1;6
1509;Drevinukas;PELĖDŽIUKAI;11985365230;Taip;7;0;0;7
1510;Drevinukas;PELĖDŽIUKAI;83204594508;Taip;0;5;0;5
1511;Drevinukas;PELĖDŽIUKAI;78255352251;Taip;5;0;0;5
1512;Drevinukas;PELĖDŽIUKAI;59835545517;Taip;7;7;0;14
1513;Drevinukas;PELĖDŽIUKAI;12709943846;Taip;0;7;0;7
1514;Drevinukas;PELĖDŽIUKAI;69217298162;Taip;0;5;2;7
1515;Drevinukas;PELĖDŽIUKAI;47576956459;Taip;5;4;0;9
1516;Drevinukas;PELĖDŽIUKAI;61881364454;Taip;9;0;0;9
1517;Drevinukas;BORUŽĖLĖS;24300552411;Taip;12;0;0;12
1518;Drevinukas;BORUŽĖLĖS;39014589824;Taip;0;1;3;4
1519;Drevinukas;BORUŽĖLĖS;3625661236;Taip;5;6;0;11
1520;Drevinukas;BORUŽĖLĖS;41776089342;Taip;0;5;0;5
1521;Drevinukas;BORUŽĖLĖS;46323011887;Taip;0;9;0;9
1522;Drevinukas;BORUŽĖLĖS;17722412785;Taip;0;5;0;5
1523;Drevinukas;BORUŽĖLĖS;1437074990;Taip;0;0;7;7
1524;Drevinukas;BORUŽĖLĖS;8325320616;Taip;0;0;4;4
1525;Drevinukas;BORUŽĖLĖS;1577311253;Taip;0;5;1;6
1526;Drevinukas;BORUŽĖLĖS;7570410899;Taip;2;0;3;5
1527;Drevinukas;BORUŽĖLĖS;1929303009;Taip;0;1;3;4
1528;Drevinukas;BORUŽĖLĖS;64093448834;Taip;15;0;0;15
1529;Drevinukas;BORUŽĖLĖS;59090501289;Taip;0;2;8;10
1530;Drevinukas;BORUŽĖLĖS;1585468549;Taip;5;5;0;10
1531;Drevinukas;BORUŽĖLĖS;1276720097;Taip;7;0;0;7
1532;Drevinukas;BORUŽĖLĖS;47549756124;Taip;0;2;5;7
1533;Drevinukas;BORUŽĖLĖS;3604979285;Taip;0;2;4;6
1534;Drevinukas;BORUŽĖLĖS;78348414683;Taip;5;5;0;10
1535;Drevinukas;BORUŽĖLĖS;1970787957;Taip;0;9;0;9
1536;Drevinukas;BORUŽĖLĖS;30667895560;Taip;0;5;0;5
1537;Drevinukas;BORUŽĖLĖS;83194462453;Taip;0;6;0;6
1538;Drevinukas;BITUTĖS;81036035477;Taip;0;1;0;1
1539;Drevinukas;BITUTĖS;96688324084;Taip;0;6;1;7
1540;Drevinukas;BITUTĖS;70347618653;Taip;0;9;0;9
1541;Drevinukas;BITUTĖS;24223024745;Taip;10;5;5;20
1542;Drevinukas;BITUTĖS;7088781332;Taip;0;6;0;6
1543;Drevinukas;BITUTĖS;67343152327;Taip;0;6;0;6
1544;Drevinukas;BITUTĖS;79654459964;Taip;2;2;0;4
1545;Drevinukas;BITUTĖS;13511159834;Taip;0;2;0;2
1546;Drevinukas;BITUTĖS;20302237493;Taip;0;5;0;5
1547;Drevinukas;BITUTĖS;7874030637;Taip;0;2;0;2
1548;Drevinukas;BITUTĖS;86268382049;Taip;0;1;0;1
1549;Drevinukas;BITUTĖS;73165075762;Taip;4;0;0;4
1550;Drevinukas;BITUTĖS;91352351942;Taip;0;14;0;14
1551;Drevinukas;BITUTĖS;43573400232;Taip;4;6;0;10
1552;Drevinukas;BITUTĖS;43087053446;Taip;5;5;0;10
1553;Drevinukas;BITUTĖS;81362980445;Taip;2;5;0;7
1554;Drevinukas;BITUTĖS;66058660804;Taip;0;8;0;8
1555;Drevinukas;BITUTĖS;56016757119;Taip;6;5;0;11
1556;Drevinukas;BITUTĖS;62294117396;Taip;3;0;0;3
1557;Drevinukas;BITUTĖS;71273092994;Taip;2;5;0;7
1558;Drevinukas;BITUTĖS;53025453998;Taip;0;2;0;2
1559;Drevinukas;NYKŠTUKAI;1720464417;Taip;0;2;4;6
1560;Drevinukas;NYKŠTUKAI;6095020718;Taip;2;0;2;4
1561;Drevinukas;NYKŠTUKAI;5679723776;Taip;15;5;0;20
1562;Drevinukas;NYKŠTUKAI;2857797268;Taip;2;0;0;2
1563;Drevinukas;NYKŠTUKAI;3875062228;Taip;8;0;0;8
1564;Drevinukas;NYKŠTUKAI;8479979176;Taip;15;0;0;15
1565;Drevinukas;NYKŠTUKAI;2531207946;Taip;15;0;0;15
1566;Drevinukas;NYKŠTUKAI;1152161183;Taip;15;0;0;15
1567;Drevinukas;NYKŠTUKAI;6256572875;Taip;5;0;0;5
1568;Drevinukas;NYKŠTUKAI;8936058501;Taip;0;1;2;3
1569;Drevinukas;NYKŠTUKAI;8130416781;Taip;5;0;0;5
1570;Drevinukas;NYKŠTUKAI;3972897839;Taip;1;0;5;6
1571;Drevinukas;NYKŠTUKAI;9772484901;Taip;0;3;1;4
1572;Drevinukas;NYKŠTUKAI;7520907833;Taip;5;7;0;12
1573;Drevinukas;NYKŠTUKAI;8625382465;Taip;6;0;0;6
1574;Drevinukas;NYKŠTUKAI;5521378389;Taip;5;10;1;16
1575;Drevinukas;SMALSUČIAI;3032536983;Taip;10;0;0;10
1576;Drevinukas;SMALSUČIAI;8556218971;Taip;0;0;5;5
1577;Drevinukas;SMALSUČIAI;5524567803;Taip;0;0;2;2
1578;Drevinukas;SMALSUČIAI;9016985238;Taip;3;0;1;4
1579;Drevinukas;SMALSUČIAI;2929598743;Taip;1;3;0;4
1580;Drevinukas;SMALSUČIAI;8744467866;Taip;13;0;0;13
1581;Drevinukas;SMALSUČIAI;6373230526;Taip;20;0;0;20
1582;Drevinukas;SMALSUČIAI;4404254932;Taip;0;0;2;2
1583;Drevinukas;SMALSUČIAI;2378493422;Taip;8;0;0;8
1584;Drevinukas;SMALSUČIAI;8984653958;Taip;0;6;2;8
1585;Drevinukas;SMALSUČIAI;5620887702;Taip;4;3;0;7
1586;Drevinukas;SMALSUČIAI;2281463885;Taip;10;0;0;10
1587;Drevinukas;SMALSUČIAI;3725760478;Taip;3;0;2;5
1588;Drevinukas;SMALSUČIAI;4662426451;Taip;10;0;0;10
1589;Drevinukas;SMALSUČIAI;7218201733;Taip;3;0;1;4
1590;Drevinukas;ŽVIRBLIUKAI;5348609358;Taip;5;5;0;10
1591;Drevinukas;ŽVIRBLIUKAI;2312241894;Taip;20;0;0;20
1592;Drevinukas;ŽVIRBLIUKAI;5394143000;Taip;0;9;0;9
1593;Drevinukas;ŽVIRBLIUKAI;3871506691;Taip;4;2;0;6
1594;Drevinukas;ŽVIRBLIUKAI;6914111231;Taip;4;2;0;6
1595;Drevinukas;ŽVIRBLIUKAI;3377957769;Taip;5;0;5;10
1596;Drevinukas;ŽVIRBLIUKAI;3779983775;Taip;15;0;0;15
1597;Drevinukas;ŽVIRBLIUKAI;1343431478;Taip;5;0;0;5
1598;Drevinukas;ŽVIRBLIUKAI;8262224710;Taip;4;8;0;12
1599;Drevinukas;ŽVIRBLIUKAI;2935175014;Taip;5;1;2;8
1600;Drevinukas;ŽVIRBLIUKAI;8679024244;Taip;10;0;4;14
1601;Drevinukas;ŽVIRBLIUKAI;5754055310;Taip;7;0;3;10
1602;Drevinukas;ŽVIRBLIUKAI;3046196006;Taip;0;15;0;15
1603;Drevinukas;ŽVIRBLIUKAI;4134729710;Taip;0;0;2;2
1604;Drugelis;NYKŠTUKŲ;17059982861;Taip;0;3;2;5
1605;Drugelis;NYKŠTUKŲ;22204482690;Taip;1;0;0;1
1606;Drugelis;NYKŠTUKŲ;18603741278;Taip;0;1;0;1
1607;Drugelis;NYKŠTUKŲ;182843897;Taip;0;5;0;5
1608;Drugelis;NYKŠTUKŲ;9263055716;Taip;5;5;0;10
1609;Drugelis;NYKŠTUKŲ;91204781931;Taip;0;4;0;4
1610;Drugelis;NYKŠTUKŲ;85144628483;Taip;0;2;2;4
1611;Drugelis;NYKŠTUKŲ;53978775822;Taip;0;3;0;3
1612;Drugelis;NYKŠTUKŲ;90197519022;Taip;0;1;0;1
1613;Drugelis;NYKŠTUKŲ;9923093174;Taip;0;6;0;6
1614;Drugelis;NYKŠTUKŲ;2593184133;Taip;6;1;0;7
1615;Drugelis;NYKŠTUKŲ;41833447251;Taip;0;5;0;5
1616;Drugelis;NYKŠTUKŲ;40524667913;Taip;5;0;0;5
1617;Drugelis;NYKŠTUKŲ;14998254512;Taip;5;6;0;11
1618;Drugelis;NYKŠTUKŲ;62834741685;Taip;0;6;0;6
1619;Drugelis;NYKŠTUKŲ;88553764001;Taip;0;7;0;7
1620;Drugelis;NYKŠTUKŲ;69762633803;Taip;0;2;0;2
1621;Drugelis;NYKŠTUKŲ;16524288155;Taip;0;2;0;2
1622;Drugelis;SMALSUČIŲ;3479833265;Taip;3;2;0;5
1623;Drugelis;SMALSUČIŲ;1217635751;Taip;7;0;0;7
1624;Drugelis;SMALSUČIŲ;3202149560;Taip;3;2;0;5
1625;Drugelis;SMALSUČIŲ;1288160341;Taip;0;2;7;9
1626;Drugelis;SMALSUČIŲ;27569805506;Taip;5;6;0;11
1627;Drugelis;SMALSUČIŲ;1856912386;Taip;4;2;0;6
1628;Drugelis;SMALSUČIŲ;1576853049;Taip;0;5;0;5
1629;Drugelis;SMALSUČIŲ;1901608445;Taip;15;0;0;15
1630;Drugelis;SMALSUČIŲ;3096906506;Taip;0;3;0;3
1631;Drugelis;SMALSUČIŲ;7406396614;Taip;0;2;0;2
1632;Drugelis;SMALSUČIŲ;1255315664;Taip;8;6;0;14
1633;Drugelis;SMALSUČIŲ;1160161173;Taip;0;5;0;5
1634;Drugelis;SMALSUČIŲ;1843605624;Taip;0;6;0;6
1635;Drugelis;SMALSUČIŲ;1506988472;Taip;0;7;0;7
1636;Drugelis;SMALSUČIŲ;1991420008;Taip;0;7;0;7
1637;Drugelis;SMALSUČIŲ;1421438458;Taip;0;6;0;6
1638;Drugelis;SMALSUČIŲ;53874036107;Taip;0;1;0;1
1639;Drugelis;SMALSUČIŲ;4788423265;Taip;0;6;11;17
1640;Drugelis;SMALSUČIŲ;1541276266;Taip;0;2;0;2
1641;Drugelis;SMALSUČIŲ;5954059321;Taip;15;0;0;15
1642;Drugelis;SMALSUČIŲ;1888002607;Taip;0;2;3;5
1643;Drugelis;MUMINUKŲ;51963723965;Taip;7;1;0;8
1644;Drugelis;MUMINUKŲ;89109375373;Taip;0;2;0;2
1645;Drugelis;MUMINUKŲ;10841811704;Taip;0;2;0;2
1646;Drugelis;MUMINUKŲ;55662263930;Taip;0;2;0;2
1647;Drugelis;MUMINUKŲ;78391738678;Taip;0;7;1;8
1648;Drugelis;MUMINUKŲ;63076864410;Taip;0;5;0;5
1649;Drugelis;MUMINUKŲ;44627668646;Taip;10;1;0;11
1650;Drugelis;MUMINUKŲ;35386244403;Taip;0;7;0;7
1651;Drugelis;MUMINUKŲ;37910900277;Ne;0;7;2;9
1652;Drugelis;MUMINUKŲ;85362607749;Taip;0;2;0;2
1653;Drugelis;MUMINUKŲ;13989264253;Taip;0;15;2;17
1654;Drugelis;MUMINUKŲ;25002448923;Taip;0;2;0;2
1655;Drugelis;MUMINUKŲ;55339135155;Taip;0;2;0;2
1656;Drugelis;MUMINUKŲ;82465836364;Taip;5;0;0;5
1657;Drugelis;MUMINUKŲ;63173368598;Taip;0;5;0;5
1658;Drugelis;MUMINUKŲ;1761079726;Taip;8;5;0;13
1659;Drugelis;MUMINUKŲ;82441447907;Taip;9;2;1;12
1660;Drugelis;MUMINUKŲ;70288969200;Taip;0;2;0;2
1661;Drugelis;MUMINUKŲ;72147158912;Taip;0;2;0;2
1662;Drugelis;PŪKUOTUKAI;49035429728;Taip;2;2;3;7
1663;Drugelis;PŪKUOTUKAI;3156382280;Taip;1;2;0;3
1664;Drugelis;PŪKUOTUKAI;59819126556;Taip;3;0;4;7
1665;Drugelis;PŪKUOTUKAI;4989130624;Taip;15;1;0;16
1666;Drugelis;PŪKUOTUKAI;1657445173;Taip;0;5;0;5
1667;Drugelis;PŪKUOTUKAI;91538620813;Taip;0;2;0;2
1668;Drugelis;PŪKUOTUKAI;57217727711;Taip;0;0;3;3
1669;Drugelis;PŪKUOTUKAI;1240607928;Taip;0;3;0;3
1670;Drugelis;PŪKUOTUKAI;68716515660;Taip;5;2;0;7
1671;Drugelis;PŪKUOTUKAI;1162058481;Taip;6;0;0;6
1672;Drugelis;PŪKUOTUKAI;20943932955;Taip;0;0;3;3
1673;Drugelis;PŪKUOTUKAI;1667056936;Taip;0;0;4;4
1674;Drugelis;PŪKUOTUKAI;63777226415;Taip;6;0;0;6
1675;Drugelis;PŪKUOTUKAI;49678120281;Taip;7;0;0;7
1676;Drugelis;PŪKUOTUKAI;1651512363;Taip;0;1;0;1
1677;Drugelis;PŪKUOTUKAI;1546655542;Taip;0;4;0;4
1678;Drugelis;SPINDULIUKAI;6594452094;Taip;10;2;0;12
1679;Drugelis;SPINDULIUKAI;4523513611;Taip;4;2;0;6
1680;Drugelis;SPINDULIUKAI;5122256823;Taip;5;2;0;7
1681;Drugelis;SPINDULIUKAI;7609530453;Taip;9;0;0;9
1682;Drugelis;SPINDULIUKAI;1142209285;Taip;2;4;0;6
1683;Drugelis;SPINDULIUKAI;4158475365;Taip;17;0;0;17
1684;Drugelis;SPINDULIUKAI;9510744779;Taip;0;0;12;12
1685;Drugelis;SPINDULIUKAI;8717445483;Taip;15;1;0;16
1686;Drugelis;SPINDULIUKAI;7477547789;Taip;7;1;0;8
1687;Drugelis;SPINDULIUKAI;4825232236;Taip;9;3;0;12
1688;Drugelis;SPINDULIUKAI;5515894973;Taip;3;1;0;4
1689;Drugelis;SPINDULIUKAI;7447519502;Taip;6;5;0;11
1690;Drugelis;SPINDULIUKAI;7590759136;Taip;15;0;0;15
1691;Drugelis;SPINDULIUKAI;8752459733;Taip;3;2;1;6
1692;Drugelis;SPINDULIUKAI;7719697394;Taip;0;0;11;11
1693;Drugelis;SPINDULIUKAI;5692743298;Taip;9;0;0;9
1694;Drugelis;KIŠKUČIAI;3551095669;Taip;6;1;0;7
1695;Drugelis;KIŠKUČIAI;3061896520;Taip;5;0;0;5
1696;Drugelis;KIŠKUČIAI;8070030439;Taip;5;0;0;5
1697;Drugelis;KIŠKUČIAI;9612696781;Taip;0;4;0;4
1698;Drugelis;KIŠKUČIAI;5691833295;Taip;0;0;10;10
1699;Drugelis;KIŠKUČIAI;4927896706;Taip;9;1;0;10
1700;Drugelis;KIŠKUČIAI;5902687211;Taip;16;0;0;16
1701;Drugelis;KIŠKUČIAI;1785724340;Taip;5;5;0;10
1702;Drugelis;KIŠKUČIAI;6038184222;Taip;0;1;0;1
1703;Drugelis;KIŠKUČIAI;6321332888;Taip;0;12;3;15
1704;Drugelis;KIŠKUČIAI;6452921695;Taip;9;1;0;10
1705;Drugelis;KIŠKUČIAI;6632884258;Taip;5;6;0;11
1706;Drugelis;KIŠKUČIAI;8591548746;Taip;15;0;0;15
1707;"Du gaideliai";Uodelių;7084763712;Taip;0;5;2;7
1708;"Du gaideliai";Uodelių;1758546983;Taip;6;4;4;14
1709;"Du gaideliai";Uodelių;94639433266;Taip;4;1;0;5
1710;"Du gaideliai";Uodelių;1230622413;Taip;11;4;0;15
1711;"Du gaideliai";Uodelių;6715434585;Taip;0;2;0;2
1712;"Du gaideliai";Uodelių;1500684755;Taip;8;5;0;13
1713;"Du gaideliai";Uodelių;4387568448;Taip;4;1;7;12
1714;"Du gaideliai";Uodelių;6750787450;Taip;0;3;0;3
1715;"Du gaideliai";Uodelių;2601122166;Taip;13;7;0;20
1716;"Du gaideliai";Uodelių;5430986033;Taip;0;8;0;8
1717;"Du gaideliai";Uodelių;1876870081;Taip;11;1;0;12
1718;"Du gaideliai";Uodelių;1557413692;Taip;0;15;0;15
1719;"Du gaideliai";Uodelių;3560637865;Taip;0;12;0;12
1720;"Du gaideliai";Uodelių;7783203480;Taip;2;5;0;7
1721;"Du gaideliai";Uodelių;9324740716;Taip;0;9;0;9
1722;"Du gaideliai";Uodelių;1211005513;Taip;0;1;4;5
1723;"Du gaideliai";Uodelių;1549762923;Taip;0;1;0;1
1724;"Du gaideliai";Uodelių;2159833613;Taip;5;9;0;14
1725;"Du gaideliai";Uodelių;6203383711;Taip;0;5;3;8
1726;"Du gaideliai";OŽIUKŲ;25738622801;Taip;13;0;0;13
1727;"Du gaideliai";OŽIUKŲ;50087080642;Taip;13;0;0;13
1728;"Du gaideliai";OŽIUKŲ;91470338843;Taip;5;0;0;5
1729;"Du gaideliai";OŽIUKŲ;2025641113;Taip;0;0;2;2
1730;"Du gaideliai";OŽIUKŲ;1479672134;Taip;14;0;0;14
1731;"Du gaideliai";OŽIUKŲ;88801178853;Taip;9;1;4;14
1732;"Du gaideliai";OŽIUKŲ;60934378499;Taip;5;4;0;9
1733;"Du gaideliai";OŽIUKŲ;1128234653;Taip;12;5;0;17
1734;"Du gaideliai";OŽIUKŲ;14681393632;Taip;5;5;0;10
1735;"Du gaideliai";OŽIUKŲ;13384312035;Taip;7;3;3;13
1736;"Du gaideliai";OŽIUKŲ;30562958921;Taip;0;1;2;3
1737;"Du gaideliai";OŽIUKŲ;1291620608;Taip;20;0;0;20
1738;"Du gaideliai";OŽIUKŲ;1628346439;Taip;4;8;0;12
1739;"Du gaideliai";OŽIUKŲ;1304400387;Taip;7;2;0;9
1740;"Du gaideliai";OŽIUKŲ;80297570999;Taip;5;0;0;5
1741;"Du gaideliai";OŽIUKŲ;1512578437;Ne;0;6;2;8
1742;"Du gaideliai";OŽIUKŲ;1261678548;Taip;0;10;0;10
1743;"Du gaideliai";OŽIUKŲ;73447542654;Taip;6;1;0;7
1744;"Du gaideliai";OŽIUKŲ;1906486044;Taip;0;2;0;2
1745;"Du gaideliai";OŽIUKŲ;41922349110;Taip;0;3;0;3
1746;"Du gaideliai";OŽIUKŲ;6161829923;Taip;0;13;0;13
1747;"Du gaideliai";OŽIUKŲ;85962801220;Taip;11;2;0;13
1748;"Du gaideliai";OŽIUKŲ;1923863232;Taip;1;6;0;7
1749;"Du gaideliai";Vištyčių;1888402861;Taip;10;5;0;15
1750;"Du gaideliai";Vištyčių;31139048776;Taip;6;7;0;13
1751;"Du gaideliai";Vištyčių;25898248315;Taip;0;8;0;8
1752;"Du gaideliai";Vištyčių;56826255179;Taip;12;1;0;13
1753;"Du gaideliai";Vištyčių;10516676378;Taip;3;2;0;5
1754;"Du gaideliai";Vištyčių;11621795110;Taip;0;2;0;2
1755;"Du gaideliai";Vištyčių;59558745879;Taip;20;0;0;20
1756;"Du gaideliai";Vištyčių;14599820571;Taip;13;0;0;13
1757;"Du gaideliai";Vištyčių;8087660692;Taip;12;1;0;13
1758;"Du gaideliai";Vištyčių;46193129936;Taip;0;6;0;6
1759;"Du gaideliai";Vištyčių;82205925738;Taip;0;1;0;1
1760;"Du gaideliai";Vištyčių;9173656753;Taip;8;5;0;13
1761;"Du gaideliai";Vištyčių;1277603882;Taip;0;2;0;2
1762;"Du gaideliai";Vištyčių;73654636959;Taip;9;5;0;14
1763;"Du gaideliai";Vištyčių;1850550387;Taip;0;9;0;9
1764;"Du gaideliai";Vištyčių;1258859998;Taip;7;1;0;8
1765;"Du gaideliai";Vištyčių;2157315097;Taip;0;5;0;5
1766;"Du gaideliai";Vištyčių;1823681047;Taip;0;15;0;15
1767;"Du gaideliai";Vištyčių;5028304472;Taip;14;0;0;14
1768;"Du gaideliai";GAIDŽIUKŲ;9478614075;Taip;0;5;0;5
1769;"Du gaideliai";GAIDŽIUKŲ;32735548453;Taip;1;0;0;1
1770;"Du gaideliai";GAIDŽIUKŲ;13544785168;Taip;4;2;0;6
1771;"Du gaideliai";GAIDŽIUKŲ;98790674632;Taip;5;5;0;10
1772;"Du gaideliai";GAIDŽIUKŲ;94409399599;Taip;0;8;0;8
1773;"Du gaideliai";GAIDŽIUKŲ;67678569738;Taip;10;0;4;14
1774;"Du gaideliai";GAIDŽIUKŲ;10671107948;Taip;0;4;0;4
1775;"Du gaideliai";GAIDŽIUKŲ;79968702371;Taip;0;4;2;6
1776;"Du gaideliai";GAIDŽIUKŲ;24753427184;Taip;10;5;0;15
1777;"Du gaideliai";GAIDŽIUKŲ;63476686143;Ne;0;5;0;5
1778;"Du gaideliai";GAIDŽIUKŲ;65144471076;Taip;0;2;4;6
1779;"Du gaideliai";GAIDŽIUKŲ;83990613379;Taip;0;1;0;1
1780;"Du gaideliai";GAIDŽIUKŲ;1016464081;Taip;0;5;0;5
1781;"Du gaideliai";GAIDŽIUKŲ;74161177222;Taip;4;0;0;4
1782;"Du gaideliai";GAIDŽIUKŲ;97364620242;Ne;0;17;0;17
1783;"Du gaideliai";GAIDŽIUKŲ;8471369515;Taip;0;6;0;6
1784;"Du gaideliai";GAIDŽIUKŲ;79558840364;Taip;0;4;0;4
1785;"Du gaideliai";GAIDŽIUKŲ;71411267197;Taip;0;1;0;1
1786;"Du gaideliai";GAIDŽIUKŲ;8643242715;Taip;0;7;0;7
1787;"Du gaideliai";GAIDŽIUKŲ;87984135142;Taip;0;5;0;5
1788;"Du gaideliai";GAIDŽIUKŲ;40776415914;Taip;4;1;0;5
1789;"Du gaideliai";Musyčių;4144269068;Taip;7;6;0;13
1790;"Du gaideliai";Musyčių;3370029981;Taip;0;6;0;6
1791;"Du gaideliai";Musyčių;5103483956;Taip;0;8;0;8
1792;"Du gaideliai";Musyčių;4378924981;Taip;6;2;0;8
1793;"Du gaideliai";Musyčių;7373413569;Taip;5;6;0;11
1794;"Du gaideliai";Musyčių;6783206132;Taip;19;0;0;19
1795;"Du gaideliai";Musyčių;3507387826;Taip;10;8;0;18
1796;"Du gaideliai";Musyčių;1785976627;Taip;5;1;0;6
1797;"Du gaideliai";Musyčių;2921485707;Taip;8;1;0;9
1798;"Du gaideliai";Musyčių;5894974508;Taip;7;5;0;12
1799;"Du gaideliai";Musyčių;1135098595;Taip;15;2;0;17
1800;"Du gaideliai";Musyčių;5652662610;Taip;7;5;0;12
1801;"Du gaideliai";Musyčių;6348951959;Taip;14;0;0;14
1802;"Du gaideliai";Musyčių;3854355215;Taip;17;0;0;17
1803;"Du gaideliai";Musyčių;3849899284;Taip;20;0;0;20
1804;"Du gaideliai";Musyčių;2262425557;Taip;20;0;0;20
1805;"Du gaideliai";Musyčių;6417648753;Taip;10;0;4;14
1806;"Du gaideliai";MALŪNO;6247706405;Taip;7;0;0;7
1807;"Du gaideliai";MALŪNO;6870356241;Taip;0;5;0;5
1808;"Du gaideliai";MALŪNO;7033276798;Taip;0;2;2;4
1809;"Du gaideliai";MALŪNO;1268479215;Taip;5;2;0;7
1810;"Du gaideliai";MALŪNO;5728374219;Taip;4;0;0;4
1811;"Du gaideliai";MALŪNO;6015360076;Taip;0;13;0;13
1812;"Du gaideliai";MALŪNO;5998344519;Taip;20;0;0;20
1813;"Du gaideliai";MALŪNO;8043896286;Taip;10;0;0;10
1814;"Du gaideliai";MALŪNO;2240947701;Taip;7;3;0;10
1815;"Du gaideliai";MALŪNO;6120647567;Taip;8;3;0;11
1816;"Du gaideliai";MALŪNO;4798503931;Taip;11;0;0;11
1817;"Du gaideliai";MALŪNO;3247101840;Taip;20;0;0;20
1818;Eglutė;RAMUNĖ;58949721375;Taip;0;6;0;6
1819;Eglutė;RAMUNĖ;86332858914;Taip;0;5;0;5
1820;Eglutė;RAMUNĖ;90728032521;Taip;0;5;0;5
1821;Eglutė;RAMUNĖ;71905692638;Taip;0;2;0;2
1822;Eglutė;RAMUNĖ;48107118284;Taip;11;0;0;11
1823;Eglutė;RAMUNĖ;18336619115;Taip;0;5;0;5
1824;Eglutė;RAMUNĖ;73455764001;Taip;0;5;0;5
1825;Eglutė;RAMUNĖ;99937268711;Taip;0;5;0;5
1826;Eglutė;RAMUNĖ;42898142937;Taip;4;2;0;6
1827;Eglutė;RAMUNĖ;48271429590;Taip;0;1;0;1
1828;Eglutė;RAMUNĖ;60233622647;Taip;0;2;0;2
1829;Eglutė;RAMUNĖ;9492889889;Taip;9;6;0;15
1830;Eglutė;RAMUNĖ;45851193886;Taip;0;10;0;10
1831;Eglutė;RAMUNĖ;54671481514;Taip;5;1;0;6
1832;Eglutė;RAMUNĖ;87045022282;Taip;0;0;1;1
1833;Eglutė;RAMUNĖ;73442251672;Taip;0;1;0;1
1834;Eglutė;RAMUNĖ;26590185216;Taip;0;3;0;3
1835;Eglutė;RAMUNĖ;60500002903;Taip;10;0;0;10
1836;Eglutė;RAMUNĖ;59228063911;Taip;10;0;0;10
1837;Eglutė;RAMUNĖ;89786711506;Taip;0;5;0;5
1838;Eglutė;RAMUNĖ;12750056416;Taip;0;3;0;3
1839;Eglutė;RAMUNĖ;51769852427;Taip;0;5;7;12
1840;Eglutė;RAMUNĖ;93415626815;Taip;15;5;0;20
1841;Eglutė;RAMUNĖ;65706339440;Taip;0;1;0;1
1842;Eglutė;PELĖDŽIUKAI;72590410220;Taip;0;7;1;8
1843;Eglutė;PELĖDŽIUKAI;49145620813;Taip;10;0;0;10
1844;Eglutė;PELĖDŽIUKAI;1668758645;Taip;10;0;1;11
1845;Eglutė;PELĖDŽIUKAI;5625034056;Taip;5;5;0;10
1846;Eglutė;PELĖDŽIUKAI;85774102049;Taip;7;0;1;8
1847;Eglutė;PELĖDŽIUKAI;46538092543;Taip;0;5;1;6
1848;Eglutė;PELĖDŽIUKAI;2092342476;Taip;10;9;0;19
1849;Eglutė;PELĖDŽIUKAI;70857129908;Taip;0;5;5;10
1850;Eglutė;PELĖDŽIUKAI;77689530230;Taip;0;8;0;8
1851;Eglutė;PELĖDŽIUKAI;584301494;Taip;0;0;2;2
1852;Eglutė;PELĖDŽIUKAI;14576118725;Taip;0;4;5;9
1853;Eglutė;PELĖDŽIUKAI;72428098332;Taip;0;1;2;3
1854;Eglutė;PELĖDŽIUKAI;66053397092;Taip;5;5;1;11
1855;Eglutė;PELĖDŽIUKAI;41303920332;Taip;0;1;4;5
1856;Eglutė;PELĖDŽIUKAI;4857192691;Taip;0;5;4;9
1857;Eglutė;PELĖDŽIUKAI;1909791840;Taip;0;5;7;12
1858;Eglutė;PELĖDŽIUKAI;2045454657;Taip;0;5;7;12
1859;Eglutė;PELĖDŽIUKAI;50552087321;Taip;11;4;0;15
1860;Eglutė;PELĖDŽIUKAI;87481211277;Taip;0;5;5;10
1861;Eglutė;PELĖDŽIUKAI;74449042391;Taip;0;5;1;6
1862;Eglutė;PELĖDŽIUKAI;1553160829;Taip;5;5;2;12
1863;Eglutė;PELĖDŽIUKAI;6248194593;Taip;15;3;0;18
1864;Eglutė;PELĖDŽIUKAI;80113201617;Taip;0;0;1;1
1865;Eglutė;PELĖDŽIUKAI;90430489503;Taip;0;9;0;9
1866;Eglutė;KODĖLČIUKAI;85964105325;Taip;0;5;5;10
1867;Eglutė;KODĖLČIUKAI;6403410879;Taip;10;5;1;16
1868;Eglutė;KODĖLČIUKAI;1939447097;Taip;6;0;0;6
1869;Eglutė;KODĖLČIUKAI;1881111005;Taip;6;0;0;6
1870;Eglutė;KODĖLČIUKAI;1100326735;Taip;6;7;0;13
1871;Eglutė;KODĖLČIUKAI;1398611395;Taip;0;11;0;11
1872;Eglutė;KODĖLČIUKAI;2041825568;Taip;10;5;0;15
1873;Eglutė;KODĖLČIUKAI;1814357743;Taip;5;0;0;5
1874;Eglutė;KODĖLČIUKAI;1356175751;Taip;7;1;1;9
1875;Eglutė;KODĖLČIUKAI;2147042152;Taip;6;0;0;6
1876;Eglutė;KODĖLČIUKAI;1112445550;Taip;0;0;10;10
1877;Eglutė;KODĖLČIUKAI;78489473446;Taip;8;0;1;9
1878;Eglutė;KODĖLČIUKAI;63268716266;Taip;5;0;0;5
1879;Eglutė;KODĖLČIUKAI;1418516444;Taip;5;1;2;8
1880;Eglutė;KODĖLČIUKAI;2112417439;Taip;18;0;0;18
1881;Eglutė;KODĖLČIUKAI;64360778537;Taip;8;0;0;8
1882;Eglutė;KODĖLČIUKAI;1426211949;Taip;8;2;0;10
1883;Eglutė;KODĖLČIUKAI;1120848949;Taip;0;20;0;20
1884;Eglutė;KODĖLČIUKAI;1882915662;Taip;5;0;0;5
1885;Eglutė;KODĖLČIUKAI;1747424609;Taip;10;1;1;12
1886;Eglutė;KODĖLČIUKAI;1485521357;Taip;10;0;0;10
1887;Eglutė;KODĖLČIUKAI;1040409859;Taip;15;0;0;15
1888;Eglutė;KODĖLČIUKAI;1227167233;Taip;10;2;0;12
1889;Eglutė;KODĖLČIUKAI;1187563631;Taip;7;1;1;9
1890;Eglutė;KODĖLČIUKAI;90878878800;Taip;10;1;0;11
1891;Eglutė;KODĖLČIUKAI;7132999520;Taip;10;2;0;12
1892;Eglutė;OBUOLIUKAI;7354260503;Taip;9;6;0;15
1893;Eglutė;OBUOLIUKAI;5731355126;Taip;11;4;0;15
1894;Eglutė;OBUOLIUKAI;7629424045;Taip;10;0;0;10
1895;Eglutė;OBUOLIUKAI;9527732584;Taip;4;3;0;7
1896;Eglutė;OBUOLIUKAI;1122308715;Taip;11;1;0;12
1897;Eglutė;OBUOLIUKAI;9771473322;Taip;11;0;0;11
1898;Eglutė;OBUOLIUKAI;7307564177;Taip;0;5;11;16
1899;Eglutė;OBUOLIUKAI;3856651647;Ne;10;0;0;10
1900;Eglutė;OBUOLIUKAI;1265463853;Taip;0;0;15;15
1901;Eglutė;OBUOLIUKAI;8364693548;Taip;10;2;1;13
1902;Eglutė;OBUOLIUKAI;8162972897;Taip;10;0;0;10
1903;Eglutė;OBUOLIUKAI;8703243352;Taip;0;0;4;4
1904;Eglutė;OBUOLIUKAI;6891834971;Taip;0;13;0;13
1905;Eglutė;OBUOLIUKAI;1712276393;Taip;7;0;1;8
1906;Eglutė;OBUOLIUKAI;8523618773;Taip;11;0;4;15
1907;Eglutė;OBUOLIUKAI;1321901982;Taip;0;6;0;6
1908;Eglutė;OBUOLIUKAI;8421062747;Taip;7;6;0;13
1909;Eglutė;OBUOLIUKAI;3081691175;Taip;0;20;0;20
1910;Eglutė;OBUOLIUKAI;3775081619;Taip;9;0;0;9
1911;Eglutė;OBUOLIUKAI;9992438336;Taip;10;5;0;15
1912;Eglutė;OBUOLIUKAI;1908835124;Taip;3;2;0;5
1913;Eglutė;KAŠTONAS;1565149756;Taip;4;3;0;7
1914;Eglutė;KAŠTONAS;7506194777;Taip;5;2;0;7
1915;Eglutė;KAŠTONAS;92489023262;Taip;0;3;0;3
1916;Eglutė;KAŠTONAS;55334393780;Taip;0;15;0;15
1917;Eglutė;KAŠTONAS;40880035310;Taip;7;6;0;13
1918;Eglutė;KAŠTONAS;5214574745;Taip;0;7;0;7
1919;Eglutė;KAŠTONAS;82988135134;Taip;0;5;0;5
1920;Eglutė;KAŠTONAS;83194451903;Taip;0;2;0;2
1921;Eglutė;KAŠTONAS;96041043843;Taip;0;11;0;11
1922;Eglutė;KAŠTONAS;37576322876;Taip;0;5;0;5
1923;Eglutė;KAŠTONAS;46002742287;Ne;0;6;0;6
1924;Eglutė;KAŠTONAS;95597529215;Taip;0;1;1;2
1925;Eglutė;KAŠTONAS;3997033;Taip;0;20;0;20
1926;Eglutė;KAŠTONAS;83912035659;Taip;0;6;0;6
1927;Eglutė;KAŠTONAS;44421461989;Taip;0;7;0;7
1928;Eglutė;KAŠTONAS;40325923876;Taip;0;5;0;5
1929;Eglutė;KAŠTONAS;91896736509;Taip;0;5;0;5
1930;Eglutė;KAŠTONAS;50471207849;Taip;0;6;0;6
1931;Eglutė;KAŠTONAS;6542189095;Taip;0;11;0;11
1932;Eglutė;KAŠTONAS;75229333120;Ne;0;7;0;7
1933;Eglutė;KAŠTONAS;10122792768;Taip;6;6;0;12
1934;Eglutė;KAŠTONAS;1905376778;Taip;0;7;1;8
1935;Eglutė;KAŠTONAS;77296894224;Taip;0;0;2;2
1936;Eglutė;KAŠTONAS;2029176205;Taip;16;0;0;16
1937;Eglutė;KAŠTONAS;69979676570;Taip;0;1;0;1
1938;Eglutė;EŽIUKAI;2808806070;Taip;0;5;3;8
1939;Eglutė;EŽIUKAI;58699109274;Taip;6;0;0;6
1940;Eglutė;EŽIUKAI;15852252535;Taip;0;1;0;1
1941;Eglutė;EŽIUKAI;20502611523;Taip;0;5;0;5
1942;Eglutė;EŽIUKAI;27038409488;Taip;0;5;0;5
1943;Eglutė;EŽIUKAI;58521679969;Ne;0;9;0;9
1944;Eglutė;EŽIUKAI;16522997461;Ne;0;1;1;2
1945;Eglutė;EŽIUKAI;70702928356;Ne;5;12;0;17
1946;Eglutė;EŽIUKAI;6066756372;Taip;0;5;0;5
1947;Eglutė;EŽIUKAI;9976231692;Taip;0;5;0;5
1948;Eglutė;EŽIUKAI;59146493060;Taip;0;0;2;2
1949;Eglutė;EŽIUKAI;83443573014;Ne;5;0;0;5
1950;Eglutė;EŽIUKAI;33254488808;Ne;0;6;0;6
1951;Eglutė;EŽIUKAI;93769554398;Taip;5;9;0;14
1952;Eglutė;EŽIUKAI;619528177;Taip;0;10;0;10
1953;Eglutė;EŽIUKAI;39537089288;Taip;0;5;1;6
1954;Eglutė;EŽIUKAI;84721839602;Taip;5;0;3;8
1955;Eglutė;EŽIUKAI;9318501404;Taip;5;6;0;11
1956;Eglutė;EŽIUKAI;6570561861;Taip;0;5;0;5
1957;Eglutė;EŽIUKAI;8213137021;Taip;0;5;0;5
1958;Eglutė;EŽIUKAI;87191303145;Taip;5;2;0;7
1959;Eglutė;GILĖ;1308252968;Taip;5;0;1;6
1960;Eglutė;GILĖ;2053316445;Taip;7;2;2;11
1961;Eglutė;GILĖ;1954232966;Taip;16;0;0;16
1962;Eglutė;GILĖ;70203658097;Ne;11;5;0;16
1963;Eglutė;GILĖ;62257831469;Taip;13;2;0;15
1964;Eglutė;GILĖ;18202528233;Taip;14;0;0;14
1965;Eglutė;GILĖ;9375046883;Taip;5;1;0;6
1966;Eglutė;GILĖ;60257242941;Taip;0;18;0;18
1967;Eglutė;GILĖ;1125331552;Ne;0;0;3;3
1968;Eglutė;GILĖ;75731523422;Taip;10;1;0;11
1969;Eglutė;GILĖ;82910530417;Taip;0;8;0;8
1970;Eglutė;GILĖ;7035023835;Ne;0;3;6;9
1971;Eglutė;GILĖ;51884188642;Taip;9;0;3;12
1972;Eglutė;GILĖ;67038463806;Taip;5;5;1;11
1973;Eglutė;GILĖ;61256135116;Taip;18;0;0;18
1974;Eglutė;GILĖ;2138306323;Taip;0;2;4;6
1975;Eglutė;GILĖ;32102678081;Taip;0;5;8;13
1976;Eglutė;GILĖ;65593915933;Ne;0;0;2;2
1977;Eglutė;GILĖ;15019818974;Taip;0;10;0;10
1978;Eglutė;GILĖ;9169758481;Taip;0;1;4;5
1979;Eglutė;GILĖ;92526575353;Taip;6;3;0;9
1980;Eglutė;GILĖ;24785196945;Taip;0;4;4;8
1981;Eglutė;GILĖ;95274378693;Taip;10;0;0;10
1982;Eglutė;GILĖ;64518610112;Taip;0;5;0;5
1983;Eglutė;GILĖ;3725462135;Taip;3;7;2;12
1984;Eglutė;GILĖ;6323002362;Taip;8;5;0;13
1985;Eglutė;GILĖ;26716650724;Taip;0;6;0;6
1986;Eglutė;SAULUTĖ;72153018644;Taip;0;10;0;10
1987;Eglutė;SAULUTĖ;27441180688;Taip;0;5;0;5
1988;Eglutė;SAULUTĖ;2395506996;Ne;4;0;0;4
1989;Eglutė;SAULUTĖ;37487292437;Taip;4;9;0;13
1990;Eglutė;SAULUTĖ;1935089263;Taip;5;5;0;10
1991;Eglutė;SAULUTĖ;1555843610;Taip;7;0;0;7
1992;Eglutė;SAULUTĖ;1161438789;Taip;10;0;0;10
1993;Eglutė;SAULUTĖ;1864153865;Taip;0;0;3;3
1994;Eglutė;SAULUTĖ;2547404429;Taip;0;5;0;5
1995;Eglutė;SAULUTĖ;49268076669;Taip;13;0;0;13
1996;Eglutė;SAULUTĖ;65985749472;Taip;0;1;0;1
1997;Eglutė;SAULUTĖ;20582720349;Taip;3;0;0;3
1998;Eglutė;SAULUTĖ;7744905325;Taip;5;8;0;13
1999;Eglutė;SAULUTĖ;1347527598;Taip;0;5;0;5
2000;Eglutė;SAULUTĖ;1477651468;Taip;3;0;0;3
2001;Eglutė;SAULUTĖ;1306820123;Taip;6;0;0;6
2002;Eglutė;SAULUTĖ;2109443590;Taip;5;0;3;8
2003;Eglutė;SAULUTĖ;1272418234;Taip;0;0;2;2
2004;Eglutė;SAULUTĖ;1753853153;Taip;10;4;0;14
2005;Eglutė;SAULUTĖ;1044133613;Taip;0;6;0;6
2006;Eglutė;SAULUTĖ;1180482309;Taip;4;0;7;11
2007;Eglutė;SAULUTĖ;4248739383;Taip;0;9;0;9
2008;Eglutė;SAULUTĖ;2087083722;Taip;5;0;2;7
2009;Eglutė;SAULUTĖ;1859052313;Taip;8;5;0;13
2010;Eglutė;ŠARKELĖ;2082716398;Taip;10;5;0;15
2011;Eglutė;ŠARKELĖ;1324622835;Taip;20;0;0;20
2012;Eglutė;ŠARKELĖ;9173875647;Taip;0;0;2;2
2013;Eglutė;ŠARKELĖ;6518497374;Taip;0;16;0;16
2014;Eglutė;ŠARKELĖ;3275796441;Taip;0;0;2;2
2015;Eglutė;ŠARKELĖ;1209962222;Taip;7;0;3;10
2016;Eglutė;ŠARKELĖ;3203786388;Taip;0;0;3;3
2017;Eglutė;ŠARKELĖ;8033370429;Taip;0;0;1;1
2018;Eglutė;ŠARKELĖ;3616979217;Taip;0;0;5;5
2019;Eglutė;ŠARKELĖ;7148210944;Ne;0;12;0;12
2020;Eglutė;ŠARKELĖ;9066178904;Taip;0;10;0;10
2021;Eglutė;ŠARKELĖ;9488150450;Taip;0;5;5;10
2022;Eglutė;ŠARKELĖ;3393414294;Taip;1;0;1;2
2023;Eglutė;ŠARKELĖ;7823828202;Taip;10;0;0;10
2024;Eglutė;ŠARKELĖ;3178489517;Taip;11;0;4;15
2025;Eglutė;ŠARKELĖ;1004866224;Taip;5;0;0;5
2026;Eglutė;ŠARKELĖ;2638807860;Taip;10;0;0;10
2027;Eglutė;ŠARKELĖ;6835296034;Taip;5;0;2;7
2028;Eglutė;ŠARKELĖ;9950953029;Taip;6;0;1;7
2029;Eglutė;NYKŠTUKAI;5943856319;Taip;5;0;0;5
2030;Eglutė;NYKŠTUKAI;9402686801;Taip;9;7;0;16
2031;Eglutė;NYKŠTUKAI;2783338563;Taip;10;0;0;10
2032;Eglutė;NYKŠTUKAI;2252971349;Taip;5;5;4;14
2033;Eglutė;NYKŠTUKAI;6544877723;Taip;0;3;1;4
2034;Eglutė;NYKŠTUKAI;1050313582;Taip;4;0;0;4
2035;Eglutė;NYKŠTUKAI;1534556744;Taip;7;0;0;7
2036;Eglutė;NYKŠTUKAI;6093932811;Taip;7;4;0;11
2037;Eglutė;NYKŠTUKAI;3473388722;Taip;8;0;0;8
2038;Eglutė;NYKŠTUKAI;3006381069;Taip;10;4;1;15
2039;Eglutė;NYKŠTUKAI;5563593953;Taip;3;0;0;3
2040;Eglutė;NYKŠTUKAI;2597978713;Taip;0;5;1;6
2041;Eglutė;NYKŠTUKAI;6105927493;Taip;0;2;1;3
2042;Eglutė;NYKŠTUKAI;4230594049;Taip;15;0;0;15
2043;Eglutė;NYKŠTUKAI;5505398901;Taip;0;0;20;20
2044;Eglutė;NYKŠTUKAI;2651867769;Taip;1;0;0;1
2045;Eglutė;NYKŠTUKAI;8493750509;Taip;8;0;0;8
2046;Eglutė;NYKŠTUKAI;7491022301;Taip;10;2;3;15
2047;Eglutė;NYKŠTUKAI;2357276888;Taip;7;0;0;7
2048;Eglutė;NYKŠTUKAI;3985929379;Taip;14;0;1;15
2049;Eglutė;NYKŠTUKAI;3483007385;Taip;0;5;12;17
2050;Eglutė;ŽIRNIUKAI;1759383841;Taip;0;12;0;12
2051;Eglutė;ŽIRNIUKAI;4348313801;Taip;0;5;0;5
2052;Eglutė;ŽIRNIUKAI;9967488317;Taip;10;1;0;11
2053;Eglutė;ŽIRNIUKAI;7758643349;Taip;8;0;0;8
2054;Eglutė;ŽIRNIUKAI;5924994736;Taip;5;3;0;8
2055;Eglutė;ŽIRNIUKAI;3883122650;Taip;6;0;0;6
2056;Eglutė;ŽIRNIUKAI;1550045866;Taip;0;3;3;6
2057;Eglutė;ŽIRNIUKAI;3605053253;Taip;0;0;20;20
2058;Eglutė;ŽIRNIUKAI;7404631298;Taip;20;0;0;20
2059;Eglutė;ŽIRNIUKAI;7446423510;Taip;10;0;0;10
2060;Eglutė;ŽIRNIUKAI;1842517164;Taip;10;0;6;16
2061;Eglutė;ŽIRNIUKAI;2240154775;Taip;0;4;0;4
2062;Eglutė;ŽIRNIUKAI;7047262367;Taip;0;16;0;16
2063;Eglutė;ŽIRNIUKAI;4176597208;Taip;3;0;3;6
2064;Eglutė;ŽIRNIUKAI;3584247594;Taip;0;20;0;20
2065;Eglutė;ŽIRNIUKAI;8797889347;Taip;16;0;0;16
2066;Eglutė;ŽIRNIUKAI;1835565594;Taip;8;5;0;13
2067;Eglutė;BORUŽIUKAI;9439309687;Taip;1;0;3;4
2068;Eglutė;BORUŽIUKAI;8943684351;Taip;0;2;0;2
2069;Eglutė;BORUŽIUKAI;6597261061;Taip;1;0;0;1
2070;Eglutė;BORUŽIUKAI;1932785408;Taip;0;0;2;2
2071;Eglutė;BORUŽIUKAI;6328900251;Taip;0;9;0;9
2072;Eglutė;BORUŽIUKAI;7859815752;Taip;6;6;0;12
2073;Eglutė;BORUŽIUKAI;1422631723;Taip;0;20;0;20
2074;Eglutė;BORUŽIUKAI;1531942494;Taip;0;0;20;20
2075;Eglutė;BORUŽIUKAI;7778598035;Taip;4;5;0;9
2076;Eglutė;BORUŽIUKAI;6483580751;Taip;0;0;2;2
2077;Eglutė;BORUŽIUKAI;9661883776;Taip;0;16;0;16
2078;Eglutė;BORUŽIUKAI;8165126017;Taip;5;0;2;7
2079;Eglutė;BORUŽIUKAI;4451772812;Taip;6;0;5;11
2080;Eglutė;BORUŽIUKAI;8933416279;Taip;6;0;4;10
2081;Eglutė;BORUŽIUKAI;9046652370;Taip;0;0;17;17
2082;Aušrinė;Varpeliai;40427909744;Taip;10;5;1;16
2083;Aušrinė;Varpeliai;73663919787;Taip;0;4;0;4
2084;Aušrinė;Varpeliai;1182643102;Taip;9;0;2;11
2085;Aušrinė;Varpeliai;2030227606;Taip;0;20;0;20
2086;Aušrinė;Varpeliai;51725342242;Ne;6;5;0;11
2087;Aušrinė;Varpeliai;1448250372;Taip;3;5;0;8
2088;Aušrinė;Varpeliai;68192824475;Taip;11;0;0;11
2089;Aušrinė;Varpeliai;69919525470;Taip;0;12;0;12
2090;Aušrinė;Varpeliai;11187944085;Taip;0;1;1;2
2091;Aušrinė;Varpeliai;1278319590;Taip;18;0;0;18
2092;Aušrinė;Varpeliai;3356127625;Taip;20;0;0;20
2093;Aušrinė;Varpeliai;1148796296;Taip;5;8;0;13
2094;Aušrinė;Varpeliai;1927141701;Taip;2;4;0;6
2095;Aušrinė;Varpeliai;1515536619;Taip;0;2;0;2
2096;Aušrinė;Varpeliai;1996032555;Taip;5;5;4;14
2097;Aušrinė;Varpeliai;9989277772;Taip;7;2;5;14
2098;Aušrinė;Varpeliai;5306416511;Taip;0;5;0;5
2099;Aušrinė;Varpeliai;1000417905;Taip;5;9;0;14
2100;Aušrinė;Bitutės;58768831540;Taip;3;0;0;3
2101;Aušrinė;Bitutės;97658375230;Taip;0;2;1;3
2102;Aušrinė;Bitutės;1303589037;Taip;0;5;1;6
2103;Aušrinė;Bitutės;1601648171;Taip;6;5;0;11
2104;Aušrinė;Bitutės;4903762612;Taip;0;1;0;1
2105;Aušrinė;Bitutės;17061806895;Taip;9;5;0;14
2106;Aušrinė;Bitutės;6443602669;Taip;0;3;3;6
2107;Aušrinė;Bitutės;7796318812;Taip;0;5;0;5
2108;Aušrinė;Bitutės;83017543760;Taip;0;2;0;2
2109;Aušrinė;Bitutės;6318538591;Taip;0;4;0;4
2110;Aušrinė;Bitutės;3035781587;Taip;5;0;2;7
2111;Aušrinė;Bitutės;9605160359;Taip;0;15;0;15
2112;Aušrinė;Bitutės;5090847702;Taip;5;0;2;7
2113;Aušrinė;Bitutės;1399518471;Taip;0;2;0;2
2114;Aušrinė;Bitutės;25590576293;Taip;0;11;0;11
2115;Aušrinė;Bitutės;7507448059;Taip;2;5;0;7
2116;Aušrinė;Bitutės;1291308838;Taip;3;0;0;3
2117;Aušrinė;Bitutės;63299644698;Taip;5;5;0;10
2118;Aušrinė;Bitutės;2526585854;Taip;0;11;0;11
2119;Aušrinė;Drugeliai;2043278242;Taip;8;1;0;9
2120;Aušrinė;Drugeliai;32489318287;Taip;7;0;1;8
2121;Aušrinė;Drugeliai;1343667707;Taip;10;1;0;11
2122;Aušrinė;Drugeliai;96010737590;Taip;10;4;0;14
2123;Aušrinė;Drugeliai;5729812682;Taip;9;5;0;14
2124;Aušrinė;Drugeliai;1133359254;Taip;15;5;0;20
2125;Aušrinė;Drugeliai;30244366906;Taip;5;6;0;11
2126;Aušrinė;Drugeliai;1974161463;Taip;10;7;0;17
2127;Aušrinė;Drugeliai;1184543607;Taip;12;0;0;12
2128;Aušrinė;Drugeliai;1573790467;Taip;0;15;1;16
2129;Aušrinė;Drugeliai;1944291082;Taip;11;1;1;13
2130;Aušrinė;Drugeliai;48118825872;Taip;5;5;1;11
2131;Aušrinė;Drugeliai;2069277030;Taip;10;5;0;15
2132;Aušrinė;Drugeliai;1065470806;Taip;20;0;0;20
2133;Aušrinė;Drugeliai;1206863546;Taip;0;2;2;4
2134;Aušrinė;Drugeliai;2022412040;Taip;10;0;0;10
2135;Aušrinė;Drugeliai;1501614270;Taip;3;1;0;4
2136;Aušrinė;Drugeliai;6265909152;Taip;17;0;1;18
2137;Aušrinė;Drugeliai;1532235421;Taip;14;0;0;14
2138;Aušrinė;Drugeliai;2212814026;Taip;15;2;0;17
2139;Aušrinė;Boružėlės;7052024709;Taip;7;0;1;8
2140;Aušrinė;Boružėlės;1298127839;Taip;0;1;0;1
2141;Aušrinė;Boružėlės;8364033602;Taip;20;0;0;20
2142;Aušrinė;Boružėlės;1151612627;Taip;0;5;2;7
2143;Aušrinė;Boružėlės;1009453682;Taip;0;10;0;10
2144;Aušrinė;Boružėlės;3544848804;Taip;15;0;0;15
2145;Aušrinė;Boružėlės;6136579994;Taip;4;0;0;4
2146;Aušrinė;Boružėlės;8463758715;Taip;2;6;0;8
2147;Aušrinė;Boružėlės;4579700769;Taip;0;6;1;7
2148;Aušrinė;Boružėlės;7268811782;Taip;10;2;0;12
2149;Aušrinė;Boružėlės;3042409414;Taip;2;13;1;16
2150;Aušrinė;Boružėlės;1831094707;Taip;12;1;0;13
2151;Aušrinė;Boružėlės;3593323270;Taip;5;6;0;11
2152;Aušrinė;Boružėlės;3795927209;Taip;6;5;0;11
2153;Aušrinė;Boružėlės;5283207520;Taip;0;5;1;6
2154;Aušrinė;Boružėlės;1116822936;Taip;10;0;0;10
2155;Aušrinė;Boružėlės;6226967695;Taip;4;1;0;5
2156;Aušrinė;Boružėlės;9226214856;Taip;6;0;1;7
2157;Aušrinė;Boružėlės;4562536818;Taip;7;0;0;7
2158;Aušrinė;Boružėlės;71379978884;Ne;0;1;3;4
2159;Aušrinė;Zuikučiai;5776170550;Taip;12;0;8;20
2160;Aušrinė;Zuikučiai;9641020899;Taip;10;3;0;13
2161;Aušrinė;Zuikučiai;5277217733;Taip;17;0;0;17
2162;Aušrinė;Zuikučiai;6375484280;Taip;18;0;0;18
2163;Aušrinė;Zuikučiai;1502013942;Taip;20;0;0;20
2164;Aušrinė;Zuikučiai;2190583964;Taip;11;0;0;11
2165;Aušrinė;Zuikučiai;3920229653;Taip;10;0;0;10
2166;Aušrinė;Zuikučiai;5563356449;Taip;6;5;1;12
2167;Aušrinė;Zuikučiai;9501262918;Taip;10;0;0;10
2168;Aušrinė;Zuikučiai;8756465854;Taip;0;8;2;10
2169;Aušrinė;Zuikučiai;6756184787;Taip;0;20;0;20
2170;Aušrinė;Zuikučiai;4288487063;Taip;20;0;0;20
2171;Aušrinė;Zuikučiai;5768470608;Taip;12;0;2;14
2172;Aušrinė;Zuikučiai;1440531672;Taip;6;0;0;6
2173;Aušrinė;Zuikučiai;7194803557;Taip;5;0;0;5
2174;Aušrinė;Zuikučiai;2309358870;Taip;15;0;5;20
2175;Aušrinė;Zuikučiai;2304972692;Taip;2;7;0;9
2176;Aušrinė;Meškiukai;5204445760;Taip;0;7;0;7
2177;Aušrinė;Meškiukai;3269357241;Taip;15;0;0;15
2178;Aušrinė;Meškiukai;2583331243;Taip;11;1;0;12
2179;Aušrinė;Meškiukai;2948716989;Taip;10;2;0;12
2180;Aušrinė;Meškiukai;2055282010;Taip;0;2;0;2
2181;Aušrinė;Meškiukai;3346154143;Taip;6;0;0;6
2182;Aušrinė;Meškiukai;2778931038;Taip;7;0;3;10
2183;Aušrinė;Meškiukai;8092890260;Taip;0;1;0;1
2184;Aušrinė;Meškiukai;8465864375;Taip;10;3;3;16
2185;Aušrinė;Meškiukai;7784329873;Taip;0;2;1;3
2186;Aušrinė;Meškiukai;7089883250;Taip;0;3;0;3
2187;Aušrinė;Meškiukai;6525761466;Taip;11;0;0;11
2188;Aušrinė;Meškiukai;5043122065;Taip;8;0;3;11
2189;Aušrinė;Meškiukai;3998988004;Taip;5;5;2;12
2190;Aušrinė;Meškiukai;7358925256;Taip;2;0;1;3
2191;"Geniukų kalvė";SAULUTĖS;97391898211;Ne;0;2;0;2
2192;"Geniukų kalvė";SAULUTĖS;50484102538;Taip;0;4;0;4
2193;"Geniukų kalvė";SAULUTĖS;22439864337;Taip;6;5;0;11
2194;"Geniukų kalvė";SAULUTĖS;19739642721;Taip;0;8;0;8
2195;"Geniukų kalvė";SAULUTĖS;87723170266;Taip;5;1;0;6
2196;"Geniukų kalvė";SAULUTĖS;88770807216;Taip;0;18;0;18
2197;"Geniukų kalvė";SAULUTĖS;22867530415;Ne;0;7;0;7
2198;"Geniukų kalvė";SAULUTĖS;80569810851;Taip;0;1;0;1
2199;"Geniukų kalvė";SAULUTĖS;68771652481;Taip;0;9;0;9
2200;"Geniukų kalvė";SAULUTĖS;88828238496;Taip;0;7;0;7
2201;"Geniukų kalvė";SAULUTĖS;83181896988;Taip;5;6;0;11
2202;"Geniukų kalvė";SAULUTĖS;50839305875;Taip;7;5;0;12
2203;"Geniukų kalvė";SAULUTĖS;66371314129;Taip;0;6;0;6
2204;"Geniukų kalvė";SAULUTĖS;70163293669;Taip;0;0;2;2
2205;"Geniukų kalvė";SAULUTĖS;54754447084;Taip;0;4;0;4
2206;"Geniukų kalvė";SAULUTĖS;35212920132;Taip;0;6;0;6
2207;"Geniukų kalvė";SAULUTĖS;95119267553;Taip;0;6;0;6
2208;"Geniukų kalvė";SAULUTĖS;75895159280;Taip;4;0;0;4
2209;"Geniukų kalvė";SAULUTĖS;89508036774;Taip;0;0;1;1
2210;"Geniukų kalvė";SAULUTĖS;98495225027;Taip;0;7;6;13
2211;"Geniukų kalvė";BITUTĖS;7745656622;Taip;15;1;0;16
2212;"Geniukų kalvė";BITUTĖS;6520429663;Taip;10;0;0;10
2213;"Geniukų kalvė";BITUTĖS;6466912385;Taip;0;0;4;4
2214;"Geniukų kalvė";BITUTĖS;2718961466;Taip;6;1;0;7
2215;"Geniukų kalvė";BITUTĖS;4967513360;Taip;3;1;0;4
2216;"Geniukų kalvė";BITUTĖS;2016254460;Taip;0;4;0;4
2217;"Geniukų kalvė";BITUTĖS;5776314197;Taip;4;0;0;4
2218;"Geniukų kalvė";BITUTĖS;1897809684;Taip;0;5;0;5
2219;"Geniukų kalvė";BITUTĖS;8872900558;Taip;0;5;0;5
2220;"Geniukų kalvė";BITUTĖS;6511955882;Taip;3;1;0;4
2221;"Geniukų kalvė";BITUTĖS;6500641378;Taip;5;5;0;10
2222;"Geniukų kalvė";BITUTĖS;2143334688;Taip;2;0;0;2
2223;"Geniukų kalvė";BITUTĖS;6498149304;Taip;5;0;0;5
2224;"Geniukų kalvė";BITUTĖS;7081093742;Taip;0;3;0;3
2225;"Geniukų kalvė";BITUTĖS;3984265624;Taip;0;5;0;5
2226;"Geniukų kalvė";BITUTĖS;4813232640;Taip;8;0;0;8
2227;"Geniukų kalvė";BITUTĖS;9676782662;Taip;8;0;0;8
2228;"Geniukų kalvė";BITUTĖS;1451190239;Taip;0;1;0;1
2229;"Geniukų kalvė";BITUTĖS;4647433927;Taip;0;10;0;10
2230;"Geniukų kalvė";BITUTĖS;5257713434;Taip;0;10;0;10
2231;"Geniukų kalvė";BITUTĖS;2031800114;Taip;0;2;0;2
2232;"Geniukų kalvė";KIŠKUČIAI;1568133009;Taip;0;18;2;20
2233;"Geniukų kalvė";KIŠKUČIAI;7664689396;Taip;0;2;3;5
2234;"Geniukų kalvė";KIŠKUČIAI;2599885007;Taip;0;16;4;20
2235;"Geniukų kalvė";KIŠKUČIAI;4758435835;Taip;10;0;1;11
2236;"Geniukų kalvė";KIŠKUČIAI;4661051023;Taip;6;0;4;10
2237;"Geniukų kalvė";KIŠKUČIAI;23023070502;Taip;2;2;4;8
2238;"Geniukų kalvė";KIŠKUČIAI;8668696743;Ne;10;0;0;10
2239;"Geniukų kalvė";KIŠKUČIAI;2262014110;Taip;0;8;0;8
2240;"Geniukų kalvė";KIŠKUČIAI;1947173142;Taip;10;0;0;10
2241;"Geniukų kalvė";KIŠKUČIAI;43097490633;Taip;12;7;0;19
2242;"Geniukų kalvė";KIŠKUČIAI;23153198194;Taip;6;0;1;7
2243;"Geniukų kalvė";KIŠKUČIAI;2043786151;Taip;9;5;0;14
2244;"Geniukų kalvė";KIŠKUČIAI;1460456166;Taip;0;4;0;4
2245;"Geniukų kalvė";KIŠKUČIAI;8939171238;Taip;5;0;2;7
2246;"Geniukų kalvė";KIŠKUČIAI;7839383630;Taip;5;11;0;16
2247;"Geniukų kalvė";KIŠKUČIAI;2140334255;Taip;20;0;0;20
2248;"Geniukų kalvė";KIŠKUČIAI;2301758912;Taip;4;0;1;5
2249;"Geniukų kalvė";KIŠKUČIAI;8635708009;Taip;17;0;0;17
2250;"Geniukų kalvė";KIŠKUČIAI;9081596975;Taip;12;0;0;12
2251;"Geniukų kalvė";KIŠKUČIAI;2337226175;Taip;5;0;2;7
2252;"Geniukų kalvė";VYTURĖLIAI;91633670390;Taip;4;1;0;5
2253;"Geniukų kalvė";VYTURĖLIAI;27433933081;Taip;4;9;0;13
2254;"Geniukų kalvė";VYTURĖLIAI;93578160269;Ne;9;3;0;12
2255;"Geniukų kalvė";VYTURĖLIAI;73702027599;Ne;10;3;0;13
2256;"Geniukų kalvė";VYTURĖLIAI;43457570841;Ne;9;5;0;14
2257;"Geniukų kalvė";VYTURĖLIAI;83612705234;Taip;0;5;0;5
2258;"Geniukų kalvė";VYTURĖLIAI;92967424590;Taip;8;5;0;13
2259;"Geniukų kalvė";VYTURĖLIAI;91532192571;Taip;0;5;0;5
2260;"Geniukų kalvė";VYTURĖLIAI;60793380826;Taip;8;0;0;8
2261;"Geniukų kalvė";VYTURĖLIAI;71553800692;Taip;11;2;0;13
2262;"Geniukų kalvė";VYTURĖLIAI;24599003355;Ne;10;0;0;10
2263;"Geniukų kalvė";VYTURĖLIAI;32731577118;Taip;3;10;0;13
2264;"Geniukų kalvė";VYTURĖLIAI;2088336409;Taip;10;1;0;11
2265;"Geniukų kalvė";VYTURĖLIAI;1648595304;Taip;6;0;0;6
2266;"Geniukų kalvė";VYTURĖLIAI;21213070417;Ne;5;7;0;12
2267;"Geniukų kalvė";VYTURĖLIAI;89176368447;Ne;5;2;2;9
2268;"Geniukų kalvė";VYTURĖLIAI;92776604959;Taip;5;9;0;14
2269;"Geniukų kalvė";VYTURĖLIAI;84771534522;Taip;4;2;0;6
2270;"Geniukų kalvė";VYTURĖLIAI;53430469011;Taip;5;0;0;5
2271;"Geniukų kalvė";VYTURĖLIAI;77639318512;Taip;0;5;0;5
2272;"Geniukų kalvė";VYTURĖLIAI;1131917679;Taip;0;8;0;8
2273;"Geniukų kalvė";DRUGELIAI;1974481974;Taip;0;1;0;1
2274;"Geniukų kalvė";DRUGELIAI;46050191161;Taip;7;6;3;16
2275;"Geniukų kalvė";DRUGELIAI;11531299319;Taip;0;7;0;7
2276;"Geniukų kalvė";DRUGELIAI;37570191268;Taip;0;5;0;5
2277;"Geniukų kalvė";DRUGELIAI;80173832943;Ne;5;5;0;10
2278;"Geniukų kalvė";DRUGELIAI;21387794128;Taip;0;3;0;3
2279;"Geniukų kalvė";DRUGELIAI;72591209415;Taip;0;4;0;4
2280;"Geniukų kalvė";DRUGELIAI;89253663707;Taip;0;0;2;2
2281;"Geniukų kalvė";DRUGELIAI;56872543521;Taip;0;5;2;7
2282;"Geniukų kalvė";DRUGELIAI;90336374948;Taip;8;5;0;13
2283;"Geniukų kalvė";DRUGELIAI;23422495596;Taip;0;3;0;3
2284;"Geniukų kalvė";DRUGELIAI;20968739747;Taip;4;2;1;7
2285;"Geniukų kalvė";DRUGELIAI;64035235105;Ne;0;2;2;4
2286;"Geniukų kalvė";DRUGELIAI;1395993314;Taip;10;6;0;16
2287;"Geniukų kalvė";DRUGELIAI;1318135788;Taip;0;0;1;1
2288;"Geniukų kalvė";DRUGELIAI;9656415371;Taip;0;0;2;2
2289;"Geniukų kalvė";DRUGELIAI;6553877473;Taip;0;5;2;7
2290;"Geniukų kalvė";"SAULĖS ZUIKUČIAI";37079991701;Taip;5;0;0;5
2291;"Geniukų kalvė";"SAULĖS ZUIKUČIAI";49352255237;Taip;0;5;0;5
2292;"Geniukų kalvė";"SAULĖS ZUIKUČIAI";90227736128;Taip;4;8;0;12
2293;"Geniukų kalvė";"SAULĖS ZUIKUČIAI";54856843273;Taip;6;1;0;7
2294;"Geniukų kalvė";"SAULĖS ZUIKUČIAI";1806626063;Taip;0;7;0;7
2295;"Geniukų kalvė";"SAULĖS ZUIKUČIAI";88504194684;Taip;0;0;7;7
2296;"Geniukų kalvė";"SAULĖS ZUIKUČIAI";1776042329;Taip;0;5;4;9
2297;"Geniukų kalvė";"SAULĖS ZUIKUČIAI";1716204178;Taip;9;0;0;9
2298;"Geniukų kalvė";"SAULĖS ZUIKUČIAI";1774738349;Taip;2;0;0;2
2299;"Geniukų kalvė";"SAULĖS ZUIKUČIAI";2120890722;Taip;0;10;0;10
2300;"Geniukų kalvė";"SAULĖS ZUIKUČIAI";87718471880;Taip;0;4;0;4
2301;"Geniukų kalvė";"SAULĖS ZUIKUČIAI";1415719190;Taip;0;1;0;1
2302;"Geniukų kalvė";"SAULĖS ZUIKUČIAI";83443339743;Taip;0;16;0;16
2303;"Geniukų kalvė";"SAULĖS ZUIKUČIAI";2094764804;Taip;2;0;2;4
2304;"Geniukų kalvė";"SAULĖS ZUIKUČIAI";3553253934;Taip;8;5;0;13
2305;"Geniukų kalvė";"SAULĖS ZUIKUČIAI";2056340856;Ne;0;1;0;1
2306;"Geniukų kalvė";"SAULĖS ZUIKUČIAI";9669281441;Taip;5;5;0;10
2307;"Geniukų kalvė";SMALSUČIAI;44345867922;Taip;10;0;0;10
2308;"Geniukų kalvė";SMALSUČIAI;82277353185;Taip;0;1;2;3
2309;"Geniukų kalvė";SMALSUČIAI;19181427380;Taip;4;4;2;10
2310;"Geniukų kalvė";SMALSUČIAI;1684481833;Taip;12;0;0;12
2311;"Geniukų kalvė";SMALSUČIAI;14939415217;Taip;5;0;0;5
2312;"Geniukų kalvė";SMALSUČIAI;1990303616;Taip;14;1;0;15
2313;"Geniukų kalvė";SMALSUČIAI;62774512989;Taip;20;0;0;20
2314;"Geniukų kalvė";SMALSUČIAI;45542289762;Taip;0;0;1;1
2315;"Geniukų kalvė";SMALSUČIAI;23964009189;Taip;9;1;0;10
2316;"Geniukų kalvė";SMALSUČIAI;42328019754;Taip;5;1;0;6
2317;"Geniukų kalvė";SMALSUČIAI;90435684305;Taip;0;1;0;1
2318;"Geniukų kalvė";SMALSUČIAI;84974376966;Taip;4;5;0;9
2319;"Geniukų kalvė";SMALSUČIAI;97616612192;Taip;5;0;0;5
2320;"Geniukų kalvė";SMALSUČIAI;1031455575;Taip;8;0;0;8
2321;"Geniukų kalvė";SMALSUČIAI;93834840514;Taip;0;4;0;4
2322;"Geniukų kalvė";SMALSUČIAI;67762121244;Ne;0;4;0;4
2323;"Geniukų kalvė";SMALSUČIAI;1663744490;Taip;5;6;0;11
2324;"Geniukų kalvė";SMALSUČIAI;2003986836;Taip;8;5;0;13
2325;"Geniukų kalvė";SMALSUČIAI;1248190435;Taip;0;7;0;7
2326;"Geniukų kalvė";SMALSUČIAI;5792552722;Taip;0;0;2;2
2327;"Geniukų kalvė";SMALSUČIAI;6253940549;Taip;0;4;0;4
2328;"Geniukų kalvė";SMALSUČIAI;9416843495;Taip;0;2;1;3
2329;"Geniukų kalvė";RUDNOSIUKAI;2082749897;Taip;0;13;0;13
2330;"Geniukų kalvė";RUDNOSIUKAI;7352976665;Taip;1;0;0;1
2331;"Geniukų kalvė";RUDNOSIUKAI;12109348143;Taip;5;0;2;7
2332;"Geniukų kalvė";RUDNOSIUKAI;6728268857;Taip;3;2;0;5
2333;"Geniukų kalvė";RUDNOSIUKAI;87858628237;Taip;0;5;0;5
2334;"Geniukų kalvė";RUDNOSIUKAI;93360165202;Taip;10;0;0;10
2335;"Geniukų kalvė";RUDNOSIUKAI;36553641202;Taip;0;2;0;2
2336;"Geniukų kalvė";RUDNOSIUKAI;36295276899;Taip;0;3;0;3
2337;"Geniukų kalvė";RUDNOSIUKAI;16810843163;Taip;0;5;0;5
2338;"Geniukų kalvė";RUDNOSIUKAI;56705168000;Taip;6;0;1;7
2339;"Geniukų kalvė";RUDNOSIUKAI;75926614045;Taip;0;6;0;6
2340;"Geniukų kalvė";RUDNOSIUKAI;42849805342;Taip;0;0;7;7
2341;"Geniukų kalvė";RUDNOSIUKAI;51320722945;Ne;0;1;0;1
2342;"Geniukų kalvė";RUDNOSIUKAI;96448080708;Taip;13;0;0;13
2343;"Geniukų kalvė";RUDNOSIUKAI;1727967870;Taip;0;1;0;1
2344;"Geniukų kalvė";RUDNOSIUKAI;1794537433;Taip;0;0;5;5
2345;"Geniukų kalvė";RUDNOSIUKAI;29353737550;Taip;10;1;1;12
2346;"Geniukų kalvė";RUDNOSIUKAI;6928979691;Taip;9;1;0;10
2347;"Geniukų kalvė";RUDNOSIUKAI;22074236863;Taip;5;5;0;10
2348;"Geniukų kalvė";RUDNOSIUKAI;73331235731;Taip;2;0;0;2
2349;"Geniukų kalvė";RUDNOSIUKAI;8462193223;Taip;4;0;1;5
2350;"Geniukų kalvė";RUDNOSIUKAI;7269049874;Taip;4;0;1;5
2351;"Geniukų kalvė";PELĖDŽIUKAI;1933003833;Taip;0;5;0;5
2352;"Geniukų kalvė";PELĖDŽIUKAI;1829858221;Taip;10;0;1;11
2353;"Geniukų kalvė";PELĖDŽIUKAI;1624933726;Taip;3;0;0;3
2354;"Geniukų kalvė";PELĖDŽIUKAI;3599151643;Taip;10;0;2;12
2355;"Geniukų kalvė";PELĖDŽIUKAI;37670000746;Taip;0;3;0;3
2356;"Geniukų kalvė";PELĖDŽIUKAI;14839311346;Taip;10;1;4;15
2357;"Geniukų kalvė";PELĖDŽIUKAI;31140342871;Taip;10;0;2;12
2358;"Geniukų kalvė";PELĖDŽIUKAI;70097449722;Taip;9;5;0;14
2359;"Geniukų kalvė";PELĖDŽIUKAI;11476134327;Taip;0;7;0;7
2360;"Geniukų kalvė";PELĖDŽIUKAI;53385228310;Ne;10;6;2;18
2361;"Geniukų kalvė";PELĖDŽIUKAI;57595197116;Taip;0;1;1;2
2362;"Geniukų kalvė";PELĖDŽIUKAI;61225085978;Taip;9;7;0;16
2363;"Geniukų kalvė";PELĖDŽIUKAI;83623361401;Ne;0;1;1;2
2364;"Geniukų kalvė";PELĖDŽIUKAI;67649373235;Taip;2;0;0;2
2365;"Geniukų kalvė";PELĖDŽIUKAI;87751274075;Taip;14;0;0;14
2366;"Geniukų kalvė";PELĖDŽIUKAI;71884588832;Taip;0;0;4;4
2367;"Geniukų kalvė";PELĖDŽIUKAI;26733422046;Taip;0;5;0;5
2368;"Geniukų kalvė";PELĖDŽIUKAI;96267794763;Taip;15;0;0;15
2369;"Geniukų kalvė";PELĖDŽIUKAI;1239061261;Taip;0;2;0;2
2370;"Geniukų kalvė";PELĖDŽIUKAI;91734868433;Taip;0;2;1;3
2371;"Geniukų kalvė";BORUŽĖLĖS;51353124475;Ne;0;1;2;3
2372;"Geniukų kalvė";BORUŽĖLĖS;1246234700;Taip;6;0;0;6
2373;"Geniukų kalvė";BORUŽĖLĖS;66632618838;Taip;0;5;0;5
2374;"Geniukų kalvė";BORUŽĖLĖS;35180545728;Taip;2;6;0;8
2375;"Geniukų kalvė";BORUŽĖLĖS;96954076142;Taip;0;12;0;12
2376;"Geniukų kalvė";BORUŽĖLĖS;27479616927;Taip;14;0;0;14
2377;"Geniukų kalvė";BORUŽĖLĖS;30015301622;Taip;0;0;1;1
2378;"Geniukų kalvė";BORUŽĖLĖS;26912425905;Taip;0;0;5;5
2379;"Geniukų kalvė";BORUŽĖLĖS;38949678625;Taip;0;6;0;6
2380;"Geniukų kalvė";BORUŽĖLĖS;80957343774;Taip;0;0;6;6
2381;"Geniukų kalvė";BORUŽĖLĖS;99051569551;Taip;0;0;1;1
2382;"Geniukų kalvė";BORUŽĖLĖS;7837682774;Taip;5;0;0;5
2383;"Geniukų kalvė";BORUŽĖLĖS;8916930503;Taip;2;0;0;2
2384;"Geniukų kalvė";BORUŽĖLĖS;2038860438;Taip;0;12;6;18
2385;"Geniukų kalvė";BORUŽĖLĖS;74161080879;Taip;6;0;1;7
2386;"Geniukų kalvė";BORUŽĖLĖS;1073117547;Taip;5;0;2;7
2387;"Geniukų kalvė";PAGRANDUKAI;2938446054;Taip;0;4;0;4
2388;"Geniukų kalvė";PAGRANDUKAI;1237228692;Taip;9;1;0;10
2389;"Geniukų kalvė";PAGRANDUKAI;6737863183;Taip;5;1;0;6
2390;"Geniukų kalvė";PAGRANDUKAI;9990243525;Taip;0;3;0;3
2391;"Geniukų kalvė";PAGRANDUKAI;6174114461;Taip;15;0;0;15
2392;"Geniukų kalvė";PAGRANDUKAI;5542539934;Taip;0;10;0;10
2393;"Geniukų kalvė";PAGRANDUKAI;5704223824;Taip;7;8;0;15
2394;"Geniukų kalvė";PAGRANDUKAI;6024288147;Taip;0;2;0;2
2395;"Geniukų kalvė";PAGRANDUKAI;1051563985;Taip;5;0;0;5
2396;"Geniukų kalvė";PAGRANDUKAI;2659298240;Taip;0;3;0;3
2397;"Geniukų kalvė";PAGRANDUKAI;9976423099;Taip;16;0;0;16
2398;"Geniukų kalvė";PAGRANDUKAI;3762178533;Taip;5;1;0;6
2399;"Geniukų kalvė";PAGRANDUKAI;2426186771;Taip;5;5;0;10
2400;"Geniukų kalvė";NYKŠTUKAI;8095693657;Taip;0;0;6;6
2401;"Geniukų kalvė";NYKŠTUKAI;4958738745;Taip;0;0;1;1
2402;"Geniukų kalvė";NYKŠTUKAI;4271763719;Taip;7;5;6;18
2403;"Geniukų kalvė";NYKŠTUKAI;9069256760;Taip;18;0;0;18
2404;"Geniukų kalvė";NYKŠTUKAI;7501831333;Taip;3;0;0;3
2405;"Geniukų kalvė";NYKŠTUKAI;3493492581;Taip;4;0;2;6
2406;"Geniukų kalvė";NYKŠTUKAI;3180116136;Taip;13;0;0;13
2407;"Geniukų kalvė";NYKŠTUKAI;2904091819;Taip;7;1;0;8
2408;"Geniukų kalvė";NYKŠTUKAI;5245434552;Taip;14;1;0;15
2409;"Geniukų kalvė";NYKŠTUKAI;6794151223;Taip;6;0;0;6
2410;"Geniukų kalvė";NYKŠTUKAI;4777155321;Taip;15;0;0;15
2411;"Geniukų kalvė";NYKŠTUKAI;4186376527;Taip;20;0;0;20
2412;"Geniukų kalvė";NYKŠTUKAI;6674038058;Taip;7;0;0;7
2413;"Geniukų kalvė";NYKŠTUKAI;5161535756;Taip;11;0;2;13
2414;"Geniukų kalvė";NYKŠTUKAI;1499735818;Taip;5;0;1;6
2415;Gelvonėlis;ĄŽUOLIUKAI;36610437375;Taip;5;0;0;5
2416;Gelvonėlis;ĄŽUOLIUKAI;48593832088;Taip;0;1;1;2
2417;Gelvonėlis;ĄŽUOLIUKAI;71199691102;Taip;0;12;0;12
2418;Gelvonėlis;ĄŽUOLIUKAI;2218767947;Taip;0;3;3;6
2419;Gelvonėlis;ĄŽUOLIUKAI;5393404051;Taip;11;0;2;13
2420;Gelvonėlis;ĄŽUOLIUKAI;7277516341;Taip;2;0;0;2
2421;Gelvonėlis;ĄŽUOLIUKAI;40127507796;Taip;0;5;0;5
2422;Gelvonėlis;ĄŽUOLIUKAI;98009116912;Taip;5;4;1;10
2423;Gelvonėlis;ĄŽUOLIUKAI;91507293029;Taip;0;8;0;8
2424;Gelvonėlis;ĄŽUOLIUKAI;79847096929;Taip;14;0;1;15
2425;Gelvonėlis;ĄŽUOLIUKAI;70550528579;Taip;0;4;3;7
2426;Gelvonėlis;ĄŽUOLIUKAI;51375531815;Taip;9;0;0;9
2427;Gelvonėlis;ĄŽUOLIUKAI;17021411833;Taip;0;4;1;5
2428;Gelvonėlis;ĄŽUOLIUKAI;9970883470;Taip;15;4;0;19
2429;Gelvonėlis;ĄŽUOLIUKAI;1902998389;Taip;0;11;0;11
2430;Gelvonėlis;ĄŽUOLIUKAI;7822842578;Taip;0;0;3;3
2431;Gelvonėlis;ĄŽUOLIUKAI;21918212071;Taip;2;0;1;3
2432;Gelvonėlis;ĄŽUOLIUKAI;2146163687;Taip;0;1;0;1
2433;Gelvonėlis;ĄŽUOLIUKAI;71076083278;Taip;0;5;3;8
2434;Gelvonėlis;ĄŽUOLIUKAI;1776015014;Taip;6;11;0;17
2435;Gelvonėlis;ĄŽUOLIUKAI;43250059460;Taip;3;0;0;3
2436;Gelvonėlis;ĄŽUOLIUKAI;22201650331;Taip;0;5;0;5
2437;Gelvonėlis;ŽVIRBLIUKAI;1772713183;Taip;12;0;0;12
2438;Gelvonėlis;ŽVIRBLIUKAI;1801724527;Ne;5;3;0;8
2439;Gelvonėlis;ŽVIRBLIUKAI;83360239551;Taip;0;3;17;20
2440;Gelvonėlis;ŽVIRBLIUKAI;21250325232;Taip;10;0;0;10
2441;Gelvonėlis;ŽVIRBLIUKAI;5798439412;Taip;0;1;0;1
2442;Gelvonėlis;ŽVIRBLIUKAI;23181505838;Taip;0;13;0;13
2443;Gelvonėlis;ŽVIRBLIUKAI;2997738880;Taip;0;0;3;3
2444;Gelvonėlis;ŽVIRBLIUKAI;1373771258;Taip;5;4;0;9
2445;Gelvonėlis;ŽVIRBLIUKAI;92420286100;Taip;7;4;0;11
2446;Gelvonėlis;ŽVIRBLIUKAI;41610307448;Taip;7;0;0;7
2447;Gelvonėlis;ŽVIRBLIUKAI;87746258537;Taip;4;5;0;9
2448;Gelvonėlis;ŽVIRBLIUKAI;6635285387;Taip;15;0;0;15
2449;Gelvonėlis;ŽVIRBLIUKAI;1938913528;Taip;0;8;0;8
2450;Gelvonėlis;ŽVIRBLIUKAI;2096702999;Taip;0;5;0;5
2451;Gelvonėlis;ŽVIRBLIUKAI;84863800926;Taip;0;6;0;6
2452;Gelvonėlis;ŽVIRBLIUKAI;1355742622;Taip;0;7;0;7
2453;Gelvonėlis;ŽVIRBLIUKAI;90961913967;Taip;5;2;0;7
2454;Gelvonėlis;ŽVIRBLIUKAI;1827511187;Taip;0;3;8;11
2455;Gelvonėlis;ŽVIRBLIUKAI;1835508505;Taip;6;0;0;6
2456;Gelvonėlis;ŽVIRBLIUKAI;9784762153;Taip;5;6;0;11
2457;Gelvonėlis;ŽVIRBLIUKAI;9919860358;Taip;0;7;0;7
2458;Gelvonėlis;RASELĖS;27296649662;Taip;5;5;1;11
2459;Gelvonėlis;RASELĖS;11994848859;Taip;0;5;1;6
2460;Gelvonėlis;RASELĖS;40035134521;Taip;5;11;0;16
2461;Gelvonėlis;RASELĖS;57163457394;Taip;0;5;0;5
2462;Gelvonėlis;RASELĖS;23568664214;Taip;7;5;0;12
2463;Gelvonėlis;RASELĖS;41750260566;Taip;0;5;0;5
2464;Gelvonėlis;RASELĖS;3461354329;Taip;0;7;0;7
2465;Gelvonėlis;RASELĖS;95413117888;Taip;0;11;0;11
2466;Gelvonėlis;RASELĖS;3325116198;Taip;0;5;0;5
2467;Gelvonėlis;RASELĖS;2153676615;Taip;10;9;0;19
2468;Gelvonėlis;RASELĖS;87254295179;Taip;0;7;0;7
2469;Gelvonėlis;RASELĖS;47302438188;Taip;7;4;1;12
2470;Gelvonėlis;RASELĖS;66162315180;Taip;3;5;0;8
2471;Gelvonėlis;RASELĖS;32893563601;Taip;15;0;0;15
2472;Gelvonėlis;RASELĖS;18324768783;Taip;7;4;0;11
2473;Gelvonėlis;RASELĖS;11697172905;Taip;5;1;0;6
2474;Gelvonėlis;RASELĖS;1221420212;Taip;7;6;0;13
2475;Gelvonėlis;RASELĖS;1396698456;Taip;3;1;1;5
2476;Gelvonėlis;RASELĖS;43145774484;Taip;0;4;0;4
2477;Gelvonėlis;RASELĖS;18237108866;Taip;0;11;0;11
2478;Gelvonėlis;RASELĖS;3271118581;Taip;10;0;1;11
2479;Gelvonėlis;RASELĖS;79607769503;Ne;15;5;0;20
2480;Gelvonėlis;RASELĖS;96792124844;Ne;15;5;0;20
2481;Gelvonėlis;SAULUTĖ;57821074297;Taip;15;0;0;15
2482;Gelvonėlis;SAULUTĖ;35428558838;Taip;5;5;0;10
2483;Gelvonėlis;SAULUTĖ;57792200616;Taip;10;5;0;15
2484;Gelvonėlis;SAULUTĖ;38629832653;Taip;0;13;0;13
2485;Gelvonėlis;SAULUTĖ;473144281;Taip;5;1;0;6
2486;Gelvonėlis;SAULUTĖ;81833782531;Taip;3;7;0;10
2487;Gelvonėlis;SAULUTĖ;72048682220;Taip;13;5;0;18
2488;Gelvonėlis;SAULUTĖ;33845988568;Taip;8;5;0;13
2489;Gelvonėlis;SAULUTĖ;66520207357;Taip;5;1;0;6
2490;Gelvonėlis;SAULUTĖ;45588179697;Taip;8;0;0;8
2491;Gelvonėlis;SAULUTĖ;50263542291;Taip;0;1;0;1
2492;Gelvonėlis;SAULUTĖ;4316492518;Taip;12;4;0;16
2493;Gelvonėlis;SAULUTĖ;17005717219;Taip;0;2;0;2
2494;Gelvonėlis;SAULUTĖ;59265250104;Taip;8;6;0;14
2495;Gelvonėlis;SAULUTĖ;6346945643;Taip;0;14;0;14
2496;Gelvonėlis;SAULUTĖ;34373469291;Taip;3;0;0;3
2497;Gelvonėlis;SAULUTĖ;35992063196;Taip;0;5;0;5
2498;Gelvonėlis;SAULUTĖ;11807134557;Taip;0;5;0;5
2499;Gelvonėlis;SAULUTĖ;72859950160;Taip;0;1;0;1
2500;Gelvonėlis;SAULUTĖ;80973545044;Taip;0;0;18;18
2501;Gelvonėlis;PELĖDŽIUKAI;72281404967;Taip;0;1;0;1
2502;Gelvonėlis;PELĖDŽIUKAI;58820730862;Taip;0;5;0;5
2503;Gelvonėlis;PELĖDŽIUKAI;15735896493;Taip;0;5;0;5
2504;Gelvonėlis;PELĖDŽIUKAI;94399276762;Taip;7;1;0;8
2505;Gelvonėlis;PELĖDŽIUKAI;59868339873;Taip;0;8;0;8
2506;Gelvonėlis;PELĖDŽIUKAI;91191192491;Taip;0;9;0;9
2507;Gelvonėlis;PELĖDŽIUKAI;2044305781;Taip;0;1;0;1
2508;Gelvonėlis;PELĖDŽIUKAI;54577279896;Taip;0;5;2;7
2509;Gelvonėlis;PELĖDŽIUKAI;71918920181;Taip;5;5;0;10
2510;Gelvonėlis;PELĖDŽIUKAI;90921912769;Ne;0;10;0;10
2511;Gelvonėlis;PELĖDŽIUKAI;45653629924;Taip;6;5;0;11
2512;Gelvonėlis;PELĖDŽIUKAI;52663286630;Taip;0;5;0;5
2513;Gelvonėlis;PELĖDŽIUKAI;16588607945;Taip;0;8;0;8
2514;Gelvonėlis;PELĖDŽIUKAI;10505090360;Taip;0;5;0;5
2515;Gelvonėlis;PELĖDŽIUKAI;9898346862;Taip;0;5;6;11
2516;Gelvonėlis;PELĖDŽIUKAI;15109448940;Taip;0;2;1;3
2517;Gelvonėlis;PELĖDŽIUKAI;3227827255;Taip;0;4;0;4
2518;Gelvonėlis;PELĖDŽIUKAI;75070203296;Taip;0;2;4;6
2519;Gelvonėlis;PELĖDŽIUKAI;1955777921;Taip;10;5;4;19
2520;Gelvonėlis;PELĖDŽIUKAI;24391920760;Taip;5;5;0;10
2521;Gelvonėlis;PELĖDŽIUKAI;31736209837;Taip;0;5;0;5
2522;Gelvonėlis;PELĖDŽIUKAI;67940634367;Taip;3;5;0;8
2523;Gelvonėlis;PELĖDŽIUKAI;83653321747;Taip;5;5;0;10
2524;Gelvonėlis;DRUGELIAI;5098282548;Taip;1;9;0;10
2525;Gelvonėlis;DRUGELIAI;50383394228;Ne;5;5;0;10
2526;Gelvonėlis;DRUGELIAI;68841073274;Taip;0;9;0;9
2527;Gelvonėlis;DRUGELIAI;67365224459;Taip;0;7;0;7
2528;Gelvonėlis;DRUGELIAI;1042715433;Ne;0;8;0;8
2529;Gelvonėlis;DRUGELIAI;59592904001;Taip;0;1;0;1
2530;Gelvonėlis;DRUGELIAI;6405741006;Taip;18;0;0;18
2531;Gelvonėlis;DRUGELIAI;9595350871;Taip;12;0;0;12
2532;Gelvonėlis;DRUGELIAI;1750552925;Taip;2;7;0;9
2533;Gelvonėlis;DRUGELIAI;19782508652;Taip;5;5;0;10
2534;Gelvonėlis;DRUGELIAI;86895427397;Taip;0;5;0;5
2535;Gelvonėlis;DRUGELIAI;3859776410;Taip;7;1;0;8
2536;Gelvonėlis;DRUGELIAI;19955601762;Taip;10;0;0;10
2537;Gelvonėlis;DRUGELIAI;71806077882;Taip;4;13;0;17
2538;Gelvonėlis;DRUGELIAI;8475204684;Taip;0;3;0;3
2539;Gelvonėlis;DRUGELIAI;2501735556;Taip;1;1;0;2
2540;Gelvonėlis;DRUGELIAI;4830374546;Taip;19;0;0;19
2541;Gelvonėlis;DRUGELIAI;6226970200;Taip;8;0;0;8
2542;Gelvonėlis;DRUGELIAI;2622967319;Taip;7;4;0;11
2543;Gelvonėlis;VARPELIAI;3059903126;Taip;10;0;2;12
2544;Gelvonėlis;VARPELIAI;9149117970;Taip;4;0;0;4
2545;Gelvonėlis;VARPELIAI;3483144401;Taip;0;13;0;13
2546;Gelvonėlis;VARPELIAI;1512245903;Taip;1;0;0;1
2547;Gelvonėlis;VARPELIAI;6451557430;Taip;7;0;0;7
2548;Gelvonėlis;VARPELIAI;6225854165;Taip;15;0;0;15
2549;Gelvonėlis;VARPELIAI;2791652988;Taip;13;0;0;13
2550;Gelvonėlis;VARPELIAI;2638430817;Taip;0;5;8;13
2551;Gelvonėlis;VARPELIAI;9396676137;Taip;10;0;0;10
2552;Gelvonėlis;VARPELIAI;9353066785;Taip;10;0;0;10
2553;Gelvonėlis;VARPELIAI;9059244134;Taip;0;7;0;7
2554;Gelvonėlis;VARPELIAI;1987204544;Taip;7;5;0;12
2555;Gelvonėlis;VARPELIAI;9600526942;Taip;0;1;14;15
2556;Gelvonėlis;VARPELIAI;1387948936;Taip;0;0;20;20
2557;Gelvonėlis;VARPELIAI;9650922918;Taip;15;0;0;15
2558;Gelvonėlis;VARPELIAI;3121251271;Taip;15;0;0;15
2559;Gelvonėlis;VARPELIAI;1462716950;Taip;12;0;0;12
2560;Gelvonėlis;VARPELIAI;6949090250;Taip;20;0;0;20
2561;Gelvonėlis;BORUŽĖLĖS;1030246127;Taip;0;1;0;1
2562;Gelvonėlis;BORUŽĖLĖS;22575527531;Taip;0;9;0;9
2563;Gelvonėlis;BORUŽĖLĖS;1163833201;Taip;0;6;0;6
2564;Gelvonėlis;BORUŽĖLĖS;1236944078;Taip;5;6;0;11
2565;Gelvonėlis;BORUŽĖLĖS;3379601736;Taip;0;11;0;11
2566;Gelvonėlis;BORUŽĖLĖS;1597669426;Taip;0;8;0;8
2567;Gelvonėlis;BORUŽĖLĖS;31744699590;Taip;9;5;0;14
2568;Gelvonėlis;BORUŽĖLĖS;4917453676;Ne;0;1;0;1
2569;Gelvonėlis;BORUŽĖLĖS;9108760720;Taip;0;5;0;5
2570;Gelvonėlis;BORUŽĖLĖS;9777094764;Taip;10;0;0;10
2571;Gelvonėlis;BORUŽĖLĖS;12715604772;Taip;0;5;0;5
2572;Gelvonėlis;BORUŽĖLĖS;8050788182;Taip;0;11;0;11
2573;Gelvonėlis;BORUŽĖLĖS;1183745610;Taip;0;13;0;13
2574;Gelvonėlis;BORUŽĖLĖS;1836155450;Taip;0;6;0;6
2575;Gelvonėlis;BORUŽĖLĖS;1400871061;Taip;0;9;0;9
2576;Gelvonėlis;BORUŽĖLĖS;87693970225;Taip;0;8;0;8
2577;Gelvonėlis;BORUŽĖLĖS;69221565557;Taip;0;2;0;2
2578;Gelvonėlis;BORUŽĖLĖS;79899652046;Taip;11;5;0;16
2579;Gelvonėlis;BORUŽĖLĖS;7903272826;Taip;15;5;0;20
2580;Gelvonėlis;NYKŠTUKAI;6604992169;Taip;5;5;0;10
2581;Gelvonėlis;NYKŠTUKAI;6556472766;Taip;13;1;0;14
2582;Gelvonėlis;NYKŠTUKAI;7182180008;Taip;9;0;0;9
2583;Gelvonėlis;NYKŠTUKAI;6598178467;Taip;4;1;1;6
2584;Gelvonėlis;NYKŠTUKAI;8885088900;Taip;0;1;2;3
2585;Gelvonėlis;NYKŠTUKAI;8622621570;Taip;10;0;0;10
2586;Gelvonėlis;NYKŠTUKAI;2400289466;Taip;5;4;0;9
2587;Gelvonėlis;NYKŠTUKAI;5129492284;Taip;8;2;0;10
2588;Gelvonėlis;NYKŠTUKAI;9493536517;Taip;5;0;0;5
2589;Gelvonėlis;NYKŠTUKAI;2288951845;Taip;0;1;0;1
2590;Gelvonėlis;NYKŠTUKAI;2515471132;Taip;7;0;0;7
2591;Gelvonėlis;NYKŠTUKAI;6505814802;Taip;5;0;0;5
2592;Gelvonėlis;NYKŠTUKAI;6319058542;Taip;0;3;4;7
2593;Gelvonėlis;NYKŠTUKAI;9538571448;Taip;6;7;0;13
2594;Gelvonėlis;NYKŠTUKAI;9147186080;Taip;5;6;0;11
2595;Gelvonėlis;NYKŠTUKAI;7919814808;Taip;0;9;0;9
2596;Gelvonėlis;NYKŠTUKAI;7620280474;Taip;5;0;1;6
2597;Gelvonėlis;BITUTĖS;7759317220;Taip;10;0;0;10
2598;Gelvonėlis;BITUTĖS;6196065515;Taip;0;3;0;3
2599;Gelvonėlis;BITUTĖS;2504468098;Taip;7;8;0;15
2600;Gelvonėlis;BITUTĖS;7983982378;Taip;5;2;0;7
2601;Gelvonėlis;BITUTĖS;5721858659;Taip;4;0;0;4
2602;Gelvonėlis;BITUTĖS;9667024635;Taip;0;4;0;4
2603;Gelvonėlis;BITUTĖS;2108690954;Taip;5;0;0;5
2604;Gelvonėlis;BITUTĖS;4855800131;Taip;6;0;0;6
2605;Gelvonėlis;BITUTĖS;1753617545;Taip;7;3;0;10
2606;Gelvonėlis;BITUTĖS;6189110767;Taip;0;1;0;1
2607;Gelvonėlis;BITUTĖS;3843881329;Taip;2;1;1;4
2608;Gelvonėlis;BITUTĖS;6317822775;Taip;0;2;0;2
2609;Gelvonėlis;BITUTĖS;9184192787;Taip;6;0;0;6
2610;Gelvonėlis;BITUTĖS;2119550116;Taip;14;1;0;15
2611;Gelvonėlis;BITUTĖS;7826522180;Taip;11;4;0;15
2612;Gelvonėlis;BITUTĖS;9286500887;Taip;0;9;0;9
2613;Gelvonėlis;BITUTĖS;5095782784;Taip;9;0;0;9
2614;Gelvonėlis;BITUTĖS;1516164123;Taip;7;5;0;12
2615;Gelvonėlis;BITUTĖS;7226051965;Taip;4;0;2;6
2616;Gelvonėlis;BITUTĖS;3788522708;Taip;3;0;0;3
2617;Gelvonėlis;RAMUNĖLĖS;5047022305;Taip;0;14;1;15
2618;Gelvonėlis;RAMUNĖLĖS;2742000725;Taip;0;0;1;1
2619;Gelvonėlis;RAMUNĖLĖS;1085845218;Taip;5;0;1;6
2620;Gelvonėlis;RAMUNĖLĖS;5511174729;Taip;20;0;0;20
2621;Gelvonėlis;RAMUNĖLĖS;1284359362;Taip;0;6;0;6
2622;Gelvonėlis;RAMUNĖLĖS;69073786634;Taip;2;0;0;2
2623;Gelvonėlis;RAMUNĖLĖS;6579934222;Taip;0;0;3;3
2624;Gelvonėlis;RAMUNĖLĖS;8775661719;Taip;5;5;0;10
2625;Gelvonėlis;RAMUNĖLĖS;6255253658;Taip;0;2;1;3
2626;Gelvonėlis;RAMUNĖLĖS;21684706944;Taip;0;1;0;1
2627;Gelvonėlis;RAMUNĖLĖS;75676389361;Taip;10;0;0;10
2628;Gelvonėlis;RAMUNĖLĖS;9387523651;Taip;0;11;0;11
2629;Gelvonėlis;RAMUNĖLĖS;2140799517;Taip;15;0;0;15
2630;Gelvonėlis;RAMUNĖLĖS;3830940009;Taip;4;0;0;4
2631;Gelvonėlis;RAMUNĖLĖS;3089755141;Taip;20;0;0;20
2632;Gelvonėlis;RAMUNĖLĖS;2077783219;Taip;6;3;0;9
2633;Gelvonėlis;RAMUNĖLĖS;1408313697;Taip;0;1;0;1
2634;Gelvonėlis;RAMUNĖLĖS;1624125024;Taip;5;1;4;10
2635;Gelvonėlis;RAMUNĖLĖS;3147489259;Taip;8;3;2;13
2636;Gervelė;ŽIRNIUKAI;3525060645;Taip;6;7;0;13
2637;Gervelė;ŽIRNIUKAI;94487630173;Taip;7;0;2;9
2638;Gervelė;ŽIRNIUKAI;2551280794;Taip;11;6;0;17
2639;Gervelė;ŽIRNIUKAI;7302238728;Taip;6;5;0;11
2640;Gervelė;ŽIRNIUKAI;5989713844;Taip;15;0;0;15
2641;Gervelė;ŽIRNIUKAI;4560752068;Taip;0;9;0;9
2642;Gervelė;ŽIRNIUKAI;87619285504;Taip;10;5;0;15
2643;Gervelė;ŽIRNIUKAI;1991238577;Taip;0;11;0;11
2644;Gervelė;ŽIRNIUKAI;9515308666;Taip;5;1;0;6
2645;Gervelė;ŽIRNIUKAI;1616949023;Taip;18;0;0;18
2646;Gervelė;ŽIRNIUKAI;4943974662;Taip;0;7;0;7
2647;Gervelė;ŽIRNIUKAI;8152446576;Taip;7;6;3;16
2648;Gervelė;ŽIRNIUKAI;6967078836;Taip;5;5;0;10
2649;Gervelė;ŽIRNIUKAI;3015424614;Taip;15;0;2;17
2650;Gervelė;ŽIRNIUKAI;1704033440;Taip;20;0;0;20
2651;Gervelė;ŽIRNIUKAI;4705514590;Taip;3;0;0;3
2652;Gervelė;ŽIRNIUKAI;89076506192;Taip;15;0;0;15
2653;Gervelė;ŽIRNIUKAI;2167744244;Taip;0;7;0;7
2654;Gervelė;ŽIRNIUKAI;3427400844;Taip;0;10;2;12
2655;Gervelė;ŽIRNIUKAI;7697761552;Taip;0;1;0;1
2656;Gervelė;LAŠIUKAI;52142182972;Taip;5;5;0;10
2657;Gervelė;LAŠIUKAI;73803372762;Taip;12;0;1;13
2658;Gervelė;LAŠIUKAI;1697536098;Taip;10;3;0;13
2659;Gervelė;LAŠIUKAI;1617055167;Taip;0;17;0;17
2660;Gervelė;LAŠIUKAI;3278950938;Taip;0;1;0;1
2661;Gervelė;LAŠIUKAI;49013139623;Taip;8;0;0;8
2662;Gervelė;LAŠIUKAI;2019214634;Taip;10;0;0;10
2663;Gervelė;LAŠIUKAI;1860333208;Taip;0;9;0;9
2664;Gervelė;LAŠIUKAI;8454703111;Taip;0;2;0;2
2665;Gervelė;LAŠIUKAI;1921567602;Taip;0;3;0;3
2666;Gervelė;LAŠIUKAI;8035942210;Taip;0;12;0;12
2667;Gervelė;LAŠIUKAI;2191126539;Taip;7;5;0;12
2668;Gervelė;LAŠIUKAI;2632272974;Taip;0;11;0;11
2669;Gervelė;LAŠIUKAI;62782512806;Taip;0;11;0;11
2670;Gervelė;LAŠIUKAI;85689668690;Taip;0;1;0;1
2671;Gervelė;LAŠIUKAI;1792726318;Ne;15;4;0;19
2672;Gervelė;PABIRUČIAI;81112128210;Taip;0;3;0;3
2673;Gervelė;PABIRUČIAI;48497142461;Ne;4;1;0;5
2674;Gervelė;PABIRUČIAI;1928679740;Taip;9;3;2;14
2675;Gervelė;PABIRUČIAI;24724452164;Taip;0;1;0;1
2676;Gervelė;PABIRUČIAI;30126718224;Taip;0;7;0;7
2677;Gervelė;PABIRUČIAI;15891512215;Taip;6;5;0;11
2678;Gervelė;PABIRUČIAI;65086547895;Taip;0;7;0;7
2679;Gervelė;PABIRUČIAI;32101040739;Taip;4;0;5;9
2680;Gervelė;PABIRUČIAI;97418410809;Ne;0;2;0;2
2681;Gervelė;PABIRUČIAI;4265845947;Taip;5;0;0;5
2682;Gervelė;PABIRUČIAI;51805829511;Taip;6;0;0;6
2683;Gervelė;PABIRUČIAI;44678807307;Ne;0;1;5;6
2684;Gervelė;PABIRUČIAI;5085234839;Taip;0;5;0;5
2685;Gervelė;PABIRUČIAI;65751519550;Taip;15;0;0;15
2686;Gervelė;PABIRUČIAI;1303396562;Taip;15;0;1;16
2687;Gervelė;PABIRUČIAI;2017094793;Taip;0;1;1;2
2688;Gervelė;PABIRUČIAI;76731434799;Taip;20;0;0;20
2689;Gervelė;PABIRUČIAI;8302493906;Ne;0;10;0;10
2690;Gervelė;PABIRUČIAI;1371549808;Taip;5;5;0;10
2691;Gervelė;PABIRUČIAI;1413157604;Taip;5;0;0;5
2692;Gervelė;BITUTĖS;47945657061;Taip;0;8;0;8
2693;Gervelė;BITUTĖS;64688647985;Taip;3;7;0;10
2694;Gervelė;BITUTĖS;1545499809;Taip;0;7;0;7
2695;Gervelė;BITUTĖS;73134084618;Taip;0;5;0;5
2696;Gervelė;BITUTĖS;59156024051;Taip;5;6;0;11
2697;Gervelė;BITUTĖS;12701715977;Taip;0;1;0;1
2698;Gervelė;BITUTĖS;29756975817;Taip;0;1;0;1
2699;Gervelė;BITUTĖS;1897895689;Taip;0;9;0;9
2700;Gervelė;BITUTĖS;87075838181;Taip;0;1;0;1
2701;Gervelė;BITUTĖS;85855349922;Taip;0;8;0;8
2702;Gervelė;BITUTĖS;75507305203;Taip;0;16;0;16
2703;Gervelė;BITUTĖS;4092917137;Taip;15;5;0;20
2704;Gervelė;BURATINO;54142931109;Taip;0;5;6;11
2705;Gervelė;BURATINO;1772051140;Taip;0;8;0;8
2706;Gervelė;BURATINO;1690867495;Taip;4;0;0;4
2707;Gervelė;BURATINO;29832889771;Taip;0;2;0;2
2708;Gervelė;BURATINO;1815418720;Taip;0;13;0;13
2709;Gervelė;BURATINO;1106442860;Taip;0;2;0;2
2710;Gervelė;BURATINO;80029915729;Taip;0;11;0;11
2711;Gervelė;BURATINO;6168558862;Taip;0;12;0;12
2712;Gervelė;BURATINO;92859033264;Taip;4;4;0;8
2713;Gervelė;BURATINO;1083567209;Taip;0;4;0;4
2714;Gervelė;BURATINO;3784549444;Taip;11;9;0;20
2715;Gervelė;BURATINO;3946391650;Taip;0;1;0;1
2716;Gervelė;BURATINO;7620764911;Taip;10;5;0;15
2717;Gervelė;BURATINO;5440557094;Taip;10;2;0;12
2718;Gervelė;BURATINO;9202293067;Taip;5;0;1;6
2719;Gervelė;BURATINO;8195558041;Taip;0;12;0;12
2720;Gervelė;BURATINO;9909794030;Taip;0;5;4;9
2721;Gervelė;BURATINO;3022690832;Taip;12;0;0;12
2722;Gervelė;BURATINO;3825101647;Ne;20;0;0;20
2723;Gervelė;VIŠČIUKŲ;4394752176;Taip;0;4;0;4
2724;Gervelė;VIŠČIUKŲ;7020599764;Taip;6;0;0;6
2725;Gervelė;VIŠČIUKŲ;5953552777;Taip;5;4;0;9
2726;Gervelė;VIŠČIUKŲ;6951455424;Taip;0;0;6;6
2727;Gervelė;VIŠČIUKŲ;8016341646;Taip;10;0;0;10
2728;Gervelė;VIŠČIUKŲ;6263562066;Ne;5;0;0;5
2729;Gervelė;VIŠČIUKŲ;9970293084;Taip;5;10;0;15
2730;Gervelė;VIŠČIUKŲ;6287806975;Taip;0;0;5;5
2731;Gervelė;VIŠČIUKŲ;5267617723;Taip;15;0;0;15
2732;Gervelė;VIŠČIUKŲ;1400044294;Taip;10;0;1;11
2733;Gervelė;VIŠČIUKŲ;7935059565;Taip;6;0;0;6
2734;Gervelė;VIŠČIUKŲ;8012122042;Taip;5;0;5;10
2735;Gervelė;VIŠČIUKŲ;7050837754;Taip;1;0;4;5
2736;Gervelė;VIŠČIUKŲ;6228025635;Taip;14;0;0;14
2737;Gervelė;VIŠČIUKŲ;2185853339;Taip;5;0;3;8
2738;Gervelė;VIŠČIUKŲ;8840658383;Taip;8;0;1;9
2739;Gervelė;VIŠČIUKŲ;5685222621;Taip;6;0;0;6
2740;Gilužis;Skruzdėliukų;35511006307;Taip;0;6;0;6
2741;Gilužis;Skruzdėliukų;44807904472;Taip;0;3;0;3
2742;Gilužis;Skruzdėliukų;1671692484;Taip;10;0;0;10
2743;Gilužis;Skruzdėliukų;1615293331;Taip;5;1;0;6
2744;Gilužis;Skruzdėliukų;9474400084;Taip;0;10;0;10
2745;Gilužis;Skruzdėliukų;5161095299;Taip;5;5;0;10
2746;Gilužis;Skruzdėliukų;70959404439;Taip;1;0;0;1
2747;Gilužis;Skruzdėliukų;8120898865;Taip;5;0;0;5
2748;Gilužis;Skruzdėliukų;8840822243;Taip;1;0;0;1
2749;Gilužis;Skruzdėliukų;4611735601;Taip;10;0;0;10
2750;Gilužis;Skruzdėliukų;5920357223;Taip;0;1;0;1
2751;Gilužis;Skruzdėliukų;8595541498;Taip;5;5;0;10
2752;Gilužis;Skruzdėliukų;5365582271;Taip;15;5;0;20
2753;Gilužis;Skruzdėliukų;7364297673;Taip;10;0;0;10
2754;Gilužis;Skruzdėliukų;4362244070;Taip;6;1;0;7
2755;Gilužis;Skruzdėliukų;2093487071;Taip;9;0;0;9
2756;Gilužis;Skruzdėliukų;2042514241;Taip;12;2;0;14
2757;Gilužis;Skruzdėliukų;2218793969;Taip;11;1;1;13
2758;Gilužis;Skruzdėliukų;3216004438;Taip;3;12;0;15
2759;Gilužis;Nykštukų;94828544657;Taip;6;5;0;11
2760;Gilužis;Nykštukų;65865096435;Taip;0;4;0;4
2761;Gilužis;Nykštukų;41863620605;Taip;0;1;0;1
2762;Gilužis;Nykštukų;10456837723;Taip;4;5;0;9
2763;Gilužis;Nykštukų;89960109702;Taip;0;20;0;20
2764;Gilužis;Nykštukų;18927429626;Taip;3;4;0;7
2765;Gilužis;Nykštukų;30714242097;Taip;3;0;1;4
2766;Gilužis;Nykštukų;72071736122;Taip;10;1;0;11
2767;Gilužis;Nykštukų;25086526218;Taip;5;5;0;10
2768;Gilužis;Nykštukų;37179053472;Taip;0;2;0;2
2769;Gilužis;Nykštukų;64182110384;Taip;0;9;0;9
2770;Gilužis;Nykštukų;51989833076;Taip;0;6;0;6
2771;Gilužis;Nykštukų;42894227994;Taip;4;0;0;4
2772;Gilužis;Nykštukų;36855170422;Taip;0;4;1;5
2773;Gilužis;Nykštukų;49638196733;Taip;3;1;0;4
2774;Gilužis;Nykštukų;21430317293;Taip;4;0;0;4
2775;Gilužis;Nykštukų;93696234277;Taip;5;0;0;5
2776;Gilužis;Nykštukų;36105195245;Taip;0;3;1;4
2777;Gilužis;Nykštukų;2330374550;Taip;0;14;0;14
2778;Gilužis;Nykštukų;38286886127;Taip;5;3;5;13
2779;Gilužis;Nykštukų;51801100240;Taip;8;5;0;13
2780;Gilužis;Bitučių;7667792304;Taip;0;7;0;7
2781;Gilužis;Bitučių;33601993265;Taip;0;9;0;9
2782;Gilužis;Bitučių;16762351251;Taip;0;3;0;3
2783;Gilužis;Bitučių;79835099585;Taip;0;1;0;1
2784;Gilužis;Bitučių;86856314276;Taip;0;12;0;12
2785;Gilužis;Bitučių;86204525039;Taip;0;5;0;5
2786;Gilužis;Bitučių;66936354561;Taip;0;3;0;3
2787;Gilužis;Bitučių;31841898314;Taip;0;5;0;5
2788;Gilužis;Bitučių;99678737297;Taip;5;0;0;5
2789;Gilužis;Bitučių;35872947177;Taip;4;0;0;4
2790;Gilužis;Bitučių;67925251330;Taip;0;9;0;9
2791;Gilužis;Bitučių;75877736009;Taip;0;3;0;3
2792;Gilužis;Bitučių;77265792587;Taip;0;5;0;5
2793;Gilužis;Bitučių;98929035480;Taip;0;5;0;5
2794;Gilužis;Bitučių;16441506448;Taip;0;6;0;6
2795;Gilužis;Bitučių;60029145569;Taip;0;7;1;8
2796;Gilužis;Bitučių;6748923923;Taip;7;0;0;7
2797;Gilužis;Bitučių;84012597609;Taip;0;12;0;12
2798;Gilužis;Bitučių;44591290522;Taip;0;2;4;6
2799;Gilužis;Kačiukų;64044950817;Taip;20;0;0;20
2800;Gilužis;Kačiukų;97044945526;Taip;10;0;0;10
2801;Gilužis;Kačiukų;2452430134;Taip;0;2;0;2
2802;Gilužis;Kačiukų;97366385111;Taip;0;2;1;3
2803;Gilužis;Kačiukų;90653192774;Taip;4;0;0;4
2804;Gilužis;Kačiukų;43427840545;Taip;10;0;0;10
2805;Gilužis;Kačiukų;69179380194;Taip;6;1;0;7
2806;Gilužis;Kačiukų;93911699181;Taip;3;0;0;3
2807;Gilužis;Kačiukų;27145205823;Taip;5;0;0;5
2808;Gilužis;Kačiukų;11999596704;Taip;0;3;0;3
2809;Gilužis;Kačiukų;40327951625;Taip;0;11;0;11
2810;Gilužis;Kačiukų;32385951346;Taip;0;7;0;7
2811;Gilužis;Kačiukų;69814504535;Ne;0;5;0;5
2812;Gilužis;Kačiukų;2826672081;Taip;0;1;0;1
2813;Gilužis;Kačiukų;48813257365;Ne;0;5;0;5
2814;Gilužis;Kačiukų;37836645040;Taip;0;5;0;5
2815;Gilužis;Kačiukų;71678818697;Taip;2;0;0;2
2816;Gilužis;Kačiukų;90150093965;Taip;5;1;0;6
2817;Gilužis;Kačiukų;88997906780;Taip;0;5;0;5
2818;Gilužis;Kačiukų;1483999429;Taip;0;6;0;6
2819;Gilužis;Kačiukų;8442202778;Taip;0;0;6;6
2820;Gilužis;Kačiukų;1642252063;Taip;5;1;0;6
2821;Gilužis;Pelėdžiukų;28030501676;Taip;5;0;0;5
2822;Gilužis;Pelėdžiukų;5726426223;Taip;6;1;0;7
2823;Gilužis;Pelėdžiukų;16234698170;Taip;4;0;0;4
2824;Gilužis;Pelėdžiukų;51205862390;Taip;0;7;0;7
2825;Gilužis;Pelėdžiukų;93263653918;Taip;0;5;2;7
2826;Gilužis;Pelėdžiukų;61132410107;Taip;10;5;0;15
2827;Gilužis;Pelėdžiukų;62062383570;Taip;6;7;0;13
2828;Gilužis;Pelėdžiukų;79192054914;Taip;2;2;0;4
2829;Gilužis;Pelėdžiukų;53479123084;Taip;0;4;0;4
2830;Gilužis;Pelėdžiukų;22977705605;Taip;0;1;0;1
2831;Gilužis;Pelėdžiukų;22799444042;Taip;5;5;0;10
2832;Gilužis;Pelėdžiukų;60053609696;Taip;0;6;2;8
2833;Gilužis;Pelėdžiukų;89984610092;Taip;0;5;2;7
2834;Gilužis;Pelėdžiukų;23013185518;Taip;0;4;0;4
2835;Gilužis;Pelėdžiukų;50090534112;Taip;0;10;0;10
2836;Gilužis;Pelėdžiukų;48885794712;Taip;5;2;0;7
2837;Gilužis;Pelėdžiukų;68971431550;Taip;3;5;0;8
2838;Gilužis;Pelėdžiukų;55062344648;Taip;0;5;1;6
2839;Gilužis;Drugelių;73688524319;Taip;0;7;0;7
2840;Gilužis;Drugelių;9184268838;Taip;0;10;0;10
2841;Gilužis;Drugelių;48661024580;Taip;5;7;0;12
2842;Gilužis;Drugelių;23066248600;Taip;0;5;0;5
2843;Gilužis;Drugelių;1437220475;Taip;0;1;0;1
2844;Gilužis;Drugelių;78471541055;Taip;0;4;0;4
2845;Gilužis;Drugelių;32201401076;Taip;0;5;5;10
2846;Gilužis;Drugelių;88492331198;Taip;0;5;0;5
2847;Gilužis;Drugelių;49548271216;Taip;0;6;0;6
2848;Gilužis;Drugelių;70078053276;Taip;5;0;3;8
2849;Gilužis;Drugelių;34173898307;Taip;0;2;0;2
2850;Gilužis;Drugelių;67880087360;Taip;0;1;0;1
2851;Gilužis;Drugelių;28352939067;Taip;0;1;5;6
2852;Gilužis;Drugelių;73290159635;Taip;12;1;1;14
2853;Gilužis;Drugelių;36023384252;Taip;5;0;0;5
2854;Gilužis;Drugelių;86110181512;Taip;0;1;5;6
2855;Gilužis;Drugelių;21922874503;Taip;0;2;0;2
2856;Gilužis;Drugelių;46357319970;Taip;0;3;0;3
2857;Gilužis;Drugelių;44522730563;Taip;0;5;0;5
2858;Gilužis;Drugelių;1951561868;Taip;0;8;0;8
2859;Gilužis;Drugelių;1515789192;Taip;13;0;0;13
2860;Gilužis;Drugelių;3866604956;Taip;0;5;1;6
2861;Gilužis;Saulučių;17896774143;Taip;15;0;1;16
2862;Gilužis;Saulučių;9918995545;Taip;5;1;0;6
2863;Gilužis;Saulučių;4209000927;Taip;13;0;0;13
2864;Gilužis;Saulučių;8595551150;Taip;5;1;0;6
2865;Gilužis;Saulučių;4575619425;Taip;7;0;0;7
2866;Gilužis;Saulučių;8224691148;Taip;15;0;1;16
2867;Gilužis;Saulučių;4473810097;Taip;9;0;2;11
2868;Gilužis;Saulučių;1649256496;Taip;8;0;1;9
2869;Gilužis;Saulučių;96550272401;Taip;17;0;0;17
2870;Gilužis;Saulučių;69504888193;Taip;11;0;0;11
2871;Gilužis;Saulučių;2391630554;Taip;10;0;0;10
2872;Gilužis;Saulučių;18997894859;Taip;4;10;0;14
2873;Gilužis;Saulučių;7744997250;Taip;3;0;2;5
2874;Gilužis;Saulučių;32730847948;Taip;11;0;0;11
2875;Gilužis;Saulučių;3181765606;Taip;8;0;0;8
2876;Gilužis;Saulučių;5905237803;Taip;2;0;0;2
2877;Gilužis;Saulučių;2872439079;Taip;3;0;1;4
2878;Gilužis;Saulučių;28447690974;Taip;4;0;0;4
2879;Gilužis;Saulučių;87425898496;Taip;7;5;0;12
2880;Gilužis;Saulučių;35650138667;Taip;7;5;0;12
2881;Gilužis;Saulučių;9367673896;Taip;10;0;1;11
2882;Gilužis;Paukštelių;1911733577;Ne;2;2;2;6
2883;Gilužis;Paukštelių;2033250993;Taip;1;0;0;1
2884;Gilužis;Paukštelių;1124568431;Ne;0;3;2;5
2885;Gilužis;Paukštelių;1120628451;Taip;0;5;0;5
2886;Gilužis;Paukštelių;1772207635;Taip;1;6;0;7
2887;Gilužis;Paukštelių;9252084783;Taip;5;0;0;5
2888;Gilužis;Paukštelių;4265465127;Taip;0;2;0;2
2889;Gilužis;Paukštelių;1797199356;Taip;5;2;0;7
2890;Gilužis;Paukštelių;92163197528;Taip;13;7;0;20
2891;Gilužis;Paukštelių;1962922981;Taip;3;0;0;3
2892;Gilužis;Paukštelių;2769830772;Taip;0;0;1;1
2893;Gilužis;Paukštelių;1259168003;Taip;5;0;0;5
2894;Gilužis;Paukštelių;91148708775;Taip;3;0;0;3
2895;Gilužis;Paukštelių;8933516128;Taip;0;1;0;1
2896;Gilužis;Paukštelių;49114819476;Taip;5;0;0;5
2897;Gilužis;Paukštelių;93151301892;Taip;0;0;5;5
2898;Gilužis;Paukštelių;1067512693;Taip;0;20;0;20
2899;Gilužis;Paukštelių;65698608589;Taip;5;0;0;5
2900;Gilužis;Paukštelių;1413931545;Taip;0;1;1;2
2901;Gilužis;Paukštelių;4754994261;Taip;10;0;0;10
2902;Gilužis;Obuoliukų;27834192987;Taip;2;5;0;7
2903;Gilužis;Obuoliukų;1050659357;Taip;0;4;0;4
2904;Gilužis;Obuoliukų;72582220264;Taip;5;3;0;8
2905;Gilužis;Obuoliukų;1840213846;Taip;9;1;0;10
2906;Gilužis;Obuoliukų;2134161601;Taip;3;0;0;3
2907;Gilužis;Obuoliukų;1637726675;Taip;0;1;0;1
2908;Gilužis;Obuoliukų;1404236599;Taip;0;20;0;20
2909;Gilužis;Obuoliukų;1847232194;Taip;10;5;0;15
2910;Gilužis;Obuoliukų;93652771548;Taip;0;1;0;1
2911;Gilužis;Obuoliukų;2031851095;Taip;1;5;0;6
2912;Gilužis;Obuoliukų;8015495924;Taip;9;5;0;14
2913;Gilužis;Obuoliukų;96799037695;Taip;5;5;0;10
2914;Gilužis;Obuoliukų;2138402546;Taip;10;5;0;15
2915;Gilužis;Obuoliukų;1923605078;Taip;5;0;0;5
2916;Gilužis;Obuoliukų;1236164928;Taip;10;0;0;10
2917;Gilužis;Obuoliukų;84834458261;Taip;10;0;0;10
2918;Gilužis;Obuoliukų;5121769570;Taip;3;2;3;8
2919;Gilužis;Obuoliukų;1428994411;Taip;9;0;0;9
2920;Gilužis;Obuoliukų;5899163275;Taip;10;0;0;10
2921;Gilužis;Obuoliukų;2126527730;Taip;3;6;0;9
2922;Gilužis;Obuoliukų;53388692764;Taip;10;0;0;10
2923;Gilužis;KIŠKUČIŲ;2118119414;Taip;7;0;0;7
2924;Gilužis;KIŠKUČIŲ;1017937594;Taip;13;0;0;13
2925;Gilužis;KIŠKUČIŲ;98584480044;Taip;9;0;0;9
2926;Gilužis;KIŠKUČIŲ;97906928411;Taip;9;0;0;9
2927;Gilužis;KIŠKUČIŲ;1191967409;Taip;20;0;0;20
2928;Gilužis;KIŠKUČIŲ;1025400197;Taip;15;0;0;15
2929;Gilužis;KIŠKUČIŲ;1841556598;Taip;8;5;0;13
2930;Gilužis;KIŠKUČIŲ;1452016675;Taip;3;0;0;3
2931;Gilužis;KIŠKUČIŲ;24558082285;Taip;20;0;0;20
2932;Gilužis;KIŠKUČIŲ;31157032738;Taip;6;5;0;11
2933;Gilužis;KIŠKUČIŲ;1869058578;Taip;0;0;3;3
2934;Gilužis;KIŠKUČIŲ;1464348972;Taip;5;0;0;5
2935;Gilužis;KIŠKUČIŲ;7740703388;Taip;0;5;4;9
2936;Gilužis;KIŠKUČIŲ;1589884646;Taip;5;5;0;10
2937;Gilužis;KIŠKUČIŲ;54636558233;Taip;10;0;0;10
2938;Gilužis;KIŠKUČIŲ;1453976300;Taip;8;0;0;8
2939;Gilužis;KIŠKUČIŲ;57074114440;Taip;5;7;0;12
2940;Gilužis;KIŠKUČIŲ;15192433393;Taip;9;0;0;9
2941;Gilužis;KIŠKUČIŲ;1307302669;Taip;4;0;3;7
2942;Gilužis;KIŠKUČIŲ;1569805585;Taip;13;0;0;13
2943;Gilužis;KIŠKUČIŲ;1211233315;Taip;8;0;2;10
2944;Gilužis;KIŠKUČIŲ;21128521886;Taip;9;0;0;9
2945;Gilužis;Meškučių;5008795520;Taip;0;5;0;5
2946;Gilužis;Meškučių;82153247890;Taip;0;3;0;3
2947;Gilužis;Meškučių;9104396905;Taip;4;0;7;11
2948;Gilužis;Meškučių;15672746324;Taip;5;0;0;5
2949;Gilužis;Meškučių;8278207628;Taip;2;3;0;5
2950;Gilužis;Meškučių;5988529284;Taip;10;2;0;12
2951;Gilužis;Meškučių;2144919007;Taip;0;1;0;1
2952;Gilužis;Meškučių;6840555273;Taip;0;9;0;9
2953;Gilužis;Meškučių;2111997678;Taip;8;1;0;9
2954;Gilužis;Meškučių;1664140841;Taip;15;0;0;15
2955;Gilužis;Meškučių;1201973661;Taip;16;0;0;16
2956;Gilužis;Meškučių;99889836604;Taip;7;1;0;8
2957;Gilužis;Meškučių;93541096118;Taip;10;6;0;16
2958;Gilužis;Meškučių;41791785706;Taip;0;20;0;20
2959;Gilužis;Meškučių;3104707033;Taip;5;0;0;5
2960;Gilužis;Meškučių;3884351522;Taip;1;0;0;1
2961;Gilužis;Meškučių;48400196395;Taip;4;0;0;4
2962;Gilužis;Meškučių;1003733551;Taip;8;0;1;9
2963;Gilužis;Meškučių;41887832166;Taip;7;2;0;9
2964;Gilužis;Meškučių;57285847418;Taip;15;2;0;17
2965;Gilužis;Meškučių;37771334557;Taip;0;14;0;14
2966;Gilužis;Meškučių;3451034791;Taip;0;20;0;20
2967;Gilužis;Pagrandukai;4956685016;Taip;0;1;0;1
2968;Gilužis;Pagrandukai;7937643339;Taip;2;5;0;7
2969;Gilužis;Pagrandukai;4147821853;Taip;6;0;0;6
2970;Gilužis;Pagrandukai;8899557365;Taip;2;5;0;7
2971;Gilužis;Pagrandukai;2661894041;Taip;14;0;0;14
2972;Gilužis;Pagrandukai;5109935385;Taip;0;1;0;1
2973;Gilužis;Pagrandukai;3335512812;Taip;4;0;0;4
2974;Gilužis;Pagrandukai;6093514885;Taip;0;20;0;20
2975;Gilužis;Pagrandukai;4156613717;Taip;16;1;0;17
2976;Gilužis;Pagrandukai;5713786735;Taip;10;0;0;10
2977;Gilužis;Pagrandukai;2784416935;Taip;5;0;0;5
2978;Gilužis;Pagrandukai;6315155554;Taip;2;0;0;2
2979;Gilužis;Pagrandukai;1146713023;Taip;5;3;0;8
2980;Gilužis;Pagrandukai;9362581908;Taip;12;5;0;17
2981;Gilužis;Pagrandukai;3473889426;Taip;12;5;0;17
2982;Gilužis;Pagrandukai;7228498662;Taip;2;2;0;4
2983;Gilužis;Pagrandukai;1459273692;Taip;0;3;0;3
2984;Gilužis;Boružėlių;9421351780;Taip;13;0;0;13
2985;Gilužis;Boružėlių;9332056404;Taip;0;20;0;20
2986;Gilužis;Boružėlių;7810223775;Taip;0;20;0;20
2987;Gilužis;Boružėlių;3258640163;Taip;0;20;0;20
2988;Gilužis;Boružėlių;7742783427;Taip;20;0;0;20
2989;Gilužis;Boružėlių;7998695149;Taip;20;0;0;20
2990;Gilužis;Boružėlių;9833451628;Taip;10;0;0;10
2991;Gilužis;Boružėlių;6404411477;Taip;10;0;0;10
2992;Gilužis;Boružėlių;1222370750;Taip;0;5;0;5
2993;Gilužis;Boružėlių;5217748032;Taip;7;5;0;12
2994;Gilužis;Boružėlių;7358572344;Taip;3;7;0;10
2995;Gilužis;Boružėlių;4617259961;Taip;0;20;0;20
2996;Gilužis;Boružėlių;9186274541;Taip;11;0;0;11
2997;Gilužis;Boružėlių;6121625070;Taip;0;20;0;20
2998;Gilužis;Boružėlių;3419281756;Taip;11;1;0;12
2999;Gilužis;Boružėlių;4403218878;Taip;8;0;0;8
3000;Gilužis;Boružėlių;5989314494;Taip;12;0;0;12
3001;Gilužis;Boružėlių;6270071724;Taip;2;0;0;2
3002;Gilužis;Boružėlių;9503516686;Taip;9;0;0;9
3003;Gintarėlis;PAPŪGĖLĖS;32751650045;Taip;0;3;0;3
3004;Gintarėlis;PAPŪGĖLĖS;3100442808;Taip;0;12;0;12
3005;Gintarėlis;PAPŪGĖLĖS;41950550071;Taip;0;5;0;5
3006;Gintarėlis;PAPŪGĖLĖS;36019373990;Ne;0;5;0;5
3007;Gintarėlis;PAPŪGĖLĖS;47480197789;Taip;0;12;0;12
3008;Gintarėlis;PAPŪGĖLĖS;96134869997;Taip;0;1;0;1
3009;Gintarėlis;PAPŪGĖLĖS;77802363719;Taip;5;5;0;10
3010;Gintarėlis;PAPŪGĖLĖS;62371949439;Taip;0;8;1;9
3011;Gintarėlis;PAPŪGĖLĖS;25360163411;Taip;0;14;0;14
3012;Gintarėlis;PAPŪGĖLĖS;74116167225;Taip;0;1;1;2
3013;Gintarėlis;PAPŪGĖLĖS;45279808861;Taip;0;6;0;6
3014;Gintarėlis;PAPŪGĖLĖS;58108486480;Taip;0;2;0;2
3015;Gintarėlis;PAPŪGĖLĖS;53696873596;Taip;0;5;0;5
3016;Gintarėlis;PAPŪGĖLĖS;7610677403;Taip;0;10;0;10
3017;Gintarėlis;PAPŪGĖLĖS;51243218101;Taip;12;0;0;12
3018;Gintarėlis;PAPŪGĖLĖS;85813209902;Taip;0;3;0;3
3019;Gintarėlis;PAPŪGĖLĖS;2529363136;Taip;5;0;0;5
3020;Gintarėlis;PAPŪGĖLĖS;1943647795;Taip;0;18;0;18
3021;Gintarėlis;PAPŪGĖLĖS;6541323688;Taip;1;2;0;3
3022;Gintarėlis;PAPŪGĖLĖS;10771368524;Taip;0;9;0;9
3023;Gintarėlis;PAPŪGĖLĖS;61739452519;Taip;0;0;2;2
3024;Gintarėlis;SPINDULIUKAI;96694096944;Taip;10;3;0;13
3025;Gintarėlis;SPINDULIUKAI;58118782421;Taip;2;0;0;2
3026;Gintarėlis;SPINDULIUKAI;33863655816;Taip;0;2;0;2
3027;Gintarėlis;SPINDULIUKAI;11384063236;Taip;0;7;0;7
3028;Gintarėlis;SPINDULIUKAI;27532374357;Taip;0;1;0;1
3029;Gintarėlis;SPINDULIUKAI;8112379741;Taip;0;2;5;7
3030;Gintarėlis;SPINDULIUKAI;37848651606;Taip;5;4;2;11
3031;Gintarėlis;SPINDULIUKAI;56701557907;Ne;6;0;0;6
3032;Gintarėlis;SPINDULIUKAI;77140073438;Taip;1;2;0;3
3033;Gintarėlis;SPINDULIUKAI;18570638516;Taip;0;2;2;4
3034;Gintarėlis;SPINDULIUKAI;29392171144;Taip;0;7;0;7
3035;Gintarėlis;SPINDULIUKAI;92436759875;Taip;0;1;0;1
3036;Gintarėlis;SPINDULIUKAI;1360843628;Taip;3;2;0;5
3037;Gintarėlis;SPINDULIUKAI;6452806962;Taip;5;2;2;9
3038;Gintarėlis;SPINDULIUKAI;63037561278;Taip;0;4;2;6
3039;Gintarėlis;SPINDULIUKAI;92996401082;Taip;0;4;4;8
3040;Gintarėlis;SPINDULIUKAI;77591601744;Taip;0;3;4;7
3041;Gintarėlis;SPINDULIUKAI;24915581271;Taip;0;2;1;3
3042;Gintarėlis;SPINDULIUKAI;1076400051;Taip;0;10;0;10
3043;Gintarėlis;LAŠIUKAI;6893183889;Taip;0;2;3;5
3044;Gintarėlis;LAŠIUKAI;5880091191;Taip;0;2;3;5
3045;Gintarėlis;LAŠIUKAI;9584956349;Taip;7;0;3;10
3046;Gintarėlis;LAŠIUKAI;94354056029;Taip;8;0;2;10
3047;Gintarėlis;LAŠIUKAI;78359050717;Taip;10;0;0;10
3048;Gintarėlis;LAŠIUKAI;1002155392;Taip;5;1;0;6
3049;Gintarėlis;LAŠIUKAI;96416364735;Taip;0;2;0;2
3050;Gintarėlis;LAŠIUKAI;3504738389;Taip;0;5;0;5
3051;Gintarėlis;LAŠIUKAI;9130659549;Taip;5;1;0;6
3052;Gintarėlis;LAŠIUKAI;1809511815;Taip;5;0;3;8
3053;Gintarėlis;LAŠIUKAI;4660854883;Taip;0;0;2;2
3054;Gintarėlis;LAŠIUKAI;7192722296;Taip;7;0;0;7
3055;Gintarėlis;LAŠIUKAI;5024727902;Taip;0;8;0;8
3056;Gintarėlis;LAŠIUKAI;9040480798;Taip;10;3;0;13
3057;Gintarėlis;LAŠIUKAI;7644607132;Taip;10;4;2;16
3058;Gintarėlis;LAŠIUKAI;2088008759;Taip;8;0;0;8
3059;Gintarėlis;GAIDŽIUKAI;61360761151;Taip;0;5;0;5
3060;Gintarėlis;GAIDŽIUKAI;12332079305;Taip;2;0;0;2
3061;Gintarėlis;GAIDŽIUKAI;29645999843;Taip;5;6;0;11
3062;Gintarėlis;GAIDŽIUKAI;2099549218;Taip;0;7;0;7
3063;Gintarėlis;GAIDŽIUKAI;28514742083;Taip;0;6;0;6
3064;Gintarėlis;GAIDŽIUKAI;86948612054;Taip;0;4;0;4
3065;Gintarėlis;GAIDŽIUKAI;45480802894;Taip;0;2;0;2
3066;Gintarėlis;GAIDŽIUKAI;1539226211;Taip;0;16;0;16
3067;Gintarėlis;GAIDŽIUKAI;90891401453;Taip;5;1;0;6
3068;Gintarėlis;GAIDŽIUKAI;1770479969;Taip;0;6;0;6
3069;Gintarėlis;GAIDŽIUKAI;29331294396;Taip;0;17;0;17
3070;Gintarėlis;GAIDŽIUKAI;1799002086;Taip;20;0;0;20
3071;Gintarėlis;GAIDŽIUKAI;33786299764;Taip;0;5;0;5
3072;Gintarėlis;GAIDŽIUKAI;84375225995;Taip;0;5;0;5
3073;Gintarėlis;GAIDŽIUKAI;1441282039;Taip;12;0;0;12
3074;Gintarėlis;GAIDŽIUKAI;5835437020;Taip;13;0;2;15
3075;Gintarėlis;MEŠKUČIAI;46036221870;Taip;0;7;0;7
3076;Gintarėlis;MEŠKUČIAI;1684735692;Taip;4;1;0;5
3077;Gintarėlis;MEŠKUČIAI;5988536057;Taip;0;5;0;5
3078;Gintarėlis;MEŠKUČIAI;92253181137;Taip;0;1;0;1
3079;Gintarėlis;MEŠKUČIAI;37758004138;Taip;0;2;0;2
3080;Gintarėlis;MEŠKUČIAI;89600903751;Taip;0;1;0;1
3081;Gintarėlis;MEŠKUČIAI;26403359331;Taip;15;5;0;20
3082;Gintarėlis;MEŠKUČIAI;33678587696;Taip;0;10;0;10
3083;Gintarėlis;MEŠKUČIAI;77834528801;Taip;0;9;0;9
3084;Gintarėlis;MEŠKUČIAI;47309634627;Taip;3;0;0;3
3085;Gintarėlis;MEŠKUČIAI;49921116417;Taip;5;5;0;10
3086;Gintarėlis;MEŠKUČIAI;49473761753;Taip;0;9;0;9
3087;Gintarėlis;MEŠKUČIAI;89450049559;Taip;3;4;1;8
3088;Gintarėlis;MEŠKUČIAI;6242733673;Taip;0;3;0;3
3089;Gintarėlis;MEŠKUČIAI;49079274803;Taip;0;3;5;8
3090;Gintarėlis;MEŠKUČIAI;16507384915;Taip;0;2;0;2
3091;Gintarėlis;MEŠKUČIAI;58918505824;Taip;0;5;0;5
3092;Gintarėlis;MEŠKUČIAI;40605918843;Ne;0;2;0;2
3093;Gintarėlis;DRUGELIAI;2127877544;Taip;4;0;0;4
3094;Gintarėlis;DRUGELIAI;14840692502;Taip;0;2;0;2
3095;Gintarėlis;DRUGELIAI;1462949250;Taip;0;20;0;20
3096;Gintarėlis;DRUGELIAI;9737200226;Taip;1;2;0;3
3097;Gintarėlis;DRUGELIAI;6655809299;Taip;1;0;0;1
3098;Gintarėlis;DRUGELIAI;2614258442;Taip;1;7;0;8
3099;Gintarėlis;DRUGELIAI;1452402931;Taip;0;5;0;5
3100;Gintarėlis;DRUGELIAI;4217329880;Taip;3;3;0;6
3101;Gintarėlis;DRUGELIAI;1759217543;Taip;0;5;0;5
3102;Gintarėlis;DRUGELIAI;7571352126;Taip;3;3;0;6
3103;Gintarėlis;DRUGELIAI;1042222561;Taip;0;5;0;5
3104;Gintarėlis;DRUGELIAI;1331684725;Ne;0;5;0;5
3105;Gintarėlis;DRUGELIAI;9687974376;Taip;5;1;0;6
3106;Gintarėlis;DRUGELIAI;8704248985;Taip;5;9;0;14
3107;Gintarėlis;DRUGELIAI;9382662838;Taip;6;0;0;6
3108;Gintarėlis;DRUGELIAI;8419453060;Taip;0;0;2;2
3109;Gintarėlis;DRUGELIAI;6655645997;Taip;9;3;0;12
3110;Gintarėlis;DRUGELIAI;6080108998;Taip;9;3;0;12
3111;Gintarėlis;DRUGELIAI;7449437199;Taip;0;2;0;2
3112;Gintarėlis;DRUGELIAI;4076421692;Taip;0;2;1;3
3113;Gintarėlis;DRUGELIAI;2016067859;Taip;0;0;1;1
3114;Gintarėlis;DRUGELIAI;5355691986;Taip;0;4;0;4
3115;Gintarėlis;KAČIUKAI;5451653510;Taip;3;0;0;3
3116;Gintarėlis;KAČIUKAI;9903314418;Taip;10;0;0;10
3117;Gintarėlis;KAČIUKAI;63243392161;Taip;0;5;0;5
3118;Gintarėlis;KAČIUKAI;37612987791;Taip;0;6;0;6
3119;Gintarėlis;KAČIUKAI;26259581924;Taip;0;5;0;5
3120;Gintarėlis;KAČIUKAI;70787488885;Taip;2;1;0;3
3121;Gintarėlis;KAČIUKAI;31365533022;Ne;3;2;0;5
3122;Gintarėlis;KAČIUKAI;50715082496;Taip;0;5;0;5
3123;Gintarėlis;KAČIUKAI;1159773367;Taip;5;2;0;7
3124;Gintarėlis;KAČIUKAI;1124481108;Ne;0;5;0;5
3125;Gintarėlis;KAČIUKAI;2050020230;Taip;0;10;0;10
3126;Gintarėlis;KAČIUKAI;54145290842;Taip;0;20;0;20
3127;Gintarėlis;KAČIUKAI;19813827223;Taip;0;2;0;2
3128;Gintarėlis;KAČIUKAI;98684742007;Taip;2;18;0;20
3129;Gintarėlis;KAČIUKAI;2000986290;Taip;8;10;0;18
3130;Gintarėlis;KAČIUKAI;8860898577;Taip;4;1;0;5
3131;Gintarėlis;KAČIUKAI;6421537455;Taip;1;19;0;20
3132;Gintarėlis;KAČIUKAI;1595816431;Taip;0;0;3;3
3133;Gintarėlis;KAČIUKAI;30446888177;Taip;11;0;0;11
3134;Gintarėlis;KAČIUKAI;63221497564;Taip;0;8;0;8
3135;Gintarėlis;KAČIUKAI;81135362098;Taip;10;0;0;10
3136;Gintarėlis;KAČIUKAI;58701768194;Taip;0;3;0;3
3137;Gintarėlis;KAČIUKAI;29480359781;Taip;6;2;1;9
3138;Gintarėlis;KIŠKUČIAI;8665467175;Taip;2;3;0;5
3139;Gintarėlis;KIŠKUČIAI;14981744375;Taip;10;6;0;16
3140;Gintarėlis;KIŠKUČIAI;83754732536;Taip;5;6;0;11
3141;Gintarėlis;KIŠKUČIAI;89051269756;Taip;0;2;0;2
3142;Gintarėlis;KIŠKUČIAI;1642627920;Taip;6;0;0;6
3143;Gintarėlis;KIŠKUČIAI;1593455162;Taip;0;18;0;18
3144;Gintarėlis;KIŠKUČIAI;2043405414;Taip;0;6;0;6
3145;Gintarėlis;KIŠKUČIAI;3828845515;Taip;5;5;0;10
3146;Gintarėlis;KIŠKUČIAI;1069395570;Taip;0;5;0;5
3147;Gintarėlis;KIŠKUČIAI;1110150536;Taip;12;0;0;12
3148;Gintarėlis;KIŠKUČIAI;19402011412;Taip;0;8;0;8
3149;Gintarėlis;KIŠKUČIAI;96211766919;Taip;0;5;0;5
3150;Gintarėlis;KIŠKUČIAI;78697777550;Taip;0;1;0;1
3151;Gintarėlis;KIŠKUČIAI;85557344192;Taip;4;5;0;9
3152;Gintarėlis;KIŠKUČIAI;2970527490;Taip;0;2;0;2
3153;Gintarėlis;KIŠKUČIAI;4279681763;Taip;6;0;0;6
3154;Gintarėlis;KIŠKUČIAI;1868431609;Taip;5;5;6;16
3155;Gintarėlis;KIŠKUČIAI;2032900352;Taip;2;0;0;2
3156;Gintarėlis;KIŠKUČIAI;3292572563;Taip;0;6;0;6
3157;Gintarėlis;KIŠKUČIAI;1543013649;Taip;9;4;1;14
3158;Gintarėlis;KIŠKUČIAI;24774460882;Taip;0;13;0;13
3159;Gintarėlis;KIŠKUČIAI;1028456578;Taip;5;0;0;5
3160;Gintarėlis;VYTURIUKAI;1553747935;Taip;5;4;0;9
3161;Gintarėlis;VYTURIUKAI;4902086873;Taip;1;1;0;2
3162;Gintarėlis;VYTURIUKAI;56124970238;Taip;0;2;1;3
3163;Gintarėlis;VYTURIUKAI;34606130829;Taip;11;1;0;12
3164;Gintarėlis;VYTURIUKAI;21658913551;Taip;3;0;0;3
3165;Gintarėlis;VYTURIUKAI;18715625324;Taip;9;1;0;10
3166;Gintarėlis;VYTURIUKAI;1191846491;Taip;4;1;0;5
3167;Gintarėlis;VYTURIUKAI;9740239182;Taip;0;11;0;11
3168;Gintarėlis;VYTURIUKAI;2036488789;Taip;16;0;0;16
3169;Gintarėlis;VYTURIUKAI;8405210216;Taip;7;0;0;7
3170;Gintarėlis;VYTURIUKAI;2721386855;Taip;0;0;1;1
3171;Gintarėlis;BORUŽĖLĖS;4971574875;Taip;0;1;0;1
3172;Gintarėlis;BORUŽĖLĖS;6277010268;Taip;10;0;0;10
3173;Gintarėlis;BORUŽĖLĖS;1771868868;Taip;5;4;0;9
3174;Gintarėlis;BORUŽĖLĖS;39372328122;Taip;0;2;0;2
3175;Gintarėlis;BORUŽĖLĖS;25451522701;Taip;6;2;0;8
3176;Gintarėlis;BORUŽĖLĖS;90216120878;Taip;0;18;0;18
3177;Gintarėlis;BORUŽĖLĖS;1929900615;Taip;12;8;0;20
3178;Gintarėlis;BORUŽĖLĖS;82344200095;Taip;0;4;0;4
3179;Gintarėlis;BORUŽĖLĖS;1168158494;Taip;1;1;0;2
3180;Gintarėlis;BORUŽĖLĖS;9255623049;Taip;0;13;0;13
3181;Gintarėlis;BORUŽĖLĖS;88451515187;Taip;0;7;0;7
3182;Gintarėlis;BORUŽĖLĖS;7703150488;Taip;13;0;0;13
3183;Gintarėlis;BORUŽĖLĖS;2145479870;Taip;9;5;0;14
3184;Gintarėlis;BORUŽĖLĖS;49506158711;Taip;0;0;1;1
3185;Gintarėlis;BORUŽĖLĖS;63146841406;Taip;0;20;0;20
3186;Gintarėlis;BORUŽĖLĖS;30334064319;Taip;3;1;0;4
3187;Gintarėlis;BORUŽĖLĖS;6426075546;Taip;0;1;0;1
3188;Gintarėlis;BORUŽĖLĖS;91798408335;Taip;0;13;0;13
3189;Gintarėlis;BORUŽĖLĖS;25684002087;Taip;0;11;0;11
3190;Gintarėlis;BORUŽĖLĖS;10826255781;Taip;6;5;0;11
3191;Gintarėlis;BORUŽĖLĖS;1505703905;Taip;5;5;0;10
3192;Gintarėlis;EŽIUKAI;1793785936;Taip;0;1;1;2
3193;Gintarėlis;EŽIUKAI;96812991513;Taip;0;3;0;3
3194;Gintarėlis;EŽIUKAI;27890184523;Taip;10;4;0;14
3195;Gintarėlis;EŽIUKAI;1841482183;Taip;0;1;2;3
3196;Gintarėlis;EŽIUKAI;8074941282;Taip;0;2;1;3
3197;Gintarėlis;EŽIUKAI;2040989572;Taip;0;3;0;3
3198;Gintarėlis;EŽIUKAI;1312688961;Taip;7;3;3;13
3199;Gintarėlis;EŽIUKAI;1672037617;Taip;0;6;0;6
3200;Gintarėlis;EŽIUKAI;51418692259;Taip;0;2;0;2
3201;Gintarėlis;EŽIUKAI;1398810524;Taip;5;5;0;10
3202;Gintarėlis;EŽIUKAI;74295947670;Taip;0;1;0;1
3203;Gintarėlis;EŽIUKAI;52644122529;Taip;0;6;0;6
3204;Gintarėlis;EŽIUKAI;2732338838;Taip;0;1;0;1
3205;Gintarėlis;EŽIUKAI;7731823367;Taip;0;6;0;6
3206;Gintarėlis;EŽIUKAI;7053099543;Taip;2;5;0;7
3207;Gintarėlis;EŽIUKAI;56834651967;Taip;10;10;0;20
3208;Gintarėlis;EŽIUKAI;9705808868;Taip;0;0;1;1
3209;Gintarėlis;EŽIUKAI;13416505188;Taip;5;3;0;8
3210;Gintarėlis;EŽIUKAI;36350623756;Taip;4;0;0;4
3211;Gintarėlis;EŽIUKAI;96404879029;Taip;0;13;0;13
3212;Gintarėlis;EŽIUKAI;1725007540;Ne;0;4;1;5
3213;Gintarėlis;VIŠČIUKAI;7494884360;Taip;6;7;0;13
3214;Gintarėlis;VIŠČIUKAI;5783939567;Taip;0;0;3;3
3215;Gintarėlis;VIŠČIUKAI;8064521864;Taip;1;0;0;1
3216;Gintarėlis;VIŠČIUKAI;8913652291;Taip;10;0;1;11
3217;Gintarėlis;VIŠČIUKAI;1033624080;Taip;17;0;0;17
3218;Gintarėlis;VIŠČIUKAI;2919700367;Taip;14;0;0;14
3219;Gintarėlis;VIŠČIUKAI;1768789948;Taip;4;0;0;4
3220;Gintarėlis;VIŠČIUKAI;2235045173;Taip;5;0;0;5
3221;Gintarėlis;VIŠČIUKAI;9494521554;Taip;0;11;0;11
3222;Gintarėlis;VIŠČIUKAI;7147842224;Taip;5;0;0;5
3223;Gintarėlis;VIŠČIUKAI;7674351459;Taip;0;1;0;1
3224;Gintarėlis;VIŠČIUKAI;2485750596;Taip;4;5;0;9
3225;Gintarėlis;VIŠČIUKAI;2595566032;Taip;0;6;0;6
3226;Gintarėlis;VIŠČIUKAI;9141438560;Taip;0;6;0;6
3227;Gintarėlis;VIŠČIUKAI;9648982613;Taip;4;0;0;4
3228;Gintarėlis;VIŠČIUKAI;6292664833;Taip;7;3;5;15
3229;Gintarėlis;"SAULĖS ZUIKUČIAI";8287685690;Taip;0;7;0;7
3230;Gintarėlis;"SAULĖS ZUIKUČIAI";6914904213;Taip;8;0;0;8
3231;Gintarėlis;"SAULĖS ZUIKUČIAI";1696337909;Taip;8;0;0;8
3232;Gintarėlis;"SAULĖS ZUIKUČIAI";1778573935;Taip;5;1;1;7
3233;Gintarėlis;"SAULĖS ZUIKUČIAI";5796729245;Taip;5;2;0;7
3234;Gintarėlis;"SAULĖS ZUIKUČIAI";9915887420;Taip;5;2;0;7
3235;Gintarėlis;"SAULĖS ZUIKUČIAI";3398936974;Taip;10;0;0;10
3236;Gintarėlis;"SAULĖS ZUIKUČIAI";5153948767;Taip;0;20;0;20
3237;Gintarėlis;"SAULĖS ZUIKUČIAI";9675201979;Taip;12;0;0;12
3238;Gintarėlis;"SAULĖS ZUIKUČIAI";7971810025;Taip;18;0;0;18
3239;Gintarėlis;"SAULĖS ZUIKUČIAI";2814569415;Taip;0;0;7;7
3240;Gintarėlis;"SAULĖS ZUIKUČIAI";6862629244;Taip;15;0;1;16
3241;Gintarėlis;"SAULĖS ZUIKUČIAI";9279399214;Taip;12;0;0;12
3242;Gintarėlis;"SAULĖS ZUIKUČIAI";8000297636;Taip;10;3;0;13
3243;Gintarėlis;"SAULĖS ZUIKUČIAI";6142819210;Taip;5;1;4;10
3244;Gintarėlis;"SAULĖS ZUIKUČIAI";3359584322;Taip;0;20;0;20
3245;Gintarėlis;"SAULĖS ZUIKUČIAI";7815317644;Taip;0;0;4;4
3246;Giraitė;Aviliukas;62525988158;Taip;5;6;0;11
3247;Giraitė;Aviliukas;68804588518;Taip;0;14;0;14
3248;Giraitė;Aviliukas;809734624;Taip;10;4;0;14
3249;Giraitė;Aviliukas;44396075745;Taip;5;3;0;8
3250;Giraitė;Aviliukas;42330865487;Taip;0;2;0;2
3251;Giraitė;Aviliukas;1139666539;Ne;12;0;0;12
3252;Giraitė;Aviliukas;34957067197;Taip;0;5;0;5
3253;Giraitė;Aviliukas;94197982724;Taip;0;6;0;6
3254;Giraitė;Aviliukas;39627499338;Taip;0;1;0;1
3255;Giraitė;Aviliukas;67108509429;Taip;0;5;0;5
3256;Giraitė;Aviliukas;86412433313;Taip;2;0;1;3
3257;Giraitė;Aviliukas;10778161174;Taip;0;6;0;6
3258;Giraitė;Aviliukas;94618756885;Taip;3;1;1;5
3259;Giraitė;Aviliukas;90920588960;Taip;0;5;0;5
3260;Giraitė;Aviliukas;6449275481;Taip;10;0;0;10
3261;Giraitė;Aviliukas;37348466498;Taip;3;0;1;4
3262;Giraitė;Aviliukas;12568042778;Taip;0;4;0;4
3263;Giraitė;Aviliukas;45633008605;Taip;0;5;0;5
3264;Giraitė;Aviliukas;32804353567;Taip;0;10;0;10
3265;Giraitė;Aviliukas;24903085449;Taip;3;5;0;8
3266;Giraitė;Aviliukas;7868564343;Taip;5;10;0;15
3267;Giraitė;LapiukaI;42953220489;Taip;3;3;0;6
3268;Giraitė;LapiukaI;1285310492;Taip;2;7;0;9
3269;Giraitė;LapiukaI;17883856522;Taip;11;0;0;11
3270;Giraitė;LapiukaI;1965752607;Taip;5;0;3;8
3271;Giraitė;LapiukaI;65850793662;Taip;0;7;0;7
3272;Giraitė;LapiukaI;79459838218;Taip;0;5;0;5
3273;Giraitė;LapiukaI;1690407683;Taip;2;2;0;4
3274;Giraitė;LapiukaI;94357968497;Taip;0;2;0;2
3275;Giraitė;LapiukaI;87139343254;Taip;0;5;0;5
3276;Giraitė;LapiukaI;1146337878;Taip;5;2;0;7
3277;Giraitė;LapiukaI;1424661991;Taip;3;0;0;3
3278;Giraitė;LapiukaI;9710265790;Taip;0;6;0;6
3279;Giraitė;LapiukaI;26202357668;Taip;5;9;0;14
3280;Giraitė;LapiukaI;260305509;Taip;5;0;0;5
3281;Giraitė;LapiukaI;9493194946;Taip;9;1;0;10
3282;Giraitė;LapiukaI;89948210310;Taip;0;9;1;10
3283;Giraitė;LapiukaI;22783526738;Taip;10;0;0;10
3284;Giraitė;LapiukaI;6084454238;Taip;12;2;0;14
3285;Giraitė;LapiukaI;8986196352;Taip;5;1;2;8
3286;Giraitė;Voveriukai;83995022535;Taip;4;0;0;4
3287;Giraitė;Voveriukai;62684217934;Taip;5;3;0;8
3288;Giraitė;Voveriukai;70629522964;Taip;10;2;0;12
3289;Giraitė;Voveriukai;10070775660;Taip;6;5;0;11
3290;Giraitė;Voveriukai;68502311448;Taip;0;5;1;6
3291;Giraitė;Voveriukai;34413917793;Taip;3;0;0;3
3292;Giraitė;Voveriukai;48623826572;Taip;6;1;0;7
3293;Giraitė;Voveriukai;482311593;Taip;10;3;0;13
3294;Giraitė;Voveriukai;10108398683;Taip;0;2;1;3
3295;Giraitė;Voveriukai;19218675078;Ne;6;1;0;7
3296;Giraitė;Voveriukai;61477798910;Taip;5;0;0;5
3297;Giraitė;Voveriukai;20082610200;Taip;6;7;0;13
3298;Giraitė;Voveriukai;98106730833;Taip;3;5;0;8
3299;Giraitė;Voveriukai;2107606245;Taip;0;2;1;3
3300;Giraitė;Voveriukai;2816941652;Taip;0;1;0;1
3301;Giraitė;Voveriukai;1313395982;Taip;5;5;1;11
3302;Giraitė;Voveriukai;5824936903;Taip;0;5;0;5
3303;Giraitė;Voveriukai;6159111262;Taip;4;0;0;4
3304;Giraitė;Voveriukai;70668076883;Taip;3;5;0;8
3305;Giraitė;Grybukai;82326314822;Taip;0;8;4;12
3306;Giraitė;Grybukai;44781582045;Taip;0;6;0;6
3307;Giraitė;Grybukai;54865651920;Taip;3;0;1;4
3308;Giraitė;Grybukai;2088558056;Taip;0;1;3;4
3309;Giraitė;Grybukai;61885066766;Taip;0;10;0;10
3310;Giraitė;Grybukai;61377720550;Taip;0;5;1;6
3311;Giraitė;Grybukai;70833551710;Taip;7;5;1;13
3312;Giraitė;Grybukai;98893791966;Taip;0;6;0;6
3313;Giraitė;Grybukai;90085776538;Taip;2;5;0;7
3314;Giraitė;Grybukai;38156994332;Taip;0;11;0;11
3315;Giraitė;Grybukai;1791880914;Taip;0;0;11;11
3316;Giraitė;Grybukai;47131903191;Taip;0;8;0;8
3317;Giraitė;Grybukai;16962877902;Taip;0;2;0;2
3318;Giraitė;Grybukai;43596280059;Taip;0;1;0;1
3319;Giraitė;Grybukai;1354740688;Ne;5;0;0;5
3320;Giraitė;Riešutėliai;3683700626;Taip;0;1;0;1
3321;Giraitė;Riešutėliai;8596389737;Taip;0;5;2;7
3322;Giraitė;Riešutėliai;5167002022;Taip;0;4;0;4
3323;Giraitė;Riešutėliai;2425354598;Taip;0;2;3;5
3324;Giraitė;Riešutėliai;9495968363;Taip;11;1;0;12
3325;Giraitė;Riešutėliai;1253151830;Taip;11;1;0;12
3326;Giraitė;Riešutėliai;4336519836;Taip;12;2;1;15
3327;Giraitė;Riešutėliai;9026736929;Taip;9;2;0;11
3328;Giraitė;Riešutėliai;9882372025;Taip;20;0;0;20
3329;Giraitė;Riešutėliai;5721669627;Taip;0;1;7;8
3330;Giraitė;Riešutėliai;5029839281;Ne;4;0;1;5
3331;Giraitė;Riešutėliai;3091067158;Taip;0;2;4;6
3332;Giraitė;Riešutėliai;4785524898;Taip;4;0;0;4
3333;Giraitė;Riešutėliai;4839351300;Taip;17;0;1;18
3334;Giraitė;Riešutėliai;1817075429;Taip;7;0;1;8
3335;Giraitė;Riešutėliai;6836412890;Taip;2;0;0;2
3336;Giraitė;Riešutėliai;9224845723;Taip;15;0;0;15
3337;Giraitė;Riešutėliai;4687228561;Taip;9;0;0;9
3338;Giraitė;Riešutėliai;9652807467;Taip;20;0;0;20
3339;Giraitė;Meškiukai;27501094616;Taip;8;11;0;19
3340;Giraitė;Meškiukai;2513312448;Taip;4;4;0;8
3341;Giraitė;Meškiukai;5367392810;Taip;10;1;0;11
3342;Giraitė;Meškiukai;1608876140;Taip;5;0;0;5
3343;Giraitė;Meškiukai;1355594003;Taip;5;1;2;8
3344;Giraitė;Meškiukai;1560868105;Taip;10;5;0;15
3345;Giraitė;Meškiukai;1050699551;Taip;11;0;0;11
3346;Giraitė;Meškiukai;1876815077;Taip;0;1;2;3
3347;Giraitė;Meškiukai;1063628206;Taip;5;0;0;5
3348;Giraitė;Meškiukai;1318214394;Taip;8;0;0;8
3349;Giraitė;Meškiukai;1846118720;Taip;4;6;1;11
3350;Giraitė;Meškiukai;9195735923;Taip;15;0;0;15
3351;Giraitė;Meškiukai;65251975467;Taip;12;0;0;12
3352;Giraitė;Meškiukai;1704154980;Taip;10;0;1;11
3353;Giraitė;Meškiukai;1819657811;Taip;6;0;0;6
3354;Giraitė;Meškiukai;1512384599;Taip;12;2;0;14
3355;Giraitė;Meškiukai;2571892050;Taip;0;5;2;7
3356;Giraitė;Meškiukai;5544613599;Taip;4;2;4;10
3357;Giraitė;Meškiukai;1594965200;Taip;20;0;0;20
3358;Giraitė;Meškiukai;9723242940;Taip;18;0;0;18
3359;Giraitė;Meškiukai;5726182600;Taip;5;0;0;5
3360;Giraitė;Meškiukai;1772790396;Taip;14;2;1;17
3361;Giraitė;Uogelės;37225101302;Taip;4;0;0;4
3362;Giraitė;Uogelės;3031181239;Taip;5;0;0;5
3363;Giraitė;Uogelės;99494458394;Taip;0;5;0;5
3364;Giraitė;Uogelės;1103462199;Taip;0;9;0;9
3365;Giraitė;Uogelės;1447893912;Taip;2;7;0;9
3366;Giraitė;Uogelės;49193108666;Ne;0;1;0;1
3367;Giraitė;Uogelės;31110630088;Taip;3;1;0;4
3368;Giraitė;Uogelės;1312761239;Taip;11;5;0;16
3369;Giraitė;Uogelės;43475840493;Taip;3;2;0;5
3370;Giraitė;Uogelės;30804922053;Taip;1;14;0;15
3371;Giraitė;Uogelės;2083472940;Taip;20;0;0;20
3372;Giraitė;Uogelės;1848908894;Taip;9;0;0;9
3373;Giraitė;Uogelės;99146206772;Taip;5;1;0;6
3374;Giraitė;Uogelės;5378240128;Taip;0;9;0;9
3375;Giraitė;Uogelės;40696452801;Taip;5;2;0;7
3376;Giraitė;Uogelės;43468579365;Taip;5;2;0;7
3377;Giraitė;Uogelės;74256775397;Taip;13;1;0;14
3378;Giraitė;Uogelės;65392345188;Taip;0;2;0;2
3379;Giraitė;Uogelės;7779733510;Taip;0;5;0;5
3380;Giraitė;Uogelės;1110792632;Taip;0;1;0;1
3381;Giraitė;Šaltinėlis;83173577451;Taip;0;6;0;6
3382;Giraitė;Šaltinėlis;89112366792;Taip;0;16;0;16
3383;Giraitė;Šaltinėlis;29823126743;Ne;0;6;0;6
3384;Giraitė;Šaltinėlis;85943562009;Taip;0;6;0;6
3385;Giraitė;Šaltinėlis;80616169818;Taip;0;3;0;3
3386;Giraitė;Šaltinėlis;23695629099;Taip;0;1;0;1
3387;Giraitė;Šaltinėlis;8636782322;Taip;0;5;0;5
3388;Giraitė;Šaltinėlis;29419658963;Taip;0;5;0;5
3389;Giraitė;Šaltinėlis;57289703755;Taip;0;4;0;4
3390;Giraitė;Šaltinėlis;23443952589;Taip;0;1;3;4
3391;Giraitė;Šaltinėlis;75752125046;Taip;0;6;0;6
3392;Giraitė;Šaltinėlis;13537474624;Taip;0;8;0;8
3393;Giraitė;Šaltinėlis;74821326426;Taip;0;4;0;4
3394;Giraitė;Šaltinėlis;5106092595;Taip;0;16;0;16
3395;Giraitė;Šaltinėlis;18070708999;Taip;0;6;0;6
3396;Giraitė;Šaltinėlis;83199904684;Taip;0;5;0;5
3397;Giraitė;Šaltinėlis;72098612565;Taip;0;1;0;1
3398;Giraitė;Šaltinėlis;55816174362;Taip;0;5;2;7
3399;Giraitė;Šaltinėlis;3592590159;Taip;0;1;1;2
3400;Giraitė;Šaltinėlis;25319015890;Taip;5;1;1;7
3401;Giraitė;Boružėlės;5438716880;Taip;9;2;0;11
3402;Giraitė;Boružėlės;4055450300;Taip;5;5;0;10
3403;Giraitė;Boružėlės;4387282125;Taip;5;4;0;9
3404;Giraitė;Boružėlės;2074303013;Taip;5;0;0;5
3405;Giraitė;Boružėlės;7354834895;Taip;2;0;2;4
3406;Giraitė;Boružėlės;4822168634;Taip;0;0;1;1
3407;Giraitė;Boružėlės;6963656869;Taip;1;1;3;5
3408;Giraitė;Boružėlės;2088867630;Taip;12;0;0;12
3409;Giraitė;Boružėlės;3875214088;Taip;7;2;0;9
3410;Giraitė;Boružėlės;7481895278;Taip;0;0;2;2
3411;Giraitė;Boružėlės;3607198556;Taip;0;2;0;2
3412;Giraitė;Boružėlės;1945918102;Taip;5;5;0;10
3413;Giraitė;Boružėlės;2699984170;Taip;3;8;0;11
3414;Giraitė;Boružėlės;6265908751;Taip;10;0;0;10
3415;Giraitė;Boružėlės;5202562049;Taip;14;0;0;14
3416;Giraitė;Gandriukai;69883334049;Taip;9;0;2;11
3417;Giraitė;Gandriukai;26032013284;Taip;14;0;0;14
3418;Giraitė;Gandriukai;36650870278;Taip;0;8;2;10
3419;Giraitė;Gandriukai;82915040164;Taip;11;0;0;11
3420;Giraitė;Gandriukai;18968645937;Taip;3;0;1;4
3421;Giraitė;Gandriukai;64357457379;Taip;6;3;0;9
3422;Giraitė;Gandriukai;1022899992;Taip;1;0;0;1
3423;Giraitė;Gandriukai;1238299747;Taip;18;0;0;18
3424;Giraitė;Gandriukai;5081903157;Taip;0;8;0;8
3425;Giraitė;Gandriukai;8941330547;Taip;3;0;0;3
3426;Giraitė;Gandriukai;5759367884;Taip;3;1;0;4
3427;Giraitė;Gandriukai;1111614295;Taip;0;11;0;11
3428;Giraitė;ŽVIRBLIUKAI;4444292550;Taip;2;1;0;3
3429;Giraitė;ŽVIRBLIUKAI;1958553421;Taip;9;1;0;10
3430;Giraitė;ŽVIRBLIUKAI;77765768952;Taip;7;3;0;10
3431;Giraitė;ŽVIRBLIUKAI;56380808064;Taip;7;3;0;10
3432;Giraitė;ŽVIRBLIUKAI;1181578380;Taip;14;0;0;14
3433;Giraitė;ŽVIRBLIUKAI;1730588815;Taip;7;3;0;10
3434;Giraitė;ŽVIRBLIUKAI;1641872824;Taip;15;0;0;15
3435;Giraitė;ŽVIRBLIUKAI;1234136698;Taip;13;0;0;13
3436;Giraitė;ŽVIRBLIUKAI;2065944230;Taip;7;0;0;7
3437;Giraitė;ŽVIRBLIUKAI;1858146807;Taip;10;0;0;10
3438;Giraitė;ŽVIRBLIUKAI;2951520056;Taip;9;0;0;9
3439;Giraitė;ŽVIRBLIUKAI;1464444782;Taip;0;2;1;3
3440;Giraitė;ŽVIRBLIUKAI;1435017557;Taip;20;0;0;20
3441;Giraitė;ŽVIRBLIUKAI;1149254911;Taip;0;7;0;7
3442;Giraitė;ŽVIRBLIUKAI;1284187551;Taip;5;5;0;10
3443;Giraitė;ŽVIRBLIUKAI;48291239027;Taip;10;0;0;10
3444;Giraitė;ŽVIRBLIUKAI;3628448974;Taip;13;0;0;13
3445;Giraitė;ŽVIRBLIUKAI;8020051188;Taip;11;0;0;11
3446;Giraitė;ŽVIRBLIUKAI;6197641912;Taip;3;0;0;3
3447;Giraitė;Kiškeliai;4076402180;Taip;4;0;0;4
3448;Giraitė;Kiškeliai;5902161665;Taip;4;5;0;9
3449;Giraitė;Kiškeliai;7551981095;Taip;15;2;0;17
3450;Giraitė;Kiškeliai;5532639133;Taip;13;5;0;18
3451;Giraitė;Kiškeliai;4296449093;Taip;15;1;0;16
3452;Giraitė;Kiškeliai;1974159110;Taip;5;5;1;11
3453;Giraitė;Kiškeliai;1583733838;Taip;0;14;0;14
3454;Giraitė;Kiškeliai;4009092043;Taip;4;3;0;7
3455;Giraitė;Kiškeliai;7919088987;Taip;6;1;1;8
3456;Giraitė;Kiškeliai;8376809208;Taip;6;1;0;7
3457;Giraitė;Kiškeliai;5616242311;Taip;5;0;1;6
3458;Giraitė;Kiškeliai;4272999339;Taip;0;0;1;1
3459;Giraitė;Kiškeliai;4955786826;Taip;11;1;0;12
3460;Gudrutis;Gandriukų;38591847769;Taip;5;6;0;11
3461;Gudrutis;Gandriukų;33123804925;Taip;15;0;0;15
3462;Gudrutis;Gandriukų;21999129886;Taip;0;1;0;1
3463;Gudrutis;Gandriukų;69437346100;Taip;0;13;0;13
3464;Gudrutis;Gandriukų;85886111222;Taip;0;6;0;6
3465;Gudrutis;Gandriukų;1261390117;Taip;9;2;2;13
3466;Gudrutis;Gandriukų;1013150817;Taip;0;6;0;6
3467;Gudrutis;Gandriukų;1174040508;Taip;2;5;0;7
3468;Gudrutis;Gandriukų;14626533681;Taip;13;5;0;18
3469;Gudrutis;Gandriukų;13755502342;Taip;0;5;0;5
3470;Gudrutis;Gandriukų;1436950588;Taip;5;0;0;5
3471;Gudrutis;Gandriukų;35401545938;Taip;0;2;0;2
3472;Gudrutis;Gandriukų;3363640861;Taip;14;0;0;14
3473;Gudrutis;Gandriukų;70107420346;Taip;0;3;1;4
3474;Gudrutis;Gandriukų;62735575539;Taip;11;2;0;13
3475;Gudrutis;Gandriukų;6824283429;Taip;19;1;0;20
3476;Gudrutis;"Saulės zuikučių";2453989647;Taip;0;0;2;2
3477;Gudrutis;"Saulės zuikučių";1434565790;Taip;5;0;0;5
3478;Gudrutis;"Saulės zuikučių";1238607523;Taip;5;0;1;6
3479;Gudrutis;"Saulės zuikučių";1204945185;Taip;0;11;2;13
3480;Gudrutis;"Saulės zuikučių";77776725399;Taip;0;3;0;3
3481;Gudrutis;"Saulės zuikučių";21494647270;Taip;0;4;0;4
3482;Gudrutis;"Saulės zuikučių";87981934125;Taip;6;0;0;6
3483;Gudrutis;"Saulės zuikučių";1998630017;Taip;0;1;3;4
3484;Gudrutis;"Saulės zuikučių";1823786522;Taip;0;6;0;6
3485;Gudrutis;"Saulės zuikučių";1618442704;Taip;0;1;3;4
3486;Gudrutis;"Saulės zuikučių";1592255250;Taip;0;0;3;3
3487;Gudrutis;"Saulės zuikučių";8085295588;Taip;0;0;2;2
3488;Gudrutis;"Saulės zuikučių";4392872175;Taip;0;1;0;1
3489;Gudrutis;"Saulės zuikučių";11383212272;Taip;15;0;0;15
3490;Gudrutis;"Saulės zuikučių";1156575830;Taip;7;5;0;12
3491;Gudrutis;"Saulės zuikučių";1490739175;Taip;15;1;1;17
3492;Gudrutis;"Saulės zuikučių";8128313792;Taip;6;0;0;6
3493;Gudrutis;"Saulės zuikučių";8768627605;Taip;0;1;0;1
3494;Gudrutis;"Saulės zuikučių";18320321051;Taip;15;0;0;15
3495;Gudrutis;Pelėdžiukų;2012092629;Taip;0;5;4;9
3496;Gudrutis;Pelėdžiukų;21178331458;Taip;13;0;0;13
3497;Gudrutis;Pelėdžiukų;46232665673;Taip;0;0;3;3
3498;Gudrutis;Pelėdžiukų;18813895572;Taip;0;5;0;5
3499;Gudrutis;Pelėdžiukų;14779917423;Taip;0;20;0;20
3500;Gudrutis;Pelėdžiukų;2579697941;Taip;0;1;2;3
3501;Gudrutis;Pelėdžiukų;54019097027;Taip;5;2;0;7
3502;Gudrutis;Pelėdžiukų;79189562476;Ne;0;5;10;15
3503;Gudrutis;Pelėdžiukų;77718940253;Taip;0;1;1;2
3504;Gudrutis;Pelėdžiukų;3970404528;Taip;0;0;1;1
3505;Gudrutis;Pelėdžiukų;1427882103;Taip;0;2;0;2
3506;Gudrutis;Pelėdžiukų;16404432728;Taip;3;5;4;12
3507;Gudrutis;Pelėdžiukų;81252457503;Taip;0;2;3;5
3508;Gudrutis;Pelėdžiukų;1340947103;Taip;5;2;13;20
3509;Gudrutis;Pelėdžiukų;7632549677;Ne;0;1;11;12
3510;Gudrutis;Pelėdžiukų;1464768624;Taip;0;4;5;9
3511;Gudrutis;BITUČIŲ;4125420913;Taip;0;11;1;12
3512;Gudrutis;BITUČIŲ;35630338758;Taip;0;5;0;5
3513;Gudrutis;BITUČIŲ;13495334557;Taip;4;5;0;9
3514;Gudrutis;BITUČIŲ;59378091248;Taip;0;11;0;11
3515;Gudrutis;BITUČIŲ;26020212688;Taip;2;3;3;8
3516;Gudrutis;BITUČIŲ;84586752341;Taip;5;0;0;5
3517;Gudrutis;BITUČIŲ;47141496535;Taip;0;2;4;6
3518;Gudrutis;BITUČIŲ;1264146375;Taip;5;5;0;10
3519;Gudrutis;BITUČIŲ;93833325038;Taip;5;1;0;6
3520;Gudrutis;BITUČIŲ;7838753258;Taip;0;1;0;1
3521;Gudrutis;BITUČIŲ;83200430763;Taip;0;6;0;6
3522;Gudrutis;BITUČIŲ;1042589663;Taip;0;7;0;7
3523;Gudrutis;BITUČIŲ;41945603137;Taip;0;4;0;4
3524;Gudrutis;BITUČIŲ;58999949883;Taip;0;5;0;5
3525;Gudrutis;BITUČIŲ;90567524206;Taip;5;0;0;5
3526;Gudrutis;BITUČIŲ;65712774270;Taip;2;0;1;3
3527;Gudrutis;BITUČIŲ;61452187923;Taip;8;0;0;8
3528;Gudrutis;BITUČIŲ;44451036504;Taip;0;4;0;4
3529;Gudrutis;BITUČIŲ;30787734143;Taip;0;0;1;1
3530;Gudrutis;BITUČIŲ;36492561410;Taip;5;2;4;11
3531;Gudrutis;Boružėlių;6747372184;Taip;0;0;2;2
3532;Gudrutis;Boružėlių;3888849808;Taip;0;15;0;15
3533;Gudrutis;Boružėlių;1190408818;Taip;0;2;9;11
3534;Gudrutis;Boružėlių;2431077357;Taip;0;3;0;3
3535;Gudrutis;Boružėlių;4193661251;Taip;0;0;2;2
3536;Gudrutis;Boružėlių;7116979528;Taip;0;0;2;2
3537;Gudrutis;Boružėlių;1991658503;Taip;0;0;1;1
3538;Gudrutis;Boružėlių;3363824185;Taip;5;0;0;5
3539;Gudrutis;Boružėlių;1936327172;Taip;7;0;0;7
3540;Gudrutis;Boružėlių;3359028602;Taip;0;0;4;4
3541;Gudrutis;Boružėlių;1693306014;Taip;0;7;0;7
3542;Gudrutis;Boružėlių;6443631536;Taip;8;0;0;8
3543;Gudrutis;Boružėlių;9797417587;Taip;0;5;0;5
3544;Gudrutis;Boružėlių;9042793284;Taip;5;0;1;6
3545;Gudrutis;Boružėlių;4945755164;Taip;0;6;4;10
3546;Gudrutis;Boružėlių;2074151024;Taip;15;0;0;15
3547;Gudrutis;Boružėlių;1445657342;Taip;0;3;1;4
3548;Gudrutis;Boružėlių;9841172472;Taip;8;2;0;10
3549;Gudrutis;Boružėlių;2865995680;Taip;0;0;1;1
3550;Gudrutis;Drugeliai;2487363252;Ne;5;0;1;6
3551;Gudrutis;Drugeliai;5580618896;Taip;0;0;4;4
3552;Gudrutis;Drugeliai;7871991275;Taip;0;0;4;4
3553;Gudrutis;Drugeliai;4612995336;Taip;11;0;0;11
3554;Gudrutis;Drugeliai;2197278086;Taip;0;0;1;1
3555;Gudrutis;Drugeliai;6530101961;Taip;15;5;0;20
3556;Gudrutis;Drugeliai;6731806925;Taip;0;5;1;6
3557;Gudrutis;Drugeliai;9701111916;Taip;13;0;0;13
3558;Gudrutis;Drugeliai;1228190677;Taip;0;0;1;1
3559;Gudrutis;Drugeliai;6198012431;Taip;0;0;3;3
3560;Gudrutis;Drugeliai;3646335609;Taip;11;2;2;15
3561;Gudrutis;Drugeliai;3625838131;Taip;0;4;0;4
3562;Gudrutis;Drugeliai;2337493193;Taip;0;1;0;1
3563;Gudrutis;Drugeliai;2764843216;Taip;3;1;0;4
3564;Gudrutis;Drugeliai;7955353991;Taip;5;1;0;6
3565;Jurginėlis;Ąžuoliukai;8217773164;Taip;3;6;0;9
3566;Jurginėlis;Ąžuoliukai;29155768493;Taip;16;0;0;16
3567;Jurginėlis;Ąžuoliukai;1591501789;Taip;0;7;0;7
3568;Jurginėlis;Ąžuoliukai;75192831969;Taip;0;4;2;6
3569;Jurginėlis;Ąžuoliukai;67578476769;Taip;0;2;0;2
3570;Jurginėlis;Ąžuoliukai;10095155757;Taip;0;11;0;11
3571;Jurginėlis;Ąžuoliukai;64641268493;Taip;0;9;0;9
3572;Jurginėlis;Ąžuoliukai;13085086595;Taip;6;1;0;7
3573;Jurginėlis;Ąžuoliukai;7798931951;Taip;0;10;0;10
3574;Jurginėlis;Ąžuoliukai;92559573466;Taip;0;3;0;3
3575;Jurginėlis;Ąžuoliukai;29601247012;Taip;0;2;0;2
3576;Jurginėlis;Ąžuoliukai;56382554421;Taip;0;13;0;13
3577;Jurginėlis;Ąžuoliukai;75958769515;Taip;0;12;0;12
3578;Jurginėlis;Ąžuoliukai;59618430487;Taip;0;6;0;6
3579;Jurginėlis;Ąžuoliukai;51856181602;Taip;9;1;0;10
3580;Jurginėlis;Ąžuoliukai;64852957209;Taip;0;6;0;6
3581;Jurginėlis;Ąžuoliukai;23049094719;Taip;0;7;0;7
3582;Jurginėlis;Ąžuoliukai;1742217696;Taip;6;2;1;9
3583;Jurginėlis;Ąžuoliukai;8423424896;Taip;0;10;0;10
3584;Jurginėlis;Ąžuoliukai;52105378503;Taip;0;3;0;3
3585;Jurginėlis;Žiogeliai;1421681717;Taip;0;0;4;4
3586;Jurginėlis;Žiogeliai;64524305038;Taip;3;11;0;14
3587;Jurginėlis;Žiogeliai;60988201430;Taip;0;1;0;1
3588;Jurginėlis;Žiogeliai;55253928424;Taip;0;1;0;1
3589;Jurginėlis;Žiogeliai;50470137888;Taip;0;2;4;6
3590;Jurginėlis;Žiogeliai;85888481045;Taip;8;3;0;11
3591;Jurginėlis;Žiogeliai;96017651718;Taip;10;7;0;17
3592;Jurginėlis;Žiogeliai;92688596347;Taip;4;13;0;17
3593;Jurginėlis;Žiogeliai;84691244839;Taip;0;8;0;8
3594;Jurginėlis;Žiogeliai;87566883270;Taip;6;4;0;10
3595;Jurginėlis;Žiogeliai;1175198086;Taip;0;11;0;11
3596;Jurginėlis;Žiogeliai;8149405217;Taip;0;1;0;1
3597;Jurginėlis;Žiogeliai;1058274970;Taip;0;2;3;5
3598;Jurginėlis;Žiogeliai;53924769958;Taip;2;0;0;2
3599;Jurginėlis;Žiogeliai;53783266582;Taip;15;0;0;15
3600;Jurginėlis;Žiogeliai;93055778306;Taip;7;7;0;14
3601;Jurginėlis;Žiogeliai;24615714793;Taip;5;7;0;12
3602;Jurginėlis;Žiogeliai;90786336005;Taip;0;0;3;3
3603;Jurginėlis;Žiogeliai;1041294212;Taip;0;17;0;17
3604;Jurginėlis;Žiogeliai;1191021311;Taip;12;1;1;14
3605;Jurginėlis;Pelėdžiukų;49181526821;Taip;10;0;0;10
3606;Jurginėlis;Pelėdžiukų;35653034443;Taip;8;0;0;8
3607;Jurginėlis;Pelėdžiukų;59935106302;Taip;0;12;0;12
3608;Jurginėlis;Pelėdžiukų;91317327949;Taip;5;1;3;9
3609;Jurginėlis;Pelėdžiukų;52877525045;Taip;10;6;0;16
3610;Jurginėlis;Pelėdžiukų;36829106143;Taip;13;0;0;13
3611;Jurginėlis;Pelėdžiukų;97726131559;Taip;11;0;0;11
3612;Jurginėlis;Pelėdžiukų;45200409204;Taip;10;0;0;10
3613;Jurginėlis;Pelėdžiukų;2544904907;Taip;20;0;0;20
3614;Jurginėlis;Pelėdžiukų;8414893303;Taip;11;0;0;11
3615;Jurginėlis;Pelėdžiukų;70733592257;Taip;11;2;0;13
3616;Jurginėlis;Pelėdžiukų;7449558199;Taip;13;0;0;13
3617;Jurginėlis;Pelėdžiukų;54494144846;Taip;15;1;0;16
3618;Jurginėlis;Pelėdžiukų;6072633581;Taip;0;13;0;13
3619;Jurginėlis;Pelėdžiukų;57340494605;Taip;8;2;3;13
3620;Jurginėlis;Pelėdžiukų;18273043496;Taip;9;0;0;9
3621;Jurginėlis;Pelėdžiukų;91909797332;Taip;9;0;0;9
3622;Jurginėlis;Pelėdžiukų;7278855565;Taip;5;0;1;6
3623;Jurginėlis;Pelėdžiukų;1295024976;Taip;8;5;3;16
3624;Jurginėlis;Pelėdžiukų;85293469079;Taip;13;0;2;15
3625;Jurginėlis;Boružėlių;63355660135;Taip;0;2;0;2
3626;Jurginėlis;Boružėlių;64840404890;Taip;0;1;0;1
3627;Jurginėlis;Boružėlių;39360122004;Taip;0;5;0;5
3628;Jurginėlis;Boružėlių;82216478040;Ne;0;8;0;8
3629;Jurginėlis;Boružėlių;86967421380;Taip;6;8;0;14
3630;Jurginėlis;Boružėlių;10360871447;Taip;0;4;0;4
3631;Jurginėlis;Boružėlių;81519067874;Taip;0;4;0;4
3632;Jurginėlis;Boružėlių;2588167364;Taip;7;0;0;7
3633;Jurginėlis;Boružėlių;88889021693;Taip;0;9;0;9
3634;Jurginėlis;Boružėlių;74738988946;Taip;8;0;0;8
3635;Jurginėlis;Boružėlių;26247261025;Taip;7;5;0;12
3636;Jurginėlis;Boružėlių;87889324886;Taip;8;0;0;8
3637;Jurginėlis;Boružėlių;12869519580;Taip;0;5;0;5
3638;Jurginėlis;Boružėlių;32999311928;Taip;5;6;0;11
3639;Jurginėlis;Boružėlių;53414286952;Taip;0;11;0;11
3640;Jurginėlis;Boružėlių;17134738202;Taip;0;6;0;6
3641;Jurginėlis;Boružėlių;38238082314;Taip;0;14;0;14
3642;Jurginėlis;Boružėlių;11327131918;Taip;4;2;0;6
3643;Jurginėlis;Boružėlių;19813742281;Taip;5;7;0;12
3644;Jurginėlis;Boružėlių;1167229378;Taip;3;5;0;8
3645;Jurginėlis;Boružėlių;96095068634;Taip;0;5;0;5
3646;Jurginėlis;Bitučių;41492483889;Taip;10;5;0;15
3647;Jurginėlis;Bitučių;47471788525;Ne;0;5;8;13
3648;Jurginėlis;Bitučių;9063688205;Ne;6;5;0;11
3649;Jurginėlis;Bitučių;3788255853;Taip;15;2;0;17
3650;Jurginėlis;Bitučių;82962903099;Taip;0;7;0;7
3651;Jurginėlis;Bitučių;32667255865;Taip;5;4;0;9
3652;Jurginėlis;Bitučių;25564914064;Taip;0;2;0;2
3653;Jurginėlis;Bitučių;20339209794;Taip;0;9;0;9
3654;Jurginėlis;Bitučių;84958379689;Taip;11;5;0;16
3655;Jurginėlis;Bitučių;86820360373;Taip;13;0;0;13
3656;Jurginėlis;Bitučių;2123535778;Taip;0;2;2;4
3657;Jurginėlis;Bitučių;50656028856;Taip;0;10;0;10
3658;Jurginėlis;Bitučių;45937957629;Taip;0;5;0;5
3659;Jurginėlis;Bitučių;10179464570;Taip;0;5;3;8
3660;Jurginėlis;Bitučių;87615798332;Taip;2;5;0;7
3661;Jurginėlis;Bitučių;56127406092;Taip;10;0;0;10
3662;Jurginėlis;Bitučių;36215389575;Taip;3;0;1;4
3663;Jurginėlis;Bitučių;14158658573;Taip;0;9;0;9
3664;Jurginėlis;Bitučių;57002585818;Taip;10;0;0;10
3665;Jurginėlis;Bitučių;1196957598;Taip;5;3;0;8
3666;Jurginėlis;Bitučių;1698001579;Taip;0;5;0;5
3667;Jurginėlis;Skruzdeliukų;92602685294;Taip;5;0;0;5
3668;Jurginėlis;Skruzdeliukų;1710682615;Taip;5;0;2;7
3669;Jurginėlis;Skruzdeliukų;1485725580;Taip;10;0;0;10
3670;Jurginėlis;Skruzdeliukų;51685299187;Ne;5;0;0;5
3671;Jurginėlis;Skruzdeliukų;1881790340;Taip;15;5;0;20
3672;Jurginėlis;Skruzdeliukų;31143311410;Taip;2;5;0;7
3673;Jurginėlis;Skruzdeliukų;94107758268;Taip;10;0;0;10
3674;Jurginėlis;Skruzdeliukų;77480957625;Taip;0;1;0;1
3675;Jurginėlis;Skruzdeliukų;1258821883;Taip;4;0;0;4
3676;Jurginėlis;Skruzdeliukų;1868080361;Taip;6;7;0;13
3677;Jurginėlis;Skruzdeliukų;38755774035;Taip;5;1;0;6
3678;Jurginėlis;Skruzdeliukų;68109772993;Taip;9;0;0;9
3679;Jurginėlis;Skruzdeliukų;81064432153;Taip;5;0;0;5
3680;Jurginėlis;Skruzdeliukų;12659496203;Taip;0;0;1;1
3681;Jurginėlis;Skruzdeliukų;1828295769;Taip;5;0;0;5
3682;Jurginėlis;Skruzdeliukų;17286700686;Ne;0;0;3;3
3683;Jurginėlis;Skruzdeliukų;1506649972;Taip;0;1;0;1
3684;Jurginėlis;Drugelių;9589394406;Taip;13;0;1;14
3685;Jurginėlis;Drugelių;47243459592;Taip;9;0;0;9
3686;Jurginėlis;Drugelių;8972814655;Taip;4;0;3;7
3687;Jurginėlis;Drugelių;8784076886;Taip;10;0;1;11
3688;Jurginėlis;Drugelių;7753784918;Taip;0;0;11;11
3689;Jurginėlis;Drugelių;1829089083;Taip;8;0;0;8
3690;Jurginėlis;Drugelių;6111863896;Taip;5;0;1;6
3691;Jurginėlis;Drugelių;8338173095;Taip;10;0;0;10
3692;Jurginėlis;Drugelių;3068120316;Taip;8;0;3;11
3693;Jurginėlis;Drugelių;1361108271;Taip;4;0;0;4
3694;Jurginėlis;Drugelių;4852619394;Taip;5;0;0;5
3695;Jurginėlis;Drugelių;1563317396;Taip;8;0;2;10
3696;Jurginėlis;Drugelių;8920304044;Taip;0;3;2;5
3697;Jurginėlis;Drugelių;1954364886;Taip;4;0;0;4
3698;Jurginėlis;Drugelių;1467200002;Taip;5;2;4;11
3699;Jurginėlis;Drugelių;1974388885;Taip;5;1;2;8
3700;Jurginėlis;Drugelių;2171115974;Taip;4;2;3;9
3701;Jurginėlis;Drugelių;3027573572;Taip;5;0;0;5
3702;Jurginėlis;Drugelių;4851923549;Taip;4;0;1;5
3703;Jurginėlis;Žibučių;4806248290;Taip;9;0;0;9
3704;Jurginėlis;Žibučių;2624313807;Taip;20;0;0;20
3705;Jurginėlis;Žibučių;2710889915;Taip;7;6;0;13
3706;Jurginėlis;Žibučių;1983924909;Taip;5;2;0;7
3707;Jurginėlis;Žibučių;1547101731;Taip;9;0;0;9
3708;Jurginėlis;Žibučių;2639125463;Taip;9;0;0;9
3709;Jurginėlis;Žibučių;2535601005;Taip;4;5;0;9
3710;Jurginėlis;Žibučių;7297672386;Taip;9;0;0;9
3711;Jurginėlis;Žibučių;5242359650;Taip;4;2;0;6
3712;Jurginėlis;Žibučių;903039398;Taip;2;2;0;4
3713;Jurginėlis;Žibučių;1175441410;Taip;10;6;0;16
3714;Jurginėlis;Žibučių;1586599624;Taip;10;0;0;10
3715;Jurginėlis;Žibučių;1343532870;Taip;8;0;0;8
3716;Jurginėlis;Žibučių;1102466152;Taip;10;4;0;14
3717;Jurginėlis;Žibučių;5892180334;Taip;1;5;0;6
3718;Jurginėlis;Žibučių;1759218238;Taip;10;1;0;11
3719;Jurginėlis;Žibučių;3708774681;Taip;10;3;0;13
3720;Jurginėlis;Žibučių;7928799065;Taip;6;0;0;6
3721;Jurginėlis;Žibučių;9646318532;Taip;10;2;0;12
3722;Jurginėlis;Žibučių;1082593212;Taip;5;0;0;5
3723;Jurginėlis;Žibučių;8144038013;Taip;10;2;0;12
3724;Jurginėlis;Žibučių;1787311340;Taip;0;3;0;3
3725;Jurginėlis;Žibučių;6413324051;Taip;10;4;0;14
3726;Jurginėlis;Zuikučių;6217229672;Taip;0;18;0;18
3727;Jurginėlis;Zuikučių;1762685527;Taip;13;1;0;14
3728;Jurginėlis;Zuikučių;1649208522;Taip;10;2;1;13
3729;Jurginėlis;Zuikučių;8084970770;Taip;14;0;0;14
3730;Jurginėlis;Zuikučių;87991288027;Taip;20;0;0;20
3731;Jurginėlis;Zuikučių;1400142372;Taip;3;0;0;3
3732;Jurginėlis;Zuikučių;1416995981;Taip;6;0;1;7
3733;Jurginėlis;Zuikučių;1656300401;Taip;7;0;0;7
3734;Jurginėlis;Zuikučių;1759031589;Taip;5;6;0;11
3735;Jurginėlis;Zuikučių;1945098580;Taip;13;2;0;15
3736;Jurginėlis;Zuikučių;1409480187;Taip;0;5;0;5
3737;Jurginėlis;Zuikučių;1780106633;Taip;3;0;0;3
3738;Jurginėlis;Zuikučių;2106937059;Taip;14;2;0;16
3739;Jurginėlis;Zuikučių;1535907893;Ne;0;16;0;16
3740;Jurginėlis;Zuikučių;8793129805;Taip;0;9;0;9
3741;Jurginėlis;Zuikučių;74303787465;Taip;0;15;0;15
3742;Jurginėlis;Zuikučių;60128913543;Taip;5;5;0;10
3743;Jurginėlis;Zuikučių;9320841905;Taip;0;10;0;10
3744;Jurginėlis;Zuikučių;7293372539;Taip;4;0;0;4
3745;Jurginėlis;Viščiukų;1656335765;Taip;0;13;0;13
3746;Jurginėlis;Viščiukų;6579565337;Taip;9;0;0;9
3747;Jurginėlis;Viščiukų;6729212950;Taip;20;0;0;20
3748;Jurginėlis;Viščiukų;4827340942;Taip;16;0;0;16
3749;Jurginėlis;Viščiukų;6806704355;Taip;11;0;1;12
3750;Jurginėlis;Viščiukų;7990015623;Taip;0;4;7;11
3751;Jurginėlis;Viščiukų;9882919290;Taip;4;0;0;4
3752;Jurginėlis;Viščiukų;2548920722;Taip;14;0;1;15
3753;Jurginėlis;Viščiukų;4536086996;Taip;11;0;4;15
3754;Jurginėlis;Viščiukų;7229961310;Taip;14;0;0;14
3755;Jurginėlis;Viščiukų;4231659246;Taip;10;10;0;20
3756;Jurginėlis;Viščiukų;3284464951;Taip;0;16;0;16
3757;Jurginėlis;Viščiukų;5921714669;Taip;10;10;0;20
3758;Jurginėlis;Viščiukų;4158502752;Taip;20;0;0;20
3759;Jurginėlis;Viščiukų;1335152703;Taip;17;0;0;17
3760;Jurginėlis;Viščiukų;4463258777;Taip;15;0;0;15
3761;Jurginėlis;Meškiukų;8443412187;Taip;15;0;2;17
3762;Jurginėlis;Meškiukų;7809274980;Taip;0;1;4;5
3763;Jurginėlis;Meškiukų;4292932046;Taip;14;0;0;14
3764;Jurginėlis;Meškiukų;2221708420;Taip;2;20;0;22
3765;Jurginėlis;Meškiukų;5984893389;Taip;0;15;0;15
3766;Jurginėlis;Meškiukų;3079495897;Taip;16;0;3;19
3767;Jurginėlis;Meškiukų;1455749921;Taip;13;9;0;22
3768;Jurginėlis;Meškiukų;9946892497;Taip;24;0;0;24
3769;Jurginėlis;Meškiukų;2417314519;Taip;7;0;3;10
3770;Jurginėlis;Meškiukų;6968528293;Taip;7;9;0;16
3771;Jurginėlis;Meškiukų;9507571301;Taip;5;1;6;12
3772;Jurginėlis;Meškiukų;8779807396;Taip;3;1;2;6
3773;Jurginėlis;Meškiukų;8161347781;Taip;15;7;0;22
3774;Jurginėlis;Meškiukų;4967548277;Taip;5;12;7;24
3775;Jurginėlis;Meškiukų;2925253653;Taip;10;0;0;10
3776;Jurginėlis;Meškiukų;1340689348;Taip;15;7;0;22
3777;Jurginėlis;Meškiukų;6181547354;Taip;15;0;6;21
3778;Jurginėlis;Meškiukų;4113264904;Taip;19;0;1;20
3779;Jurginėlis;Gandriukų;7419836868;Taip;10;0;0;10
3780;Jurginėlis;Gandriukų;51603579121;Ne;10;7;0;17
3781;Jurginėlis;Gandriukų;87444065733;Taip;10;4;0;14
3782;Jurginėlis;Gandriukų;2179884441;Taip;0;13;2;15
3783;Jurginėlis;Gandriukų;2264351097;Taip;11;3;0;14
3784;Jurginėlis;Gandriukų;78496894090;Taip;5;0;9;14
3785;Jurginėlis;Gandriukų;99523320519;Taip;15;0;0;15
3786;Jurginėlis;Gandriukų;1498351759;Taip;15;0;2;17
3787;Jurginėlis;Gandriukų;1159550277;Taip;5;5;0;10
3788;Jurginėlis;Gandriukų;75383941896;Taip;15;0;0;15
3789;Jurginėlis;Gandriukų;1508705709;Taip;0;7;0;7
3790;Jurginėlis;Gandriukų;1773100970;Taip;5;5;0;10
3791;Jurginėlis;Gandriukų;1500087367;Taip;5;5;0;10
3792;Jurginėlis;Gandriukų;43368987046;Taip;10;5;0;15
3793;Jurginėlis;Gandriukų;6707289955;Taip;16;0;0;16
3794;Jurginėlis;Gandriukų;1927843089;Taip;14;0;0;14
3795;Jurginėlis;Gandriukų;8178112926;Taip;7;1;1;9
3796;Jurginėlis;Gandriukų;6475508583;Taip;10;2;8;20
3797;Jurginėlis;Gandriukų;91517951071;Taip;5;1;0;6
3798;Jurginėlis;Gandriukų;9714764714;Taip;16;0;0;16
3799;Jurginėlis;Gandriukų;5756997642;Taip;9;1;0;10
3800;Karusėlė;PAGRANDUKAS;3660843696;Taip;15;1;0;16
3801;Karusėlė;PAGRANDUKAS;1412890120;Taip;17;0;1;18
3802;Karusėlė;PAGRANDUKAS;8967704928;Taip;10;1;1;12
3803;Karusėlė;PAGRANDUKAS;5132581245;Taip;13;0;0;13
3804;Karusėlė;PAGRANDUKAS;2160071272;Taip;0;4;0;4
3805;Karusėlė;PAGRANDUKAS;9996567374;Taip;0;9;0;9
3806;Karusėlė;PAGRANDUKAS;9462242426;Taip;6;3;0;9
3807;Karusėlė;PAGRANDUKAS;2412418335;Taip;12;5;0;17
3808;Karusėlė;PAGRANDUKAS;7393434659;Taip;7;0;0;7
3809;Karusėlė;PAGRANDUKAS;8678437720;Taip;8;3;0;11
3810;Karusėlė;PAGRANDUKAS;6826455161;Taip;0;5;2;7
3811;Karusėlė;PAGRANDUKAS;5695697634;Taip;5;5;0;10
3812;Karusėlė;PAGRANDUKAS;8127218866;Taip;5;0;0;5
3813;Karusėlė;PAGRANDUKAS;6062361348;Taip;17;0;0;17
3814;Karusėlė;PAGRANDUKAS;3620722907;Taip;10;5;0;15
3815;Karusėlė;PAGRANDUKAS;7013765804;Taip;20;0;0;20
3816;Karusėlė;NYKŠTUKAS;1560316431;Taip;7;5;0;12
3817;Karusėlė;NYKŠTUKAS;82963400142;Taip;6;0;0;6
3818;Karusėlė;NYKŠTUKAS;1567290218;Taip;0;8;0;8
3819;Karusėlė;NYKŠTUKAS;77290004668;Taip;0;1;3;4
3820;Karusėlė;NYKŠTUKAS;64652121316;Taip;15;0;0;15
3821;Karusėlė;NYKŠTUKAS;1250530261;Taip;15;0;0;15
3822;Karusėlė;NYKŠTUKAS;4568159355;Taip;20;0;0;20
3823;Karusėlė;NYKŠTUKAS;1397009220;Taip;0;11;0;11
3824;Karusėlė;NYKŠTUKAS;62938709605;Taip;5;0;0;5
3825;Karusėlė;NYKŠTUKAS;2064301292;Taip;12;0;0;12
3826;Karusėlė;NYKŠTUKAS;96150256487;Taip;0;2;0;2
3827;Karusėlė;NYKŠTUKAS;1680275369;Taip;8;5;0;13
3828;Karusėlė;NYKŠTUKAS;17728195505;Taip;13;0;0;13
3829;Karusėlė;NYKŠTUKAS;1534689679;Taip;2;2;1;5
3830;Karusėlė;NYKŠTUKAS;1226371512;Taip;5;3;3;11
3831;Karusėlė;NYKŠTUKAS;45634061915;Taip;10;5;0;15
3832;Karusėlė;NYKŠTUKAS;9377426384;Taip;3;0;0;3
3833;Karusėlė;NYKŠTUKAS;1311631554;Ne;0;2;1;3
3834;Karusėlė;NYKŠTUKAS;5481354767;Taip;15;0;0;15
3835;Karusėlė;NYKŠTUKAS;1798723081;Ne;0;1;2;3
3836;Karusėlė;NYKŠTUKAS;8419242504;Taip;8;0;2;10
3837;Karusėlė;BITUTĖ;34233236889;Taip;0;10;0;10
3838;Karusėlė;BITUTĖ;59360129103;Taip;20;0;0;20
3839;Karusėlė;BITUTĖ;73632076815;Taip;0;6;0;6
3840;Karusėlė;BITUTĖ;13709181657;Ne;0;5;0;5
3841;Karusėlė;BITUTĖ;79818913523;Taip;3;9;0;12
3842;Karusėlė;BITUTĖ;70640710377;Taip;5;1;0;6
3843;Karusėlė;BITUTĖ;49030870029;Taip;0;4;0;4
3844;Karusėlė;BITUTĖ;3136722375;Taip;0;7;0;7
3845;Karusėlė;BITUTĖ;61949196545;Ne;15;0;0;15
3846;Karusėlė;BITUTĖ;92696158075;Taip;0;5;0;5
3847;Karusėlė;BITUTĖ;53518197256;Taip;0;9;0;9
3848;Karusėlė;BITUTĖ;32652681132;Taip;0;5;0;5
3849;Karusėlė;BITUTĖ;50671265678;Taip;0;6;0;6
3850;Karusėlė;BITUTĖ;93257316270;Taip;0;2;0;2
3851;Karusėlė;BITUTĖ;5205096259;Taip;16;1;0;17
3852;Karusėlė;BITUTĖ;75225376723;Taip;0;3;0;3
3853;Karusėlė;BITUTĖ;57323585520;Taip;0;6;0;6
3854;Karusėlė;BITUTĖ;14967055322;Ne;8;6;0;14
3855;Karusėlė;BITUTĖ;2582494071;Taip;0;12;0;12
3856;Karusėlė;BITUTĖ;28039124654;Taip;0;16;0;16
3857;Karusėlė;BITUTĖ;13158075075;Taip;0;8;0;8
3858;Karusėlė;BITUTĖ;92236920191;Taip;0;5;0;5
3859;Karusėlė;BITUTĖ;8302185030;Taip;0;4;0;4
3860;Karusėlė;BITUTĖ;58784706592;Taip;5;4;0;9
3861;Karusėlė;BITUTĖ;8079425267;Taip;0;15;0;15
3862;Karusėlė;BITUTĖ;1688616471;Taip;5;5;0;10
3863;Karusėlė;BITUTĖ;85881177597;Taip;5;7;0;12
3864;Karusėlė;BORUŽĖLĖ;1705790474;Taip;0;7;0;7
3865;Karusėlė;BORUŽĖLĖ;8608177987;Taip;10;0;0;10
3866;Karusėlė;BORUŽĖLĖ;4890393582;Taip;5;2;3;10
3867;Karusėlė;BORUŽĖLĖ;1311907441;Taip;11;0;0;11
3868;Karusėlė;BORUŽĖLĖ;1593728369;Taip;6;3;0;9
3869;Karusėlė;BORUŽĖLĖ;6313010762;Taip;0;5;0;5
3870;Karusėlė;BORUŽĖLĖ;5859827168;Taip;10;0;0;10
3871;Karusėlė;BORUŽĖLĖ;37349219339;Taip;2;1;0;3
3872;Karusėlė;BORUŽĖLĖ;49110267692;Taip;7;1;0;8
3873;Karusėlė;BORUŽĖLĖ;1809033214;Taip;0;6;1;7
3874;Karusėlė;BORUŽĖLĖ;9065247151;Taip;0;5;13;18
3875;Karusėlė;BORUŽĖLĖ;6811862463;Taip;5;7;0;12
3876;Karusėlė;BORUŽĖLĖ;5471989295;Taip;5;1;0;6
3877;Karusėlė;BORUŽĖLĖ;9753876554;Taip;11;3;0;14
3878;Karusėlė;BORUŽĖLĖ;1204919995;Taip;20;0;0;20
3879;Karusėlė;BORUŽĖLĖ;8717484092;Taip;17;0;0;17
3880;Karusėlė;BORUŽĖLĖ;5351690991;Taip;1;0;0;1
3881;Karusėlė;BORUŽĖLĖ;7969250635;Taip;7;0;0;7
3882;Karusėlė;BORUŽĖLĖ;1994682683;Taip;5;13;0;18
3883;Karusėlė;BORUŽĖLĖ;5632697184;Taip;5;1;0;6
3884;Karusėlė;UOGELĖ;3053539045;Taip;0;5;4;9
3885;Karusėlė;UOGELĖ;9992989896;Taip;0;3;3;6
3886;Karusėlė;UOGELĖ;2084276906;Taip;15;5;0;20
3887;Karusėlė;UOGELĖ;1098106063;Taip;0;1;0;1
3888;Karusėlė;UOGELĖ;8665314366;Taip;5;7;0;12
3889;Karusėlė;UOGELĖ;5651238035;Taip;0;1;0;1
3890;Karusėlė;UOGELĖ;4121668687;Taip;10;2;0;12
3891;Karusėlė;UOGELĖ;8316147204;Taip;5;10;0;15
3892;Karusėlė;UOGELĖ;5504719953;Taip;0;15;0;15
3893;Karusėlė;UOGELĖ;5919009583;Taip;11;7;0;18
3894;Karusėlė;UOGELĖ;4199597984;Taip;2;7;0;9
3895;Karusėlė;UOGELĖ;2383023280;Taip;8;5;0;13
3896;Karusėlė;UOGELĖ;1575408822;Taip;15;5;0;20
3897;Karusėlė;UOGELĖ;7908136147;Taip;0;5;0;5
3898;Karusėlė;UOGELĖ;3917113787;Taip;11;0;0;11
3899;Karusėlė;UOGELĖ;6221257045;Taip;0;8;0;8
3900;Karusėlė;UOGELĖ;4068106379;Taip;5;5;2;12
3901;Karusėlė;UOGELĖ;1428516421;Taip;0;5;6;11
3902;Karusėlė;UOGELĖ;4638918427;Taip;6;1;1;8
3903;Karusėlė;UOGELĖ;3615957761;Taip;0;15;0;15
3904;Karusėlė;UOGELĖ;3514026443;Taip;6;0;0;6
3905;Karusėlė;GINTARĖLIS;75574841532;Taip;15;5;0;20
3906;Karusėlė;GINTARĖLIS;89669425763;Taip;5;0;0;5
3907;Karusėlė;GINTARĖLIS;1058129883;Taip;5;5;0;10
3908;Karusėlė;GINTARĖLIS;1625704473;Taip;0;10;0;10
3909;Karusėlė;GINTARĖLIS;5267055924;Taip;11;1;0;12
3910;Karusėlė;GINTARĖLIS;17254955427;Taip;0;6;0;6
3911;Karusėlė;GINTARĖLIS;1467237683;Taip;0;1;0;1
3912;Karusėlė;GINTARĖLIS;33935704865;Taip;5;7;0;12
3913;Karusėlė;GINTARĖLIS;92286460424;Taip;19;0;0;19
3914;Karusėlė;GINTARĖLIS;80377577910;Taip;16;3;0;19
3915;Karusėlė;GINTARĖLIS;7794899167;Taip;3;9;0;12
3916;Karusėlė;GINTARĖLIS;1302846796;Taip;17;1;0;18
3917;Karusėlė;GINTARĖLIS;6181109173;Taip;12;5;0;17
3918;Karusėlė;GINTARĖLIS;65387251381;Taip;9;0;0;9
3919;Karusėlė;GINTARĖLIS;90635580825;Taip;2;8;0;10
3920;Karusėlė;GINTARĖLIS;93635113154;Taip;5;5;0;10
3921;Karusėlė;GINTARĖLIS;2386140324;Taip;15;1;0;16
3922;Karusėlė;GINTARĖLIS;90731574209;Taip;4;3;0;7
3923;Karusėlė;GINTARĖLIS;77007130834;Taip;6;0;0;6
3924;Karusėlė;GINTARĖLIS;1248828581;Taip;6;2;0;8
3925;Karusėlė;GINTARĖLIS;6596029324;Taip;10;0;0;10
3926;Karusėlė;GINTARĖLIS;1477282992;Taip;5;1;0;6
3927;Karusėlė;GINTARĖLIS;1487641646;Taip;0;5;0;5
3928;Karusėlė;SAULUTĖ;1705251019;Taip;3;6;0;9
3929;Karusėlė;SAULUTĖ;64855471225;Taip;0;6;0;6
3930;Karusėlė;SAULUTĖ;45701480267;Taip;0;6;0;6
3931;Karusėlė;SAULUTĖ;35910852843;Taip;5;2;1;8
3932;Karusėlė;SAULUTĖ;1198992954;Taip;10;0;0;10
3933;Karusėlė;SAULUTĖ;1223992311;Taip;0;7;0;7
3934;Karusėlė;SAULUTĖ;6702329224;Taip;20;0;0;20
3935;Karusėlė;SAULUTĖ;1239411995;Taip;12;0;0;12
3936;Karusėlė;SAULUTĖ;4806666157;Taip;0;1;0;1
3937;Karusėlė;SAULUTĖ;10539595272;Taip;5;1;0;6
3938;Karusėlė;SAULUTĖ;52452661421;Taip;7;5;0;12
3939;Karusėlė;SAULUTĖ;54723578928;Taip;0;1;0;1
3940;Karusėlė;SAULUTĖ;2606829789;Ne;0;1;0;1
3941;Karusėlė;SAULUTĖ;91676265927;Taip;0;7;0;7
3942;Karusėlė;SAULUTĖ;39088931809;Taip;10;4;0;14
3943;Karusėlė;SAULUTĖ;63044693440;Taip;0;1;0;1
3944;Karusėlė;SAULUTĖ;23662916408;Taip;0;13;0;13
3945;Karusėlė;SAULUTĖ;99462674291;Taip;0;3;1;4
3946;Karusėlė;SAULUTĖ;59790578013;Taip;0;6;0;6
3947;Karusėlė;SAULUTĖ;1279503209;Taip;4;0;0;4
3948;Karusėlė;SAULUTĖ;2025180617;Taip;0;4;0;4
3949;Karusėlė;SAULUTĖ;7977835762;Taip;0;6;0;6
3950;Karusėlė;SAULUTĖ;1273810363;Taip;0;1;0;1
3951;Karusėlė;SAULUTĖ;25328680614;Taip;5;2;0;7
3952;Karusėlė;SAULUTĖ;2038274137;Taip;3;2;0;5
3953;Karusėlė;TIGRIUKAS;1277422207;Taip;5;13;0;18
3954;Karusėlė;TIGRIUKAS;1982126099;Taip;20;0;0;20
3955;Karusėlė;TIGRIUKAS;1799128848;Taip;3;1;0;4
3956;Karusėlė;TIGRIUKAS;1292576152;Taip;20;0;0;20
3957;Karusėlė;TIGRIUKAS;95430039864;Taip;0;7;0;7
3958;Karusėlė;TIGRIUKAS;68279619421;Taip;6;6;0;12
3959;Karusėlė;TIGRIUKAS;86870088150;Taip;10;5;0;15
3960;Karusėlė;TIGRIUKAS;25581881402;Taip;0;9;0;9
3961;Karusėlė;TIGRIUKAS;60785707116;Taip;0;10;0;10
3962;Karusėlė;TIGRIUKAS;18831943978;Taip;0;5;0;5
3963;Karusėlė;TIGRIUKAS;1253277950;Taip;10;0;0;10
3964;Karusėlė;TIGRIUKAS;19906965254;Taip;3;4;0;7
3965;Karusėlė;TIGRIUKAS;1817869518;Taip;12;1;0;13
3966;Karusėlė;TIGRIUKAS;1193711193;Taip;0;9;0;9
3967;Karusėlė;TIGRIUKAS;1773362652;Taip;0;5;0;5
3968;Karusėlė;TIGRIUKAS;3752570475;Taip;5;5;0;10
3969;Karusėlė;TIGRIUKAS;1305485683;Taip;9;2;0;11
3970;Karusėlė;TIGRIUKAS;8881750322;Taip;3;1;0;4
3971;Karusėlė;TIGRIUKAS;8946147763;Taip;9;0;0;9
3972;Karusėlė;TIGRIUKAS;4426462711;Taip;6;0;0;6
3973;Karusėlė;TIGRIUKAS;3960354989;Taip;5;5;0;10
3974;Karusėlė;TIGRIUKAS;1947403400;Taip;0;5;0;5
3975;Karusėlė;TIGRIUKAS;2036366726;Taip;3;1;0;4
3976;Karusėlė;VAIVORYKŠTĖ;1653601923;Taip;7;5;0;12
3977;Karusėlė;VAIVORYKŠTĖ;27840592998;Taip;10;7;0;17
3978;Karusėlė;VAIVORYKŠTĖ;1979913722;Taip;0;6;0;6
3979;Karusėlė;VAIVORYKŠTĖ;89727334417;Taip;16;2;0;18
3980;Karusėlė;VAIVORYKŠTĖ;88371238657;Taip;10;1;0;11
3981;Karusėlė;VAIVORYKŠTĖ;1629901230;Taip;0;2;0;2
3982;Karusėlė;VAIVORYKŠTĖ;2092642601;Taip;10;3;0;13
3983;Karusėlė;VAIVORYKŠTĖ;2083974132;Taip;15;0;0;15
3984;Karusėlė;VAIVORYKŠTĖ;1097025436;Taip;4;1;0;5
3985;Karusėlė;VAIVORYKŠTĖ;1945164524;Taip;0;9;0;9
3986;Karusėlė;VAIVORYKŠTĖ;1886562437;Taip;6;2;0;8
3987;Karusėlė;VAIVORYKŠTĖ;1915396083;Taip;0;6;0;6
3988;Karusėlė;VAIVORYKŠTĖ;1094853107;Taip;0;12;0;12
3989;Karusėlė;VAIVORYKŠTĖ;40499469616;Taip;15;0;0;15
3990;Karusėlė;VAIVORYKŠTĖ;26373120499;Taip;9;1;0;10
3991;Karusėlė;VAIVORYKŠTĖ;78971949838;Taip;20;0;0;20
3992;Karusėlė;VAIVORYKŠTĖ;25859211954;Taip;12;1;0;13
3993;Karusėlė;VAIVORYKŠTĖ;47751458940;Taip;15;0;0;15
3994;Karusėlė;VAIVORYKŠTĖ;68537797465;Taip;0;6;0;6
3995;Karusėlė;VAIVORYKŠTĖ;50904986408;Taip;1;0;0;1
3996;Karusėlė;VAIVORYKŠTĖ;11336671763;Taip;6;5;0;11
3997;Karusėlė;VAIVORYKŠTĖ;9482894921;Taip;10;6;0;16
3998;Karusėlė;"AUKSINĖ ŽUVELĖ";77212719456;Taip;0;4;0;4
3999;Karusėlė;"AUKSINĖ ŽUVELĖ";1414085818;Taip;0;10;0;10
4000;Karusėlė;"AUKSINĖ ŽUVELĖ";4888730297;Taip;0;4;0;4
4001;Karusėlė;"AUKSINĖ ŽUVELĖ";1048086957;Taip;10;5;0;15
4002;Karusėlė;"AUKSINĖ ŽUVELĖ";1709733062;Taip;20;0;0;20
4003;Karusėlė;"AUKSINĖ ŽUVELĖ";26710882757;Taip;0;9;0;9
4004;Karusėlė;"AUKSINĖ ŽUVELĖ";47542882134;Taip;2;5;0;7
4005;Karusėlė;"AUKSINĖ ŽUVELĖ";6580115367;Taip;0;4;0;4
4006;Karusėlė;"AUKSINĖ ŽUVELĖ";27958836709;Taip;5;3;0;8
4007;Karusėlė;"AUKSINĖ ŽUVELĖ";76108591835;Taip;3;0;0;3
4008;Karusėlė;"AUKSINĖ ŽUVELĖ";30839035183;Taip;0;2;0;2
4009;Karusėlė;"AUKSINĖ ŽUVELĖ";23369021638;Taip;6;5;0;11
4010;Karusėlė;"AUKSINĖ ŽUVELĖ";2216383015;Taip;0;6;0;6
4011;Karusėlė;"AUKSINĖ ŽUVELĖ";58031363722;Taip;0;2;0;2
4012;Karusėlė;"AUKSINĖ ŽUVELĖ";41390857064;Taip;10;1;0;11
4013;Karusėlė;"AUKSINĖ ŽUVELĖ";1462103488;Taip;9;0;0;9
4014;Karusėlė;"AUKSINĖ ŽUVELĖ";2038901113;Taip;0;5;0;5
4015;Karusėlė;"AUKSINĖ ŽUVELĖ";1948979039;Taip;3;2;0;5
4016;Karusėlė;"AUKSINĖ ŽUVELĖ";6737041892;Taip;0;10;4;14
4017;Karusėlė;"AUKSINĖ ŽUVELĖ";1982350605;Taip;0;7;0;7
4018;Karusėlė;"AUKSINĖ ŽUVELĖ";4878805177;Taip;0;2;0;2
4019;Karusėlė;RAMUNĖ;5951045233;Taip;7;7;0;14
4020;Karusėlė;RAMUNĖ;9868386182;Taip;13;0;0;13
4021;Karusėlė;RAMUNĖ;2215367063;Taip;20;0;0;20
4022;Karusėlė;RAMUNĖ;6495631086;Taip;2;11;0;13
4023;Karusėlė;RAMUNĖ;1698478530;Taip;13;0;0;13
4024;Karusėlė;RAMUNĖ;5146709341;Taip;12;0;0;12
4025;Karusėlė;RAMUNĖ;8331985564;Taip;19;0;0;19
4026;Karusėlė;RAMUNĖ;5803808409;Taip;0;13;0;13
4027;Karusėlė;RAMUNĖ;5855430678;Taip;2;1;0;3
4028;Karusėlė;RAMUNĖ;9400171357;Taip;0;20;0;20
4029;Karusėlė;RAMUNĖ;5766390337;Taip;10;3;0;13
4030;Karusėlė;RAMUNĖ;8987444198;Taip;0;1;0;1
4031;Karusėlė;RAMUNĖ;6413701823;Taip;8;1;0;9
4032;Karusėlė;RAMUNĖ;2007411601;Taip;12;5;0;17
4033;Kaštonas;NYKŠTUKAI;41926955433;Taip;0;8;0;8
4034;Kaštonas;NYKŠTUKAI;81834426663;Taip;19;0;0;19
4035;Kaštonas;NYKŠTUKAI;7481170301;Taip;0;3;0;3
4036;Kaštonas;NYKŠTUKAI;1626798162;Taip;7;11;0;18
4037;Kaštonas;NYKŠTUKAI;46191613797;Taip;0;14;0;14
4038;Kaštonas;NYKŠTUKAI;76576870173;Taip;16;0;0;16
4039;Kaštonas;NYKŠTUKAI;1313119270;Taip;0;1;0;1
4040;Kaštonas;NYKŠTUKAI;1152555202;Taip;5;0;0;5
4041;Kaštonas;NYKŠTUKAI;1023364928;Taip;0;1;0;1
4042;Kaštonas;NYKŠTUKAI;1186956315;Taip;0;4;0;4
4043;Kaštonas;NYKŠTUKAI;1931800904;Taip;0;8;0;8
4044;Kaštonas;NYKŠTUKAI;1781481896;Taip;0;2;0;2
4045;Kaštonas;NYKŠTUKAI;6701145026;Taip;6;0;0;6
4046;Kaštonas;NYKŠTUKAI;9287426151;Taip;0;3;0;3
4047;Kaštonas;NYKŠTUKAI;55052021468;Taip;0;8;0;8
4048;Kaštonas;NYKŠTUKAI;6560054869;Taip;0;16;0;16
4049;Kaštonas;NYKŠTUKAI;9168456496;Taip;3;0;0;3
4050;Kaštonas;NYKŠTUKAI;3059036526;Taip;0;9;0;9
4051;Kaštonas;NYKŠTUKAI;8990194475;Taip;3;8;0;11
4052;Kaštonas;NYKŠTUKAI;9702914628;Taip;5;8;0;13
4053;Kaštonas;NYKŠTUKAI;41221846403;Taip;10;0;0;10
4054;Kaštonas;NYKŠTUKAI;3773227028;Taip;12;0;0;12
4055;Kaštonas;DRUGELIAI;1547554662;Taip;0;5;0;5
4056;Kaštonas;DRUGELIAI;25534865569;Ne;0;1;0;1
4057;Kaštonas;DRUGELIAI;91745369760;Ne;0;6;0;6
4058;Kaštonas;DRUGELIAI;78786250725;Taip;0;6;0;6
4059;Kaštonas;DRUGELIAI;7641793210;Taip;10;6;0;16
4060;Kaštonas;DRUGELIAI;46419017842;Taip;0;2;0;2
4061;Kaštonas;DRUGELIAI;59413506728;Taip;3;5;0;8
4062;Kaštonas;DRUGELIAI;1641976468;Ne;11;5;0;16
4063;Kaštonas;DRUGELIAI;2825343274;Taip;0;3;0;3
4064;Kaštonas;DRUGELIAI;54580238237;Taip;0;10;0;10
4065;Kaštonas;DRUGELIAI;8748600333;Taip;10;3;0;13
4066;Kaštonas;DRUGELIAI;87941682538;Taip;0;2;0;2
4067;Kaštonas;DRUGELIAI;1364683665;Taip;8;0;0;8
4068;Kaštonas;DRUGELIAI;75540345287;Taip;0;8;0;8
4069;Kaštonas;DRUGELIAI;23319023639;Taip;0;10;0;10
4070;Kaštonas;DRUGELIAI;52064859848;Taip;0;1;0;1
4071;Kaštonas;DRUGELIAI;16395082273;Taip;0;7;0;7
4072;Kaštonas;DRUGELIAI;2120469277;Taip;3;5;0;8
4073;Kaštonas;DRUGELIAI;61557505110;Taip;5;1;0;6
4074;Kaštonas;DRUGELIAI;47802818774;Taip;0;3;0;3
4075;Kaštonas;KIŠKUČIAI;1859126564;Taip;0;18;0;18
4076;Kaštonas;KIŠKUČIAI;57362664278;Taip;5;5;0;10
4077;Kaštonas;KIŠKUČIAI;4449017708;Ne;0;7;0;7
4078;Kaštonas;KIŠKUČIAI;2539596633;Taip;0;7;0;7
4079;Kaštonas;KIŠKUČIAI;3638565578;Taip;0;12;0;12
4080;Kaštonas;KIŠKUČIAI;5153948802;Taip;4;8;0;12
4081;Kaštonas;KIŠKUČIAI;4956177048;Taip;15;0;0;15
4082;Kaštonas;KIŠKUČIAI;2165890763;Taip;0;13;0;13
4083;Kaštonas;KIŠKUČIAI;5610113641;Taip;0;12;0;12
4084;Kaštonas;KIŠKUČIAI;2417951642;Taip;7;3;0;10
4085;Kaštonas;KIŠKUČIAI;2797443202;Taip;5;9;0;14
4086;Kaštonas;KIŠKUČIAI;7776071299;Taip;13;0;0;13
4087;Kaštonas;KIŠKUČIAI;3039980710;Taip;0;16;0;16
4088;Kaštonas;KIŠKUČIAI;3507672150;Taip;12;0;0;12
4089;Kaštonas;KIŠKUČIAI;3131712783;Taip;15;2;0;17
4090;Kaštonas;KIŠKUČIAI;1747580231;Ne;2;6;0;8
4091;Kaštonas;KIŠKUČIAI;1826015013;Taip;6;2;0;8
4092;Kaštonas;KIŠKUČIAI;7553024183;Taip;0;16;0;16
4093;Kaštonas;KIŠKUČIAI;5630659056;Taip;10;5;0;15
4094;Kaštonas;KIŠKUČIAI;8151333699;Taip;16;0;0;16
4095;Kaštonas;KIŠKUČIAI;2007064959;Taip;0;16;0;16
4096;Kaštonas;KIŠKUČIAI;7841179083;Taip;0;20;0;20
4097;Kaštonas;KIŠKUČIAI;3649329598;Taip;0;15;0;15
4098;Kaštonas;KIŠKUČIAI;8906976150;Taip;12;5;0;17
4099;Kaštonas;KIŠKUČIAI;7508357392;Taip;10;0;0;10
4100;Kaštonas;BITUTĖS;8377601628;Ne;0;7;0;7
4101;Kaštonas;BITUTĖS;2062489205;Taip;14;0;0;14
4102;Kaštonas;BITUTĖS;78535860714;Taip;0;10;0;10
4103;Kaštonas;BITUTĖS;2146285017;Taip;0;12;0;12
4104;Kaštonas;BITUTĖS;98526928421;Taip;4;11;0;15
4105;Kaštonas;BITUTĖS;52212151760;Taip;5;0;0;5
4106;Kaštonas;BITUTĖS;1292350264;Taip;0;11;0;11
4107;Kaštonas;BITUTĖS;3967999408;Taip;0;7;0;7
4108;Kaštonas;BITUTĖS;39974835155;Taip;0;1;0;1
4109;Kaštonas;BITUTĖS;1380861719;Taip;0;2;0;2
4110;Kaštonas;BITUTĖS;18542160352;Taip;10;6;0;16
4111;Kaštonas;BITUTĖS;1162926887;Taip;0;10;0;10
4112;Kaštonas;BITUTĖS;1459614385;Taip;20;0;0;20
4113;Kaštonas;BITUTĖS;9167719015;Taip;15;0;0;15
4114;Kaštonas;BITUTĖS;4250816034;Taip;0;10;0;10
4115;Kaštonas;BITUTĖS;2801321116;Taip;0;6;0;6
4116;Kaštonas;BITUTĖS;9967553882;Taip;0;13;0;13
4117;Kaštonas;BITUTĖS;27082059521;Taip;0;8;0;8
4118;Kaštonas;BITUTĖS;1465714333;Taip;0;5;0;5
4119;Kaštonas;BITUTĖS;1252815477;Taip;0;13;0;13
4120;Kaštonas;BITUTĖS;7557437205;Taip;0;4;0;4
4121;Kaštonas;BITUTĖS;92533370070;Taip;13;0;0;13
4122;Kaštonas;BITUTĖS;9215070593;Taip;0;15;0;15
4123;Kaštonas;BITUTĖS;2396379813;Ne;3;0;0;3
4124;Kaštonas;BITUTĖS;2504312724;Taip;0;5;0;5
4125;Kaštonas;MEŠKIUKAI;13105582649;Taip;0;17;0;17
4126;Kaštonas;MEŠKIUKAI;1420929477;Taip;10;5;0;15
4127;Kaštonas;MEŠKIUKAI;2764004779;Taip;5;4;0;9
4128;Kaštonas;MEŠKIUKAI;12354635231;Taip;6;0;0;6
4129;Kaštonas;MEŠKIUKAI;94748215851;Taip;15;5;0;20
4130;Kaštonas;MEŠKIUKAI;66717201099;Taip;10;5;0;15
4131;Kaštonas;MEŠKIUKAI;12358360731;Taip;10;4;0;14
4132;Kaštonas;MEŠKIUKAI;97106889191;Taip;10;8;0;18
4133;Kaštonas;MEŠKIUKAI;8042807487;Taip;0;17;0;17
4134;Kaštonas;MEŠKIUKAI;2711819539;Taip;5;10;0;15
4135;Kaštonas;MEŠKIUKAI;1294879767;Taip;5;11;0;16
4136;Kaštonas;MEŠKIUKAI;1367704050;Taip;0;15;0;15
4137;Kaštonas;MEŠKIUKAI;5722934228;Taip;8;6;0;14
4138;Kaštonas;MEŠKIUKAI;89221382880;Taip;8;5;0;13
4139;Kaštonas;MEŠKIUKAI;65960895249;Taip;14;0;0;14
4140;Kaštonas;MEŠKIUKAI;69883785412;Taip;0;8;0;8
4141;Kaštonas;MEŠKIUKAI;1049699735;Taip;9;4;0;13
4142;Kaštonas;MEŠKIUKAI;1385352925;Taip;10;3;0;13
4143;Kaštonas;MEŠKIUKAI;5557487532;Taip;11;5;0;16
4144;Kaštonas;MEŠKIUKAI;3863015751;Ne;6;0;0;6
4145;Kaštonas;MEŠKIUKAI;2760501432;Ne;3;16;0;19
4146;Kaštonas;MEŠKIUKAI;70838449788;Ne;5;7;0;12
4147;Kaštonas;MEŠKIUKAI;1196590128;Taip;6;6;0;12
4148;Kaštonas;BORUŽĖLĖS;5099098185;Taip;10;0;0;10
4149;Kaštonas;BORUŽĖLĖS;6967725663;Taip;0;17;0;17
4150;Kaštonas;BORUŽĖLĖS;5478395437;Taip;5;4;0;9
4151;Kaštonas;BORUŽĖLĖS;6606094891;Taip;0;17;0;17
4152;Kaštonas;BORUŽĖLĖS;1364391105;Taip;0;17;0;17
4153;Kaštonas;BORUŽĖLĖS;2125410714;Taip;9;3;0;12
4154;Kaštonas;BORUŽĖLĖS;7956422880;Taip;0;20;0;20
4155;Kaštonas;BORUŽĖLĖS;8564586014;Taip;5;5;0;10
4156;Kaštonas;BORUŽĖLĖS;5328263421;Taip;7;4;0;11
4157;Kaštonas;BORUŽĖLĖS;4033866425;Taip;15;0;0;15
4158;Kaštonas;BORUŽĖLĖS;3961661158;Taip;0;20;0;20
4159;Kaštonas;BORUŽĖLĖS;6251564828;Taip;0;20;0;20
4160;Kaštonas;BORUŽĖLĖS;7291448857;Taip;10;5;0;15
4161;Kaštonas;BORUŽĖLĖS;3105500733;Taip;13;0;0;13
4162;Kaštonas;BORUŽĖLĖS;6175014441;Taip;0;16;0;16
4163;Kaštonas;BORUŽĖLĖS;4450146424;Taip;15;0;0;15
4164;Kaštonas;BORUŽĖLĖS;5548875714;Taip;10;5;0;15
4165;Kaštonas;BORUŽĖLĖS;3333990952;Taip;10;5;0;15
4166;Kaštonas;BORUŽĖLĖS;8166925991;Taip;18;0;0;18
4167;Krivūlė;SPINDULIUKAI;59978148537;Taip;5;3;1;9
4168;Krivūlė;SPINDULIUKAI;55356606791;Taip;2;0;0;2
4169;Krivūlė;SPINDULIUKAI;10728010124;Taip;3;0;0;3
4170;Krivūlė;SPINDULIUKAI;88714209343;Taip;0;1;13;14
4171;Krivūlė;SPINDULIUKAI;50715118246;Taip;0;6;1;7
4172;Krivūlė;SPINDULIUKAI;88645409146;Taip;0;0;1;1
4173;Krivūlė;SPINDULIUKAI;43180342657;Taip;8;0;0;8
4174;Krivūlė;SPINDULIUKAI;78895964424;Taip;0;5;2;7
4175;Krivūlė;SPINDULIUKAI;9864428506;Taip;0;5;0;5
4176;Krivūlė;SPINDULIUKAI;58431942;Taip;0;5;0;5
4177;Krivūlė;SPINDULIUKAI;48514609257;Taip;4;1;0;5
4178;Krivūlė;SPINDULIUKAI;49698343392;Taip;4;0;0;4
4179;Krivūlė;SPINDULIUKAI;3157698386;Taip;0;6;5;11
4180;Krivūlė;SPINDULIUKAI;91823213506;Taip;10;0;10;20
4181;Krivūlė;SPINDULIUKAI;26046598666;Taip;9;5;0;14
4182;Krivūlė;SPINDULIUKAI;52632731467;Taip;0;5;2;7
4183;Krivūlė;SPINDULIUKAI;1443815293;Taip;0;5;0;5
4184;Krivūlė;SPINDULIUKAI;1980001276;Taip;0;13;0;13
4185;Krivūlė;SPINDULIUKAI;14824959974;Taip;0;4;1;5
4186;Krivūlė;BORUŽĖLĖS;4969782237;Taip;0;1;0;1
4187;Krivūlė;BORUŽĖLĖS;4845515196;Taip;8;0;0;8
4188;Krivūlė;BORUŽĖLĖS;5676562063;Taip;5;0;5;10
4189;Krivūlė;BORUŽĖLĖS;6935969502;Taip;5;0;5;10
4190;Krivūlė;BORUŽĖLĖS;4972360440;Taip;10;0;0;10
4191;Krivūlė;BORUŽĖLĖS;7318064702;Taip;5;8;0;13
4192;Krivūlė;BORUŽĖLĖS;3912620138;Taip;7;0;0;7
4193;Krivūlė;BORUŽĖLĖS;3246787504;Taip;10;0;6;16
4194;Krivūlė;BORUŽĖLĖS;5531566792;Taip;0;0;2;2
4195;Krivūlė;BORUŽĖLĖS;2386053480;Taip;0;0;1;1
4196;Krivūlė;BORUŽĖLĖS;8586287004;Taip;0;0;5;5
4197;Krivūlė;BORUŽĖLĖS;4540069843;Taip;10;0;1;11
4198;Krivūlė;BORUŽĖLĖS;4297876008;Taip;0;15;0;15
4199;Krivūlė;BORUŽĖLĖS;2138125571;Taip;0;3;2;5
4200;Krivūlė;BORUŽĖLĖS;4257468922;Taip;10;3;0;13
4201;Krivūlė;BORUŽĖLĖS;4177660973;Taip;4;1;0;5
4202;Krivūlė;BORUŽĖLĖS;2517785727;Taip;5;0;1;6
4203;Krivūlė;BORUŽĖLĖS;4025821636;Taip;20;0;0;20
4204;Krivūlė;DRUGELIŲ;23648162135;Taip;3;0;1;4
4205;Krivūlė;DRUGELIŲ;1061891147;Taip;0;5;13;18
4206;Krivūlė;DRUGELIŲ;61141298766;Taip;0;5;1;6
4207;Krivūlė;DRUGELIŲ;3203271448;Taip;0;5;3;8
4208;Krivūlė;DRUGELIŲ;56163922565;Taip;7;5;0;12
4209;Krivūlė;DRUGELIŲ;29375281615;Taip;0;5;0;5
4210;Krivūlė;DRUGELIŲ;29880105166;Taip;0;5;1;6
4211;Krivūlė;DRUGELIŲ;10583191450;Taip;9;0;0;9
4212;Krivūlė;DRUGELIŲ;13434120023;Taip;2;17;0;19
4213;Krivūlė;DRUGELIŲ;5825154729;Taip;0;0;1;1
4214;Krivūlė;DRUGELIŲ;54700834388;Taip;9;5;0;14
4215;Krivūlė;DRUGELIŲ;1465116151;Taip;0;5;4;9
4216;Krivūlė;DRUGELIŲ;1091759903;Taip;0;4;6;10
4217;Krivūlė;DRUGELIŲ;21718245739;Taip;0;0;4;4
4218;Krivūlė;DRUGELIŲ;97176703854;Taip;5;0;0;5
4219;Krivūlė;"BITUTĖS (VALDOFRO)";4205061357;Taip;0;4;0;4
4220;Krivūlė;"BITUTĖS (VALDOFRO)";73736799724;Taip;0;14;0;14
4221;Krivūlė;"BITUTĖS (VALDOFRO)";60958909807;Taip;6;5;0;11
4222;Krivūlė;"BITUTĖS (VALDOFRO)";66552145067;Taip;0;5;1;6
4223;Krivūlė;"BITUTĖS (VALDOFRO)";66555601736;Taip;5;0;3;8
4224;Krivūlė;"BITUTĖS (VALDOFRO)";99074500749;Taip;5;0;3;8
4225;Krivūlė;"BITUTĖS (VALDOFRO)";46337826378;Taip;6;4;0;10
4226;Krivūlė;"BITUTĖS (VALDOFRO)";98620856056;Taip;4;0;0;4
4227;Krivūlė;"BITUTĖS (VALDOFRO)";1588621536;Taip;0;4;1;5
4228;Krivūlė;"BITUTĖS (VALDOFRO)";97075230746;Taip;0;5;1;6
4229;Krivūlė;"BITUTĖS (VALDOFRO)";97859012083;Taip;5;5;0;10
4230;Krivūlė;"BITUTĖS (VALDOFRO)";37704437957;Taip;0;0;2;2
4231;Krivūlė;"BITUTĖS (VALDOFRO)";2425023811;Taip;9;0;0;9
4232;Krivūlė;"BITUTĖS (VALDOFRO)";4838666934;Taip;3;2;0;5
4233;Krivūlė;"BITUTĖS (VALDOFRO)";3994278221;Taip;5;2;0;7
4234;Krivūlė;"BITUTĖS (VALDOFRO)";3868507751;Taip;3;2;0;5
4235;Krivūlė;"BITUTĖS (VALDOFRO)";18486357195;Taip;5;1;0;6
4236;Krivūlė;"BITUTĖS (VALDOFRO)";7789248863;Taip;0;0;1;1
4237;Krivūlė;EŽIUKAI;80991786508;Taip;3;2;0;5
4238;Krivūlė;EŽIUKAI;2099607493;Taip;15;0;2;17
4239;Krivūlė;EŽIUKAI;1290759541;Taip;10;5;2;17
4240;Krivūlė;EŽIUKAI;28308524979;Taip;9;5;0;14
4241;Krivūlė;EŽIUKAI;1699961817;Taip;0;5;4;9
4242;Krivūlė;EŽIUKAI;96319752378;Taip;10;0;1;11
4243;Krivūlė;EŽIUKAI;66981981114;Taip;0;0;2;2
4244;Krivūlė;EŽIUKAI;50967415904;Taip;0;5;9;14
4245;Krivūlė;EŽIUKAI;1113101710;Taip;0;4;0;4
4246;Krivūlė;EŽIUKAI;8463621294;Taip;5;0;0;5
4247;Krivūlė;EŽIUKAI;86659723162;Taip;0;0;2;2
4248;Krivūlė;EŽIUKAI;2125078552;Taip;0;5;0;5
4249;Krivūlė;EŽIUKAI;81401012140;Taip;6;0;5;11
4250;Krivūlė;NYKŠTUKAI;37502093836;Taip;0;9;7;16
4251;Krivūlė;NYKŠTUKAI;83840444975;Taip;0;9;7;16
4252;Krivūlė;NYKŠTUKAI;1769984489;Taip;0;4;6;10
4253;Krivūlė;NYKŠTUKAI;19674882649;Taip;6;0;0;6
4254;Krivūlė;NYKŠTUKAI;701438210;Taip;0;5;0;5
4255;Krivūlė;NYKŠTUKAI;1657452686;Taip;0;0;1;1
4256;Krivūlė;NYKŠTUKAI;3015266398;Taip;0;0;4;4
4257;Krivūlė;NYKŠTUKAI;2109315338;Taip;0;2;0;2
4258;Krivūlė;NYKŠTUKAI;7873123757;Taip;5;6;0;11
4259;Krivūlė;NYKŠTUKAI;10005041572;Taip;6;0;0;6
4260;Krivūlė;NYKŠTUKAI;1515185307;Taip;8;0;0;8
4261;Krivūlė;NYKŠTUKAI;1217856292;Taip;14;0;0;14
4262;Krivūlė;NYKŠTUKAI;3064591570;Taip;0;3;1;4
4263;Krivūlė;NYKŠTUKAI;7922515745;Taip;0;0;4;4
4264;Krivūlė;NYKŠTUKAI;9311270695;Taip;0;0;1;1
4265;Krivūlė;NYKŠTUKAI;6861483854;Taip;0;3;0;3
4266;Krivūlė;NYKŠTUKAI;1283858948;Taip;6;0;0;6
4267;Krivūlė;NYKŠTUKAI;7052198958;Taip;14;0;2;16
4268;Krivūlė;NYKŠTUKAI;5818988913;Taip;0;5;0;5
4269;Kodėlčiukas;Saulutės;42540143229;Taip;0;5;0;5
4270;Kodėlčiukas;Saulutės;79090323340;Taip;0;1;1;2
4271;Kodėlčiukas;Saulutės;5922075420;Taip;8;0;0;8
4272;Kodėlčiukas;Saulutės;82725509126;Taip;4;5;0;9
4273;Kodėlčiukas;Saulutės;1905426469;Taip;8;2;0;10
4274;Kodėlčiukas;Saulutės;79742559803;Taip;0;0;1;1
4275;Kodėlčiukas;Saulutės;68236236113;Taip;0;5;0;5
4276;Kodėlčiukas;Saulutės;62309098505;Taip;0;4;0;4
4277;Kodėlčiukas;Saulutės;14611425618;Taip;0;1;0;1
4278;Kodėlčiukas;Saulutės;49784617790;Taip;0;1;1;2
4279;Kodėlčiukas;Saulutės;43335982030;Taip;6;5;1;12
4280;Kodėlčiukas;Saulutės;49731697380;Taip;0;1;0;1
4281;Kodėlčiukas;Saulutės;23065888472;Taip;7;1;0;8
4282;Kodėlčiukas;Saulutės;1730913401;Taip;10;0;2;12
4283;Kodėlčiukas;Saulutės;98738524708;Taip;0;5;0;5
4284;Kodėlčiukas;Saulutės;66109277013;Taip;0;10;0;10
4285;Kodėlčiukas;Saulutės;30952731344;Taip;10;0;0;10
4286;Kodėlčiukas;Saulutės;48669541733;Taip;5;0;1;6
4287;Kodėlčiukas;Saulutės;45910018746;Taip;0;7;0;7
4288;Kodėlčiukas;Saulutės;1608321100;Taip;4;5;2;11
4289;Kodėlčiukas;Saulutės;24024963204;Taip;2;0;0;2
4290;Kodėlčiukas;Saulutės;1290630625;Taip;7;1;0;8
4291;Kodėlčiukas;Saulutės;9323563664;Taip;8;0;1;9
4292;Kodėlčiukas;Nežiniukai;49317624340;Taip;0;5;2;7
4293;Kodėlčiukas;Nežiniukai;69860272843;Taip;0;10;0;10
4294;Kodėlčiukas;Nežiniukai;52040715568;Taip;0;7;0;7
4295;Kodėlčiukas;Nežiniukai;37852137155;Taip;7;0;0;7
4296;Kodėlčiukas;Nežiniukai;86134523927;Taip;10;3;3;16
4297;Kodėlčiukas;Nežiniukai;27110279093;Taip;10;0;1;11
4298;Kodėlčiukas;Nežiniukai;47677246360;Taip;11;0;0;11
4299;Kodėlčiukas;Nežiniukai;46307870009;Taip;10;0;4;14
4300;Kodėlčiukas;Nežiniukai;35337024913;Taip;0;5;0;5
4301;Kodėlčiukas;Nežiniukai;82927457803;Taip;0;5;0;5
4302;Kodėlčiukas;Nežiniukai;33432780322;Taip;5;4;0;9
4303;Kodėlčiukas;Nežiniukai;96270550335;Taip;0;2;0;2
4304;Kodėlčiukas;Nežiniukai;98476858512;Taip;0;5;0;5
4305;Kodėlčiukas;Nežiniukai;50234358109;Taip;0;0;1;1
4306;Kodėlčiukas;Nežiniukai;53066448447;Taip;10;5;0;15
4307;Kodėlčiukas;Nežiniukai;30874603769;Taip;0;1;10;11
4308;Kodėlčiukas;Nežiniukai;50411894014;Ne;7;0;0;7
4309;Kodėlčiukas;Nežiniukai;93698504377;Taip;0;0;6;6
4310;Kodėlčiukas;Nežiniukai;1518135854;Ne;0;0;1;1
4311;Kodėlčiukas;Nežiniukai;41664027247;Taip;5;5;0;10
4312;Kodėlčiukas;Nežiniukai;35779814505;Taip;5;5;0;10
4313;Kodėlčiukas;Nežiniukai;1614088526;Taip;10;0;4;14
4314;Kodėlčiukas;Nežiniukai;1347742983;Taip;7;1;0;8
4315;Kodėlčiukas;Nežiniukai;1951603132;Taip;4;0;0;4
4316;Kodėlčiukas;Nežiniukai;15211280060;Taip;10;3;3;16
4317;Kodėlčiukas;Gintarėliai;58406224468;Taip;3;0;6;9
4318;Kodėlčiukas;Gintarėliai;1485012710;Taip;10;0;0;10
4319;Kodėlčiukas;Gintarėliai;5520128823;Taip;8;0;0;8
4320;Kodėlčiukas;Gintarėliai;2062878300;Taip;4;4;0;8
4321;Kodėlčiukas;Gintarėliai;20084022099;Taip;5;0;0;5
4322;Kodėlčiukas;Gintarėliai;1950934087;Taip;5;0;1;6
4323;Kodėlčiukas;Gintarėliai;9686497547;Taip;15;0;0;15
4324;Kodėlčiukas;Gintarėliai;4884104023;Taip;10;0;3;13
4325;Kodėlčiukas;Gintarėliai;1632458573;Taip;10;0;0;10
4326;Kodėlčiukas;Gintarėliai;9332136116;Taip;5;5;0;10
4327;Kodėlčiukas;Gintarėliai;4944791330;Taip;16;0;0;16
4328;Kodėlčiukas;Gintarėliai;8219424737;Taip;12;0;0;12
4329;Kodėlčiukas;Gintarėliai;4849314647;Taip;0;3;1;4
4330;Kodėlčiukas;Gintarėliai;5202375085;Taip;4;0;0;4
4331;Kodėlčiukas;Gintarėliai;1923835699;Taip;15;0;0;15
4332;Kodėlčiukas;Gintarėliai;3758606327;Taip;5;0;1;6
4333;Kodėlčiukas;Gintarėliai;8647609373;Taip;20;0;0;20
4334;Kodėlčiukas;Gintarėliai;5093139270;Taip;0;3;3;6
4335;Kodėlčiukas;Gintarėliai;4738357524;Taip;15;0;0;15
4336;Kodėlčiukas;Gintarėliai;8075591032;Taip;10;0;1;11
4337;Kodėlčiukas;Gintarėliai;8873629130;Taip;10;0;0;10
4338;Kodėlčiukas;Gintarėliai;2765869141;Taip;0;1;7;8
4339;Kodėlčiukas;Šnekučiai;1844016431;Taip;12;0;1;13
4340;Kodėlčiukas;Šnekučiai;1550915654;Taip;0;1;0;1
4341;Kodėlčiukas;Šnekučiai;1935757837;Taip;7;8;0;15
4342;Kodėlčiukas;Šnekučiai;8114859362;Taip;0;2;7;9
4343;Kodėlčiukas;Šnekučiai;1666743304;Taip;2;0;0;2
4344;Kodėlčiukas;Šnekučiai;1584936719;Taip;15;0;0;15
4345;Kodėlčiukas;Šnekučiai;9178209049;Taip;2;3;5;10
4346;Kodėlčiukas;Šnekučiai;5988863934;Taip;0;11;0;11
4347;Kodėlčiukas;Šnekučiai;2742365461;Taip;7;1;0;8
4348;Kodėlčiukas;Šnekučiai;76164689333;Taip;14;0;1;15
4349;Kodėlčiukas;Šnekučiai;5386820408;Taip;0;7;0;7
4350;Kodėlčiukas;Šnekučiai;6194726931;Taip;19;0;0;19
4351;Kodėlčiukas;Šnekučiai;6327741830;Taip;16;0;0;16
4352;Kodėlčiukas;Šnekučiai;5782600824;Taip;2;0;0;2
4353;Kodėlčiukas;Šnekučiai;7074381835;Taip;11;0;1;12
4354;Kodėlčiukas;Šnekučiai;7757494295;Taip;0;8;0;8
4355;Kodėlčiukas;Šnekučiai;5827455834;Taip;5;3;0;8
4356;Kodėlčiukas;Šnekučiai;2988674717;Taip;16;2;2;20
4357;Kodėlčiukas;Pabiručiai;2108297221;Taip;0;5;0;5
4358;Kodėlčiukas;Pabiručiai;39617728687;Taip;0;1;0;1
4359;Kodėlčiukas;Pabiručiai;81633973264;Taip;0;0;2;2
4360;Kodėlčiukas;Pabiručiai;58428282965;Ne;6;0;0;6
4361;Kodėlčiukas;Pabiručiai;51185323645;Taip;0;0;1;1
4362;Kodėlčiukas;Pabiručiai;48423906431;Taip;5;0;0;5
4363;Kodėlčiukas;Pabiručiai;87708953660;Taip;3;0;1;4
4364;Kodėlčiukas;Pabiručiai;53418429595;Taip;0;2;1;3
4365;Kodėlčiukas;Pabiručiai;98729047811;Taip;0;5;0;5
4366;Kodėlčiukas;Pabiručiai;88106769076;Taip;0;5;6;11
4367;Kodėlčiukas;Pabiručiai;88962123607;Taip;0;5;0;5
4368;Kodėlčiukas;Pabiručiai;62762045244;Taip;0;5;0;5
4369;Kodėlčiukas;Pabiručiai;21552812103;Taip;4;0;2;6
4370;Kodėlčiukas;Pabiručiai;63558518927;Taip;0;1;1;2
4371;Kodėlčiukas;Pabiručiai;78294320340;Taip;0;3;0;3
4372;Kodėlčiukas;Pabiručiai;87517377176;Taip;0;1;0;1
4373;Kodėlčiukas;Pabiručiai;94058317569;Taip;0;5;2;7
4374;Kodėlčiukas;Pabiručiai;77935011738;Taip;0;5;0;5
4375;Kodėlčiukas;Pabiručiai;2315513519;Taip;5;5;1;11
4376;Kodėlčiukas;Pabiručiai;1833960742;Taip;8;7;0;15
4377;Kodėlčiukas;Pabiručiai;5421835194;Taip;9;5;0;14
4378;Kodėlčiukas;Pabiručiai;60728060670;Taip;15;2;0;17
4379;Kodėlčiukas;Smalsučiai;83992508203;Taip;0;5;0;5
4380;Kodėlčiukas;Smalsučiai;67642708813;Taip;0;0;2;2
4381;Kodėlčiukas;Smalsučiai;20612460521;Taip;6;6;0;12
4382;Kodėlčiukas;Smalsučiai;5708143211;Taip;7;1;0;8
4383;Kodėlčiukas;Smalsučiai;36383021317;Ne;0;14;0;14
4384;Kodėlčiukas;Smalsučiai;9551387327;Taip;1;0;0;1
4385;Kodėlčiukas;Smalsučiai;12032780110;Taip;0;1;3;4
4386;Kodėlčiukas;Smalsučiai;14856898838;Taip;3;5;1;9
4387;Kodėlčiukas;Smalsučiai;4126338806;Taip;4;5;0;9
4388;Kodėlčiukas;Smalsučiai;96798716829;Taip;0;8;0;8
4389;Kodėlčiukas;Smalsučiai;30131221448;Taip;0;5;3;8
4390;Kodėlčiukas;Smalsučiai;84863948327;Taip;5;5;3;13
4391;Kodėlčiukas;Smalsučiai;85578471272;Taip;10;5;0;15
4392;Kodėlčiukas;Smalsučiai;74068673680;Taip;4;6;0;10
4393;Kodėlčiukas;Smalsučiai;70047045302;Ne;0;10;0;10
4394;Kodėlčiukas;Smalsučiai;83002620619;Taip;0;6;0;6
4395;Kodėlčiukas;Smalsučiai;39818301789;Taip;10;7;0;17
4396;Kodėlčiukas;Smalsučiai;83838177418;Taip;2;2;0;4
4397;Kodėlčiukas;Smalsučiai;32715685481;Taip;7;5;0;12
4398;Kodėlčiukas;Smalsučiai;90639838215;Taip;5;5;2;12
4399;Kodėlčiukas;Smalsučiai;76998539095;Taip;0;5;5;10
4400;Kodėlčiukas;Smalsučiai;10616561892;Taip;0;5;1;6
4401;Kodėlčiukas;Giliukai;26010333641;Taip;10;0;0;10
4402;Kodėlčiukas;Giliukai;90443995599;Taip;0;8;0;8
4403;Kodėlčiukas;Giliukai;1782784297;Taip;0;5;0;5
4404;Kodėlčiukas;Giliukai;97902789189;Taip;7;0;1;8
4405;Kodėlčiukas;Giliukai;99164081259;Taip;4;5;0;9
4406;Kodėlčiukas;Giliukai;93684599166;Taip;12;3;0;15
4407;Kodėlčiukas;Giliukai;88371652763;Taip;0;5;1;6
4408;Kodėlčiukas;Giliukai;80767435810;Taip;0;5;0;5
4409;Kodėlčiukas;Giliukai;62063291384;Taip;10;0;0;10
4410;Kodėlčiukas;Giliukai;1825630143;Taip;0;5;15;20
4411;Kodėlčiukas;Giliukai;11130172902;Taip;3;0;2;5
4412;Kodėlčiukas;Giliukai;1330761392;Taip;5;1;0;6
4413;Kodėlčiukas;Giliukai;24138056567;Taip;5;2;0;7
4414;Kodėlčiukas;Giliukai;84905680496;Taip;6;4;0;10
4415;Kodėlčiukas;Giliukai;58893099621;Taip;0;0;1;1
4416;Kodėlčiukas;Giliukai;2637712514;Taip;0;5;5;10
4417;Kodėlčiukas;Giliukai;1354133871;Taip;6;0;4;10
4418;Kodėlčiukas;Giliukai;45393129631;Taip;3;0;0;3
4419;Kodėlčiukas;Giliukai;47667750562;Taip;10;0;0;10
4420;Kodėlčiukas;Giliukai;8204069897;Taip;15;2;0;17
4421;Kodėlčiukas;Giliukai;1938753417;Taip;4;5;0;9
4422;Kodėlčiukas;Giliukai;29319461634;Taip;10;1;2;13
4423;Kodėlčiukas;Gudručiai;20467065338;Taip;5;1;1;7
4424;Kodėlčiukas;Gudručiai;15580950604;Taip;5;5;0;10
4425;Kodėlčiukas;Gudručiai;44431255380;Taip;10;5;1;16
4426;Kodėlčiukas;Gudručiai;32318234528;Ne;12;0;0;12
4427;Kodėlčiukas;Gudručiai;93275059990;Taip;5;6;0;11
4428;Kodėlčiukas;Gudručiai;18557158044;Taip;10;0;3;13
4429;Kodėlčiukas;Gudručiai;3542081571;Taip;20;0;0;20
4430;Kodėlčiukas;Gudručiai;84450296241;Taip;0;5;0;5
4431;Kodėlčiukas;Gudručiai;1234971388;Taip;0;13;0;13
4432;Kodėlčiukas;Gudručiai;1048653620;Taip;6;5;0;11
4433;Kodėlčiukas;Gudručiai;1202105251;Taip;5;0;2;7
4434;Kodėlčiukas;Gudručiai;1662717348;Taip;10;1;0;11
4435;Kodėlčiukas;Gudručiai;1978279511;Taip;0;0;1;1
4436;Kodėlčiukas;Gudručiai;1251970125;Taip;9;0;0;9
4437;Kodėlčiukas;Gudručiai;6186365121;Taip;8;5;0;13
4438;Kodėlčiukas;Gudručiai;70940790491;Taip;10;0;0;10
4439;Kodėlčiukas;Gudručiai;6168432879;Taip;1;4;0;5
4440;Kodėlčiukas;Gudručiai;1106092960;Taip;0;5;1;6
4441;Kodėlčiukas;Gudručiai;8393750817;Taip;7;1;3;11
4442;Kodėlčiukas;Gudručiai;2061169442;Taip;10;1;0;11
4443;Kodėlčiukas;Gudručiai;1115828736;Taip;8;1;0;9
4444;Kodėlčiukas;Gudručiai;1723716524;Taip;9;5;0;14
4445;Kodėlčiukas;Gudručiai;87784905691;Taip;5;5;0;10
4446;Kodėlčiukas;Žirniukai;7327247516;Taip;0;0;1;1
4447;Kodėlčiukas;Žirniukai;1725624698;Taip;7;0;0;7
4448;Kodėlčiukas;Žirniukai;6517880481;Taip;0;2;0;2
4449;Kodėlčiukas;Žirniukai;3385551650;Taip;12;0;0;12
4450;Kodėlčiukas;Žirniukai;7080578299;Taip;17;0;0;17
4451;Kodėlčiukas;Žirniukai;9865803714;Taip;0;3;15;18
4452;Kodėlčiukas;Žirniukai;2464972409;Taip;10;5;0;15
4453;Kodėlčiukas;Žirniukai;7116594055;Taip;3;0;3;6
4454;Kodėlčiukas;Žirniukai;8890987483;Taip;5;0;0;5
4455;Kodėlčiukas;Žirniukai;7509476161;Taip;15;0;0;15
4456;Kodėlčiukas;Žirniukai;4687333060;Taip;11;2;0;13
4457;Kodėlčiukas;Žirniukai;1491160730;Taip;5;0;0;5
4458;Kodėlčiukas;Žirniukai;2216791610;Taip;7;5;0;12
4459;Kodėlčiukas;Katinėliai;6248137523;Taip;9;0;0;9
4460;Kodėlčiukas;Katinėliai;1233880820;Taip;14;0;2;16
4461;Kodėlčiukas;Katinėliai;5443377251;Taip;15;0;0;15
4462;Kodėlčiukas;Katinėliai;7136890681;Taip;7;0;0;7
4463;Kodėlčiukas;Katinėliai;7971932716;Taip;7;0;0;7
4464;Kodėlčiukas;Katinėliai;6045564826;Taip;15;0;2;17
4465;Kodėlčiukas;Katinėliai;7282579315;Taip;14;0;0;14
4466;Kodėlčiukas;Katinėliai;6905424567;Taip;0;12;0;12
4467;Kodėlčiukas;Katinėliai;3150006441;Taip;10;0;0;10
4468;Kodėlčiukas;Katinėliai;7626940433;Taip;0;4;0;4
4469;Kodėlčiukas;Katinėliai;9803206596;Taip;12;0;0;12
4470;Kodėlčiukas;Katinėliai;4917910801;Taip;5;5;0;10
4471;Kodėlčiukas;Katinėliai;1699358514;Taip;15;0;0;15
4472;Kodėlčiukas;Katinėliai;3473981974;Taip;10;0;1;11
4473;Kodėlčiukas;Katinėliai;4038168647;Taip;10;5;0;15
4474;Kodėlčiukas;Katinėliai;8378295683;Taip;14;2;0;16
4475;Kodėlčiukas;Katinėliai;6000831611;Taip;10;0;4;14
4476;Kodėlčiukas;Nykštukai;7246243975;Taip;9;3;0;12
4477;Kodėlčiukas;Nykštukai;1906128091;Taip;3;3;4;10
4478;Kodėlčiukas;Nykštukai;8879977943;Taip;0;18;0;18
4479;Kodėlčiukas;Nykštukai;8140940288;Taip;10;5;0;15
4480;Kodėlčiukas;Nykštukai;2929946390;Taip;4;7;0;11
4481;Kodėlčiukas;Nykštukai;9528997865;Taip;10;1;0;11
4482;Kodėlčiukas;Nykštukai;3782714343;Taip;10;0;0;10
4483;Kodėlčiukas;Nykštukai;1600501494;Taip;8;0;0;8
4484;Kodėlčiukas;Nykštukai;9460792167;Taip;10;0;2;12
4485;Kodėlčiukas;Nykštukai;1256650715;Taip;5;0;2;7
4486;Kodėlčiukas;Nykštukai;4818678923;Taip;16;0;0;16
4487;Kodėlčiukas;Nykštukai;8302606312;Taip;4;0;0;4
4488;Kodėlčiukas;Nykštukai;1919722425;Taip;8;0;0;8
4489;Kodėlčiukas;Nykštukai;1218904283;Taip;2;0;1;3
4490;Kodėlčiukas;Nykštukai;3880019350;Taip;17;0;0;17
4491;Kodėlčiukas;Nykštukai;7630180473;Taip;13;0;6;19
4492;Kodėlčiukas;Nykštukai;9589692031;Taip;19;1;0;20
4493;Kodėlčiukas;Nykštukai;2593524511;Taip;17;0;0;17
4494;Kodėlčiukas;Nykštukai;9794875862;Taip;8;0;0;8
4495;Kodėlčiukas;Nykštukai;1052656432;Taip;8;0;0;8
4496;Klevelis;Gėlytės;61178149504;Taip;0;5;0;5
4497;Klevelis;Gėlytės;1907412546;Taip;0;3;0;3
4498;Klevelis;Gėlytės;36864673412;Taip;6;4;0;10
4499;Klevelis;Gėlytės;65540816272;Taip;5;2;0;7
4500;Klevelis;Gėlytės;8756257605;Taip;4;3;0;7
4501;Klevelis;Gėlytės;15615294726;Taip;0;2;0;2
4502;Klevelis;Gėlytės;3101947555;Taip;0;8;0;8
4503;Klevelis;Gėlytės;7829685182;Taip;0;2;0;2
4504;Klevelis;Gėlytės;1024982577;Ne;0;11;0;11
4505;Klevelis;Gėlytės;7309676894;Taip;0;8;0;8
4506;Klevelis;Gėlytės;1942666372;Taip;10;10;0;20
4507;Klevelis;Gėlytės;50441219517;Taip;0;4;0;4
4508;Klevelis;Gėlytės;1181500775;Taip;5;5;0;10
4509;Klevelis;Gėlytės;8154620920;Ne;0;10;0;10
4510;Klevelis;Gėlytės;5075314234;Taip;10;2;0;12
4511;Klevelis;Paukšteliai;1606294984;Taip;0;3;0;3
4512;Klevelis;Paukšteliai;1953918266;Taip;5;0;0;5
4513;Klevelis;Paukšteliai;1685710938;Taip;0;6;0;6
4514;Klevelis;Paukšteliai;1757321892;Taip;4;1;0;5
4515;Klevelis;Paukšteliai;88565114332;Taip;0;1;1;2
4516;Klevelis;Paukšteliai;4400576631;Taip;5;0;0;5
4517;Klevelis;Paukšteliai;7506522045;Taip;1;5;2;8
4518;Klevelis;Paukšteliai;8155136607;Ne;0;12;0;12
4519;Klevelis;Paukšteliai;2043650571;Taip;0;5;3;8
4520;Klevelis;Paukšteliai;6172016747;Taip;11;0;0;11
4521;Klevelis;Paukšteliai;23520576240;Taip;0;3;0;3
4522;Klevelis;Paukšteliai;4930308435;Taip;0;5;0;5
4523;Klevelis;Paukšteliai;2555810841;Taip;8;4;0;12
4524;Klevelis;Paukšteliai;5024289280;Taip;0;1;0;1
4525;Klevelis;Paukšteliai;3437712794;Taip;10;2;0;12
4526;Klevelis;Paukšteliai;2744433344;Taip;0;5;1;6
4527;Klevelis;Paukšteliai;5354831337;Ne;9;3;0;12
4528;Klevelis;Paukšteliai;1851385706;Taip;11;5;0;16
4529;Klevelis;Paukšteliai;2078069088;Taip;0;5;0;5
4530;Klevelis;Spindulėliai;8957321461;Taip;5;13;0;18
4531;Klevelis;Spindulėliai;72505352951;Ne;0;3;0;3
4532;Klevelis;Spindulėliai;36733972781;Ne;0;3;0;3
4533;Klevelis;Spindulėliai;1929138590;Taip;5;0;0;5
4534;Klevelis;Spindulėliai;71637673796;Taip;10;2;0;12
4535;Klevelis;Spindulėliai;49983865253;Taip;0;13;0;13
4536;Klevelis;Spindulėliai;85910214189;Taip;3;7;0;10
4537;Klevelis;Spindulėliai;27776527268;Ne;0;6;0;6
4538;Klevelis;Spindulėliai;1299222411;Taip;6;2;0;8
4539;Klevelis;Spindulėliai;2041814549;Taip;5;0;0;5
4540;Klevelis;Spindulėliai;30473769754;Taip;0;1;0;1
4541;Klevelis;Spindulėliai;1608781752;Taip;0;9;0;9
4542;Klevelis;Spindulėliai;32063805512;Taip;0;17;0;17
4543;Klevelis;Spindulėliai;1980755137;Taip;5;0;0;5
4544;Klevelis;Spindulėliai;8246422485;Taip;4;0;0;4
4545;Klevelis;Spindulėliai;58302265771;Taip;0;7;0;7
4546;Klevelis;Spindulėliai;4733970252;Taip;10;0;0;10
4547;Klevelis;Spindulėliai;1141466643;Taip;10;7;0;17
4548;Klevelis;Spindulėliai;9125827523;Taip;0;6;0;6
4549;Klevelis;Spindulėliai;3397741232;Taip;3;7;0;10
4550;Klevelis;Spindulėliai;1520846063;Taip;4;0;0;4
4551;Klevelis;Spindulėliai;3201144750;Taip;0;10;0;10
4552;Klevelis;BORUŽĖLĖS;8195584468;Taip;10;6;0;16
4553;Klevelis;BORUŽĖLĖS;8357021249;Taip;10;0;0;10
4554;Klevelis;BORUŽĖLĖS;4558350854;Ne;0;14;0;14
4555;Klevelis;BORUŽĖLĖS;3873345138;Ne;8;3;0;11
4556;Klevelis;BORUŽĖLĖS;1020095914;Taip;0;10;0;10
4557;Klevelis;BORUŽĖLĖS;1749117711;Taip;0;5;1;6
4558;Klevelis;BORUŽĖLĖS;5402403433;Taip;0;20;0;20
4559;Klevelis;BORUŽĖLĖS;4424095457;Taip;0;1;0;1
4560;Klevelis;BORUŽĖLĖS;2207041148;Taip;17;0;0;17
4561;Klevelis;BORUŽĖLĖS;9291855374;Taip;10;0;0;10
4562;Klevelis;BORUŽĖLĖS;4775822341;Taip;11;6;0;17
4563;Klevelis;BORUŽĖLĖS;7855598075;Taip;15;5;0;20
4564;Klevelis;BORUŽĖLĖS;2031118410;Taip;9;2;0;11
4565;Klevelis;BORUŽĖLĖS;6488139414;Taip;20;0;0;20
4566;Klevelis;BORUŽĖLĖS;7115198351;Taip;12;1;0;13
4567;Klevelis;BORUŽĖLĖS;7559183263;Taip;0;7;0;7
4568;Kurpaitė;Viščiukų;8669676262;Taip;5;5;0;10
4569;Kurpaitė;Viščiukų;2827617670;Taip;11;5;0;16
4570;Kurpaitė;Viščiukų;4168882748;Taip;0;10;0;10
4571;Kurpaitė;Viščiukų;9062514113;Taip;3;1;0;4
4572;Kurpaitė;Viščiukų;9200404698;Taip;5;0;0;5
4573;Kurpaitė;Viščiukų;7546409044;Taip;20;0;0;20
4574;Kurpaitė;Viščiukų;4592795281;Taip;20;0;0;20
4575;Kurpaitė;Viščiukų;4964063637;Taip;10;0;0;10
4576;Kurpaitė;Viščiukų;5609161523;Taip;0;5;0;5
4577;Kurpaitė;Viščiukų;9480290430;Taip;0;10;0;10
4578;Kurpaitė;Viščiukų;8868415451;Taip;10;2;0;12
4579;Kurpaitė;Viščiukų;9655585527;Taip;15;5;0;20
4580;Kurpaitė;Viščiukų;4684525618;Taip;0;18;0;18
4581;Kurpaitė;Viščiukų;3634641300;Taip;0;4;0;4
4582;Kurpaitė;Viščiukų;9529949992;Taip;0;0;20;20
4583;Kurpaitė;Viščiukų;4602268315;Taip;20;0;0;20
4584;Kurpaitė;Gėlyčių;9435979008;Taip;14;0;0;14
4585;Kurpaitė;Gėlyčių;7431793716;Taip;0;20;0;20
4586;Kurpaitė;Gėlyčių;72710210157;Taip;0;11;0;11
4587;Kurpaitė;Gėlyčių;24410351286;Taip;0;12;0;12
4588;Kurpaitė;Gėlyčių;2359555461;Taip;10;2;0;12
4589;Kurpaitė;Gėlyčių;1505783589;Taip;0;14;0;14
4590;Kurpaitė;Gėlyčių;7249931704;Taip;11;0;0;11
4591;Kurpaitė;Gėlyčių;3102257512;Taip;7;7;0;14
4592;Kurpaitė;Gėlyčių;58127430940;Taip;0;18;0;18
4593;Kurpaitė;Gėlyčių;1606617694;Taip;0;18;0;18
4594;Kurpaitė;Gėlyčių;1660650556;Taip;0;14;0;14
4595;Kurpaitė;Gėlyčių;1151128660;Taip;7;0;0;7
4596;Kurpaitė;Gėlyčių;1457318954;Taip;10;2;0;12
4597;Kurpaitė;Gėlyčių;2116580903;Taip;0;17;0;17
4598;Kurpaitė;Gėlyčių;65434834152;Taip;10;3;0;13
4599;Kurpaitė;Gėlyčių;3660687688;Taip;0;6;0;6
4600;Kurpaitė;Gėlyčių;2890934301;Taip;8;0;0;8
4601;Kurpaitė;Gėlyčių;9063294667;Taip;8;7;0;15
4602;Kurpaitė;Drugelių;49970457589;Taip;10;6;0;16
4603;Kurpaitė;Drugelių;62959992605;Taip;0;15;0;15
4604;Kurpaitė;Drugelių;38605683298;Taip;0;3;0;3
4605;Kurpaitė;Drugelių;5394176979;Taip;12;0;0;12
4606;Kurpaitė;Drugelių;5442955475;Taip;0;10;0;10
4607;Kurpaitė;Drugelių;31201788860;Taip;0;1;0;1
4608;Kurpaitė;Drugelių;65418822653;Taip;0;6;0;6
4609;Kurpaitė;Drugelių;66920939967;Taip;0;12;0;12
4610;Kurpaitė;Drugelių;1730735673;Taip;0;5;0;5
4611;Kurpaitė;Drugelių;52852801754;Taip;0;5;0;5
4612;Kurpaitė;Drugelių;43247754405;Taip;13;6;0;19
4613;Kurpaitė;Drugelių;1236147310;Taip;0;5;0;5
4614;Kurpaitė;Drugelių;48526842780;Taip;0;2;0;2
4615;Kurpaitė;Drugelių;61993267223;Taip;0;11;0;11
4616;Kurpaitė;Drugelių;1641562196;Taip;5;0;0;5
4617;Kurpaitė;Drugelių;2200676656;Taip;5;1;0;6
4618;Kurpaitė;Drugelių;71716344368;Taip;0;15;0;15
4619;Kurpaitė;Drugelių;48538300542;Taip;5;9;0;14
4620;Kurpaitė;Drugelių;85698687930;Taip;0;5;0;5
4621;Kurpaitė;Drugelių;51115562424;Taip;5;5;0;10
4622;Kurpaitė;Drugelių;1202869338;Taip;12;0;0;12
4623;Kurpaitė;Pelyčių;9919068986;Taip;0;11;0;11
4624;Kurpaitė;Pelyčių;54413485607;Taip;10;5;0;15
4625;Kurpaitė;Pelyčių;41686757437;Taip;10;5;0;15
4626;Kurpaitė;Pelyčių;32817744462;Taip;10;5;0;15
4627;Kurpaitė;Pelyčių;1993159901;Taip;0;10;0;10
4628;Kurpaitė;Pelyčių;32746331924;Taip;10;4;0;14
4629;Kurpaitė;Pelyčių;31034408890;Taip;0;8;0;8
4630;Kurpaitė;Pelyčių;42531654257;Taip;0;17;0;17
4631;Kurpaitė;Pelyčių;42230129130;Taip;0;17;0;17
4632;Kurpaitė;Pelyčių;28569380108;Taip;0;14;0;14
4633;Kurpaitė;Pelyčių;52350974867;Taip;2;3;0;5
4634;Kurpaitė;Pelyčių;86497821794;Taip;0;5;0;5
4635;Kurpaitė;Pelyčių;97469119395;Taip;5;0;0;5
4636;Kurpaitė;Pelyčių;14193840490;Taip;1;1;0;2
4637;Kurpaitė;Pelyčių;34995551069;Taip;0;5;0;5
4638;Kurpaitė;Pelyčių;71783740325;Taip;0;5;0;5
4639;Kurpaitė;Pelyčių;1136113867;Taip;0;11;0;11
4640;Kurpaitė;Pelyčių;1936055251;Taip;0;5;0;5
4641;Kurpaitė;Pelyčių;3697560973;Taip;0;5;15;20
4642;Kurpaitė;Pelyčių;5902371603;Taip;0;12;0;12
4643;Kūlverstukas;Saulutės;1816105412;Taip;10;1;0;11
4644;Kūlverstukas;Saulutės;1471794813;Taip;0;0;4;4
4645;Kūlverstukas;Saulutės;4028937969;Taip;0;13;7;20
4646;Kūlverstukas;Saulutės;1109035765;Taip;0;0;4;4
4647;Kūlverstukas;Saulutės;1570383265;Taip;5;5;0;10
4648;Kūlverstukas;Saulutės;46862868133;Taip;0;0;2;2
4649;Kūlverstukas;Saulutės;3737085009;Taip;0;0;2;2
4650;Kūlverstukas;Saulutės;49788909084;Taip;11;3;3;17
4651;Kūlverstukas;Saulutės;1009117653;Taip;15;0;0;15
4652;Kūlverstukas;Saulutės;8362459952;Taip;9;2;6;17
4653;Kūlverstukas;Saulutės;74829986958;Taip;0;7;7;14
4654;Kūlverstukas;Saulutės;47399326083;Taip;7;0;1;8
4655;Kūlverstukas;Saulutės;21138396996;Taip;5;1;1;7
4656;Kūlverstukas;Saulutės;2072009099;Taip;10;0;3;13
4657;Kūlverstukas;Saulutės;1000393691;Taip;0;0;11;11
4658;Kūlverstukas;Saulutės;2135571148;Taip;0;15;0;15
4659;Kūlverstukas;Saulutės;1987591278;Taip;15;2;3;20
4660;Kūlverstukas;Saulutės;1396533792;Taip;10;2;8;20
4661;Kūlverstukas;Peledžiukai;52190958426;Taip;0;3;0;3
4662;Kūlverstukas;Peledžiukai;1399479148;Taip;5;5;0;10
4663;Kūlverstukas;Peledžiukai;85330859485;Taip;1;2;0;3
4664;Kūlverstukas;Peledžiukai;2179050825;Taip;0;3;0;3
4665;Kūlverstukas;Peledžiukai;81294065628;Taip;10;0;0;10
4666;Kūlverstukas;Peledžiukai;66857330884;Taip;0;5;0;5
4667;Kūlverstukas;Peledžiukai;89965851223;Ne;0;5;1;6
4668;Kūlverstukas;Peledžiukai;2972422399;Taip;1;0;3;4
4669;Kūlverstukas;Peledžiukai;46254945540;Taip;0;5;0;5
4670;Kūlverstukas;Peledžiukai;80342796585;Taip;0;2;0;2
4671;Kūlverstukas;Peledžiukai;55515614021;Taip;1;0;0;1
4672;Kūlverstukas;Peledžiukai;61916609121;Taip;0;5;0;5
4673;Kūlverstukas;Peledžiukai;1260193245;Taip;16;0;0;16
4674;Kūlverstukas;Peledžiukai;29398080266;Taip;5;5;0;10
4675;Kūlverstukas;Peledžiukai;31032210878;Taip;3;0;0;3
4676;Kūlverstukas;Peledžiukai;69472316532;Taip;2;0;0;2
4677;Kūlverstukas;Peledžiukai;89179106633;Ne;0;12;0;12
4678;Kūlverstukas;Gelytės;2130099456;Taip;0;2;0;2
4679;Kūlverstukas;Gelytės;1226883894;Taip;2;10;0;12
4680;Kūlverstukas;Gelytės;37991935289;Taip;7;3;0;10
4681;Kūlverstukas;Gelytės;2716194746;Taip;0;18;2;20
4682;Kūlverstukas;Gelytės;7440474403;Taip;5;5;0;10
4683;Kūlverstukas;Gelytės;3991821717;Taip;12;5;0;17
4684;Kūlverstukas;Gelytės;3937419139;Taip;2;2;0;4
4685;Kūlverstukas;Gelytės;8092104136;Taip;8;0;10;18
4686;Kūlverstukas;Gelytės;7480593611;Ne;11;3;0;14
4687;Kūlverstukas;Gelytės;1699783763;Taip;10;1;0;11
4688;Kūlverstukas;Gelytės;1240006602;Taip;5;0;0;5
4689;Kūlverstukas;Gelytės;3162189859;Taip;10;0;2;12
4690;Kūlverstukas;Gelytės;5372936730;Taip;0;0;4;4
4691;Kūlverstukas;Gelytės;7359354944;Taip;5;0;2;7
4692;Kūlverstukas;Gelytės;8243342948;Taip;5;2;0;7
4693;Kūlverstukas;Gelytės;1452422691;Taip;14;0;0;14
4694;Kūlverstukas;Bitutės;3270176280;Taip;15;0;0;15
4695;Kūlverstukas;Bitutės;1932066021;Taip;17;0;0;17
4696;Kūlverstukas;Bitutės;4073233921;Taip;13;0;0;13
4697;Kūlverstukas;Bitutės;9427388681;Taip;13;3;0;16
4698;Kūlverstukas;Bitutės;5345423038;Taip;9;0;0;9
4699;Kūlverstukas;Bitutės;8853848991;Taip;10;3;0;13
4700;Kūlverstukas;Bitutės;4285624305;Taip;10;0;10;20
4701;Kūlverstukas;Bitutės;5103259175;Taip;0;5;6;11
4702;Kūlverstukas;Bitutės;9167460438;Taip;7;0;2;9
4703;Kūlverstukas;Bitutės;2087570702;Taip;0;5;7;12
4704;Kūlverstukas;Bitutės;5488852698;Taip;8;4;0;12
4705;Kūlverstukas;Bitutės;2419847093;Taip;6;1;0;7
4706;Kūlverstukas;Bitutės;1898905623;Taip;20;0;0;20
4707;Kūlverstukas;Bitutės;3069047204;Taip;10;2;0;12
4708;Kūlverstukas;Bitutės;2169480822;Taip;0;17;0;17
4709;Lakštingala;Saulutės;33332213331;Taip;5;5;4;14
4710;Lakštingala;Saulutės;35681729219;Ne;0;5;0;5
4711;Lakštingala;Saulutės;1416434491;Taip;1;5;2;8
4712;Lakštingala;Saulutės;17738218138;Taip;0;5;1;6
4713;Lakštingala;Saulutės;23753553201;Taip;0;5;1;6
4714;Lakštingala;Saulutės;31706572403;Taip;3;7;0;10
4715;Lakštingala;Saulutės;51200162218;Taip;10;0;0;10
4716;Lakštingala;Saulutės;22211300772;Taip;4;5;1;10
4717;Lakštingala;Saulutės;18470272487;Taip;5;5;0;10
4718;Lakštingala;Saulutės;25804940619;Taip;0;6;0;6
4719;Lakštingala;Saulutės;35357852412;Taip;0;1;1;2
4720;Lakštingala;Saulutės;42865585801;Taip;11;2;0;13
4721;Lakštingala;Saulutės;30224525177;Taip;0;2;0;2
4722;Lakštingala;Saulutės;1914662837;Taip;4;6;0;10
4723;Lakštingala;Saulutės;18798639428;Taip;0;2;0;2
4724;Lakštingala;Saulutės;87760794641;Taip;0;6;0;6
4725;Lakštingala;Saulutės;87223860105;Ne;5;9;0;14
4726;Lakštingala;Saulutės;1451425863;Taip;0;5;2;7
4727;Lakštingala;Saulutės;75435214041;Taip;0;1;4;5
4728;Lakštingala;Saulutės;98174553118;Taip;0;5;0;5
4729;Lakštingala;Saulutės;58644572893;Ne;0;5;0;5
4730;Lakštingala;Nykštukai;98655995607;Taip;0;1;0;1
4731;Lakštingala;Nykštukai;45850246980;Taip;0;6;3;9
4732;Lakštingala;Nykštukai;74001349345;Taip;5;1;0;6
4733;Lakštingala;Nykštukai;51586922715;Taip;8;9;0;17
4734;Lakštingala;Nykštukai;31221126819;Taip;5;0;2;7
4735;Lakštingala;Nykštukai;95489864230;Taip;15;5;0;20
4736;Lakštingala;Nykštukai;10653315095;Ne;0;6;0;6
4737;Lakštingala;Nykštukai;96792864646;Taip;0;5;0;5
4738;Lakštingala;Nykštukai;43151626858;Taip;0;8;0;8
4739;Lakštingala;Nykštukai;5692087454;Taip;15;5;0;20
4740;Lakštingala;Nykštukai;780078103;Taip;0;5;0;5
4741;Lakštingala;Nykštukai;68037499606;Taip;12;5;0;17
4742;Lakštingala;Nykštukai;93222430249;Taip;6;0;0;6
4743;Lakštingala;Nykštukai;89747320378;Taip;2;7;0;9
4744;Lakštingala;Nykštukai;79583726414;Taip;10;5;0;15
4745;Lakštingala;Nykštukai;2430795418;Taip;0;5;0;5
4746;Lakštingala;Nykštukai;40682764019;Taip;5;0;0;5
4747;Lakštingala;Nykštukai;62866040506;Taip;10;5;0;15
4748;Lakštingala;Nykštukai;98717827320;Taip;1;5;0;6
4749;Lakštingala;Nykštukai;57836156450;Taip;10;5;0;15
4750;Lakštingala;Nykštukai;50868279016;Taip;9;0;1;10
4751;Lakštingala;Nykštukai;3426133948;Taip;0;14;0;14
4752;Lakštingala;Nykštukai;37722153251;Taip;9;6;0;15
4753;Lakštingala;Bitutės;81628046226;Taip;0;13;0;13
4754;Lakštingala;Bitutės;4915919195;Taip;0;1;0;1
4755;Lakštingala;Bitutės;63360792078;Taip;3;4;0;7
4756;Lakštingala;Bitutės;84925543738;Taip;0;5;0;5
4757;Lakštingala;Bitutės;1150148262;Taip;0;5;0;5
4758;Lakštingala;Bitutės;88634927621;Taip;0;11;0;11
4759;Lakštingala;Bitutės;58670695979;Taip;0;6;0;6
4760;Lakštingala;Bitutės;1208496587;Taip;0;5;0;5
4761;Lakštingala;Bitutės;1478103633;Taip;0;6;0;6
4762;Lakštingala;Bitutės;5460505229;Taip;0;4;3;7
4763;Lakštingala;Bitutės;43764846549;Taip;0;2;0;2
4764;Lakštingala;Bitutės;59776948588;Taip;0;1;3;4
4765;Lakštingala;Bitutės;7179277612;Taip;0;6;0;6
4766;Lakštingala;Bitutės;85722261846;Taip;15;5;0;20
4767;Lakštingala;Bitutės;90557374701;Taip;0;5;1;6
4768;Lakštingala;Bitutės;70253545165;Taip;0;5;0;5
4769;Lakštingala;Bitutės;49381287243;Taip;0;5;0;5
4770;Lakštingala;Bitutės;96502788115;Taip;0;6;0;6
4771;Lakštingala;Bitutės;20671216208;Taip;0;5;1;6
4772;Lakštingala;Bitutės;3544861594;Taip;0;10;0;10
4773;Lakštingala;Bitutės;75081412082;Taip;5;0;0;5
4774;Lakštingala;Pūkeliai;91158318909;Taip;0;5;0;5
4775;Lakštingala;Pūkeliai;95149875628;Taip;0;15;0;15
4776;Lakštingala;Pūkeliai;72834597919;Taip;10;0;0;10
4777;Lakštingala;Pūkeliai;46426227002;Taip;0;0;5;5
4778;Lakštingala;Pūkeliai;82319560992;Taip;0;12;0;12
4779;Lakštingala;Pūkeliai;14826956710;Taip;0;5;1;6
4780;Lakštingala;Pūkeliai;7860949054;Taip;5;5;0;10
4781;Lakštingala;Pūkeliai;1056248263;Taip;10;5;0;15
4782;Lakštingala;Pūkeliai;92129853333;Taip;5;0;0;5
4783;Lakštingala;Pūkeliai;19356167631;Taip;4;0;0;4
4784;Lakštingala;Pūkeliai;56646163756;Taip;6;0;0;6
4785;Lakštingala;Pūkeliai;33431377093;Taip;10;5;0;15
4786;Lakštingala;Pūkeliai;63698553352;Taip;0;2;0;2
4787;Lakštingala;Pūkeliai;45199150020;Taip;0;4;0;4
4788;Lakštingala;Pūkeliai;24905526995;Taip;5;0;2;7
4789;Lakštingala;Pūkeliai;2106666739;Taip;20;0;0;20
4790;Lakštingala;Aitvariukai;36990696663;Taip;5;7;0;12
4791;Lakštingala;Aitvariukai;99780001413;Taip;15;5;0;20
4792;Lakštingala;Aitvariukai;7857821609;Taip;0;4;0;4
4793;Lakštingala;Aitvariukai;8946285512;Ne;0;6;0;6
4794;Lakštingala;Aitvariukai;33957315145;Taip;0;12;0;12
4795;Lakštingala;Aitvariukai;19833280319;Taip;0;4;0;4
4796;Lakštingala;Aitvariukai;2088394089;Taip;0;0;1;1
4797;Lakštingala;Aitvariukai;15819827141;Taip;0;5;0;5
4798;Lakštingala;Aitvariukai;44523220134;Taip;0;2;0;2
4799;Lakštingala;Aitvariukai;61122948431;Ne;0;4;0;4
4800;Lakštingala;Aitvariukai;84766974984;Taip;0;1;0;1
4801;Lakštingala;Aitvariukai;26675933922;Taip;0;10;0;10
4802;Lakštingala;Aitvariukai;69176146563;Taip;3;0;0;3
4803;Lakštingala;Aitvariukai;8781225219;Taip;0;6;0;6
4804;Lakštingala;Aitvariukai;86429853759;Taip;0;5;0;5
4805;Lakštingala;Boružiukai;9795993812;Taip;0;1;0;1
4806;Lakštingala;Boružiukai;3280380015;Taip;7;0;0;7
4807;Lakštingala;Boružiukai;43313173294;Taip;6;0;0;6
4808;Lakštingala;Boružiukai;9004336424;Taip;1;0;8;9
4809;Lakštingala;Boružiukai;87470014156;Taip;0;0;1;1
4810;Lakštingala;Boružiukai;8820053026;Taip;5;4;0;9
4811;Lakštingala;Boružiukai;2072883878;Taip;0;5;0;5
4812;Lakštingala;Boružiukai;8873445262;Taip;7;0;4;11
4813;Lakštingala;Boružiukai;4811759034;Taip;1;1;0;2
4814;Lakštingala;Boružiukai;1898853302;Taip;6;1;0;7
4815;Lakštingala;Boružiukai;7443563000;Taip;4;0;1;5
4816;Lakštingala;Boružiukai;2792618575;Taip;0;13;0;13
4817;Lakštingala;Boružiukai;55720630870;Taip;2;0;4;6
4818;Lakštingala;Boružiukai;4766547534;Taip;0;0;5;5
4819;Lakštingala;Boružiukai;4818524423;Taip;5;4;0;9
4820;Lakštingala;Boružiukai;1444534032;Taip;5;0;1;6
4821;Lakštingala;Boružiukai;6150013105;Taip;0;0;8;8
4822;Lakštingala;"KIŠKUČIAI (SAV.)";64992551832;Taip;0;6;0;6
4823;Lakštingala;"KIŠKUČIAI (SAV.)";1169891428;Taip;0;5;0;5
4824;Lakštingala;"KIŠKUČIAI (SAV.)";63039806752;Taip;6;5;0;11
4825;Lakštingala;"KIŠKUČIAI (SAV.)";1409132656;Taip;7;7;0;14
4826;Lakštingala;"KIŠKUČIAI (SAV.)";1236087612;Taip;7;7;0;14
4827;Lakštingala;"KIŠKUČIAI (SAV.)";80762133625;Taip;0;5;0;5
4828;Lakštingala;"KIŠKUČIAI (SAV.)";1128658722;Taip;0;6;0;6
4829;Lakštingala;"KIŠKUČIAI (SAV.)";9862985913;Taip;0;5;0;5
4830;Lakštingala;"KIŠKUČIAI (SAV.)";8645237294;Taip;0;2;0;2
4831;Lakštingala;"KIŠKUČIAI (SAV.)";2083229761;Taip;0;7;0;7
4832;Lakštingala;"KIŠKUČIAI (SAV.)";1538315501;Taip;0;7;0;7
4833;Lakštingala;"KIŠKUČIAI (SAV.)";40853872375;Taip;0;3;1;4
4834;Lakštingala;"KIŠKUČIAI (SAV.)";1663637599;Taip;10;4;0;14
4835;Lakštingala;"KIŠKUČIAI (SAV.)";1716046309;Taip;0;5;0;5
4836;Lakštingala;"KIŠKUČIAI (SAV.)";3660645944;Taip;5;7;0;12
4837;Lakštingala;"KIŠKUČIAI (SAV.)";7038977283;Taip;0;4;1;5
4838;Lakštingala;"KIŠKUČIAI (SAV.)";80142440362;Taip;0;6;0;6
4839;Lakštingala;"KIŠKUČIAI (SAV.)";7623300327;Taip;6;0;0;6
4840;Lakštingala;"KIŠKUČIAI (SAV.)";2241000661;Taip;6;0;0;6
4841;Lakštingala;Žiogeliai;2104150466;Taip;0;2;1;3
4842;Lakštingala;Žiogeliai;9395512638;Taip;0;1;0;1
4843;Lakštingala;Žiogeliai;9689911725;Taip;0;1;0;1
4844;Lakštingala;Žiogeliai;8705627810;Taip;0;2;5;7
4845;Lakštingala;Žiogeliai;1832608585;Taip;11;1;0;12
4846;Lakštingala;Žiogeliai;9958821769;Taip;12;5;0;17
4847;Lakštingala;Žiogeliai;7953724873;Taip;3;2;0;5
4848;Lakštingala;Žiogeliai;1411121466;Taip;7;5;0;12
4849;Lakštingala;Žiogeliai;8944088082;Taip;0;3;0;3
4850;Lakštingala;Žiogeliai;9897713625;Taip;9;1;0;10
4851;Lakštingala;Žiogeliai;70798601578;Taip;0;8;0;8
4852;Lakštingala;Žiogeliai;1736130324;Taip;8;1;0;9
4853;Lakštingala;Žiogeliai;2039579203;Taip;10;0;0;10
4854;Lakštingala;Žiogeliai;6576202365;Taip;10;7;0;17
4855;Lakštingala;Žiogeliai;89044575245;Taip;0;0;14;14
4856;Lakštingala;Žiogeliai;7900597697;Taip;0;5;1;6
4857;Lakštingala;Žiogeliai;9497327995;Taip;4;0;4;8
4858;Lakštingala;Žiogeliai;8016552114;Taip;0;8;0;8
4859;Lakštingala;Žiogeliai;8470575927;Taip;1;0;0;1
4860;Lakštingala;SPINDULIUKAI;19003276281;Taip;0;6;1;7
4861;Lakštingala;SPINDULIUKAI;31911078405;Taip;0;6;1;7
4862;Lakštingala;SPINDULIUKAI;59343571746;Taip;9;0;0;9
4863;Lakštingala;SPINDULIUKAI;601001178;Taip;3;0;4;7
4864;Lakštingala;SPINDULIUKAI;1263184555;Taip;0;3;1;4
4865;Lakštingala;SPINDULIUKAI;42012300013;Taip;0;1;0;1
4866;Lakštingala;SPINDULIUKAI;2002196654;Taip;9;5;0;14
4867;Lakštingala;SPINDULIUKAI;4261431738;Taip;0;1;0;1
4868;Lakštingala;SPINDULIUKAI;58847206918;Taip;15;0;0;15
4869;Lakštingala;SPINDULIUKAI;5033145687;Taip;11;5;0;16
4870;Lakštingala;SPINDULIUKAI;26288159700;Taip;2;5;5;12
4871;Lakštingala;SPINDULIUKAI;11399672681;Taip;5;0;0;5
4872;Lakštingala;SPINDULIUKAI;95832669291;Taip;0;8;0;8
4873;Lakštingala;SPINDULIUKAI;4183492894;Taip;0;1;0;1
4874;Lakštingala;SPINDULIUKAI;65408046990;Taip;5;0;2;7
4875;Lakštingala;SPINDULIUKAI;48160996499;Taip;7;5;0;12
4876;Lakštingala;SPINDULIUKAI;70748679017;Taip;2;0;1;3
4877;Lakštingala;SPINDULIUKAI;37897965773;Taip;12;5;0;17
4878;Lakštingala;SPINDULIUKAI;4770775472;Taip;0;3;0;3
4879;Lakštingala;SPINDULIUKAI;7448175606;Taip;0;7;1;8
4880;Lakštingala;Pėledžiukai;98609129644;Taip;0;11;0;11
4881;Lakštingala;Pėledžiukai;2635399411;Taip;0;6;0;6
4882;Lakštingala;Pėledžiukai;7325183642;Taip;0;2;1;3
4883;Lakštingala;Pėledžiukai;1271455798;Taip;0;5;0;5
4884;Lakštingala;Pėledžiukai;1868573076;Taip;5;2;0;7
4885;Lakštingala;Pėledžiukai;14410791110;Taip;0;1;0;1
4886;Lakštingala;Pėledžiukai;30840899725;Taip;0;5;0;5
4887;Lakštingala;Pėledžiukai;1676655778;Taip;10;0;0;10
4888;Lakštingala;Pėledžiukai;15430318196;Taip;0;0;18;18
4889;Lakštingala;Pėledžiukai;9381815353;Taip;0;7;0;7
4890;Lakštingala;Pėledžiukai;25449089230;Taip;0;7;0;7
4891;Lakštingala;Pėledžiukai;36367286465;Taip;0;5;4;9
4892;Lakštingala;Pėledžiukai;91671174585;Taip;0;7;0;7
4893;Lakštingala;Pėledžiukai;1347480198;Taip;0;6;0;6
4894;Lakštingala;Pėledžiukai;88947243829;Taip;4;7;0;11
4895;Lakštingala;Pėledžiukai;6329787217;Taip;0;2;5;7
4896;Lakštingala;Pėledžiukai;58056130761;Taip;0;10;0;10
4897;Lakštingala;Pėledžiukai;1310400524;Taip;6;4;0;10
4898;Lakštingala;Pėledžiukai;2013216779;Taip;0;5;0;5
4899;Lakštingala;Pėledžiukai;8890852891;Taip;0;5;0;5
4900;Lakštingala;Pėledžiukai;9998322501;Taip;15;0;2;17
4901;Lakštingala;Katinėliai;9774836470;Taip;3;2;0;5
4902;Lakštingala;Katinėliai;4751761623;Ne;0;1;0;1
4903;Lakštingala;Katinėliai;7929034243;Taip;0;1;7;8
4904;Lakštingala;Katinėliai;8171357606;Taip;10;7;0;17
4905;Lakštingala;Katinėliai;6780591792;Taip;16;0;0;16
4906;Lakštingala;Katinėliai;9431217584;Taip;0;0;10;10
4907;Lakštingala;Katinėliai;2962846236;Taip;0;0;9;9
4908;Lakštingala;Katinėliai;3109623760;Taip;20;0;0;20
4909;Lakštingala;Katinėliai;3811230983;Taip;0;7;1;8
4910;Lakštingala;Katinėliai;6908873466;Taip;0;1;0;1
4911;Lakštingala;Katinėliai;5854794141;Taip;5;0;0;5
4912;Lakštingala;Katinėliai;8422745100;Taip;0;0;6;6
4913;Lakštingala;Katinėliai;5598711072;Taip;18;0;0;18
4914;Lakštingala;Katinėliai;1958696382;Taip;0;0;7;7
4915;Lakštingala;Katinėliai;2022621678;Taip;0;0;8;8
4916;Lakštingala;Katinėliai;4542992319;Taip;14;0;2;16
4917;Lakštingala;Katinėliai;5537018556;Taip;0;2;3;5
4918;Lakštingala;Katinėliai;2593030897;Taip;4;1;0;5
4919;Lakštingala;Katinėliai;8529259340;Taip;0;0;13;13
4920;Lakštingala;Deimantėliai;4032030375;Taip;3;13;0;16
4921;Lakštingala;Deimantėliai;1655202909;Taip;6;10;0;16
4922;Lakštingala;Deimantėliai;7931292601;Taip;0;0;1;1
4923;Lakštingala;Deimantėliai;8284565948;Taip;0;1;0;1
4924;Lakštingala;Deimantėliai;1648466517;Taip;5;0;0;5
4925;Lakštingala;Deimantėliai;3993759015;Taip;10;10;0;20
4926;Lakštingala;Deimantėliai;3568151046;Taip;15;0;0;15
4927;Lakštingala;Deimantėliai;9725851433;Taip;7;1;0;8
4928;Lakštingala;Deimantėliai;4700135106;Taip;3;1;0;4
4929;Lakštingala;Deimantėliai;1863034132;Taip;20;0;0;20
4930;Lakštingala;Deimantėliai;9879064676;Taip;12;0;0;12
4931;Lakštingala;Deimantėliai;2423651716;Taip;5;2;0;7
4932;Lakštingala;Deimantėliai;3369263112;Taip;15;0;0;15
4933;Lakštingala;Deimantėliai;9489982241;Taip;13;0;0;13
4934;Lakštingala;Deimantėliai;3724324861;Taip;2;0;0;2
4935;Lakštingala;Deimantėliai;2652305131;Taip;2;0;0;2
4936;Lakštingala;Deimantėliai;6332498461;Taip;2;7;0;9
4937;Lakštingala;Deimantėliai;9375002191;Taip;2;6;2;10
4938;Lakštingala;Deimantėliai;2941128360;Taip;2;3;0;5
4939;Lašelis;VIŠČIUKAI;86191407652;Taip;0;3;0;3
4940;Lašelis;VIŠČIUKAI;8873895533;Taip;10;0;0;10
4941;Lašelis;VIŠČIUKAI;58391864442;Taip;0;3;0;3
4942;Lašelis;VIŠČIUKAI;10694830733;Ne;0;8;5;13
4943;Lašelis;VIŠČIUKAI;4320017329;Taip;10;10;0;20
4944;Lašelis;VIŠČIUKAI;1132803162;Taip;6;8;0;14
4945;Lašelis;VIŠČIUKAI;14934740494;Ne;0;9;0;9
4946;Lašelis;VIŠČIUKAI;8332516807;Taip;0;5;0;5
4947;Lašelis;VIŠČIUKAI;1584708183;Taip;0;2;0;2
4948;Lašelis;VIŠČIUKAI;1282991939;Taip;10;0;0;10
4949;Lašelis;VIŠČIUKAI;60394164372;Taip;15;0;0;15
4950;Lašelis;VIŠČIUKAI;713862923;Taip;0;5;1;6
4951;Lašelis;VIŠČIUKAI;82073061357;Taip;10;0;0;10
4952;Lašelis;VIŠČIUKAI;4277113412;Ne;0;5;6;11
4953;Lašelis;VIŠČIUKAI;7349722463;Taip;12;1;0;13
4954;Lašelis;VIŠČIUKAI;2429224297;Taip;0;11;0;11
4955;Lašelis;VIŠČIUKAI;1383759549;Taip;13;0;4;17
4956;Lašelis;VIŠČIUKAI;5437008837;Taip;10;0;0;10
4957;Lašelis;VIŠČIUKAI;1171647193;Taip;0;0;12;12
4958;Lašelis;ŠYPSENA;9391594216;Taip;13;3;0;16
4959;Lašelis;ŠYPSENA;65174922062;Taip;4;7;1;12
4960;Lašelis;ŠYPSENA;6977000987;Taip;5;3;2;10
4961;Lašelis;ŠYPSENA;4599789649;Taip;10;4;0;14
4962;Lašelis;ŠYPSENA;6136792125;Taip;4;10;0;14
4963;Lašelis;ŠYPSENA;6090290046;Taip;15;0;0;15
4964;Lašelis;ŠYPSENA;1417989409;Taip;11;0;0;11
4965;Lašelis;ŠYPSENA;1193336600;Taip;10;2;0;12
4966;Lašelis;ŠYPSENA;1268330178;Taip;10;5;0;15
4967;Lašelis;ŠYPSENA;1739797553;Taip;5;3;0;8
4968;Lašelis;ŠYPSENA;1578956182;Taip;0;8;0;8
4969;Lašelis;ŠYPSENA;2113295854;Taip;0;0;4;4
4970;Lašelis;ŠYPSENA;2500332755;Taip;7;3;0;10
4971;Lašelis;ŠYPSENA;1953392509;Taip;5;0;0;5
4972;Lašelis;ŠYPSENA;1343084840;Taip;10;0;0;10
4973;Lašelis;ŠYPSENA;7471332824;Taip;11;3;0;14
4974;Lašelis;ŠYPSENA;4062516422;Taip;0;6;0;6
4975;Lašelis;ŠYPSENA;6492909546;Taip;0;9;0;9
4976;Lašelis;ŠYPSENA;8324581018;Ne;10;2;1;13
4977;Lašelis;ŠYPSENA;3741905080;Taip;0;0;15;15
4978;Lašelis;NYKŠTUKAI;1614647892;Taip;0;5;1;6
4979;Lašelis;NYKŠTUKAI;8181369424;Taip;0;0;1;1
4980;Lašelis;NYKŠTUKAI;1534313851;Ne;1;8;0;9
4981;Lašelis;NYKŠTUKAI;1099685342;Taip;0;12;0;12
4982;Lašelis;NYKŠTUKAI;1917927039;Taip;5;11;0;16
4983;Lašelis;NYKŠTUKAI;3447120578;Taip;7;1;2;10
4984;Lašelis;NYKŠTUKAI;1833121579;Taip;0;1;0;1
4985;Lašelis;NYKŠTUKAI;1635550414;Taip;0;15;0;15
4986;Lašelis;NYKŠTUKAI;7047619741;Taip;11;5;0;16
4987;Lašelis;NYKŠTUKAI;85641710509;Taip;0;5;15;20
4988;Lašelis;NYKŠTUKAI;1742951527;Taip;0;1;1;2
4989;Lašelis;NYKŠTUKAI;28071639285;Taip;12;0;0;12
4990;Lašelis;NYKŠTUKAI;87745170593;Taip;0;5;0;5
4991;Lašelis;NYKŠTUKAI;37726695989;Taip;0;13;0;13
4992;Lašelis;NYKŠTUKAI;75224154074;Taip;5;5;0;10
4993;Lašelis;NYKŠTUKAI;29417065142;Taip;0;10;0;10
4994;Lašelis;NYKŠTUKAI;1711262987;Taip;0;6;0;6
4995;Lašelis;NYKŠTUKAI;73391370015;Taip;0;13;0;13
4996;Lašelis;SAULUTĖ;17105970545;Taip;0;5;0;5
4997;Lašelis;SAULUTĖ;28319122501;Taip;7;11;0;18
4998;Lašelis;SAULUTĖ;18905952587;Taip;0;5;0;5
4999;Lašelis;SAULUTĖ;39887519960;Taip;13;1;0;14
5000;Lašelis;SAULUTĖ;52081356883;Taip;0;10;0;10
5001;Lašelis;SAULUTĖ;3071193513;Taip;0;1;0;1
5002;Lašelis;SAULUTĖ;19712015840;Taip;0;10;0;10
5003;Lašelis;SAULUTĖ;72661430712;Taip;7;10;0;17
5004;Lašelis;SAULUTĖ;94756490716;Taip;0;5;0;5
5005;Lašelis;SAULUTĖ;1124839579;Taip;0;3;0;3
5006;Lašelis;SAULUTĖ;39661215923;Taip;0;1;0;1
5007;Lašelis;SAULUTĖ;36907557289;Ne;0;1;0;1
5008;Lašelis;SAULUTĖ;92897887533;Ne;0;0;3;3
5009;Lašelis;SAULUTĖ;85978955807;Taip;7;5;0;12
5010;Lašelis;SAULUTĖ;20798875600;Ne;0;15;0;15
5011;Lašelis;SAULUTĖ;3505668718;Taip;0;11;0;11
5012;Lašelis;SAULUTĖ;72124622387;Taip;11;6;0;17
5013;Lašelis;BORUŽĖLĖS;1085400709;Taip;0;5;0;5
5014;Lašelis;BORUŽĖLĖS;7998812497;Taip;15;5;0;20
5015;Lašelis;BORUŽĖLĖS;2912232814;Taip;9;0;4;13
5016;Lašelis;BORUŽĖLĖS;6127747445;Taip;0;4;0;4
5017;Lašelis;BORUŽĖLĖS;1777442316;Taip;0;10;0;10
5018;Lašelis;BORUŽĖLĖS;6553762186;Taip;8;2;0;10
5019;Lašelis;BORUŽĖLĖS;3867799187;Taip;0;10;0;10
5020;Lašelis;BORUŽĖLĖS;3982877012;Taip;0;0;6;6
5021;Lašelis;BORUŽĖLĖS;6669130831;Taip;0;1;0;1
5022;Lašelis;BORUŽĖLĖS;5556821953;Taip;0;6;0;6
5023;Lašelis;BORUŽĖLĖS;1646912457;Taip;5;0;0;5
5024;Lašelis;BORUŽĖLĖS;1886540733;Taip;10;0;0;10
5025;Lašelis;BORUŽĖLĖS;4151582358;Taip;0;11;0;11
5026;Lašelis;BORUŽĖLĖS;7802622810;Taip;15;0;0;15
5027;Lašelis;SKRUZDELIUKAI;3297005183;Taip;3;0;2;5
5028;Lašelis;SKRUZDELIUKAI;8318512396;Taip;10;0;0;10
5029;Lašelis;SKRUZDELIUKAI;1244168190;Taip;0;16;1;17
5030;Lašelis;SKRUZDELIUKAI;2034007263;Taip;10;0;1;11
5031;Lašelis;SKRUZDELIUKAI;7367305924;Taip;2;0;4;6
5032;Lašelis;SKRUZDELIUKAI;7657786815;Taip;15;0;0;15
5033;Lašelis;SKRUZDELIUKAI;7107685761;Taip;7;3;1;11
5034;Lašelis;SKRUZDELIUKAI;3495676199;Taip;0;7;0;7
5035;Lašelis;SKRUZDELIUKAI;3843163586;Taip;14;0;0;14
5036;Lašelis;SKRUZDELIUKAI;6304391719;Taip;5;0;0;5
5037;Lazdynėlis;BITUTĖS;75400333117;Taip;0;5;1;6
5038;Lazdynėlis;BITUTĖS;55695017411;Taip;12;0;0;12
5039;Lazdynėlis;BITUTĖS;50788636961;Taip;0;20;0;20
5040;Lazdynėlis;BITUTĖS;48328518819;Taip;0;0;6;6
5041;Lazdynėlis;BITUTĖS;90734124818;Taip;0;0;2;2
5042;Lazdynėlis;BITUTĖS;83140388277;Taip;14;0;0;14
5043;Lazdynėlis;BITUTĖS;69220585579;Taip;3;5;1;9
5044;Lazdynėlis;BITUTĖS;79847018203;Taip;0;5;1;6
5045;Lazdynėlis;BITUTĖS;76733730112;Taip;0;0;6;6
5046;Lazdynėlis;BITUTĖS;93770511704;Taip;0;2;2;4
5047;Lazdynėlis;BITUTĖS;95546662727;Taip;0;7;5;12
5048;Lazdynėlis;BITUTĖS;82313332357;Taip;0;20;0;20
5049;Lazdynėlis;BITUTĖS;57393413722;Taip;0;5;0;5
5050;Lazdynėlis;BITUTĖS;28670815274;Taip;0;5;1;6
5051;Lazdynėlis;BITUTĖS;57891137452;Taip;0;5;0;5
5052;Lazdynėlis;BITUTĖS;14797154110;Taip;0;5;1;6
5053;Lazdynėlis;BITUTĖS;58991424753;Taip;3;6;0;9
5054;Lazdynėlis;BITUTĖS;8954195210;Taip;0;5;0;5
5055;Lazdynėlis;BITUTĖS;49407698116;Taip;10;0;0;10
5056;Lazdynėlis;BITUTĖS;8012374474;Taip;0;7;0;7
5057;Lazdynėlis;BITUTĖS;8245694943;Taip;0;1;0;1
5058;Lazdynėlis;BITUTĖS;99629193401;Taip;0;3;0;3
5059;Lazdynėlis;BITUTĖS;57522150425;Taip;0;9;0;9
5060;Lazdynėlis;EŽIUKAI;5068598385;Taip;0;2;0;2
5061;Lazdynėlis;EŽIUKAI;2491872016;Taip;0;2;0;2
5062;Lazdynėlis;EŽIUKAI;1593314326;Taip;0;5;2;7
5063;Lazdynėlis;EŽIUKAI;2041709821;Taip;0;20;0;20
5064;Lazdynėlis;EŽIUKAI;32856469893;Taip;10;1;0;11
5065;Lazdynėlis;EŽIUKAI;6542840562;Taip;5;0;0;5
5066;Lazdynėlis;EŽIUKAI;8975341347;Taip;11;0;0;11
5067;Lazdynėlis;EŽIUKAI;5301460250;Taip;20;0;0;20
5068;Lazdynėlis;EŽIUKAI;1265404063;Taip;8;0;0;8
5069;Lazdynėlis;EŽIUKAI;83586382037;Taip;0;5;0;5
5070;Lazdynėlis;EŽIUKAI;7313399153;Taip;5;0;0;5
5071;Lazdynėlis;EŽIUKAI;10727984477;Taip;0;0;4;4
5072;Lazdynėlis;EŽIUKAI;9081770664;Taip;11;0;0;11
5073;Lazdynėlis;EŽIUKAI;1479568714;Taip;16;0;0;16
5074;Lazdynėlis;EŽIUKAI;8271766964;Taip;0;20;0;20
5075;Lazdynėlis;EŽIUKAI;9668839027;Taip;0;8;0;8
5076;Lazdynėlis;EŽIUKAI;2740122426;Taip;0;20;0;20
5077;Lazdynėlis;EŽIUKAI;47861078891;Taip;5;0;0;5
5078;Lazdynėlis;EŽIUKAI;2841262230;Taip;10;5;0;15
5079;Lazdynėlis;EŽIUKAI;7499322078;Taip;9;5;0;14
5080;Lazdynėlis;EŽIUKAI;48860174942;Taip;5;7;0;12
5081;Lazdynėlis;EŽIUKAI;92889991874;Taip;7;5;0;12
5082;Lazdynėlis;EŽIUKAI;65806780298;Taip;5;5;1;11
5083;Lazdynėlis;EŽIUKAI;91720096560;Taip;6;3;0;9
5084;Lazdynėlis;BORUŽIUKAI;2168516394;Taip;0;5;0;5
5085;Lazdynėlis;BORUŽIUKAI;4961149717;Taip;0;2;0;2
5086;Lazdynėlis;BORUŽIUKAI;99475014554;Taip;3;6;2;11
5087;Lazdynėlis;BORUŽIUKAI;6156638726;Taip;0;20;0;20
5088;Lazdynėlis;BORUŽIUKAI;1321841783;Taip;10;0;0;10
5089;Lazdynėlis;BORUŽIUKAI;1055608079;Taip;0;3;0;3
5090;Lazdynėlis;BORUŽIUKAI;9570299877;Taip;0;20;0;20
5091;Lazdynėlis;BORUŽIUKAI;1715738053;Taip;5;0;0;5
5092;Lazdynėlis;BORUŽIUKAI;50390821034;Taip;0;1;0;1
5093;Lazdynėlis;BORUŽIUKAI;2112064241;Taip;3;1;0;4
5094;Lazdynėlis;BORUŽIUKAI;86740660262;Taip;0;3;0;3
5095;Lazdynėlis;BORUŽIUKAI;1207280684;Taip;0;1;0;1
5096;Lazdynėlis;BORUŽIUKAI;57448939020;Taip;3;5;0;8
5097;Lazdynėlis;BORUŽIUKAI;1789237348;Taip;0;9;0;9
5098;Lazdynėlis;BORUŽIUKAI;2105998927;Taip;4;1;0;5
5099;Lazdynėlis;BORUŽIUKAI;29288665418;Taip;20;0;0;20
5100;Lazdynėlis;BORUŽIUKAI;11379612306;Taip;0;7;0;7
5101;Lazdynėlis;BORUŽIUKAI;7237629135;Taip;12;1;0;13
5102;Lazdynėlis;BORUŽIUKAI;8945282683;Taip;0;1;0;1
5103;Lazdynėlis;BORUŽIUKAI;5838945434;Taip;0;5;0;5
5104;Lazdynėlis;BORUŽIUKAI;6230420677;Taip;0;9;0;9
5105;Lazdynėlis;KAČIUKAI;3603045321;Taip;0;5;0;5
5106;Lazdynėlis;KAČIUKAI;58490612549;Taip;0;6;1;7
5107;Lazdynėlis;KAČIUKAI;43267615847;Taip;0;5;0;5
5108;Lazdynėlis;KAČIUKAI;59588430935;Taip;2;6;4;12
5109;Lazdynėlis;KAČIUKAI;66134107213;Taip;15;5;0;20
5110;Lazdynėlis;KAČIUKAI;32336340968;Taip;2;2;0;4
5111;Lazdynėlis;KAČIUKAI;23011537816;Taip;8;0;0;8
5112;Lazdynėlis;KAČIUKAI;61642550142;Ne;0;5;0;5
5113;Lazdynėlis;KAČIUKAI;83123063983;Taip;0;3;0;3
5114;Lazdynėlis;KAČIUKAI;67819115627;Taip;5;0;0;5
5115;Lazdynėlis;KAČIUKAI;52949287680;Taip;0;6;1;7
5116;Lazdynėlis;KAČIUKAI;97795271362;Taip;10;6;0;16
5117;Lazdynėlis;KAČIUKAI;55167939220;Taip;5;1;0;6
5118;Lazdynėlis;KAČIUKAI;56747379453;Taip;0;1;0;1
5119;Lazdynėlis;KAČIUKAI;1634936961;Taip;17;3;0;20
5120;Lazdynėlis;KAČIUKAI;65438421685;Taip;10;3;0;13
5121;Lazdynėlis;KAČIUKAI;52528629956;Taip;3;6;4;13
5122;Lazdynėlis;KAČIUKAI;79445476316;Taip;10;1;0;11
5123;Lazdynėlis;KAČIUKAI;5638072847;Taip;0;0;2;2
5124;Lazdynėlis;KAČIUKAI;78302777769;Taip;5;7;0;12
5125;Lazdynėlis;KAČIUKAI;87419458418;Taip;0;6;3;9
5126;Lazdynėlis;KAČIUKAI;85340642919;Taip;10;5;0;15
5127;Lazdynėlis;KAČIUKAI;77950321376;Taip;7;0;0;7
5128;Lazdynėlis;KAČIUKAI;20331444858;Taip;0;4;5;9
5129;Lazdynėlis;KAČIUKAI;7981495545;Taip;5;15;0;20
5130;Lazdynėlis;KAČIUKAI;62600252729;Ne;0;1;0;1
5131;Lazdynėlis;VOVERIUKAI;4425724586;Taip;5;5;2;12
5132;Lazdynėlis;VOVERIUKAI;4928593615;Taip;0;5;0;5
5133;Lazdynėlis;VOVERIUKAI;6684940385;Taip;14;0;2;16
5134;Lazdynėlis;VOVERIUKAI;9187681789;Taip;11;0;1;12
5135;Lazdynėlis;VOVERIUKAI;6307407620;Taip;0;5;2;7
5136;Lazdynėlis;VOVERIUKAI;14427234202;Taip;4;0;1;5
5137;Lazdynėlis;VOVERIUKAI;1107441074;Taip;5;5;0;10
5138;Lazdynėlis;VOVERIUKAI;25596458181;Taip;0;20;0;20
5139;Lazdynėlis;VOVERIUKAI;24978945607;Taip;4;0;0;4
5140;Lazdynėlis;VOVERIUKAI;158059657;Taip;0;1;0;1
5141;Lazdynėlis;VOVERIUKAI;1852865534;Taip;15;0;0;15
5142;Lazdynėlis;VOVERIUKAI;7789345652;Taip;5;3;0;8
5143;Lazdynėlis;VOVERIUKAI;3902772678;Taip;4;5;0;9
5144;Lazdynėlis;VOVERIUKAI;8822378464;Taip;9;0;0;9
5145;Lazdynėlis;VOVERIUKAI;6863715428;Taip;5;3;0;8
5146;Lazdynėlis;VOVERIUKAI;1386686123;Taip;6;0;0;6
5147;Lazdynėlis;VOVERIUKAI;2587142646;Taip;5;0;0;5
5148;Lazdynėlis;VOVERIUKAI;2603427970;Taip;15;5;0;20
5149;Lazdynėlis;VOVERIUKAI;2441835588;Taip;0;2;0;2
5150;Lazdynėlis;VOVERIUKAI;3043350186;Taip;0;2;0;2
5151;Lazdynėlis;VOVERIUKAI;44510351979;Taip;15;0;1;16
5152;Lazdynėlis;VOVERIUKAI;6762216509;Taip;4;0;0;4
5153;Lazdynėlis;VOVERIUKAI;7965433882;Taip;0;3;0;3
5154;Lazdynėlis;VOVERIUKAI;1424382629;Taip;5;0;0;5
5155;Lazdynėlis;RIEŠUTĖLIAI;82893485399;Taip;0;6;0;6
5156;Lazdynėlis;RIEŠUTĖLIAI;53141612488;Taip;5;0;0;5
5157;Lazdynėlis;RIEŠUTĖLIAI;81489861336;Taip;0;5;0;5
5158;Lazdynėlis;RIEŠUTĖLIAI;11830560488;Taip;0;1;1;2
5159;Lazdynėlis;RIEŠUTĖLIAI;24433496244;Taip;10;4;0;14
5160;Lazdynėlis;RIEŠUTĖLIAI;99158632198;Taip;0;5;0;5
5161;Lazdynėlis;RIEŠUTĖLIAI;91895608057;Taip;17;0;0;17
5162;Lazdynėlis;RIEŠUTĖLIAI;95539787778;Taip;0;8;0;8
5163;Lazdynėlis;RIEŠUTĖLIAI;3000783343;Taip;7;0;0;7
5164;Lazdynėlis;RIEŠUTĖLIAI;75017112973;Taip;2;1;0;3
5165;Lazdynėlis;RIEŠUTĖLIAI;66392058189;Taip;6;1;0;7
5166;Lazdynėlis;RIEŠUTĖLIAI;93311489447;Taip;7;5;0;12
5167;Lazdynėlis;RIEŠUTĖLIAI;3980826951;Taip;15;0;0;15
5168;Lazdynėlis;RIEŠUTĖLIAI;8338944978;Taip;9;0;0;9
5169;Lazdynėlis;RIEŠUTĖLIAI;1712263816;Taip;19;0;0;19
5170;Lazdynėlis;RIEŠUTĖLIAI;98624254124;Taip;0;1;0;1
5171;Lazdynėlis;RIEŠUTĖLIAI;1213657708;Taip;1;1;0;2
5172;Lazdynėlis;RIEŠUTĖLIAI;1169424024;Taip;5;5;0;10
5173;Lazdynėlis;RIEŠUTĖLIAI;1257093165;Taip;7;1;0;8
5174;Lazdynėlis;RIEŠUTĖLIAI;58985240094;Taip;3;6;0;9
5175;Lazdynėlis;RIEŠUTĖLIAI;7044338769;Taip;14;0;0;14
5176;Lazdynėlis;ANČIUKAI;5888646355;Taip;0;0;15;15
5177;Lazdynėlis;ANČIUKAI;4758605343;Taip;9;0;1;10
5178;Lazdynėlis;ANČIUKAI;4842228703;Taip;7;0;0;7
5179;Lazdynėlis;ANČIUKAI;3678422730;Taip;3;0;2;5
5180;Lazdynėlis;ANČIUKAI;8295967906;Taip;0;10;2;12
5181;Lazdynėlis;ANČIUKAI;7076664657;Taip;7;0;0;7
5182;Lazdynėlis;ANČIUKAI;7864896721;Taip;10;0;4;14
5183;Lazdynėlis;ANČIUKAI;8435203145;Taip;17;0;0;17
5184;Lazdynėlis;ANČIUKAI;4779025603;Taip;0;0;16;16
5185;Lazdynėlis;ANČIUKAI;79583491543;Taip;0;14;0;14
5186;Lazdynėlis;ANČIUKAI;2998606948;Taip;0;20;0;20
5187;Lazdynėlis;ANČIUKAI;9886856760;Taip;0;20;0;20
5188;Lazdynėlis;ANČIUKAI;3062408541;Taip;0;20;0;20
5189;Lazdynėlis;ANČIUKAI;7941793866;Taip;10;5;0;15
5190;Lazdynėlis;ANČIUKAI;3667994076;Taip;0;20;0;20
5191;Lazdynėlis;ANČIUKAI;6762312809;Taip;10;0;2;12
5192;Lazdynėlis;ANČIUKAI;9881554733;Taip;8;0;0;8
5193;Lazdynėlis;ANČIUKAI;7242681767;Taip;12;0;1;13
5194;Lazdynėlis;ANČIUKAI;5796381191;Taip;0;20;0;20
5195;Lazdynėlis;ANČIUKAI;5708643953;Taip;4;0;0;4
5196;Lazdynėlis;GUDRUČIAI;46106429615;Taip;4;0;0;4
5197;Lazdynėlis;GUDRUČIAI;11183641643;Taip;9;0;0;9
5198;Lazdynėlis;GUDRUČIAI;1543682603;Taip;5;0;0;5
5199;Lazdynėlis;GUDRUČIAI;6079498859;Ne;0;5;1;6
5200;Lazdynėlis;GUDRUČIAI;96599967318;Taip;4;4;5;13
5201;Lazdynėlis;GUDRUČIAI;16456265624;Taip;0;6;0;6
5202;Lazdynėlis;GUDRUČIAI;92885300680;Ne;0;20;0;20
5203;Lazdynėlis;GUDRUČIAI;44974714364;Taip;0;0;3;3
5204;Lazdynėlis;GUDRUČIAI;57304690488;Taip;2;0;0;2
5205;Lazdynėlis;GUDRUČIAI;57619129301;Taip;0;11;0;11
5206;Lazdynėlis;GUDRUČIAI;64086512959;Taip;9;0;0;9
5207;Lazdynėlis;GUDRUČIAI;56719158862;Taip;10;1;0;11
5208;Lazdynėlis;GUDRUČIAI;76657029807;Taip;8;5;0;13
5209;Lazdynėlis;GUDRUČIAI;41094911675;Taip;1;5;0;6
5210;Lazdynėlis;GUDRUČIAI;70505428445;Taip;0;5;0;5
5211;Lazdynėlis;GUDRUČIAI;1349582895;Taip;5;0;0;5
5212;Lazdynėlis;GUDRUČIAI;47140772153;Taip;0;0;2;2
5213;Lazdynėlis;GUDRUČIAI;34657435789;Taip;0;9;0;9
5214;Lazdynėlis;GUDRUČIAI;62863155757;Taip;0;5;0;5
5215;Lazdynėlis;GUDRUČIAI;34619798427;Taip;2;6;0;8
5216;Lazdynėlis;GUDRUČIAI;1909075641;Taip;9;0;0;9
5217;Lazdynėlis;GUDRUČIAI;2496563388;Taip;5;6;0;11
5218;Lazdynėlis;GUDRUČIAI;8704566189;Taip;12;0;0;12
5219;Lazdynėlis;GUDRUČIAI;41929529092;Taip;0;14;0;14
5220;Lazdynėlis;MEŠKIUKAI;2013752858;Taip;5;15;0;20
5221;Lazdynėlis;MEŠKIUKAI;2586187455;Taip;9;10;0;19
5222;Lazdynėlis;MEŠKIUKAI;6038907328;Taip;0;16;0;16
5223;Lazdynėlis;MEŠKIUKAI;2802505435;Taip;3;0;1;4
5224;Lazdynėlis;MEŠKIUKAI;2032759165;Taip;0;5;1;6
5225;Lazdynėlis;MEŠKIUKAI;4142277927;Taip;10;0;0;10
5226;Lazdynėlis;MEŠKIUKAI;2044188250;Taip;0;20;0;20
5227;Lazdynėlis;MEŠKIUKAI;1450181711;Taip;10;0;0;10
5228;Lazdynėlis;MEŠKIUKAI;7911328294;Taip;5;0;0;5
5229;Lazdynėlis;MEŠKIUKAI;9761942869;Taip;0;20;0;20
5230;Lazdynėlis;MEŠKIUKAI;6557165567;Taip;5;15;0;20
5231;Lazdynėlis;MEŠKIUKAI;5557752248;Taip;0;20;0;20
5232;Lazdynėlis;MEŠKIUKAI;4545757725;Taip;0;20;0;20
5233;Lazdynėlis;MEŠKIUKAI;8159928299;Taip;4;0;0;4
5234;Lazdynėlis;MEŠKIUKAI;5030400578;Taip;5;5;0;10
5235;Lazdynėlis;MEŠKIUKAI;1574847460;Taip;0;20;0;20
5236;Lazdynėlis;MEŠKIUKAI;4462819848;Taip;9;0;0;9
5237;Lazdynėlis;MEŠKIUKAI;1748260780;Taip;0;20;0;20
5238;Lazdynėlis;MEŠKIUKAI;8008332680;Taip;3;5;3;11
5239;Lazdynėlis;MEŠKIUKAI;4826167852;Taip;0;20;0;20
5240;Linelis;Giliukai;85241351404;Ne;7;0;2;9
5241;Linelis;Giliukai;18406137746;Taip;7;0;0;7
5242;Linelis;Giliukai;29074930927;Taip;0;11;0;11
5243;Linelis;Giliukai;1539102468;Taip;13;0;1;14
5244;Linelis;Giliukai;79543604124;Taip;3;0;3;6
5245;Linelis;Giliukai;5903547677;Taip;4;1;0;5
5246;Linelis;Giliukai;3300710386;Taip;7;0;0;7
5247;Linelis;Giliukai;1505058152;Taip;15;5;0;20
5248;Linelis;Giliukai;92658776822;Taip;0;13;0;13
5249;Linelis;Giliukai;4644771654;Taip;18;1;0;19
5250;Linelis;Giliukai;11026646292;Taip;0;0;4;4
5251;Linelis;Giliukai;94514045159;Taip;11;6;0;17
5252;Linelis;Giliukai;68089107580;Taip;8;1;0;9
5253;Linelis;Giliukai;18847368957;Taip;20;0;0;20
5254;Linelis;Giliukai;1646521870;Taip;0;5;13;18
5255;Linelis;Giliukai;1270931913;Taip;3;5;2;10
5256;Linelis;Giliukai;1237521453;Taip;0;1;2;3
5257;Linelis;Giliukai;53442382594;Taip;8;0;0;8
5258;Linelis;Giliukai;87947273588;Taip;5;1;0;6
5259;Linelis;Giliukai;93959783827;Taip;0;6;2;8
5260;Linelis;Giliukai;1270843542;Taip;0;5;2;7
5261;Linelis;Giliukai;1159267747;Taip;7;5;0;12
5262;Linelis;Saulutė;39379678474;Taip;3;0;3;6
5263;Linelis;Saulutė;67550509307;Taip;0;6;3;9
5264;Linelis;Saulutė;50135757374;Taip;0;2;0;2
5265;Linelis;Saulutė;88082442940;Taip;0;7;0;7
5266;Linelis;Saulutė;3721941885;Taip;0;6;0;6
5267;Linelis;Saulutė;78794214074;Taip;0;6;0;6
5268;Linelis;Saulutė;39302486335;Taip;0;1;0;1
5269;Linelis;Saulutė;76034696439;Taip;0;1;0;1
5270;Linelis;Saulutė;77154624822;Taip;0;2;1;3
5271;Linelis;Saulutė;54594020356;Taip;0;0;8;8
5272;Linelis;Saulutė;4425214681;Taip;5;1;0;6
5273;Linelis;Saulutė;68038417200;Taip;6;6;1;13
5274;Linelis;Saulutė;23823598531;Taip;0;2;0;2
5275;Linelis;Saulutė;26545201411;Taip;0;5;1;6
5276;Linelis;Saulutė;91181408578;Taip;0;5;3;8
5277;Linelis;Saulutė;74841087302;Taip;5;6;0;11
5278;Linelis;Saulutė;44313943197;Ne;5;2;0;7
5279;Linelis;Saulutė;30874840026;Taip;12;1;0;13
5280;Linelis;Saulutė;13906245933;Taip;0;5;0;5
5281;Linelis;Saulutė;90100555876;Taip;3;6;0;9
5282;Linelis;Saulutė;62954795489;Taip;0;5;6;11
5283;Linelis;Saulutė;60507620097;Taip;0;3;4;7
5284;Linelis;Saulutė;1478318177;Taip;3;3;0;6
5285;Linelis;Saulutė;13522521866;Taip;0;6;0;6
5286;Linelis;Nykštukai;58467930454;Taip;5;8;0;13
5287;Linelis;Nykštukai;38426234048;Taip;8;0;0;8
5288;Linelis;Nykštukai;1526473615;Taip;4;0;0;4
5289;Linelis;Nykštukai;61862257310;Taip;0;0;1;1
5290;Linelis;Nykštukai;1891722948;Taip;6;1;2;9
5291;Linelis;Nykštukai;1148540808;Taip;3;1;4;8
5292;Linelis;Nykštukai;4443285231;Taip;0;5;2;7
5293;Linelis;Nykštukai;37069004807;Taip;0;3;1;4
5294;Linelis;Nykštukai;5075219728;Taip;0;5;1;6
5295;Linelis;Nykštukai;8339073780;Taip;5;0;2;7
5296;Linelis;Nykštukai;5302605429;Taip;0;1;6;7
5297;Linelis;Nykštukai;7530950218;Taip;5;1;1;7
5298;Linelis;Nykštukai;71647031404;Taip;5;0;2;7
5299;Linelis;Nykštukai;1194624252;Taip;8;0;3;11
5300;Linelis;Nykštukai;46788785414;Taip;20;0;0;20
5301;Linelis;Nykštukai;3483401448;Taip;17;0;1;18
5302;Linelis;Nykštukai;2391319590;Taip;5;0;1;6
5303;Linelis;Nykštukai;9666785036;Taip;0;3;4;7
5304;Linelis;Nykštukai;8095635609;Taip;0;3;4;7
5305;Linelis;Nykštukai;1887737859;Taip;3;0;1;4
5306;Markučiai;Žirniukų;13358445982;Taip;0;5;1;6
5307;Markučiai;Žirniukų;4934200922;Taip;10;2;0;12
5308;Markučiai;Žirniukų;89393452327;Taip;8;0;2;10
5309;Markučiai;Žirniukų;9506953554;Taip;0;13;1;14
5310;Markučiai;Žirniukų;61354140820;Taip;0;4;0;4
5311;Markučiai;Žirniukų;86073430849;Taip;9;5;0;14
5312;Markučiai;Žirniukų;23712199138;Taip;2;1;0;3
5313;Markučiai;Žirniukų;59514770545;Taip;11;0;0;11
5314;Markučiai;Žirniukų;68178936347;Taip;14;2;0;16
5315;Markučiai;Žirniukų;62276512687;Taip;3;0;0;3
5316;Markučiai;Žirniukų;95776655287;Taip;12;0;0;12
5317;Markučiai;Žirniukų;1193600084;Taip;5;8;0;13
5318;Markučiai;Žirniukų;9326053563;Taip;7;1;1;9
5319;Markučiai;Žirniukų;3498150320;Taip;8;0;1;9
5320;Markučiai;Žirniukų;1813116125;Taip;0;13;1;14
5321;Markučiai;Žirniukų;1150675918;Taip;10;1;0;11
5322;Markučiai;Žirniukų;95347461846;Taip;0;7;0;7
5323;Markučiai;Žirniukų;1962169822;Taip;0;1;0;1
5324;Markučiai;Žirniukų;4511936094;Taip;2;5;2;9
5325;Markučiai;Nykštukų;46647877230;Taip;9;6;0;15
5326;Markučiai;Nykštukų;37101160556;Taip;0;3;2;5
5327;Markučiai;Nykštukų;92394309416;Taip;0;5;4;9
5328;Markučiai;Nykštukų;5026941590;Taip;0;3;0;3
5329;Markučiai;Nykštukų;81140027425;Taip;0;4;3;7
5330;Markučiai;Nykštukų;6915912992;Taip;0;5;4;9
5331;Markučiai;Nykštukų;52920975294;Taip;0;0;1;1
5332;Markučiai;Nykštukų;88304161598;Taip;0;4;0;4
5333;Markučiai;Nykštukų;1828510990;Taip;0;0;2;2
5334;Markučiai;Nykštukų;76003071176;Taip;6;5;0;11
5335;Markučiai;Nykštukų;7578995182;Taip;0;14;0;14
5336;Markučiai;Nykštukų;1464123752;Taip;0;2;0;2
5337;Markučiai;Nykštukų;1937352406;Taip;0;1;0;1
5338;Markučiai;Nykštukų;1821127640;Taip;0;1;0;1
5339;Markučiai;Nykštukų;6639579832;Taip;12;0;0;12
5340;Markučiai;Nykštukų;9985442003;Taip;0;7;0;7
5341;Markučiai;Nykštukų;1507368475;Taip;15;3;2;20
5342;Markučiai;Nykštukų;1817367317;Taip;4;6;0;10
5343;Markučiai;Nykštukų;5954207590;Taip;11;0;0;11
5344;Markučiai;Pelėdžiukų;1586644788;Taip;4;0;4;8
5345;Markučiai;Pelėdžiukų;2539130198;Taip;11;0;0;11
5346;Markučiai;Pelėdžiukų;66953564222;Taip;0;5;1;6
5347;Markučiai;Pelėdžiukų;99878848764;Taip;0;0;1;1
5348;Markučiai;Pelėdžiukų;6430378111;Taip;0;1;0;1
5349;Markučiai;Pelėdžiukų;40039975519;Taip;1;4;0;5
5350;Markučiai;Pelėdžiukų;47402355544;Taip;0;5;0;5
5351;Markučiai;Pelėdžiukų;62012358431;Taip;1;6;3;10
5352;Markučiai;Pelėdžiukų;35937680002;Taip;0;10;0;10
5353;Markučiai;Pelėdžiukų;80867943870;Taip;11;0;0;11
5354;Markučiai;Pelėdžiukų;86596936099;Taip;0;10;0;10
5355;Markučiai;Pelėdžiukų;29403750068;Taip;0;5;2;7
5356;Markučiai;Pelėdžiukų;37310130818;Taip;0;13;0;13
5357;Markučiai;Pelėdžiukų;52599782800;Taip;0;15;0;15
5358;Markučiai;Pelėdžiukų;1482031262;Taip;0;6;0;6
5359;Markučiai;Pelėdžiukų;95026191001;Taip;5;5;3;13
5360;Markučiai;Pelėdžiukų;28059558537;Taip;7;5;0;12
5361;Markučiai;Pelėdžiukų;4938918595;Taip;0;5;0;5
5362;Markučiai;Pelėdžiukų;54616789785;Taip;0;0;1;1
5363;Markučiai;Pelėdžiukų;981774400;Taip;0;1;0;1
5364;Markučiai;Pelėdžiukų;1155718131;Taip;0;13;0;13
5365;Markučiai;Pelėdžiukų;18563720509;Taip;0;5;4;9
5366;Markučiai;Boružėlių;9059302464;Taip;0;2;6;8
5367;Markučiai;Boružėlių;9220749889;Taip;3;0;2;5
5368;Markučiai;Boružėlių;5752762229;Taip;0;2;6;8
5369;Markučiai;Boružėlių;4383421917;Taip;0;4;0;4
5370;Markučiai;Boružėlių;9789274040;Taip;5;1;1;7
5371;Markučiai;Boružėlių;1171899107;Taip;0;10;0;10
5372;Markučiai;Boružėlių;8092642447;Taip;0;1;2;3
5373;Markučiai;Boružėlių;8078777204;Taip;0;4;0;4
5374;Markučiai;Boružėlių;8605357678;Taip;0;3;3;6
5375;Markučiai;Boružėlių;3755794133;Taip;10;5;0;15
5376;Markučiai;Boružėlių;5902165968;Taip;0;0;2;2
5377;Markučiai;Bitučių;4653663237;Taip;12;1;1;14
5378;Markučiai;Bitučių;1720541082;Taip;8;0;0;8
5379;Markučiai;Bitučių;8792524832;Taip;11;5;0;16
5380;Markučiai;Bitučių;9518247571;Taip;5;1;5;11
5381;Markučiai;Bitučių;4836298058;Taip;5;0;0;5
5382;Markučiai;Bitučių;9027071539;Taip;8;1;0;9
5383;Markučiai;Bitučių;8748794886;Taip;0;0;6;6
5384;Markučiai;Bitučių;5727655114;Taip;0;0;3;3
5385;Markučiai;Bitučių;6740434675;Taip;5;0;0;5
5386;Markučiai;Bitučių;6707310242;Taip;7;0;3;10
5387;Markučiai;Bitučių;2256262371;Taip;15;5;0;20
5388;Markučiai;Bitučių;7387460586;Taip;0;5;0;5
5389;Markučiai;Bitučių;8950442843;Taip;16;0;1;17
5390;Markučiai;Bitučių;6260010822;Taip;19;0;1;20
5391;Markučiai;Drugelių;2851424931;Taip;0;2;0;2
5392;Markučiai;Drugelių;1719927769;Taip;0;1;1;2
5393;Markučiai;Drugelių;1411292558;Taip;10;0;0;10
5394;Markučiai;Drugelių;63211076619;Taip;0;2;2;4
5395;Markučiai;Drugelių;2608111078;Taip;0;2;2;4
5396;Markučiai;Drugelių;61666612833;Taip;2;1;0;3
5397;Markučiai;Drugelių;20261053601;Taip;2;1;0;3
5398;Markučiai;Drugelių;4573605085;Taip;0;1;0;1
5399;Markučiai;Drugelių;24315961901;Taip;2;3;3;8
5400;Markučiai;Drugelių;45698891062;Taip;0;0;1;1
5401;Markučiai;Drugelių;9028932081;Taip;0;10;2;12
5402;Markučiai;Drugelių;9019827941;Taip;0;0;1;1
5403;Markučiai;Drugelių;11203825718;Taip;0;9;0;9
5404;Markučiai;Drugelių;7538681006;Taip;5;9;5;19
5405;Markučiai;Drugelių;7194049189;Taip;0;3;2;5
5406;Markučiai;Drugelių;1964223995;Taip;12;0;0;12
5407;Markučiai;Drugelių;23081602011;Taip;0;2;8;10
5408;Markučiai;Skruzdėliukų;1471334430;Taip;10;3;0;13
5409;Markučiai;Skruzdėliukų;9825799013;Ne;0;8;0;8
5410;Markučiai;Skruzdėliukų;8803226424;Taip;6;2;2;10
5411;Markučiai;Skruzdėliukų;20702694553;Taip;0;5;0;5
5412;Markučiai;Skruzdėliukų;55093673733;Taip;5;2;2;9
5413;Markučiai;Skruzdėliukų;39971140989;Taip;12;0;0;12
5414;Markučiai;Skruzdėliukų;54732351634;Taip;5;5;2;12
5415;Markučiai;Skruzdėliukų;1631270056;Taip;0;2;0;2
5416;Markučiai;Skruzdėliukų;1419433247;Taip;5;11;0;16
5417;Markučiai;Skruzdėliukų;1089500743;Taip;0;10;4;14
5418;Markučiai;Skruzdėliukų;2939795063;Taip;10;1;0;11
5419;Markučiai;Skruzdėliukų;9285037135;Taip;12;2;1;15
5420;Markučiai;Skruzdėliukų;1699369138;Taip;4;3;6;13
5421;Markučiai;Skruzdėliukų;1881218133;Taip;5;5;0;10
5422;Markučiai;Skruzdėliukų;1200278823;Taip;0;13;1;14
5423;Markučiai;Skruzdėliukų;8863238710;Taip;7;0;4;11
5424;Markučiai;Skruzdėliukų;68193563408;Taip;0;5;2;7
5425;Markučiai;Skruzdėliukų;92854605649;Taip;5;1;1;7
5426;Markučiai;Skruzdėliukų;7114409929;Taip;8;0;0;8
5427;Markučiai;Skruzdėliukų;1529531638;Taip;5;0;3;8
5428;Markučiai;ZUIKUČIŲ;82320812575;Taip;15;0;0;15
5429;Markučiai;ZUIKUČIŲ;4861535057;Taip;5;0;0;5
5430;Markučiai;ZUIKUČIŲ;2045207175;Taip;12;0;0;12
5431;Markučiai;ZUIKUČIŲ;11751635395;Taip;0;12;1;13
5432;Markučiai;ZUIKUČIŲ;1184908076;Taip;8;9;0;17
5433;Markučiai;ZUIKUČIŲ;7729045227;Taip;0;0;1;1
5434;Markučiai;ZUIKUČIŲ;8061880631;Taip;5;0;0;5
5435;Markučiai;ZUIKUČIŲ;1392582514;Taip;5;0;0;5
5436;Markučiai;ZUIKUČIŲ;7691410556;Taip;0;7;0;7
5437;Markučiai;ZUIKUČIŲ;7969520467;Taip;9;0;0;9
5438;Markučiai;ZUIKUČIŲ;6453095915;Taip;2;0;0;2
5439;Markučiai;ZUIKUČIŲ;6808291628;Taip;0;16;0;16
5440;Markučiai;ZUIKUČIŲ;3794643964;Taip;5;6;0;11
5441;Markučiai;ZUIKUČIŲ;91228262895;Taip;0;5;0;5
5442;Markučiai;ZUIKUČIŲ;7481923902;Taip;0;3;2;5
5443;Markučiai;ZUIKUČIŲ;1025406111;Taip;0;16;0;16
5444;Markučiai;ZUIKUČIŲ;5749873170;Taip;9;3;0;12
5445;Markučiai;ZUIKUČIŲ;9581578352;Taip;20;0;0;20
5446;Markučiai;ŽIOGELIŲ;5099997904;Taip;0;0;5;5
5447;Markučiai;ŽIOGELIŲ;3163226803;Taip;2;1;0;3
5448;Markučiai;ŽIOGELIŲ;1244026489;Taip;11;4;1;16
5449;Markučiai;ŽIOGELIŲ;76025616287;Taip;7;7;0;14
5450;Markučiai;ŽIOGELIŲ;1323922187;Taip;17;2;0;19
5451;Markučiai;ŽIOGELIŲ;54892037118;Taip;3;3;1;7
5452;Markučiai;ŽIOGELIŲ;1549653580;Taip;0;15;0;15
5453;Markučiai;ŽIOGELIŲ;1054802708;Taip;7;6;0;13
5454;Markučiai;ŽIOGELIŲ;67074776419;Taip;0;5;0;5
5455;Markučiai;ŽIOGELIŲ;1007919702;Taip;9;5;0;14
5456;Markučiai;ŽIOGELIŲ;1923521405;Taip;18;0;0;18
5457;Markučiai;ŽIOGELIŲ;1164386108;Taip;18;0;0;18
5458;Markučiai;ŽIOGELIŲ;7850311496;Taip;2;5;2;9
5459;Markučiai;ŽIOGELIŲ;2169583290;Taip;0;12;0;12
5460;Markučiai;ŽIOGELIŲ;3340385503;Taip;9;0;3;12
5461;Markučiai;ŽIOGELIŲ;4152184290;Taip;0;3;0;3
5462;Markučiai;ŽIOGELIŲ;1742944578;Taip;0;2;1;3
5463;Markučiai;ŽIOGELIŲ;5224257097;Taip;0;0;18;18
5464;Markučiai;Ežiukių;1827829954;Taip;10;0;0;10
5465;Markučiai;Ežiukių;4925856706;Taip;0;5;0;5
5466;Markučiai;Ežiukių;6570638672;Taip;4;6;0;10
5467;Markučiai;Ežiukių;3771563320;Taip;4;3;0;7
5468;Markučiai;Ežiukių;1648283497;Taip;11;5;0;16
5469;Markučiai;Ežiukių;4186684938;Taip;5;3;2;10
5470;Markučiai;Ežiukių;5975331223;Taip;0;5;1;6
5471;Markučiai;Ežiukių;2687320408;Taip;7;2;0;9
5472;Markučiai;Ežiukių;1309122110;Taip;8;1;0;9
5473;Markučiai;Ežiukių;9295954145;Taip;0;1;6;7
5474;Markučiai;Ežiukių;8990923872;Taip;11;3;2;16
5475;Markučiai;Ežiukių;2738553283;Taip;15;0;1;16
5476;Markučiai;Ežiukių;3386071459;Taip;5;0;0;5
5477;Markučiai;Ežiukių;7255617408;Taip;11;3;0;14
5478;Markučiai;Ežiukių;5246980173;Taip;4;0;0;4
5479;Markučiai;Ežiukių;1599633295;Taip;8;7;0;15
5480;Markučiai;Ežiukių;6308368050;Taip;5;0;0;5
5481;Markučiai;Ežiukių;5958705106;Taip;20;0;0;20
5482;Markučiai;Ežiukių;3282845685;Taip;10;0;1;11
5483;Mažylis;"2 DARŽELIO GR.";5063094678;Taip;0;1;5;6
5484;Mažylis;"2 DARŽELIO GR.";3860760654;Taip;6;1;5;12
5485;Mažylis;"2 DARŽELIO GR.";9608529135;Taip;10;0;1;11
5486;Mažylis;"2 DARŽELIO GR.";8899463988;Taip;0;0;1;1
5487;Mažylis;"2 DARŽELIO GR.";8816413703;Taip;19;0;0;19
5488;Mažylis;"2 DARŽELIO GR.";9411559447;Taip;14;0;0;14
5489;Mažylis;"2 DARŽELIO GR.";45148418456;Taip;0;5;1;6
5490;Mažylis;"2 DARŽELIO GR.";38277640135;Taip;5;5;3;13
5491;Mažylis;"2 DARŽELIO GR.";1514640197;Taip;0;0;1;1
5492;Mažylis;"2 DARŽELIO GR.";6851169340;Taip;10;0;0;10
5493;Mažylis;"2 DARŽELIO GR.";4486742281;Taip;15;0;0;15
5494;Mažylis;"2 DARŽELIO GR.";79181926145;Taip;6;0;3;9
5495;Mažylis;"2 DARŽELIO GR.";6920129837;Taip;0;0;1;1
5496;Mažylis;"2 DARŽELIO GR.";1663347167;Taip;20;0;0;20
5497;Mažylis;"2 DARŽELIO GR.";1460572347;Taip;5;0;0;5
5498;Mažylis;"2 DARŽELIO GR.";7416381505;Taip;17;0;0;17
5499;Mažylis;"2 DARŽELIO GR.";3217527771;Taip;6;10;0;16
5500;Mažylis;"2 DARŽELIO GR.";1002832487;Taip;0;5;1;6
5501;Mažylis;"2 DARŽELIO GR.";8352202912;Taip;0;0;6;6
5502;Mažylis;"4 PRIEŠMOKYKLINĖ GR.";70526651195;Taip;0;0;2;2
5503;Mažylis;"4 PRIEŠMOKYKLINĖ GR.";6302092043;Taip;0;5;2;7
5504;Mažylis;"4 PRIEŠMOKYKLINĖ GR.";66861078627;Ne;0;5;3;8
5505;Mažylis;"4 PRIEŠMOKYKLINĖ GR.";57677251463;Taip;0;1;10;11
5506;Mažylis;"4 PRIEŠMOKYKLINĖ GR.";69106809499;Ne;0;3;6;9
5507;Mažylis;"4 PRIEŠMOKYKLINĖ GR.";5439091390;Taip;9;0;0;9
5508;Mažylis;"4 PRIEŠMOKYKLINĖ GR.";36779005815;Taip;0;1;11;12
5509;Mažylis;"4 PRIEŠMOKYKLINĖ GR.";79482905001;Taip;0;5;1;6
5510;Mažylis;"4 PRIEŠMOKYKLINĖ GR.";87616420119;Taip;5;0;1;6
5511;Mažylis;"4 PRIEŠMOKYKLINĖ GR.";33743124122;Taip;10;0;0;10
5512;Mažylis;"4 PRIEŠMOKYKLINĖ GR.";40329007615;Ne;0;5;1;6
5513;Mažylis;"4 PRIEŠMOKYKLINĖ GR.";81496635362;Taip;0;6;0;6
5514;Mažylis;"4 PRIEŠMOKYKLINĖ GR.";1102106521;Taip;0;4;5;9
5515;Mažylis;"4 PRIEŠMOKYKLINĖ GR.";54844605291;Taip;0;10;0;10
5516;Mažylis;"4 PRIEŠMOKYKLINĖ GR.";26981897418;Taip;0;12;0;12
5517;Mažylis;"4 PRIEŠMOKYKLINĖ GR.";53780435826;Taip;0;0;4;4
5518;Mažylis;"4 PRIEŠMOKYKLINĖ GR.";89877442445;Taip;0;5;1;6
5519;Mažylis;"4 PRIEŠMOKYKLINĖ GR.";5984612355;Taip;0;4;0;4
5520;Mažylis;"5 DARŽ.GR.";7774469604;Taip;0;0;3;3
5521;Mažylis;"5 DARŽ.GR.";71577274183;Taip;0;0;1;1
5522;Mažylis;"5 DARŽ.GR.";9095049088;Taip;0;0;6;6
5523;Mažylis;"5 DARŽ.GR.";1692808423;Taip;0;0;1;1
5524;Mažylis;"5 DARŽ.GR.";18640177395;Taip;0;0;1;1
5525;Mažylis;"5 DARŽ.GR.";37676161966;Taip;10;0;2;12
5526;Mažylis;"5 DARŽ.GR.";91436869919;Taip;0;0;8;8
5527;Mažylis;"5 DARŽ.GR.";74056314359;Taip;0;1;3;4
5528;Mažylis;"5 DARŽ.GR.";36307201422;Taip;0;4;1;5
5529;Mažylis;"5 DARŽ.GR.";37179412928;Taip;0;0;1;1
5530;Mažylis;"5 DARŽ.GR.";9958976870;Taip;0;1;12;13
5531;Mažylis;"5 DARŽ.GR.";56438009944;Taip;0;11;0;11
5532;Mažylis;"5 DARŽ.GR.";87637767247;Taip;0;1;4;5
5533;Mažylis;"5 DARŽ.GR.";1391395429;Taip;0;0;10;10
5534;Mažylis;"5 DARŽ.GR.";43986953632;Taip;9;2;1;12
5535;Mažylis;"5 DARŽ.GR.";8439933210;Taip;2;0;0;2
5536;Mažylis;"5 DARŽ.GR.";3436690709;Taip;0;0;4;4
5537;Mažylis;"5 DARŽ.GR.";8318476578;Taip;0;1;19;20
5538;Mažylis;"3 DARŽELIO GR.";98057700570;Taip;0;6;0;6
5539;Mažylis;"3 DARŽELIO GR.";1643460270;Taip;2;0;2;4
5540;Mažylis;"3 DARŽELIO GR.";24303144913;Taip;0;0;4;4
5541;Mažylis;"3 DARŽELIO GR.";69238700097;Taip;0;1;7;8
5542;Mažylis;"3 DARŽELIO GR.";50868656860;Taip;6;0;3;9
5543;Mažylis;"3 DARŽELIO GR.";13841546358;Taip;0;5;1;6
5544;Mažylis;"3 DARŽELIO GR.";1370723211;Taip;0;0;11;11
5545;Mažylis;"3 DARŽELIO GR.";2070067356;Ne;6;0;3;9
5546;Mažylis;"3 DARŽELIO GR.";81907805809;Taip;0;10;10;20
5547;Mažylis;"3 DARŽELIO GR.";1999937720;Taip;0;1;5;6
5548;Mažylis;"3 DARŽELIO GR.";98251642256;Taip;10;0;1;11
5549;Mažylis;"3 DARŽELIO GR.";90336289067;Taip;0;1;7;8
5550;Mažylis;"3 DARŽELIO GR.";46239142395;Taip;0;0;1;1
5551;Mažylis;"3 DARŽELIO GR.";1021183555;Taip;1;5;1;7
5552;Mažylis;"3 DARŽELIO GR.";1910064549;Taip;6;0;0;6
5553;Mažylis;"3 DARŽELIO GR.";86823456557;Taip;6;0;0;6
5554;Mažylis;"3 DARŽELIO GR.";2520667095;Taip;0;0;1;1
5555;Mažylis;"3 DARŽELIO GR.";2299288258;Taip;20;0;0;20
5556;Mažylis;"3 DARŽELIO GR.";5479496104;Taip;10;0;0;10
5557;Mažylis;"3 DARŽELIO GR.";1520251270;Taip;0;0;1;1
5558;Mažylis;"3 DARŽELIO GR.";5271395545;Taip;0;0;1;1
5559;Mažylis;"6 DARŽELIO GR.";1023886258;Taip;0;5;6;11
5560;Mažylis;"6 DARŽELIO GR.";2249845212;Taip;0;0;1;1
5561;Mažylis;"6 DARŽELIO GR.";38333694019;Taip;0;1;2;3
5562;Mažylis;"6 DARŽELIO GR.";68630915872;Taip;17;0;0;17
5563;Mažylis;"6 DARŽELIO GR.";37552673590;Taip;0;0;1;1
5564;Mažylis;"6 DARŽELIO GR.";44917962136;Taip;0;5;0;5
5565;Mažylis;"6 DARŽELIO GR.";34677678888;Ne;0;10;0;10
5566;Mažylis;"6 DARŽELIO GR.";88409362086;Taip;0;1;4;5
5567;Mažylis;"6 DARŽELIO GR.";72018918082;Taip;0;5;2;7
5568;Mažylis;"6 DARŽELIO GR.";99612915803;Taip;0;10;10;20
5569;Mažylis;"6 DARŽELIO GR.";96882209197;Taip;5;0;0;5
5570;Mažylis;"6 DARŽELIO GR.";10093289570;Ne;6;10;0;16
5571;Mažylis;"6 DARŽELIO GR.";71414598607;Taip;8;0;0;8
5572;Mažylis;"6 DARŽELIO GR.";67697608754;Taip;0;0;1;1
5573;Mažylis;"6 DARŽELIO GR.";1217081615;Taip;0;1;14;15
5574;Mažylis;"6 DARŽELIO GR.";4899739075;Taip;5;0;1;6
5575;Mažylis;"6 DARŽELIO GR.";1418120714;Taip;15;0;0;15
5576;Mažylis;"6 DARŽELIO GR.";1381948803;Taip;4;0;3;7
5577;Mažylis;"6 DARŽELIO GR.";2379352639;Taip;2;4;0;6
5578;Mažylis;"6 DARŽELIO GR.";94128544096;Taip;0;5;0;5
5579;Mažylis;"6 DARŽELIO GR.";33428832459;Taip;0;0;1;1
5580;Mažylis;"1 NAUJA (LOPŠELIS)";6854350717;Taip;0;1;9;10
5581;Mažylis;"1 NAUJA (LOPŠELIS)";5870983755;Taip;0;5;2;7
5582;Mažylis;"1 NAUJA (LOPŠELIS)";2979849055;Taip;13;0;0;13
5583;Mažylis;"1 NAUJA (LOPŠELIS)";4503734408;Taip;14;0;0;14
5584;Mažylis;"1 NAUJA (LOPŠELIS)";6162880220;Taip;10;0;0;10
5585;Mažylis;"1 NAUJA (LOPŠELIS)";9362249595;Taip;8;0;3;11
5586;Mažylis;"1 NAUJA (LOPŠELIS)";1077493584;Taip;0;1;19;20
5587;Mažylis;"1 NAUJA (LOPŠELIS)";2704741847;Taip;10;0;0;10
5588;Mažylis;"1 NAUJA (LOPŠELIS)";4798415786;Taip;10;0;0;10
5589;Mažylis;"1 NAUJA (LOPŠELIS)";2656290898;Taip;0;0;5;5
5590;Mažylis;"1 NAUJA (LOPŠELIS)";7185347381;Taip;17;0;0;17
5591;Mažylis;"1 NAUJA (LOPŠELIS)";3327673298;Taip;5;0;0;5
5592;Mažylis;"1 NAUJA (LOPŠELIS)";4280547746;Taip;8;0;1;9
5593;Mažylis;"1 NAUJA (LOPŠELIS)";9447747294;Taip;8;0;0;8
5594;Mažylis;"1 NAUJA (LOPŠELIS)";2126108232;Taip;0;0;1;1
5595;Medynėlis;BITUTĖS;1721728772;Taip;5;5;0;10
5596;Medynėlis;BITUTĖS;1870621987;Taip;5;0;0;5
5597;Medynėlis;BITUTĖS;51942577095;Taip;6;5;0;11
5598;Medynėlis;BITUTĖS;46570048371;Taip;3;1;0;4
5599;Medynėlis;BITUTĖS;42543506690;Taip;0;6;0;6
5600;Medynėlis;BITUTĖS;57858019710;Taip;0;5;1;6
5601;Medynėlis;BITUTĖS;78341557395;Taip;4;5;0;9
5602;Medynėlis;BITUTĖS;70950123240;Taip;0;2;1;3
5603;Medynėlis;BITUTĖS;13947002802;Taip;0;0;1;1
5604;Medynėlis;BITUTĖS;38838111813;Taip;8;5;0;13
5605;Medynėlis;BITUTĖS;1641742927;Ne;0;5;0;5
5606;Medynėlis;BITUTĖS;5202479867;Taip;15;0;1;16
5607;Medynėlis;BITUTĖS;83599369692;Taip;8;2;0;10
5608;Medynėlis;BITUTĖS;72334464245;Taip;0;8;0;8
5609;Medynėlis;BITUTĖS;54282609151;Taip;10;0;0;10
5610;Medynėlis;BITUTĖS;44971270687;Taip;2;0;0;2
5611;Medynėlis;BITUTĖS;39476010274;Taip;8;1;1;10
5612;Medynėlis;BITUTĖS;43383127907;Taip;0;1;0;1
5613;Medynėlis;BITUTĖS;7522506857;Taip;0;5;0;5
5614;Medynėlis;BITUTĖS;2055140361;Taip;0;15;0;15
5615;Medynėlis;BITUTĖS;1663988144;Taip;0;15;0;15
5616;Medynėlis;BITUTĖS;3684709853;Taip;0;6;1;7
5617;Medynėlis;BITUTĖS;65852278020;Taip;0;7;1;8
5618;Medynėlis;BITUTĖS;34879998108;Taip;4;6;0;10
5619;Medynėlis;DRUGELIAI;29673282359;Taip;0;7;0;7
5620;Medynėlis;DRUGELIAI;119345675;Ne;5;0;0;5
5621;Medynėlis;DRUGELIAI;56207399170;Taip;0;5;0;5
5622;Medynėlis;DRUGELIAI;77267420461;Taip;17;0;0;17
5623;Medynėlis;DRUGELIAI;64020246327;Taip;6;0;0;6
5624;Medynėlis;DRUGELIAI;82368415455;Taip;1;0;0;1
5625;Medynėlis;DRUGELIAI;22422832248;Taip;8;0;0;8
5626;Medynėlis;DRUGELIAI;69233446672;Taip;0;6;0;6
5627;Medynėlis;DRUGELIAI;96133788423;Taip;13;0;0;13
5628;Medynėlis;DRUGELIAI;1673034349;Taip;16;0;0;16
5629;Medynėlis;DRUGELIAI;98839852579;Taip;0;6;0;6
5630;Medynėlis;DRUGELIAI;22845549109;Taip;0;1;0;1
5631;Medynėlis;DRUGELIAI;20592655649;Taip;10;0;0;10
5632;Medynėlis;DRUGELIAI;64603154583;Taip;15;0;0;15
5633;Medynėlis;DRUGELIAI;27434992072;Taip;5;5;0;10
5634;Medynėlis;DRUGELIAI;4567518841;Taip;5;5;0;10
5635;Medynėlis;DRUGELIAI;68940537831;Taip;0;10;0;10
5636;Medynėlis;DRUGELIAI;75083011184;Taip;15;3;0;18
5637;Medynėlis;DRUGELIAI;5748498291;Ne;2;0;0;2
5638;Medynėlis;DRUGELIAI;55276812676;Taip;1;0;0;1
5639;Medynėlis;DRUGELIAI;76282032727;Taip;0;2;0;2
5640;Medynėlis;DRUGELIAI;97943522374;Taip;5;5;0;10
5641;Medynėlis;DRUGELIAI;1864572888;Taip;0;5;0;5
5642;Medynėlis;DRUGELIAI;1828684971;Taip;4;4;0;8
5643;Medynėlis;DRUGELIAI;30399789674;Taip;5;2;0;7
5644;Medynėlis;SKRUZDĖLIUKAI;4024866819;Taip;8;4;0;12
5645;Medynėlis;SKRUZDĖLIUKAI;2418225089;Taip;5;5;0;10
5646;Medynėlis;SKRUZDĖLIUKAI;1827495325;Taip;0;0;2;2
5647;Medynėlis;SKRUZDĖLIUKAI;6594928740;Taip;0;12;0;12
5648;Medynėlis;SKRUZDĖLIUKAI;4581683292;Taip;5;2;0;7
5649;Medynėlis;SKRUZDĖLIUKAI;4137297035;Taip;0;3;0;3
5650;Medynėlis;SKRUZDĖLIUKAI;1795479738;Taip;10;5;0;15
5651;Medynėlis;SKRUZDĖLIUKAI;5530782065;Taip;0;1;3;4
5652;Medynėlis;SKRUZDĖLIUKAI;5269927048;Taip;7;0;0;7
5653;Medynėlis;SKRUZDĖLIUKAI;2427349194;Taip;14;0;0;14
5654;Medynėlis;SKRUZDĖLIUKAI;8948133343;Taip;0;6;0;6
5655;Medynėlis;SKRUZDĖLIUKAI;7244497661;Taip;8;0;1;9
5656;Medynėlis;SKRUZDĖLIUKAI;5995034919;Taip;12;0;0;12
5657;Medynėlis;SKRUZDĖLIUKAI;8775219704;Taip;0;6;0;6
5658;Medynėlis;SKRUZDĖLIUKAI;1658457155;Taip;5;2;0;7
5659;Medynėlis;SKRUZDĖLIUKAI;33981260502;Taip;16;0;0;16
5660;Medynėlis;SKRUZDĖLIUKAI;3773215372;Taip;20;0;0;20
5661;Medynėlis;VOVERIUKAI;2834559432;Taip;0;0;1;1
5662;Medynėlis;VOVERIUKAI;2310200034;Taip;8;0;1;9
5663;Medynėlis;VOVERIUKAI;90556319090;Taip;5;0;0;5
5664;Medynėlis;VOVERIUKAI;6999562417;Taip;15;5;0;20
5665;Medynėlis;VOVERIUKAI;5586407412;Taip;8;0;1;9
5666;Medynėlis;VOVERIUKAI;7108619017;Taip;0;19;0;19
5667;Medynėlis;VOVERIUKAI;8441104709;Taip;0;3;1;4
5668;Medynėlis;VOVERIUKAI;1820113382;Taip;0;9;0;9
5669;Medynėlis;VOVERIUKAI;9304002459;Taip;0;2;1;3
5670;Medynėlis;VOVERIUKAI;5982453884;Taip;5;4;0;9
5671;Medynėlis;VOVERIUKAI;1173510831;Taip;17;1;0;18
5672;Medynėlis;VOVERIUKAI;6406459222;Taip;0;9;0;9
5673;Medynėlis;VOVERIUKAI;2335108073;Taip;11;0;0;11
5674;Medynėlis;VOVERIUKAI;4985243068;Taip;10;0;1;11
5675;Medynėlis;VOVERIUKAI;2057309788;Taip;10;0;0;10
5676;Medynėlis;VOVERIUKAI;9073514151;Taip;0;4;0;4
5677;Medynėlis;VOVERIUKAI;1750775033;Taip;16;0;0;16
5678;Medynėlis;VOVERIUKAI;9800678364;Taip;11;6;0;17
5679;Medynėlis;VOVERIUKAI;1237589979;Taip;20;0;0;20
5680;Medynėlis;MEŠKIUKAI;1434648803;Taip;10;5;0;15
5681;Medynėlis;MEŠKIUKAI;1975763240;Taip;8;3;5;16
5682;Medynėlis;MEŠKIUKAI;5347745655;Taip;0;11;0;11
5683;Medynėlis;MEŠKIUKAI;1781906016;Taip;0;11;0;11
5684;Medynėlis;MEŠKIUKAI;91658912153;Taip;9;2;0;11
5685;Medynėlis;MEŠKIUKAI;1269734734;Taip;0;15;0;15
5686;Medynėlis;MEŠKIUKAI;46445461622;Taip;0;8;0;8
5687;Medynėlis;MEŠKIUKAI;7226012217;Taip;15;5;0;20
5688;Medynėlis;MEŠKIUKAI;5007624930;Taip;6;6;0;12
5689;Medynėlis;MEŠKIUKAI;9476336240;Taip;12;2;0;14
5690;Medynėlis;MEŠKIUKAI;8629622922;Taip;0;3;2;5
5691;Medynėlis;MEŠKIUKAI;1479759021;Taip;0;2;1;3
5692;Medynėlis;MEŠKIUKAI;2389345601;Taip;10;5;4;19
5693;Medynėlis;MEŠKIUKAI;1635649525;Taip;7;0;3;10
5694;Medynėlis;MEŠKIUKAI;6479758789;Taip;7;0;1;8
5695;Medynėlis;MEŠKIUKAI;12287981032;Taip;6;2;2;10
5696;Medynėlis;MEŠKIUKAI;12812096047;Taip;16;0;0;16
5697;Medynėlis;MEŠKIUKAI;2326848026;Taip;0;6;0;6
5698;Medynėlis;MEŠKIUKAI;5924711043;Taip;10;1;0;11
5699;Medynėlis;MEŠKIUKAI;8143370943;Taip;0;3;4;7
5700;Medynėlis;MEŠKIUKAI;32683798983;Taip;5;1;1;7
5701;Medynėlis;MEŠKIUKAI;99799126572;Ne;10;5;0;15
5702;Medynėlis;PELĖDŽIUKAI;1379827887;Taip;6;5;2;13
5703;Medynėlis;PELĖDŽIUKAI;1829338208;Taip;9;1;0;10
5704;Medynėlis;PELĖDŽIUKAI;88240380945;Taip;7;0;1;8
5705;Medynėlis;PELĖDŽIUKAI;1129265551;Taip;5;9;0;14
5706;Medynėlis;PELĖDŽIUKAI;76668029492;Taip;8;1;0;9
5707;Medynėlis;PELĖDŽIUKAI;1080058205;Taip;4;5;0;9
5708;Medynėlis;PELĖDŽIUKAI;38759466139;Taip;0;5;1;6
5709;Medynėlis;PELĖDŽIUKAI;1968892466;Taip;0;5;0;5
5710;Medynėlis;PELĖDŽIUKAI;1194247621;Taip;0;10;0;10
5711;Medynėlis;PELĖDŽIUKAI;1590889839;Taip;5;8;0;13
5712;Medynėlis;PELĖDŽIUKAI;1755767517;Taip;0;7;0;7
5713;Medynėlis;PELĖDŽIUKAI;37435525923;Taip;10;0;0;10
5714;Medynėlis;PELĖDŽIUKAI;1415208530;Taip;5;14;0;19
5715;Medynėlis;PELĖDŽIUKAI;7804751416;Taip;0;17;0;17
5716;Medynėlis;PELĖDŽIUKAI;6182500688;Taip;0;11;0;11
5717;Medynėlis;PELĖDŽIUKAI;2831484614;Taip;8;0;1;9
5718;Medynėlis;PELĖDŽIUKAI;8122944228;Taip;10;6;2;18
5719;Medynėlis;PELĖDŽIUKAI;15047814683;Taip;8;0;1;9
5720;Medynėlis;PELĖDŽIUKAI;1937403950;Ne;0;5;1;6
5721;Medynėlis;PELĖDŽIUKAI;53914093216;Taip;20;0;0;20
5722;Medynėlis;BORUŽIUKAI;52437462417;Taip;0;1;0;1
5723;Medynėlis;BORUŽIUKAI;1657676226;Taip;0;5;0;5
5724;Medynėlis;BORUŽIUKAI;80165108645;Taip;0;1;0;1
5725;Medynėlis;BORUŽIUKAI;1010025777;Taip;0;7;0;7
5726;Medynėlis;BORUŽIUKAI;96544597673;Taip;10;1;0;11
5727;Medynėlis;BORUŽIUKAI;79786316561;Taip;8;0;0;8
5728;Medynėlis;BORUŽIUKAI;88550635466;Taip;0;7;0;7
5729;Medynėlis;BORUŽIUKAI;1563329598;Taip;0;6;0;6
5730;Medynėlis;BORUŽIUKAI;1611512841;Taip;5;4;0;9
5731;Medynėlis;BORUŽIUKAI;55848491611;Taip;5;1;0;6
5732;Medynėlis;BORUŽIUKAI;7061506238;Taip;16;0;0;16
5733;Medynėlis;BORUŽIUKAI;1192592678;Ne;5;4;0;9
5734;Medynėlis;BORUŽIUKAI;12150004702;Taip;8;0;0;8
5735;Medynėlis;BORUŽIUKAI;7628899696;Taip;0;9;0;9
5736;Medynėlis;BORUŽIUKAI;2044676215;Taip;2;6;0;8
5737;Medynėlis;BORUŽIUKAI;48636516521;Taip;10;0;0;10
5738;Medynėlis;EŽIUKAI;1409464952;Taip;0;2;0;2
5739;Medynėlis;EŽIUKAI;3398294520;Taip;3;0;0;3
5740;Medynėlis;EŽIUKAI;2026582294;Taip;0;4;0;4
5741;Medynėlis;EŽIUKAI;1437000615;Taip;0;12;0;12
5742;Medynėlis;EŽIUKAI;1995078812;Taip;11;0;0;11
5743;Medynėlis;EŽIUKAI;1208227740;Taip;0;5;0;5
5744;Medynėlis;EŽIUKAI;1569413876;Taip;20;0;0;20
5745;Medynėlis;EŽIUKAI;82365840630;Taip;0;1;0;1
5746;Medynėlis;EŽIUKAI;31443674861;Taip;8;2;0;10
5747;Medynėlis;EŽIUKAI;3165639252;Taip;8;3;3;14
5748;Medynėlis;EŽIUKAI;1882919126;Taip;5;3;0;8
5749;Medynėlis;EŽIUKAI;1472082682;Taip;0;2;0;2
5750;Medynėlis;EŽIUKAI;50558260808;Taip;0;3;0;3
5751;Medynėlis;EŽIUKAI;61158254770;Taip;0;7;0;7
5752;Medynėlis;EŽIUKAI;1216195798;Taip;0;14;0;14
5753;Medynėlis;EŽIUKAI;2406561273;Taip;11;0;0;11
5754;Medynėlis;EŽIUKAI;3225662051;Taip;0;5;0;5
5755;Medynėlis;EŽIUKAI;1311654913;Taip;0;1;0;1
5756;Medynėlis;EŽIUKAI;1915791061;Taip;5;5;0;10
5757;Medynėlis;ZUIKUČIAI;9825580191;Taip;6;0;0;6
5758;Medynėlis;ZUIKUČIAI;5785463517;Taip;13;1;0;14
5759;Medynėlis;ZUIKUČIAI;9184868565;Taip;15;0;0;15
5760;Medynėlis;ZUIKUČIAI;1621499650;Taip;5;5;0;10
5761;Medynėlis;ZUIKUČIAI;4222917765;Taip;5;5;0;10
5762;Medynėlis;ZUIKUČIAI;4323515017;Taip;10;0;0;10
5763;Medynėlis;ZUIKUČIAI;9866431097;Taip;20;0;0;20
5764;Medynėlis;ZUIKUČIAI;5571641847;Taip;18;1;0;19
5765;Medynėlis;ZUIKUČIAI;6681155625;Taip;20;0;0;20
5766;Medynėlis;ZUIKUČIAI;6073797962;Taip;15;0;0;15
5767;Medynėlis;ZUIKUČIAI;9355165862;Taip;5;2;0;7
5768;Medynėlis;ZUIKUČIAI;1901805808;Taip;14;0;0;14
5769;Medynėlis;ZUIKUČIAI;5784691118;Taip;14;0;0;14
5770;Medynėlis;KAČIUKAI;7740591575;Taip;4;0;0;4
5771;Medynėlis;KAČIUKAI;4100792567;Taip;0;0;1;1
5772;Medynėlis;KAČIUKAI;2086963376;Taip;10;0;0;10
5773;Medynėlis;KAČIUKAI;4217263449;Taip;0;0;1;1
5774;Medynėlis;KAČIUKAI;1587899391;Taip;20;0;0;20
5775;Medynėlis;KAČIUKAI;1056744101;Taip;0;5;5;10
5776;Medynėlis;KAČIUKAI;7455041214;Taip;10;0;0;10
5777;Medynėlis;KAČIUKAI;5267128750;Taip;0;3;0;3
5778;Medynėlis;KAČIUKAI;3554823424;Taip;16;0;0;16
5779;Medynėlis;KAČIUKAI;7272017225;Taip;5;2;0;7
5780;Medynėlis;KAČIUKAI;4092824377;Taip;8;4;0;12
5781;Medynėlis;KAČIUKAI;6826790492;Taip;0;2;1;3
5782;Medynėlis;KAČIUKAI;4488439037;Taip;2;13;5;20
5783;Medynėlis;KAČIUKAI;6101613567;Taip;15;0;0;15
5784;Medynėlis;KAČIUKAI;2234994999;Taip;0;6;0;6
5785;Medynėlis;PELIUKAI;9314893329;Taip;16;0;0;16
5786;Medynėlis;PELIUKAI;9764215406;Taip;0;0;5;5
5787;Medynėlis;PELIUKAI;3787172254;Taip;10;0;0;10
5788;Medynėlis;PELIUKAI;5051773825;Taip;18;0;0;18
5789;Medynėlis;PELIUKAI;1525185037;Taip;13;0;4;17
5790;Medynėlis;PELIUKAI;6218943275;Taip;20;0;0;20
5791;Medynėlis;PELIUKAI;1406029765;Taip;0;1;3;4
5792;Medynėlis;PELIUKAI;1162859552;Taip;0;4;0;4
5793;Medynėlis;PELIUKAI;6032067904;Taip;5;0;0;5
5794;Medynėlis;PELIUKAI;7232396755;Taip;9;2;1;12
5795;Medynėlis;PELIUKAI;9919108302;Taip;9;7;0;16
5796;Medynėlis;PELIUKAI;1463263793;Taip;0;7;0;7
5797;Medynėlis;PELIUKAI;1333848517;Taip;0;1;1;2
5798;Medynėlis;PELIUKAI;3270413614;Taip;0;1;0;1
5799;Medynėlis;PELIUKAI;5532880670;Taip;5;0;1;6
5800;Medynėlis;PELIUKAI;7651663404;Taip;0;5;1;6
5801;Medynėlis;PELIUKAI;5446430319;Taip;6;2;5;13
5802;Medynėlis;PELIUKAI;8271170887;Taip;0;3;4;7
5803;Medynėlis;PELIUKAI;4315717555;Taip;14;0;1;15
5804;Naminukas;Drugeliai;46165828687;Taip;0;8;0;8
5805;Naminukas;Drugeliai;2126348084;Taip;0;14;0;14
5806;Naminukas;Drugeliai;1462439902;Taip;0;1;0;1
5807;Naminukas;Drugeliai;85754834119;Taip;0;0;1;1
5808;Naminukas;Drugeliai;66842454987;Taip;8;0;0;8
5809;Naminukas;Drugeliai;91504585368;Taip;0;5;3;8
5810;Naminukas;Drugeliai;1315517694;Taip;5;0;0;5
5811;Naminukas;Drugeliai;93286140513;Taip;0;5;8;13
5812;Naminukas;Drugeliai;10134368426;Taip;0;9;0;9
5813;Naminukas;Drugeliai;2126839560;Taip;8;5;1;14
5814;Naminukas;Drugeliai;1355495217;Taip;5;5;1;11
5815;Naminukas;Drugeliai;7291023483;Taip;0;4;0;4
5816;Naminukas;Drugeliai;27189261329;Taip;5;0;0;5
5817;Naminukas;Drugeliai;34296400556;Taip;10;5;0;15
5818;Naminukas;Drugeliai;19432091931;Taip;2;2;0;4
5819;Naminukas;Drugeliai;90672353258;Taip;0;13;0;13
5820;Naminukas;Drugeliai;15608850480;Taip;0;1;0;1
5821;Naminukas;Drugeliai;8716638124;Taip;5;6;0;11
5822;Naminukas;Drugeliai;2967647412;Taip;5;1;2;8
5823;Naminukas;Drugeliai;5817578784;Taip;0;0;5;5
5824;Naminukas;Drugeliai;5822184150;Taip;0;0;5;5
5825;Naminukas;Drugeliai;7440490894;Taip;0;11;0;11
5826;Naminukas;Bitutės;8012095082;Taip;20;0;0;20
5827;Naminukas;Bitutės;53746114607;Taip;0;12;0;12
5828;Naminukas;Bitutės;9541388086;Taip;0;1;0;1
5829;Naminukas;Bitutės;4419568254;Taip;0;5;0;5
5830;Naminukas;Bitutės;1956749138;Taip;2;7;0;9
5831;Naminukas;Bitutės;6503569633;Taip;3;3;3;9
5832;Naminukas;Bitutės;3192885665;Taip;5;5;2;12
5833;Naminukas;Bitutės;9530232649;Taip;6;2;0;8
5834;Naminukas;Bitutės;8131328042;Taip;0;14;0;14
5835;Naminukas;Bitutės;2769848640;Taip;20;0;0;20
5836;Naminukas;Bitutės;7176287699;Taip;13;0;0;13
5837;Naminukas;Bitutės;7888950723;Taip;1;3;2;6
5838;Naminukas;Bitutės;1710002948;Taip;0;3;0;3
5839;Naminukas;Bitutės;5610993611;Taip;0;5;2;7
5840;Naminukas;Bitutės;3994190066;Taip;0;8;0;8
5841;Naminukas;Bitutės;6526207235;Taip;4;6;0;10
5842;Naminukas;Bitutės;9600303816;Taip;0;4;0;4
5843;Naminukas;Bitutės;5244682030;Taip;0;4;0;4
5844;Naminukas;Bitutės;9501202207;Taip;10;2;0;12
5845;Naminukas;Paukšteliai;92882855386;Taip;0;0;1;1
5846;Naminukas;Paukšteliai;37525846039;Taip;0;5;0;5
5847;Naminukas;Paukšteliai;2126182508;Taip;0;12;0;12
5848;Naminukas;Paukšteliai;3603079488;Taip;10;2;2;14
5849;Naminukas;Paukšteliai;1870907311;Taip;10;5;0;15
5850;Naminukas;Paukšteliai;69952843049;Taip;6;2;3;11
5851;Naminukas;Paukšteliai;59473696226;Taip;5;2;0;7
5852;Naminukas;Paukšteliai;39747242234;Taip;0;2;0;2
5853;Naminukas;Paukšteliai;1946057668;Taip;10;2;0;12
5854;Naminukas;Paukšteliai;1063718923;Taip;3;0;0;3
5855;Naminukas;Paukšteliai;1647625489;Taip;4;0;0;4
5856;Naminukas;Paukšteliai;93648945843;Taip;2;0;0;2
5857;Naminukas;Paukšteliai;34168788672;Taip;5;8;0;13
5858;Naminukas;Paukšteliai;1893485577;Taip;4;0;1;5
5859;Naminukas;Paukšteliai;1863885754;Taip;10;8;2;20
5860;Naminukas;Paukšteliai;2100371376;Taip;5;0;1;6
5861;Naminukas;Paukšteliai;1439033627;Taip;5;2;3;10
5862;Naminukas;Paukšteliai;1973581463;Taip;13;0;7;20
5863;Naminukas;Paukšteliai;15748906161;Taip;0;1;0;1
5864;Naminukas;Paukšteliai;70836957729;Taip;15;5;0;20
5865;Naminukas;Paukšteliai;79166535343;Taip;5;3;1;9
5866;Naminukas;Paukšteliai;7386776624;Taip;0;1;0;1
5867;Naminukas;Paukšteliai;9039313646;Taip;0;1;0;1
5868;Naminukas;"NYKŠTUKAI ";59020433000;Taip;0;5;0;5
5869;Naminukas;"NYKŠTUKAI ";2544422668;Taip;5;3;0;8
5870;Naminukas;"NYKŠTUKAI ";3029310084;Taip;3;0;0;3
5871;Naminukas;"NYKŠTUKAI ";46665774314;Taip;1;12;0;13
5872;Naminukas;"NYKŠTUKAI ";1490712871;Taip;4;8;1;13
5873;Naminukas;"NYKŠTUKAI ";1252481328;Taip;14;2;0;16
5874;Naminukas;"NYKŠTUKAI ";5918430817;Taip;0;1;0;1
5875;Naminukas;"NYKŠTUKAI ";1499464511;Taip;4;7;0;11
5876;Naminukas;"NYKŠTUKAI ";9321656855;Taip;6;5;0;11
5877;Naminukas;"NYKŠTUKAI ";4515242836;Taip;0;7;0;7
5878;Naminukas;"NYKŠTUKAI ";3826149605;Taip;0;2;0;2
5879;Naminukas;"NYKŠTUKAI ";6501046678;Taip;2;0;1;3
5880;Naminukas;"NYKŠTUKAI ";6029194403;Taip;8;3;0;11
5881;Naminukas;"NYKŠTUKAI ";70281612245;Taip;14;0;0;14
5882;Naminukas;"NYKŠTUKAI ";10563508139;Taip;8;0;0;8
5883;Naminukas;"NYKŠTUKAI ";90045007984;Taip;17;0;0;17
5884;Naminukas;"NYKŠTUKAI ";74291965804;Taip;5;2;1;8
5885;Neries;DEBESĖLIŲ;28267779362;Taip;0;5;0;5
5886;Neries;DEBESĖLIŲ;8573169074;Taip;0;16;0;16
5887;Neries;DEBESĖLIŲ;2085901811;Taip;0;2;0;2
5888;Neries;DEBESĖLIŲ;70177841044;Taip;10;0;0;10
5889;Neries;DEBESĖLIŲ;66348813404;Taip;0;1;0;1
5890;Neries;DEBESĖLIŲ;97670123581;Taip;13;0;0;13
5891;Neries;DEBESĖLIŲ;78475531620;Taip;15;0;0;15
5892;Neries;DEBESĖLIŲ;58447815495;Taip;10;0;0;10
5893;Neries;DEBESĖLIŲ;1908377973;Taip;0;17;0;17
5894;Neries;DEBESĖLIŲ;1139288486;Taip;0;14;0;14
5895;Neries;DEBESĖLIŲ;34210170709;Taip;2;3;0;5
5896;Neries;DEBESĖLIŲ;6449369298;Taip;0;7;0;7
5897;Neries;DEBESĖLIŲ;6378297641;Taip;0;20;0;20
5898;Neries;DEBESĖLIŲ;2531690903;Taip;3;1;1;5
5899;Neries;DEBESĖLIŲ;1117389814;Taip;5;0;0;5
5900;Neries;DEBESĖLIŲ;25015347703;Taip;0;14;0;14
5901;Neries;DEBESĖLIŲ;40087119136;Taip;9;0;0;9
5902;Neries;DEBESĖLIŲ;6994378824;Taip;3;0;0;3
5903;Neries;PUMPURĖLIŲ;4058545269;Taip;0;10;0;10
5904;Neries;PUMPURĖLIŲ;40762091796;Taip;0;11;0;11
5905;Neries;PUMPURĖLIŲ;5189351158;Taip;0;5;0;5
5906;Neries;PUMPURĖLIŲ;42514000113;Taip;0;2;1;3
5907;Neries;PUMPURĖLIŲ;4112888398;Taip;0;1;2;3
5908;Neries;PUMPURĖLIŲ;1300411811;Taip;0;20;0;20
5909;Neries;PUMPURĖLIŲ;1414837177;Taip;0;10;0;10
5910;Neries;PUMPURĖLIŲ;2003536788;Taip;0;10;0;10
5911;Neries;PUMPURĖLIŲ;14071513289;Taip;0;0;1;1
5912;Neries;PUMPURĖLIŲ;7332285452;Taip;0;13;0;13
5913;Neries;PUMPURĖLIŲ;2823401633;Taip;9;0;2;11
5914;Neries;PUMPURĖLIŲ;3914400553;Taip;0;5;4;9
5915;Neries;PUMPURĖLIŲ;1666616466;Taip;0;0;5;5
5916;Neries;PUMPURĖLIŲ;6603354413;Taip;7;0;0;7
5917;Neries;PUMPURĖLIŲ;5283566263;Ne;3;0;0;3
5918;Nykštukas;AITVARIUKAI;1144228064;Taip;10;5;0;15
5919;Nykštukas;AITVARIUKAI;6787279403;Taip;0;9;0;9
5920;Nykštukas;AITVARIUKAI;2002197530;Taip;18;0;0;18
5921;Nykštukas;AITVARIUKAI;2113361929;Taip;8;0;0;8
5922;Nykštukas;AITVARIUKAI;1555891900;Taip;0;1;0;1
5923;Nykštukas;AITVARIUKAI;4256675710;Taip;3;11;0;14
5924;Nykštukas;AITVARIUKAI;1209871301;Taip;0;4;0;4
5925;Nykštukas;AITVARIUKAI;93527297465;Taip;20;0;0;20
5926;Nykštukas;AITVARIUKAI;1642172676;Taip;6;3;0;9
5927;Nykštukas;AITVARIUKAI;1603960759;Taip;11;4;0;15
5928;Nykštukas;AITVARIUKAI;4487291454;Taip;4;0;0;4
5929;Nykštukas;AITVARIUKAI;6274009442;Taip;0;6;0;6
5930;Nykštukas;AITVARIUKAI;5356005675;Taip;10;8;0;18
5931;Nykštukas;AITVARIUKAI;1760718866;Taip;0;0;1;1
5932;Nykštukas;AITVARIUKAI;5772758127;Taip;0;5;0;5
5933;Nykštukas;AITVARIUKAI;9229795383;Taip;0;8;0;8
5934;Nykštukas;AITVARIUKAI;3479582264;Taip;0;4;0;4
5935;Nykštukas;AITVARIUKAI;1643843455;Taip;17;0;0;17
5936;Nykštukas;AITVARIUKAI;5421090978;Taip;0;16;0;16
5937;Nykštukas;AITVARIUKAI;1965559069;Taip;5;3;0;8
5938;Nykštukas;AITVARIUKAI;6480026426;Taip;0;1;0;1
5939;Nykštukas;DAINORĖLIAI;1505896987;Taip;0;0;1;1
5940;Nykštukas;DAINORĖLIAI;1070086244;Taip;11;6;0;17
5941;Nykštukas;DAINORĖLIAI;67968815055;Taip;5;2;0;7
5942;Nykštukas;DAINORĖLIAI;7498721887;Taip;10;0;0;10
5943;Nykštukas;DAINORĖLIAI;7660848578;Taip;5;0;0;5
5944;Nykštukas;DAINORĖLIAI;4720226790;Taip;0;12;0;12
5945;Nykštukas;DAINORĖLIAI;7546263542;Taip;15;0;0;15
5946;Nykštukas;DAINORĖLIAI;7150793310;Taip;10;5;0;15
5947;Nykštukas;DAINORĖLIAI;7615678714;Taip;9;1;0;10
5948;Nykštukas;DAINORĖLIAI;9567571526;Taip;10;0;4;14
5949;Nykštukas;DAINORĖLIAI;3970413055;Taip;5;5;3;13
5950;Nykštukas;DAINORĖLIAI;2657373608;Taip;0;4;2;6
5951;Nykštukas;DAINORĖLIAI;8781148130;Taip;0;6;0;6
5952;Nykštukas;DAINORĖLIAI;3904901392;Taip;9;4;0;13
5953;Ozas;Smalsučiai;2641398988;Taip;9;0;0;9
5954;Ozas;Smalsučiai;9227939420;Taip;5;0;0;5
5955;Ozas;Smalsučiai;7917100888;Taip;18;1;0;19
5956;Ozas;Smalsučiai;87218067796;Taip;10;0;0;10
5957;Ozas;Smalsučiai;4397034031;Taip;0;1;0;1
5958;Ozas;Smalsučiai;1974320330;Taip;1;2;0;3
5959;Ozas;Smalsučiai;1173284700;Taip;0;6;0;6
5960;Ozas;Smalsučiai;67987032400;Taip;5;3;0;8
5961;Ozas;Smalsučiai;71695973592;Taip;0;5;0;5
5962;Ozas;Smalsučiai;57069047630;Taip;7;4;0;11
5963;Ozas;Smalsučiai;5150746885;Taip;5;5;0;10
5964;Ozas;Smalsučiai;9595277597;Taip;0;5;0;5
5965;Ozas;Smalsučiai;1893257809;Taip;15;0;0;15
5966;Ozas;Smalsučiai;6540803077;Taip;3;0;0;3
5967;Ozas;Smalsučiai;8072802467;Taip;7;2;0;9
5968;Ozas;Smalsučiai;1248092034;Ne;9;0;0;9
5969;Ozas;Smalsučiai;43381497677;Taip;5;1;0;6
5970;Ozas;Smalsučiai;7351651916;Taip;0;4;0;4
5971;Ozas;Smalsučiai;3286170280;Taip;7;0;0;7
5972;Ozas;Smalsučiai;9521048381;Taip;15;0;0;15
5973;Ozas;Smalsučiai;2053832360;Taip;10;0;1;11
5974;Ozas;Drugeliai;1655808777;Taip;0;2;0;2
5975;Ozas;Drugeliai;8176840834;Taip;0;17;3;20
5976;Ozas;Drugeliai;6668470892;Taip;0;2;1;3
5977;Ozas;Drugeliai;2302999759;Taip;5;2;0;7
5978;Ozas;Drugeliai;8088330187;Taip;2;5;1;8
5979;Ozas;Drugeliai;9073973849;Taip;2;10;0;12
5980;Ozas;Drugeliai;9322806566;Taip;0;6;0;6
5981;Ozas;Drugeliai;2676747542;Taip;4;5;0;9
5982;Ozas;Drugeliai;2812687451;Taip;0;5;2;7
5983;Ozas;Drugeliai;8289643065;Taip;10;0;1;11
5984;Ozas;Drugeliai;4726019355;Taip;5;0;0;5
5985;Ozas;Drugeliai;9987863302;Taip;10;0;0;10
5986;Ozas;Drugeliai;5503766544;Taip;0;10;0;10
5987;Ozas;Drugeliai;2980799420;Taip;15;5;0;20
5988;Ozas;Drugeliai;4935698806;Taip;0;5;0;5
5989;Ozas;Drugeliai;1793692289;Taip;0;5;0;5
5990;Ozas;Drugeliai;8318380547;Taip;0;5;0;5
5991;Ozas;Drugeliai;4884054504;Taip;0;1;1;2
5992;Ozas;Drugeliai;2825614921;Taip;10;6;0;16
5993;Ozas;Drugeliai;43660054250;Taip;0;15;0;15
5994;Ozas;Boružėlės;1375643969;Ne;5;1;4;10
5995;Ozas;Boružėlės;63852147122;Taip;0;5;1;6
5996;Ozas;Boružėlės;8190314087;Taip;15;1;0;16
5997;Ozas;Boružėlės;3803998816;Taip;10;4;2;16
5998;Ozas;Boružėlės;1212358423;Taip;12;5;0;17
5999;Ozas;Boružėlės;7615907271;Taip;12;5;0;17
6000;Ozas;Boružėlės;1560342499;Taip;0;1;0;1
6001;Ozas;Boružėlės;8529654920;Taip;6;0;0;6
6002;Ozas;Boružėlės;60194872867;Taip;5;5;0;10
6003;Ozas;Boružėlės;7172573921;Taip;0;0;5;5
6004;Ozas;Boružėlės;2527574646;Taip;0;8;0;8
6005;Ozas;Boružėlės;9773251894;Taip;5;5;0;10
6006;Ozas;Boružėlės;36523514229;Taip;0;6;0;6
6007;Ozas;Boružėlės;1367050160;Taip;3;0;0;3
6008;Ozas;Boružėlės;68364031736;Taip;0;5;0;5
6009;Ozas;Boružėlės;2678629892;Taip;0;5;4;9
6010;Ozas;Boružėlės;1109113859;Ne;0;0;3;3
6011;Ozas;Boružėlės;1826499734;Taip;0;0;3;3
6012;Ozas;Boružėlės;6432357144;Taip;15;5;0;20
6013;Ozas;Boružėlės;1498656201;Taip;7;5;0;12
6014;Ozas;Boružėlės;8979747150;Taip;11;5;0;16
6015;Ozas;Boružėlės;1217496635;Taip;13;0;0;13
6016;Ozas;Boružėlės;1682529482;Taip;9;4;5;18
6017;Ozas;Žiogeliai;89211493110;Taip;6;7;0;13
6018;Ozas;Žiogeliai;51572539013;Ne;0;5;0;5
6019;Ozas;Žiogeliai;47957527704;Taip;6;5;0;11
6020;Ozas;Žiogeliai;84527270114;Taip;0;5;1;6
6021;Ozas;Žiogeliai;52850058303;Taip;6;7;0;13
6022;Ozas;Žiogeliai;71334912565;Taip;0;11;0;11
6023;Ozas;Žiogeliai;58157410967;Taip;0;3;0;3
6024;Ozas;Žiogeliai;54246199303;Taip;0;6;0;6
6025;Ozas;Žiogeliai;34439403991;Taip;0;7;0;7
6026;Ozas;Žiogeliai;89415254787;Taip;0;5;0;5
6027;Ozas;Žiogeliai;4757239107;Taip;0;14;0;14
6028;Ozas;Žiogeliai;1763449085;Taip;0;3;2;5
6029;Ozas;Žiogeliai;79201129646;Taip;15;5;0;20
6030;Ozas;Žiogeliai;33802611373;Taip;11;5;0;16
6031;Ozas;Žiogeliai;26147218825;Taip;0;10;1;11
6032;Ozas;Žiogeliai;4396409015;Taip;0;8;1;9
6033;Ozas;Žiogeliai;16202534864;Ne;4;6;2;12
6034;Ozas;Žiogeliai;47247380242;Ne;0;6;0;6
6035;Ozas;Žiogeliai;49875201400;Taip;0;7;0;7
6036;Ozas;Žiogeliai;44852155196;Taip;0;3;6;9
6037;Ozas;Žiogeliai;82797241773;Taip;0;3;0;3
6038;Ozas;Žiogeliai;15053930619;Taip;5;3;0;8
6039;Ozas;Žiogeliai;42846343820;Taip;5;5;0;10
6040;Ozas;Bitutės;72570693905;Taip;0;1;0;1
6041;Ozas;Bitutės;26114981770;Taip;0;5;0;5
6042;Ozas;Bitutės;49220695182;Taip;0;11;0;11
6043;Ozas;Bitutės;97985936709;Taip;0;6;4;10
6044;Ozas;Bitutės;96089833744;Taip;0;7;0;7
6045;Ozas;Bitutės;91462990629;Taip;0;0;1;1
6046;Ozas;Bitutės;99554644089;Taip;0;5;0;5
6047;Ozas;Bitutės;25241271456;Taip;9;5;0;14
6048;Ozas;Bitutės;21436609394;Ne;0;4;0;4
6049;Ozas;Bitutės;1806690419;Taip;11;5;0;16
6050;Ozas;Bitutės;20806414515;Taip;0;3;1;4
6051;Ozas;Bitutės;11842802958;Taip;0;2;0;2
6052;Ozas;Bitutės;14182351781;Taip;0;5;4;9
6053;Ozas;Bitutės;89886182151;Taip;10;5;0;15
6054;Ozas;Bitutės;1352632856;Taip;0;8;0;8
6055;Ozas;Bitutės;11088024064;Taip;0;5;0;5
6056;Ozas;Bitutės;9120194842;Taip;0;5;0;5
6057;Ozas;Bitutės;2110892014;Taip;0;0;2;2
6058;Ozas;Aitvarėliai;1653285671;Taip;0;12;0;12
6059;Ozas;Aitvarėliai;65979490151;Taip;2;1;0;3
6060;Ozas;Aitvarėliai;36897118363;Taip;0;3;0;3
6061;Ozas;Aitvarėliai;25660709486;Taip;0;12;0;12
6062;Ozas;Aitvarėliai;87500216376;Taip;4;6;0;10
6063;Ozas;Aitvarėliai;62542133064;Taip;4;5;0;9
6064;Ozas;Aitvarėliai;77935174855;Taip;0;1;3;4
6065;Ozas;Aitvarėliai;74709964983;Taip;0;5;0;5
6066;Ozas;Aitvarėliai;28736160618;Taip;0;5;0;5
6067;Ozas;Aitvarėliai;31810796132;Taip;0;5;0;5
6068;Ozas;Aitvarėliai;49556201469;Taip;0;10;0;10
6069;Ozas;Aitvarėliai;3222282556;Taip;0;2;0;2
6070;Ozas;Aitvarėliai;46679332069;Taip;0;6;0;6
6071;Ozas;Aitvarėliai;1556404162;Taip;5;5;0;10
6072;Ozas;Aitvarėliai;20944134865;Taip;0;6;0;6
6073;Ozas;Aitvarėliai;2087307495;Taip;0;7;0;7
6074;Ozas;Aitvarėliai;99211100553;Taip;3;3;0;6
6075;Ozas;Aitvarėliai;56927777775;Taip;0;3;0;3
6076;Ozas;Aitvarėliai;84378491220;Taip;0;5;0;5
6077;Ozas;Aitvarėliai;71286685759;Taip;0;10;0;10
6078;Ozas;Aitvarėliai;1182573257;Taip;0;2;0;2
6079;Ozas;Aitvarėliai;85075096111;Taip;7;5;0;12
6080;Ozas;Voveraitės;89115682092;Taip;5;5;0;10
6081;Ozas;Voveraitės;97875471586;Taip;5;2;3;10
6082;Ozas;Voveraitės;42030629149;Taip;0;5;2;7
6083;Ozas;Voveraitės;8817179462;Taip;0;5;0;5
6084;Ozas;Voveraitės;87683044622;Taip;1;5;5;11
6085;Ozas;Voveraitės;88443183082;Taip;6;4;0;10
6086;Ozas;Voveraitės;94576453630;Taip;5;6;2;13
6087;Ozas;Voveraitės;26834809068;Taip;0;5;0;5
6088;Ozas;Voveraitės;47574756201;Taip;5;7;0;12
6089;Ozas;Voveraitės;24088059514;Taip;0;7;1;8
6090;Ozas;Voveraitės;29411948493;Taip;0;5;0;5
6091;Ozas;Voveraitės;27655773887;Taip;0;7;0;7
6092;Ozas;Voveraitės;62608717700;Taip;0;7;0;7
6093;Ozas;Voveraitės;88837027397;Taip;0;9;0;9
6094;Ozas;Voveraitės;46431348128;Taip;0;1;0;1
6095;Ozas;Voveraitės;66463185196;Taip;7;6;0;13
6096;Ozas;Voveraitės;93882562685;Taip;0;10;0;10
6097;Ozas;Voveraitės;37505558259;Taip;7;5;0;12
6098;Ozas;Voveraitės;90020306864;Taip;10;0;0;10
6099;Ozas;Voveraitės;34723844399;Taip;5;2;0;7
6100;Ozas;Voveraitės;16101439010;Taip;0;3;2;5
6101;Ozas;Voveraitės;5637273299;Taip;0;4;3;7
6102;Ozas;Voveraitės;1637437696;Taip;0;3;2;5
6103;Ozas;Kodelčiukai;2808066733;Taip;20;0;0;20
6104;Ozas;Kodelčiukai;71351371644;Taip;0;8;0;8
6105;Ozas;Kodelčiukai;13077342836;Taip;0;12;0;12
6106;Ozas;Kodelčiukai;1746778441;Taip;12;7;0;19
6107;Ozas;Kodelčiukai;1110232715;Taip;5;5;0;10
6108;Ozas;Kodelčiukai;28273919775;Taip;0;6;0;6
6109;Ozas;Kodelčiukai;88618151766;Taip;0;4;2;6
6110;Ozas;Kodelčiukai;3637786952;Taip;4;7;0;11
6111;Ozas;Kodelčiukai;39003781970;Taip;0;7;0;7
6112;Ozas;Kodelčiukai;1243205832;Taip;8;5;0;13
6113;Ozas;Kodelčiukai;1235925750;Taip;2;6;0;8
6114;Ozas;Kodelčiukai;69756875821;Taip;5;7;0;12
6115;Ozas;Kodelčiukai;19065860134;Taip;5;7;0;12
6116;Ozas;Kodelčiukai;91774614891;Taip;7;2;0;9
6117;Ozas;Kodelčiukai;19284606277;Taip;7;6;0;13
6118;Ozas;Kodelčiukai;1230455881;Taip;3;5;0;8
6119;Ozas;Kodelčiukai;9664748034;Taip;1;3;3;7
6120;Ozas;Kodelčiukai;1684454071;Taip;8;5;0;13
6121;Ozas;Kodelčiukai;1008366446;Taip;17;0;0;17
6122;Ozas;Kodelčiukai;1995302672;Taip;0;8;0;8
6123;Ozas;Kodelčiukai;82373453244;Taip;7;3;0;10
6124;Ozas;Kodelčiukai;94673981368;Taip;15;5;0;20
6125;Ozas;Pelėdžiukai;1462541264;Taip;0;2;0;2
6126;Ozas;Pelėdžiukai;3439351594;Taip;5;11;0;16
6127;Ozas;Pelėdžiukai;60743195418;Taip;5;7;0;12
6128;Ozas;Pelėdžiukai;64778552590;Taip;0;3;0;3
6129;Ozas;Pelėdžiukai;1755283948;Taip;7;0;0;7
6130;Ozas;Pelėdžiukai;35346948351;Taip;5;0;0;5
6131;Ozas;Pelėdžiukai;13375413701;Taip;0;2;0;2
6132;Ozas;Pelėdžiukai;16523707810;Taip;0;5;2;7
6133;Ozas;Pelėdžiukai;47291376629;Taip;11;0;0;11
6134;Ozas;Pelėdžiukai;34330362446;Taip;20;0;0;20
6135;Ozas;Pelėdžiukai;2140385280;Taip;1;5;2;8
6136;Ozas;Pelėdžiukai;1450257399;Taip;15;0;0;15
6137;Ozas;Pelėdžiukai;56346624523;Taip;5;5;0;10
6138;Ozas;Pelėdžiukai;4765249675;Taip;10;0;0;10
6139;Ozas;Pelėdžiukai;1814400303;Taip;15;1;0;16
6140;Ozas;Pelėdžiukai;1889249743;Taip;0;0;1;1
6141;Ozas;Pelėdžiukai;1099026003;Taip;4;0;0;4
6142;Ozas;Pelėdžiukai;15885510365;Taip;6;0;1;7
6143;Ozas;Pelėdžiukai;2058548464;Taip;9;5;0;14
6144;Ozas;Pelėdžiukai;4590847831;Taip;0;4;0;4
6145;Ozas;Pelėdžiukai;1910114048;Taip;0;0;4;4
6146;Ozas;"Kačiukai ";75077443996;Taip;16;0;0;16
6147;Ozas;"Kačiukai ";95179927759;Taip;0;3;9;12
6148;Ozas;"Kačiukai ";4075968205;Taip;20;0;0;20
6149;Ozas;"Kačiukai ";6618249243;Taip;5;10;1;16
6150;Ozas;"Kačiukai ";1151213934;Taip;0;0;1;1
6151;Ozas;"Kačiukai ";2114612776;Taip;0;6;2;8
6152;Ozas;"Kačiukai ";60155732637;Taip;0;5;0;5
6153;Ozas;"Kačiukai ";37159754070;Taip;0;11;5;16
6154;Ozas;"Kačiukai ";61398533877;Taip;2;0;2;4
6155;Ozas;"Kačiukai ";1580501935;Taip;2;1;2;5
6156;Ozas;"Kačiukai ";1210902341;Taip;5;1;0;6
6157;Ozas;"Kačiukai ";1848619053;Taip;0;3;2;5
6158;Ozas;"Kačiukai ";1316758924;Taip;14;0;1;15
6159;Ozas;"Kačiukai ";2018398634;Taip;0;2;9;11
6160;Ozas;"Kačiukai ";84277015523;Taip;8;5;1;14
6161;Ozas;"Kačiukai ";1822377180;Taip;0;1;6;7
6162;Ozas;"Kačiukai ";1551028882;Taip;0;0;3;3
6163;Ozas;"Kačiukai ";14760258125;Taip;0;5;0;5
6164;Ozas;"Kačiukai ";4400619617;Taip;0;2;1;3
6165;Ozas;"Kačiukai ";9345447142;Taip;0;0;3;3
6166;Ozas;"Kačiukai ";1681367373;Taip;0;13;0;13
6167;Ozas;"Kačiukai ";8248732706;Taip;0;5;2;7
6168;Ozas;Ančiukų;9392526836;Taip;0;2;0;2
6169;Ozas;Ančiukų;3631049449;Taip;15;0;0;15
6170;Ozas;Ančiukų;3255382007;Taip;10;0;0;10
6171;Ozas;Ančiukų;1837947633;Taip;5;3;0;8
6172;Ozas;Ančiukų;5850824864;Taip;9;5;0;14
6173;Ozas;Ančiukų;4966355020;Taip;9;0;0;9
6174;Ozas;Ančiukų;1562277866;Taip;0;1;1;2
6175;Ozas;Ančiukų;2991511872;Taip;8;5;0;13
6176;Ozas;Ančiukų;6257625501;Taip;12;4;0;16
6177;Ozas;Ančiukų;7402290524;Taip;11;4;0;15
6178;Ozas;Ančiukų;4571583671;Taip;6;5;0;11
6179;Ozas;Ančiukų;5682027094;Taip;10;5;5;20
6180;Ozas;Ančiukų;4125830926;Taip;0;5;0;5
6181;Ozas;Ančiukų;6053885086;Taip;20;0;0;20
6182;Ozas;Ančiukų;6950802941;Taip;17;0;0;17
6183;Ozas;Ančiukų;3770045761;Taip;8;0;0;8
6184;Ozas;Ančiukų;6499549095;Taip;11;1;0;12
6185;Ozas;Ančiukų;9324647606;Taip;15;1;0;16
6186;Ozas;Ančiukų;7978092840;Taip;12;1;0;13
6187;Ozas;Nykškukų;3329391600;Taip;5;5;0;10
6188;Ozas;Nykškukų;2352118061;Taip;4;5;0;9
6189;Ozas;Nykškukų;7499756171;Taip;7;9;0;16
6190;Ozas;Nykškukų;7018190169;Taip;10;0;0;10
6191;Ozas;Nykškukų;4254601638;Taip;7;0;0;7
6192;Ozas;Nykškukų;2705294874;Taip;4;1;0;5
6193;Ozas;Nykškukų;4227555342;Taip;5;1;1;7
6194;Ozas;Nykškukų;4220780257;Taip;0;5;2;7
6195;Ozas;Nykškukų;2773182934;Taip;1;0;2;3
6196;Ozas;Nykškukų;5102704846;Taip;0;0;4;4
6197;Ozas;Nykškukų;5642468671;Taip;20;0;0;20
6198;Ozas;Nykškukų;7494307084;Taip;18;0;0;18
6199;Ozas;Nykškukų;1475005204;Taip;5;2;0;7
6200;Ozas;Nykškukų;4583818638;Taip;5;0;0;5
6201;Ozas;Nykškukų;2369544599;Taip;0;2;0;2
6202;Ozas;Nykškukų;4207160323;Taip;0;5;0;5
6203;Ozas;Nykškukų;8416839037;Taip;15;0;0;15
6204;Ozas;Nykškukų;4699369567;Taip;5;2;0;7
6205;Ozas;Nykškukų;1161776624;Taip;5;9;0;14
6206;Pabiručiai;Voveriukų;82866592801;Taip;5;4;0;9
6207;Pabiručiai;Voveriukų;36884058806;Taip;0;5;0;5
6208;Pabiručiai;Voveriukų;1798480819;Taip;15;5;0;20
6209;Pabiručiai;Voveriukų;57797244989;Taip;0;6;0;6
6210;Pabiručiai;Voveriukų;48017416657;Taip;0;5;0;5
6211;Pabiručiai;Voveriukų;16377580421;Taip;5;0;1;6
6212;Pabiručiai;Voveriukų;95846629190;Taip;0;11;0;11
6213;Pabiručiai;Voveriukų;5059523668;Taip;0;5;0;5
6214;Pabiručiai;Voveriukų;53593230261;Taip;0;2;0;2
6215;Pabiručiai;Voveriukų;92007951082;Taip;0;10;0;10
6216;Pabiručiai;Voveriukų;55956922916;Taip;0;11;0;11
6217;Pabiručiai;Voveriukų;77233391342;Taip;0;4;0;4
6218;Pabiručiai;Voveriukų;7487052362;Taip;0;5;0;5
6219;Pabiručiai;Voveriukų;81393745800;Ne;0;7;0;7
6220;Pabiručiai;Voveriukų;9492402983;Taip;5;5;0;10
6221;Pabiručiai;Voveriukų;44352248446;Ne;0;8;0;8
6222;Pabiručiai;Voveriukų;6160308400;Taip;0;8;0;8
6223;Pabiručiai;Boružiukų;1303589700;Taip;7;6;0;13
6224;Pabiručiai;Boružiukų;22866929836;Taip;5;8;0;13
6225;Pabiručiai;Boružiukų;47314536610;Taip;0;5;0;5
6226;Pabiručiai;Boružiukų;39499870735;Taip;0;8;0;8
6227;Pabiručiai;Boružiukų;82164704789;Taip;0;2;1;3
6228;Pabiručiai;Boružiukų;32325675784;Taip;0;6;0;6
6229;Pabiručiai;Boružiukų;93509618214;Taip;0;6;0;6
6230;Pabiručiai;Boružiukų;57792326027;Taip;0;5;0;5
6231;Pabiručiai;Boružiukų;91293202710;Taip;0;8;0;8
6232;Pabiručiai;Boružiukų;27052463521;Taip;6;3;0;9
6233;Pabiručiai;Boružiukų;59616111036;Taip;10;5;0;15
6234;Pabiručiai;Boružiukų;2284041402;Taip;10;5;0;15
6235;Pabiručiai;Boružiukų;67295377190;Taip;5;6;0;11
6236;Pabiručiai;Boružiukų;61547104192;Taip;7;0;0;7
6237;Pabiručiai;Boružiukų;97165250663;Taip;0;5;0;5
6238;Pabiručiai;Boružiukų;38492844225;Taip;0;11;0;11
6239;Pabiručiai;Boružiukų;3959937657;Taip;5;5;0;10
6240;Pabiručiai;Boružiukų;51516019654;Taip;0;2;0;2
6241;Pabiručiai;Boružiukų;37884558736;Taip;0;6;0;6
6242;Pabiručiai;Boružiukų;74823092402;Ne;8;6;0;14
6243;Pabiručiai;Boružiukų;32339177392;Taip;0;6;0;6
6244;Pabiručiai;Katinėlių;1670938208;Taip;0;5;0;5
6245;Pabiručiai;Katinėlių;1224986101;Taip;15;0;3;18
6246;Pabiručiai;Katinėlių;3756365293;Taip;5;0;0;5
6247;Pabiručiai;Katinėlių;6283372742;Taip;5;0;0;5
6248;Pabiručiai;Katinėlių;1749155319;Ne;15;5;0;20
6249;Pabiručiai;Katinėlių;34883375155;Taip;6;11;0;17
6250;Pabiručiai;Katinėlių;1705085006;Taip;0;0;1;1
6251;Pabiručiai;Katinėlių;58112415466;Taip;0;14;0;14
6252;Pabiručiai;Katinėlių;42877891797;Taip;0;10;0;10
6253;Pabiručiai;Katinėlių;6285940478;Taip;0;6;0;6
6254;Pabiručiai;Katinėlių;8284711578;Taip;5;0;0;5
6255;Pabiručiai;Katinėlių;8710389714;Taip;10;2;0;12
6256;Pabiručiai;Katinėlių;4501176225;Taip;0;10;0;10
6257;Pabiručiai;Katinėlių;8503177793;Taip;15;0;0;15
6258;Pabiručiai;Katinėlių;95695057362;Taip;10;2;0;12
6259;Pabiručiai;Katinėlių;4339607826;Taip;5;11;0;16
6260;Pabiručiai;Katinėlių;8306688649;Taip;5;0;0;5
6261;Pabiručiai;Katinėlių;2572570925;Taip;0;4;2;6
6262;Pabiručiai;Katinėlių;6994301415;Taip;16;0;3;19
6263;Pabiručiai;Katinėlių;4205107384;Taip;5;0;0;5
6264;Pabiručiai;Žiogelių;3272576627;Taip;0;9;0;9
6265;Pabiručiai;Žiogelių;5522447437;Taip;4;0;0;4
6266;Pabiručiai;Žiogelių;7974345478;Taip;0;8;0;8
6267;Pabiručiai;Žiogelių;8367889753;Taip;0;11;0;11
6268;Pabiručiai;Žiogelių;8421025940;Taip;0;7;0;7
6269;Pabiručiai;Žiogelių;3028063887;Taip;0;5;0;5
6270;Pabiručiai;Žiogelių;1642658060;Taip;5;9;0;14
6271;Pabiručiai;Žiogelių;3206962828;Taip;5;0;1;6
6272;Pabiručiai;Žiogelių;3355875364;Taip;0;7;0;7
6273;Pabiručiai;Žiogelių;7085036701;Taip;0;4;0;4
6274;Pabiručiai;Žiogelių;8736658575;Taip;5;6;1;12
6275;Pabiručiai;Žiogelių;1311650644;Taip;0;4;0;4
6276;Pabiručiai;Žiogelių;5480714322;Taip;0;5;0;5
6277;Pabiručiai;Žiogelių;3585198013;Taip;0;6;0;6
6278;Pabiručiai;Žiogelių;2356833740;Taip;9;0;1;10
6279;Pabiručiai;Žiogelių;5311762824;Taip;6;7;0;13
6280;Pabiručiai;Žiogelių;1587905929;Taip;15;4;1;20
6281;Pabiručiai;Žiogelių;4667769378;Taip;0;7;0;7
6282;Pabiručiai;Smalsiukai;77665506359;Taip;0;6;0;6
6283;Pabiručiai;Smalsiukai;33576823599;Taip;0;13;0;13
6284;Pabiručiai;Smalsiukai;99245902550;Ne;0;1;0;1
6285;Pabiručiai;Smalsiukai;72030186300;Taip;0;4;0;4
6286;Pabiručiai;Smalsiukai;1749795353;Taip;12;6;0;18
6287;Pabiručiai;Smalsiukai;83758151778;Ne;0;2;0;2
6288;Pabiručiai;Smalsiukai;46891762701;Taip;0;6;0;6
6289;Pabiručiai;Smalsiukai;88469372129;Taip;5;5;0;10
6290;Pabiručiai;Smalsiukai;1052844376;Taip;4;0;0;4
6291;Pabiručiai;Smalsiukai;55812858767;Taip;0;2;0;2
6292;Pabiručiai;Smalsiukai;97516241743;Taip;8;0;2;10
6293;Pabiručiai;Smalsiukai;37299891873;Taip;5;6;0;11
6294;Pabiručiai;Smalsiukai;99612002248;Taip;7;0;0;7
6295;Pabiručiai;Smalsiukai;67029008630;Taip;10;6;0;16
6296;Pabiručiai;Smalsiukai;84458450123;Taip;0;12;0;12
6297;Pabiručiai;Kiškučiai;23334247840;Taip;5;2;0;7
6298;Pabiručiai;Kiškučiai;78055744911;Taip;3;1;0;4
6299;Pabiručiai;Kiškučiai;9756328087;Ne;0;15;0;15
6300;Pabiručiai;Kiškučiai;16153916925;Taip;0;9;0;9
6301;Pabiručiai;Kiškučiai;69948274186;Taip;0;13;0;13
6302;Pabiručiai;Kiškučiai;62817645726;Taip;0;13;0;13
6303;Pabiručiai;Kiškučiai;2117594123;Taip;9;3;0;12
6304;Pabiručiai;Kiškučiai;25986912111;Taip;0;1;0;1
6305;Pabiručiai;Kiškučiai;99405892035;Taip;0;12;0;12
6306;Pabiručiai;Kiškučiai;31043795418;Taip;0;15;0;15
6307;Pabiručiai;Kiškučiai;1189209435;Taip;5;2;0;7
6308;Pabiručiai;Kiškučiai;58410416452;Taip;8;4;0;12
6309;Pabiručiai;Kiškučiai;1457799587;Taip;0;5;0;5
6310;Pabiručiai;Kiškučiai;93595653770;Taip;0;8;0;8
6311;Pabiručiai;Kiškučiai;72090235276;Taip;15;5;0;20
6312;Pabiručiai;Kiškučiai;4463663862;Taip;5;5;0;10
6313;Pabiručiai;Kiškučiai;1780827082;Taip;11;5;0;16
6314;Pabiručiai;Kiškučiai;3767061583;Taip;0;8;0;8
6315;Pabiručiai;Kiškučiai;37991862437;Taip;0;9;0;9
6316;Pabiručiai;Kiškučiai;5327687404;Taip;14;0;0;14
6317;Pabiručiai;"Pėledžiukai ";7457099536;Taip;10;0;0;10
6318;Pabiručiai;"Pėledžiukai ";77273870334;Taip;5;2;0;7
6319;Pabiručiai;"Pėledžiukai ";80756439543;Taip;0;2;2;4
6320;Pabiručiai;"Pėledžiukai ";75098378597;Taip;0;2;1;3
6321;Pabiručiai;"Pėledžiukai ";90849312010;Taip;8;0;0;8
6322;Pabiručiai;"Pėledžiukai ";6112244077;Taip;5;7;0;12
6323;Pabiručiai;"Pėledžiukai ";18356992277;Taip;0;12;0;12
6324;Pabiručiai;"Pėledžiukai ";42627202407;Taip;0;8;0;8
6325;Pabiručiai;"Pėledžiukai ";28121667845;Taip;0;7;0;7
6326;Pabiručiai;"Pėledžiukai ";1474411801;Taip;5;1;0;6
6327;Pabiručiai;"Pėledžiukai ";1591342751;Taip;5;1;0;6
6328;Pabiručiai;"Pėledžiukai ";1701727758;Taip;5;5;0;10
6329;Pabiručiai;"Pėledžiukai ";1078387167;Taip;0;1;0;1
6330;Pabiručiai;"Pėledžiukai ";3733576400;Taip;5;4;0;9
6331;Pabiručiai;"Pėledžiukai ";34215100257;Taip;0;7;0;7
6332;Pabiručiai;"Pėledžiukai ";26940925728;Taip;0;9;0;9
6333;Pabiručiai;"Pėledžiukai ";2944433375;Taip;0;6;0;6
6334;Pabiručiai;"Kodelčiūkai ";1819457592;Taip;0;11;0;11
6335;Pabiručiai;"Kodelčiūkai ";38142737487;Taip;0;6;0;6
6336;Pabiručiai;"Kodelčiūkai ";1177208864;Taip;6;0;3;9
6337;Pabiručiai;"Kodelčiūkai ";62923769489;Taip;7;9;0;16
6338;Pabiručiai;"Kodelčiūkai ";81307674221;Taip;0;10;0;10
6339;Pabiručiai;"Kodelčiūkai ";15948930587;Taip;7;6;0;13
6340;Pabiručiai;"Kodelčiūkai ";6696186733;Taip;10;0;0;10
6341;Pabiručiai;"Kodelčiūkai ";61144974706;Taip;0;4;0;4
6342;Pabiručiai;"Kodelčiūkai ";78798062773;Taip;0;5;0;5
6343;Pabiručiai;"Kodelčiūkai ";66085180057;Ne;0;12;0;12
6344;Pabiručiai;"Kodelčiūkai ";7468072633;Ne;0;6;0;6
6345;Pabiručiai;"Kodelčiūkai ";1901455947;Taip;11;0;0;11
6346;Pabiručiai;"Kodelčiūkai ";1718014001;Taip;10;4;0;14
6347;Pabiručiai;"Kodelčiūkai ";2143676810;Taip;0;8;0;8
6348;Pabiručiai;"Kodelčiūkai ";46251218463;Taip;8;3;0;11
6349;Pabiručiai;"Kodelčiūkai ";1029743585;Taip;10;5;0;15
6350;Pabiručiai;"Kodelčiūkai ";1236499374;Taip;3;15;0;18
6351;Pabiručiai;"Kodelčiūkai ";8690290547;Taip;0;13;0;13
6352;Pabiručiai;"Kodelčiūkai ";8344476830;Taip;2;10;0;12
6353;Pabiručiai;"Peliukų ";4301904533;Taip;16;0;0;16
6354;Pabiručiai;"Peliukų ";3096466200;Taip;9;0;0;9
6355;Pabiručiai;"Peliukų ";7524993271;Taip;0;8;0;8
6356;Pabiručiai;"Peliukų ";5708597471;Taip;0;2;0;2
6357;Pabiručiai;"Peliukų ";8106446562;Taip;0;13;0;13
6358;Pabiručiai;"Peliukų ";7046122545;Taip;0;0;3;3
6359;Pabiručiai;"Peliukų ";1673473814;Taip;8;2;0;10
6360;Pabiručiai;"Peliukų ";6401188653;Taip;0;8;0;8
6361;Pabiručiai;"Peliukų ";5686769648;Taip;10;1;0;11
6362;Pabiručiai;"Peliukų ";8175565139;Taip;11;0;0;11
6363;Pabiručiai;"Peliukų ";7737045952;Taip;16;0;0;16
6364;Pabiručiai;"Peliukų ";4006783343;Taip;15;1;0;16
6365;Pabiručiai;"Peliukų ";7073230645;Taip;11;0;0;11
6366;Pabiručiai;"Peliukų ";1344711015;Taip;19;0;0;19
6367;Pabiručiai;"Viščiukų ";2349337471;Taip;0;2;0;2
6368;Pabiručiai;"Viščiukų ";9468698553;Taip;1;0;3;4
6369;Pabiručiai;"Viščiukų ";4040533883;Taip;0;0;6;6
6370;Pabiručiai;"Viščiukų ";9356327400;Taip;0;2;0;2
6371;Pabiručiai;"Viščiukų ";8236964683;Taip;0;9;0;9
6372;Pabiručiai;"Viščiukų ";7066037017;Taip;10;1;0;11
6373;Pabiručiai;"Viščiukų ";7090116276;Taip;0;3;8;11
6374;Pabiručiai;"Viščiukų ";4069564285;Taip;0;7;0;7
6375;Pabiručiai;"Viščiukų ";5232678556;Taip;5;5;2;12
6376;Pabiručiai;"Viščiukų ";2514312233;Taip;0;10;0;10
6377;Pabiručiai;"Viščiukų ";7606274875;Taip;0;10;0;10
6378;Pabiručiai;"Viščiukų ";8897462614;Taip;0;5;0;5
6379;Pabiručiai;"Viščiukų ";7278334800;Taip;3;0;1;4
6380;Pabiručiai;"Viščiukų ";7846758352;Taip;18;0;0;18
6381;Pabiručiai;"Viščiukų ";1663953648;Taip;0;15;0;15
6382;Pabiručiai;"Drugelių ";6251432968;Taip;0;0;1;1
6383;Pabiručiai;"Drugelių ";1671027282;Taip;18;0;0;18
6384;Pabiručiai;"Drugelių ";3151360288;Taip;5;8;0;13
6385;Pabiručiai;"Drugelių ";1028312285;Taip;11;0;0;11
6386;Pabiručiai;"Drugelių ";2446697763;Taip;0;0;5;5
6387;Pabiručiai;"Drugelių ";1498738549;Taip;7;0;0;7
6388;Pabiručiai;"Drugelių ";4312364951;Taip;15;2;0;17
6389;Pabiručiai;"Drugelių ";4462744848;Taip;14;3;0;17
6390;Pabiručiai;"Drugelių ";1240057541;Taip;10;1;0;11
6391;Pabiručiai;"Drugelių ";3759350345;Taip;12;1;0;13
6392;Pabiručiai;"Drugelių ";1582754284;Taip;18;0;0;18
6393;Pabiručiai;"Drugelių ";4813206044;Taip;10;5;0;15
6394;Pabiručiai;"Drugelių ";7572077461;Taip;10;0;0;10
6395;Pagrandukas;Saulytės;56985738094;Taip;0;10;0;10
6396;Pagrandukas;Saulytės;90141915028;Taip;0;13;0;13
6397;Pagrandukas;Saulytės;73094500140;Taip;0;4;0;4
6398;Pagrandukas;Saulytės;25042144265;Taip;11;0;0;11
6399;Pagrandukas;Saulytės;92496791690;Taip;0;16;0;16
6400;Pagrandukas;Saulytės;8490035231;Taip;16;1;0;17
6401;Pagrandukas;Saulytės;10275994267;Taip;0;3;0;3
6402;Pagrandukas;Saulytės;53442283517;Taip;0;7;0;7
6403;Pagrandukas;Saulytės;85893187794;Taip;0;1;0;1
6404;Pagrandukas;Saulytės;1735088719;Taip;0;1;0;1
6405;Pagrandukas;Saulytės;2240690677;Taip;5;0;0;5
6406;Pagrandukas;Saulytės;23836053268;Taip;0;5;0;5
6407;Pagrandukas;Saulytės;82076379343;Taip;0;1;0;1
6408;Pagrandukas;Saulytės;90244057040;Taip;0;14;0;14
6409;Pagrandukas;Saulytės;5179694773;Taip;0;1;0;1
6410;Pagrandukas;Saulytės;4550081974;Taip;0;12;0;12
6411;Pagrandukas;Zuikučiai;13992515800;Taip;0;0;1;1
6412;Pagrandukas;Zuikučiai;27121246153;Taip;3;5;2;10
6413;Pagrandukas;Zuikučiai;7341198311;Taip;7;0;0;7
6414;Pagrandukas;Zuikučiai;69489178826;Taip;0;0;2;2
6415;Pagrandukas;Zuikučiai;61698205530;Taip;3;5;2;10
6416;Pagrandukas;Zuikučiai;65443026043;Taip;0;5;0;5
6417;Pagrandukas;Zuikučiai;45339513408;Taip;4;6;0;10
6418;Pagrandukas;Zuikučiai;52079380668;Taip;0;14;0;14
6419;Pagrandukas;Zuikučiai;8268544829;Taip;0;0;3;3
6420;Pagrandukas;Zuikučiai;37941723547;Taip;0;6;0;6
6421;Pagrandukas;Zuikučiai;58398098970;Taip;1;0;0;1
6422;Pagrandukas;Zuikučiai;44541642222;Taip;9;0;0;9
6423;Pagrandukas;Zuikučiai;68051228918;Taip;1;0;0;1
6424;Pagrandukas;Zuikučiai;81042926297;Taip;7;4;0;11
6425;Pagrandukas;Zuikučiai;641267897;Taip;2;11;0;13
6426;Pagrandukas;Zuikučiai;99150983585;Taip;0;10;0;10
6427;Pagrandukas;Zuikučiai;43720624711;Taip;0;8;0;8
6428;Pagrandukas;Zuikučiai;1350949224;Taip;5;2;0;7
6429;Pagrandukas;Zuikučiai;49574848652;Taip;0;11;0;11
6430;Pagrandukas;Zuikučiai;18049426774;Taip;3;5;0;8
6431;Pagrandukas;Boružėlių;3398225200;Taip;0;11;0;11
6432;Pagrandukas;Boružėlių;5752454925;Taip;0;0;3;3
6433;Pagrandukas;Boružėlių;3587941684;Taip;5;1;0;6
6434;Pagrandukas;Boružėlių;5946007985;Taip;0;1;0;1
6435;Pagrandukas;Boružėlių;7770852445;Taip;0;1;0;1
6436;Pagrandukas;Boružėlių;3953844737;Taip;8;5;0;13
6437;Pagrandukas;Boružėlių;7271589727;Taip;0;9;0;9
6438;Pagrandukas;Boružėlių;7064391685;Taip;2;0;0;2
6439;Pagrandukas;Boružėlių;5511396314;Taip;9;7;0;16
6440;Pagrandukas;Bitutės;95949044544;Taip;0;5;9;14
6441;Pagrandukas;Bitutės;22146063631;Taip;0;14;3;17
6442;Pagrandukas;Bitutės;1844631218;Taip;0;5;15;20
6443;Pagrandukas;Bitutės;1479570204;Taip;0;4;1;5
6444;Pagrandukas;Bitutės;1505620688;Taip;0;2;0;2
6445;Pagrandukas;Bitutės;1654566158;Taip;0;6;0;6
6446;Pagrandukas;Bitutės;41904915714;Taip;0;4;0;4
6447;Pagrandukas;Bitutės;44029972943;Taip;0;5;0;5
6448;Pagrandukas;Bitutės;1707429884;Taip;11;1;0;12
6449;Pagrandukas;Bitutės;91591094393;Taip;5;0;0;5
6450;Pagrandukas;Bitutės;8891887553;Taip;0;8;12;20
6451;Pagrandukas;Bitutės;1503479321;Taip;0;3;0;3
6452;Pagrandukas;Bitutės;9313380552;Taip;5;0;0;5
6453;Pagrandukas;Bitutės;51982253355;Taip;0;6;0;6
6454;Pagrandukas;Bitutės;3227066520;Taip;0;2;0;2
6455;Pagrandukas;Bitutės;1813676320;Taip;0;5;2;7
6456;Pagrandukas;Pelėdžiukai;1590309916;Taip;0;1;0;1
6457;Pagrandukas;Pelėdžiukai;44044284874;Taip;0;8;0;8
6458;Pagrandukas;Pelėdžiukai;33750135077;Taip;0;6;0;6
6459;Pagrandukas;Pelėdžiukai;2066377478;Taip;0;4;0;4
6460;Pagrandukas;Pelėdžiukai;1189453012;Taip;0;5;0;5
6461;Pagrandukas;Pelėdžiukai;43539883053;Taip;2;4;0;6
6462;Pagrandukas;Pelėdžiukai;4391887554;Taip;10;0;0;10
6463;Pagrandukas;Pelėdžiukai;6364473206;Taip;0;5;0;5
6464;Pagrandukas;Pelėdžiukai;33909593470;Taip;0;1;0;1
6465;Pagrandukas;Pelėdžiukai;2068155037;Taip;5;0;0;5
6466;Pagrandukas;Pelėdžiukai;7751376696;Taip;0;7;0;7
6467;Pagrandukas;Pelėdžiukai;5818020587;Taip;4;1;0;5
6468;Pagrandukas;Pelėdžiukai;21544489661;Taip;0;4;0;4
6469;Pagrandukas;Pelėdžiukai;93036151205;Taip;0;5;0;5
6470;Pagrandukas;Pelėdžiukai;1232460221;Taip;0;7;0;7
6471;Pagrandukas;Pelėdžiukai;57471531440;Taip;0;13;0;13
6472;Pagrandukas;Žvaigždutė;1904462840;Taip;0;10;0;10
6473;Pagrandukas;Žvaigždutė;9329518124;Taip;10;1;0;11
6474;Pagrandukas;Žvaigždutė;75080308291;Taip;0;11;0;11
6475;Pagrandukas;Žvaigždutė;7876029445;Taip;0;8;0;8
6476;Pagrandukas;Žvaigždutė;1313716840;Taip;0;8;0;8
6477;Pagrandukas;Žvaigždutė;14043704729;Taip;0;6;0;6
6478;Pagrandukas;Žvaigždutė;51692261484;Taip;2;1;0;3
6479;Pagrandukas;Žvaigždutė;1511562720;Taip;0;10;0;10
6480;Pagrandukas;Žvaigždutė;2923517578;Taip;0;6;0;6
6481;Pagrandukas;Žvaigždutė;4724383814;Taip;15;0;0;15
6482;Pagrandukas;Žvaigždutė;7782678159;Taip;2;0;5;7
6483;Pagrandukas;Žvaigždutė;8879549409;Taip;0;20;0;20
6484;Pagrandukas;Žvaigždutė;6299298199;Taip;0;20;0;20
6485;Pagrandukas;Žvaigždutė;7543795007;Taip;5;2;0;7
6486;Pagrandukas;Žvaigždutė;3860781857;Taip;2;0;0;2
6487;Pagrandukas;Žvaigždutė;24287759126;Taip;7;0;0;7
6488;Pagrandukas;Žvaigždutė;9522269582;Taip;5;9;0;14
6489;Pagrandukas;Žvaigždutė;2461803626;Taip;10;0;0;10
6490;Pakalnutė;Pagrandukai;22735454739;Taip;14;1;4;19
6491;Pakalnutė;Pagrandukai;1621947670;Taip;12;3;3;18
6492;Pakalnutė;Pagrandukai;2930341121;Taip;0;1;0;1
6493;Pakalnutė;Pagrandukai;18927141423;Taip;0;6;0;6
6494;Pakalnutė;Pagrandukai;70476217309;Ne;0;6;1;7
6495;Pakalnutė;Pagrandukai;83425301719;Taip;0;1;0;1
6496;Pakalnutė;Pagrandukai;46144634381;Taip;0;4;0;4
6497;Pakalnutė;Pagrandukai;85764245101;Taip;0;5;0;5
6498;Pakalnutė;Pagrandukai;57463392902;Taip;0;8;0;8
6499;Pakalnutė;Pagrandukai;97346486902;Taip;0;3;2;5
6500;Pakalnutė;Pagrandukai;24840895951;Taip;0;5;0;5
6501;Pakalnutė;Pagrandukai;89329905839;Taip;0;1;0;1
6502;Pakalnutė;Pagrandukai;7535589010;Taip;0;2;1;3
6503;Pakalnutė;Pagrandukai;1210432627;Taip;0;5;0;5
6504;Pakalnutė;Pagrandukai;3987920952;Ne;0;5;0;5
6505;Pakalnutė;Pagrandukai;34357752735;Taip;5;0;0;5
6506;Pakalnutė;Pagrandukai;28398386463;Taip;7;0;1;8
6507;Pakalnutė;"Pelėdžiukų ";39708333436;Taip;0;5;1;6
6508;Pakalnutė;"Pelėdžiukų ";1167939323;Taip;0;0;1;1
6509;Pakalnutė;"Pelėdžiukų ";1478348672;Taip;0;5;0;5
6510;Pakalnutė;"Pelėdžiukų ";88746368414;Taip;0;0;1;1
6511;Pakalnutė;"Pelėdžiukų ";77988376736;Taip;16;1;0;17
6512;Pakalnutė;"Pelėdžiukų ";26491667009;Taip;0;8;0;8
6513;Pakalnutė;"Pelėdžiukų ";77242242918;Taip;0;0;2;2
6514;Pakalnutė;"Pelėdžiukų ";37321817270;Taip;5;0;1;6
6515;Pakalnutė;"Pelėdžiukų ";42969128937;Taip;0;5;0;5
6516;Pakalnutė;"Pelėdžiukų ";16841777805;Taip;0;4;0;4
6517;Pakalnutė;"Pelėdžiukų ";1970792910;Taip;0;0;4;4
6518;Pakalnutė;"Pelėdžiukų ";1101880932;Taip;0;0;3;3
6519;Pakalnutė;"Pelėdžiukų ";2304898969;Taip;7;5;0;12
6520;Pakalnutė;"Pelėdžiukų ";12785798739;Taip;9;4;0;13
6521;Pakalnutė;"Pelėdžiukų ";9626872763;Taip;13;0;0;13
6522;Pakalnutė;"Pelėdžiukų ";65265804867;Taip;0;0;3;3
6523;Pakalnutė;"Pelėdžiukų ";24118925398;Taip;0;10;0;10
6524;Pakalnutė;Ežiukai;72729647117;Taip;0;9;0;9
6525;Pakalnutė;Ežiukai;64242664158;Taip;0;1;0;1
6526;Pakalnutė;Ežiukai;56277347819;Taip;6;8;0;14
6527;Pakalnutė;Ežiukai;48593837984;Taip;5;1;0;6
6528;Pakalnutė;Ežiukai;26038172396;Taip;4;0;0;4
6529;Pakalnutė;Ežiukai;82408964876;Taip;14;2;0;16
6530;Pakalnutė;Ežiukai;60227035402;Taip;0;0;2;2
6531;Pakalnutė;Ežiukai;68936094010;Ne;6;7;0;13
6532;Pakalnutė;Ežiukai;49066311903;Taip;0;3;0;3
6533;Pakalnutė;Ežiukai;613434268;Taip;16;0;0;16
6534;Pakalnutė;Ežiukai;78371539346;Ne;0;12;0;12
6535;Pakalnutė;Ežiukai;30435436817;Taip;0;20;0;20
6536;Pakalnutė;Ežiukai;89871858343;Taip;5;0;1;6
6537;Pakalnutė;Ežiukai;71254042639;Taip;0;2;3;5
6538;Pakalnutė;Ežiukai;7696792543;Taip;1;5;0;6
6539;Pakalnutė;Skruzdėliukų;58775427990;Taip;5;5;0;10
6540;Pakalnutė;Skruzdėliukų;35416453763;Taip;0;1;0;1
6541;Pakalnutė;Skruzdėliukų;90799416844;Taip;0;2;0;2
6542;Pakalnutė;Skruzdėliukų;89875639056;Taip;0;12;0;12
6543;Pakalnutė;Skruzdėliukų;1855158585;Taip;6;0;0;6
6544;Pakalnutė;Skruzdėliukų;7171281063;Taip;0;1;0;1
6545;Pakalnutė;Skruzdėliukų;79722445374;Taip;0;1;0;1
6546;Pakalnutė;Skruzdėliukų;58650103614;Taip;0;12;0;12
6547;Pakalnutė;Skruzdėliukų;54453953995;Ne;0;5;0;5
6548;Pakalnutė;Skruzdėliukų;63030910797;Taip;0;1;0;1
6549;Pakalnutė;Skruzdėliukų;1785760365;Taip;0;1;0;1
6550;Pakalnutė;Skruzdėliukų;42536262678;Taip;0;5;0;5
6551;Pakalnutė;Skruzdėliukų;16888957248;Taip;5;0;0;5
6552;Pakalnutė;Skruzdėliukų;1115709083;Taip;0;13;0;13
6553;Pakalnutė;Skruzdėliukų;1576453554;Taip;0;13;0;13
6554;Pakalnutė;Bitučių;2993145079;Taip;0;5;0;5
6555;Pakalnutė;Bitučių;8461220770;Taip;2;0;3;5
6556;Pakalnutė;Bitučių;2367683002;Taip;6;7;0;13
6557;Pakalnutė;Bitučių;2765220889;Taip;10;5;0;15
6558;Pakalnutė;Bitučių;9445909071;Taip;5;0;0;5
6559;Pakalnutė;Bitučių;5532458706;Taip;20;0;0;20
6560;Pakalnutė;Bitučių;5355198213;Taip;13;4;0;17
6561;Pakalnutė;Bitučių;5941955322;Taip;11;2;0;13
6562;Pakalnutė;Bitučių;3306334576;Taip;18;0;0;18
6563;Pakalnutė;Bitučių;2095540372;Taip;10;3;2;15
6564;Pakalnutė;Bitučių;5342592825;Taip;5;9;0;14
6565;Pakalnutė;Bitučių;1238121406;Taip;0;5;0;5
6566;Pakalnutė;Bitučių;6117542654;Taip;10;5;0;15
6567;Pakalnutė;Bitučių;5464143742;Taip;18;0;0;18
6568;Pakalnutė;Bitučių;2714905466;Taip;11;0;0;11
6569;Pakalnutė;Bitučių;6351193702;Taip;4;5;1;10
6570;Pakalnutė;Bitučių;2070744110;Taip;0;0;3;3
6571;Pakalnutė;Boružiukų;5120176374;Taip;0;6;0;6
6572;Pakalnutė;Boružiukų;9256219647;Taip;10;5;0;15
6573;Pakalnutė;Boružiukų;6798939288;Taip;8;5;0;13
6574;Pakalnutė;Boružiukų;7357431226;Taip;19;0;0;19
6575;Pakalnutė;Boružiukų;4934095931;Taip;6;0;0;6
6576;Pakalnutė;Boružiukų;5039000154;Taip;2;2;0;4
6577;Pakalnutė;Boružiukų;7853479591;Taip;10;8;0;18
6578;Pakalnutė;Boružiukų;6575909478;Taip;6;0;0;6
6579;Pakalnutė;Boružiukų;3583094831;Taip;5;5;0;10
6580;Pakalnutė;Boružiukų;2040992265;Taip;10;0;0;10
6581;Pakalnutė;Boružiukų;7223747714;Taip;4;0;0;4
6582;Pakalnutė;Boružiukų;7503936754;Taip;10;0;0;10
6583;Pakalnutė;Boružiukų;9382160515;Taip;0;1;0;1
6584;Pakalnutė;Boružiukų;2835611316;Taip;7;0;0;7
6585;Pakalnutė;Boružiukų;5134342817;Taip;15;0;0;15
6586;Pakalnutė;Boružiukų;7672252382;Taip;5;0;0;5
6587;Pakalnutė;Meškiukų;1602013811;Taip;0;11;0;11
6588;Pakalnutė;Meškiukų;41008813511;Ne;12;0;1;13
6589;Pakalnutė;Meškiukų;83174865018;Taip;0;6;0;6
6590;Pakalnutė;Meškiukų;1655551042;Taip;6;5;0;11
6591;Pakalnutė;Meškiukų;40117721972;Taip;0;6;0;6
6592;Pakalnutė;Meškiukų;64706392096;Taip;10;6;0;16
6593;Pakalnutė;Meškiukų;1411083263;Taip;0;5;0;5
6594;Pakalnutė;Meškiukų;2202341545;Taip;10;2;2;14
6595;Pakalnutė;Meškiukų;7180617984;Taip;7;0;0;7
6596;Pakalnutė;Meškiukų;7487278074;Taip;0;2;2;4
6597;Pakalnutė;Meškiukų;9355380341;Taip;11;0;0;11
6598;Pakalnutė;Meškiukų;7324846434;Taip;12;1;1;14
6599;Pakalnutė;Meškiukų;9001185744;Taip;0;0;2;2
6600;Pakalnutė;Nykštukai;6769352325;Taip;0;4;0;4
6601;Pakalnutė;Nykštukai;1202301707;Taip;0;1;3;4
6602;Pakalnutė;Nykštukai;72137985328;Taip;10;0;0;10
6603;Pakalnutė;Nykštukai;11183301096;Taip;5;4;0;9
6604;Pakalnutė;Nykštukai;19773872429;Taip;0;1;0;1
6605;Pakalnutė;Nykštukai;85900847069;Taip;0;3;3;6
6606;Pakalnutė;Nykštukai;16651154416;Taip;2;2;2;6
6607;Pakalnutė;Nykštukai;7389600659;Taip;8;1;0;9
6608;Pakalnutė;Nykštukai;5309195407;Taip;0;7;0;7
6609;Pakalnutė;Nykštukai;1849396954;Taip;10;0;3;13
6610;Pakalnutė;Nykštukai;81963663668;Taip;9;0;1;10
6611;Pakalnutė;Nykštukai;76382908561;Taip;0;0;2;2
6612;Pakalnutė;Nykštukai;99344331316;Taip;8;0;0;8
6613;Pakalnutė;Nykštukai;33667858388;Taip;0;8;0;8
6614;Pakalnutė;Nykštukai;2815093249;Taip;0;9;0;9
6615;Pakalnutė;Nykštukai;1372722843;Taip;5;3;2;10
6616;Pakalnutė;Nykštukai;2051737273;Taip;5;0;0;5
6617;Pakalnutė;Nykštukai;61712002384;Taip;0;13;0;13
6618;Pakalnutė;Nykštukai;2946347383;Taip;0;10;0;10
6619;Pakalnutė;"Zuikučių ";1198230323;Taip;0;5;0;5
6620;Pakalnutė;"Zuikučių ";6016791282;Taip;15;0;0;15
6621;Pakalnutė;"Zuikučių ";3609982613;Taip;0;9;0;9
6622;Pakalnutė;"Zuikučių ";5958653847;Taip;0;1;0;1
6623;Pakalnutė;"Zuikučių ";8513260520;Taip;6;0;0;6
6624;Pakalnutė;"Zuikučių ";2159430356;Taip;0;11;0;11
6625;Pakalnutė;"Zuikučių ";1147843795;Taip;15;0;0;15
6626;Pakalnutė;"Zuikučių ";6879558965;Taip;0;6;0;6
6627;Pakalnutė;"Zuikučių ";3555822605;Taip;11;0;1;12
6628;Pakalnutė;"Zuikučių ";7563201788;Taip;0;5;0;5
6629;Pakalnutė;"Zuikučių ";1583462733;Taip;0;2;0;2
6630;Pakalnutė;"Zuikučių ";6377564215;Taip;0;3;0;3
6631;Pakalnutė;"Zuikučių ";3306670221;Taip;0;4;4;8
6632;Pakalnutė;"Zuikučių ";1159312512;Taip;7;5;0;12
6633;Pakalnutė;"Zuikučių ";6549217377;Taip;0;1;0;1
6634;Pakalnutė;"Zuikučių ";1610847242;Taip;0;3;0;3
6635;Pakalnutė;"Zuikučių ";8813262660;Taip;19;0;0;19
6636;Pakalnutė;"Zuikučių ";5102345686;Taip;0;1;1;2
6637;Pakalnutė;"Zuikučių ";7949588551;Taip;0;4;2;6
6638;Pakalnutė;"Drugelių ";4046820545;Taip;4;2;0;6
6639;Pakalnutė;"Drugelių ";5973972464;Taip;11;0;0;11
6640;Pakalnutė;"Drugelių ";3035056391;Taip;0;11;0;11
6641;Pakalnutė;"Drugelių ";4742424647;Taip;7;0;0;7
6642;Pakalnutė;"Drugelių ";2075865543;Taip;7;0;1;8
6643;Pakalnutė;"Drugelių ";9562957603;Taip;7;0;0;7
6644;Pakalnutė;"Drugelių ";5435336235;Taip;16;0;0;16
6645;Pakalnutė;"Drugelių ";2050880681;Taip;7;0;0;7
6646;Pakalnutė;"Drugelių ";4514642887;Taip;0;5;0;5
6647;Pakalnutė;"Drugelių ";9274456755;Taip;0;5;0;5
6648;Pakalnutė;"Drugelių ";2721810040;Taip;5;0;10;15
6649;Pakalnutė;"Drugelių ";80818670065;Taip;17;0;0;17
6650;Pakalnutė;"Drugelių ";2049079012;Taip;11;5;0;16
6651;Pakalnutė;"Drugelių ";4681267749;Taip;13;3;0;16
6652;Pakalnutė;"Drugelių ";85356812538;Taip;8;1;1;10
6653;Pakalnutė;"Drugelių ";6771510589;Taip;0;1;3;4
6654;Pakalnutė;"Drugelių ";18503890312;Taip;5;8;0;13
6655;Pakalnutė;"Drugelių ";4264260466;Taip;7;0;10;17
6656;Panerių;Rūtelė;21661667266;Taip;0;4;8;12
6657;Panerių;Rūtelė;1429591387;Taip;0;0;1;1
6658;Panerių;Rūtelė;14092687895;Taip;0;0;1;1
6659;Panerių;Rūtelė;8498616733;Taip;0;13;0;13
6660;Panerių;Rūtelė;7324873912;Taip;3;0;1;4
6661;Panerių;Rūtelė;8388744329;Taip;0;3;1;4
6662;Panerių;Rūtelė;2348627375;Taip;5;0;1;6
6663;Panerių;Rūtelė;3349776899;Taip;0;11;7;18
6664;Panerių;Rūtelė;68313730462;Taip;5;0;1;6
6665;Panerių;Rūtelė;84672957234;Taip;0;6;0;6
6666;Panerių;Rūtelė;60738239005;Taip;19;0;0;19
6667;Panerių;Rūtelė;10051044012;Taip;0;10;0;10
6668;Panerių;Rūtelė;1017100748;Taip;6;4;0;10
6669;Panerių;Rūtelė;68231938043;Taip;10;0;1;11
6670;Panerių;Rūtelė;78838685571;Taip;0;5;5;10
6671;Panerių;Rūtelė;53384267657;Taip;0;2;1;3
6672;Panerių;Rūtelė;1558843252;Taip;17;0;0;17
6673;Panerių;Rūtelė;8666159951;Taip;12;0;4;16
6674;Panerių;Rūtelė;39185053006;Taip;11;2;0;13
6675;Panerių;Gėlytės;1894521927;Taip;0;4;1;5
6676;Panerių;Gėlytės;1303873524;Taip;0;2;1;3
6677;Panerių;Gėlytės;75034220223;Taip;20;0;0;20
6678;Panerių;Gėlytės;1386277428;Taip;0;1;0;1
6679;Panerių;Gėlytės;2069150261;Taip;8;2;0;10
6680;Panerių;Gėlytės;5109850366;Taip;11;2;0;13
6681;Panerių;Gėlytės;9268558715;Taip;17;0;0;17
6682;Panerių;Gėlytės;9004468035;Taip;0;3;6;9
6683;Panerių;Gėlytės;1423148023;Taip;0;8;1;9
6684;Panerių;Gėlytės;8149880453;Taip;5;0;4;9
6685;Panerių;Gėlytės;6227583229;Taip;0;4;8;12
6686;Panerių;Gėlytės;3843500717;Taip;7;2;2;11
6687;Panerių;Gėlytės;9639587601;Taip;0;1;0;1
6688;Panerių;Gėlytės;2786775879;Taip;14;4;0;18
6689;Panerių;Gėlytės;7337663549;Taip;18;0;0;18
6690;Panerių;Gėlytės;4103412131;Taip;9;0;1;10
6691;Panerių;Gėlytės;7903272014;Taip;5;6;0;11
6692;Panerių;Gėlytės;3631150576;Taip;0;1;0;1
6693;Panerių;Gėlytės;5001921323;Taip;0;1;2;3
6694;Panerių;Boružė;7805429137;Taip;0;4;2;6
6695;Panerių;Boružė;8299189235;Taip;20;0;0;20
6696;Panerių;Boružė;9268618414;Taip;0;1;3;4
6697;Panerių;Boružė;6908487075;Taip;0;5;5;10
6698;Panerių;Boružė;2571561865;Taip;0;13;0;13
6699;Panerių;Boružė;6411372006;Taip;15;5;0;20
6700;Panerių;Boružė;1419817211;Taip;20;0;0;20
6701;Panerių;Boružė;9188471756;Taip;5;0;1;6
6702;Panerių;Boružė;4023257875;Taip;0;13;0;13
6703;Panerių;Boružė;4689913361;Taip;0;0;2;2
6704;Panerių;Boružė;8693113275;Taip;15;0;0;15
6705;Panerių;Boružė;6182126113;Ne;5;0;1;6
6706;Papartis;ZUIKUČIAI;1065234123;Taip;8;2;3;13
6707;Papartis;ZUIKUČIAI;27900855758;Taip;15;0;0;15
6708;Papartis;ZUIKUČIAI;1219140467;Taip;10;0;0;10
6709;Papartis;ZUIKUČIAI;1260151691;Taip;7;3;0;10
6710;Papartis;ZUIKUČIAI;2412700197;Taip;15;0;0;15
6711;Papartis;ZUIKUČIAI;1554777403;Taip;0;7;0;7
6712;Papartis;ZUIKUČIAI;7703070601;Taip;0;6;0;6
6713;Papartis;ZUIKUČIAI;7902130389;Taip;13;0;0;13
6714;Papartis;ZUIKUČIAI;4992305227;Taip;10;6;0;16
6715;Papartis;ZUIKUČIAI;4346817695;Taip;10;2;3;15
6716;Papartis;ZUIKUČIAI;2447926422;Taip;10;5;0;15
6717;Papartis;ZUIKUČIAI;3182457453;Taip;10;1;0;11
6718;Papartis;ZUIKUČIAI;3275123842;Taip;8;3;0;11
6719;Papartis;ZUIKUČIAI;8190458132;Taip;8;5;0;13
6720;Papartis;ZUIKUČIAI;8952917454;Taip;10;5;0;15
6721;Papartis;ZUIKUČIAI;5410369044;Taip;12;5;0;17
6722;Papartis;ZUIKUČIAI;6126912448;Taip;7;0;1;8
6723;Papartis;ZUIKUČIAI;3221250267;Taip;5;0;0;5
6724;Papartis;ZUIKUČIAI;5846324441;Taip;10;2;1;13
6725;Papartis;ZUIKUČIAI;1065128993;Taip;7;4;2;13
6726;Papartis;ZUIKUČIAI;3895487270;Taip;12;1;0;13
6727;Papartis;DRUGELIAI;4508053349;Taip;3;4;0;7
6728;Papartis;DRUGELIAI;7387281720;Taip;16;0;0;16
6729;Papartis;DRUGELIAI;3243869451;Taip;0;1;3;4
6730;Papartis;DRUGELIAI;2778629398;Taip;20;0;0;20
6731;Papartis;DRUGELIAI;3475745012;Taip;5;2;13;20
6732;Papartis;DRUGELIAI;2535412635;Taip;7;0;1;8
6733;Papartis;DRUGELIAI;6797687614;Taip;0;11;0;11
6734;Papartis;DRUGELIAI;7606939822;Taip;0;0;3;3
6735;Papartis;DRUGELIAI;9719465384;Taip;7;0;0;7
6736;Papartis;DRUGELIAI;8148483438;Taip;16;0;0;16
6737;Papartis;DRUGELIAI;5265293240;Taip;10;2;0;12
6738;Papartis;DRUGELIAI;7590170146;Taip;0;0;3;3
6739;Papartis;DRUGELIAI;9134335737;Taip;10;2;0;12
6740;Papartis;DRUGELIAI;1836914270;Taip;0;0;2;2
6741;Papartis;DRUGELIAI;4935694347;Taip;10;0;5;15
6742;Papartis;DRUGELIAI;1672028156;Taip;7;2;0;9
6743;Papartis;DRUGELIAI;4634683589;Ne;0;3;0;3
6744;Papartis;DRUGELIAI;3267416367;Taip;0;1;0;1
6745;Papartis;DRUGELIAI;3107106078;Taip;6;0;0;6
6746;Papartis;DRUGELIAI;1205854439;Taip;16;0;0;16
6747;Papartis;DRUGELIAI;7067369268;Taip;11;0;1;12
6748;Papartis;DRUGELIAI;6746279237;Taip;14;6;0;20
6749;Papartis;ŽVIRBLIUKAI;50932429867;Taip;0;5;0;5
6750;Papartis;ŽVIRBLIUKAI;76557621397;Taip;0;5;2;7
6751;Papartis;ŽVIRBLIUKAI;25395258852;Taip;0;2;0;2
6752;Papartis;ŽVIRBLIUKAI;38687595335;Taip;8;2;0;10
6753;Papartis;ŽVIRBLIUKAI;2572865390;Taip;0;5;7;12
6754;Papartis;ŽVIRBLIUKAI;42525320308;Taip;5;4;0;9
6755;Papartis;ŽVIRBLIUKAI;36753788655;Taip;3;11;0;14
6756;Papartis;ŽVIRBLIUKAI;75872164784;Taip;0;5;2;7
6757;Papartis;ŽVIRBLIUKAI;97003005429;Taip;0;15;5;20
6758;Papartis;ŽVIRBLIUKAI;2328716782;Taip;0;13;0;13
6759;Papartis;ŽVIRBLIUKAI;46090386686;Taip;0;5;3;8
6760;Papartis;ŽVIRBLIUKAI;42363051383;Taip;0;5;0;5
6761;Papartis;ŽVIRBLIUKAI;44727915152;Taip;0;5;0;5
6762;Papartis;ŽVIRBLIUKAI;60618694149;Taip;0;8;0;8
6763;Papartis;ŽVIRBLIUKAI;60803503066;Taip;0;6;0;6
6764;Papartis;ŽVIRBLIUKAI;66084413148;Taip;0;1;4;5
6765;Papartis;ŽVIRBLIUKAI;54923526939;Taip;0;5;0;5
6766;Papartis;ŽVIRBLIUKAI;65887563163;Ne;0;5;0;5
6767;Papartis;ŽVIRBLIUKAI;95325725936;Taip;0;10;0;10
6768;Papartis;ŽVIRBLIUKAI;6896883671;Taip;0;0;4;4
6769;Papartis;ŽVIRBLIUKAI;1712122097;Taip;3;1;0;4
6770;Papartis;PELĖDŽIUKAI;31558670598;Taip;3;5;0;8
6771;Papartis;PELĖDŽIUKAI;17727499036;Taip;0;5;6;11
6772;Papartis;PELĖDŽIUKAI;33710012877;Taip;0;5;1;6
6773;Papartis;PELĖDŽIUKAI;3150874256;Taip;3;6;1;10
6774;Papartis;PELĖDŽIUKAI;37962640982;Taip;4;0;0;4
6775;Papartis;PELĖDŽIUKAI;5610352010;Taip;0;8;0;8
6776;Papartis;PELĖDŽIUKAI;97048061562;Taip;0;8;0;8
6777;Papartis;PELĖDŽIUKAI;14737302670;Taip;0;9;0;9
6778;Papartis;PELĖDŽIUKAI;77941154397;Taip;3;5;0;8
6779;Papartis;PELĖDŽIUKAI;10942624686;Taip;0;5;15;20
6780;Papartis;PELĖDŽIUKAI;2759394795;Taip;3;6;0;9
6781;Papartis;PELĖDŽIUKAI;62851879822;Taip;0;5;0;5
6782;Papartis;PELĖDŽIUKAI;75595469519;Taip;9;0;0;9
6783;Papartis;PELĖDŽIUKAI;50230057955;Taip;0;5;1;6
6784;Papartis;PELĖDŽIUKAI;98845059554;Taip;0;5;1;6
6785;Papartis;PELĖDŽIUKAI;14077470090;Taip;0;6;0;6
6786;Papartis;PELĖDŽIUKAI;7603023091;Ne;0;10;1;11
6787;Papartis;PELĖDŽIUKAI;72201740881;Taip;6;5;0;11
6788;Papartis;PELĖDŽIUKAI;87817163360;Taip;0;1;1;2
6789;Papartis;PELĖDŽIUKAI;89808286532;Taip;0;3;0;3
6790;Papartis;PELĖDŽIUKAI;4351158000;Taip;0;8;0;8
6791;Papartis;SAULUTĖS;42803013754;Taip;0;6;0;6
6792;Papartis;SAULUTĖS;2022533158;Taip;0;3;2;5
6793;Papartis;SAULUTĖS;1237889393;Taip;3;6;0;9
6794;Papartis;SAULUTĖS;1246604915;Taip;1;2;0;3
6795;Papartis;SAULUTĖS;48182233276;Taip;0;6;0;6
6796;Papartis;SAULUTĖS;23218268605;Ne;1;0;0;1
6797;Papartis;SAULUTĖS;18124337938;Taip;4;5;0;9
6798;Papartis;SAULUTĖS;22443998204;Taip;8;1;0;9
6799;Papartis;SAULUTĖS;30982681803;Taip;0;5;0;5
6800;Papartis;SAULUTĖS;95139517078;Taip;0;6;0;6
6801;Papartis;SAULUTĖS;14978429821;Taip;0;6;0;6
6802;Papartis;SAULUTĖS;55573140983;Taip;1;0;0;1
6803;Papartis;SAULUTĖS;50090482473;Taip;0;3;0;3
6804;Papartis;SAULUTĖS;10078570352;Taip;10;0;0;10
6805;Papartis;SAULUTĖS;88700503601;Taip;10;5;1;16
6806;Papartis;SAULUTĖS;21963930874;Taip;4;1;0;5
6807;Papartis;SAULUTĖS;15207322802;Taip;0;6;0;6
6808;Papartis;SAULUTĖS;2115718328;Ne;2;0;5;7
6809;Papartis;SAULUTĖS;3933829088;Taip;6;3;1;10
6810;Papartis;SAULUTĖS;67966766974;Taip;3;5;0;8
6811;Papartis;GANDRIUKAI;46076659264;Ne;10;5;0;15
6812;Papartis;GANDRIUKAI;31606112621;Taip;5;0;0;5
6813;Papartis;GANDRIUKAI;1727771667;Taip;4;5;1;10
6814;Papartis;GANDRIUKAI;37759125130;Taip;0;20;0;20
6815;Papartis;GANDRIUKAI;20862839950;Taip;10;2;0;12
6816;Papartis;GANDRIUKAI;8564913801;Taip;15;0;0;15
6817;Papartis;GANDRIUKAI;47876153590;Taip;10;0;0;10
6818;Papartis;GANDRIUKAI;84260015363;Taip;1;7;0;8
6819;Papartis;GANDRIUKAI;67226404925;Taip;20;0;0;20
6820;Papartis;GANDRIUKAI;41330436046;Taip;0;5;1;6
6821;Papartis;GANDRIUKAI;83927324420;Taip;4;0;0;4
6822;Papartis;GANDRIUKAI;21840378271;Taip;5;0;0;5
6823;Papartis;GANDRIUKAI;93141801552;Taip;10;0;0;10
6824;Papartis;GANDRIUKAI;80455285324;Taip;5;0;0;5
6825;Papartis;GANDRIUKAI;81006952163;Taip;6;0;0;6
6826;Papartis;GANDRIUKAI;285754903;Taip;5;5;0;10
6827;Papartis;GANDRIUKAI;79080758672;Taip;0;5;0;5
6828;Papartis;GANDRIUKAI;18164175829;Taip;15;0;0;15
6829;Papartis;GANDRIUKAI;10026323228;Taip;0;5;15;20
6830;Papartis;GANDRIUKAI;1045629158;Taip;0;5;3;8
6831;Papartis;GANDRIUKAI;8593823543;Taip;13;2;0;15
6832;Papartis;AITVARELIAI;4139884005;Taip;0;1;1;2
6833;Papartis;AITVARELIAI;2146286089;Taip;0;0;2;2
6834;Papartis;AITVARELIAI;1876543445;Taip;1;0;0;1
6835;Papartis;AITVARELIAI;19544040390;Taip;3;0;0;3
6836;Papartis;AITVARELIAI;19852567505;Taip;4;9;0;13
6837;Papartis;AITVARELIAI;32352993438;Taip;10;0;3;13
6838;Papartis;AITVARELIAI;67237428983;Taip;7;0;1;8
6839;Papartis;AITVARELIAI;89486863055;Taip;0;3;0;3
6840;Papartis;AITVARELIAI;20002349512;Taip;0;1;0;1
6841;Papartis;AITVARELIAI;81734271362;Taip;10;5;0;15
6842;Papartis;AITVARELIAI;87519747220;Taip;0;4;11;15
6843;Papartis;AITVARELIAI;93468721158;Taip;0;7;0;7
6844;Papartis;AITVARELIAI;87353511647;Taip;0;5;0;5
6845;Papartis;AITVARELIAI;25990216006;Taip;5;1;2;8
6846;Papartis;AITVARELIAI;26912851152;Taip;5;0;1;6
6847;Papartis;AITVARELIAI;60706816641;Taip;0;5;7;12
6848;Papartis;AITVARELIAI;1973027294;Taip;3;11;0;14
6849;Papartis;AITVARELIAI;1403114386;Taip;2;4;0;6
6850;Papartis;SMALSUČIAI;2889259605;Taip;5;0;2;7
6851;Papartis;SMALSUČIAI;72182866449;Taip;5;5;0;10
6852;Papartis;SMALSUČIAI;3287617252;Taip;0;0;2;2
6853;Papartis;SMALSUČIAI;4823666725;Taip;8;2;0;10
6854;Papartis;SMALSUČIAI;1406820323;Taip;10;6;0;16
6855;Papartis;SMALSUČIAI;2092191603;Taip;5;1;0;6
6856;Papartis;SMALSUČIAI;10659508171;Taip;12;1;0;13
6857;Papartis;SMALSUČIAI;2067304804;Taip;6;3;0;9
6858;Papartis;SMALSUČIAI;88418552221;Taip;13;1;0;14
6859;Papartis;SMALSUČIAI;51899025231;Taip;4;0;0;4
6860;Papartis;SMALSUČIAI;74972133115;Taip;10;0;0;10
6861;Papartis;SMALSUČIAI;1322826573;Taip;10;0;0;10
6862;Papartis;SMALSUČIAI;1527263538;Taip;9;0;0;9
6863;Papartis;SMALSUČIAI;88722771438;Taip;0;5;0;5
6864;Papartis;SMALSUČIAI;4216398263;Taip;6;0;0;6
6865;Papartis;SMALSUČIAI;89525856173;Taip;0;5;0;5
6866;Papartis;SMALSUČIAI;82454730189;Taip;9;0;0;9
6867;Papartis;SMALSUČIAI;74734443304;Taip;3;2;0;5
6868;Papartis;SMALSUČIAI;2398385967;Taip;5;2;0;7
6869;Papartis;SMALSUČIAI;63087155760;Taip;6;0;1;7
6870;Papartis;SMALSUČIAI;26193472997;Taip;13;1;1;15
6871;Papartis;SMALSUČIAI;68478260102;Ne;10;1;0;11
6872;Papartis;"ŽIRNIUKAI ";44833872631;Taip;16;0;0;16
6873;Papartis;"ŽIRNIUKAI ";1944730492;Taip;9;5;0;14
6874;Papartis;"ŽIRNIUKAI ";12406782910;Taip;9;0;0;9
6875;Papartis;"ŽIRNIUKAI ";1271303103;Taip;0;3;17;20
6876;Papartis;"ŽIRNIUKAI ";7845277151;Taip;0;4;1;5
6877;Papartis;"ŽIRNIUKAI ";30041894006;Taip;0;0;4;4
6878;Papartis;"ŽIRNIUKAI ";3630377970;Taip;7;5;5;17
6879;Papartis;"ŽIRNIUKAI ";38896771062;Taip;8;0;0;8
6880;Papartis;"ŽIRNIUKAI ";86735273559;Taip;0;3;0;3
6881;Papartis;"ŽIRNIUKAI ";29789530287;Taip;0;5;2;7
6882;Papartis;"ŽIRNIUKAI ";22570313128;Taip;15;3;0;18
6883;Papartis;"ŽIRNIUKAI ";51588027659;Taip;8;4;0;12
6884;Papartis;"ŽIRNIUKAI ";1703232380;Taip;0;6;0;6
6885;Papartis;"ŽIRNIUKAI ";64345875780;Ne;11;2;0;13
6886;Papartis;"ŽIRNIUKAI ";2598688561;Taip;17;0;0;17
6887;Papartis;"ŽIRNIUKAI ";53040207725;Taip;2;9;1;12
6888;Papartis;"ŽIRNIUKAI ";3991709974;Taip;8;8;0;16
6889;Papartis;"ŽIRNIUKAI ";3367009621;Taip;11;0;0;11
6890;Papartis;"ŽIRNIUKAI ";7102350653;Taip;8;4;0;12
6891;Papartis;"ŽIRNIUKAI ";3408756311;Taip;0;1;0;1
6892;Papartis;BORUŽĖLĖS;3320524073;Taip;15;0;0;15
6893;Papartis;BORUŽĖLĖS;9384670351;Taip;5;8;0;13
6894;Papartis;BORUŽĖLĖS;5732853976;Taip;12;0;0;12
6895;Papartis;BORUŽĖLĖS;4279580382;Taip;5;0;1;6
6896;Papartis;BORUŽĖLĖS;8891856856;Taip;6;3;0;9
6897;Papartis;BORUŽĖLĖS;8532558577;Taip;5;2;0;7
6898;Papartis;BORUŽĖLĖS;9968072478;Taip;2;0;7;9
6899;Papartis;BORUŽĖLĖS;1916222143;Taip;5;7;0;12
6900;Papartis;BORUŽĖLĖS;2215846642;Taip;18;0;0;18
6901;Papartis;BORUŽĖLĖS;9704930584;Taip;5;2;0;7
6902;Papartis;BORUŽĖLĖS;7859096984;Taip;5;3;0;8
6903;Papartis;BORUŽĖLĖS;1442806517;Taip;10;0;2;12
6904;Papartis;BORUŽĖLĖS;7252265838;Taip;13;0;0;13
6905;Papartis;BORUŽĖLĖS;9072635586;Taip;12;0;0;12
6906;Papartis;BORUŽĖLĖS;9804863902;Taip;6;5;0;11
6907;Papartis;VARPELIAI;9502229005;Taip;10;0;0;10
6908;Papartis;VARPELIAI;4203241118;Taip;5;5;1;11
6909;Papartis;VARPELIAI;4570512336;Taip;14;0;0;14
6910;Papartis;VARPELIAI;3324647852;Taip;5;5;0;10
6911;Papartis;VARPELIAI;5652560002;Taip;5;0;0;5
6912;Papartis;VARPELIAI;6949120693;Taip;0;9;3;12
6913;Papartis;VARPELIAI;6794076631;Taip;10;5;0;15
6914;Papartis;VARPELIAI;1596721999;Taip;9;3;8;20
6915;Papartis;VARPELIAI;5957889361;Taip;3;0;0;3
6916;Papartis;VARPELIAI;4806652727;Taip;10;5;0;15
6917;Papartis;VARPELIAI;9939850340;Taip;5;1;0;6
6918;Papartis;VARPELIAI;8932290803;Taip;9;0;2;11
6919;Papartis;VARPELIAI;7803854703;Taip;0;6;0;6
6920;Papartis;VARPELIAI;5218101579;Taip;16;0;0;16
6921;Papartis;VARPELIAI;5608868738;Ne;7;5;0;12
6922;Papartis;VARPELIAI;6423401656;Taip;4;0;0;4
6923;Papartis;NYKŠTUKAI;94692743993;Taip;5;1;0;6
6924;Papartis;NYKŠTUKAI;28903744662;Taip;10;5;0;15
6925;Papartis;NYKŠTUKAI;49067272346;Taip;15;5;0;20
6926;Papartis;NYKŠTUKAI;1683639252;Taip;5;5;0;10
6927;Papartis;NYKŠTUKAI;86974446702;Taip;0;11;0;11
6928;Papartis;NYKŠTUKAI;18677892477;Taip;0;9;0;9
6929;Papartis;NYKŠTUKAI;2414727436;Taip;10;5;0;15
6930;Papartis;NYKŠTUKAI;8116656307;Taip;5;0;0;5
6931;Papartis;NYKŠTUKAI;1787027071;Taip;0;5;2;7
6932;Papartis;NYKŠTUKAI;1957969359;Taip;8;5;0;13
6933;Papartis;NYKŠTUKAI;1699776923;Taip;4;5;1;10
6934;Papartis;NYKŠTUKAI;1691817767;Taip;5;11;0;16
6935;Papartis;NYKŠTUKAI;35385266110;Taip;0;8;0;8
6936;Papartis;NYKŠTUKAI;1201154176;Ne;0;0;2;2
6937;Papartis;NYKŠTUKAI;7308118576;Taip;0;10;5;15
6938;Papartis;NYKŠTUKAI;4999708473;Taip;9;0;2;11
6939;Papartis;NYKŠTUKAI;3264373480;Taip;9;1;0;10
6940;Papartis;NYKŠTUKAI;29324405170;Taip;0;9;0;9
6941;Pasagėlė;SMALSUČIŲ;63657801249;Taip;1;4;3;8
6942;Pasagėlė;SMALSUČIŲ;2077383621;Taip;0;6;0;6
6943;Pasagėlė;SMALSUČIŲ;2096927238;Taip;9;0;0;9
6944;Pasagėlė;SMALSUČIŲ;2096035763;Taip;2;5;0;7
6945;Pasagėlė;SMALSUČIŲ;6687699907;Taip;4;5;0;9
6946;Pasagėlė;SMALSUČIŲ;27151485531;Taip;11;0;2;13
6947;Pasagėlė;SMALSUČIŲ;1616662586;Taip;13;3;0;16
6948;Pasagėlė;SMALSUČIŲ;7477773004;Taip;10;0;0;10
6949;Pasagėlė;SMALSUČIŲ;1180183091;Taip;6;0;1;7
6950;Pasagėlė;SMALSUČIŲ;8285580095;Taip;0;4;16;20
6951;Pasagėlė;SMALSUČIŲ;8218872969;Taip;0;1;4;5
6952;Pasagėlė;SMALSUČIŲ;8301904575;Taip;11;1;1;13
6953;Pasagėlė;SMALSUČIŲ;1587218379;Taip;10;5;0;15
6954;Pasagėlė;SMALSUČIŲ;80775017833;Taip;0;4;5;9
6955;Pasagėlė;SMALSUČIŲ;49106308532;Taip;0;5;0;5
6956;Pasagėlė;SMALSUČIŲ;6543038595;Taip;13;4;0;17
6957;Pasagėlė;GUDRUČIŲ;75037090183;Ne;0;6;6;12
6958;Pasagėlė;GUDRUČIŲ;1768000089;Taip;5;0;0;5
6959;Pasagėlė;GUDRUČIŲ;84330734709;Taip;0;0;2;2
6960;Pasagėlė;GUDRUČIŲ;80908835303;Taip;0;3;0;3
6961;Pasagėlė;GUDRUČIŲ;7050705086;Taip;0;1;0;1
6962;Pasagėlė;GUDRUČIŲ;2137489054;Taip;0;3;2;5
6963;Pasagėlė;GUDRUČIŲ;5228878677;Taip;15;5;0;20
6964;Pasagėlė;GUDRUČIŲ;1040850911;Taip;0;6;1;7
6965;Pasagėlė;GUDRUČIŲ;1215400980;Taip;10;5;0;15
6966;Pasagėlė;GUDRUČIŲ;1054424694;Taip;0;1;1;2
6967;Pasagėlė;GUDRUČIŲ;6011034443;Taip;0;1;3;4
6968;Pasagėlė;GUDRUČIŲ;3254801126;Taip;0;3;0;3
6969;Pasagėlė;GUDRUČIŲ;1511098546;Taip;3;5;0;8
6970;Pasagėlė;GUDRUČIŲ;54694832614;Taip;0;5;1;6
6971;Pasagėlė;GUDRUČIŲ;2023002624;Taip;0;0;10;10
6972;Pasagėlė;GUDRUČIŲ;8428101374;Taip;2;0;0;2
6973;Pasagėlė;GUDRUČIŲ;60492768809;Taip;0;3;2;5
6974;Pasagėlė;GUDRUČIŲ;64636489181;Taip;0;1;1;2
6975;Pasagėlė;GUDRUČIŲ;69892632522;Taip;15;5;0;20
6976;Pasagėlė;GUDRUČIŲ;1600378710;Taip;0;5;2;7
6977;Pasagėlė;PABIRUČIŲ;1113026818;Taip;0;0;1;1
6978;Pasagėlė;PABIRUČIŲ;8301938009;Taip;5;0;0;5
6979;Pasagėlė;PABIRUČIŲ;20999997254;Taip;0;1;0;1
6980;Pasagėlė;PABIRUČIŲ;9388057389;Taip;2;0;0;2
6981;Pasagėlė;PABIRUČIŲ;20743334216;Taip;1;5;3;9
6982;Pasagėlė;PABIRUČIŲ;1371753067;Taip;6;0;0;6
6983;Pasagėlė;PABIRUČIŲ;9801268758;Taip;0;3;3;6
6984;Pasagėlė;PABIRUČIŲ;3405470634;Taip;6;0;0;6
6985;Pasagėlė;PABIRUČIŲ;3583848327;Taip;0;5;1;6
6986;Pasagėlė;PABIRUČIŲ;5040657332;Taip;8;0;0;8
6987;Pasagėlė;PABIRUČIŲ;3924127476;Taip;0;9;0;9
6988;Pasagėlė;PABIRUČIŲ;2769668641;Taip;8;0;0;8
6989;Pasagėlė;PABIRUČIŲ;4261133734;Taip;13;1;0;14
6990;Pasagėlė;PABIRUČIŲ;3576157355;Taip;13;5;0;18
6991;Pasagėlė;PABIRUČIŲ;6429160371;Taip;10;1;0;11
6992;Pasaka;Drugelių;94297031036;Taip;5;1;11;17
6993;Pasaka;Drugelių;13636850029;Taip;5;0;0;5
6994;Pasaka;Drugelių;6029722606;Taip;0;0;3;3
6995;Pasaka;Drugelių;1182329854;Taip;0;3;0;3
6996;Pasaka;Drugelių;28436567147;Taip;0;0;2;2
6997;Pasaka;Drugelių;23870813014;Taip;0;0;4;4
6998;Pasaka;Drugelių;9176679994;Taip;5;0;0;5
6999;Pasaka;Drugelių;39078157321;Taip;0;5;0;5
7000;Pasaka;Drugelių;39551214597;Taip;1;0;0;1
7001;Pasaka;Drugelių;93787399452;Taip;0;1;0;1
7002;Pasaka;Drugelių;27093500070;Taip;0;12;0;12
7003;Pasaka;Drugelių;33026273567;Taip;0;1;2;3
7004;Pasaka;Drugelių;28874215183;Taip;0;10;0;10
7005;Pasaka;Drugelių;70534119238;Taip;0;1;4;5
7006;Pasaka;Drugelių;63580854012;Taip;4;6;0;10
7007;Pasaka;Nykštukų;71026394541;Taip;3;1;0;4
7008;Pasaka;Nykštukų;93130495054;Taip;0;2;3;5
7009;Pasaka;Nykštukų;57075224058;Taip;0;2;3;5
7010;Pasaka;Nykštukų;2063660647;Taip;5;2;0;7
7011;Pasaka;Nykštukų;18135410695;Taip;8;7;0;15
7012;Pasaka;Nykštukų;37149227316;Taip;3;1;0;4
7013;Pasaka;Nykštukų;44488699090;Taip;0;1;0;1
7014;Pasaka;Nykštukų;1386420328;Taip;5;0;9;14
7015;Pasaka;Nykštukų;27770796692;Taip;0;0;3;3
7016;Pasaka;Nykštukų;5459272292;Taip;0;2;10;12
7017;Pasaka;Nykštukų;5665758011;Taip;4;2;2;8
7018;Pasaka;Nykštukų;8166051272;Taip;0;3;2;5
7019;Pasaka;Nykštukų;1237568934;Taip;0;3;0;3
7020;Pasaka;Nykštukų;91546084785;Taip;5;2;5;12
7021;Pasaka;Nykštukų;7040953491;Taip;5;0;0;5
7022;Pasaka;Nykštukų;1333499160;Taip;5;1;0;6
7023;Pasaka;Nykštukų;66315088164;Taip;1;2;1;4
7024;Pasaka;Nykštukų;3088081091;Taip;3;2;1;6
7025;Pasaka;Nykštukų;6893044575;Taip;10;0;0;10
7026;Pasaka;Nykštukų;4071643754;Taip;5;2;2;9
7027;Pasaka;Montesori;22952446246;Taip;0;0;3;3
7028;Pasaka;Montesori;52716349501;Taip;11;5;0;16
7029;Pasaka;Montesori;4130774501;Taip;7;3;0;10
7030;Pasaka;Montesori;93485300003;Taip;5;5;0;10
7031;Pasaka;Montesori;67492634520;Taip;7;0;1;8
7032;Pasaka;Montesori;56974315820;Taip;10;0;0;10
7033;Pasaka;Montesori;31094198532;Taip;0;5;0;5
7034;Pasaka;Montesori;65118883315;Taip;0;5;0;5
7035;Pasaka;Montesori;50242777961;Taip;0;5;0;5
7036;Pasaka;Montesori;88392698583;Taip;15;5;0;20
7037;Pasaka;Montesori;49914586879;Taip;10;0;0;10
7038;Pasaka;Montesori;17561742498;Taip;0;4;0;4
7039;Pasaka;Montesori;47000824102;Taip;0;5;0;5
7040;Pasaka;Montesori;42973327518;Taip;0;0;3;3
7041;Pasaka;Montesori;1450566193;Taip;0;6;1;7
7042;Pasaka;Montesori;31880975983;Taip;0;4;0;4
7043;Pasaka;Montesori;90472847444;Taip;5;5;0;10
7044;Pasaka;Montesori;69250064506;Taip;10;3;0;13
7045;Pasaka;Montesori;81598865451;Taip;0;0;5;5
7046;Pasaka;Montesori;7016077429;Taip;0;5;0;5
7047;Pasaka;Montesori;39319539842;Taip;7;0;1;8
7048;Pasaka;Montesori;16974081144;Taip;10;0;0;10
7049;Pasaka;Montesori;1514381003;Taip;0;5;0;5
7050;Pasaka;Montesori;93994995081;Taip;0;5;0;5
7051;Pasaka;Montesori;4305485747;Taip;5;0;0;5
7052;Pasaka;Žirniukų;17931259433;Taip;0;5;4;9
7053;Pasaka;Žirniukų;7648503006;Taip;6;0;1;7
7054;Pasaka;Žirniukų;2697014098;Taip;5;0;0;5
7055;Pasaka;Žirniukų;73703706115;Taip;0;2;6;8
7056;Pasaka;Žirniukų;2018620389;Taip;0;3;0;3
7057;Pasaka;Žirniukų;6441884677;Taip;0;11;0;11
7058;Pasaka;Žirniukų;5651452381;Taip;0;11;0;11
7059;Pasaka;Žirniukų;1720511696;Taip;5;5;0;10
7060;Pasaka;Žirniukų;1836826810;Taip;5;0;0;5
7061;Pasaka;Žirniukų;1826743229;Taip;0;1;0;1
7062;Pasaka;Žirniukų;9560190761;Taip;0;1;0;1
7063;Pasaka;Žirniukų;7286419663;Taip;10;0;0;10
7064;Pasaka;Žirniukų;2788679885;Taip;0;10;0;10
7065;Pasaka;Žirniukų;6378803142;Taip;17;0;0;17
7066;Pasaka;Žirniukų;7441310161;Taip;17;0;0;17
7067;Pasaka;Žirniukų;1565873178;Taip;2;1;0;3
7068;Pasaka;Žirniukų;7445696309;Taip;0;5;0;5
7069;Pasaka;Žirniukų;2400455036;Taip;6;5;0;11
7070;Pasaka;Žirniukų;79170702319;Taip;5;5;0;10
7071;Pasaka;"Voveriukų ";15051078156;Taip;10;0;0;10
7072;Pasaka;"Voveriukų ";50319234551;Taip;2;2;3;7
7073;Pasaka;"Voveriukų ";15500820772;Taip;7;0;2;9
7074;Pasaka;"Voveriukų ";12951124853;Taip;0;5;0;5
7075;Pasaka;"Voveriukų ";53523660848;Taip;2;0;0;2
7076;Pasaka;"Voveriukų ";89376142045;Taip;2;1;0;3
7077;Pasaka;"Voveriukų ";1188769609;Taip;2;0;0;2
7078;Pasaka;"Voveriukų ";59491538033;Taip;0;5;0;5
7079;Pasaka;"Voveriukų ";20358771509;Taip;0;5;0;5
7080;Pasaka;"Voveriukų ";94514447596;Taip;0;7;0;7
7081;Pasaka;"Voveriukų ";35718732394;Taip;7;5;0;12
7082;Pasaka;"Voveriukų ";71316589358;Taip;4;7;0;11
7083;Pasaka;"Voveriukų ";61091610394;Taip;4;0;1;5
7084;Pasaka;"Voveriukų ";4344243194;Taip;3;6;0;9
7085;Pasaka;"Voveriukų ";8122815158;Taip;0;10;0;10
7086;Pasaka;"Voveriukų ";1719236931;Taip;4;9;1;14
7087;Pasaka;"Voveriukų ";1257775317;Taip;1;5;0;6
7088;Pasaka;"VALDOFRO 12";7865658875;Taip;6;0;1;7
7089;Pasaka;"VALDOFRO 12";2141354232;Taip;0;5;0;5
7090;Pasaka;"VALDOFRO 12";4271029223;Taip;10;5;0;15
7091;Pasaka;"VALDOFRO 12";49627576872;Taip;5;5;0;10
7092;Pasaka;"VALDOFRO 12";75591036061;Taip;0;1;1;2
7093;Pasaka;"VALDOFRO 12";8042135600;Taip;0;6;9;15
7094;Pasaka;"VALDOFRO 12";20521208273;Taip;4;5;2;11
7095;Pasaka;"VALDOFRO 12";73057603223;Taip;0;3;0;3
7096;Pasaka;"VALDOFRO 12";95288167171;Taip;14;0;0;14
7097;Pasaka;"VALDOFRO 12";40698629247;Taip;0;0;5;5
7098;Pasaka;"VALDOFRO 12";72287065055;Ne;0;5;1;6
7099;Pasaka;"VALDOFRO 12";77282670444;Taip;0;0;3;3
7100;Pasaka;"VALDOFRO 12";22557231904;Taip;0;6;9;15
7101;Pasaka;"VALDOFRO 12";3367120837;Taip;6;0;4;10
7102;Pasaka;"VALDOFRO 12";7010681103;Taip;7;0;4;11
7103;Pasaka;"VALDOFRO 12";1155273197;Taip;0;5;5;10
7104;Pasaka;"VALDOFRO 12";56766427323;Taip;3;1;0;4
7105;Pasaka;"VALDOFRO 12";4680456848;Taip;0;5;0;5
7106;Pasaka;"VALDOFRO 12";5141156728;Taip;0;0;8;8
7107;Pasaka;"VALDORFO 2";34612155918;Taip;0;6;2;8
7108;Pasaka;"VALDORFO 2";48295303497;Taip;4;5;0;9
7109;Pasaka;"VALDORFO 2";1397972532;Taip;3;5;0;8
7110;Pasaka;"VALDORFO 2";27035873367;Taip;3;5;0;8
7111;Pasaka;"VALDORFO 2";27496232796;Taip;0;5;0;5
7112;Pasaka;"VALDORFO 2";95494862542;Taip;10;5;0;15
7113;Pasaka;"VALDORFO 2";25283698668;Taip;0;6;0;6
7114;Pasaka;"VALDORFO 2";42294285713;Taip;7;4;0;11
7115;Pasaka;"VALDORFO 2";50030735612;Taip;0;6;2;8
7116;Pasaka;"VALDORFO 2";80814715752;Taip;0;6;2;8
7117;Pasaka;"VALDORFO 2";15760212135;Taip;0;5;0;5
7118;Pasaka;"VALDORFO 2";61077353229;Taip;6;5;0;11
7119;Pasaka;"VALDORFO 2";2077818693;Taip;0;1;1;2
7120;Pasaka;"VALDORFO 2";71365777764;Taip;4;0;0;4
7121;Pasaka;"VALDORFO 2";1741935840;Taip;9;5;0;14
7122;Pasaka;"VALDORFO 2";77904202630;Taip;12;5;0;17
7123;Pasaka;"VALDORFO 2";4752117533;Taip;0;1;0;1
7124;Pasaka;"VALDORFO 2";7432241898;Taip;5;5;1;11
7125;Pasaka;"VALDORFO 2";10616073718;Taip;6;3;2;11
7126;Pasaka;Gudručiai;39815814046;Taip;3;3;1;7
7127;Pasaka;Gudručiai;92877021972;Taip;10;3;0;13
7128;Pasaka;Gudručiai;81610725511;Taip;10;0;0;10
7129;Pasaka;Gudručiai;48750144608;Taip;2;0;0;2
7130;Pasaka;Gudručiai;1291936607;Taip;0;5;0;5
7131;Pasaka;Gudručiai;49342277188;Taip;0;6;0;6
7132;Pasaka;Gudručiai;79187482503;Taip;0;5;0;5
7133;Pasaka;Gudručiai;36316289275;Taip;0;5;0;5
7134;Pasaka;Gudručiai;55650091777;Taip;0;5;0;5
7135;Pasaka;Gudručiai;74752546806;Taip;0;1;0;1
7136;Pasaka;Gudručiai;21863319299;Taip;0;1;4;5
7137;Pasaka;Gudručiai;65228168263;Taip;6;1;0;7
7138;Pasaka;Gudručiai;15867940757;Taip;0;5;0;5
7139;Pasaka;Gudručiai;91855873214;Taip;0;2;5;7
7140;Pasaka;Gudručiai;35413730712;Taip;4;4;0;8
7141;Pasaka;Gudručiai;19883430399;Taip;2;1;0;3
7142;Pasaka;Gudručiai;46628468146;Taip;0;6;0;6
7143;Pasaka;Gudručiai;1117608861;Taip;5;6;0;11
7144;Pasaka;Gudručiai;78574165785;Taip;0;7;0;7
7145;Pasaka;Bitelių;76899232405;Taip;6;0;1;7
7146;Pasaka;Bitelių;8821776109;Taip;15;5;0;20
7147;Pasaka;Bitelių;45184972933;Taip;0;0;3;3
7148;Pasaka;Bitelių;29836649248;Taip;1;0;0;1
7149;Pasaka;Bitelių;76560015870;Taip;5;0;0;5
7150;Pasaka;Bitelių;78517147252;Taip;9;2;0;11
7151;Pasaka;Bitelių;45850914548;Taip;1;6;0;7
7152;Pasaka;Bitelių;55254934245;Taip;3;5;0;8
7153;Pasaka;Bitelių;4895994309;Taip;3;0;1;4
7154;Pasaka;Bitelių;64143651711;Taip;0;4;3;7
7155;Pasaka;Bitelių;96080851386;Taip;7;0;4;11
7156;Pasaka;Bitelių;62051806386;Taip;5;5;0;10
7157;Pasaka;Bitelių;80567536745;Taip;8;0;2;10
7158;Pasaka;Bitelių;52667398476;Taip;3;1;0;4
7159;Pasaka;Bitelių;53151161817;Taip;0;6;0;6
7160;Pasaka;Bitelių;97012371435;Taip;1;6;0;7
7161;Pasaka;Bitelių;40182594961;Taip;10;0;0;10
7162;Pasaka;Bitelių;17537343699;Taip;3;3;0;6
7163;Pasaka;Bitelių;72878659455;Taip;0;6;0;6
7164;Pasaka;Bitelių;91499940063;Taip;3;5;0;8
7165;Pasaka;"Pabiručių ";6868519179;Taip;0;2;2;4
7166;Pasaka;"Pabiručių ";6759415053;Taip;0;2;2;4
7167;Pasaka;"Pabiručių ";5351364328;Taip;0;4;1;5
7168;Pasaka;"Pabiručių ";4635912654;Taip;0;4;1;5
7169;Pasaka;"Pabiručių ";8132829016;Taip;8;4;1;13
7170;Pasaka;"Pabiručių ";8651165520;Taip;8;4;1;13
7171;Pasaka;"Pabiručių ";5371046207;Taip;15;3;0;18
7172;Pasaka;"Pabiručių ";4137222204;Taip;0;0;2;2
7173;Pasaka;"Pabiručių ";7103485358;Taip;5;1;0;6
7174;Pasaka;"Pabiručių ";8277245475;Taip;0;0;2;2
7175;Pasaka;"Pabiručių ";5723970763;Taip;11;4;2;17
7176;Pasaka;"Pabiručių ";8119086492;Taip;17;0;0;17
7177;Pasaka;Šnekučių;31896116591;Taip;0;0;3;3
7178;Pasaka;Šnekučių;36716138833;Taip;5;0;0;5
7179;Pasaka;Šnekučių;49626651411;Taip;8;0;6;14
7180;Pasaka;Šnekučių;9549799936;Taip;14;6;0;20
7181;Pasaka;Šnekučių;34897359060;Taip;0;0;1;1
7182;Pasaka;Šnekučių;52912333520;Taip;6;0;0;6
7183;Pasaka;Šnekučių;49520139946;Taip;0;0;8;8
7184;Pasaka;Šnekučių;9973758979;Taip;3;0;0;3
7185;Pasaka;Šnekučių;62303770229;Taip;5;0;1;6
7186;Pasaka;Šnekučių;23132755276;Taip;5;5;1;11
7187;Pasaka;Šnekučių;7082166681;Taip;4;1;0;5
7188;Pasaka;Šnekučių;8615661704;Taip;5;7;0;12
7189;Pasaka;Šnekučių;4178679491;Taip;5;7;0;12
7190;Pasaka;Šnekučių;56983167265;Taip;5;7;3;15
7191;Pasaka;Šnekučių;5021568651;Taip;6;0;0;6
7192;Pasaka;Šnekučių;50456063454;Taip;0;0;3;3
7193;Pasaka;Šnekučių;10055061537;Taip;5;0;6;11
7194;Pasaka;Šnekučių;51500606207;Taip;18;0;0;18
7195;Paslaptis;Priešmokyklinė;62476103195;Taip;0;16;0;16
7196;Paslaptis;Priešmokyklinė;8052295537;Taip;0;7;3;10
7197;Paslaptis;Priešmokyklinė;9611990012;Taip;0;5;0;5
7198;Paslaptis;Priešmokyklinė;50274794824;Taip;11;0;0;11
7199;Paslaptis;Priešmokyklinė;26977991466;Taip;0;1;0;1
7200;Paslaptis;Priešmokyklinė;61247199871;Taip;0;4;1;5
7201;Paslaptis;Priešmokyklinė;16224875313;Taip;10;0;6;16
7202;Paslaptis;Priešmokyklinė;68726419200;Taip;0;7;0;7
7203;Paslaptis;Priešmokyklinė;60268283772;Taip;3;5;0;8
7204;Paslaptis;Priešmokyklinė;1828914082;Taip;1;10;0;11
7205;Paslaptis;Priešmokyklinė;1259942408;Taip;0;13;0;13
7206;Paslaptis;Priešmokyklinė;1667818122;Taip;5;10;0;15
7207;Paslaptis;Priešmokyklinė;1128775055;Taip;0;6;7;13
7208;Paslaptis;Priešmokyklinė;36229769543;Taip;10;0;0;10
7209;Paslaptis;Priešmokyklinė;87862241593;Taip;0;3;2;5
7210;Paslaptis;Priešmokyklinė;1677007836;Taip;5;4;0;9
7211;Paslaptis;Priešmokyklinė;1982955007;Ne;0;5;0;5
7212;Paslaptis;Priešmokyklinė;1273662366;Taip;5;1;0;6
7213;Paslaptis;Priešmokyklinė;99228588629;Taip;0;3;1;4
7214;Paslaptis;Priešmokyklinė;57773958059;Taip;0;8;1;9
7215;Paslaptis;Priešmokyklinė;73547132372;Taip;0;6;0;6
7216;Paslaptis;Priešmokyklinė;69704103686;Taip;0;6;5;11
7217;Paslaptis;Priešmokyklinė;18629473292;Taip;5;4;0;9
7218;Paslaptis;Priešmokyklinė;85698709368;Ne;6;3;0;9
7219;Paslaptis;Priešmokyklinė;96867169512;Taip;6;3;0;9
7220;Paslaptis;Priešmokyklinė;1445974659;Taip;0;5;0;5
7221;Paslaptis;Priešmokyklinė;2578713065;Ne;0;13;2;15
7222;Paslaptis;"Darželio mišraus amžiaus grupė";8522925854;Taip;0;13;0;13
7223;Paslaptis;"Darželio mišraus amžiaus grupė";1868248793;Taip;11;2;0;13
7224;Paslaptis;"Darželio mišraus amžiaus grupė";1950287365;Taip;10;0;10;20
7225;Paslaptis;"Darželio mišraus amžiaus grupė";1530380043;Taip;2;1;0;3
7226;Paslaptis;"Darželio mišraus amžiaus grupė";1938288335;Taip;5;0;0;5
7227;Paslaptis;"Darželio mišraus amžiaus grupė";1127602652;Taip;0;3;0;3
7228;Paslaptis;"Darželio mišraus amžiaus grupė";40283689721;Taip;0;10;0;10
7229;Paslaptis;"Darželio mišraus amžiaus grupė";4731417201;Taip;14;1;0;15
7230;Paslaptis;"Darželio mišraus amžiaus grupė";3461773781;Taip;0;14;2;16
7231;Paslaptis;"Darželio mišraus amžiaus grupė";5790420711;Taip;0;8;0;8
7232;Paslaptis;"Darželio mišraus amžiaus grupė";1195616749;Taip;0;1;0;1
7233;Paslaptis;"Darželio mišraus amžiaus grupė";4674623065;Taip;0;2;0;2
7234;Paslaptis;"Darželio mišraus amžiaus grupė";6375966771;Taip;0;13;0;13
7235;Paslaptis;"Darželio mišraus amžiaus grupė";4345420422;Taip;15;0;0;15
7236;Paslaptis;"Darželio mišraus amžiaus grupė";3093280943;Taip;0;1;0;1
7237;Paslaptis;"Darželio mišraus amžiaus grupė";9559318660;Taip;2;0;0;2
7238;Paslaptis;"Darželio mišraus amžiaus grupė";2705751628;Taip;0;0;1;1
7239;Paslaptis;"Darželio mišraus amžiaus grupė";8280740387;Taip;0;5;3;8
7240;Paslaptis;"Darželio mišraus amžiaus grupė";2891547963;Taip;19;0;0;19
7241;Paslaptis;"Darželio mišraus amžiaus grupė";3415869190;Taip;0;5;1;6
7242;Paslaptis;"Darželio mišraus amžiaus grupė";1983773762;Taip;0;1;0;1
7243;Paslaptis;"Darželio mišraus amžiaus grupė";5557019619;Taip;0;1;0;1
7244;Paslaptis;"Darželio mišraus amžiaus grupė";1782398974;Taip;5;5;0;10
7245;Paslaptis;"Darželio mišraus amžiaus grupė";4109288950;Taip;0;0;1;1
7246;Paslaptis;"Darželio mišraus amžiaus grupė";8083478190;Taip;2;3;7;12
7247;Paslaptis;"Darželio mišraus amžiaus grupė";2089780119;Taip;5;7;1;13
7248;Paslaptis;"NAUJA (LOPŠELIS)";2879752620;Taip;0;8;0;8
7249;Paslaptis;"NAUJA (LOPŠELIS)";2693910134;Taip;5;0;0;5
7250;Paslaptis;"NAUJA (LOPŠELIS)";1033910097;Taip;9;0;0;9
7251;Paslaptis;"NAUJA (LOPŠELIS)";1029321312;Taip;0;1;0;1
7252;Paslaptis;"NAUJA (LOPŠELIS)";5206529350;Taip;12;0;0;12
7253;Paslaptis;"NAUJA (LOPŠELIS)";5852939221;Taip;8;0;0;8
7254;Paslaptis;"NAUJA (LOPŠELIS)";5456011928;Taip;10;3;0;13
7255;Paslaptis;"NAUJA (LOPŠELIS)";5756338103;Taip;12;0;0;12
7256;Paslaptis;"NAUJA (LOPŠELIS)";6131831325;Taip;12;1;0;13
7257;Paslaptis;"NAUJA (LOPŠELIS)";5886364670;Taip;12;0;0;12
7258;Paslaptis;"NAUJA (LOPŠELIS)";9941731250;Taip;3;0;1;4
7259;Paslaptis;"NAUJA (LOPŠELIS)";7579781779;Taip;12;0;0;12
7260;Paslaptis;"NAUJA (LOPŠELIS)";3844066232;Taip;0;6;0;6
7261;Paslaptis;"NAUJA (LOPŠELIS)";3243226933;Taip;10;4;0;14
7262;Paslaptis;"NAUJA (LOPŠELIS)";3104525540;Taip;20;0;0;20
7263;Paslaptis;"NAUJA (LOPŠELIS)";8146824196;Taip;4;2;0;6
7264;Paslaptis;"NAUJA (LOPŠELIS)";3398729758;Taip;8;0;0;8
7265;Paslaptis;"NAUJA (LOPŠELIS)";2675089401;Taip;7;0;0;7
7266;Pasakaitė;Vieversėlių;70802215290;Taip;0;14;0;14
7267;Pasakaitė;Vieversėlių;82272856075;Taip;0;5;0;5
7268;Pasakaitė;Vieversėlių;23103636206;Taip;0;9;0;9
7269;Pasakaitė;Vieversėlių;48421643700;Taip;0;7;0;7
7270;Pasakaitė;Vieversėlių;94906317709;Taip;0;5;0;5
7271;Pasakaitė;Vieversėlių;725988513;Taip;0;2;0;2
7272;Pasakaitė;Vieversėlių;91751201397;Taip;0;0;6;6
7273;Pasakaitė;Vieversėlių;1537944476;Taip;0;5;0;5
7274;Pasakaitė;Vieversėlių;1631919806;Taip;0;0;2;2
7275;Pasakaitė;Vieversėlių;1696228992;Taip;0;0;2;2
7276;Pasakaitė;Vieversėlių;47661428412;Taip;0;6;0;6
7277;Pasakaitė;Vieversėlių;18419655194;Taip;0;7;7;14
7278;Pasakaitė;Vieversėlių;91109909258;Taip;0;5;0;5
7279;Pasakaitė;Vieversėlių;39926553926;Taip;8;11;0;19
7280;Pasakaitė;Vieversėlių;1139554564;Taip;4;13;0;17
7281;Pasakaitė;Spindulėlių;52127092749;Taip;0;5;0;5
7282;Pasakaitė;Spindulėlių;72232008007;Taip;5;0;0;5
7283;Pasakaitė;Spindulėlių;58071607976;Taip;0;5;0;5
7284;Pasakaitė;Spindulėlių;20667371334;Taip;0;19;0;19
7285;Pasakaitė;Spindulėlių;21284070194;Taip;0;6;0;6
7286;Pasakaitė;Spindulėlių;74253024682;Taip;5;0;0;5
7287;Pasakaitė;Spindulėlių;15644259897;Taip;0;1;0;1
7288;Pasakaitė;Spindulėlių;13787417933;Taip;5;0;0;5
7289;Pasakaitė;Spindulėlių;88951595986;Ne;10;5;0;15
7290;Pasakaitė;Spindulėlių;21872672491;Taip;13;0;0;13
7291;Pasakaitė;Spindulėlių;45451715428;Taip;0;6;0;6
7292;Pasakaitė;Spindulėlių;1381307997;Taip;0;11;0;11
7293;Pasakaitė;Spindulėlių;8638071584;Ne;15;0;0;15
7294;Pasakaitė;Spindulėlių;75361056418;Taip;11;0;0;11
7295;Pasakaitė;Spindulėlių;99890448836;Taip;5;1;0;6
7296;Pasakaitė;Spindulėlių;4680949976;Taip;0;3;0;3
7297;Pasakaitė;Spindulėlių;3734935229;Taip;11;0;0;11
7298;Pasakaitė;Spindulėlių;4267488049;Taip;5;5;0;10
7299;Pasakaitė;Spindulėlių;1523034176;Taip;0;5;0;5
7300;Pasakaitė;Spindulėlių;7152349570;Taip;0;9;0;9
7301;Pasakaitė;Pasagėlių;3165658822;Taip;0;16;0;16
7302;Pasakaitė;Pasagėlių;61230317080;Taip;7;6;0;13
7303;Pasakaitė;Pasagėlių;1740419218;Taip;4;13;0;17
7304;Pasakaitė;Pasagėlių;5378855541;Taip;5;0;1;6
7305;Pasakaitė;Pasagėlių;8466086339;Taip;5;0;0;5
7306;Pasakaitė;Pasagėlių;67374677045;Taip;0;1;0;1
7307;Pasakaitė;Pasagėlių;1019010454;Taip;5;8;0;13
7308;Pasakaitė;Pasagėlių;4959175420;Taip;9;6;0;15
7309;Pasakaitė;Pasagėlių;1144813356;Taip;12;0;0;12
7310;Pasakaitė;Pasagėlių;83018133588;Taip;20;0;0;20
7311;Pasakaitė;Pasagėlių;4013900094;Taip;0;0;3;3
7312;Pasakaitė;Pasagėlių;1791015854;Taip;6;1;0;7
7313;Pasakaitė;Pasagėlių;4591161640;Ne;0;0;7;7
7314;Pasakaitė;Pasagėlių;1707428977;Taip;10;5;0;15
7315;Pasakaitė;Pasagėlių;5467179333;Taip;6;10;0;16
7316;Pasakaitė;Švyturėlių;26826144324;Taip;0;5;0;5
7317;Pasakaitė;Švyturėlių;26485770641;Taip;0;2;0;2
7318;Pasakaitė;Švyturėlių;30460033968;Taip;0;7;0;7
7319;Pasakaitė;Švyturėlių;39762990812;Taip;0;0;8;8
7320;Pasakaitė;Švyturėlių;24235494284;Taip;0;1;2;3
7321;Pasakaitė;Švyturėlių;74338375162;Taip;5;3;1;9
7322;Pasakaitė;Švyturėlių;83737263199;Taip;0;5;1;6
7323;Pasakaitė;Švyturėlių;56474981516;Taip;5;0;1;6
7324;Pasakaitė;Švyturėlių;24096031951;Taip;4;5;2;11
7325;Pasakaitė;Švyturėlių;11001677712;Taip;0;0;7;7
7326;Pasakaitė;Švyturėlių;9914689534;Taip;0;4;0;4
7327;Pasakaitė;Švyturėlių;88077831193;Taip;0;0;3;3
7328;Pasakaitė;Švyturėlių;8225188274;Taip;0;5;0;5
7329;Pasakaitė;Švyturėlių;73957497029;Taip;3;0;0;3
7330;Pasakaitė;Švyturėlių;1070409611;Taip;0;5;2;7
7331;Pasakaitė;Švyturėlių;1159523006;Taip;0;5;3;8
7332;Pasakaitė;Švyturėlių;5436985035;Taip;0;7;0;7
7333;Pasakaitė;Švyturėlių;1627102470;Taip;8;0;0;8
7334;Pasakaitė;Švyturėlių;4008826950;Taip;15;0;1;16
7335;Pasakaitė;Švyturėlių;32235101944;Taip;7;0;0;7
7336;Pasakaitė;Kodėlčiukų;82138492327;Taip;0;2;0;2
7337;Pasakaitė;Kodėlčiukų;94317654094;Taip;0;5;1;6
7338;Pasakaitė;Kodėlčiukų;1121139222;Ne;0;0;16;16
7339;Pasakaitė;Kodėlčiukų;2017823264;Taip;3;0;0;3
7340;Pasakaitė;Kodėlčiukų;72093762601;Taip;2;0;0;2
7341;Pasakaitė;Kodėlčiukų;11006810461;Taip;14;0;0;14
7342;Pasakaitė;Kodėlčiukų;1553678838;Taip;5;5;1;11
7343;Pasakaitė;Kodėlčiukų;22071058323;Taip;15;4;1;20
7344;Pasakaitė;Kodėlčiukų;93907096625;Taip;5;0;0;5
7345;Pasakaitė;Kodėlčiukų;6839399035;Taip;0;0;3;3
7346;Pasakaitė;Kodėlčiukų;99352468512;Taip;5;0;0;5
7347;Pasakaitė;Kodėlčiukų;1809383469;Taip;5;0;0;5
7348;Pasakaitė;Kodėlčiukų;2742595829;Taip;6;0;1;7
7349;Pasakaitė;Kodėlčiukų;6983619733;Taip;1;0;6;7
7350;Pasakaitė;Gudručių;85389647155;Taip;0;8;0;8
7351;Pasakaitė;Gudručių;89807086522;Taip;6;7;3;16
7352;Pasakaitė;Gudručių;25228014112;Taip;0;5;4;9
7353;Pasakaitė;Gudručių;61088864114;Taip;0;0;2;2
7354;Pasakaitė;Gudručių;31076632547;Taip;0;10;0;10
7355;Pasakaitė;Gudručių;29112724120;Taip;0;4;0;4
7356;Pasakaitė;Gudručių;1175881877;Ne;5;5;1;11
7357;Pasakaitė;Gudručių;96876687235;Taip;0;5;4;9
7358;Pasakaitė;Gudručių;76810884215;Taip;5;0;0;5
7359;Pasakaitė;Gudručių;89036969556;Taip;0;5;1;6
7360;Pasakaitė;Gudručių;44876121501;Taip;0;5;3;8
7361;Pasakaitė;Gudručių;68762624079;Taip;10;5;0;15
7362;Pasakaitė;Gudručių;36916241082;Ne;5;0;1;6
7363;Pasakaitė;Gudručių;62505201993;Taip;0;5;0;5
7364;Pasakaitė;Gudručių;64811535115;Taip;0;5;6;11
7365;Pasakaitė;Gudručių;13548717757;Taip;0;5;1;6
7366;Pasakaitė;Gudručių;38485750316;Taip;0;5;0;5
7367;Pasakaitė;Gudručių;80929303402;Taip;0;5;0;5
7368;Pasakaitė;Gudručių;31971771240;Taip;5;3;0;8
7369;Pasakaitė;Gudručių;81509638417;Ne;0;10;2;12
7370;Pasakaitė;Gudručių;2031899743;Taip;0;5;2;7
7371;Pasakaitė;Čiulbonėlių;18107086294;Taip;0;10;0;10
7372;Pasakaitė;Čiulbonėlių;5414310905;Taip;0;5;0;5
7373;Pasakaitė;Čiulbonėlių;81406378986;Taip;2;1;0;3
7374;Pasakaitė;Čiulbonėlių;61216378563;Taip;0;1;0;1
7375;Pasakaitė;Čiulbonėlių;52612577074;Taip;16;2;2;20
7376;Pasakaitė;Čiulbonėlių;55594674308;Taip;3;0;0;3
7377;Pasakaitė;Čiulbonėlių;4889157048;Taip;0;5;0;5
7378;Pasakaitė;Čiulbonėlių;6035279095;Taip;0;5;0;5
7379;Pasakaitė;Čiulbonėlių;1827896757;Taip;0;5;0;5
7380;Pasakaitė;Čiulbonėlių;61297377425;Ne;0;20;0;20
7381;Pasakaitė;Čiulbonėlių;20868624857;Taip;10;5;1;16
7382;Pasakaitė;Čiulbonėlių;55779894463;Taip;0;2;0;2
7383;Pasakaitė;Čiulbonėlių;90096913388;Taip;0;9;0;9
7384;Pasakaitė;Čiulbonėlių;26218072375;Taip;0;11;1;12
7385;Pasakaitė;Čiulbonėlių;98801528286;Taip;0;1;0;1
7386;Pasakaitė;Čiulbonėlių;52200664190;Taip;0;5;3;8
7387;Pasakaitė;Čiulbonėlių;1135448504;Taip;0;5;0;5
7388;Pasakaitė;Čiulbonėlių;1801321757;Taip;0;5;0;5
7389;Pasakaitė;"Verpstelių ";12092268542;Taip;0;11;0;11
7390;Pasakaitė;"Verpstelių ";62677241195;Taip;0;5;0;5
7391;Pasakaitė;"Verpstelių ";600641021;Taip;0;10;0;10
7392;Pasakaitė;"Verpstelių ";1407277414;Taip;6;0;5;11
7393;Pasakaitė;"Verpstelių ";17218793370;Taip;15;5;0;20
7394;Pasakaitė;"Verpstelių ";33418184802;Taip;0;0;3;3
7395;Pasakaitė;"Verpstelių ";46873849992;Taip;0;7;0;7
7396;Pasakaitė;"Verpstelių ";96648719544;Taip;0;14;1;15
7397;Pasakaitė;"Verpstelių ";82475369612;Taip;12;0;0;12
7398;Pasakaitė;"Verpstelių ";51040024089;Taip;3;0;0;3
7399;Pasakaitė;"Verpstelių ";88885227604;Taip;0;7;0;7
7400;Pasakaitė;"Verpstelių ";5954676615;Taip;0;0;4;4
7401;Pasakaitė;"Verpstelių ";2210519019;Taip;5;0;1;6
7402;Pasakaitė;"Verpstelių ";18105216772;Taip;0;1;0;1
7403;Pasakaitė;"Verpstelių ";50537059387;Taip;0;0;5;5
7404;Pasakaitė;"Verpstelių ";29699532850;Taip;10;7;0;17
7405;Pasakaitė;"Verpstelių ";46074425530;Taip;4;2;0;6
7406;Pasakaitė;"Verpstelių ";45157801238;Taip;5;0;0;5
7407;Pasakaitė;Smalsučiai;7685647972;Taip;20;0;0;20
7408;Pasakaitė;Smalsučiai;7020773169;Taip;9;0;0;9
7409;Pasakaitė;Smalsučiai;3231283338;Taip;0;5;0;5
7410;Pasakaitė;Smalsučiai;5455278072;Taip;8;0;4;12
7411;Pasakaitė;Smalsučiai;9543991684;Taip;0;2;0;2
7412;Pasakaitė;Smalsučiai;3778906698;Taip;0;7;0;7
7413;Pasakaitė;Smalsučiai;3541877287;Taip;0;0;3;3
7414;Pasakaitė;Smalsučiai;3680596008;Taip;3;0;0;3
7415;Pasakaitė;Smalsučiai;4882856664;Taip;5;10;0;15
7416;Pasakaitė;Smalsučiai;8315840473;Taip;5;3;0;8
7417;Pasakaitė;Smalsučiai;5953162958;Taip;0;0;1;1
7418;Pasakaitė;Smalsučiai;3579498202;Taip;11;1;0;12
7419;Pasakaitė;"Čiauškučiai ";5004888659;Taip;0;0;10;10
7420;Pasakaitė;"Čiauškučiai ";3606601644;Taip;0;5;0;5
7421;Pasakaitė;"Čiauškučiai ";6714500298;Taip;0;10;0;10
7422;Pasakaitė;"Čiauškučiai ";8578521969;Taip;6;0;0;6
7423;Pasakaitė;"Čiauškučiai ";9166649594;Taip;2;0;0;2
7424;Pasakaitė;"Čiauškučiai ";8390366303;Taip;0;4;1;5
7425;Pasakaitė;"Čiauškučiai ";8463220257;Taip;7;0;2;9
7426;Pasakaitė;"Čiauškučiai ";7761162338;Taip;5;1;0;6
7427;Pasakaitė;"Čiauškučiai ";8223662339;Taip;15;0;0;15
7428;Pasakaitė;"Čiauškučiai ";9018830962;Taip;15;0;0;15
7429;Pasakaitė;"Čiauškučiai ";8469043564;Taip;13;0;2;15
7430;Pasakaitė;Pabiručiai;1827070201;Taip;10;0;0;10
7431;Pasakaitė;Pabiručiai;1879865535;Taip;0;6;2;8
7432;Pasakaitė;Pabiručiai;9175612991;Taip;15;0;0;15
7433;Pasakaitė;Pabiručiai;26714845001;Taip;6;0;2;8
7434;Pasakaitė;Pabiručiai;46891856500;Taip;11;3;0;14
7435;Pasakaitė;Pabiručiai;3397132786;Taip;10;8;1;19
7436;Pasakaitė;Pabiručiai;1769070351;Taip;0;4;0;4
7437;Pasakaitė;Pabiručiai;49117693773;Taip;4;2;1;7
7438;Pasakaitė;Pabiručiai;1320898756;Taip;6;1;10;17
7439;Pasakaitė;Pabiručiai;1027136050;Taip;7;0;0;7
7440;Pasakaitė;Pabiručiai;1198248619;Taip;0;9;0;9
7441;Pasakaitė;Pabiručiai;1595057434;Taip;5;5;1;11
7442;Pasakaitė;Pabiručiai;1032113089;Taip;0;0;11;11
7443;Pasakaitė;Pabiručiai;21252086256;Taip;4;0;2;6
7444;Pasakaitė;Pabiručiai;6134483994;Taip;8;5;0;13
7445;Pasakaitė;Pabiručiai;1673576868;Taip;0;9;8;17
7446;Pasakaitė;Pabiručiai;2017275984;Taip;0;0;2;2
7447;Pasakaitė;Pabiručiai;6346678827;Ne;0;0;13;13
7448;Pelenė;Varpelis;69242277342;Taip;0;1;0;1
7449;Pelenė;Varpelis;59921559091;Taip;0;5;0;5
7450;Pelenė;Varpelis;54232015265;Taip;5;0;0;5
7451;Pelenė;Varpelis;62426432001;Taip;8;5;0;13
7452;Pelenė;Varpelis;84471715677;Taip;0;1;0;1
7453;Pelenė;Varpelis;2029929226;Taip;0;1;0;1
7454;Pelenė;Varpelis;8311474428;Taip;7;6;0;13
7455;Pelenė;Varpelis;8189960936;Taip;0;4;2;6
7456;Pelenė;Varpelis;37922275946;Taip;0;5;0;5
7457;Pelenė;Varpelis;62172213063;Taip;4;0;0;4
7458;Pelenė;Varpelis;2054163380;Taip;0;2;1;3
7459;Pelenė;Varpelis;93009343319;Taip;5;1;0;6
7460;Pelenė;Varpelis;72752022712;Taip;0;15;0;15
7461;Pelenė;Varpelis;22762248459;Taip;0;1;0;1
7462;Pelenė;Varpelis;70438374608;Taip;0;6;0;6
7463;Pelenė;Varpelis;17746532458;Taip;1;5;0;6
7464;Pelenė;Varpelis;6533433685;Taip;0;12;0;12
7465;Pelenė;Varpelis;59795549508;Taip;0;8;0;8
7466;Pelenė;Varpelis;1072148409;Taip;0;3;2;5
7467;Pelenė;Varpelis;83359560510;Taip;10;3;0;13
7468;Pelenė;Saulutės;99521206531;Taip;0;9;0;9
7469;Pelenė;Saulutės;59732999282;Taip;3;1;0;4
7470;Pelenė;Saulutės;99849461351;Taip;0;1;0;1
7471;Pelenė;Saulutės;4233272418;Taip;5;1;0;6
7472;Pelenė;Saulutės;93982153559;Taip;11;0;0;11
7473;Pelenė;Saulutės;55808304356;Taip;3;0;0;3
7474;Pelenė;Saulutės;12170216844;Taip;0;0;2;2
7475;Pelenė;Saulutės;1321060587;Taip;8;0;0;8
7476;Pelenė;Saulutės;11671895181;Taip;0;1;1;2
7477;Pelenė;Saulutės;24547508796;Ne;0;10;1;11
7478;Pelenė;Saulutės;91433727359;Taip;2;3;0;5
7479;Pelenė;Saulutės;72216942887;Taip;7;1;0;8
7480;Pelenė;Saulutės;55937499558;Taip;8;7;0;15
7481;Pelenė;Saulutės;96121315210;Taip;3;1;3;7
7482;Pelenė;Saulutės;11924441656;Taip;0;17;0;17
7483;Pelenė;Saulutės;15949989455;Ne;0;4;0;4
7484;Pelenė;Saulutės;53044546376;Taip;0;0;4;4
7485;Pelenė;Saulutės;98221995571;Taip;5;1;0;6
7486;Pelenė;Saulutės;2115021063;Taip;0;5;1;6
7487;Pelenė;Raktelis;85051053863;Taip;0;5;6;11
7488;Pelenė;Raktelis;1342370096;Taip;14;0;6;20
7489;Pelenė;Raktelis;1356029457;Taip;2;10;4;16
7490;Pelenė;Raktelis;32577488307;Taip;0;5;0;5
7491;Pelenė;Raktelis;75264382003;Taip;0;0;1;1
7492;Pelenė;Raktelis;3245982902;Taip;5;0;0;5
7493;Pelenė;Raktelis;32716320977;Taip;0;5;0;5
7494;Pelenė;Raktelis;1733433768;Taip;9;0;0;9
7495;Pelenė;Raktelis;40968963343;Taip;0;2;0;2
7496;Pelenė;Raktelis;29587640966;Taip;0;9;0;9
7497;Pelenė;Raktelis;55350714718;Taip;0;0;3;3
7498;Pelenė;Raktelis;30625065081;Taip;0;5;0;5
7499;Pelenė;Raktelis;62615483649;Taip;0;0;2;2
7500;Pelenė;Raktelis;87207607315;Taip;10;0;3;13
7501;Pelenė;Raktelis;70335326964;Taip;0;3;0;3
7502;Pelenė;Raktelis;1045206373;Taip;6;4;1;11
7503;Pelenė;Raktelis;120966603;Taip;0;10;0;10
7504;Pelenė;Raktelis;534670514;Taip;8;0;0;8
7505;Pelenė;Žvaigždutės;33028103211;Taip;6;1;1;8
7506;Pelenė;Žvaigždutės;45687410331;Taip;13;6;0;19
7507;Pelenė;Žvaigždutės;8483195434;Taip;0;6;0;6
7508;Pelenė;Žvaigždutės;66474157416;Taip;0;0;2;2
7509;Pelenė;Žvaigždutės;1793514226;Taip;14;6;0;20
7510;Pelenė;Žvaigždutės;55747365118;Taip;0;5;0;5
7511;Pelenė;Žvaigždutės;12400151337;Taip;7;2;2;11
7512;Pelenė;Žvaigždutės;77504082241;Taip;5;8;0;13
7513;Pelenė;Žvaigždutės;93234992958;Taip;7;0;2;9
7514;Pelenė;Žvaigždutės;2393068606;Taip;0;5;0;5
7515;Pelenė;Žvaigždutės;62544766703;Taip;8;5;1;14
7516;Pelenė;Žvaigždutės;14791621417;Taip;15;0;1;16
7517;Pelenė;Žvaigždutės;43686344645;Ne;0;9;0;9
7518;Pelenė;Žvaigždutės;39850314417;Taip;0;0;3;3
7519;Pelenė;Žvaigždutės;71274664713;Taip;0;3;0;3
7520;Pelenė;Žvaigždutės;1542958753;Taip;5;2;2;9
7521;Pelenė;Žvaigždutės;1846536895;Taip;0;16;0;16
7522;Pelenė;Žvaigždutės;1516249890;Taip;0;8;0;8
7523;Pelenė;Žvaigždutės;2147596414;Taip;5;0;0;5
7524;Pelenė;Žvaigždutės;1908166570;Taip;5;2;2;9
7525;Pelenė;Žvaigždutės;1157718969;Taip;0;1;0;1
7526;Pelenė;Žvaigždutės;1599336930;Taip;10;0;0;10
7527;Pelenė;Žvaigždutės;1283843474;Taip;5;0;0;5
7528;Pelenė;Nykštukas;35657264407;Ne;0;1;3;4
7529;Pelenė;Nykštukas;3299454566;Taip;5;1;3;9
7530;Pelenė;Nykštukas;1931857547;Taip;9;1;2;12
7531;Pelenė;Nykštukas;3465518545;Taip;1;0;1;2
7532;Pelenė;Nykštukas;4386060612;Ne;6;9;0;15
7533;Pelenė;Nykštukas;1568123491;Taip;0;1;0;1
7534;Pelenė;Nykštukas;1418000665;Taip;12;0;1;13
7535;Pelenė;Nykštukas;1038583766;Taip;5;0;0;5
7536;Pelenė;Nykštukas;1127657620;Taip;8;7;0;15
7537;Pelenė;Nykštukas;42431378466;Taip;0;9;0;9
7538;Pelenė;Nykštukas;17572291941;Taip;5;0;0;5
7539;Pelenė;Nykštukas;1050272821;Taip;4;0;0;4
7540;Pelenė;Nykštukas;45589326259;Ne;0;5;1;6
7541;Pelenė;Nykštukas;26010775076;Taip;0;6;0;6
7542;Pelenė;Nykštukas;51979406888;Taip;19;0;0;19
7543;Pelenė;Nykštukas;14200374671;Taip;12;0;0;12
7544;Pelenė;Nykštukas;89920419797;Taip;8;2;0;10
7545;Pelenė;Žirniukai;59244146880;Taip;0;4;0;4
7546;Pelenė;Žirniukai;96840961754;Taip;0;0;2;2
7547;Pelenė;Žirniukai;52690820;Taip;5;0;1;6
7548;Pelenė;Žirniukai;43987538343;Taip;12;0;0;12
7549;Pelenė;Žirniukai;1710249888;Taip;0;6;0;6
7550;Pelenė;Žirniukai;78648474464;Taip;6;4;3;13
7551;Pelenė;Žirniukai;61012202440;Taip;0;1;0;1
7552;Pelenė;Žirniukai;4178071578;Taip;0;1;0;1
7553;Pelenė;Žirniukai;45410683361;Taip;5;0;1;6
7554;Pelenė;Žirniukai;5804848640;Taip;0;1;1;2
7555;Pelenė;Žirniukai;8813044848;Taip;4;0;0;4
7556;Pelenė;Žirniukai;1807037374;Taip;4;2;6;12
7557;Pelenė;Žirniukai;6559830470;Taip;0;2;1;3
7558;Pelenė;Žirniukai;62484999314;Taip;11;0;2;13
7559;Pelenė;Žirniukai;1289416312;Taip;0;0;1;1
7560;Pelenė;Žirniukai;33009702783;Taip;2;0;0;2
7561;Pelenė;Žirniukai;1774912517;Taip;10;3;0;13
7562;Pelenė;Žirniukai;6937587856;Taip;5;1;0;6
7563;Pelenė;Lašeliai;1483843416;Taip;0;16;0;16
7564;Pelenė;Lašeliai;6579504852;Taip;8;0;1;9
7565;Pelenė;Lašeliai;6181604926;Taip;3;0;1;4
7566;Pelenė;Lašeliai;2092775878;Taip;5;6;0;11
7567;Pelenė;Lašeliai;9584503078;Taip;8;0;1;9
7568;Pelenė;Lašeliai;7589978427;Taip;0;10;0;10
7569;Pelenė;Lašeliai;8721423900;Taip;10;8;0;18
7570;Pelenė;Lašeliai;3189305906;Taip;0;1;0;1
7571;Pelenė;Lašeliai;7351477901;Taip;7;0;0;7
7572;Pelenė;Lašeliai;8607110629;Taip;4;3;1;8
7573;Pelenė;Lašeliai;7144616734;Taip;13;0;0;13
7574;Pelenė;Lašeliai;8770771520;Taip;5;0;0;5
7575;Pelenė;Lašeliai;1750366978;Taip;20;0;0;20
7576;Pelenė;Lašeliai;8675348688;Taip;8;0;2;10
7577;Pelenė;Lašeliai;1217505164;Taip;15;0;0;15
7578;Pelenė;Lašeliai;7836778389;Taip;1;15;0;16
7579;Pelenė;Lašeliai;1978481168;Taip;8;0;0;8
7580;Pelenė;Lašeliai;3596386480;Taip;0;9;0;9
7581;Pelenė;Lašeliai;7254981715;Ne;16;4;0;20
7582;Pelenė;Lašeliai;6021833025;Taip;3;10;0;13
7583;Pelenė;Lašeliai;7469266085;Taip;10;10;0;20
7584;Pelenė;Lašeliai;3296147024;Taip;0;2;0;2
7585;Pelenė;Grūdelis;88349051367;Taip;10;7;0;17
7586;Pelenė;Grūdelis;38804968295;Taip;1;5;0;6
7587;Pelenė;Grūdelis;83979485459;Taip;2;0;0;2
7588;Pelenė;Grūdelis;27608464415;Ne;8;5;0;13
7589;Pelenė;Grūdelis;60203121022;Taip;4;5;0;9
7590;Pelenė;Grūdelis;71212019568;Taip;0;5;0;5
7591;Pelenė;Grūdelis;86862048784;Taip;0;0;1;1
7592;Pelenė;Grūdelis;8945972016;Taip;0;18;0;18
7593;Pelenė;Grūdelis;98433445604;Taip;0;1;0;1
7594;Pelenė;Grūdelis;52681956071;Taip;6;1;0;7
7595;Pelenė;Grūdelis;96734246902;Taip;3;5;0;8
7596;Pelenė;Grūdelis;45985345611;Taip;0;5;0;5
7597;Pelenė;Grūdelis;28035546865;Taip;0;5;0;5
7598;Pelenė;Grūdelis;21224601178;Taip;1;0;0;1
7599;Pelenė;Grūdelis;44154428944;Taip;2;3;0;5
7600;Pelenė;Grūdelis;67249286878;Taip;2;6;0;8
7601;Pelenė;Grūdelis;82762950191;Taip;2;5;0;7
7602;Pelenė;Grūdelis;12965686122;Taip;4;3;0;7
7603;Pelenė;Braškytė;5325176433;Taip;5;6;0;11
7604;Pelenė;Braškytė;7205437280;Taip;10;2;0;12
7605;Pelenė;Braškytė;9009271610;Taip;0;13;0;13
7606;Pelenė;Braškytė;8916634408;Taip;13;0;0;13
7607;Pelenė;Braškytė;4546285993;Taip;10;1;2;13
7608;Pelenė;Braškytė;3238807604;Taip;9;5;3;17
7609;Pelenė;Braškytė;1902314385;Taip;0;1;2;3
7610;Pelenė;Braškytė;5063098703;Taip;7;0;1;8
7611;Pelenė;Braškytė;5780697554;Taip;7;0;1;8
7612;Pelenė;Braškytė;6707167720;Taip;5;5;0;10
7613;Pelenė;Braškytė;5389865440;Taip;5;0;0;5
7614;Pelenė;Braškytė;8466974910;Taip;5;0;3;8
7615;Pelenė;Braškytė;7880284433;Taip;6;0;2;8
7616;Pelenė;Braškytė;9621197758;Taip;0;15;0;15
7617;Pelenė;Braškytė;9195113444;Taip;15;1;0;16
7618;Pelenė;Braškytė;4541391191;Taip;10;0;0;10
7619;Pelenė;Braškytė;6375060159;Taip;0;20;0;20
7620;Pelenė;Braškytė;9218868317;Taip;11;0;2;13
7621;Pelenė;Boružėlės;4624325473;Taip;0;12;0;12
7622;Pelenė;Boružėlės;1336431888;Taip;10;5;0;15
7623;Pelenė;Boružėlės;1533938659;Ne;0;0;1;1
7624;Pelenė;Boružėlės;1114786936;Taip;14;0;0;14
7625;Pelenė;Boružėlės;8404317146;Taip;4;0;0;4
7626;Pelenė;Boružėlės;1781704945;Taip;6;0;0;6
7627;Pelenė;Boružėlės;1140030742;Taip;0;5;0;5
7628;Pelenė;Boružėlės;3497915398;Taip;0;8;0;8
7629;Pelenė;Boružėlės;2154553741;Taip;5;3;0;8
7630;Pelenė;Boružėlės;8598498275;Taip;0;19;0;19
7631;Pelenė;Boružėlės;69721118552;Taip;6;0;0;6
7632;Pelenė;Boružėlės;39705461573;Taip;20;0;0;20
7633;Pelenė;Boružėlės;5356756237;Taip;6;0;1;7
7634;Pelenė;Boružėlės;3131930907;Taip;14;0;0;14
7635;Pelenė;Boružėlės;7172604045;Taip;6;0;2;8
7636;Pelenė;Boružėlės;1067737206;Taip;0;13;0;13
7637;Pelenė;Boružėlės;1775717256;Taip;12;0;0;12
7638;Pelenė;Boružėlės;7587887488;Taip;10;3;0;13
7639;Pelenė;Boružėlės;3419051414;Taip;4;5;0;9
7640;Pelenė;Boružėlės;6632188229;Taip;5;6;0;11
7641;Pelenė;Boružėlės;8716395810;Taip;7;0;0;7
7642;Pelenė;Boružėlės;6191899254;Taip;1;0;0;1
7643;Pelenė;Saldainiukai;2737277656;Taip;5;0;0;5
7644;Pelenė;Saldainiukai;2647876561;Taip;5;1;0;6
7645;Pelenė;Saldainiukai;8194354176;Taip;5;0;0;5
7646;Pelenė;Saldainiukai;2322908067;Taip;18;2;0;20
7647;Pelenė;Saldainiukai;5228983908;Taip;2;0;0;2
7648;Pelenė;Saldainiukai;3174009848;Taip;8;5;0;13
7649;Pelenė;Saldainiukai;6894978459;Taip;0;1;0;1
7650;Pelenė;Saldainiukai;2103177773;Taip;6;0;0;6
7651;Pelenė;Saldainiukai;4321705575;Taip;5;5;0;10
7652;Pelenė;Saldainiukai;6481466282;Taip;4;1;0;5
7653;Pipiras;EŽIUKAI;12489971559;Taip;0;16;0;16
7654;Pipiras;EŽIUKAI;1112327896;Taip;7;0;0;7
7655;Pipiras;EŽIUKAI;24106575180;Taip;19;0;0;19
7656;Pipiras;EŽIUKAI;52968399382;Taip;1;1;0;2
7657;Pipiras;EŽIUKAI;38894447952;Taip;0;13;0;13
7658;Pipiras;EŽIUKAI;24414917430;Taip;0;11;0;11
7659;Pipiras;EŽIUKAI;71881026465;Taip;14;0;0;14
7660;Pipiras;EŽIUKAI;32958963027;Taip;0;6;1;7
7661;Pipiras;EŽIUKAI;95904922548;Taip;0;5;0;5
7662;Pipiras;EŽIUKAI;55466909230;Taip;0;3;2;5
7663;Pipiras;EŽIUKAI;77307352546;Taip;10;5;0;15
7664;Pipiras;EŽIUKAI;53468621826;Taip;0;10;1;11
7665;Pipiras;EŽIUKAI;93498963556;Taip;5;5;0;10
7666;Pipiras;EŽIUKAI;22190236403;Taip;0;5;0;5
7667;Pipiras;EŽIUKAI;1213972436;Taip;2;6;0;8
7668;Pipiras;EŽIUKAI;4564046164;Taip;20;0;0;20
7669;Pipiras;EŽIUKAI;35225328018;Taip;1;1;1;3
7670;Pipiras;EŽIUKAI;1129409620;Taip;0;5;0;5
7671;Pipiras;BITUTĖS;20034839935;Taip;0;1;0;1
7672;Pipiras;BITUTĖS;35376853030;Taip;0;5;0;5
7673;Pipiras;BITUTĖS;96219330294;Taip;0;6;0;6
7674;Pipiras;BITUTĖS;77699420684;Taip;0;7;0;7
7675;Pipiras;BITUTĖS;61581422755;Taip;0;6;0;6
7676;Pipiras;BITUTĖS;9503515806;Taip;0;8;0;8
7677;Pipiras;BITUTĖS;41774848347;Taip;0;3;0;3
7678;Pipiras;BITUTĖS;75297843018;Taip;0;5;0;5
7679;Pipiras;BITUTĖS;81094360294;Taip;3;1;0;4
7680;Pipiras;BITUTĖS;64050236851;Taip;0;7;0;7
7681;Pipiras;BITUTĖS;35448366688;Ne;3;0;0;3
7682;Pipiras;BITUTĖS;89245567171;Taip;0;6;0;6
7683;Pipiras;BITUTĖS;7501158031;Taip;0;11;0;11
7684;Pipiras;BITUTĖS;35777468660;Taip;0;1;0;1
7685;Pipiras;BITUTĖS;8797825745;Taip;4;2;0;6
7686;Pipiras;BITUTĖS;74448139833;Taip;4;7;0;11
7687;Pipiras;BITUTĖS;66532279326;Taip;5;5;0;10
7688;Pipiras;BITUTĖS;7724903510;Taip;5;5;0;10
7689;Pipiras;NYKŠTUKAI;45471590000;Taip;0;13;0;13
7690;Pipiras;NYKŠTUKAI;5849366642;Taip;0;3;0;3
7691;Pipiras;NYKŠTUKAI;56791669968;Taip;0;9;0;9
7692;Pipiras;NYKŠTUKAI;41412423426;Taip;0;3;0;3
7693;Pipiras;NYKŠTUKAI;32061333461;Taip;0;8;0;8
7694;Pipiras;NYKŠTUKAI;55177242235;Taip;0;20;0;20
7695;Pipiras;NYKŠTUKAI;12906419175;Taip;3;3;0;6
7696;Pipiras;NYKŠTUKAI;72634292284;Taip;0;5;0;5
7697;Pipiras;NYKŠTUKAI;10825133339;Taip;5;0;0;5
7698;Pipiras;NYKŠTUKAI;86812470693;Taip;0;10;0;10
7699;Pipiras;NYKŠTUKAI;66182015590;Taip;0;10;0;10
7700;Pipiras;NYKŠTUKAI;11746912226;Taip;0;5;0;5
7701;Pipiras;NYKŠTUKAI;1626782165;Taip;0;3;0;3
7702;Pipiras;NYKŠTUKAI;1813200223;Taip;0;2;0;2
7703;Pipiras;PELĖDŽIUKAI;6694920607;Taip;0;11;0;11
7704;Pipiras;PELĖDŽIUKAI;3325511140;Taip;0;2;0;2
7705;Pipiras;PELĖDŽIUKAI;3341850450;Taip;5;0;0;5
7706;Pipiras;PELĖDŽIUKAI;5778300856;Taip;0;5;0;5
7707;Pipiras;PELĖDŽIUKAI;7026118693;Taip;0;2;0;2
7708;Pipiras;PELĖDŽIUKAI;1391682850;Taip;0;4;0;4
7709;Pipiras;PELĖDŽIUKAI;87924002679;Taip;5;9;0;14
7710;Pipiras;PELĖDŽIUKAI;6136423200;Taip;10;0;0;10
7711;Pipiras;PELĖDŽIUKAI;6805620664;Taip;5;4;0;9
7712;Pipiras;PELĖDŽIUKAI;7912217889;Taip;5;0;1;6
7713;Pipiras;PELĖDŽIUKAI;5502001191;Taip;4;0;0;4
7714;Pipiras;PELĖDŽIUKAI;9275905384;Taip;4;1;2;7
7715;Pipiras;PELĖDŽIUKAI;4496076326;Taip;8;0;0;8
7716;Pipiras;PELĖDŽIUKAI;3141822820;Taip;5;7;0;12
7717;Pipiras;PELĖDŽIUKAI;2044498561;Taip;5;4;0;9
7718;Pipiras;PELĖDŽIUKAI;3357866319;Taip;8;3;0;11
7719;Pipiras;DRUGELIAI;41585818819;Taip;20;0;0;20
7720;Pipiras;DRUGELIAI;5577759167;Taip;5;0;0;5
7721;Pipiras;DRUGELIAI;7799786844;Taip;4;1;0;5
7722;Pipiras;DRUGELIAI;2345034928;Taip;18;0;0;18
7723;Pipiras;DRUGELIAI;5014457985;Taip;19;0;0;19
7724;Pipiras;DRUGELIAI;4927845000;Taip;4;0;0;4
7725;Pipiras;DRUGELIAI;1904376366;Taip;0;5;0;5
7726;Pipiras;DRUGELIAI;1128674099;Taip;5;5;0;10
7727;Pipiras;DRUGELIAI;3422170541;Taip;0;5;0;5
7728;Pipiras;DRUGELIAI;1391958633;Taip;5;9;0;14
7729;Pipiras;DRUGELIAI;7784343130;Taip;7;2;0;9
7730;Pipiras;DRUGELIAI;3622164823;Taip;0;0;9;9
7731;Pipiras;DRUGELIAI;3008358842;Taip;6;0;0;6
7732;Pipiras;DRUGELIAI;2024777430;Taip;0;4;0;4
7733;Pipiras;DRUGELIAI;4959823035;Taip;4;0;0;4
7734;Pipiras;DRUGELIAI;6339186940;Taip;0;5;0;5
7735;Pipiras;DRUGELIAI;3314276870;Taip;7;1;0;8
7736;Pipiras;DRUGELIAI;5637557921;Taip;5;0;0;5
7737;Pipiras;DRUGELIAI;1050430252;Taip;9;2;0;11
7738;Pipiras;GĖLYTĖS;56325056631;Taip;0;3;0;3
7739;Pipiras;GĖLYTĖS;81335131932;Taip;0;6;0;6
7740;Pipiras;GĖLYTĖS;23377947863;Taip;0;15;0;15
7741;Pipiras;GĖLYTĖS;87831792882;Taip;0;15;0;15
7742;Pipiras;GĖLYTĖS;1417855241;Taip;0;12;0;12
7743;Pipiras;GĖLYTĖS;1791226869;Taip;0;15;0;15
7744;Pipiras;GĖLYTĖS;1077104941;Taip;8;0;0;8
7745;Pipiras;GĖLYTĖS;60652954862;Taip;0;15;0;15
7746;Pipiras;GĖLYTĖS;27808576289;Taip;0;4;0;4
7747;Pipiras;GĖLYTĖS;5114553619;Taip;0;9;0;9
7748;Pipiras;GĖLYTĖS;1780531222;Taip;4;4;0;8
7749;Pipiras;GĖLYTĖS;18211174874;Taip;3;5;0;8
7750;Pipiras;GĖLYTĖS;4246712256;Taip;0;14;0;14
7751;Pipiras;GĖLYTĖS;25000181631;Taip;0;6;0;6
7752;Pipiras;GĖLYTĖS;2473644942;Taip;0;18;0;18
7753;Pipiras;GĖLYTĖS;1650661825;Taip;0;2;0;2
7754;Pipiras;GĖLYTĖS;23663823688;Taip;0;20;0;20
7755;Pipiras;GĖLYTĖS;6481320053;Ne;0;6;0;6
7756;Pipiras;BORUŽĖLĖS;54633757340;Taip;5;10;0;15
7757;Pipiras;BORUŽĖLĖS;68636458010;Taip;0;1;0;1
7758;Pipiras;BORUŽĖLĖS;20456702162;Taip;0;1;0;1
7759;Pipiras;BORUŽĖLĖS;57459408180;Taip;0;18;0;18
7760;Pipiras;BORUŽĖLĖS;7354253729;Taip;0;4;0;4
7761;Pipiras;BORUŽĖLĖS;99551392640;Taip;5;0;0;5
7762;Pipiras;BORUŽĖLĖS;9423015002;Taip;0;7;0;7
7763;Pipiras;BORUŽĖLĖS;23794561369;Taip;0;8;0;8
7764;Pipiras;BORUŽĖLĖS;46165404909;Taip;0;14;0;14
7765;Pipiras;BORUŽĖLĖS;6804964469;Taip;0;3;0;3
7766;Pipiras;BORUŽĖLĖS;81817710888;Taip;0;6;0;6
7767;Pipiras;BORUŽĖLĖS;7448924569;Taip;0;1;0;1
7768;Pipiras;BORUŽĖLĖS;1676986127;Taip;4;0;0;4
7769;Pipiras;BORUŽĖLĖS;1334584865;Taip;11;4;0;15
7770;Pipiras;BORUŽĖLĖS;9673674008;Taip;3;0;0;3
7771;Pipiras;BORUŽĖLĖS;1657721144;Taip;8;1;0;9
7772;Pipiras;BORUŽĖLĖS;6766596656;Taip;4;0;0;4
7773;Pipiras;SKRUZDĖLIUKAI;76840668343;Taip;15;5;0;20
7774;Pipiras;SKRUZDĖLIUKAI;1975780209;Taip;0;0;4;4
7775;Pipiras;SKRUZDĖLIUKAI;50739918812;Ne;5;5;0;10
7776;Pipiras;SKRUZDĖLIUKAI;75153377410;Taip;0;0;6;6
7777;Pipiras;SKRUZDĖLIUKAI;53426269440;Taip;0;5;0;5
7778;Pipiras;SKRUZDĖLIUKAI;7196519583;Taip;0;15;0;15
7779;Pipiras;SKRUZDĖLIUKAI;53180156021;Taip;0;2;0;2
7780;Pipiras;SKRUZDĖLIUKAI;96711811784;Taip;0;8;0;8
7781;Pipiras;SKRUZDĖLIUKAI;85339674885;Taip;0;16;0;16
7782;Pipiras;SKRUZDĖLIUKAI;61166497338;Taip;0;5;0;5
7783;Pipiras;SKRUZDĖLIUKAI;90202583208;Taip;4;5;0;9
7784;Pipiras;SKRUZDĖLIUKAI;84791674090;Ne;0;10;0;10
7785;Pipiras;SKRUZDĖLIUKAI;49361002482;Taip;4;3;0;7
7786;Pipiras;SKRUZDĖLIUKAI;53377928276;Taip;8;1;1;10
7787;Pipiras;SKRUZDĖLIUKAI;57731282074;Taip;10;0;0;10
7788;Pipiras;SKRUZDĖLIUKAI;1450882528;Taip;7;0;0;7
7789;Pipiras;SKRUZDĖLIUKAI;65132324180;Taip;5;2;5;12
7790;Pipiras;SKRUZDĖLIUKAI;1469877916;Taip;10;5;0;15
7791;Pipiras;SKRUZDĖLIUKAI;71790101454;Taip;0;5;0;5
7792;Pipiras;SKRUZDĖLIUKAI;73564428514;Ne;0;18;0;18
7793;Pipiras;ŽVIRBLIUKŲ;80046621658;Taip;20;0;0;20
7794;Pipiras;ŽVIRBLIUKŲ;70940029154;Taip;0;8;0;8
7795;Pipiras;ŽVIRBLIUKŲ;1232620336;Taip;5;12;0;17
7796;Pipiras;ŽVIRBLIUKŲ;1549121029;Taip;1;1;0;2
7797;Pipiras;ŽVIRBLIUKŲ;37087220885;Taip;0;6;0;6
7798;Pipiras;ŽVIRBLIUKŲ;1700856741;Taip;1;2;0;3
7799;Pipiras;ŽVIRBLIUKŲ;1319863476;Taip;0;14;0;14
7800;Pipiras;ŽVIRBLIUKŲ;1757192919;Taip;0;4;0;4
7801;Pipiras;ŽVIRBLIUKŲ;1417086043;Taip;0;5;0;5
7802;Pipiras;ŽVIRBLIUKŲ;1441590033;Taip;0;11;0;11
7803;Pipiras;ŽVIRBLIUKŲ;3370047940;Taip;0;4;0;4
7804;Pipiras;ŽVIRBLIUKŲ;2030665851;Taip;0;7;0;7
7805;Pipiras;ŽVIRBLIUKŲ;1182415963;Taip;0;9;0;9
7806;Pipiras;ŽVIRBLIUKŲ;10750695428;Taip;4;8;0;12
7807;Pipiras;ŽVIRBLIUKŲ;1799335356;Ne;13;2;0;15
7808;Pipiras;ŽVIRBLIUKŲ;3247709788;Taip;0;20;0;20
7809;Pipiras;ZUIKUČIŲ;7161727352;Taip;0;11;0;11
7810;Pipiras;ZUIKUČIŲ;5225533488;Taip;11;6;0;17
7811;Pipiras;ZUIKUČIŲ;5622119207;Taip;3;0;0;3
7812;Pipiras;ZUIKUČIŲ;2016718354;Taip;8;0;0;8
7813;Pipiras;ZUIKUČIŲ;9157870634;Taip;0;1;0;1
7814;Pipiras;ZUIKUČIŲ;4017042461;Taip;5;0;0;5
7815;Pipiras;ZUIKUČIŲ;4177166475;Taip;0;13;0;13
7816;Pipiras;ZUIKUČIŲ;6792777396;Taip;0;4;0;4
7817;Pipiras;ZUIKUČIŲ;5845498558;Taip;0;7;0;7
7818;Pipiras;ZUIKUČIŲ;1784839485;Taip;0;14;0;14
7819;Pipiras;ZUIKUČIŲ;5141447649;Taip;11;0;0;11
7820;Pipiras;ZUIKUČIŲ;3775916247;Taip;3;5;0;8
7821;Pipiras;ZUIKUČIŲ;5908707752;Taip;2;17;0;19
7822;Pipiras;ZUIKUČIŲ;8422419380;Taip;5;0;0;5
7823;Pipiras;ZUIKUČIŲ;3882437376;Taip;3;0;0;3
7824;Pipiras;VARLIUKŲ;6363349541;Taip;5;0;0;5
7825;Pipiras;VARLIUKŲ;4266424785;Taip;12;0;0;12
7826;Pipiras;VARLIUKŲ;6748400056;Taip;5;1;0;6
7827;Pipiras;VARLIUKŲ;2315614501;Taip;0;9;0;9
7828;Pipiras;VARLIUKŲ;5422547144;Taip;5;3;0;8
7829;Pipiras;VARLIUKŲ;3421769229;Taip;5;1;0;6
7830;Pipiras;VARLIUKŲ;5445858240;Taip;0;6;0;6
7831;Pipiras;VARLIUKŲ;1242260242;Taip;6;1;0;7
7832;Pipiras;VARLIUKŲ;6685567970;Taip;10;1;0;11
7833;Pipiras;VARLIUKŲ;8520454289;Taip;0;2;0;2
7834;Pipiras;VARLIUKŲ;7969837759;Taip;0;19;0;19
7835;Pipiras;VARLIUKŲ;4426479971;Taip;4;1;0;5
7836;Pipiras;VARLIUKŲ;2267192782;Taip;0;10;0;10
7837;Pipiras;ŽIOGELIŲ;2096009051;Taip;0;11;0;11
7838;Pipiras;ŽIOGELIŲ;71283505646;Taip;6;3;0;9
7839;Pipiras;ŽIOGELIŲ;2061168407;Taip;0;4;0;4
7840;Pipiras;ŽIOGELIŲ;2030170020;Taip;5;6;0;11
7841;Pipiras;ŽIOGELIŲ;2637950013;Taip;20;0;0;20
7842;Pipiras;ŽIOGELIŲ;3652741639;Taip;17;0;0;17
7843;Pipiras;ŽIOGELIŲ;1415741097;Taip;0;5;0;5
7844;Pipiras;ŽIOGELIŲ;1658491279;Taip;0;4;0;4
7845;Pipiras;ŽIOGELIŲ;1082396096;Taip;7;2;0;9
7846;Pipiras;ŽIOGELIŲ;1324680675;Taip;4;0;0;4
7847;Pipiras;ŽIOGELIŲ;6794437566;Taip;17;0;0;17
7848;Pipiras;ŽIOGELIŲ;1371141047;Taip;0;3;0;3
7849;Pipiras;ŽIOGELIŲ;1420510354;Taip;5;0;0;5
7850;Pipiras;ŽIOGELIŲ;1293250996;Taip;3;3;0;6
7851;Pipiras;ŽIOGELIŲ;1751427121;Taip;9;0;0;9
7852;Pipiras;ŽIOGELIŲ;1114377378;Taip;0;17;0;17
7853;Pipiras;ŽIOGELIŲ;1694848410;Taip;11;0;0;11
7854;Pipiras;ŽIOGELIŲ;8088285579;Ne;0;3;0;3
7855;Pipiras;ŽIOGELIŲ;1949087858;Taip;14;0;0;14
7856;"Prie pasakų parko";"ZUIKUČIŲ (SPEC.)";1783727978;Taip;10;0;0;10
7857;"Prie pasakų parko";"ZUIKUČIŲ (SPEC.)";2058795331;Taip;4;0;1;5
7858;"Prie pasakų parko";"ZUIKUČIŲ (SPEC.)";1079827182;Taip;5;0;4;9
7859;"Prie pasakų parko";"ZUIKUČIŲ (SPEC.)";1057427744;Ne;4;0;8;12
7860;"Prie pasakų parko";"ZUIKUČIŲ (SPEC.)";4574965127;Ne;0;0;5;5
7861;"Prie pasakų parko";"ZUIKUČIŲ (SPEC.)";8949507250;Taip;10;0;0;10
7862;"Prie pasakų parko";"ZUIKUČIŲ (SPEC.)";18652266729;Taip;5;0;0;5
7863;"Prie pasakų parko";"ZUIKUČIŲ (SPEC.)";3397410463;Ne;9;0;5;14
7864;"Prie pasakų parko";PAUKŠČIUKŲ;5982019255;Taip;5;0;0;5
7865;"Prie pasakų parko";PAUKŠČIUKŲ;2160440145;Taip;5;5;0;10
7866;"Prie pasakų parko";PAUKŠČIUKŲ;6992830082;Taip;5;0;0;5
7867;"Prie pasakų parko";PAUKŠČIUKŲ;2216634402;Taip;0;0;2;2
7868;"Prie pasakų parko";PAUKŠČIUKŲ;1278065349;Taip;20;0;0;20
7869;"Prie pasakų parko";PAUKŠČIUKŲ;3356307067;Taip;16;0;0;16
7870;"Prie pasakų parko";PAUKŠČIUKŲ;8215830508;Ne;5;8;0;13
7871;"Prie pasakų parko";PAUKŠČIUKŲ;8318567916;Taip;4;0;0;4
7872;"Prie pasakų parko";PAUKŠČIUKŲ;8189217660;Taip;10;9;0;19
7873;"Prie pasakų parko";PAUKŠČIUKŲ;2741301903;Taip;5;4;0;9
7874;"Prie pasakų parko";PAUKŠČIUKŲ;4181676762;Taip;0;9;0;9
7875;"Prie pasakų parko";PAUKŠČIUKŲ;1482803930;Taip;9;0;5;14
7876;"Prie pasakų parko";PAUKŠČIUKŲ;9926991259;Taip;5;6;0;11
7877;"Prie pasakų parko";PAUKŠČIUKŲ;8574432191;Taip;0;7;0;7
7878;"Prie pasakų parko";PAUKŠČIUKŲ;1588062393;Taip;0;0;9;9
7879;"Prie pasakų parko";"LINKSMOJI ŠEIMYNĖLĖ (SPEC)";70678189213;Taip;0;0;2;2
7880;"Prie pasakų parko";"LINKSMOJI ŠEIMYNĖLĖ (SPEC)";3023913956;Ne;0;5;7;12
7881;"Prie pasakų parko";"LINKSMOJI ŠEIMYNĖLĖ (SPEC)";29561378525;Taip;20;0;0;20
7882;"Prie pasakų parko";"LINKSMOJI ŠEIMYNĖLĖ (SPEC)";7375940325;Taip;0;0;4;4
7883;"Prie pasakų parko";"LINKSMOJI ŠEIMYNĖLĖ (SPEC)";7186554262;Taip;5;0;0;5
7884;"Prie pasakų parko";"LINKSMOJI ŠEIMYNĖLĖ (SPEC)";6339321027;Taip;4;4;2;10
7885;"Prie pasakų parko";"LINKSMOJI ŠEIMYNĖLĖ (SPEC)";1007988202;Ne;0;5;0;5
7886;"Prie pasakų parko";"LINKSMOJI ŠEIMYNĖLĖ (SPEC)";50713289266;Taip;11;0;1;12
7887;"Prie pasakų parko";"LINKSMOJI ŠEIMYNĖLĖ (SPEC)";1327847558;Taip;5;15;0;20
7888;"Prie pasakų parko";NYKŠTUKŲ;41410871117;Taip;3;5;0;8
7889;"Prie pasakų parko";NYKŠTUKŲ;18733824395;Taip;0;5;2;7
7890;"Prie pasakų parko";NYKŠTUKŲ;79438946697;Taip;15;5;0;20
7891;"Prie pasakų parko";NYKŠTUKŲ;21605684303;Taip;5;0;0;5
7892;"Prie pasakų parko";NYKŠTUKŲ;72936036464;Taip;14;0;0;14
7893;"Prie pasakų parko";NYKŠTUKŲ;1410161486;Taip;0;8;0;8
7894;"Prie pasakų parko";NYKŠTUKŲ;9384410578;Taip;0;0;3;3
7895;"Prie pasakų parko";NYKŠTUKŲ;9511739352;Taip;5;0;0;5
7896;"Prie pasakų parko";NYKŠTUKŲ;7235277422;Taip;8;5;4;17
7897;"Prie pasakų parko";NYKŠTUKŲ;6577763037;Taip;0;2;0;2
7898;"Prie pasakų parko";NYKŠTUKŲ;6027613840;Taip;0;2;1;3
7899;"Prie pasakų parko";NYKŠTUKŲ;4657371068;Taip;1;0;0;1
7900;"Prie pasakų parko";NYKŠTUKŲ;70510594589;Taip;0;0;2;2
7901;"Prie pasakų parko";NYKŠTUKŲ;1634442815;Taip;3;7;0;10
7902;"Prie pasakų parko";LAŠELIŲ;2106160177;Taip;6;11;0;17
7903;"Prie pasakų parko";LAŠELIŲ;15531434904;Taip;0;4;0;4
7904;"Prie pasakų parko";LAŠELIŲ;62268017779;Taip;11;0;2;13
7905;"Prie pasakų parko";LAŠELIŲ;1414828294;Taip;0;1;0;1
7906;"Prie pasakų parko";LAŠELIŲ;98216786643;Taip;6;0;5;11
7907;"Prie pasakų parko";LAŠELIŲ;488285764;Taip;0;0;11;11
7908;"Prie pasakų parko";LAŠELIŲ;41495895397;Taip;0;11;0;11
7909;"Prie pasakų parko";LAŠELIŲ;80772711351;Taip;8;0;0;8
7910;"Prie pasakų parko";LAŠELIŲ;17947580061;Taip;0;0;2;2
7911;"Prie pasakų parko";"KAČIUKAI (SPEC)";5049934191;Ne;6;0;2;8
7912;"Prie pasakų parko";"KAČIUKAI (SPEC)";47641041054;Taip;4;5;0;9
7913;"Prie pasakų parko";"KAČIUKAI (SPEC)";67103811533;Ne;5;0;3;8
7914;"Prie pasakų parko";"KAČIUKAI (SPEC)";4241426494;Ne;8;5;0;13
7915;"Prie pasakų parko";"KAČIUKAI (SPEC)";42696300043;Taip;11;0;0;11
7916;"Prie pasakų parko";"ŽVAIGŽDUTĖS  (SPEC)";2224744461;Taip;0;0;1;1
7917;"Prie pasakų parko";"ŽVAIGŽDUTĖS  (SPEC)";39511689145;Taip;0;4;0;4
7918;"Prie pasakų parko";"ŽVAIGŽDUTĖS  (SPEC)";11759638207;Taip;0;0;1;1
7919;"Prie pasakų parko";"ŽVAIGŽDUTĖS  (SPEC)";3045247119;Taip;0;0;7;7
7920;"Prie pasakų parko";"ŽVAIGŽDUTĖS  (SPEC)";28449237128;Taip;5;0;0;5
7921;"Prie pasakų parko";"ŽVAIGŽDUTĖS  (SPEC)";7341054382;Ne;20;0;0;20
7922;"Prie pasakų parko";"ŽVAIGŽDUTĖS  (SPEC)";1118596267;Taip;0;0;1;1
7923;"Prie pasakų parko";"ŽVAIGŽDUTĖS  (SPEC)";89327404290;Taip;17;0;0;17
7924;"Prie pasakų parko";"ANČIUKAI (SPEC)";47396396133;Taip;0;0;8;8
7925;"Prie pasakų parko";"ANČIUKAI (SPEC)";4908579339;Taip;5;5;2;12
7926;"Prie pasakų parko";"ANČIUKAI (SPEC)";1730134670;Ne;0;0;4;4
7927;"Prie pasakų parko";"ANČIUKAI (SPEC)";78012776060;Taip;0;5;5;10
7928;"Prie pasakų parko";"ANČIUKAI (SPEC)";1658448860;Taip;0;7;0;7
7929;"Prie pasakų parko";"ANČIUKAI (SPEC)";78634860827;Taip;0;5;8;13
7930;"Prie pasakų parko";TIGRIUKAI;1425859956;Taip;0;1;0;1
7931;"Prie pasakų parko";TIGRIUKAI;4427448272;Taip;10;0;1;11
7932;"Prie pasakų parko";TIGRIUKAI;2601881804;Taip;0;7;0;7
7933;"Prie pasakų parko";TIGRIUKAI;34800098950;Taip;0;0;1;1
7934;"Prie pasakų parko";TIGRIUKAI;1275460051;Taip;0;0;3;3
7935;"Prie pasakų parko";TIGRIUKAI;1400892707;Taip;0;0;7;7
7936;"Prie pasakų parko";TIGRIUKAI;4365489653;Taip;0;3;0;3
7937;"Prie pasakų parko";TIGRIUKAI;1163359201;Taip;20;0;0;20
7938;"Prie pasakų parko";TIGRIUKAI;6273733995;Taip;0;11;0;11
7939;"Prie pasakų parko";TIGRIUKAI;1204812495;Taip;0;10;0;10
7940;"Prie pasakų parko";TIGRIUKAI;5699852944;Taip;0;0;2;2
7941;"Prie pasakų parko";TIGRIUKAI;5001661462;Taip;0;0;1;1
7942;"Prie pasakų parko";TIGRIUKAI;65825430797;Taip;0;13;0;13
7943;"Prie pasakų parko";TIGRIUKAI;4900757614;Taip;0;4;0;4
7944;"Prie pasakų parko";TIGRIUKAI;8205731591;Taip;20;0;0;20
7945;"Prie pasakų parko";TIGRIUKAI;1357074461;Taip;0;0;20;20
7946;"Prie pasakų parko";TIGRIUKAI;8474308320;Ne;20;0;0;20
7947;"Prie pasakų parko";"EŽIUKŲ (SPEC)";8323172347;Taip;4;0;0;4
7948;"Prie pasakų parko";"EŽIUKŲ (SPEC)";2820889357;Ne;4;0;2;6
7949;"Prie pasakų parko";"EŽIUKŲ (SPEC)";1549137154;Taip;10;0;1;11
7950;"Prie pasakų parko";"EŽIUKŲ (SPEC)";29445903073;Taip;9;6;0;15
7951;"Prie pasakų parko";"EŽIUKŲ (SPEC)";2133790263;Ne;6;1;0;7
7952;"Prie pasakų parko";"EŽIUKŲ (SPEC)";8849417734;Taip;0;0;1;1
7953;"Prie pasakų parko";"EŽIUKŲ (SPEC)";9190379838;Taip;0;0;1;1
7954;"Prie pasakų parko";"EŽIUKŲ (SPEC)";7327208141;Ne;20;0;0;20
7955;"Prie pasakų parko";"BORUŽIUKŲ (SPEC)";2080597774;Taip;5;0;0;5
7956;"Prie pasakų parko";"BORUŽIUKŲ (SPEC)";8817950372;Taip;0;10;0;10
7957;"Prie pasakų parko";"BORUŽIUKŲ (SPEC)";4203385836;Taip;7;7;0;14
7958;"Prie pasakų parko";"BORUŽIUKŲ (SPEC)";92307951922;Taip;11;3;0;14
7959;"Prie pasakų parko";SAULYTĖS;1543331408;Taip;0;0;11;11
7960;"Prie pasakų parko";SAULYTĖS;1369637618;Taip;5;0;0;5
7961;"Prie pasakų parko";SAULYTĖS;4501408366;Taip;0;4;0;4
7962;"Prie pasakų parko";SAULYTĖS;4874244790;Taip;17;0;0;17
7963;"Prie pasakų parko";SAULYTĖS;8182873487;Taip;0;3;0;3
7964;"Prie pasakų parko";SAULYTĖS;1610362831;Ne;0;17;0;17
7965;"Prie pasakų parko";SAULYTĖS;2548712970;Taip;11;0;0;11
7966;"Prie pasakų parko";SAULYTĖS;78516912418;Taip;0;3;0;3
7967;"Prie pasakų parko";SAULYTĖS;5593546668;Taip;0;4;0;4
7968;"Prie pasakų parko";SAULYTĖS;6361878877;Taip;10;0;0;10
7969;"Prie pasakų parko";SAULYTĖS;4443834766;Taip;2;0;0;2
7970;"Prie pasakų parko";SAULYTĖS;3453119286;Taip;5;0;0;5
7971;"Prie pasakų parko";SAULYTĖS;5169736542;Ne;0;11;0;11
7972;"Prie pasakų parko";SAULYTĖS;4332682721;Ne;7;0;5;12
7973;"Prie pasakų parko";SAULYTĖS;5494350183;Taip;0;4;0;4
7974;"Prie pasakų parko";SAULYTĖS;6250397070;Taip;0;2;0;2
7975;Pumpurėlis;RAMUNĖLIŲ;61297074638;Taip;0;5;0;5
7976;Pumpurėlis;RAMUNĖLIŲ;87813594933;Taip;9;7;0;16
7977;Pumpurėlis;RAMUNĖLIŲ;7015779224;Taip;0;13;0;13
7978;Pumpurėlis;RAMUNĖLIŲ;24681852477;Taip;0;1;0;1
7979;Pumpurėlis;RAMUNĖLIŲ;27361939846;Taip;0;7;0;7
7980;Pumpurėlis;RAMUNĖLIŲ;72455192748;Taip;0;9;0;9
7981;Pumpurėlis;RAMUNĖLIŲ;20093100251;Taip;0;2;0;2
7982;Pumpurėlis;RAMUNĖLIŲ;66672997420;Taip;0;6;0;6
7983;Pumpurėlis;RAMUNĖLIŲ;15096075268;Taip;0;3;0;3
7984;Pumpurėlis;RAMUNĖLIŲ;1685401053;Taip;0;6;0;6
7985;Pumpurėlis;RAMUNĖLIŲ;33847164571;Taip;4;0;0;4
7986;Pumpurėlis;RAMUNĖLIŲ;2671657094;Taip;5;5;0;10
7987;Pumpurėlis;RAMUNĖLIŲ;91612536967;Taip;0;1;0;1
7988;Pumpurėlis;RAMUNĖLIŲ;45279361421;Taip;0;5;0;5
7989;Pumpurėlis;RAMUNĖLIŲ;16656067942;Taip;0;9;0;9
7990;Pumpurėlis;RAMUNĖLIŲ;9041599264;Taip;5;0;0;5
7991;Pumpurėlis;RAMUNĖLIŲ;1021043951;Taip;0;1;0;1
7992;Pumpurėlis;RAMUNĖLIŲ;1524688901;Taip;7;5;0;12
7993;Pumpurėlis;RAMUNĖLIŲ;1366801299;Taip;7;5;0;12
7994;Pumpurėlis;RAMUNĖLIŲ;1631951556;Taip;0;5;2;7
7995;Pumpurėlis;RAMUNĖLIŲ;1085633311;Taip;0;0;1;1
7996;Pumpurėlis;RAMUNĖLIŲ;6215273976;Taip;0;10;0;10
7997;Pumpurėlis;VARPELIŲ;97145389284;Taip;5;1;0;6
7998;Pumpurėlis;VARPELIŲ;70522541316;Taip;0;7;0;7
7999;Pumpurėlis;VARPELIŲ;465606233;Taip;5;5;0;10
8000;Pumpurėlis;VARPELIŲ;93964052608;Taip;2;1;0;3
8001;Pumpurėlis;VARPELIŲ;11052382671;Taip;0;18;0;18
8002;Pumpurėlis;VARPELIŲ;77110003421;Taip;0;10;0;10
8003;Pumpurėlis;VARPELIŲ;47596248180;Taip;0;14;0;14
8004;Pumpurėlis;VARPELIŲ;46386981131;Taip;3;6;0;9
8005;Pumpurėlis;VARPELIŲ;49176440282;Ne;10;6;0;16
8006;Pumpurėlis;VARPELIŲ;40808677022;Taip;0;1;0;1
8007;Pumpurėlis;VARPELIŲ;36645787745;Taip;10;7;1;18
8008;Pumpurėlis;VARPELIŲ;5901659879;Taip;0;2;0;2
8009;Pumpurėlis;VARPELIŲ;56351492623;Taip;0;5;0;5
8010;Pumpurėlis;VARPELIŲ;1754102092;Taip;0;5;0;5
8011;Pumpurėlis;VARPELIŲ;57426850391;Taip;0;2;3;5
8012;Pumpurėlis;VARPELIŲ;15256433275;Taip;0;13;0;13
8013;Pumpurėlis;VARPELIŲ;89695456583;Taip;9;2;0;11
8014;Pumpurėlis;VARPELIŲ;1544903261;Ne;0;20;0;20
8015;Pumpurėlis;VARPELIŲ;1945407792;Taip;0;2;0;2
8016;Pumpurėlis;VARPELIŲ;1645287832;Taip;0;6;2;8
8017;Pumpurėlis;VARPELIŲ;6025998706;Taip;5;0;0;5
8018;Pumpurėlis;DRUGELIŲ;1230058211;Taip;0;9;0;9
8019;Pumpurėlis;DRUGELIŲ;1053338730;Taip;7;0;0;7
8020;Pumpurėlis;DRUGELIŲ;1261919194;Taip;0;0;5;5
8021;Pumpurėlis;DRUGELIŲ;1397924008;Taip;0;0;2;2
8022;Pumpurėlis;DRUGELIŲ;6230500803;Taip;0;11;0;11
8023;Pumpurėlis;DRUGELIŲ;2129779614;Taip;0;0;7;7
8024;Pumpurėlis;DRUGELIŲ;2102427499;Taip;0;12;0;12
8025;Pumpurėlis;DRUGELIŲ;9317495169;Taip;0;3;0;3
8026;Pumpurėlis;DRUGELIŲ;8262886949;Taip;0;6;0;6
8027;Pumpurėlis;DRUGELIŲ;6535398274;Taip;20;0;0;20
8028;Pumpurėlis;DRUGELIŲ;9078991043;Taip;10;2;0;12
8029;Pumpurėlis;DRUGELIŲ;9733380187;Taip;0;12;0;12
8030;Pumpurėlis;DRUGELIŲ;83388662869;Taip;0;8;0;8
8031;Pumpurėlis;DRUGELIŲ;1690424790;Taip;0;16;0;16
8032;Pumpurėlis;DRUGELIŲ;4192641015;Taip;0;6;0;6
8033;Pumpurėlis;DRUGELIŲ;7519369167;Taip;5;0;3;8
8034;Pumpurėlis;DRUGELIŲ;1248017244;Taip;6;1;3;10
8035;Pumpurėlis;DRUGELIŲ;6395230524;Taip;0;0;1;1
8036;Pumpurėlis;KODĖLČIUKŲ;5984878126;Taip;5;6;0;11
8037;Pumpurėlis;KODĖLČIUKŲ;18928851032;Taip;12;0;0;12
8038;Pumpurėlis;KODĖLČIUKŲ;9224879966;Taip;0;11;0;11
8039;Pumpurėlis;KODĖLČIUKŲ;1188314397;Taip;0;4;0;4
8040;Pumpurėlis;KODĖLČIUKŲ;2468796972;Taip;0;7;0;7
8041;Pumpurėlis;KODĖLČIUKŲ;8830261792;Taip;0;1;0;1
8042;Pumpurėlis;KODĖLČIUKŲ;9583257172;Taip;0;6;0;6
8043;Pumpurėlis;KODĖLČIUKŲ;9138883172;Taip;3;1;0;4
8044;Pumpurėlis;KODĖLČIUKŲ;7533555059;Taip;0;11;0;11
8045;Pumpurėlis;KODĖLČIUKŲ;6669327226;Taip;0;5;0;5
8046;Pumpurėlis;KODĖLČIUKŲ;13952236905;Taip;15;0;0;15
8047;Pumpurėlis;KODĖLČIUKŲ;87061817106;Taip;15;0;0;15
8048;Pumpurėlis;KODĖLČIUKŲ;30267173981;Taip;5;0;0;5
8049;Pumpurėlis;KODĖLČIUKŲ;1835168438;Taip;5;0;0;5
8050;Pumpurėlis;KODĖLČIUKŲ;5615260965;Taip;0;9;0;9
8051;Pumpurėlis;KODĖLČIUKŲ;4344595328;Taip;0;4;0;4
8052;Pumpurėlis;KODĖLČIUKŲ;3298821054;Taip;7;4;0;11
8053;Pumpurėlis;KODĖLČIUKŲ;8806961007;Taip;13;0;2;15
8054;Pumpurėlis;KODĖLČIUKŲ;9439363363;Taip;12;0;2;14
8055;Pumpurėlis;KODĖLČIUKŲ;5964953923;Taip;15;5;0;20
8056;Pumpurėlis;KODĖLČIUKŲ;1492810528;Taip;0;17;0;17
8057;Pumpurėlis;KODĖLČIUKŲ;7566451857;Taip;7;0;0;7
8058;Pumpurėlis;LINELIS;1320618070;Taip;0;5;0;5
8059;Pumpurėlis;LINELIS;42874947682;Taip;2;0;0;2
8060;Pumpurėlis;LINELIS;90214423899;Taip;10;1;0;11
8061;Pumpurėlis;LINELIS;79993170267;Taip;0;5;0;5
8062;Pumpurėlis;LINELIS;98941059894;Taip;5;3;0;8
8063;Pumpurėlis;LINELIS;22232669189;Taip;7;6;0;13
8064;Pumpurėlis;LINELIS;65556407758;Taip;2;5;0;7
8065;Pumpurėlis;LINELIS;50662453283;Taip;0;3;1;4
8066;Pumpurėlis;LINELIS;5626656132;Taip;0;10;0;10
8067;Pumpurėlis;LINELIS;8088505202;Taip;0;1;0;1
8068;Pumpurėlis;LINELIS;39148007125;Taip;0;8;0;8
8069;Pumpurėlis;LINELIS;8916669921;Taip;0;1;0;1
8070;Pumpurėlis;LINELIS;79813871981;Taip;0;4;0;4
8071;Pumpurėlis;LINELIS;86581864351;Taip;0;1;0;1
8072;Pumpurėlis;LINELIS;24135602993;Taip;13;4;0;17
8073;Pumpurėlis;LINELIS;74357094385;Taip;8;0;0;8
8074;Pumpurėlis;LINELIS;99841176399;Taip;0;5;0;5
8075;Pumpurėlis;LINELIS;57455327823;Taip;0;6;0;6
8076;Pumpurėlis;LINELIS;5956784613;Taip;10;8;0;18
8077;Pumpurėlis;SAULUTĖS;42537135918;Taip;0;5;0;5
8078;Pumpurėlis;SAULUTĖS;50393587861;Taip;0;7;0;7
8079;Pumpurėlis;SAULUTĖS;45898175544;Taip;0;17;0;17
8080;Pumpurėlis;SAULUTĖS;49696660115;Taip;0;11;0;11
8081;Pumpurėlis;SAULUTĖS;24927191443;Taip;0;6;0;6
8082;Pumpurėlis;SAULUTĖS;82272797732;Taip;0;2;0;2
8083;Pumpurėlis;SAULUTĖS;76081690528;Taip;0;6;0;6
8084;Pumpurėlis;SAULUTĖS;76467622234;Taip;0;10;0;10
8085;Pumpurėlis;SAULUTĖS;89004303712;Taip;0;7;0;7
8086;Pumpurėlis;SAULUTĖS;32946314312;Taip;5;5;0;10
8087;Pumpurėlis;SAULUTĖS;50292067501;Taip;6;5;0;11
8088;Pumpurėlis;SAULUTĖS;91231481674;Taip;0;5;0;5
8089;Pumpurėlis;SAULUTĖS;77181386286;Taip;0;1;0;1
8090;Pumpurėlis;SAULUTĖS;77106733982;Taip;0;2;0;2
8091;Pumpurėlis;SAULUTĖS;25796704653;Taip;0;5;0;5
8092;Pumpurėlis;SAULUTĖS;45310988567;Taip;0;7;0;7
8093;Pumpurėlis;SAULUTĖS;73862556514;Ne;0;5;0;5
8094;Pumpurėlis;SAULUTĖS;96528992638;Taip;5;15;0;20
8095;Pumpurėlis;SAULUTĖS;2129522323;Taip;0;5;0;5
8096;Pumpurėlis;SAULUTĖS;1595705560;Taip;0;5;0;5
8097;Pumpurėlis;BITUTĖS;2028515310;Taip;0;7;0;7
8098;Pumpurėlis;BITUTĖS;44982629856;Taip;0;5;0;5
8099;Pumpurėlis;BITUTĖS;1333429949;Taip;0;1;0;1
8100;Pumpurėlis;BITUTĖS;8747439652;Taip;5;0;0;5
8101;Pumpurėlis;BITUTĖS;92238719397;Taip;0;5;0;5
8102;Pumpurėlis;BITUTĖS;1400057487;Taip;5;0;0;5
8103;Pumpurėlis;BITUTĖS;1274293175;Taip;0;4;0;4
8104;Pumpurėlis;BITUTĖS;93809482039;Taip;10;1;0;11
8105;Pumpurėlis;BITUTĖS;7786926187;Taip;4;5;0;9
8106;Pumpurėlis;BITUTĖS;74144468541;Taip;0;4;0;4
8107;Pumpurėlis;BITUTĖS;1640573725;Taip;0;15;0;15
8108;Pumpurėlis;BITUTĖS;1473237607;Taip;0;5;1;6
8109;Pumpurėlis;BITUTĖS;71979455611;Taip;0;1;0;1
8110;Pumpurėlis;BITUTĖS;26859673794;Taip;20;0;0;20
8111;Pumpurėlis;BITUTĖS;1527144198;Taip;0;7;0;7
8112;Pumpurėlis;BITUTĖS;57949968899;Taip;12;0;0;12
8113;Pumpurėlis;BITUTĖS;1298302188;Taip;0;0;1;1
8114;Pumpurėlis;BITUTĖS;1255753542;Taip;5;15;0;20
8115;Pumpurėlis;DOBILIUKAI;1273831078;Taip;0;4;0;4
8116;Pumpurėlis;DOBILIUKAI;1264017142;Taip;10;0;1;11
8117;Pumpurėlis;DOBILIUKAI;98061041685;Taip;0;1;0;1
8118;Pumpurėlis;DOBILIUKAI;1287902351;Taip;0;5;0;5
8119;Pumpurėlis;DOBILIUKAI;1867989314;Taip;1;0;0;1
8120;Pumpurėlis;DOBILIUKAI;1209654095;Taip;0;0;3;3
8121;Pumpurėlis;DOBILIUKAI;40267078306;Taip;0;0;2;2
8122;Pumpurėlis;DOBILIUKAI;51793437519;Taip;0;7;0;7
8123;Pumpurėlis;DOBILIUKAI;1319664504;Taip;0;0;5;5
8124;Pumpurėlis;DOBILIUKAI;1921332565;Taip;0;10;1;11
8125;Pumpurėlis;DOBILIUKAI;1055683170;Taip;0;5;0;5
8126;Pumpurėlis;DOBILIUKAI;1620037477;Taip;0;5;0;5
8127;Pumpurėlis;DOBILIUKAI;1307929787;Taip;0;2;0;2
8128;Pumpurėlis;DOBILIUKAI;1511761574;Taip;0;6;0;6
8129;Pumpurėlis;DOBILIUKAI;1346602122;Taip;4;6;0;10
8130;Pumpurėlis;DOBILIUKAI;88732170322;Taip;0;5;0;5
8131;Pumpurėlis;DOBILIUKAI;1469189392;Taip;15;0;5;20
8132;Pumpurėlis;DOBILIUKAI;94636926281;Taip;8;0;5;13
8133;Pumpurėlis;DOBILIUKAI;1027125361;Taip;10;5;0;15
8134;Pumpurėlis;PUPYČIŲ;9612924972;Taip;8;0;0;8
8135;Pumpurėlis;PUPYČIŲ;9884099545;Taip;10;0;2;12
8136;Pumpurėlis;PUPYČIŲ;8258560345;Taip;0;0;17;17
8137;Pumpurėlis;PUPYČIŲ;1687770779;Taip;12;0;0;12
8138;Pumpurėlis;PUPYČIŲ;5196733185;Taip;0;10;0;10
8139;Pumpurėlis;PUPYČIŲ;2668855786;Taip;16;2;0;18
8140;Pumpurėlis;PUPYČIŲ;4928495108;Taip;0;6;0;6
8141;Pumpurėlis;PUPYČIŲ;8886730333;Taip;20;0;0;20
8142;Pumpurėlis;PUPYČIŲ;7160091629;Taip;13;1;0;14
8143;Pumpurėlis;PUPYČIŲ;3893768713;Taip;0;4;0;4
8144;Pumpurėlis;PUPYČIŲ;3101133244;Taip;0;16;0;16
8145;Pumpurėlis;PUPYČIŲ;4508966729;Taip;8;0;0;8
8146;Pumpurėlis;PUPYČIŲ;4451898302;Taip;7;0;0;7
8147;Pumpurėlis;PUPYČIŲ;5023658988;Taip;14;0;0;14
8148;Pumpurėlis;PUPYČIŲ;9552913910;Taip;14;0;0;14
8149;Pumpurėlis;ŽIRNIUKŲ;4985045047;Taip;14;0;0;14
8150;Pumpurėlis;ŽIRNIUKŲ;7610949816;Taip;0;2;0;2
8151;Pumpurėlis;ŽIRNIUKŲ;6977710645;Taip;13;0;4;17
8152;Pumpurėlis;ŽIRNIUKŲ;9431295796;Taip;11;0;2;13
8153;Pumpurėlis;ŽIRNIUKŲ;1395380236;Taip;10;0;1;11
8154;Pumpurėlis;ŽIRNIUKŲ;9424449290;Taip;10;8;0;18
8155;Pumpurėlis;ŽIRNIUKŲ;6955168163;Taip;2;0;0;2
8156;Pumpurėlis;ŽIRNIUKŲ;7229289985;Taip;6;0;1;7
8157;Pumpurėlis;ŽIRNIUKŲ;1674341906;Taip;0;7;0;7
8158;Pumpurėlis;ŽIRNIUKŲ;5663147778;Taip;9;0;1;10
8159;Pumpurėlis;ŽIRNIUKŲ;7559071945;Taip;0;1;1;2
8160;Pumpurėlis;ŽIRNIUKŲ;8373105196;Taip;11;0;0;11
8161;Pumpurėlis;ŽIRNIUKŲ;9726028397;Taip;0;10;0;10
8162;Pumpurėlis;ŽIRNIUKŲ;5171198109;Taip;0;12;0;12
8163;Pumpurėlis;ŽIRNIUKŲ;2969734731;Taip;13;0;0;13
8164;Pumpurėlis;BORUŽĖLIŲ;49767198843;Taip;5;0;0;5
8165;Pumpurėlis;BORUŽĖLIŲ;42611228425;Taip;5;0;5;10
8166;Pumpurėlis;BORUŽĖLIŲ;68035717481;Taip;12;1;0;13
8167;Pumpurėlis;BORUŽĖLIŲ;1594436797;Taip;1;5;0;6
8168;Pumpurėlis;BORUŽĖLIŲ;1568701327;Taip;3;0;1;4
8169;Pumpurėlis;BORUŽĖLIŲ;1842097360;Taip;0;0;1;1
8170;Pumpurėlis;BORUŽĖLIŲ;82659096039;Taip;9;2;0;11
8171;Pumpurėlis;BORUŽĖLIŲ;1098875585;Taip;7;0;0;7
8172;Pumpurėlis;BORUŽĖLIŲ;1034745510;Taip;10;0;0;10
8173;Pumpurėlis;BORUŽĖLIŲ;5364345261;Taip;0;3;0;3
8174;Pumpurėlis;BORUŽĖLIŲ;1617303626;Taip;3;0;0;3
8175;Pumpurėlis;BORUŽĖLIŲ;1306102772;Taip;9;5;0;14
8176;Pumpurėlis;BORUŽĖLIŲ;1436627913;Taip;4;2;0;6
8177;Pumpurėlis;BORUŽĖLIŲ;1075914140;Taip;4;0;5;9
8178;Pumpurėlis;BORUŽĖLIŲ;2345116167;Taip;13;0;0;13
8179;Pumpurėlis;BORUŽĖLIŲ;63610860077;Taip;0;11;0;11
8180;Pumpurėlis;BORUŽĖLIŲ;6097804285;Taip;7;0;0;7
8181;Pumpurėlis;BORUŽĖLIŲ;1508245418;Taip;5;0;0;5
8182;Pumpurėlis;BORUŽĖLIŲ;81595634697;Taip;7;0;0;7
8183;Pumpurėlis;BORUŽĖLIŲ;1061975374;Taip;5;4;0;9
8184;Puriena;Ančiukų;73312316742;Taip;15;0;0;15
8185;Puriena;Ančiukų;90765300922;Taip;0;2;0;2
8186;Puriena;Ančiukų;54803470430;Taip;0;2;0;2
8187;Puriena;Ančiukų;27321768851;Taip;0;2;0;2
8188;Puriena;Ančiukų;17378740941;Taip;10;0;2;12
8189;Puriena;Ančiukų;58363113692;Taip;0;0;1;1
8190;Puriena;Ančiukų;78566741895;Taip;20;0;0;20
8191;Puriena;Ančiukų;69902514699;Taip;20;0;0;20
8192;Puriena;Ančiukų;54723251890;Taip;13;2;0;15
8193;Puriena;Ančiukų;54181308247;Taip;10;8;0;18
8194;Puriena;Ančiukų;76491901304;Taip;1;4;0;5
8195;Puriena;Ančiukų;86174474927;Taip;5;0;0;5
8196;Puriena;Ančiukų;85013789582;Taip;0;11;0;11
8197;Puriena;Ančiukų;93516016900;Taip;9;2;0;11
8198;Puriena;Ančiukų;61259599767;Taip;7;6;0;13
8199;Puriena;Ančiukų;84757305442;Taip;0;4;0;4
8200;Puriena;Ančiukų;50171510736;Taip;8;2;0;10
8201;Puriena;Ančiukų;48507270084;Taip;9;0;1;10
8202;Puriena;Ančiukų;88268169404;Taip;0;1;0;1
8203;Puriena;Ančiukų;9440991851;Taip;10;5;0;15
8204;Puriena;Ančiukų;1394510964;Taip;5;6;0;11
8205;Puriena;Drugeliai;7337038503;Taip;12;2;0;14
8206;Puriena;Drugeliai;47316276655;Taip;18;0;0;18
8207;Puriena;Drugeliai;48468411549;Taip;6;0;2;8
8208;Puriena;Drugeliai;20286870431;Taip;6;6;0;12
8209;Puriena;Drugeliai;63196502622;Taip;4;5;1;10
8210;Puriena;Drugeliai;11497629767;Taip;15;0;0;15
8211;Puriena;Drugeliai;2146036332;Taip;5;0;1;6
8212;Puriena;Drugeliai;1142929858;Taip;3;1;2;6
8213;Puriena;Drugeliai;1443945321;Taip;0;0;2;2
8214;Puriena;Drugeliai;1703078658;Taip;0;5;0;5
8215;Puriena;Drugeliai;2083071198;Taip;5;8;0;13
8216;Puriena;Drugeliai;8213725698;Taip;14;0;0;14
8217;Puriena;Drugeliai;2378865002;Taip;11;0;0;11
8218;Puriena;Drugeliai;5891404983;Taip;5;0;4;9
8219;Puriena;Drugeliai;9239618299;Taip;0;12;5;17
8220;Puriena;Drugeliai;2089174669;Taip;10;2;1;13
8221;Puriena;Drugeliai;2131343339;Taip;10;0;0;10
8222;Puriena;Drugeliai;1748337587;Taip;0;8;0;8
8223;Puriena;Drugeliai;8618298134;Taip;14;0;0;14
8224;Puriena;Drugeliai;8707076857;Taip;5;0;0;5
8225;Puriena;Drugeliai;1820719083;Taip;12;0;0;12
8226;Puriena;Drugeliai;4394023057;Taip;0;7;0;7
8227;Puriena;Pelėdžiukai;11431481909;Taip;7;6;0;13
8228;Puriena;Pelėdžiukai;53451774513;Taip;0;11;0;11
8229;Puriena;Pelėdžiukai;12499791115;Taip;0;3;0;3
8230;Puriena;Pelėdžiukai;54048579160;Taip;4;9;0;13
8231;Puriena;Pelėdžiukai;43490363874;Taip;7;6;0;13
8232;Puriena;Pelėdžiukai;34689084311;Taip;4;3;0;7
8233;Puriena;Pelėdžiukai;21611180390;Taip;0;8;0;8
8234;Puriena;Pelėdžiukai;15016729899;Taip;7;1;0;8
8235;Puriena;Pelėdžiukai;11677252767;Taip;10;0;0;10
8236;Puriena;Pelėdžiukai;16437608299;Taip;4;8;0;12
8237;Puriena;Pelėdžiukai;69494886505;Taip;1;9;0;10
8238;Puriena;Pelėdžiukai;51874022935;Taip;7;3;0;10
8239;Puriena;Pelėdžiukai;58791977007;Taip;2;2;0;4
8240;Puriena;Pelėdžiukai;53286108187;Taip;0;2;0;2
8241;Puriena;Pelėdžiukai;81806945761;Taip;8;3;0;11
8242;Puriena;Pelėdžiukai;43963341624;Ne;6;6;0;12
8243;Puriena;Pelėdžiukai;26040866189;Taip;0;6;0;6
8244;Puriena;Pelėdžiukai;90508354565;Taip;0;4;0;4
8245;Puriena;Pelėdžiukai;95822432988;Taip;7;0;0;7
8246;Puriena;Pelėdžiukai;45627148409;Taip;10;1;0;11
8247;Puriena;Pelėdžiukai;2011809589;Taip;4;6;0;10
8248;Puriena;Voveriukai;23746358787;Taip;0;2;0;2
8249;Puriena;Voveriukai;5501308683;Taip;0;2;0;2
8250;Puriena;Voveriukai;1263637124;Taip;13;2;0;15
8251;Puriena;Voveriukai;1290933817;Taip;5;5;0;10
8252;Puriena;Voveriukai;7429832136;Taip;15;0;0;15
8253;Puriena;Voveriukai;2663832596;Taip;0;7;0;7
8254;Puriena;Voveriukai;4966293604;Taip;0;7;0;7
8255;Puriena;Voveriukai;2203259310;Taip;0;1;1;2
8256;Puriena;Voveriukai;40573980976;Taip;0;6;0;6
8257;Puriena;Voveriukai;1381379515;Taip;5;3;0;8
8258;Puriena;Voveriukai;6057477307;Taip;0;5;0;5
8259;Puriena;Voveriukai;1290962809;Taip;6;11;0;17
8260;Puriena;Voveriukai;9139110598;Taip;0;1;0;1
8261;Puriena;Voveriukai;9106525954;Taip;20;0;0;20
8262;Puriena;Voveriukai;5999564879;Taip;7;0;0;7
8263;Puriena;Voveriukai;6053657231;Taip;0;1;0;1
8264;Puriena;Voveriukai;9146447088;Taip;0;20;0;20
8265;Puriena;Voveriukai;8478901457;Taip;0;3;0;3
8266;Puriena;Bitučių;77708842205;Taip;0;7;0;7
8267;Puriena;Bitučių;67031288256;Taip;20;0;0;20
8268;Puriena;Bitučių;84484585930;Taip;14;4;0;18
8269;Puriena;Bitučių;11169417266;Ne;0;8;0;8
8270;Puriena;Bitučių;45287018563;Taip;5;2;0;7
8271;Puriena;Bitučių;3538587188;Taip;0;6;0;6
8272;Puriena;Bitučių;17841197680;Taip;0;1;0;1
8273;Puriena;Bitučių;25813179990;Taip;0;5;10;15
8274;Puriena;Bitučių;59762352185;Taip;11;0;0;11
8275;Puriena;Bitučių;87462824319;Taip;15;0;1;16
8276;Puriena;Bitučių;6794972162;Taip;5;8;0;13
8277;Puriena;Bitučių;33307762315;Taip;0;0;4;4
8278;Puriena;Bitučių;65319170607;Taip;4;5;0;9
8279;Puriena;Bitučių;55441324338;Taip;0;4;0;4
8280;Puriena;Bitučių;10701053444;Taip;10;0;0;10
8281;Puriena;Bitučių;10530139834;Taip;10;10;0;20
8282;Puriena;Bitučių;85386780648;Taip;3;5;0;8
8283;Puriena;Bitučių;38994996491;Taip;0;5;0;5
8284;Puriena;Bitučių;65910898731;Taip;6;0;2;8
8285;Puriena;Bitučių;3883844676;Taip;4;5;0;9
8286;Puriena;Zylutės;5920910288;Taip;0;10;0;10
8287;Puriena;Zylutės;14052847763;Taip;9;5;0;14
8288;Puriena;Zylutės;46510003255;Taip;0;8;0;8
8289;Puriena;Zylutės;64733952400;Taip;6;1;0;7
8290;Puriena;Zylutės;1993142891;Taip;20;0;0;20
8291;Puriena;Zylutės;6539425730;Ne;0;16;0;16
8292;Puriena;Zylutės;88483773966;Taip;20;0;0;20
8293;Puriena;Zylutės;61706928693;Taip;0;3;0;3
8294;Puriena;Zylutės;45128021817;Taip;18;0;0;18
8295;Puriena;Zylutės;7285127722;Taip;3;0;0;3
8296;Puriena;Zylutės;63953968050;Ne;0;7;0;7
8297;Puriena;Zylutės;87711542948;Taip;0;1;0;1
8298;Puriena;Zylutės;50199557129;Taip;0;1;0;1
8299;Puriena;Zylutės;88595039240;Taip;0;7;0;7
8300;Puriena;Zylutės;14780389529;Taip;5;0;0;5
8301;Puriena;Zylutės;54604607448;Taip;10;0;0;10
8302;Puriena;Zylutės;1994224209;Taip;0;6;0;6
8303;Puriena;Meškučių;5026857195;Taip;0;2;0;2
8304;Puriena;Meškučių;88588968229;Taip;0;2;0;2
8305;Puriena;Meškučių;1758690169;Taip;5;5;0;10
8306;Puriena;Meškučių;25112307864;Taip;0;5;1;6
8307;Puriena;Meškučių;1240190350;Taip;8;0;0;8
8308;Puriena;Meškučių;19157486407;Taip;10;0;0;10
8309;Puriena;Meškučių;1557814435;Taip;0;1;0;1
8310;Puriena;Meškučių;87523460146;Taip;0;8;0;8
8311;Puriena;Meškučių;61241768982;Taip;14;0;0;14
8312;Puriena;Meškučių;26980342372;Taip;14;4;0;18
8313;Puriena;Meškučių;4260334053;Taip;0;12;0;12
8314;Puriena;Meškučių;83821680276;Taip;6;0;0;6
8315;Puriena;Meškučių;71778035373;Taip;0;6;0;6
8316;Puriena;Meškučių;1184946421;Taip;12;2;0;14
8317;Puriena;Meškučių;61117212576;Taip;0;5;3;8
8318;Puriena;Meškučių;59193676476;Taip;14;5;0;19
8319;Puriena;Meškučių;91069175088;Taip;20;0;0;20
8320;Puriena;Meškučių;16572830524;Taip;0;1;0;1
8321;Puriena;Meškučių;18592085188;Taip;5;2;0;7
8322;Puriena;Meškučių;3327714361;Taip;8;2;1;11
8323;Puriena;Nykštukų;71773966341;Taip;9;0;0;9
8324;Puriena;Nykštukų;85334594528;Taip;11;5;0;16
8325;Puriena;Nykštukų;1945542034;Taip;8;4;0;12
8326;Puriena;Nykštukų;79194353091;Taip;7;0;0;7
8327;Puriena;Nykštukų;1629458651;Taip;15;0;0;15
8328;Puriena;Nykštukų;91735621242;Taip;10;0;0;10
8329;Puriena;Nykštukų;5284316470;Taip;13;0;0;13
8330;Puriena;Nykštukų;1116529845;Taip;0;5;0;5
8331;Puriena;Nykštukų;98967026878;Taip;13;0;0;13
8332;Puriena;Nykštukų;8719239663;Taip;13;0;0;13
8333;Puriena;Nykštukų;1206969296;Taip;10;2;0;12
8334;Puriena;Nykštukų;84527348236;Ne;9;5;0;14
8335;Puriena;Nykštukų;24572685191;Taip;0;1;5;6
8336;Puriena;Nykštukų;63944407195;Taip;5;0;0;5
8337;Puriena;Nykštukų;95153406240;Taip;7;1;0;8
8338;Puriena;Nykštukų;1125102675;Taip;14;2;0;16
8339;Puriena;Nykštukų;29217326976;Taip;18;1;0;19
8340;Puriena;Nykštukų;9666714143;Taip;4;2;0;6
8341;Puriena;Nykštukų;1507059980;Taip;0;6;0;6
8342;Puriena;Ežiukai;1174355613;Taip;7;6;0;13
8343;Puriena;Ežiukai;2255508780;Taip;5;6;0;11
8344;Puriena;Ežiukai;35226601932;Taip;14;1;0;15
8345;Puriena;Ežiukai;2072874096;Taip;5;5;0;10
8346;Puriena;Ežiukai;11011727269;Taip;10;1;0;11
8347;Puriena;Ežiukai;87416314075;Taip;0;0;6;6
8348;Puriena;Ežiukai;1175577834;Taip;7;2;2;11
8349;Puriena;Ežiukai;1134539790;Taip;11;3;1;15
8350;Puriena;Ežiukai;8852985927;Taip;0;10;0;10
8351;Puriena;Ežiukai;9471669903;Taip;11;1;0;12
8352;Puriena;Ežiukai;1707413291;Taip;5;7;0;12
8353;Puriena;Ežiukai;1773431155;Taip;5;0;3;8
8354;Puriena;Ežiukai;1379084331;Taip;0;0;2;2
8355;Puriena;Ežiukai;1710087159;Taip;1;1;5;7
8356;Puriena;Ežiukai;21180207545;Taip;0;10;0;10
8357;Puriena;Ežiukai;1762395617;Taip;0;12;0;12
8358;Puriena;Ežiukai;2560477213;Taip;5;0;0;5
8359;Puriena;Ežiukai;41863686552;Taip;0;9;0;9
8360;Puriena;Ežiukai;4792538031;Taip;5;1;0;6
8361;Puriena;"Boružiukų ";3033562627;Taip;12;2;0;14
8362;Puriena;"Boružiukų ";5777076971;Taip;12;2;0;14
8363;Puriena;"Boružiukų ";5336923102;Taip;5;5;0;10
8364;Puriena;"Boružiukų ";7769252165;Taip;0;2;0;2
8365;Puriena;"Boružiukų ";2170025682;Taip;0;5;0;5
8366;Puriena;"Boružiukų ";1428098802;Taip;0;4;0;4
8367;Puriena;"Boružiukų ";3772941726;Taip;0;4;0;4
8368;Puriena;"Boružiukų ";4460575818;Taip;15;2;0;17
8369;Puriena;"Boružiukų ";4605662701;Taip;11;4;0;15
8370;Puriena;"Boružiukų ";8120597514;Taip;0;8;0;8
8371;Puriena;"Boružiukų ";4776745276;Taip;20;0;0;20
8372;Puriena;"Boružiukų ";6158842119;Taip;20;0;0;20
8373;Puriena;"Boružiukų ";3681811493;Taip;5;0;0;5
8374;Puriena;"Boružiukų ";4060087185;Taip;0;1;0;1
8375;Puriena;"Boružiukų ";1819876614;Taip;6;1;1;8
8376;Puriena;"Zuikučių ";6883573289;Taip;13;0;0;13
8377;Puriena;"Zuikučių ";1339162214;Taip;17;1;0;18
8378;Puriena;"Zuikučių ";4283608124;Taip;10;10;0;20
8379;Puriena;"Zuikučių ";8130975863;Taip;16;0;0;16
8380;Puriena;"Zuikučių ";2813562677;Taip;13;0;1;14
8381;Puriena;"Zuikučių ";6656013805;Taip;2;1;0;3
8382;Puriena;"Zuikučių ";3542374463;Taip;10;2;0;12
8383;Puriena;"Zuikučių ";7573536525;Taip;9;5;0;14
8384;Puriena;"Zuikučių ";8022809059;Taip;10;1;0;11
8385;Puriena;"Zuikučių ";4498919764;Taip;11;5;1;17
8386;Puriena;"Zuikučių ";5395382717;Taip;11;2;0;13
8387;Puriena;"Zuikučių ";4444523140;Taip;15;1;0;16
8388;Puriena;"Zuikučių ";1933733714;Taip;20;0;0;20
8389;Puriena;"Zuikučių ";7622407056;Taip;10;3;0;13
8390;Puriena;"Zuikučių ";6150437624;Taip;14;0;0;14
8391;Puriena;"Zuikučių ";6813480086;Taip;5;2;0;7
8392;Puriena;"Zuikučių ";9854244405;Taip;5;5;0;10
8393;Pušaitė;Kodėlčiukai;1972872969;Taip;0;20;0;20
8394;Pušaitė;Kodėlčiukai;44525744411;Taip;5;0;0;5
8395;Pušaitė;Kodėlčiukai;1434600898;Taip;16;1;0;17
8396;Pušaitė;Kodėlčiukai;10978479164;Ne;3;6;0;9
8397;Pušaitė;Kodėlčiukai;92087943993;Taip;0;1;2;3
8398;Pušaitė;Kodėlčiukai;79462284429;Taip;0;6;0;6
8399;Pušaitė;Kodėlčiukai;51875651426;Taip;5;1;4;10
8400;Pušaitė;Kodėlčiukai;35587797387;Taip;0;2;2;4
8401;Pušaitė;Kodėlčiukai;36990708512;Taip;10;5;2;17
8402;Pušaitė;Kodėlčiukai;12300222260;Taip;0;1;0;1
8403;Pušaitė;Kodėlčiukai;37480908997;Taip;5;1;3;9
8404;Pušaitė;Kodėlčiukai;81773729142;Taip;0;0;1;1
8405;Pušaitė;Kodėlčiukai;2856902024;Taip;0;20;0;20
8406;Pušaitė;Kodėlčiukai;15593642938;Taip;0;2;0;2
8407;Pušaitė;Kodėlčiukai;10955132610;Taip;0;1;2;3
8408;Pušaitė;Kodėlčiukai;7680945149;Taip;0;2;0;2
8409;Pušaitė;Kodėlčiukai;1611231114;Taip;0;1;2;3
8410;Pušaitė;Kodėlčiukai;89687717250;Taip;0;6;0;6
8411;Pušaitė;Kodėlčiukai;3554790718;Taip;6;0;0;6
8412;Pušaitė;Kodėlčiukai;1912176781;Taip;0;6;0;6
8413;Pušaitė;Kodėlčiukai;20960105409;Taip;10;5;0;15
8414;Pušaitė;Kodėlčiukai;1444313482;Taip;0;2;0;2
8415;Pušaitė;Saulutės;1918948738;Taip;0;0;2;2
8416;Pušaitė;Saulutės;58885325641;Taip;2;0;0;2
8417;Pušaitė;Saulutės;29899199427;Taip;0;1;0;1
8418;Pušaitė;Saulutės;20174084726;Ne;0;0;4;4
8419;Pušaitė;Saulutės;36646217833;Taip;5;7;1;13
8420;Pušaitė;Saulutės;40449072854;Taip;3;3;0;6
8421;Pušaitė;Saulutės;46097491628;Taip;0;1;0;1
8422;Pušaitė;Saulutės;2066639203;Taip;0;9;0;9
8423;Pušaitė;Saulutės;99740435577;Ne;4;7;0;11
8424;Pušaitė;Saulutės;34324686486;Taip;0;2;4;6
8425;Pušaitė;Saulutės;88286687854;Taip;0;8;0;8
8426;Pušaitė;Saulutės;1302087452;Taip;15;5;0;20
8427;Pušaitė;Saulutės;12326544543;Taip;0;1;0;1
8428;Pušaitė;Saulutės;61624123734;Taip;0;1;0;1
8429;Pušaitė;Saulutės;10115195053;Taip;5;0;0;5
8430;Pušaitė;Saulutės;1389123203;Taip;0;5;0;5
8431;Pušaitė;Saulutės;2030939996;Taip;0;5;0;5
8432;Pušaitė;Zuikučiai;2115591523;Taip;4;0;1;5
8433;Pušaitė;Zuikučiai;8738827821;Taip;5;0;2;7
8434;Pušaitė;Zuikučiai;2181510181;Taip;0;5;0;5
8435;Pušaitė;Zuikučiai;7477429922;Taip;0;5;0;5
8436;Pušaitė;Zuikučiai;6306133416;Taip;0;4;0;4
8437;Pušaitė;Zuikučiai;2099169654;Taip;8;0;0;8
8438;Pušaitė;Zuikučiai;6355379926;Taip;7;0;1;8
8439;Pušaitė;Zuikučiai;9389544351;Taip;0;20;0;20
8440;Pušaitė;Zuikučiai;80743691769;Taip;6;0;0;6
8441;Pušaitė;Zuikučiai;1296700534;Taip;1;5;2;8
8442;Pušaitė;Zuikučiai;51500717235;Taip;0;20;0;20
8443;Pušaitė;Zuikučiai;2125574493;Taip;10;0;0;10
8444;Pušaitė;Zuikučiai;5398532705;Taip;0;7;2;9
8445;Pušaitė;Zuikučiai;8309000712;Taip;5;1;1;7
8446;Pušaitė;Zuikučiai;4881689337;Taip;11;0;5;16
8447;Pušaitė;Zuikučiai;3718196299;Taip;5;0;1;6
8448;Pušaitė;Zuikučiai;1295203136;Taip;0;6;4;10
8449;Pušaitė;Zuikučiai;6259961070;Taip;4;0;0;4
8450;Pušaitė;Zuikučiai;2944418714;Taip;4;0;1;5
8451;Pušaitė;Zuikučiai;3813761666;Taip;20;0;0;20
8452;Pušaitė;Zuikučiai;4762094720;Taip;3;5;3;11
8453;Pušaitė;Zuikučiai;6600314608;Taip;15;0;0;15
8454;Pušaitė;Vėžliukai;33935878843;Taip;0;20;0;20
8455;Pušaitė;Vėžliukai;82156965570;Taip;0;5;1;6
8456;Pušaitė;Vėžliukai;23761715185;Taip;0;6;0;6
8457;Pušaitė;Vėžliukai;64592128211;Ne;0;7;1;8
8458;Pušaitė;Vėžliukai;1556107106;Taip;0;0;3;3
8459;Pušaitė;Vėžliukai;82231263639;Taip;0;1;1;2
8460;Pušaitė;Vėžliukai;2841816118;Taip;0;5;3;8
8461;Pušaitė;Vėžliukai;26420369316;Taip;0;1;0;1
8462;Pušaitė;Vėžliukai;42099662246;Taip;15;2;0;17
8463;Pušaitė;Vėžliukai;18643269807;Taip;0;3;0;3
8464;Pušaitė;Vėžliukai;3633640722;Taip;5;0;0;5
8465;Pušaitė;Vėžliukai;15673961087;Taip;0;2;0;2
8466;Pušaitė;Vėžliukai;34495599676;Taip;8;0;1;9
8467;Pušaitė;Vėžliukai;57942390119;Taip;0;5;1;6
8468;Pušaitė;Vėžliukai;54773904854;Taip;10;0;0;10
8469;Pušaitė;Vėžliukai;24065238572;Ne;0;3;0;3
8470;Pušaitė;Vėžliukai;94185131317;Taip;5;5;0;10
8471;Pušaitė;Vėžliukai;49430231849;Taip;7;7;0;14
8472;Pušaitė;Vėžliukai;87253675662;Taip;10;3;0;13
8473;Pušaitė;Vėžliukai;85087765749;Taip;0;6;0;6
8474;Pušaitė;Vėžliukai;2452682364;Taip;0;2;0;2
8475;Pušaitė;Vėžliukai;7097481136;Taip;0;6;0;6
8476;Pušaitė;"Linksmieji nykštukai";78786009806;Taip;0;5;0;5
8477;Pušaitė;"Linksmieji nykštukai";44872108751;Taip;0;0;1;1
8478;Pušaitė;"Linksmieji nykštukai";8716642556;Taip;0;5;0;5
8479;Pušaitė;"Linksmieji nykštukai";64419428816;Taip;0;2;2;4
8480;Pušaitė;"Linksmieji nykštukai";60260690155;Taip;0;7;0;7
8481;Pušaitė;"Linksmieji nykštukai";97437734501;Taip;0;5;0;5
8482;Pušaitė;"Linksmieji nykštukai";34531949984;Taip;0;5;0;5
8483;Pušaitė;"Linksmieji nykštukai";1195830679;Taip;0;3;2;5
8484;Pušaitė;"Linksmieji nykštukai";31633196136;Taip;0;1;0;1
8485;Pušaitė;"Linksmieji nykštukai";49959888584;Taip;1;2;0;3
8486;Pušaitė;"Linksmieji nykštukai";43153897720;Taip;5;0;0;5
8487;Pušaitė;"Linksmieji nykštukai";35461910180;Taip;0;2;0;2
8488;Pušaitė;"Linksmieji nykštukai";2060782612;Taip;0;6;0;6
8489;Pušaitė;"Linksmieji nykštukai";7340376218;Taip;0;1;0;1
8490;Pušaitė;"Linksmieji nykštukai";1877125294;Taip;0;4;6;10
8491;Pušaitė;"Linksmieji nykštukai";7827620759;Taip;5;5;0;10
8492;Pušaitė;"Linksmieji nykštukai";3670887761;Taip;0;5;0;5
8493;Pušaitė;"Linksmieji nykštukai";1907401304;Taip;0;5;0;5
8494;Pušaitė;"Linksmieji nykštukai";2725492842;Taip;0;2;4;6
8495;Pušaitė;"Kačiukų trobelė";1822282723;Taip;7;0;0;7
8496;Pušaitė;"Kačiukų trobelė";1665866520;Taip;0;5;12;17
8497;Pušaitė;"Kačiukų trobelė";78247116817;Taip;0;0;4;4
8498;Pušaitė;"Kačiukų trobelė";16304995570;Taip;10;4;0;14
8499;Pušaitė;"Kačiukų trobelė";4007278281;Taip;6;5;2;13
8500;Pušaitė;"Kačiukų trobelė";48012145823;Taip;0;5;0;5
8501;Pušaitė;"Kačiukų trobelė";41913267562;Taip;0;5;2;7
8502;Pušaitė;"Kačiukų trobelė";94141517569;Taip;0;6;0;6
8503;Pušaitė;"Kačiukų trobelė";50194950518;Taip;0;6;0;6
8504;Pušaitė;"Kačiukų trobelė";39697900885;Taip;0;1;1;2
8505;Pušaitė;"Kačiukų trobelė";48452579219;Taip;5;0;0;5
8506;Pušaitė;"Kačiukų trobelė";37954589328;Taip;0;1;2;3
8507;Pušaitė;"Kačiukų trobelė";75933088658;Ne;10;3;0;13
8508;Pušaitė;"Kačiukų trobelė";96861089842;Taip;4;5;0;9
8509;Pušaitė;"Kačiukų trobelė";63041098317;Taip;0;7;0;7
8510;Pušaitė;"Kačiukų trobelė";1478137437;Ne;0;9;0;9
8511;Pušaitė;"Kačiukų trobelė";77239977929;Taip;5;0;0;5
8512;Pušaitė;"Kačiukų trobelė";9124124056;Taip;0;0;2;2
8513;Pušaitė;"Kačiukų trobelė";3996667689;Taip;0;2;3;5
8514;Pušaitė;"Kačiukų trobelė";7216538264;Taip;10;5;0;15
8515;Pušaitė;"Kačiukų trobelė";5534494766;Taip;0;20;0;20
8516;Pušaitė;"Kačiukų trobelė";5354874010;Taip;0;20;0;20
8517;Pušaitė;Ežiukai;3577616212;Taip;8;3;1;12
8518;Pušaitė;Ežiukai;2090143259;Taip;2;0;0;2
8519;Pušaitė;Ežiukai;2951618391;Taip;0;0;7;7
8520;Pušaitė;Ežiukai;7305350540;Taip;5;1;0;6
8521;Pušaitė;Ežiukai;1111143593;Taip;9;0;0;9
8522;Pušaitė;Ežiukai;5394378197;Taip;0;9;0;9
8523;Pušaitė;Ežiukai;15270671089;Taip;1;1;4;6
8524;Pušaitė;Ežiukai;69869396094;Taip;0;0;6;6
8525;Pušaitė;Ežiukai;1143122778;Taip;2;1;0;3
8526;Pušaitė;Ežiukai;9461292576;Taip;5;2;0;7
8527;Pušaitė;Ežiukai;5185787803;Taip;0;0;3;3
8528;Pušaitė;Ežiukai;4671293211;Taip;13;0;0;13
8529;Pušaitė;Ežiukai;4101326122;Taip;4;0;1;5
8530;Pušaitė;Ežiukai;8958364766;Taip;11;0;0;11
8531;Pušaitė;Ežiukai;2983890410;Taip;0;5;0;5
8532;Pušaitė;Ežiukai;7575143890;Taip;10;0;1;11
8533;Pušaitė;Ežiukai;7808186865;Taip;0;3;0;3
8534;Pušaitė;Ežiukai;4842783897;Taip;0;5;1;6
8535;Pušaitė;Ežiukai;5436168234;Taip;9;0;1;10
8536;Pušaitė;Ežiukai;6472169278;Taip;8;0;0;8
8537;Pušaitė;Ežiukai;8021494509;Taip;0;20;0;20
8538;Pušaitė;Ežiukai;2172342063;Taip;10;5;0;15
8539;Pušaitė;"Gudručių šalis";24768657107;Taip;0;9;2;11
8540;Pušaitė;"Gudručių šalis";55304000825;Taip;0;3;1;4
8541;Pušaitė;"Gudručių šalis";15550007793;Taip;0;5;0;5
8542;Pušaitė;"Gudručių šalis";4386242143;Taip;5;5;0;10
8543;Pušaitė;"Gudručių šalis";9997642887;Taip;5;2;3;10
8544;Pušaitė;"Gudručių šalis";15546035138;Taip;0;7;4;11
8545;Pušaitė;"Gudručių šalis";1275885492;Taip;0;7;1;8
8546;Pušaitė;"Gudručių šalis";40886746431;Taip;3;0;0;3
8547;Pušaitė;"Gudručių šalis";66025911973;Taip;0;12;0;12
8548;Pušaitė;"Gudručių šalis";90178990466;Taip;0;0;2;2
8549;Pušaitė;"Gudručių šalis";89985930634;Taip;10;4;0;14
8550;Pušaitė;"Gudručių šalis";4266368627;Ne;0;6;0;6
8551;Pušaitė;"Gudručių šalis";49973513385;Taip;0;7;0;7
8552;Pušaitė;"Gudručių šalis";89212112638;Taip;0;7;3;10
8553;Pušaitė;"Gudručių šalis";11297426946;Taip;6;2;0;8
8554;Pušaitė;"Gudručių šalis";67365323950;Taip;0;1;0;1
8555;Pušaitė;"Gudručių šalis";35947321028;Taip;0;20;0;20
8556;Pušaitė;"Gudručių šalis";1459628106;Taip;0;1;0;1
8557;Pušaitė;"Gudručių šalis";87504481892;Taip;5;0;0;5
8558;Pušaitė;"Gudručių šalis";6915619931;Taip;0;20;0;20
8559;Pušaitė;"Lapučių mokyklėlė";1108868901;Taip;0;20;0;20
8560;Pušaitė;"Lapučių mokyklėlė";1102988768;Taip;0;6;1;7
8561;Pušaitė;"Lapučių mokyklėlė";53211427399;Taip;0;0;2;2
8562;Pušaitė;"Lapučių mokyklėlė";40417586835;Taip;0;7;0;7
8563;Pušaitė;"Lapučių mokyklėlė";91960884985;Taip;4;2;3;9
8564;Pušaitė;"Lapučių mokyklėlė";60394388920;Taip;0;6;0;6
8565;Pušaitė;"Lapučių mokyklėlė";85343380637;Taip;0;4;0;4
8566;Pušaitė;"Lapučių mokyklėlė";2044213583;Taip;0;20;0;20
8567;Pušaitė;"Lapučių mokyklėlė";1394847204;Taip;14;0;0;14
8568;Pušaitė;"Lapučių mokyklėlė";97778827111;Taip;0;7;0;7
8569;Pušaitė;"Lapučių mokyklėlė";13127077816;Taip;0;5;0;5
8570;Pušaitė;"Lapučių mokyklėlė";21992678312;Taip;10;0;0;10
8571;Pušaitė;"Lapučių mokyklėlė";6667124375;Taip;0;5;0;5
8572;Pušaitė;"Lapučių mokyklėlė";71218084687;Taip;10;1;0;11
8573;Pušaitė;"Lapučių mokyklėlė";41026183089;Taip;8;6;0;14
8574;Pušaitė;"Lapučių mokyklėlė";77082825248;Taip;18;2;0;20
8575;Pušaitė;"Lapučių mokyklėlė";1487637695;Taip;0;5;0;5
8576;Pušaitė;"Lapučių mokyklėlė";53766202712;Taip;7;3;5;15
8577;Pušaitė;"Lapučių mokyklėlė";3231637165;Taip;0;0;3;3
8578;Pušaitė;"Lapučių mokyklėlė";6542917863;Taip;0;2;2;4
8579;Pušaitė;"VOVERIUKAI ";8438652029;Taip;4;0;3;7
8580;Pušaitė;"VOVERIUKAI ";4662871524;Taip;15;5;0;20
8581;Pušaitė;"VOVERIUKAI ";6323180798;Taip;8;1;0;9
8582;Pušaitė;"VOVERIUKAI ";5191894075;Taip;8;0;3;11
8583;Pušaitė;"VOVERIUKAI ";6180888008;Taip;0;0;2;2
8584;Pušaitė;"VOVERIUKAI ";9127444013;Taip;12;3;0;15
8585;Pušaitė;"VOVERIUKAI ";6578483902;Taip;5;5;1;11
8586;Pušaitė;"VOVERIUKAI ";3350461304;Taip;5;1;2;8
8587;Pušaitė;"VOVERIUKAI ";9313564235;Taip;10;3;0;13
8588;Pušaitė;"VOVERIUKAI ";1781601521;Taip;8;0;0;8
8589;Pušaitė;"VOVERIUKAI ";1024996364;Taip;0;20;0;20
8590;Pušaitė;"VOVERIUKAI ";4123080241;Taip;0;20;0;20
8591;Pušaitė;"VOVERIUKAI ";1161519408;Taip;0;20;0;20
8592;Pušaitė;"VOVERIUKAI ";8822285103;Taip;10;5;0;15
8593;Pušaitė;MEŠKUČIAI;7983115812;Taip;0;5;0;5
8594;Pušaitė;MEŠKUČIAI;3695016765;Taip;10;8;0;18
8595;Pušaitė;MEŠKUČIAI;3195191374;Taip;10;0;0;10
8596;Pušaitė;MEŠKUČIAI;5104111840;Taip;12;0;0;12
8597;Pušaitė;MEŠKUČIAI;8702361596;Taip;4;0;0;4
8598;Pušaitė;MEŠKUČIAI;1122112207;Taip;0;3;9;12
8599;Pušaitė;MEŠKUČIAI;1624587173;Taip;5;4;4;13
8600;Pušaitė;MEŠKUČIAI;5415680731;Taip;0;20;0;20
8601;Pušaitė;MEŠKUČIAI;7614475216;Taip;5;0;0;5
8602;Pušaitė;MEŠKUČIAI;3014180020;Taip;15;2;0;17
8603;Pušaitė;MEŠKUČIAI;9327636862;Taip;14;0;0;14
8604;Pušaitė;MEŠKUČIAI;4175909754;Taip;20;0;0;20
8605;Pušaitė;MEŠKUČIAI;1635528919;Taip;18;0;0;18
8606;Pušaitė;MEŠKUČIAI;3788392895;Taip;10;0;0;10
8607;Pušaitė;MEŠKUČIAI;2837439334;Taip;0;20;0;20
8608;Pušaitė;MEŠKUČIAI;7014914682;Taip;0;5;0;5
8609;Pušaitė;PELIUKAI;3130824742;Taip;5;0;0;5
8610;Pušaitė;PELIUKAI;9265357004;Taip;0;11;0;11
8611;Pušaitė;PELIUKAI;8793102437;Taip;5;6;0;11
8612;Pušaitė;PELIUKAI;3150144924;Taip;10;0;0;10
8613;Pušaitė;PELIUKAI;9390342572;Taip;16;0;0;16
8614;Pušaitė;PELIUKAI;9056933586;Taip;7;5;1;13
8615;Pušaitė;PELIUKAI;4517181474;Taip;4;6;0;10
8616;Pušaitė;PELIUKAI;9033615485;Taip;9;1;0;10
8617;Pušaitė;PELIUKAI;4605161267;Taip;20;0;0;20
8618;Pušaitė;PELIUKAI;7520393710;Taip;0;0;5;5
8619;Pušaitė;PELIUKAI;4374232593;Taip;0;3;1;4
8620;Pušaitė;PELIUKAI;6160825713;Taip;2;6;0;8
8621;Pušaitė;PELIUKAI;7898355721;Taip;5;3;2;10
8622;Pušaitė;PELIUKAI;3698808100;Taip;5;0;0;5
8623;Pušynėlis;PUMPURĖLIAI;2048377076;Taip;5;0;1;6
8624;Pušynėlis;PUMPURĖLIAI;23816147491;Taip;0;6;0;6
8625;Pušynėlis;PUMPURĖLIAI;9665845150;Taip;9;4;0;13
8626;Pušynėlis;PUMPURĖLIAI;1817179601;Taip;0;12;0;12
8627;Pušynėlis;PUMPURĖLIAI;9466109315;Taip;0;4;3;7
8628;Pušynėlis;PUMPURĖLIAI;9192206804;Taip;9;0;0;9
8629;Pušynėlis;PUMPURĖLIAI;76597184985;Taip;4;0;0;4
8630;Pušynėlis;PUMPURĖLIAI;1573574250;Taip;0;6;0;6
8631;Pušynėlis;PUMPURĖLIAI;9039274775;Taip;15;0;0;15
8632;Pušynėlis;PUMPURĖLIAI;2012089695;Taip;5;0;0;5
8633;Pušynėlis;PUMPURĖLIAI;6077698697;Taip;0;10;1;11
8634;Pušynėlis;PUMPURĖLIAI;25261143142;Taip;0;1;0;1
8635;Pušynėlis;PUMPURĖLIAI;35538053975;Taip;9;2;0;11
8636;Pušynėlis;PUMPURĖLIAI;3510202379;Taip;9;0;1;10
8637;Pušynėlis;PUMPURĖLIAI;9154108688;Taip;12;0;0;12
8638;Pušynėlis;PUMPURĖLIAI;7046421581;Taip;3;0;2;5
8639;Pušynėlis;PUMPURĖLIAI;3037031809;Taip;4;0;1;5
8640;Pušynėlis;PUMPURĖLIAI;6716726918;Taip;10;4;0;14
8641;Pušynėlis;SAULUTĖS;1415916851;Taip;8;5;0;13
8642;Pušynėlis;SAULUTĖS;93484950406;Taip;0;0;16;16
8643;Pušynėlis;SAULUTĖS;91759717760;Taip;0;17;0;17
8644;Pušynėlis;SAULUTĖS;15555681471;Taip;0;5;4;9
8645;Pušynėlis;SAULUTĖS;51866074822;Taip;0;9;2;11
8646;Pušynėlis;SAULUTĖS;2431940444;Taip;0;14;0;14
8647;Pušynėlis;SAULUTĖS;58252435610;Taip;0;0;2;2
8648;Pušynėlis;SAULUTĖS;75716791245;Taip;5;1;0;6
8649;Pušynėlis;SAULUTĖS;40478713455;Taip;0;0;3;3
8650;Pušynėlis;SAULUTĖS;1253953853;Ne;0;4;0;4
8651;Pušynėlis;SAULUTĖS;39796631884;Taip;0;17;0;17
8652;Pušynėlis;SAULUTĖS;48050606382;Taip;0;2;0;2
8653;Pušynėlis;SAULUTĖS;79386112020;Taip;2;2;3;7
8654;Pušynėlis;SAULUTĖS;2042833795;Taip;0;2;0;2
8655;Pušynėlis;SAULUTĖS;74952593070;Taip;4;2;0;6
8656;Pušynėlis;SAULUTĖS;1610449906;Taip;0;5;4;9
8657;Pušynėlis;SAULUTĖS;8920359311;Taip;0;11;0;11
8658;Pušynėlis;SAULUTĖS;51835639636;Taip;0;6;0;6
8659;Pušynėlis;SAULUTĖS;32714964224;Taip;0;11;0;11
8660;Pušynėlis;SAULUTĖS;1863758087;Taip;5;1;0;6
8661;Pušynėlis;PRIEŠMOKYKLINĖ;45205911818;Taip;0;5;0;5
8662;Pušynėlis;PRIEŠMOKYKLINĖ;62127095103;Taip;0;5;0;5
8663;Pušynėlis;PRIEŠMOKYKLINĖ;72180767422;Taip;0;1;0;1
8664;Pušynėlis;PRIEŠMOKYKLINĖ;80673105992;Ne;0;10;0;10
8665;Pušynėlis;PRIEŠMOKYKLINĖ;1148988140;Taip;12;0;0;12
8666;Pušynėlis;PRIEŠMOKYKLINĖ;34354697329;Ne;0;5;2;7
8667;Pušynėlis;PRIEŠMOKYKLINĖ;6823339260;Taip;0;8;0;8
8668;Pušynėlis;PRIEŠMOKYKLINĖ;45123764353;Taip;0;10;0;10
8669;Pušynėlis;PRIEŠMOKYKLINĖ;23088088585;Taip;0;5;0;5
8670;Pušynėlis;PRIEŠMOKYKLINĖ;81276442183;Taip;0;5;10;15
8671;Pušynėlis;PRIEŠMOKYKLINĖ;53367560890;Taip;0;4;0;4
8672;Pušynėlis;PRIEŠMOKYKLINĖ;6577939120;Taip;0;5;0;5
8673;Pušynėlis;PRIEŠMOKYKLINĖ;21260292631;Taip;0;10;1;11
8674;Pušynėlis;PRIEŠMOKYKLINĖ;75612576422;Taip;0;2;0;2
8675;Pušynėlis;PRIEŠMOKYKLINĖ;24035278105;Taip;0;5;1;6
8676;Pušynėlis;PRIEŠMOKYKLINĖ;68201469907;Taip;0;1;0;1
8677;Pušynėlis;PRIEŠMOKYKLINĖ;61363661998;Taip;0;5;0;5
8678;Pušynėlis;PRIEŠMOKYKLINĖ;21082691040;Taip;0;1;0;1
8679;Pušynėlis;PRIEŠMOKYKLINĖ;97100141866;Taip;0;7;0;7
8680;Pušynėlis;PRIEŠMOKYKLINĖ;80287782066;Taip;0;1;0;1
8681;Pušynėlis;PRIEŠMOKYKLINĖ;1224747660;Taip;0;11;0;11
8682;Pušynėlis;PRIEŠMOKYKLINĖ;1071102465;Taip;0;5;0;5
8683;Pušynėlis;LOPŠELIS;2141785580;Taip;6;9;0;15
8684;Pušynėlis;LOPŠELIS;2508640229;Taip;5;0;0;5
8685;Pušynėlis;LOPŠELIS;2793982816;Taip;0;0;6;6
8686;Pušynėlis;LOPŠELIS;1034336110;Taip;0;0;2;2
8687;Pušynėlis;LOPŠELIS;1610132076;Taip;0;20;0;20
8688;Pušynėlis;LOPŠELIS;1164201286;Taip;0;1;0;1
8689;Pušynėlis;LOPŠELIS;4920818548;Taip;0;4;16;20
8690;Pušynėlis;LOPŠELIS;5236219294;Taip;0;0;14;14
8691;Pušynėlis;LOPŠELIS;6709692748;Taip;0;7;0;7
8692;Pušynėlis;LOPŠELIS;8799095053;Taip;0;6;0;6
8693;Pušynėlis;LOPŠELIS;5318223378;Taip;11;0;2;13
8694;Pušynėlis;LOPŠELIS;4052132379;Taip;0;0;5;5
8695;Pušynėlis;LOPŠELIS;5897839636;Taip;0;14;0;14
8696;Raktelis;LAŠIUKAI;91578547534;Taip;0;4;0;4
8697;Raktelis;LAŠIUKAI;84902670203;Taip;0;5;0;5
8698;Raktelis;LAŠIUKAI;54911112924;Taip;7;3;0;10
8699;Raktelis;LAŠIUKAI;58035524929;Taip;7;8;0;15
8700;Raktelis;LAŠIUKAI;44697037907;Ne;20;0;0;20
8701;Raktelis;LAŠIUKAI;44404187711;Taip;0;7;0;7
8702;Raktelis;LAŠIUKAI;4050296775;Taip;0;4;0;4
8703;Raktelis;LAŠIUKAI;2586639003;Ne;0;9;2;11
8704;Raktelis;LAŠIUKAI;88421097745;Taip;0;6;0;6
8705;Raktelis;LAŠIUKAI;11398845304;Taip;5;0;0;5
8706;Raktelis;LAŠIUKAI;83327989096;Taip;5;8;0;13
8707;Raktelis;LAŠIUKAI;43111419596;Taip;0;6;0;6
8708;Raktelis;LAŠIUKAI;74848273145;Taip;0;5;0;5
8709;Raktelis;LAŠIUKAI;61588160544;Taip;0;6;0;6
8710;Raktelis;LAŠIUKAI;10029133549;Ne;10;5;0;15
8711;Raktelis;LAŠIUKAI;59965096201;Taip;6;6;0;12
8712;Raktelis;LAŠIUKAI;81622959801;Taip;10;0;0;10
8713;Raktelis;LAŠIUKAI;7486620978;Taip;0;8;0;8
8714;Raktelis;LAŠIUKAI;1090555980;Taip;0;4;0;4
8715;Raktelis;LAŠIUKAI;6358826871;Taip;9;5;0;14
8716;Raktelis;LAŠIUKAI;88714718433;Taip;10;5;0;15
8717;Raktelis;LAŠIUKAI;8495930552;Taip;0;8;0;8
8718;Raktelis;LAŠIUKAI;1508479097;Taip;4;8;0;12
8719;Raktelis;LAŠIUKAI;13722490194;Taip;0;7;0;7
8720;Raktelis;BITUTĖS;61636842808;Taip;0;5;0;5
8721;Raktelis;BITUTĖS;49216690763;Taip;0;5;3;8
8722;Raktelis;BITUTĖS;68578915107;Taip;0;6;0;6
8723;Raktelis;BITUTĖS;38068336379;Taip;0;2;2;4
8724;Raktelis;BITUTĖS;67716590566;Taip;0;4;0;4
8725;Raktelis;BITUTĖS;77068762851;Taip;0;4;4;8
8726;Raktelis;BITUTĖS;83366206408;Taip;0;1;0;1
8727;Raktelis;BITUTĖS;86120193313;Taip;0;6;1;7
8728;Raktelis;BITUTĖS;1224477393;Ne;0;2;0;2
8729;Raktelis;BITUTĖS;69445577844;Taip;0;4;0;4
8730;Raktelis;BITUTĖS;93797285418;Taip;0;5;0;5
8731;Raktelis;BITUTĖS;60619347523;Taip;20;0;0;20
8732;Raktelis;BITUTĖS;71909273139;Taip;4;10;1;15
8733;Raktelis;BITUTĖS;37587869107;Taip;7;7;0;14
8734;Raktelis;BITUTĖS;1544882634;Taip;0;5;0;5
8735;Raktelis;BITUTĖS;63051817818;Taip;0;7;0;7
8736;Raktelis;BITUTĖS;78841101231;Taip;1;5;0;6
8737;Raktelis;BITUTĖS;76758476679;Taip;10;0;0;10
8738;Raktelis;BITUTĖS;5663304735;Ne;5;3;0;8
8739;Raktelis;BITUTĖS;17270742947;Taip;0;13;0;13
8740;Raktelis;BITUTĖS;5392514118;Taip;5;7;3;15
8741;Raktelis;BITUTĖS;7048022562;Taip;5;6;0;11
8742;Raktelis;BITUTĖS;9774706725;Taip;1;7;0;8
8743;Raktelis;BITUTĖS;1455550617;Taip;0;3;7;10
8744;Raktelis;BORUŽĖLĖS;8117871963;Taip;0;5;8;13
8745;Raktelis;BORUŽĖLĖS;5031703240;Taip;5;7;0;12
8746;Raktelis;BORUŽĖLĖS;95104355224;Taip;16;0;0;16
8747;Raktelis;BORUŽĖLĖS;6049420030;Ne;14;0;0;14
8748;Raktelis;BORUŽĖLĖS;9313156299;Taip;11;3;0;14
8749;Raktelis;BORUŽĖLĖS;54221331553;Taip;1;7;0;8
8750;Raktelis;BORUŽĖLĖS;2070196225;Taip;20;0;0;20
8751;Raktelis;BORUŽĖLĖS;2303286473;Taip;10;0;0;10
8752;Raktelis;BORUŽĖLĖS;1192775994;Taip;3;3;0;6
8753;Raktelis;BORUŽĖLĖS;3609939325;Taip;0;0;1;1
8754;Raktelis;BORUŽĖLĖS;8374755632;Taip;16;0;0;16
8755;Raktelis;BORUŽĖLĖS;3345708690;Taip;5;2;0;7
8756;Raktelis;BORUŽĖLĖS;8245310502;Taip;20;0;0;20
8757;Raktelis;BORUŽĖLĖS;7487507324;Taip;4;2;0;6
8758;Raktelis;BORUŽĖLĖS;93271260871;Taip;6;8;0;14
8759;Raktelis;BORUŽĖLĖS;6779413882;Taip;0;1;0;1
8760;Raktelis;BORUŽĖLĖS;9584164290;Taip;20;0;0;20
8761;Raktelis;BORUŽĖLĖS;2055530718;Taip;10;1;0;11
8762;Raktelis;BORUŽĖLĖS;8410301417;Taip;0;2;0;2
8763;Raktelis;BORUŽĖLĖS;6854111162;Taip;8;4;0;12
8764;Raktelis;BORUŽĖLĖS;5818899732;Taip;5;0;0;5
8765;Raktelis;BORUŽĖLĖS;9348898875;Taip;5;2;0;7
8766;Raktelis;BORUŽĖLĖS;9053427316;Taip;7;0;0;7
8767;Raktelis;BORUŽĖLĖS;3762141936;Taip;20;0;0;20
8768;Raktelis;BORUŽĖLĖS;3713386556;Taip;5;12;0;17
8769;Raktelis;KAČIUKAI;8579864696;Taip;5;1;4;10
8770;Raktelis;KAČIUKAI;1393351147;Taip;4;5;0;9
8771;Raktelis;KAČIUKAI;27084497916;Taip;1;5;0;6
8772;Raktelis;KAČIUKAI;1063413424;Ne;0;11;2;13
8773;Raktelis;KAČIUKAI;4449411816;Taip;1;5;0;6
8774;Raktelis;KAČIUKAI;89139880068;Taip;5;6;0;11
8775;Raktelis;KAČIUKAI;1623046697;Taip;10;0;0;10
8776;Raktelis;KAČIUKAI;1468915955;Taip;0;2;0;2
8777;Raktelis;KAČIUKAI;87211875672;Taip;0;6;0;6
8778;Raktelis;KAČIUKAI;21063882404;Taip;8;5;0;13
8779;Raktelis;KAČIUKAI;78145437124;Taip;5;9;0;14
8780;Raktelis;KAČIUKAI;2143998936;Taip;0;11;0;11
8781;Raktelis;KAČIUKAI;4906678347;Taip;5;2;1;8
8782;Raktelis;KAČIUKAI;1567546511;Taip;15;5;0;20
8783;Raktelis;KAČIUKAI;86883305675;Taip;5;5;0;10
8784;Raktelis;KAČIUKAI;9380332489;Taip;0;6;0;6
8785;Raktelis;KAČIUKAI;26727657814;Taip;0;1;0;1
8786;Raktelis;KAČIUKAI;30092089456;Taip;10;5;0;15
8787;Raktelis;KAČIUKAI;50372098009;Taip;0;12;0;12
8788;Raktelis;KAČIUKAI;1378192491;Taip;0;7;0;7
8789;Raktelis;KAČIUKAI;3180109604;Taip;7;0;0;7
8790;Raktelis;KAČIUKAI;1046075234;Taip;0;4;0;4
8791;Raktelis;KAČIUKAI;1457880868;Taip;17;0;0;17
8792;Raktelis;KAČIUKAI;4071338645;Taip;10;6;0;16
8793;Raktelis;KIŠKUČIAI;7170546710;Taip;15;2;0;17
8794;Raktelis;KIŠKUČIAI;6014726741;Taip;6;1;0;7
8795;Raktelis;KIŠKUČIAI;4905982507;Taip;0;6;4;10
8796;Raktelis;KIŠKUČIAI;6367875352;Taip;0;9;0;9
8797;Raktelis;KIŠKUČIAI;6877934219;Taip;16;0;0;16
8798;Raktelis;KIŠKUČIAI;1975411457;Taip;8;0;1;9
8799;Raktelis;KIŠKUČIAI;3661917922;Taip;4;0;0;4
8800;Raktelis;KIŠKUČIAI;6199212999;Taip;5;4;0;9
8801;Raktelis;KIŠKUČIAI;2499890317;Taip;9;6;0;15
8802;Raktelis;KIŠKUČIAI;1843086151;Taip;12;0;0;12
8803;Raktelis;KIŠKUČIAI;1622504968;Taip;7;0;0;7
8804;Raktelis;KIŠKUČIAI;5405322552;Taip;16;0;0;16
8805;Raktelis;KIŠKUČIAI;6281687751;Taip;0;10;0;10
8806;Raktelis;KIŠKUČIAI;6550851582;Taip;5;10;0;15
8807;Raktelis;KIŠKUČIAI;7334310944;Taip;0;2;0;2
8808;Raktelis;KIŠKUČIAI;5492437864;Taip;5;3;0;8
8809;Raktelis;KIŠKUČIAI;9779789133;Taip;0;12;0;12
8810;Raktelis;KIŠKUČIAI;6102196040;Taip;0;12;0;12
8811;Raktelis;NYKŠTUKAI;5627179884;Taip;7;5;0;12
8812;Raktelis;NYKŠTUKAI;6608224825;Taip;10;0;4;14
8813;Raktelis;NYKŠTUKAI;9210856228;Taip;2;5;4;11
8814;Raktelis;NYKŠTUKAI;8873203690;Taip;5;7;4;16
8815;Raktelis;NYKŠTUKAI;8559758812;Taip;10;5;0;15
8816;Raktelis;NYKŠTUKAI;2219712757;Taip;3;1;0;4
8817;Raktelis;NYKŠTUKAI;8456082594;Taip;7;5;5;17
8818;Raktelis;NYKŠTUKAI;2807100092;Taip;7;5;0;12
8819;Raktelis;NYKŠTUKAI;5218387088;Taip;10;10;0;20
8820;Raktelis;NYKŠTUKAI;2753402906;Taip;12;0;0;12
8821;Raktelis;NYKŠTUKAI;9591285702;Taip;16;0;0;16
8822;Raktelis;NYKŠTUKAI;5925441742;Taip;5;5;0;10
8823;Raktelis;NYKŠTUKAI;6929358401;Taip;8;3;0;11
8824;Raktelis;NYKŠTUKAI;9593639791;Taip;11;5;0;16
8825;Raktelis;NYKŠTUKAI;4658530212;Taip;15;5;0;20
8826;Raktelis;NYKŠTUKAI;9357757604;Taip;0;2;2;4
8827;Raktelis;NYKŠTUKAI;4335378625;Taip;1;2;0;3
8828;Raktelis;NYKŠTUKAI;7973137015;Taip;11;5;0;16
8829;Raktelis;NYKŠTUKAI;7265543701;Taip;14;5;0;19
8830;Raktelis;NYKŠTUKAI;1392036584;Taip;0;1;0;1
8831;Raktelis;NYKŠTUKAI;8459980712;Taip;11;1;0;12
8832;Raktelis;PELIUKAI;5595087767;Taip;8;0;0;8
8833;Raktelis;PELIUKAI;4610536784;Taip;9;1;0;10
8834;Raktelis;PELIUKAI;3423529085;Taip;6;5;0;11
8835;Raktelis;PELIUKAI;1109105359;Taip;5;3;0;8
8836;Raktelis;PELIUKAI;8320696048;Taip;8;0;0;8
8837;Raktelis;PELIUKAI;1453677708;Taip;5;2;0;7
8838;Raktelis;PELIUKAI;3880578523;Taip;5;5;0;10
8839;Raktelis;PELIUKAI;5768653399;Taip;20;0;0;20
8840;Raktelis;PELIUKAI;4583377785;Taip;12;1;0;13
8841;Raktelis;PELIUKAI;9072312203;Taip;5;0;0;5
8842;Raktelis;PELIUKAI;6385127914;Taip;10;4;0;14
8843;Raktelis;PELIUKAI;3884068578;Taip;5;5;0;10
8844;Raktelis;PELIUKAI;1322912585;Taip;0;10;0;10
8845;Raktelis;PELIUKAI;4228614834;Taip;5;2;0;7
8846;Raktelis;PELIUKAI;4755892641;Taip;9;2;0;11
8847;Raktelis;PELIUKAI;8353427144;Taip;5;11;0;16
8848;Raktelis;PELIUKAI;5082785025;Taip;16;0;1;17
8849;Raktelis;PELIUKAI;7869495911;Taip;15;0;0;15
8850;Raktelis;PELIUKAI;9130613710;Taip;7;6;0;13
8851;Raktelis;PELIUKAI;2282754345;Taip;10;1;0;11
8852;Raktelis;PELIUKAI;8869030487;Taip;20;0;0;20
8853;Raktelis;PELIUKAI;4167194960;Taip;17;0;0;17
8854;Raktelis;AGUONOS;1453259901;Taip;10;0;3;13
8855;Raktelis;AGUONOS;66327590524;Taip;0;6;0;6
8856;Raktelis;AGUONOS;6935703343;Taip;0;7;1;8
8857;Raktelis;AGUONOS;54361317676;Taip;0;11;0;11
8858;Raktelis;AGUONOS;5430563880;Taip;5;4;0;9
8859;Raktelis;AGUONOS;25504804011;Taip;0;8;0;8
8860;Raktelis;AGUONOS;12333424396;Taip;8;5;0;13
8861;Raktelis;AGUONOS;30483797110;Taip;6;5;0;11
8862;Raktelis;AGUONOS;61367764807;Taip;0;0;3;3
8863;Raktelis;AGUONOS;24160611392;Taip;10;7;0;17
8864;Raktelis;AGUONOS;55504358470;Taip;0;8;0;8
8865;Raktelis;AGUONOS;34960672068;Taip;0;5;0;5
8866;Raktelis;AGUONOS;82549894936;Taip;0;16;0;16
8867;Raktelis;AGUONOS;874585350;Taip;10;5;0;15
8868;Raktelis;AGUONOS;79301972646;Taip;14;5;0;19
8869;Raktelis;AGUONOS;24323703041;Taip;11;1;0;12
8870;Raktelis;AGUONOS;8796557675;Taip;16;0;0;16
8871;Raktelis;AGUONOS;1820583792;Taip;16;0;0;16
8872;Raktelis;AGUONOS;5711863758;Taip;6;0;5;11
8873;Raktelis;AGUONOS;1747834520;Taip;10;5;1;16
8874;Raktelis;AGUONOS;5000264125;Taip;9;4;0;13
8875;Raktelis;AGUONOS;53034039807;Taip;6;0;1;7
8876;Raktelis;AGUONOS;5802689482;Taip;11;3;0;14
8877;Raktelis;LAPIUKŲ;8996622650;Taip;0;6;0;6
8878;Raktelis;LAPIUKŲ;51237034253;Taip;0;8;0;8
8879;Raktelis;LAPIUKŲ;1326855282;Taip;11;0;0;11
8880;Raktelis;LAPIUKŲ;92373834478;Ne;0;8;0;8
8881;Raktelis;LAPIUKŲ;68570148753;Taip;0;11;0;11
8882;Raktelis;LAPIUKŲ;53270411090;Ne;0;1;0;1
8883;Raktelis;LAPIUKŲ;27403835292;Taip;0;6;0;6
8884;Raktelis;LAPIUKŲ;10188975432;Taip;6;1;0;7
8885;Raktelis;LAPIUKŲ;14234831040;Taip;0;3;0;3
8886;Raktelis;LAPIUKŲ;25141529581;Taip;5;0;2;7
8887;Raktelis;LAPIUKŲ;43500434912;Taip;0;7;0;7
8888;Raktelis;LAPIUKŲ;9501202273;Taip;15;1;0;16
8889;Raktelis;LAPIUKŲ;98616285680;Taip;5;5;0;10
8890;Raktelis;LAPIUKŲ;54341630847;Taip;8;1;0;9
8891;Raktelis;LAPIUKŲ;1197826066;Taip;5;2;0;7
8892;Raktelis;LAPIUKŲ;5943583254;Taip;0;2;0;2
8893;Raktelis;LAPIUKŲ;4569798381;Taip;20;0;0;20
8894;Raktelis;LAPIUKŲ;1819514057;Ne;4;6;0;10
8895;Raktelis;LAPIUKŲ;67304194087;Taip;10;5;0;15
8896;Raktelis;LAPIUKŲ;15583558585;Taip;20;0;0;20
8897;Raktelis;PELĖDŽIUKAI;2985254060;Taip;5;0;0;5
8898;Raktelis;PELĖDŽIUKAI;59913848400;Taip;0;10;0;10
8899;Raktelis;PELĖDŽIUKAI;73426072972;Taip;5;2;0;7
8900;Raktelis;PELĖDŽIUKAI;23688235312;Taip;0;2;0;2
8901;Raktelis;PELĖDŽIUKAI;68390568000;Taip;10;1;0;11
8902;Raktelis;PELĖDŽIUKAI;61890775725;Taip;0;1;0;1
8903;Raktelis;PELĖDŽIUKAI;26764160130;Taip;7;1;1;9
8904;Raktelis;PELĖDŽIUKAI;58513885211;Taip;0;5;0;5
8905;Raktelis;PELĖDŽIUKAI;79109699217;Taip;5;2;0;7
8906;Raktelis;PELĖDŽIUKAI;11937575740;Taip;8;5;0;13
8907;Raktelis;PELĖDŽIUKAI;34216516886;Taip;5;0;0;5
8908;Raktelis;PELĖDŽIUKAI;15685936471;Taip;0;6;1;7
8909;Raktelis;PELĖDŽIUKAI;24221829774;Taip;0;6;0;6
8910;Raktelis;PELĖDŽIUKAI;57958699478;Taip;0;6;0;6
8911;Raktelis;PELĖDŽIUKAI;46587243900;Taip;10;5;0;15
8912;Raktelis;PELĖDŽIUKAI;18646642032;Taip;5;2;0;7
8913;Raktelis;PELĖDŽIUKAI;5914986262;Taip;5;5;1;11
8914;Raktelis;PELĖDŽIUKAI;48454225305;Taip;10;4;0;14
8915;Raktelis;PELĖDŽIUKAI;32913698258;Taip;5;5;1;11
8916;Raktelis;PELĖDŽIUKAI;67378900057;Ne;0;1;0;1
8917;Raktelis;PELĖDŽIUKAI;40006848965;Taip;0;5;0;5
8918;Raktelis;PELĖDŽIUKAI;38001876942;Taip;0;7;0;7
8919;Raktelis;PELĖDŽIUKAI;67756822733;Taip;0;7;0;7
8920;Raktelis;PELĖDŽIUKAI;82492627;Taip;0;5;0;5
8921;Rasa;Nykštukai;1846631921;Taip;12;2;0;14
8922;Rasa;Nykštukai;72152762554;Taip;9;1;0;10
8923;Rasa;Nykštukai;59695217278;Taip;0;5;0;5
8924;Rasa;Nykštukai;86870992605;Taip;3;6;1;10
8925;Rasa;Nykštukai;32724807082;Taip;0;10;0;10
8926;Rasa;Nykštukai;36336738780;Taip;0;2;0;2
8927;Rasa;Nykštukai;69640669835;Taip;7;2;0;9
8928;Rasa;Nykštukai;68980971096;Taip;7;0;0;7
8929;Rasa;Nykštukai;36874827315;Taip;19;0;0;19
8930;Rasa;Nykštukai;87310376118;Taip;18;0;0;18
8931;Rasa;Nykštukai;1067614202;Taip;0;14;0;14
8932;Rasa;Nykštukai;99521832856;Taip;0;10;0;10
8933;Rasa;Nykštukai;59127440556;Taip;0;6;0;6
8934;Rasa;Nykštukai;95625598016;Taip;3;5;0;8
8935;Rasa;Nykštukai;29141190550;Taip;4;6;0;10
8936;Rasa;Nykštukai;1549153022;Taip;4;0;0;4
8937;Rasa;Nykštukai;96518910021;Taip;11;1;0;12
8938;Rasa;"Širdelė mergaičių estetinio lavinimo grupė";2133989183;Taip;6;1;0;7
8939;Rasa;"Širdelė mergaičių estetinio lavinimo grupė";91941960564;Taip;0;4;1;5
8940;Rasa;"Širdelė mergaičių estetinio lavinimo grupė";1883458628;Taip;0;6;0;6
8941;Rasa;"Širdelė mergaičių estetinio lavinimo grupė";1339376048;Taip;10;0;5;15
8942;Rasa;"Širdelė mergaičių estetinio lavinimo grupė";33479419656;Taip;0;11;0;11
8943;Rasa;"Širdelė mergaičių estetinio lavinimo grupė";3281315532;Taip;0;6;0;6
8944;Rasa;"Širdelė mergaičių estetinio lavinimo grupė";58858081077;Taip;0;17;0;17
8945;Rasa;"Širdelė mergaičių estetinio lavinimo grupė";56168039878;Taip;5;4;0;9
8946;Rasa;"Širdelė mergaičių estetinio lavinimo grupė";4601657045;Taip;0;9;0;9
8947;Rasa;"Širdelė mergaičių estetinio lavinimo grupė";2626361958;Taip;0;1;0;1
8948;Rasa;"Širdelė mergaičių estetinio lavinimo grupė";8866896989;Taip;0;17;0;17
8949;Rasa;"Širdelė mergaičių estetinio lavinimo grupė";13135367451;Taip;9;5;1;15
8950;Rasa;"Širdelė mergaičių estetinio lavinimo grupė";9648034081;Taip;5;1;0;6
8951;Rasa;"Širdelė mergaičių estetinio lavinimo grupė";5599182715;Taip;0;12;0;12
8952;Rasa;"Širdelė mergaičių estetinio lavinimo grupė";9938280570;Taip;0;9;0;9
8953;Rasa;"Širdelė mergaičių estetinio lavinimo grupė";91931863004;Taip;13;4;1;18
8954;Rasa;"Širdelė mergaičių estetinio lavinimo grupė";2132535297;Taip;1;5;0;6
8955;Rasa;"Širdelė mergaičių estetinio lavinimo grupė";23600769349;Taip;0;5;0;5
8956;Rasa;Meškiukai;8278928396;Taip;0;5;3;8
8957;Rasa;Meškiukai;8052120247;Taip;0;0;2;2
8958;Rasa;Meškiukai;1013865195;Taip;0;9;0;9
8959;Rasa;Meškiukai;2110008545;Taip;5;0;0;5
8960;Rasa;Meškiukai;72772661373;Taip;6;0;0;6
8961;Rasa;Meškiukai;63673920646;Taip;5;0;0;5
8962;Rasa;Meškiukai;4485715299;Taip;5;2;0;7
8963;Rasa;Meškiukai;52913880917;Taip;0;9;0;9
8964;Rasa;Meškiukai;6734478649;Taip;0;5;2;7
8965;Rasa;Meškiukai;5932187584;Taip;5;0;0;5
8966;Rasa;Meškiukai;5145978804;Taip;20;5;0;25
8967;Rasa;Meškiukai;8438563545;Taip;5;0;4;9
8968;Rasa;Meškiukai;6356448094;Taip;0;0;25;25
8969;Rasa;Meškiukai;2683897055;Taip;12;5;0;17
8970;Rasa;Meškiukai;4790859112;Taip;5;0;2;7
8971;Rasa;Meškiukai;7534548604;Taip;9;0;5;14
8972;Rasa;Meškiukai;5606722133;Taip;0;5;0;5
8973;Rasa;Meškiukai;7565880116;Taip;0;0;13;13
8974;Rasa;Meškiukai;7544963724;Taip;5;7;0;12
8975;Rasa;Meškiukai;3567565920;Taip;10;0;1;11
8976;Rasa;Sauliukai;68458114162;Taip;5;0;0;5
8977;Rasa;Sauliukai;42792180843;Taip;5;6;0;11
8978;Rasa;Sauliukai;34022508928;Taip;5;6;0;11
8979;Rasa;Sauliukai;12635625072;Taip;0;21;0;21
8980;Rasa;Sauliukai;18715553061;Taip;0;11;0;11
8981;Rasa;Sauliukai;30725310352;Taip;0;5;0;5
8982;Rasa;Sauliukai;37957299639;Taip;5;0;0;5
8983;Rasa;Sauliukai;2095297719;Taip;7;5;0;12
8984;Rasa;Sauliukai;84260038900;Taip;0;7;0;7
8985;Rasa;Sauliukai;8781212539;Taip;5;3;3;11
8986;Rasa;Sauliukai;92593352340;Taip;0;13;0;13
8987;Rasa;Sauliukai;41438771469;Taip;0;3;0;3
8988;Rasa;Sauliukai;2452794792;Taip;0;5;15;20
8989;Rasa;Sauliukai;79283195492;Taip;5;5;0;10
8990;Rasa;Sauliukai;51362685893;Taip;0;11;0;11
8991;Rasa;Sauliukai;9148315088;Taip;0;17;0;17
8992;Rasa;Sauliukai;89783044220;Taip;0;5;1;6
8993;Rasa;Sauliukai;69984722099;Taip;5;13;0;18
8994;Rasa;Sauliukai;1717387929;Taip;0;2;0;2
8995;Rasa;Sauliukai;35226191822;Taip;1;13;0;14
8996;Rasa;Smalsučiai;38570340276;Ne;0;2;0;2
8997;Rasa;Smalsučiai;1614333465;Taip;5;5;1;11
8998;Rasa;Smalsučiai;62152088598;Taip;0;5;0;5
8999;Rasa;Smalsučiai;47160008402;Taip;0;4;5;9
9000;Rasa;Smalsučiai;1860228984;Taip;0;4;2;6
9001;Rasa;Smalsučiai;61191043836;Taip;0;6;0;6
9002;Rasa;Smalsučiai;67603435279;Taip;0;5;7;12
9003;Rasa;Smalsučiai;18169786070;Taip;0;5;2;7
9004;Rasa;Smalsučiai;7873461118;Taip;0;5;1;6
9005;Rasa;Smalsučiai;2123727085;Taip;0;17;3;20
9006;Rasa;Smalsučiai;1011880741;Taip;0;5;1;6
9007;Rasa;Smalsučiai;1908234170;Ne;0;2;0;2
9008;Rasa;Smalsučiai;38285343302;Taip;0;5;1;6
9009;Rasa;Smalsučiai;35934308248;Taip;0;2;3;5
9010;Rasa;Smalsučiai;2100861702;Taip;0;5;4;9
9011;Rasa;Smalsučiai;1348331466;Taip;0;5;1;6
9012;Rasa;Smalsučiai;33210203210;Taip;0;6;0;6
9013;Rasa;Smalsučiai;79908276669;Taip;0;5;0;5
9014;Rasa;Smalsučiai;2639024477;Taip;0;2;2;4
9015;Rasa;Smalsučiai;27981379045;Taip;0;9;0;9
9016;Rasa;"Pelėdžiukai ";77589878141;Taip;0;5;0;5
9017;Rasa;"Pelėdžiukai ";1658948426;Taip;2;2;0;4
9018;Rasa;"Pelėdžiukai ";1803769089;Taip;0;0;6;6
9019;Rasa;"Pelėdžiukai ";1311346161;Taip;5;6;3;14
9020;Rasa;"Pelėdžiukai ";1581241275;Taip;6;0;4;10
9021;Rasa;"Pelėdžiukai ";20587484061;Taip;0;0;2;2
9022;Rasa;"Pelėdžiukai ";1176606744;Taip;0;15;0;15
9023;Rasa;"Pelėdžiukai ";2121070882;Taip;0;0;10;10
9024;Rasa;"Pelėdžiukai ";1457384318;Taip;0;0;2;2
9025;Rasa;"Pelėdžiukai ";3884105235;Taip;5;5;5;15
9026;Rasa;"Pelėdžiukai ";1726266997;Taip;15;0;0;15
9027;Rasa;"Pelėdžiukai ";6704162447;Taip;6;0;0;6
9028;Rasa;"Pelėdžiukai ";7558966891;Taip;5;0;2;7
9029;Rasa;"Pelėdžiukai ";3063226692;Ne;5;7;0;12
9030;Rasa;"Pelėdžiukai ";6773004268;Taip;6;5;7;18
9031;Rasa;"Pelėdžiukai ";3023088027;Taip;0;5;0;5
9032;Rasa;"Pelėdžiukai ";8953448462;Taip;11;0;0;11
9033;Rasa;"Pelėdžiukai ";5325275053;Taip;10;7;0;17
9034;Rasa;Katinėliai;69686196470;Taip;4;7;0;11
9035;Rasa;Katinėliai;18425735174;Taip;0;8;0;8
9036;Rasa;Katinėliai;52215260039;Taip;0;8;2;10
9037;Rasa;Katinėliai;3312448238;Taip;0;5;1;6
9038;Rasa;Katinėliai;6462106753;Taip;0;20;0;20
9039;Rasa;Katinėliai;51760275118;Taip;8;5;1;14
9040;Rasa;Katinėliai;97125416712;Ne;0;3;0;3
9041;Rasa;Katinėliai;19313431652;Taip;20;5;0;25
9042;Rasa;Katinėliai;67334304285;Taip;0;5;0;5
9043;Rasa;Katinėliai;1018965809;Taip;0;5;0;5
9044;Rasa;Katinėliai;1226974819;Ne;5;7;0;12
9045;Rasa;Katinėliai;7404447244;Taip;0;11;0;11
9046;Rasa;Katinėliai;74206773356;Taip;6;1;0;7
9047;Rasa;Katinėliai;6781449151;Taip;3;4;1;8
9048;Rasa;Katinėliai;88319654798;Taip;0;10;0;10
9049;Rasa;Katinėliai;95692605702;Taip;0;5;8;13
9050;Rasa;Katinėliai;33757319655;Ne;0;7;0;7
9051;Rasa;Katinėliai;45229725317;Taip;0;4;3;7
9052;Rasa;Katinėliai;1516629281;Taip;10;5;0;15
9053;Rasa;Ančiukai;7520665472;Taip;11;2;0;13
9054;Rasa;Ančiukai;7185331699;Taip;10;1;0;11
9055;Rasa;Ančiukai;1060810039;Taip;10;1;0;11
9056;Rasa;Ančiukai;2977737634;Taip;15;6;0;21
9057;Rasa;Ančiukai;8310400946;Taip;0;15;0;15
9058;Rasa;Ančiukai;9599510902;Taip;0;22;0;22
9059;Rasa;Ančiukai;7037958994;Taip;20;2;0;22
9060;Rasa;Ančiukai;9668538340;Taip;8;7;0;15
9061;Rasa;Ančiukai;4795339259;Taip;5;12;0;17
9062;Rasa;Ančiukai;3668598028;Taip;5;19;0;24
9063;Rasa;Ančiukai;6019853365;Taip;25;0;0;25
9064;Rasa;Ančiukai;4694111253;Taip;13;2;0;15
9065;Rasa;Ančiukai;6208444770;Taip;8;5;0;13
9066;Rasa;Ančiukai;3664125930;Ne;3;1;0;4
9067;Rasa;Ančiukai;7028605422;Taip;0;23;0;23
9068;Rasa;"Vyturiukai ";1210203141;Taip;7;7;0;14
9069;Rasa;"Vyturiukai ";7575833127;Taip;0;5;8;13
9070;Rasa;"Vyturiukai ";27131705540;Taip;10;1;0;11
9071;Rasa;"Vyturiukai ";1823276800;Taip;4;0;0;4
9072;Rasa;"Vyturiukai ";1651905746;Taip;0;8;0;8
9073;Rasa;"Vyturiukai ";1940633287;Taip;0;5;0;5
9074;Rasa;"Vyturiukai ";66103644564;Taip;19;0;0;19
9075;Rasa;"Vyturiukai ";73115061371;Taip;0;10;0;10
9076;Rasa;"Vyturiukai ";1049242346;Taip;7;0;4;11
9077;Rasa;"Vyturiukai ";1179402963;Taip;0;4;0;4
9078;Rasa;"Vyturiukai ";1210340955;Taip;5;7;0;12
9079;Rasa;"Vyturiukai ";83227920971;Ne;0;12;0;12
9080;Rasa;"Vyturiukai ";84161884493;Taip;0;0;3;3
9081;Rasa;"Vyturiukai ";1214055260;Taip;5;5;0;10
9082;Rasa;"Vyturiukai ";50186813736;Taip;18;4;0;22
9083;Rasa;"Vyturiukai ";2041098301;Taip;0;19;0;19
9084;Rasa;"Vyturiukai ";71420694152;Ne;21;0;0;21
9085;Rasa;"Vyturiukai ";1477555365;Taip;0;17;0;17
9086;Rasa;"Vyturiukai ";6344169010;Taip;9;0;0;9
9087;Rasa;Voveriukai;99911904705;Taip;8;6;0;14
9088;Rasa;Voveriukai;5201341227;Taip;0;12;0;12
9089;Rasa;Voveriukai;1558712079;Taip;0;16;0;16
9090;Rasa;Voveriukai;25918582395;Ne;13;2;2;17
9091;Rasa;Voveriukai;9890493148;Taip;13;2;1;16
9092;Rasa;Voveriukai;79439306932;Taip;0;12;0;12
9093;Rasa;Voveriukai;1728275988;Taip;15;0;2;17
9094;Rasa;Voveriukai;13286984288;Taip;25;0;0;25
9095;Rasa;Voveriukai;74744565967;Taip;8;0;0;8
9096;Rasa;Voveriukai;1452467682;Taip;0;1;1;2
9097;Rasa;Voveriukai;67288516242;Taip;5;13;0;18
9098;Rasa;Voveriukai;1093723298;Ne;0;0;1;1
9099;Rasa;Voveriukai;2879767810;Taip;6;12;0;18
9100;Rasa;Voveriukai;2158444381;Taip;5;4;0;9
9101;Rasa;"DRUGELIAI ";4847544355;Taip;11;5;0;16
9102;Rasa;"DRUGELIAI ";9847597133;Taip;7;0;0;7
9103;Rasa;"DRUGELIAI ";1386880644;Taip;10;3;3;16
9104;Rasa;"DRUGELIAI ";1223962374;Taip;5;8;0;13
9105;Rasa;"DRUGELIAI ";1336291828;Taip;9;8;0;17
9106;Rasa;"DRUGELIAI ";3200377629;Taip;21;0;0;21
9107;Rasa;"DRUGELIAI ";3979273111;Taip;0;6;0;6
9108;Rasa;"DRUGELIAI ";5176175108;Taip;3;5;5;13
9109;Rasa;"DRUGELIAI ";5363748728;Taip;20;5;0;25
9110;Rasa;"DRUGELIAI ";7004232909;Taip;0;1;4;5
9111;Rasa;"DRUGELIAI ";9723040721;Taip;5;20;0;25
9112;Rasa;"DRUGELIAI ";7228037580;Taip;11;9;0;20
9113;Rasa;"DRUGELIAI ";5861229664;Taip;25;0;0;25
9114;Rasa;"DRUGELIAI ";2540124793;Taip;11;0;2;13
9115;Rasa;"DRUGELIAI ";2093263887;Taip;10;3;0;13
9116;Rasa;Zuikučiai;1916783052;Taip;7;5;0;12
9117;Rasa;Zuikučiai;4554377449;Taip;0;5;0;5
9118;Rasa;Zuikučiai;2137321989;Taip;6;10;0;16
9119;Rasa;Zuikučiai;1432856662;Taip;16;2;0;18
9120;Rasa;Zuikučiai;1993471951;Taip;6;1;2;9
9121;Rasa;Zuikučiai;1860462451;Taip;20;0;0;20
9122;Rasa;Zuikučiai;42609897431;Taip;0;5;0;5
9123;Rasa;Zuikučiai;55374082940;Taip;0;21;0;21
9124;Rasa;Zuikučiai;2114613635;Taip;0;3;2;5
9125;Rasa;Zuikučiai;7397794681;Taip;12;5;0;17
9126;Rasa;Zuikučiai;7657119471;Taip;0;5;7;12
9127;Rasa;Zuikučiai;13297122928;Taip;0;25;0;25
9128;Rasa;Zuikučiai;6795591746;Taip;5;14;0;19
9129;Rasa;Zuikučiai;6108187043;Taip;0;11;0;11
9130;Rasa;Zuikučiai;1560278351;Taip;10;3;3;16
9131;Rasa;Zuikučiai;1004116597;Taip;5;5;0;10
9132;Rasa;Zuikučiai;26384431360;Taip;0;1;1;2
9133;Rasa;Zuikučiai;1690518970;Taip;9;0;3;12
9134;Rasa;Zuikučiai;1131418692;Taip;0;3;0;3
9135;Riešutėlis;Viščiukų;1782544949;Taip;0;9;0;9
9136;Riešutėlis;Viščiukų;91799192513;Taip;1;5;0;6
9137;Riešutėlis;Viščiukų;50427986973;Taip;15;2;0;17
9138;Riešutėlis;Viščiukų;28855582790;Taip;0;5;0;5
9139;Riešutėlis;Viščiukų;2131349938;Taip;0;9;0;9
9140;Riešutėlis;Viščiukų;41275727334;Taip;7;0;0;7
9141;Riešutėlis;Viščiukų;98456292572;Taip;6;3;0;9
9142;Riešutėlis;Viščiukų;63919369801;Taip;5;1;0;6
9143;Riešutėlis;Viščiukų;85564700996;Taip;2;0;0;2
9144;Riešutėlis;Viščiukų;2146831972;Taip;12;0;0;12
9145;Riešutėlis;Viščiukų;61571638960;Taip;10;0;2;12
9146;Riešutėlis;Viščiukų;8857939937;Taip;8;0;0;8
9147;Riešutėlis;Viščiukų;1957794151;Taip;0;5;0;5
9148;Riešutėlis;Viščiukų;5520818573;Taip;9;1;0;10
9149;Riešutėlis;Viščiukų;1792212841;Taip;9;7;0;16
9150;Riešutėlis;Viščiukų;1930481567;Taip;14;0;0;14
9151;Riešutėlis;Viščiukų;86455801201;Taip;10;3;0;13
9152;Riešutėlis;Viščiukų;93958381534;Taip;0;3;2;5
9153;Riešutėlis;Viščiukų;1532275496;Taip;4;0;15;19
9154;Riešutėlis;Viščiukų;4311016578;Taip;0;0;1;1
9155;Riešutėlis;Viščiukų;4229384438;Taip;4;5;0;9
9156;Riešutėlis;"Riešutėliai ";8077135868;Taip;5;0;0;5
9157;Riešutėlis;"Riešutėliai ";84116863778;Taip;10;1;0;11
9158;Riešutėlis;"Riešutėliai ";1077680441;Taip;3;0;3;6
9159;Riešutėlis;"Riešutėliai ";1430255154;Taip;9;7;0;16
9160;Riešutėlis;"Riešutėliai ";90082848356;Taip;6;2;2;10
9161;Riešutėlis;"Riešutėliai ";6097581240;Taip;2;0;0;2
9162;Riešutėlis;"Riešutėliai ";55620350407;Taip;10;2;0;12
9163;Riešutėlis;"Riešutėliai ";57437627642;Ne;4;0;0;4
9164;Riešutėlis;"Riešutėliai ";2035669978;Taip;10;0;0;10
9165;Riešutėlis;"Riešutėliai ";1105598415;Taip;8;0;1;9
9166;Riešutėlis;"Riešutėliai ";11913461630;Taip;10;5;0;15
9167;Riešutėlis;"Riešutėliai ";1674871670;Taip;5;7;0;12
9168;Riešutėlis;"Riešutėliai ";1853283967;Taip;1;5;0;6
9169;Riešutėlis;"Riešutėliai ";49061075792;Taip;10;8;0;18
9170;Riešutėlis;"Riešutėliai ";1532633795;Taip;0;0;1;1
9171;Riešutėlis;"Riešutėliai ";6855553238;Taip;10;0;5;15
9172;Riešutėlis;"Riešutėliai ";1858221034;Ne;1;0;0;1
9173;Riešutėlis;"Riešutėliai ";3806836220;Taip;0;6;2;8
9174;Riešutėlis;"Riešutėliai ";16308059025;Taip;7;0;0;7
9175;Riešutėlis;"Riešutėliai ";9023304543;Taip;7;0;0;7
9176;Riešutėlis;"Riešutėliai ";1941869661;Taip;0;4;1;5
9177;Riešutėlis;Ežiukai;68367330775;Taip;5;5;1;11
9178;Riešutėlis;Ežiukai;80570358139;Taip;0;2;0;2
9179;Riešutėlis;Ežiukai;8407612029;Taip;11;1;0;12
9180;Riešutėlis;Ežiukai;83564208896;Taip;10;0;0;10
9181;Riešutėlis;Ežiukai;45372107189;Taip;5;0;0;5
9182;Riešutėlis;Ežiukai;1659653711;Taip;15;0;0;15
9183;Riešutėlis;Ežiukai;20330297586;Taip;3;2;0;5
9184;Riešutėlis;Ežiukai;52227650850;Taip;0;1;0;1
9185;Riešutėlis;Ežiukai;96819764408;Taip;6;10;0;16
9186;Riešutėlis;Ežiukai;66558189779;Taip;0;11;0;11
9187;Riešutėlis;Ežiukai;62003857623;Taip;4;1;0;5
9188;Riešutėlis;Ežiukai;23972193661;Taip;3;8;0;11
9189;Riešutėlis;Ežiukai;54820388507;Taip;10;8;0;18
9190;Riešutėlis;Ežiukai;32134152672;Taip;0;3;0;3
9191;Riešutėlis;Ežiukai;1579325190;Taip;4;0;0;4
9192;Riešutėlis;Ežiukai;57828137061;Taip;0;13;0;13
9193;Riešutėlis;Ežiukai;48055109138;Taip;0;2;0;2
9194;Riešutėlis;Ežiukai;69587584156;Taip;10;0;0;10
9195;Riešutėlis;Ežiukai;59086252488;Taip;0;5;0;5
9196;Riešutėlis;Ežiukai;9485880468;Taip;4;0;0;4
9197;Riešutėlis;Ežiukai;3626122579;Taip;10;5;1;16
9198;Riešutėlis;Ežiukai;2378768167;Taip;12;1;0;13
9199;Riešutėlis;Ežiukai;1320515966;Taip;4;1;5;10
9200;Riešutėlis;Pelėdžiukai;89573913251;Taip;4;10;0;14
9201;Riešutėlis;Pelėdžiukai;6303767779;Taip;10;0;1;11
9202;Riešutėlis;Pelėdžiukai;7198434243;Taip;7;0;0;7
9203;Riešutėlis;Pelėdžiukai;8018914251;Taip;14;1;0;15
9204;Riešutėlis;Pelėdžiukai;1457008581;Taip;6;0;0;6
9205;Riešutėlis;Pelėdžiukai;8012201566;Taip;14;0;0;14
9206;Riešutėlis;Pelėdžiukai;8751571852;Taip;10;0;3;13
9207;Riešutėlis;Pelėdžiukai;5479780116;Taip;10;0;0;10
9208;Riešutėlis;Pelėdžiukai;7225365172;Taip;9;0;1;10
9209;Riešutėlis;Pelėdžiukai;9839084885;Taip;10;0;0;10
9210;Riešutėlis;Pelėdžiukai;6928558714;Taip;11;0;0;11
9211;Riešutėlis;Pelėdžiukai;9040123535;Taip;9;1;0;10
9212;Riešutėlis;Pelėdžiukai;6405116059;Taip;7;0;1;8
9213;Riešutėlis;Pelėdžiukai;5995176001;Taip;10;0;3;13
9214;Riešutėlis;Pelėdžiukai;2430518637;Taip;19;0;0;19
9215;Riešutėlis;Pelėdžiukai;3970874098;Taip;15;0;0;15
9216;Riešutėlis;Pelėdžiukai;4451419273;Taip;9;0;3;12
9217;Riešutėlis;Pelėdžiukai;1638021880;Taip;6;1;0;7
9218;Riešutėlis;Pelėdžiukai;4581184004;Taip;11;0;0;11
9219;Riešutėlis;Pelėdžiukai;5598052531;Taip;15;0;0;15
9220;Riešutėlis;Pelėdžiukai;5282039544;Ne;15;0;0;15
9221;Riešutėlis;Meškiukai;1485215618;Taip;6;0;0;6
9222;Riešutėlis;Meškiukai;54091928168;Taip;5;7;0;12
9223;Riešutėlis;Meškiukai;35918917950;Taip;13;4;0;17
9224;Riešutėlis;Meškiukai;74152896785;Ne;5;0;0;5
9225;Riešutėlis;Meškiukai;14272401750;Taip;0;5;0;5
9226;Riešutėlis;Meškiukai;37951030398;Taip;10;5;0;15
9227;Riešutėlis;Meškiukai;61160276176;Taip;5;0;1;6
9228;Riešutėlis;Meškiukai;75116205075;Taip;5;5;0;10
9229;Riešutėlis;Meškiukai;50016291414;Taip;5;5;1;11
9230;Riešutėlis;Meškiukai;76883335437;Taip;11;5;0;16
9231;Riešutėlis;Meškiukai;82203033052;Taip;6;5;0;11
9232;Riešutėlis;Meškiukai;30351563466;Taip;7;0;0;7
9233;Riešutėlis;Meškiukai;54175641919;Taip;3;5;0;8
9234;Riešutėlis;Meškiukai;86230171561;Taip;4;0;0;4
9235;Riešutėlis;Meškiukai;7435155136;Taip;10;0;0;10
9236;Riešutėlis;Meškiukai;12005650217;Taip;0;8;0;8
9237;Riešutėlis;Meškiukai;14480798602;Taip;5;2;0;7
9238;Riešutėlis;Meškiukai;17419936511;Taip;12;5;0;17
9239;Riešutėlis;Meškiukai;6201042890;Taip;17;0;0;17
9240;Riešutėlis;Meškiukai;2815239542;Taip;10;0;0;10
9241;Riešutėlis;Meškiukai;8927730307;Taip;5;1;0;6
9242;Riešutėlis;Meškiukai;3722925159;Taip;15;5;0;20
9243;Riešutėlis;Kiškučiai;90088217854;Taip;6;0;0;6
9244;Riešutėlis;Kiškučiai;49061132665;Taip;3;7;0;10
9245;Riešutėlis;Kiškučiai;60941759790;Taip;5;10;0;15
9246;Riešutėlis;Kiškučiai;92159110899;Taip;14;0;0;14
9247;Riešutėlis;Kiškučiai;1623455993;Taip;4;5;1;10
9248;Riešutėlis;Kiškučiai;4464545735;Taip;3;0;0;3
9249;Riešutėlis;Kiškučiai;96066602684;Taip;7;0;1;8
9250;Riešutėlis;Kiškučiai;55715445788;Taip;8;5;0;13
9251;Riešutėlis;Kiškučiai;1747328573;Taip;5;6;0;11
9252;Riešutėlis;Kiškučiai;1250209796;Taip;6;6;0;12
9253;Riešutėlis;Kiškučiai;1526573984;Taip;16;0;0;16
9254;Riešutėlis;Kiškučiai;50338275044;Taip;0;2;0;2
9255;Riešutėlis;Kiškučiai;18310744085;Taip;5;7;0;12
9256;Riešutėlis;Kiškučiai;35876952602;Taip;5;0;0;5
9257;Riešutėlis;Kiškučiai;1748738558;Taip;4;0;0;4
9258;Riešutėlis;Kiškučiai;93192056557;Taip;11;5;0;16
9259;Riešutėlis;Kiškučiai;2973908247;Taip;0;0;1;1
9260;Riešutėlis;Kiškučiai;9205961122;Taip;5;0;1;6
9261;Riešutėlis;Kiškučiai;2163433983;Taip;8;0;0;8
9262;Riešutėlis;Kiškučiai;4916885450;Taip;0;20;0;20
9263;Riešutėlis;Kiškučiai;8864100655;Taip;4;0;0;4
9264;Riešutėlis;Voveriukų;6130980726;Taip;10;1;0;11
9265;Riešutėlis;Voveriukų;6500567162;Taip;5;5;0;10
9266;Riešutėlis;Voveriukų;2034456215;Taip;10;0;0;10
9267;Riešutėlis;Voveriukų;9081486438;Taip;10;5;0;15
9268;Riešutėlis;Voveriukų;1212829190;Taip;14;0;0;14
9269;Riešutėlis;Voveriukų;59279444190;Taip;10;0;0;10
9270;Riešutėlis;Voveriukų;31417468379;Taip;16;0;0;16
9271;Riešutėlis;Voveriukų;1065105725;Taip;0;1;0;1
9272;Riešutėlis;Voveriukų;36176126840;Taip;0;2;0;2
9273;Riešutėlis;Voveriukų;26053212952;Taip;0;1;0;1
9274;Riešutėlis;Voveriukų;51840071269;Taip;0;1;0;1
9275;Riešutėlis;Voveriukų;70549617521;Taip;6;2;0;8
9276;Riešutėlis;Voveriukų;36161702165;Taip;10;0;0;10
9277;Riešutėlis;Voveriukų;46444683383;Taip;6;7;0;13
9278;Riešutėlis;Voveriukų;92166220283;Taip;5;5;0;10
9279;Riešutėlis;Voveriukų;2163248156;Taip;10;1;0;11
9280;Riešutėlis;Voveriukų;43038393551;Taip;10;0;0;10
9281;Riešutėlis;Voveriukų;56426084480;Taip;6;1;0;7
9282;Riešutėlis;Voveriukų;65629075580;Taip;5;6;0;11
9283;Riešutėlis;Voveriukų;50971787753;Taip;10;0;0;10
9284;Riešutėlis;Voveriukų;89384403521;Taip;0;9;0;9
9285;Riešutėlis;Voveriukų;64736615832;Taip;5;0;0;5
9286;Riešutėlis;Voveriukų;29751938918;Taip;20;0;0;20
9287;Riešutėlis;Saulutės;9198963882;Taip;7;1;0;8
9288;Riešutėlis;Saulutės;2111280879;Taip;12;3;0;15
9289;Riešutėlis;Saulutės;1190403952;Taip;0;2;2;4
9290;Riešutėlis;Saulutės;1160573638;Taip;5;7;0;12
9291;Riešutėlis;Saulutės;1056034480;Taip;12;0;0;12
9292;Riešutėlis;Saulutės;1136025173;Taip;0;20;0;20
9293;Riešutėlis;Saulutės;2097580659;Taip;10;5;0;15
9294;Riešutėlis;Saulutės;2112179980;Taip;10;6;0;16
9295;Riešutėlis;Saulutės;2851186469;Taip;7;0;2;9
9296;Riešutėlis;Saulutės;8749505821;Taip;0;17;0;17
9297;Riešutėlis;Saulutės;1169051233;Taip;10;0;0;10
9298;Riešutėlis;Saulutės;1091941952;Taip;10;2;0;12
9299;Riešutėlis;Saulutės;24776322315;Taip;12;0;1;13
9300;Riešutėlis;Saulutės;7912773569;Taip;0;1;0;1
9301;Riešutėlis;Saulutės;2655848313;Taip;8;1;0;9
9302;Riešutėlis;Saulutės;6402032861;Taip;15;0;0;15
9303;Riešutėlis;Saulutės;5717194707;Taip;6;3;0;9
9304;Riešutėlis;Saulutės;5537309549;Taip;10;0;0;10
9305;Riešutėlis;Saulutės;8271632629;Taip;4;5;0;9
9306;Riešutėlis;"Boruželės ";16561622902;Taip;9;4;0;13
9307;Riešutėlis;"Boruželės ";56117509354;Taip;8;9;0;17
9308;Riešutėlis;"Boruželės ";1936519033;Taip;15;0;0;15
9309;Riešutėlis;"Boruželės ";2611705234;Taip;12;0;0;12
9310;Riešutėlis;"Boruželės ";4131218911;Taip;8;4;0;12
9311;Riešutėlis;"Boruželės ";1455509576;Taip;8;5;0;13
9312;Riešutėlis;"Boruželės ";4701887030;Taip;6;0;0;6
9313;Riešutėlis;"Boruželės ";3577669231;Taip;14;1;0;15
9314;Riešutėlis;"Boruželės ";9670912357;Taip;8;0;1;9
9315;Riešutėlis;"Boruželės ";26781529460;Taip;10;0;1;11
9316;Riešutėlis;"Boruželės ";5097410462;Taip;6;0;0;6
9317;Riešutėlis;"Boruželės ";4344185375;Taip;0;5;0;5
9318;Riešutėlis;"Boruželės ";8936419431;Taip;5;0;0;5
9319;Riešutėlis;"Boruželės ";4041498684;Taip;13;4;0;17
9320;Riešutėlis;"Boruželės ";8087180983;Taip;0;20;0;20
9321;Riešutėlis;"Boruželės ";4276034784;Taip;0;0;3;3
9322;Riešutėlis;"Boruželės ";2566084613;Taip;0;10;0;10
9323;Riešutėlis;"Boruželės ";1640383686;Taip;6;0;0;6
9324;Riešutėlis;"Boruželės ";3851000866;Taip;10;2;3;15
9325;Riešutėlis;"Boruželės ";3982030863;Taip;0;0;3;3
9326;Riešutėlis;"Boruželės ";1623681835;Taip;0;0;1;1
9327;Riešutėlis;"Bitutės ";1000408690;Taip;0;0;6;6
9328;Riešutėlis;"Bitutės ";3149710709;Taip;10;1;0;11
9329;Riešutėlis;"Bitutės ";54011982803;Taip;0;5;0;5
9330;Riešutėlis;"Bitutės ";4366097328;Taip;6;14;0;20
9331;Riešutėlis;"Bitutės ";2395648260;Taip;10;8;0;18
9332;Riešutėlis;"Bitutės ";4480906648;Taip;16;0;0;16
9333;Riešutėlis;"Bitutės ";86647499063;Taip;17;0;0;17
9334;Riešutėlis;"Bitutės ";4188823834;Taip;9;0;0;9
9335;Riešutėlis;"Bitutės ";59796628656;Taip;15;0;0;15
9336;Riešutėlis;"Bitutės ";6852846350;Taip;13;0;0;13
9337;Riešutėlis;"Bitutės ";91430094368;Taip;11;2;0;13
9338;Riešutėlis;"Bitutės ";4897379979;Taip;17;0;0;17
9339;Riešutėlis;"Bitutės ";65873300738;Taip;5;7;0;12
9340;Riešutėlis;"Bitutės ";8313605541;Taip;5;0;0;5
9341;Riešutėlis;"Bitutės ";1921241349;Taip;10;0;1;11
9342;Riešutėlis;Drugelių;8266735624;Taip;0;7;0;7
9343;Riešutėlis;Drugelių;4776231497;Taip;0;7;0;7
9344;Riešutėlis;Drugelių;5753609922;Taip;20;0;0;20
9345;Riešutėlis;Drugelių;8578903763;Taip;11;5;0;16
9346;Riešutėlis;Drugelių;3975091711;Taip;12;0;0;12
9347;Riešutėlis;Drugelių;6194259707;Taip;12;0;0;12
9348;Riešutėlis;Drugelių;7769079730;Taip;10;1;0;11
9349;Riešutėlis;Drugelių;5811657782;Taip;10;0;1;11
9350;Riešutėlis;Drugelių;4221375847;Taip;0;20;0;20
9351;Riešutėlis;Drugelių;1075842434;Taip;5;0;1;6
9352;Riešutėlis;Drugelių;8016820352;Taip;14;0;0;14
9353;Riešutėlis;Drugelių;4994368504;Taip;5;10;0;15
9354;Riešutėlis;Drugelių;1942944625;Taip;5;3;0;8
9355;Riešutėlis;Drugelių;8845709386;Taip;0;12;0;12
9356;Riešutėlis;Drugelių;8128352818;Taip;7;0;0;7
9357;Riešutėlis;Drugelių;8180618419;Taip;12;1;0;13
9358;Riešutėlis;Drugelių;3920525584;Taip;13;0;2;15
9359;Riešutėlis;Drugelių;5412882446;Taip;8;1;0;9
9360;Riešutėlis;Drugelių;8020533200;Taip;5;0;0;5
9361;Ramunėlė;SAULUTĖS;19664665864;Ne;4;8;0;12
9362;Ramunėlė;SAULUTĖS;80319760551;Taip;0;5;0;5
9363;Ramunėlė;SAULUTĖS;37338389480;Taip;0;4;0;4
9364;Ramunėlė;SAULUTĖS;7736649569;Taip;0;3;0;3
9365;Ramunėlė;SAULUTĖS;43737882488;Taip;7;0;0;7
9366;Ramunėlė;SAULUTĖS;16577268434;Taip;0;5;0;5
9367;Ramunėlė;SAULUTĖS;44016905818;Taip;5;7;0;12
9368;Ramunėlė;SAULUTĖS;19784681244;Taip;0;15;0;15
9369;Ramunėlė;SAULUTĖS;99807372989;Taip;0;12;0;12
9370;Ramunėlė;SAULUTĖS;9266024764;Taip;10;5;0;15
9371;Ramunėlė;SAULUTĖS;85972695257;Taip;0;6;0;6
9372;Ramunėlė;SAULUTĖS;94707638226;Taip;0;7;0;7
9373;Ramunėlė;SAULUTĖS;69367849602;Taip;0;13;0;13
9374;Ramunėlė;SAULUTĖS;97944093065;Taip;9;6;0;15
9375;Ramunėlė;SAULUTĖS;27163734018;Taip;1;5;5;11
9376;Ramunėlė;SAULUTĖS;1712780584;Taip;0;3;0;3
9377;Ramunėlė;SAULUTĖS;2089805114;Taip;0;3;1;4
9378;Ramunėlė;SAULUTĖS;1079295964;Taip;0;6;0;6
9379;Ramunėlė;SAULUTĖS;26568396284;Taip;15;0;0;15
9380;Ramunėlė;SAULUTĖS;1982905923;Taip;0;2;1;3
9381;Ramunėlė;SAULUTĖS;9918328799;Taip;9;7;0;16
9382;Ramunėlė;ŽIBUTĖ;8943746426;Taip;0;5;0;5
9383;Ramunėlė;ŽIBUTĖ;57697488265;Taip;7;8;0;15
9384;Ramunėlė;ŽIBUTĖ;4103951942;Taip;0;8;0;8
9385;Ramunėlė;ŽIBUTĖ;37227575121;Taip;4;0;1;5
9386;Ramunėlė;ŽIBUTĖ;21178777924;Taip;8;3;0;11
9387;Ramunėlė;ŽIBUTĖ;9615607625;Taip;3;6;0;9
9388;Ramunėlė;ŽIBUTĖ;24395304267;Taip;5;2;0;7
9389;Ramunėlė;ŽIBUTĖ;41210974793;Taip;7;0;0;7
9390;Ramunėlė;ŽIBUTĖ;71451001033;Taip;5;0;0;5
9391;Ramunėlė;ŽIBUTĖ;6126971384;Taip;5;2;0;7
9392;Ramunėlė;ŽIBUTĖ;78632810141;Taip;19;0;0;19
9393;Ramunėlė;ŽIBUTĖ;573414969;Taip;0;1;0;1
9394;Ramunėlė;ŽIBUTĖ;2069380818;Taip;0;5;0;5
9395;Ramunėlė;ŽIBUTĖ;1686559920;Taip;4;2;2;8
9396;Ramunėlė;ŽIBUTĖ;2127262855;Taip;0;8;0;8
9397;Ramunėlė;ŽIBUTĖ;1898089064;Taip;13;7;0;20
9398;Ramunėlė;ŽIBUTĖ;1575204445;Taip;10;0;0;10
9399;Ramunėlė;ŽIBUTĖ;1511271386;Taip;0;1;0;1
9400;Ramunėlė;ŽIBUTĖ;1845973626;Taip;0;4;0;4
9401;Ramunėlė;ŽIBUTĖ;1177226887;Taip;0;1;0;1
9402;Ramunėlė;ŽIRNIUKAI;99821576722;Taip;0;9;0;9
9403;Ramunėlė;ŽIRNIUKAI;50481250500;Taip;0;4;0;4
9404;Ramunėlė;ŽIRNIUKAI;94856703262;Taip;0;5;0;5
9405;Ramunėlė;ŽIRNIUKAI;63588041951;Taip;0;5;0;5
9406;Ramunėlė;ŽIRNIUKAI;65453540817;Taip;0;9;0;9
9407;Ramunėlė;ŽIRNIUKAI;42260677623;Taip;0;9;0;9
9408;Ramunėlė;ŽIRNIUKAI;6024704965;Taip;0;7;0;7
9409;Ramunėlė;ŽIRNIUKAI;26794018418;Taip;15;3;0;18
9410;Ramunėlė;ŽIRNIUKAI;91420704570;Taip;0;7;0;7
9411;Ramunėlė;ŽIRNIUKAI;32944616981;Taip;10;10;0;20
9412;Ramunėlė;ŽIRNIUKAI;88310187748;Taip;0;6;0;6
9413;Ramunėlė;ŽIRNIUKAI;26023476423;Taip;0;9;0;9
9414;Ramunėlė;ŽIRNIUKAI;31363181264;Taip;0;7;0;7
9415;Ramunėlė;ŽIRNIUKAI;74094856940;Ne;0;9;8;17
9416;Ramunėlė;ŽIRNIUKAI;84737816930;Taip;0;6;0;6
9417;Ramunėlė;ŽIRNIUKAI;46655439401;Taip;0;6;0;6
9418;Ramunėlė;ŽIRNIUKAI;81555246386;Taip;0;13;0;13
9419;Ramunėlė;ŽIRNIUKAI;68236739228;Taip;0;8;0;8
9420;Ramunėlė;ŽIRNIUKAI;15299809362;Ne;4;3;0;7
9421;Ramunėlė;ŽIRNIUKAI;64011542531;Taip;1;5;4;10
9422;Ramunėlė;ŽIRNIUKAI;74958543608;Taip;0;4;0;4
9423;Ramunėlė;ŽIRNIUKAI;19570213314;Taip;0;7;0;7
9424;Ramunėlė;BITUTĖS;32110200138;Taip;6;0;0;6
9425;Ramunėlė;BITUTĖS;96866067694;Taip;0;13;0;13
9426;Ramunėlė;BITUTĖS;23095478847;Taip;0;11;0;11
9427;Ramunėlė;BITUTĖS;9961229084;Taip;5;5;0;10
9428;Ramunėlė;BITUTĖS;8265220753;Taip;0;2;0;2
9429;Ramunėlė;BITUTĖS;7921336790;Taip;5;6;0;11
9430;Ramunėlė;BITUTĖS;86378277613;Taip;0;8;0;8
9431;Ramunėlė;BITUTĖS;1866642357;Ne;0;15;0;15
9432;Ramunėlė;BITUTĖS;32249506035;Taip;10;1;0;11
9433;Ramunėlė;BITUTĖS;42582811243;Taip;0;5;0;5
9434;Ramunėlė;BITUTĖS;1485483496;Taip;0;6;0;6
9435;Ramunėlė;BITUTĖS;3683430430;Taip;15;5;0;20
9436;Ramunėlė;BITUTĖS;4101387438;Taip;4;5;1;10
9437;Ramunėlė;BITUTĖS;16357824257;Taip;0;2;7;9
9438;Ramunėlė;BITUTĖS;9715654332;Taip;0;2;0;2
9439;Ramunėlė;BITUTĖS;1012658900;Taip;3;9;0;12
9440;Ramunėlė;BITUTĖS;9017349382;Taip;5;9;0;14
9441;Ramunėlė;DRUGELIAI;52584057093;Taip;0;7;5;12
9442;Ramunėlė;DRUGELIAI;22249196276;Taip;4;7;0;11
9443;Ramunėlė;DRUGELIAI;99570998118;Taip;5;5;0;10
9444;Ramunėlė;DRUGELIAI;81774258556;Taip;0;3;2;5
9445;Ramunėlė;DRUGELIAI;22097349678;Taip;0;5;2;7
9446;Ramunėlė;DRUGELIAI;62716754080;Taip;0;6;0;6
9447;Ramunėlė;DRUGELIAI;14581393355;Taip;0;5;0;5
9448;Ramunėlė;DRUGELIAI;35823437202;Taip;1;5;0;6
9449;Ramunėlė;DRUGELIAI;15363368541;Taip;15;3;0;18
9450;Ramunėlė;DRUGELIAI;76947701645;Taip;6;2;2;10
9451;Ramunėlė;DRUGELIAI;15310034187;Taip;0;10;0;10
9452;Ramunėlė;DRUGELIAI;22306706669;Taip;0;2;0;2
9453;Ramunėlė;DRUGELIAI;25346770513;Taip;0;2;8;10
9454;Ramunėlė;DRUGELIAI;72620475723;Taip;10;0;0;10
9455;Ramunėlė;DRUGELIAI;28838673166;Ne;0;2;0;2
9456;Ramunėlė;DRUGELIAI;1253351354;Taip;5;0;1;6
9457;Ramunėlė;DRUGELIAI;13195968349;Taip;0;6;0;6
9458;Ramunėlė;DRUGELIAI;84319432445;Taip;7;4;0;11
9459;Ramunėlė;DRUGELIAI;21608020858;Taip;0;3;7;10
9460;Ramunėlė;DRUGELIAI;1478538572;Taip;0;12;0;12
9461;Ramunėlė;DRUGELIAI;26152001976;Taip;10;5;0;15
9462;Ramunėlė;DRUGELIAI;1175561112;Taip;0;7;0;7
9463;Ramunėlė;NEUŽMIRŠTUOLĖS;19420482998;Taip;0;19;0;19
9464;Ramunėlė;NEUŽMIRŠTUOLĖS;4990982790;Taip;8;0;0;8
9465;Ramunėlė;NEUŽMIRŠTUOLĖS;9130637883;Taip;2;11;0;13
9466;Ramunėlė;NEUŽMIRŠTUOLĖS;3271832822;Taip;4;5;0;9
9467;Ramunėlė;NEUŽMIRŠTUOLĖS;3554787356;Taip;11;0;0;11
9468;Ramunėlė;NEUŽMIRŠTUOLĖS;8098492540;Taip;0;9;0;9
9469;Ramunėlė;NEUŽMIRŠTUOLĖS;6217540064;Taip;0;2;4;6
9470;Ramunėlė;NEUŽMIRŠTUOLĖS;17201639406;Taip;5;0;0;5
9471;Ramunėlė;NEUŽMIRŠTUOLĖS;4511376806;Taip;3;10;0;13
9472;Ramunėlė;NEUŽMIRŠTUOLĖS;9171690612;Taip;11;5;0;16
9473;Ramunėlė;NEUŽMIRŠTUOLĖS;8357049686;Taip;0;15;0;15
9474;Ramunėlė;NEUŽMIRŠTUOLĖS;6329943991;Taip;2;0;0;2
9475;Ramunėlė;NEUŽMIRŠTUOLĖS;8086994543;Taip;5;1;0;6
9476;Ramunėlė;NEUŽMIRŠTUOLĖS;5822045625;Taip;0;0;1;1
9477;Ramunėlė;OBUOLIUKAI;1376538015;Ne;0;2;0;2
9478;Ramunėlė;OBUOLIUKAI;1783572058;Taip;14;5;0;19
9479;Ramunėlė;OBUOLIUKAI;30907738272;Taip;7;4;1;12
9480;Ramunėlė;OBUOLIUKAI;1891454355;Taip;10;2;0;12
9481;Ramunėlė;OBUOLIUKAI;1814199950;Taip;0;6;0;6
9482;Ramunėlė;OBUOLIUKAI;1199690327;Taip;0;5;1;6
9483;Ramunėlė;OBUOLIUKAI;52168460247;Taip;2;6;0;8
9484;Ramunėlė;OBUOLIUKAI;67836032797;Taip;8;2;0;10
9485;Ramunėlė;OBUOLIUKAI;66630134164;Taip;8;0;2;10
9486;Ramunėlė;OBUOLIUKAI;1988109236;Taip;10;6;0;16
9487;Ramunėlė;OBUOLIUKAI;7228065409;Taip;7;3;0;10
9488;Ramunėlė;OBUOLIUKAI;2567264851;Taip;0;3;11;14
9489;Ramunėlė;OBUOLIUKAI;9584620339;Taip;5;3;0;8
9490;Ramunėlė;OBUOLIUKAI;8402889872;Taip;14;1;0;15
9491;Ramunėlė;OBUOLIUKAI;1745170057;Taip;0;7;5;12
9492;Ramunėlė;OBUOLIUKAI;5170325023;Taip;9;0;0;9
9493;Ramunėlė;OBUOLIUKAI;3617897977;Taip;0;5;0;5
9494;Ramunėlė;OBUOLIUKAI;8768539595;Taip;8;6;0;14
9495;Ramunėlė;OBUOLIUKAI;2055332353;Taip;0;14;0;14
9496;Ramunėlė;OBUOLIUKAI;7955507702;Taip;5;0;0;5
9497;Ramunėlė;OBUOLIUKAI;58573425792;Taip;0;0;2;2
9498;Ramunėlė;OBUOLIUKAI;1199673371;Taip;0;0;5;5
9499;Ramunėlė;OBUOLIUKAI;6930505887;Taip;10;3;0;13
9500;Ramunėlė;SAULĖGRĄŽA;3973083939;Taip;5;2;3;10
9501;Ramunėlė;SAULĖGRĄŽA;53748116108;Taip;0;5;0;5
9502;Ramunėlė;SAULĖGRĄŽA;1028730863;Taip;0;9;0;9
9503;Ramunėlė;SAULĖGRĄŽA;1085668968;Taip;0;3;0;3
9504;Ramunėlė;SAULĖGRĄŽA;1500685962;Taip;0;5;0;5
9505;Ramunėlė;SAULĖGRĄŽA;2075485387;Taip;0;5;3;8
9506;Ramunėlė;SAULĖGRĄŽA;2036562086;Taip;0;5;0;5
9507;Ramunėlė;SAULĖGRĄŽA;57963557951;Taip;0;1;0;1
9508;Ramunėlė;SAULĖGRĄŽA;9924675250;Taip;7;5;4;16
9509;Ramunėlė;SAULĖGRĄŽA;1171170929;Taip;0;7;0;7
9510;Ramunėlė;SAULĖGRĄŽA;10677635919;Taip;5;1;0;6
9511;Ramunėlė;SAULĖGRĄŽA;11512621396;Taip;0;5;0;5
9512;Ramunėlė;SAULĖGRĄŽA;1157861595;Taip;5;0;1;6
9513;Ramunėlė;SAULĖGRĄŽA;17292085814;Taip;0;7;0;7
9514;Ramunėlė;SAULĖGRĄŽA;4814208279;Taip;0;2;2;4
9515;Ramunėlė;SAULĖGRĄŽA;8254302108;Taip;0;1;0;1
9516;Ramunėlė;SAULĖGRĄŽA;1364997950;Taip;5;2;0;7
9517;Ramunėlė;SAULĖGRĄŽA;1397784717;Taip;4;0;0;4
9518;Ramunėlė;SAULĖGRĄŽA;8496322672;Taip;5;0;1;6
9519;Ramunėlė;BORUŽĖLĖS;82024687579;Taip;0;13;0;13
9520;Ramunėlė;BORUŽĖLĖS;1563618796;Taip;0;9;0;9
9521;Ramunėlė;BORUŽĖLĖS;76195144469;Taip;5;0;0;5
9522;Ramunėlė;BORUŽĖLĖS;1033548164;Taip;15;4;0;19
9523;Ramunėlė;BORUŽĖLĖS;1946639898;Taip;10;1;0;11
9524;Ramunėlė;BORUŽĖLĖS;1058243928;Taip;2;9;0;11
9525;Ramunėlė;BORUŽĖLĖS;63470398650;Taip;6;1;0;7
9526;Ramunėlė;BORUŽĖLĖS;1439962940;Taip;0;1;0;1
9527;Ramunėlė;BORUŽĖLĖS;93125217886;Taip;5;1;0;6
9528;Ramunėlė;BORUŽĖLĖS;1690224857;Taip;7;0;0;7
9529;Ramunėlė;BORUŽĖLĖS;1827657363;Taip;0;5;0;5
9530;Ramunėlė;BORUŽĖLĖS;1642082135;Taip;9;5;0;14
9531;Ramunėlė;BORUŽĖLĖS;1176835101;Taip;0;6;0;6
9532;Ramunėlė;BORUŽĖLĖS;1341351994;Taip;0;18;0;18
9533;Ramunėlė;BORUŽĖLĖS;1041998279;Taip;10;0;0;10
9534;Ramunėlė;BORUŽĖLĖS;2859202237;Taip;15;1;0;16
9535;Ramunėlė;BORUŽĖLĖS;17273267465;Taip;5;3;1;9
9536;Ramunėlė;BORUŽĖLĖS;1709795078;Taip;0;14;0;14
9537;Ramunėlė;BORUŽĖLĖS;1077068878;Taip;18;0;0;18
9538;Ramunėlė;BORUŽĖLĖS;1207455851;Taip;8;0;0;8
9539;Ramunėlė;NYKŠTUKAS;2995509132;Taip;0;2;4;6
9540;Ramunėlė;NYKŠTUKAS;3301219357;Taip;0;2;0;2
9541;Ramunėlė;NYKŠTUKAS;6348171102;Taip;0;4;0;4
9542;Ramunėlė;NYKŠTUKAS;1800967823;Taip;0;1;4;5
9543;Ramunėlė;NYKŠTUKAS;7829765488;Taip;0;5;4;9
9544;Ramunėlė;NYKŠTUKAS;8205893352;Taip;6;5;0;11
9545;Ramunėlė;NYKŠTUKAS;4392309015;Taip;4;0;4;8
9546;Ramunėlė;NYKŠTUKAS;9984243153;Taip;11;2;0;13
9547;Ramunėlė;NYKŠTUKAS;8656417794;Taip;10;2;0;12
9548;Ramunėlė;NYKŠTUKAS;9663290607;Taip;17;0;0;17
9549;Ramunėlė;NYKŠTUKAS;2569491673;Taip;17;0;0;17
9550;Ramunėlė;NYKŠTUKAS;7902931560;Taip;4;4;0;8
9551;Ramunėlė;NYKŠTUKAS;3883411539;Taip;0;5;4;9
9552;Ramunėlė;NYKŠTUKAS;5049415445;Taip;0;0;1;1
9553;Ramunėlė;NYKŠTUKAS;5465647281;Taip;0;17;0;17
9554;Ramunėlė;NYKŠTUKAS;6809164145;Taip;5;0;7;12
9555;Ramunėlė;NYKŠTUKAS;5436185479;Taip;2;0;1;3
9556;Ramunėlė;UOGELĖ;6134554678;Taip;8;5;0;13
9557;Ramunėlė;UOGELĖ;8726443989;Taip;12;4;0;16
9558;Ramunėlė;UOGELĖ;7219400182;Taip;0;2;1;3
9559;Ramunėlė;UOGELĖ;3852734401;Taip;10;2;0;12
9560;Ramunėlė;UOGELĖ;1192743154;Taip;9;4;0;13
9561;Ramunėlė;UOGELĖ;5562960498;Taip;0;15;0;15
9562;Ramunėlė;UOGELĖ;1599595174;Taip;0;18;0;18
9563;Ramunėlė;UOGELĖ;1483391590;Taip;4;5;0;9
9564;Ramunėlė;UOGELĖ;8323020864;Taip;5;0;0;5
9565;Ramunėlė;UOGELĖ;8912978935;Taip;0;1;0;1
9566;Ramunėlė;UOGELĖ;9320573498;Taip;3;7;0;10
9567;Ramunėlė;UOGELĖ;5420360864;Taip;20;0;0;20
9568;Ramunėlė;UOGELĖ;3779769727;Taip;0;6;0;6
9569;Ramunėlė;UOGELĖ;4575123456;Taip;6;0;0;6
9570;Ramunėlė;UOGELĖ;3574886801;Taip;20;0;0;20
9571;Ramunėlė;VARPELIAI;3762539352;Taip;0;1;0;1
9572;Ramunėlė;VARPELIAI;2007790746;Taip;0;2;0;2
9573;Ramunėlė;VARPELIAI;6310921755;Taip;0;7;0;7
9574;Ramunėlė;VARPELIAI;3685786758;Taip;0;10;0;10
9575;Ramunėlė;VARPELIAI;7750405604;Taip;0;6;0;6
9576;Ramunėlė;VARPELIAI;58028743912;Taip;17;0;0;17
9577;Ramunėlė;VARPELIAI;4349250416;Taip;10;0;0;10
9578;Ramunėlė;VARPELIAI;3055294324;Taip;0;15;0;15
9579;Ramunėlė;VARPELIAI;6612728883;Taip;0;6;0;6
9580;Ramunėlė;VARPELIAI;1534723406;Taip;2;1;0;3
9581;Ramunėlė;VARPELIAI;7295041630;Taip;0;1;0;1
9582;Ramunėlė;VARPELIAI;1567537525;Taip;3;3;0;6
9583;Ramunėlė;VARPELIAI;1216101539;Taip;0;14;0;14
9584;Ramunėlė;VARPELIAI;4677819736;Taip;4;5;0;9
9585;Ramunėlė;VARPELIAI;6837072361;Taip;0;5;0;5
9586;Ramunėlė;VARPELIAI;1303053333;Taip;0;5;0;5
9587;Ramunėlė;VARPELIAI;6695672297;Taip;0;2;0;2
9588;Ramunėlė;VARPELIAI;7638038269;Taip;3;5;0;8
9589;Ramunėlė;VARPELIAI;3566074517;Taip;0;4;0;4
9590;Ramunėlė;VARPELIAI;7825538259;Taip;15;0;0;15
9591;Rūta;SMALSUČIAI;14391882157;Taip;4;0;5;9
9592;Rūta;SMALSUČIAI;18117978189;Taip;0;4;4;8
9593;Rūta;SMALSUČIAI;184041928;Taip;10;0;0;10
9594;Rūta;SMALSUČIAI;77285178781;Taip;0;2;1;3
9595;Rūta;SMALSUČIAI;45391890869;Ne;0;0;1;1
9596;Rūta;SMALSUČIAI;78953568121;Taip;3;10;0;13
9597;Rūta;SMALSUČIAI;89046897963;Taip;0;10;0;10
9598;Rūta;SMALSUČIAI;26152518052;Taip;0;5;0;5
9599;Rūta;SMALSUČIAI;68107516536;Taip;0;3;0;3
9600;Rūta;SMALSUČIAI;87692898919;Taip;5;5;4;14
9601;Rūta;SMALSUČIAI;1937805277;Taip;6;0;0;6
9602;Rūta;SMALSUČIAI;3874247966;Taip;10;5;0;15
9603;Rūta;SMALSUČIAI;1323253379;Taip;4;0;0;4
9604;Rūta;SMALSUČIAI;8604212304;Taip;0;8;0;8
9605;Rūta;SMALSUČIAI;38837808144;Taip;0;0;9;9
9606;Rūta;SMALSUČIAI;50814418724;Taip;0;7;0;7
9607;Rūta;SMALSUČIAI;1364470800;Taip;0;0;1;1
9608;Rūta;SMALSUČIAI;1996690514;Taip;0;4;0;4
9609;Rūta;SMALSUČIAI;59694891781;Taip;0;8;0;8
9610;Rūta;SMALSUČIAI;1945068716;Taip;3;3;0;6
9611;Rūta;SMALSUČIAI;83473072263;Taip;5;1;0;6
9612;Rūta;KŪLVERSTUKAI;1800198849;Taip;0;1;0;1
9613;Rūta;KŪLVERSTUKAI;1150292834;Taip;0;2;0;2
9614;Rūta;KŪLVERSTUKAI;56171468735;Taip;0;9;0;9
9615;Rūta;KŪLVERSTUKAI;88159609117;Taip;0;5;0;5
9616;Rūta;KŪLVERSTUKAI;48758751494;Taip;0;0;17;17
9617;Rūta;KŪLVERSTUKAI;2084379688;Taip;0;5;0;5
9618;Rūta;KŪLVERSTUKAI;1807332522;Taip;11;3;0;14
9619;Rūta;KŪLVERSTUKAI;1674584707;Taip;0;8;0;8
9620;Rūta;KŪLVERSTUKAI;2079429418;Taip;0;5;0;5
9621;Rūta;KŪLVERSTUKAI;1972150300;Taip;0;8;0;8
9622;Rūta;KŪLVERSTUKAI;99777522247;Taip;5;0;5;10
9623;Rūta;KŪLVERSTUKAI;50658624766;Taip;0;1;3;4
9624;Rūta;KŪLVERSTUKAI;1971925569;Taip;8;7;0;15
9625;Rūta;KŪLVERSTUKAI;56470874552;Taip;5;0;4;9
9626;Rūta;KŪLVERSTUKAI;17349566042;Taip;10;6;0;16
9627;Rūta;KŪLVERSTUKAI;10059496231;Taip;0;0;2;2
9628;Rūta;KŪLVERSTUKAI;1043614414;Taip;0;3;0;3
9629;Rūta;KODĖLČIUKAI;6136733410;Taip;0;0;10;10
9630;Rūta;KODĖLČIUKAI;8607455403;Taip;0;7;0;7
9631;Rūta;KODĖLČIUKAI;4168356825;Taip;0;0;3;3
9632;Rūta;KODĖLČIUKAI;1186493111;Taip;0;8;0;8
9633;Rūta;KODĖLČIUKAI;1390207547;Taip;2;0;0;2
9634;Rūta;KODĖLČIUKAI;9569447586;Taip;0;5;0;5
9635;Rūta;KODĖLČIUKAI;1579573872;Taip;5;0;0;5
9636;Rūta;KODĖLČIUKAI;32004750783;Taip;4;5;0;9
9637;Rūta;KODĖLČIUKAI;6982618655;Taip;0;13;0;13
9638;Rūta;KODĖLČIUKAI;1433704180;Taip;15;0;0;15
9639;Rūta;KODĖLČIUKAI;1671913833;Taip;0;16;0;16
9640;Rūta;KODĖLČIUKAI;4282074540;Taip;15;0;0;15
9641;Rūta;KODĖLČIUKAI;2677062861;Taip;5;0;0;5
9642;Rūta;KODĖLČIUKAI;1415664888;Taip;0;0;12;12
9643;Rūta;KODĖLČIUKAI;4426456302;Taip;5;0;0;5
9644;Rūta;KODĖLČIUKAI;7916863933;Taip;6;0;0;6
9645;Rūta;KODĖLČIUKAI;9675482322;Taip;0;1;10;11
9646;Rūta;KODĖLČIUKAI;2912054049;Taip;5;0;0;5
9647;Rūta;BORUŽĖLĖS;1346367896;Taip;0;3;0;3
9648;Rūta;BORUŽĖLĖS;8673942478;Taip;0;6;11;17
9649;Rūta;BORUŽĖLĖS;1521231573;Taip;10;0;2;12
9650;Rūta;BORUŽĖLĖS;1967141665;Taip;5;0;3;8
9651;Rūta;BORUŽĖLĖS;8889388348;Taip;4;3;1;8
9652;Rūta;BORUŽĖLĖS;8704594038;Taip;0;0;2;2
9653;Rūta;BORUŽĖLĖS;3478456813;Taip;10;1;0;11
9654;Rūta;BORUŽĖLĖS;1180144866;Taip;5;2;0;7
9655;Rūta;BORUŽĖLĖS;4078957924;Taip;5;0;2;7
9656;Rūta;BORUŽĖLĖS;4363571135;Taip;0;14;0;14
9657;Rūta;BORUŽĖLĖS;4754142240;Taip;0;5;0;5
9658;Rūta;BORUŽĖLĖS;2116581815;Taip;9;0;0;9
9659;Rūta;BORUŽĖLĖS;8851591109;Taip;18;0;0;18
9660;Rūta;BORUŽĖLĖS;7552644990;Taip;11;0;0;11
9661;Rūta;BORUŽĖLĖS;1336973131;Taip;0;4;0;4
9662;Rūta;BORUŽĖLĖS;7631229177;Taip;5;0;3;8
9663;Rūta;VYTURĖLIAI;1938200654;Taip;0;5;0;5
9664;Rūta;VYTURĖLIAI;14552031490;Taip;0;1;1;2
9665;Rūta;VYTURĖLIAI;46129637744;Taip;0;5;1;6
9666;Rūta;VYTURĖLIAI;58334018927;Taip;0;5;3;8
9667;Rūta;VYTURĖLIAI;24807873951;Taip;0;1;0;1
9668;Rūta;VYTURĖLIAI;86163505598;Taip;5;0;1;6
9669;Rūta;VYTURĖLIAI;89650991326;Taip;0;3;0;3
9670;Rūta;VYTURĖLIAI;86514347752;Taip;0;10;0;10
9671;Rūta;VYTURĖLIAI;8941291651;Taip;0;5;4;9
9672;Rūta;VYTURĖLIAI;92007397776;Taip;5;3;0;8
9673;Rūta;VYTURĖLIAI;92554408021;Taip;15;5;0;20
9674;Rūta;VYTURĖLIAI;27023480832;Taip;0;6;0;6
9675;Rūta;VYTURĖLIAI;87233420613;Taip;0;1;0;1
9676;Rūta;VYTURĖLIAI;90699177243;Taip;5;5;0;10
9677;Rūta;VYTURĖLIAI;70038163995;Taip;0;5;12;17
9678;Rūta;VYTURĖLIAI;56355568788;Taip;0;5;4;9
9679;Rūta;VYTURĖLIAI;74717101386;Taip;10;1;0;11
9680;Rūta;VYTURĖLIAI;67822551240;Taip;5;0;0;5
9681;Rūta;VYTURĖLIAI;18736757488;Taip;0;0;1;1
9682;Rūta;VYTURĖLIAI;8213932715;Taip;0;17;0;17
9683;Rūta;"PABIRUČIAI (LOGOPEDINĖ)";70608720189;Taip;10;0;0;10
9684;Rūta;"PABIRUČIAI (LOGOPEDINĖ)";57805651069;Taip;2;0;0;2
9685;Rūta;"PABIRUČIAI (LOGOPEDINĖ)";58313529531;Taip;8;0;0;8
9686;Rūta;"PABIRUČIAI (LOGOPEDINĖ)";97812491022;Taip;1;0;0;1
9687;Rūta;"PABIRUČIAI (LOGOPEDINĖ)";1489564914;Taip;0;14;0;14
9688;Rūta;"PABIRUČIAI (LOGOPEDINĖ)";45484303685;Taip;5;0;0;5
9689;Rūta;GUDRUČIAI;69788516459;Taip;3;0;0;3
9690;Rūta;GUDRUČIAI;78925728976;Ne;0;9;0;9
9691;Rūta;GUDRUČIAI;44365150696;Taip;0;9;0;9
9692;Rūta;GUDRUČIAI;10957816153;Taip;10;1;0;11
9693;Rūta;GUDRUČIAI;35843737071;Taip;0;5;1;6
9694;Rūta;GUDRUČIAI;13023764979;Taip;5;2;0;7
9695;Rūta;GUDRUČIAI;4409524323;Taip;5;0;1;6
9696;Rūta;GUDRUČIAI;2033577529;Taip;0;6;0;6
9697;Rūta;GUDRUČIAI;15393327975;Taip;0;4;0;4
9698;Rūta;GUDRUČIAI;79762491266;Taip;5;0;0;5
9699;Rūta;GUDRUČIAI;76831234529;Taip;0;5;0;5
9700;Rūta;GUDRUČIAI;24211514845;Taip;4;5;0;9
9701;Rūta;GUDRUČIAI;48213220767;Taip;2;15;0;17
9702;Rūta;GUDRUČIAI;50266063379;Ne;0;0;5;5
9703;Rūta;GUDRUČIAI;28676981495;Taip;0;5;0;5
9704;Rūta;GUDRUČIAI;81049938466;Taip;6;6;0;12
9705;Rūta;GUDRUČIAI;67740925555;Taip;0;4;2;6
9706;Rūta;GUDRUČIAI;34935546673;Taip;0;2;1;3
9707;Rūta;GUDRUČIAI;47869128534;Taip;0;2;1;3
9708;Rūta;GUDRUČIAI;28332403249;Taip;0;4;2;6
9709;Rūta;GUDRUČIAI;91072621203;Taip;9;5;0;14
9710;Rūta;SEKLYTĖLĖ;73486569144;Taip;0;5;2;7
9711;Rūta;SEKLYTĖLĖ;63130007113;Taip;0;2;0;2
9712;Rūta;SEKLYTĖLĖ;36767660286;Taip;0;5;0;5
9713;Rūta;SEKLYTĖLĖ;44422869429;Taip;0;6;0;6
9714;Rūta;SEKLYTĖLĖ;74600889000;Taip;0;8;0;8
9715;Rūta;SEKLYTĖLĖ;61614584274;Taip;0;0;1;1
9716;Rūta;SEKLYTĖLĖ;91160282230;Taip;0;5;1;6
9717;Rūta;SEKLYTĖLĖ;38233380265;Taip;4;6;0;10
9718;Rūta;SEKLYTĖLĖ;28539513133;Taip;10;0;0;10
9719;Rūta;SEKLYTĖLĖ;11116950913;Taip;0;5;0;5
9720;Rūta;SEKLYTĖLĖ;32768658491;Taip;0;6;2;8
9721;Rūta;SEKLYTĖLĖ;39447933171;Taip;1;1;0;2
9722;Rūta;SEKLYTĖLĖ;52426424863;Taip;0;3;3;6
9723;Rūta;SEKLYTĖLĖ;9037549271;Taip;3;6;2;11
9724;Rūta;SEKLYTĖLĖ;5905750207;Taip;0;1;3;4
9725;Rūta;SEKLYTĖLĖ;2080471128;Taip;0;4;2;6
9726;Rūta;SEKLYTĖLĖ;1168419924;Taip;10;4;0;14
9727;Rūta;"VARPELIAI (LOGOPEDINĖ)";13743264567;Taip;0;5;1;6
9728;Rūta;"VARPELIAI (LOGOPEDINĖ)";23413166816;Taip;0;2;0;2
9729;Rūta;"VARPELIAI (LOGOPEDINĖ)";97163853698;Taip;0;5;3;8
9730;Rūta;"VARPELIAI (LOGOPEDINĖ)";1617760535;Taip;5;0;0;5
9731;Rūta;KIŠKUČIŲ;4297300799;Taip;0;8;0;8
9732;Rūta;KIŠKUČIŲ;6207902435;Taip;15;0;0;15
9733;Rūta;KIŠKUČIŲ;9791861646;Taip;4;5;0;9
9734;Rūta;KIŠKUČIŲ;7434152435;Taip;0;0;1;1
9735;Rūta;KIŠKUČIŲ;8182243701;Taip;15;0;5;20
9736;Rūta;KIŠKUČIŲ;3454881685;Taip;5;0;0;5
9737;Rūta;KIŠKUČIŲ;3043164521;Taip;16;0;0;16
9738;Rūta;KIŠKUČIŲ;4293920701;Taip;7;0;0;7
9739;Rūta;KIŠKUČIŲ;1510268514;Taip;10;0;0;10
9740;Rūta;KIŠKUČIŲ;4728904136;Taip;0;17;0;17
9741;Rūta;KIŠKUČIŲ;9419809946;Taip;0;0;17;17
9742;Rūta;KIŠKUČIŲ;1811055786;Taip;0;0;9;9
9743;Rūta;KIŠKUČIŲ;2928803089;Taip;0;13;0;13
9744;Rūta;KIŠKUČIŲ;3875136625;Taip;6;0;0;6
9745;Rūta;KIŠKUČIŲ;2702537976;Taip;0;0;17;17
9746;Rūta;ŽVIRBLIUKAI;3499727608;Taip;9;6;0;15
9747;Rūta;ŽVIRBLIUKAI;9765301038;Taip;9;6;0;15
9748;Rūta;ŽVIRBLIUKAI;8277677952;Taip;5;0;6;11
9749;Rūta;ŽVIRBLIUKAI;9638495757;Taip;6;0;0;6
9750;Rūta;ŽVIRBLIUKAI;3956912957;Taip;15;0;0;15
9751;Rūta;ŽVIRBLIUKAI;3055345528;Taip;0;5;11;16
9752;Rūta;ŽVIRBLIUKAI;4423305209;Taip;15;5;0;20
9753;Rūta;ŽVIRBLIUKAI;2890569107;Taip;7;0;9;16
9754;Rūta;ŽVIRBLIUKAI;3964922552;Taip;0;3;6;9
9755;Rūta;ŽVIRBLIUKAI;1216786487;Taip;10;6;0;16
9756;Rūta;ŽVIRBLIUKAI;9736567509;Taip;16;0;0;16
9757;Rūta;ŽVIRBLIUKAI;2474991135;Taip;10;0;1;11
9758;Rūta;ŽVIRBLIUKAI;7519931138;Taip;6;0;4;10
9759;Rūta;ŽVIRBLIUKAI;9400586178;Taip;13;0;0;13
9760;Rūta;ŽVIRBLIUKAI;8395765508;Taip;8;0;0;8
9761;Rūta;SAULUTĖS;54140704807;Taip;0;5;8;13
9762;Rūta;SAULUTĖS;26830853793;Taip;4;0;0;4
9763;Rūta;SAULUTĖS;75322385068;Taip;0;6;0;6
9764;Rūta;SAULUTĖS;76518034714;Taip;0;1;0;1
9765;Rūta;SAULUTĖS;79192262053;Taip;3;4;2;9
9766;Rūta;SAULUTĖS;42791864630;Taip;0;2;1;3
9767;Rūta;SAULUTĖS;61864833085;Taip;0;1;1;2
9768;Rūta;SAULUTĖS;20967345257;Taip;4;0;0;4
9769;Rūta;SAULUTĖS;89880409419;Taip;0;3;1;4
9770;Rūta;SAULUTĖS;50734030014;Taip;3;5;0;8
9771;Rūta;SAULUTĖS;29240858006;Taip;15;5;0;20
9772;Rūta;SAULUTĖS;75730421646;Taip;0;13;0;13
9773;Rūta;SAULUTĖS;732948370;Ne;5;5;0;10
9774;Rūta;SAULUTĖS;2711671531;Taip;15;5;0;20
9775;Rūta;SAULUTĖS;1545183162;Taip;3;0;1;4
9776;Rūta;SAULUTĖS;5733023163;Taip;0;0;8;8
9777;Rūta;SAULUTĖS;7061384784;Taip;0;0;7;7
9778;Rūta;SAULUTĖS;9994442882;Taip;0;4;0;4
9779;Rūta;SAULUTĖS;2188905055;Taip;0;11;0;11
9780;Sadutė;Kiškučiai;38918375280;Taip;0;1;0;1
9781;Sadutė;Kiškučiai;42447771280;Taip;4;1;0;5
9782;Sadutė;Kiškučiai;62408324442;Taip;4;0;3;7
9783;Sadutė;Kiškučiai;12421864073;Ne;1;7;0;8
9784;Sadutė;Kiškučiai;3253659165;Taip;0;4;0;4
9785;Sadutė;Kiškučiai;98527988102;Taip;0;5;0;5
9786;Sadutė;Kiškučiai;75149739907;Taip;0;1;0;1
9787;Sadutė;Kiškučiai;48298497;Taip;0;10;0;10
9788;Sadutė;Kiškučiai;61357382189;Taip;2;6;0;8
9789;Sadutė;Kiškučiai;1433422421;Taip;13;1;1;15
9790;Sadutė;Kiškučiai;73649870571;Taip;10;0;10;20
9791;Sadutė;Kiškučiai;1092421263;Taip;4;0;0;4
9792;Sadutė;Kiškučiai;1291782232;Taip;0;0;3;3
9793;Sadutė;Kiškučiai;5586949339;Taip;3;0;2;5
9794;Sadutė;Kiškučiai;64959385010;Taip;0;6;0;6
9795;Sadutė;Kiškučiai;9883685724;Taip;10;6;0;16
9796;Sadutė;Kiškučiai;4525909977;Taip;5;1;0;6
9797;Sadutė;Kiškučiai;1533081218;Taip;0;2;0;2
9798;Sadutė;Kiškučiai;3400524440;Taip;0;0;3;3
9799;Sadutė;Boružėlės;31020557647;Taip;3;0;9;12
9800;Sadutė;Boružėlės;99171108375;Taip;3;1;0;4
9801;Sadutė;Boružėlės;30046732620;Taip;3;1;0;4
9802;Sadutė;Boružėlės;91943880567;Taip;3;0;0;3
9803;Sadutė;Boružėlės;70505797915;Taip;18;0;0;18
9804;Sadutė;Boružėlės;48817619537;Taip;0;6;0;6
9805;Sadutė;Boružėlės;76464399248;Taip;0;0;1;1
9806;Sadutė;Boružėlės;47883796567;Taip;0;5;2;7
9807;Sadutė;Boružėlės;93561298785;Taip;0;5;0;5
9808;Sadutė;Boružėlės;48327367042;Taip;0;0;16;16
9809;Sadutė;Boružėlės;4064111008;Taip;0;5;3;8
9810;Sadutė;Boružėlės;35237170892;Taip;2;3;0;5
9811;Sadutė;Boružėlės;45569403734;Taip;5;1;0;6
9812;Sadutė;Boružėlės;15950584691;Taip;7;0;0;7
9813;Sadutė;Boružėlės;84758378727;Taip;0;0;1;1
9814;Sadutė;Boružėlės;38373089101;Taip;0;4;0;4
9815;Sadutė;Boružėlės;13779484979;Taip;0;5;0;5
9816;Sadutė;Boružėlės;12989960431;Taip;0;5;1;6
9817;Sadutė;Boružėlės;2414632774;Taip;11;1;1;13
9818;Sadutė;Boružėlės;16493384211;Taip;7;1;6;14
9819;Sadutė;Boružėlės;71576294118;Taip;2;0;5;7
9820;Sadutė;Boružėlės;21011440269;Taip;0;0;4;4
9821;Sadutė;Boružėlės;39222963335;Taip;7;0;1;8
9822;Sadutė;Boružėlės;4695479762;Taip;12;0;0;12
9823;Sadutė;Boružėlės;1920496059;Taip;0;2;7;9
9824;Sadutė;Bitutės;85407883222;Taip;0;5;0;5
9825;Sadutė;Bitutės;68864977379;Taip;0;2;0;2
9826;Sadutė;Bitutės;37258486995;Taip;8;5;0;13
9827;Sadutė;Bitutės;70825850509;Taip;0;5;1;6
9828;Sadutė;Bitutės;15479694222;Ne;0;7;0;7
9829;Sadutė;Bitutės;23009676870;Taip;0;0;2;2
9830;Sadutė;Bitutės;67724608574;Taip;0;2;2;4
9831;Sadutė;Bitutės;30996415525;Taip;0;6;0;6
9832;Sadutė;Bitutės;61807934102;Taip;2;0;0;2
9833;Sadutė;Bitutės;40775963018;Taip;0;5;4;9
9834;Sadutė;Bitutės;38489473571;Taip;0;5;1;6
9835;Sadutė;Bitutės;60705293244;Taip;0;1;0;1
9836;Sadutė;Bitutės;71457072146;Taip;0;2;0;2
9837;Sadutė;Bitutės;6937310439;Taip;0;8;3;11
9838;Sadutė;Bitutės;64711220209;Taip;0;2;0;2
9839;Sadutė;Bitutės;71687440687;Taip;0;3;2;5
9840;Sadutė;Bitutės;5143204888;Ne;0;6;0;6
9841;Sadutė;Bitutės;68856441792;Taip;2;6;0;8
9842;Sadutė;Bitutės;63476202833;Taip;0;5;0;5
9843;Sadutė;Bitutės;22648108782;Taip;0;3;0;3
9844;Sadutė;Bitutės;64311208989;Taip;0;2;0;2
9845;Sadutė;Bitutės;78335876444;Taip;0;1;1;2
9846;Sadutė;Bitutės;50846021514;Taip;0;5;1;6
9847;Sadutė;Drugeliai;1552350084;Taip;11;0;3;14
9848;Sadutė;Drugeliai;7910380894;Taip;5;1;0;6
9849;Sadutė;Drugeliai;2467800545;Taip;10;0;0;10
9850;Sadutė;Drugeliai;4402558234;Taip;5;1;0;6
9851;Sadutė;Drugeliai;8713575864;Taip;2;0;0;2
9852;Sadutė;Drugeliai;6994547344;Taip;0;0;1;1
9853;Sadutė;Drugeliai;1782594187;Taip;8;3;0;11
9854;Sadutė;Drugeliai;5816844295;Taip;12;0;0;12
9855;Sadutė;Drugeliai;2095914442;Taip;13;0;0;13
9856;Sadutė;Drugeliai;8803249656;Taip;18;0;0;18
9857;Sadutė;Drugeliai;4901634532;Taip;5;0;0;5
9858;Sadutė;Drugeliai;6196282159;Taip;13;5;0;18
9859;Sadutė;Drugeliai;8953107298;Taip;14;0;2;16
9860;Sadutė;Drugeliai;5139219626;Taip;5;0;0;5
9861;Sadutė;Drugeliai;1735450955;Taip;5;1;1;7
9862;Sadutė;Drugeliai;2064784580;Taip;5;1;1;7
9863;Sadutė;Drugeliai;2883991326;Taip;15;0;0;15
9864;Sadutė;Pėledžiukai;26761581977;Taip;13;2;0;15
9865;Sadutė;Pėledžiukai;1885941594;Taip;3;8;0;11
9866;Sadutė;Pėledžiukai;4933574100;Taip;6;0;3;9
9867;Sadutė;Pėledžiukai;6105924871;Taip;5;0;2;7
9868;Sadutė;Pėledžiukai;8870465478;Taip;3;6;0;9
9869;Sadutė;Pėledžiukai;64835095908;Taip;4;0;0;4
9870;Sadutė;Pėledžiukai;3619323573;Taip;0;0;2;2
9871;Sadutė;Pėledžiukai;14962142857;Taip;8;7;0;15
9872;Sadutė;Pėledžiukai;92111253012;Taip;2;0;0;2
9873;Sadutė;Pėledžiukai;1594844154;Taip;0;5;0;5
9874;Sadutė;Pėledžiukai;1005751811;Taip;6;0;1;7
9875;Sadutė;Pėledžiukai;61450959987;Taip;5;0;0;5
9876;Sadutė;Pėledžiukai;45981672295;Taip;0;1;4;5
9877;Sadutė;Pėledžiukai;8667620186;Taip;0;5;5;10
9878;Sadutė;Pėledžiukai;9946417453;Taip;0;5;0;5
9879;Sadutė;Pėledžiukai;48818906299;Taip;14;0;1;15
9880;Sadutė;Pėledžiukai;1190667513;Taip;0;2;7;9
9881;Sadutė;Pėledžiukai;1988169256;Taip;0;0;3;3
9882;Sadutė;Pėledžiukai;2004943639;Taip;0;5;0;5
9883;Sadutė;Kačiukų;1507052440;Taip;0;5;5;10
9884;Sadutė;Kačiukų;1903961488;Taip;5;5;3;13
9885;Sadutė;Kačiukų;2890916313;Taip;0;20;0;20
9886;Sadutė;Kačiukų;3993181500;Taip;0;0;3;3
9887;Sadutė;Kačiukų;1759479328;Taip;0;20;0;20
9888;Sadutė;Kačiukų;8835627470;Taip;4;0;5;9
9889;Sadutė;Kačiukų;1975767401;Taip;0;1;0;1
9890;Sadutė;Kačiukų;2532626934;Taip;0;6;0;6
9891;Sadutė;Kačiukų;2466024649;Taip;0;0;1;1
9892;Sadutė;Kačiukų;6253351299;Taip;3;1;0;4
9893;Sadutė;Kačiukų;8974374101;Taip;0;20;0;20
9894;Sadutė;Kačiukų;9285865812;Taip;12;0;0;12
9895;Sadutė;Kačiukų;4401870028;Taip;0;0;5;5
9896;Sakalėlis;GIRINUKŲ;18298832212;Taip;0;5;0;5
9897;Sakalėlis;GIRINUKŲ;2124748537;Taip;8;0;4;12
9898;Sakalėlis;GIRINUKŲ;97259304899;Taip;3;2;0;5
9899;Sakalėlis;GIRINUKŲ;8952808128;Taip;0;0;4;4
9900;Sakalėlis;GIRINUKŲ;1605682818;Taip;0;9;0;9
9901;Sakalėlis;GIRINUKŲ;68379930730;Taip;0;5;3;8
9902;Sakalėlis;GIRINUKŲ;1538847469;Taip;0;6;0;6
9903;Sakalėlis;GIRINUKŲ;57477662126;Taip;0;5;1;6
9904;Sakalėlis;GIRINUKŲ;78050507580;Taip;15;0;0;15
9905;Sakalėlis;GIRINUKŲ;11432510669;Taip;7;0;0;7
9906;Sakalėlis;GIRINUKŲ;19456041826;Taip;1;5;4;10
9907;Sakalėlis;GIRINUKŲ;28930740067;Taip;2;0;0;2
9908;Sakalėlis;GIRINUKŲ;88344653299;Taip;5;0;0;5
9909;Sakalėlis;GIRINUKŲ;15950016412;Taip;4;5;0;9
9910;Sakalėlis;GIRINUKŲ;87950904971;Taip;0;5;0;5
9911;Sakalėlis;GIRINUKŲ;1075787529;Taip;0;5;4;9
9912;Sakalėlis;GIRINUKŲ;44702801581;Taip;0;5;3;8
9913;Sakalėlis;GIRINUKŲ;3995095832;Taip;0;0;4;4
9914;Sakalėlis;GIRINUKŲ;9634589602;Taip;0;0;4;4
9915;Sakalėlis;VYTURIUKŲ;330571735;Taip;0;6;0;6
9916;Sakalėlis;VYTURIUKŲ;36411138178;Taip;0;0;2;2
9917;Sakalėlis;VYTURIUKŲ;7852180045;Taip;3;3;2;8
9918;Sakalėlis;VYTURIUKŲ;27291131963;Taip;0;6;0;6
9919;Sakalėlis;VYTURIUKŲ;1822130260;Taip;5;10;0;15
9920;Sakalėlis;VYTURIUKŲ;33360718659;Taip;0;1;0;1
9921;Sakalėlis;VYTURIUKŲ;99937511623;Taip;3;5;2;10
9922;Sakalėlis;VYTURIUKŲ;14495611614;Taip;0;5;0;5
9923;Sakalėlis;VYTURIUKŲ;32956243898;Taip;2;0;1;3
9924;Sakalėlis;VYTURIUKŲ;87806505145;Taip;0;0;2;2
9925;Sakalėlis;VYTURIUKŲ;59067963901;Taip;17;0;0;17
9926;Sakalėlis;VYTURIUKŲ;1371469574;Taip;0;5;0;5
9927;Sakalėlis;VYTURIUKŲ;52975188309;Taip;0;5;0;5
9928;Sakalėlis;VYTURIUKŲ;74622921410;Taip;0;5;2;7
9929;Sakalėlis;VYTURIUKŲ;13953070987;Taip;10;5;0;15
9930;Sakalėlis;VYTURIUKŲ;12474715312;Taip;0;5;0;5
9931;Sakalėlis;VYTURIUKŲ;80747256105;Taip;0;0;5;5
9932;Sakalėlis;VYTURIUKŲ;77801416034;Taip;10;0;4;14
9933;Sakalėlis;VYTURIUKŲ;12601081196;Taip;0;8;3;11
9934;Sakalėlis;DRUGELIŲ;21956747394;Taip;0;3;4;7
9935;Sakalėlis;DRUGELIŲ;98983107357;Taip;0;2;1;3
9936;Sakalėlis;DRUGELIŲ;56809646636;Taip;0;10;0;10
9937;Sakalėlis;DRUGELIŲ;25352655265;Taip;0;13;0;13
9938;Sakalėlis;DRUGELIŲ;45025342634;Taip;0;6;1;7
9939;Sakalėlis;DRUGELIŲ;56640981370;Taip;10;3;5;18
9940;Sakalėlis;DRUGELIŲ;91226844252;Taip;0;1;0;1
9941;Sakalėlis;DRUGELIŲ;86990914938;Taip;0;5;6;11
9942;Sakalėlis;DRUGELIŲ;72249916736;Taip;2;0;0;2
9943;Sakalėlis;DRUGELIŲ;76192257851;Taip;5;2;0;7
9944;Sakalėlis;DRUGELIŲ;15476097840;Taip;0;0;1;1
9945;Sakalėlis;DRUGELIŲ;2997731442;Taip;1;5;0;6
9946;Sakalėlis;DRUGELIŲ;43454117;Taip;8;4;0;12
9947;Sakalėlis;DRUGELIŲ;40651927926;Taip;0;5;6;11
9948;Sakalėlis;DRUGELIŲ;62214587998;Taip;4;1;0;5
9949;Sakalėlis;DRUGELIŲ;50107185320;Taip;5;5;0;10
9950;Sakalėlis;DRUGELIŲ;1320801494;Taip;0;0;3;3
9951;Sakalėlis;DRUGELIŲ;10560758846;Taip;2;5;0;7
9952;Sakalėlis;DRUGELIŲ;85527501724;Taip;2;5;0;7
9953;Sakalėlis;DRUGELIŲ;52603313942;Taip;0;5;0;5
9954;Sakalėlis;DRUGELIŲ;69625812172;Taip;0;5;0;5
9955;Sakalėlis;GENIUKŲ;58012583231;Ne;5;0;0;5
9956;Sakalėlis;GENIUKŲ;1114100138;Ne;0;5;10;15
9957;Sakalėlis;GENIUKŲ;11803756564;Taip;0;7;5;12
9958;Sakalėlis;GENIUKŲ;57612724915;Taip;7;5;0;12
9959;Sakalėlis;GENIUKŲ;63956070819;Taip;10;5;0;15
9960;Sakalėlis;GENIUKŲ;98322175734;Taip;15;5;0;20
9961;Sakalėlis;GENIUKŲ;70569243858;Taip;10;5;0;15
9962;Sakalėlis;GENIUKŲ;87968405810;Taip;5;5;0;10
9963;Sakalėlis;GENIUKŲ;72599730052;Taip;5;0;0;5
9964;Sakalėlis;GENIUKŲ;72915270234;Taip;10;5;0;15
9965;Sakalėlis;GENIUKŲ;24174522552;Taip;0;2;2;4
9966;Sakalėlis;GENIUKŲ;87799673875;Taip;8;5;1;14
9967;Sakalėlis;GENIUKŲ;47647167225;Taip;0;0;1;1
9968;Sakalėlis;GENIUKŲ;31894397351;Taip;4;5;0;9
9969;Sakalėlis;GENIUKŲ;72289518955;Taip;0;11;0;11
9970;Sakalėlis;GENIUKŲ;13087021336;Taip;2;4;7;13
9971;Sakalėlis;GENIUKŲ;96677994919;Taip;0;5;0;5
9972;Sakalėlis;GENIUKŲ;82248904456;Taip;0;5;0;5
9973;Sakalėlis;GENIUKŲ;23722033078;Taip;1;5;1;7
9974;Sakalėlis;GENIUKŲ;78556677636;Taip;5;5;3;13
9975;Sakalėlis;GENIUKŲ;1321373130;Taip;9;5;0;14
9976;Sakalėlis;GENIUKŲ;45174515952;Taip;5;5;0;10
9977;Sakalėlis;GENIUKŲ;31151919975;Taip;8;0;0;8
9978;Sakalėlis;VOVERIUKŲ;4430763418;Taip;0;10;0;10
9979;Sakalėlis;VOVERIUKŲ;6190741162;Taip;11;0;2;13
9980;Sakalėlis;VOVERIUKŲ;1702964714;Taip;17;0;0;17
9981;Sakalėlis;VOVERIUKŲ;1839096675;Taip;12;0;0;12
9982;Sakalėlis;VOVERIUKŲ;4495453007;Taip;16;0;0;16
9983;Sakalėlis;VOVERIUKŲ;1141943082;Taip;6;0;0;6
9984;Sakalėlis;VOVERIUKŲ;3962436122;Taip;6;0;0;6
9985;Sakalėlis;VOVERIUKŲ;1946531018;Taip;14;0;0;14
9986;Sakalėlis;VOVERIUKŲ;2796230671;Taip;3;5;3;11
9987;Sakalėlis;VOVERIUKŲ;1210451022;Taip;0;0;3;3
9988;Sakalėlis;VOVERIUKŲ;1912068116;Taip;14;0;0;14
9989;Sakalėlis;VOVERIUKŲ;8662137531;Taip;5;5;0;10
9990;Sakalėlis;VOVERIUKŲ;1104881142;Taip;15;0;0;15
9991;Sakalėlis;VOVERIUKŲ;46629941288;Taip;10;0;0;10
9992;Sakalėlis;VOVERIUKŲ;3678172501;Taip;10;6;0;16
9993;Sakalėlis;VOVERIUKŲ;1133377117;Taip;14;0;0;14
9994;Sakalėlis;VOVERIUKŲ;5782214279;Taip;17;0;0;17
9995;Sakalėlis;VOVERIUKŲ;22614338778;Taip;6;0;0;6
9996;Sakalėlis;VOVERIUKŲ;34464485043;Taip;8;0;12;20
9997;Sakalėlis;VOVERIUKŲ;30987215315;Taip;16;0;0;16
9998;Sakalėlis;VOVERIUKŲ;7567476424;Taip;15;0;0;15
9999;Sakalėlis;VOVERIUKŲ;6180987643;Taip;10;0;5;15
10000;Sakalėlis;PĖLEDŽIUKŲ;1974955778;Taip;15;5;0;20
10001;Sakalėlis;PĖLEDŽIUKŲ;4573623341;Taip;0;5;3;8
10002;Sakalėlis;PĖLEDŽIUKŲ;60463584826;Taip;0;1;0;1
10003;Sakalėlis;PĖLEDŽIUKŲ;1359444361;Taip;0;5;2;7
10004;Sakalėlis;PĖLEDŽIUKŲ;3781188811;Taip;1;5;1;7
10005;Sakalėlis;PĖLEDŽIUKŲ;32890764904;Taip;0;0;3;3
10006;Sakalėlis;PĖLEDŽIUKŲ;89579043958;Taip;0;10;0;10
10007;Sakalėlis;PĖLEDŽIUKŲ;54902207576;Taip;0;1;0;1
10008;Sakalėlis;PĖLEDŽIUKŲ;81593611262;Taip;0;0;1;1
10009;Sakalėlis;PĖLEDŽIUKŲ;33825546706;Taip;7;0;0;7
10010;Sakalėlis;PĖLEDŽIUKŲ;1790571847;Taip;0;0;2;2
10011;Sakalėlis;PĖLEDŽIUKŲ;81361557297;Taip;10;0;8;18
10012;Sakalėlis;PĖLEDŽIUKŲ;39504139934;Taip;5;5;0;10
10013;Sakalėlis;PĖLEDŽIUKŲ;2134118895;Taip;0;0;1;1
10014;Sakalėlis;PĖLEDŽIUKŲ;67193921335;Taip;12;0;0;12
10015;Sakalėlis;PĖLEDŽIUKŲ;6301366135;Taip;0;0;1;1
10016;Sakalėlis;PĖLEDŽIUKŲ;37201848270;Taip;0;0;1;1
10017;Sakalėlis;PĖLEDŽIUKŲ;49947049847;Taip;0;2;2;4
10018;Sakalėlis;PĖLEDŽIUKŲ;4364341933;Taip;3;0;0;3
10019;Sakalėlis;PĖLEDŽIUKŲ;79413947806;Taip;0;1;0;1
10020;Sakalėlis;"BITUČIŲ (LOGOPEDINĖ)";1139467130;Taip;4;3;2;9
10021;Sakalėlis;"BITUČIŲ (LOGOPEDINĖ)";4649447372;Taip;2;0;8;10
10022;Sakalėlis;"BITUČIŲ (LOGOPEDINĖ)";1219441890;Taip;11;0;0;11
10023;Sakalėlis;"BITUČIŲ (LOGOPEDINĖ)";16884257622;Taip;0;0;1;1
10024;Sakalėlis;"BITUČIŲ (LOGOPEDINĖ)";4086981816;Ne;0;0;7;7
10025;Sakalėlis;"BITUČIŲ (LOGOPEDINĖ)";4716949191;Taip;7;0;1;8
10026;Sakalėlis;"BITUČIŲ (LOGOPEDINĖ)";7241416465;Taip;8;5;2;15
10027;Sakalėlis;"BITUČIŲ (LOGOPEDINĖ)";2074868084;Taip;0;20;0;20
10028;Sakalėlis;"BITUČIŲ (LOGOPEDINĖ)";6321575268;Taip;0;0;1;1
10029;Sakalėlis;"BITUČIŲ (LOGOPEDINĖ)";9740003273;Taip;2;1;4;7
10030;Sakalėlis;"BITUČIŲ (LOGOPEDINĖ)";1384225025;Taip;17;0;0;17
10031;Sakalėlis;"BITUČIŲ (LOGOPEDINĖ)";8852001037;Taip;0;5;5;10
10032;Sakalėlis;"BORUŽIUKŲ (LOGOPEDINĖ)";92557587855;Taip;13;0;0;13
10033;Sakalėlis;"BORUŽIUKŲ (LOGOPEDINĖ)";11871226177;Taip;0;1;0;1
10034;Sakalėlis;"BORUŽIUKŲ (LOGOPEDINĖ)";32402268054;Taip;0;2;0;2
10035;Sakalėlis;"BORUŽIUKŲ (LOGOPEDINĖ)";1765370689;Taip;10;5;0;15
10036;Sakalėlis;"BORUŽIUKŲ (LOGOPEDINĖ)";22863239773;Taip;0;0;1;1
10037;Sakalėlis;"BORUŽIUKŲ (LOGOPEDINĖ)";70791762492;Taip;0;5;1;6
10038;Sakalėlis;"BORUŽIUKŲ (LOGOPEDINĖ)";9452901338;Taip;5;5;0;10
10039;Sakalėlis;"BORUŽIUKŲ (LOGOPEDINĖ)";76019778588;Taip;0;9;1;10
10040;Sakalėlis;"BORUŽIUKŲ (LOGOPEDINĖ)";4514546151;Taip;5;2;0;7
10041;Sakalėlis;"BORUŽIUKŲ (LOGOPEDINĖ)";50037388220;Taip;0;8;0;8
10042;Sakalėlis;MEŠKUČIŲ;1027765680;Taip;0;4;0;4
10043;Sakalėlis;MEŠKUČIŲ;3371763993;Taip;0;5;0;5
10044;Sakalėlis;MEŠKUČIŲ;4515180509;Taip;0;0;5;5
10045;Sakalėlis;MEŠKUČIŲ;2829386777;Taip;10;0;0;10
10046;Sakalėlis;MEŠKUČIŲ;8936933971;Taip;0;0;7;7
10047;Sakalėlis;MEŠKUČIŲ;96053733139;Taip;3;7;0;10
10048;Sakalėlis;MEŠKUČIŲ;1552929452;Taip;0;5;1;6
10049;Sakalėlis;MEŠKUČIŲ;1526540031;Taip;8;7;0;15
10050;Sakalėlis;MEŠKUČIŲ;7987368969;Taip;0;5;6;11
10051;Sakalėlis;MEŠKUČIŲ;8649226611;Taip;2;0;0;2
10052;Sakalėlis;MEŠKUČIŲ;4612388683;Taip;0;17;0;17
10053;Sakalėlis;MEŠKUČIŲ;4775685174;Taip;0;1;0;1
10054;Sakalėlis;MEŠKUČIŲ;4763858893;Taip;0;5;5;10
10055;Sakalėlis;MEŠKUČIŲ;5717022080;Taip;0;5;0;5
10056;Sakalėlis;MEŠKUČIŲ;69916351348;Taip;20;0;0;20
10057;Sakalėlis;MEŠKUČIŲ;7159705304;Taip;1;0;0;1
10058;Sakalėlis;MEŠKUČIŲ;3337299648;Taip;15;0;0;15
10059;Sakalėlis;MEŠKUČIŲ;81681433432;Taip;3;0;0;3
10060;Sakalėlis;MEŠKUČIŲ;2902195855;Taip;0;5;0;5
10061;Sakalėlis;MEŠKUČIŲ;6727251397;Taip;0;18;0;18
10062;Sakalėlis;KIŠKUČIŲ;5496044442;Taip;13;0;0;13
10063;Sakalėlis;KIŠKUČIŲ;2474164013;Taip;15;0;0;15
10064;Sakalėlis;KIŠKUČIŲ;5405669698;Taip;15;0;0;15
10065;Sakalėlis;KIŠKUČIŲ;9493905856;Taip;0;0;4;4
10066;Sakalėlis;KIŠKUČIŲ;6603105354;Taip;5;0;0;5
10067;Sakalėlis;KIŠKUČIŲ;3418702674;Taip;6;2;0;8
10068;Sakalėlis;KIŠKUČIŲ;3748865437;Taip;2;0;0;2
10069;Sakalėlis;KIŠKUČIŲ;8667155756;Taip;7;0;0;7
10070;Sakalėlis;KIŠKUČIŲ;4458071075;Taip;0;0;7;7
10071;Sakalėlis;KIŠKUČIŲ;4209146744;Taip;4;0;0;4
10072;Sakalėlis;KIŠKUČIŲ;2780141413;Taip;0;5;0;5
10073;Sakalėlis;KIŠKUČIŲ;4596727938;Taip;5;0;0;5
10074;Sakalėlis;KIŠKUČIŲ;3333037807;Taip;20;0;0;20
10075;Sakalėlis;KIŠKUČIŲ;6700169944;Taip;15;0;0;15
10076;Sakalėlis;KIŠKUČIŲ;8790189865;Taip;5;0;0;5
10077;Sakalėlis;SVIRPLIUKŲ;9322351120;Taip;0;0;14;14
10078;Sakalėlis;SVIRPLIUKŲ;3680732318;Taip;5;6;0;11
10079;Sakalėlis;SVIRPLIUKŲ;4862004373;Taip;8;1;0;9
10080;Sakalėlis;SVIRPLIUKŲ;6579827280;Taip;11;1;0;12
10081;Sakalėlis;SVIRPLIUKŲ;6806170544;Taip;11;0;0;11
10082;Sakalėlis;SVIRPLIUKŲ;8381310908;Taip;13;0;1;14
10083;Sakalėlis;SVIRPLIUKŲ;5795250727;Taip;5;5;0;10
10084;Sakalėlis;SVIRPLIUKŲ;2985239904;Taip;4;5;0;9
10085;Sakalėlis;SVIRPLIUKŲ;3351218789;Taip;20;0;0;20
10086;Sakalėlis;SVIRPLIUKŲ;3927363997;Taip;4;2;0;6
10087;Sakalėlis;SVIRPLIUKŲ;9120873899;Taip;8;12;0;20
10088;Sakalėlis;SVIRPLIUKŲ;1347171934;Taip;12;0;0;12
10089;Sakalėlis;SVIRPLIUKŲ;7672947538;Taip;16;0;0;16
10090;Sakalėlis;SVIRPLIUKŲ;5233697077;Taip;1;0;14;15
10091;Sakalėlis;SVIRPLIUKŲ;2539006620;Taip;0;20;0;20
10092;Sakalėlis;SVIRPLIUKŲ;7285833058;Taip;20;0;0;20
10093;Salininkų;BORUŽIUKAI;61252066272;Taip;4;0;0;4
10094;Salininkų;BORUŽIUKAI;10179604964;Taip;0;15;0;15
10095;Salininkų;BORUŽIUKAI;86262807558;Taip;0;2;1;3
10096;Salininkų;BORUŽIUKAI;81713688097;Taip;6;6;0;12
10097;Salininkų;BORUŽIUKAI;74503311061;Taip;0;5;1;6
10098;Salininkų;BORUŽIUKAI;32201000670;Taip;0;14;0;14
10099;Salininkų;BORUŽIUKAI;93466518815;Taip;14;4;0;18
10100;Salininkų;BORUŽIUKAI;75056599725;Taip;0;5;0;5
10101;Salininkų;BORUŽIUKAI;39675001939;Taip;0;5;0;5
10102;Salininkų;BORUŽIUKAI;16879258172;Taip;0;5;5;10
10103;Salininkų;BORUŽIUKAI;2097313917;Taip;0;5;0;5
10104;Salininkų;BORUŽIUKAI;87653480003;Taip;0;15;0;15
10105;Salininkų;BORUŽIUKAI;1614501473;Taip;6;5;0;11
10106;Salininkų;BORUŽIUKAI;1632485114;Taip;15;0;0;15
10107;Salininkų;BORUŽIUKAI;40053462731;Ne;0;12;0;12
10108;Salininkų;BORUŽIUKAI;54352547774;Taip;0;2;3;5
10109;Salininkų;BORUŽIUKAI;1364275404;Taip;5;5;0;10
10110;Salininkų;BORUŽIUKAI;77477857775;Taip;6;0;0;6
10111;Salininkų;BORUŽIUKAI;8258045565;Taip;0;5;0;5
10112;Salininkų;BORUŽIUKAI;6978618796;Taip;20;0;0;20
10113;Salininkų;BORUŽIUKAI;8897523583;Taip;6;1;0;7
10114;Salininkų;BORUŽIUKAI;1507178637;Taip;6;1;0;7
10115;Salininkų;BORUŽIUKAI;88149790626;Taip;14;1;0;15
10116;Salininkų;GĖLYTĖS;3015863723;Taip;5;10;0;15
10117;Salininkų;GĖLYTĖS;3323233525;Taip;5;10;0;15
10118;Salininkų;GĖLYTĖS;1832393272;Taip;10;0;0;10
10119;Salininkų;GĖLYTĖS;7665409499;Taip;19;0;0;19
10120;Salininkų;GĖLYTĖS;9890660815;Taip;20;0;0;20
10121;Salininkų;GĖLYTĖS;4323257798;Taip;0;6;0;6
10122;Salininkų;GĖLYTĖS;6850925495;Taip;5;5;1;11
10123;Salininkų;GĖLYTĖS;3585435095;Taip;11;0;0;11
10124;Salininkų;GĖLYTĖS;2760231414;Taip;13;0;0;13
10125;Salininkų;GĖLYTĖS;9724367035;Taip;10;5;0;15
10126;Salininkų;GĖLYTĖS;1658695150;Taip;0;5;0;5
10127;Salininkų;GĖLYTĖS;7383557807;Taip;10;10;0;20
10128;Salininkų;GĖLYTĖS;9344614003;Taip;15;0;0;15
10129;Salininkų;GĖLYTĖS;2808778763;Taip;5;0;0;5
10130;Salininkų;GĖLYTĖS;6656578271;Taip;0;5;0;5
10131;Salininkų;GĖLYTĖS;2278499562;Taip;10;0;0;10
10132;Salininkų;GĖLYTĖS;8995565864;Taip;15;3;0;18
10133;Salininkų;GĖLYTĖS;8394582546;Taip;0;15;0;15
10134;Salininkų;GĖLYTĖS;6327046935;Taip;16;0;0;16
10135;Salininkų;DRUGELIAI;1641123436;Taip;20;0;0;20
10136;Salininkų;DRUGELIAI;1910467994;Taip;15;1;0;16
10137;Salininkų;DRUGELIAI;2812554783;Taip;10;5;0;15
10138;Salininkų;DRUGELIAI;14626363996;Taip;0;2;0;2
10139;Salininkų;DRUGELIAI;1883307260;Taip;0;5;0;5
10140;Salininkų;DRUGELIAI;1948988168;Taip;11;5;0;16
10141;Salininkų;DRUGELIAI;1868857584;Taip;0;4;0;4
10142;Salininkų;DRUGELIAI;5434294777;Taip;7;0;0;7
10143;Salininkų;DRUGELIAI;1815368137;Taip;0;4;1;5
10144;Salininkų;DRUGELIAI;8157811781;Taip;0;16;2;18
10145;Salininkų;DRUGELIAI;48956671934;Taip;20;0;0;20
10146;Salininkų;DRUGELIAI;1963139815;Taip;0;0;5;5
10147;Salininkų;DRUGELIAI;45194646218;Taip;0;6;0;6
10148;Salininkų;DRUGELIAI;6125334614;Taip;14;0;0;14
10149;Salininkų;DRUGELIAI;15199054558;Ne;0;13;0;13
10150;Salininkų;DRUGELIAI;8081095896;Taip;5;0;0;5
10151;Salininkų;DRUGELIAI;1568780329;Taip;20;0;0;20
10152;Salininkų;DRUGELIAI;30123603107;Taip;10;0;0;10
10153;Salininkų;DRUGELIAI;9074440999;Taip;20;0;0;20
10154;Salininkų;ŽIRNIUKAI;5063792784;Taip;6;5;4;15
10155;Salininkų;ŽIRNIUKAI;73016259669;Taip;5;5;0;10
10156;Salininkų;ŽIRNIUKAI;41023354439;Taip;5;5;0;10
10157;Salininkų;ŽIRNIUKAI;76449285846;Taip;5;7;0;12
10158;Salininkų;ŽIRNIUKAI;1355032282;Taip;6;1;0;7
10159;Salininkų;ŽIRNIUKAI;35611320012;Taip;12;2;0;14
10160;Salininkų;ŽIRNIUKAI;22167560908;Taip;7;4;0;11
10161;Salininkų;ŽIRNIUKAI;9513785510;Taip;5;2;3;10
10162;Salininkų;ŽIRNIUKAI;5689344488;Taip;15;0;0;15
10163;Salininkų;ŽIRNIUKAI;2292919406;Taip;16;0;0;16
10164;Salininkų;ŽIRNIUKAI;8683841956;Taip;6;0;0;6
10165;Salininkų;ŽIRNIUKAI;10335028421;Taip;13;0;0;13
10166;Salininkų;ŽIRNIUKAI;40392900667;Taip;9;0;0;9
10167;Salininkų;ŽIRNIUKAI;8488127476;Taip;4;14;0;18
10168;Salininkų;ŽIRNIUKAI;1723241116;Taip;11;5;0;16
10169;Salininkų;ŽIRNIUKAI;46867660097;Taip;11;6;0;17
10170;Salininkų;ŽIRNIUKAI;8288199783;Taip;0;0;1;1
10171;Salininkų;ŽIRNIUKAI;4269202761;Taip;20;0;0;20
10172;Salininkų;ŽIRNIUKAI;3692008687;Taip;14;4;0;18
10173;Salininkų;ŽIRNIUKAI;91859774311;Taip;13;0;0;13
10174;Salininkų;ŽIRNIUKAI;1065549119;Taip;15;0;0;15
10175;Salininkų;PAUKŠČIUKAI;1202154135;Taip;0;5;0;5
10176;Salininkų;PAUKŠČIUKAI;1489067126;Taip;6;1;0;7
10177;Salininkų;PAUKŠČIUKAI;1521333219;Taip;6;7;0;13
10178;Salininkų;PAUKŠČIUKAI;95919160139;Taip;0;5;0;5
10179;Salininkų;PAUKŠČIUKAI;25941514634;Taip;8;0;0;8
10180;Salininkų;PAUKŠČIUKAI;23990693770;Taip;10;5;0;15
10181;Salininkų;PAUKŠČIUKAI;67593920224;Taip;0;17;0;17
10182;Salininkų;PAUKŠČIUKAI;81888649482;Taip;0;5;0;5
10183;Salininkų;PAUKŠČIUKAI;1153455356;Taip;13;1;0;14
10184;Salininkų;PAUKŠČIUKAI;1470744233;Taip;5;15;0;20
10185;Salininkų;PAUKŠČIUKAI;2031724954;Taip;15;0;0;15
10186;Salininkų;PAUKŠČIUKAI;52499970010;Taip;15;0;0;15
10187;Salininkų;PAUKŠČIUKAI;18178857793;Taip;10;4;0;14
10188;Salininkų;PAUKŠČIUKAI;1439852031;Taip;8;7;0;15
10189;Salininkų;PAUKŠČIUKAI;20609963605;Taip;10;5;0;15
10190;Salininkų;PAUKŠČIUKAI;1918440067;Taip;8;0;0;8
10191;Salininkų;PAUKŠČIUKAI;52194170807;Taip;0;10;2;12
10192;Salininkų;PAUKŠČIUKAI;86019335524;Taip;0;10;2;12
10193;Salininkų;PAUKŠČIUKAI;1586012117;Taip;8;1;0;9
10194;Salininkų;PAUKŠČIUKAI;2415539904;Taip;0;9;0;9
10195;Salininkų;PAUKŠČIUKAI;29341671329;Taip;0;9;0;9
10196;Salininkų;PAUKŠČIUKAI;3878896109;Taip;9;7;0;16
10197;Salininkų;PAUKŠČIUKAI;16967442608;Taip;10;2;0;12
10198;Salvija;Daigelis(šatil);1517130961;Ne;0;1;1;2
10199;Salvija;Daigelis(šatil);1478775998;Taip;0;1;1;2
10200;Salvija;Daigelis(šatil);8802891478;Ne;0;11;0;11
10201;Salvija;Daigelis(šatil);24038366791;Taip;4;10;0;14
10202;Salvija;Daigelis(šatil);12326049516;Taip;13;3;0;16
10203;Salvija;Daigelis(šatil);5784594015;Taip;5;1;1;7
10204;Salvija;Daigelis(šatil);1261005294;Taip;4;1;2;7
10205;Salvija;Daigelis(šatil);62170308628;Taip;2;0;5;7
10206;Salvija;Daigelis(šatil);3424917706;Ne;15;0;1;16
10207;Salvija;Daigelis(šatil);5494438837;Taip;10;0;5;15
10208;Salvija;Daigelis(šatil);9908473681;Taip;0;3;1;4
10209;Salvija;Daigelis(šatil);4152602039;Taip;10;0;1;11
10210;Salvija;Daigelis(šatil);7546216874;Taip;0;1;0;1
10211;Salvija;Daigelis(šatil);3856351749;Taip;0;2;1;3
10212;Salvija;Daigelis(šatil);1791922219;Taip;0;5;1;6
10213;Salvija;Daigelis(šatil);1653831148;Taip;18;0;0;18
10214;Salvija;Daigelis(šatil);8023422294;Taip;0;0;9;9
10215;Salvija;"Pienė (savjon)";20005587910;Taip;19;0;0;19
10216;Salvija;"Pienė (savjon)";1826525181;Taip;6;5;1;12
10217;Salvija;"Pienė (savjon)";53604559443;Taip;0;0;2;2
10218;Salvija;"Pienė (savjon)";22615390885;Taip;7;0;0;7
10219;Salvija;"Pienė (savjon)";9168718017;Taip;0;0;5;5
10220;Salvija;"Pienė (savjon)";4167467237;Taip;5;5;5;15
10221;Salvija;"Pienė (savjon)";1641242817;Taip;4;2;0;6
10222;Salvija;"Pienė (savjon)";58888784609;Taip;10;0;2;12
10223;Salvija;"Pienė (savjon)";3331501534;Taip;6;0;0;6
10224;Salvija;"Pienė (savjon)";96747548556;Taip;0;0;3;3
10225;Salvija;"Pienė (savjon)";47567003954;Taip;5;0;1;6
10226;Salvija;"Pienė (savjon)";43416476269;Taip;4;0;2;6
10227;Salvija;"Pienė (savjon)";4845744417;Taip;6;4;0;10
10228;Salvija;"Pienė (savjon)";2495133021;Taip;5;0;0;5
10229;Salvija;"Pienė (savjon)";57752478379;Taip;10;0;2;12
10230;Salvija;"Pienė (savjon)";1103379012;Taip;4;0;0;4
10231;Salvija;"Pienė (savjon)";62121799666;Taip;0;5;0;5
10232;Salvija;"Pienė (savjon)";95774147903;Taip;5;0;2;7
10233;Saulėtekis;BERŽELIS;37001834066;Taip;0;3;2;5
10234;Saulėtekis;BERŽELIS;29935189464;Taip;0;0;1;1
10235;Saulėtekis;BERŽELIS;95214907923;Taip;0;1;0;1
10236;Saulėtekis;BERŽELIS;49102885577;Taip;0;7;0;7
10237;Saulėtekis;BERŽELIS;18801492293;Taip;0;1;1;2
10238;Saulėtekis;BERŽELIS;43809213927;Taip;0;1;0;1
10239;Saulėtekis;BERŽELIS;17046444483;Taip;0;4;3;7
10240;Saulėtekis;BERŽELIS;14357681543;Taip;0;5;0;5
10241;Saulėtekis;BERŽELIS;27109020149;Taip;0;8;0;8
10242;Saulėtekis;BERŽELIS;42952333477;Taip;0;10;0;10
10243;Saulėtekis;BERŽELIS;88165168902;Taip;0;8;0;8
10244;Saulėtekis;BERŽELIS;19786161536;Taip;0;7;0;7
10245;Saulėtekis;BERŽELIS;55975992548;Taip;0;13;0;13
10246;Saulėtekis;BERŽELIS;49746307178;Taip;5;5;4;14
10247;Saulėtekis;BERŽELIS;9333073549;Taip;0;8;0;8
10248;Saulėtekis;BERŽELIS;9632257866;Taip;0;2;2;4
10249;Saulėtekis;BERŽELIS;24403133622;Taip;0;8;0;8
10250;Saulėtekis;BERŽELIS;7440287746;Taip;6;7;0;13
10251;Saulėtekis;BERŽELIS;1359594045;Taip;0;3;0;3
10252;Saulėtekis;BERŽELIS;1502304241;Ne;0;0;1;1
10253;Saulėtekis;BERŽELIS;19209281962;Taip;0;1;3;4
10254;Saulėtekis;BERŽELIS;2096996257;Taip;0;4;3;7
10255;Saulėtekis;ŠYPSENA;1720125332;Taip;3;1;0;4
10256;Saulėtekis;ŠYPSENA;9972687066;Taip;0;3;0;3
10257;Saulėtekis;ŠYPSENA;7346852524;Taip;20;0;0;20
10258;Saulėtekis;ŠYPSENA;1902333363;Taip;5;5;0;10
10259;Saulėtekis;ŠYPSENA;8574702901;Taip;10;0;0;10
10260;Saulėtekis;ŠYPSENA;7893982893;Taip;8;0;1;9
10261;Saulėtekis;ŠYPSENA;7505040675;Taip;0;9;0;9
10262;Saulėtekis;ŠYPSENA;6501250875;Taip;5;0;0;5
10263;Saulėtekis;ŠYPSENA;9791926936;Taip;20;0;0;20
10264;Saulėtekis;ŠYPSENA;8620689981;Taip;5;3;0;8
10265;Saulėtekis;ŠYPSENA;8143793642;Taip;5;6;0;11
10266;Saulėtekis;ŠYPSENA;8603952810;Taip;5;4;2;11
10267;Saulėtekis;ŠYPSENA;9783450998;Taip;0;3;0;3
10268;Saulėtekis;ŠYPSENA;4909850069;Taip;5;6;0;11
10269;Saulėtekis;NYKŠTUKAI;62765692719;Taip;5;8;0;13
10270;Saulėtekis;NYKŠTUKAI;87107015716;Taip;0;7;0;7
10271;Saulėtekis;NYKŠTUKAI;81074197598;Taip;19;0;0;19
10272;Saulėtekis;NYKŠTUKAI;87539304992;Taip;0;5;0;5
10273;Saulėtekis;NYKŠTUKAI;75818502835;Taip;0;1;0;1
10274;Saulėtekis;NYKŠTUKAI;1769434568;Taip;16;0;0;16
10275;Saulėtekis;NYKŠTUKAI;23597877284;Taip;1;5;0;6
10276;Saulėtekis;NYKŠTUKAI;36050720419;Taip;6;8;0;14
10277;Saulėtekis;NYKŠTUKAI;29734420962;Taip;0;5;0;5
10278;Saulėtekis;NYKŠTUKAI;1623791240;Taip;0;6;0;6
10279;Saulėtekis;NYKŠTUKAI;71042846070;Taip;3;6;0;9
10280;Saulėtekis;NYKŠTUKAI;9701092832;Taip;0;5;0;5
10281;Saulėtekis;NYKŠTUKAI;46936348504;Taip;0;6;0;6
10282;Saulėtekis;NYKŠTUKAI;47570401883;Taip;0;8;0;8
10283;Saulėtekis;NYKŠTUKAI;89956895058;Taip;6;7;0;13
10284;Saulėtekis;NYKŠTUKAI;90708381762;Taip;6;6;0;12
10285;Saulėtekis;NYKŠTUKAI;90484365520;Taip;0;1;0;1
10286;Saulėtekis;NYKŠTUKAI;40443812162;Taip;0;1;0;1
10287;Saulėtekis;NYKŠTUKAI;57417558875;Taip;0;9;0;9
10288;Saulėtekis;NYKŠTUKAI;1288313734;Taip;0;6;0;6
10289;Saulėtekis;NYKŠTUKAI;9282898493;Taip;6;7;0;13
10290;Saulėtekis;NYKŠTUKAI;1656800997;Taip;20;0;0;20
10291;Saulėtekis;PAGRANDUKAS;9428709415;Taip;15;0;1;16
10292;Saulėtekis;PAGRANDUKAS;8102360466;Taip;0;3;0;3
10293;Saulėtekis;PAGRANDUKAS;2371396923;Taip;10;5;5;20
10294;Saulėtekis;PAGRANDUKAS;4152255439;Taip;20;0;0;20
10295;Saulėtekis;PAGRANDUKAS;2209156661;Taip;5;5;1;11
10296;Saulėtekis;PAGRANDUKAS;3220993253;Taip;13;0;0;13
10297;Saulėtekis;PAGRANDUKAS;5552614092;Taip;2;5;0;7
10298;Saulėtekis;PAGRANDUKAS;9497129509;Taip;0;3;0;3
10299;Saulėtekis;PAGRANDUKAS;9918219913;Taip;8;0;0;8
10300;Saulėtekis;PAGRANDUKAS;8517049464;Taip;15;4;0;19
10301;Saulėtekis;PAGRANDUKAS;7186085219;Taip;3;0;3;6
10302;Saulėtekis;PAGRANDUKAS;1020209414;Taip;15;0;0;15
10303;Saulėtekis;PAGRANDUKAS;8745921541;Taip;5;1;0;6
10304;Saulėtekis;PAGRANDUKAS;2728836108;Taip;13;4;0;17
10305;Saulėtekis;PAGRANDUKAS;8390615573;Taip;5;0;0;5
10306;Saulėtekis;PAGRANDUKAS;2698535938;Taip;0;7;0;7
10307;Saulėtekis;PAGRANDUKAS;2656659133;Taip;5;12;0;17
10308;Saulėtekis;RAMUNĖLIŲ;70948000188;Taip;3;1;0;4
10309;Saulėtekis;RAMUNĖLIŲ;21299038354;Taip;0;5;1;6
10310;Saulėtekis;RAMUNĖLIŲ;1456140823;Taip;0;6;0;6
10311;Saulėtekis;RAMUNĖLIŲ;23797246535;Taip;0;1;0;1
10312;Saulėtekis;RAMUNĖLIŲ;16450627896;Taip;0;2;1;3
10313;Saulėtekis;RAMUNĖLIŲ;60662699125;Taip;0;9;0;9
10314;Saulėtekis;RAMUNĖLIŲ;77630031851;Taip;5;0;0;5
10315;Saulėtekis;RAMUNĖLIŲ;31291807930;Taip;3;9;0;12
10316;Saulėtekis;RAMUNĖLIŲ;49053923177;Taip;14;3;0;17
10317;Saulėtekis;RAMUNĖLIŲ;42485505048;Ne;0;5;0;5
10318;Saulėtekis;RAMUNĖLIŲ;86593254070;Taip;4;1;3;8
10319;Saulėtekis;RAMUNĖLIŲ;75785868657;Taip;10;1;1;12
10320;Saulėtekis;RAMUNĖLIŲ;40093795729;Taip;5;0;0;5
10321;Saulėtekis;RAMUNĖLIŲ;10524532865;Taip;0;10;0;10
10322;Saulėtekis;RAMUNĖLIŲ;80037388013;Taip;12;0;0;12
10323;Saulėtekis;RAMUNĖLIŲ;1219435678;Taip;0;4;0;4
10324;Saulėtekis;RAMUNĖLIŲ;29662148323;Taip;0;5;0;5
10325;Saulėtekis;RAMUNĖLIŲ;3394231244;Taip;8;5;0;13
10326;Saulėtekis;RAMUNĖLIŲ;7544912614;Taip;0;7;0;7
10327;Saulėtekis;RAMUNĖLIŲ;1349303787;Taip;13;2;1;16
10328;Saulėtekis;PASAKAITĖ;3458088977;Taip;0;1;0;1
10329;Saulėtekis;PASAKAITĖ;80652165734;Taip;1;5;2;8
10330;Saulėtekis;PASAKAITĖ;99932790328;Taip;0;6;0;6
10331;Saulėtekis;PASAKAITĖ;33621514262;Taip;3;5;4;12
10332;Saulėtekis;PASAKAITĖ;65869066033;Taip;1;5;0;6
10333;Saulėtekis;PASAKAITĖ;24878473562;Taip;0;20;0;20
10334;Saulėtekis;PASAKAITĖ;96500691386;Taip;2;0;0;2
10335;Saulėtekis;PASAKAITĖ;33485541086;Taip;0;11;0;11
10336;Saulėtekis;PASAKAITĖ;36401102768;Taip;0;7;0;7
10337;Saulėtekis;PASAKAITĖ;71579240842;Ne;0;8;0;8
10338;Saulėtekis;PASAKAITĖ;6833534993;Taip;0;5;0;5
10339;Saulėtekis;PASAKAITĖ;30101217515;Taip;0;3;0;3
10340;Saulėtekis;PASAKAITĖ;75415518904;Taip;8;7;0;15
10341;Saulėtekis;PASAKAITĖ;38524228416;Taip;0;6;0;6
10342;Saulėtekis;PASAKAITĖ;5777142934;Taip;0;1;0;1
10343;Saulėtekis;PASAKAITĖ;5068358612;Taip;5;6;0;11
10344;Saulėtekis;PASAKAITĖ;6084164103;Taip;0;8;1;9
10345;Saulėtekis;PASAKAITĖ;41008609722;Taip;0;1;0;1
10346;Saulėtekis;PASAKAITĖ;17692658424;Ne;0;5;0;5
10347;Saulėtekis;PASAKAITĖ;1346347454;Taip;7;5;0;12
10348;Saulėtekis;PASAKAITĖ;5930722162;Taip;15;5;0;20
10349;Saulėtekis;VARPELIAI;94326821425;Taip;0;13;0;13
10350;Saulėtekis;VARPELIAI;6984530386;Taip;0;0;1;1
10351;Saulėtekis;VARPELIAI;1069782559;Taip;0;0;2;2
10352;Saulėtekis;VARPELIAI;1339984127;Taip;0;10;0;10
10353;Saulėtekis;VARPELIAI;68563453302;Taip;0;3;0;3
10354;Saulėtekis;VARPELIAI;77901730057;Taip;0;7;0;7
10355;Saulėtekis;VARPELIAI;74713390994;Taip;0;1;0;1
10356;Saulėtekis;VARPELIAI;43127755042;Taip;0;6;0;6
10357;Saulėtekis;VARPELIAI;1154284625;Taip;5;0;3;8
10358;Saulėtekis;VARPELIAI;1335149249;Taip;0;6;0;6
10359;Saulėtekis;VARPELIAI;1108321396;Taip;10;0;0;10
10360;Saulėtekis;VARPELIAI;891603633;Taip;10;5;0;15
10361;Saulėtekis;VARPELIAI;36605502570;Taip;0;1;4;5
10362;Saulėtekis;VARPELIAI;2075281680;Taip;0;1;0;1
10363;Saulėtekis;VARPELIAI;1213567219;Taip;15;3;0;18
10364;Saulėtekis;VARPELIAI;61118132521;Taip;20;0;0;20
10365;Saulėtekis;VARPELIAI;7464965841;Taip;4;0;2;6
10366;Saulėtekis;VARPELIAI;6671771491;Taip;0;8;0;8
10367;Saulėtekis;VARPELIAI;8752857993;Taip;10;0;0;10
10368;Saulėtekis;VARPELIAI;2641849320;Ne;7;5;1;13
10369;Saulėtekis;GRŪDELIS;20794781914;Taip;5;5;2;12
10370;Saulėtekis;GRŪDELIS;9132383069;Taip;0;2;2;4
10371;Saulėtekis;GRŪDELIS;67951758325;Taip;0;5;0;5
10372;Saulėtekis;GRŪDELIS;70230805151;Taip;4;1;0;5
10373;Saulėtekis;GRŪDELIS;41775536104;Taip;0;10;0;10
10374;Saulėtekis;GRŪDELIS;12954283491;Taip;0;5;0;5
10375;Saulėtekis;GRŪDELIS;21376960952;Taip;0;8;0;8
10376;Saulėtekis;GRŪDELIS;86804497954;Taip;0;4;0;4
10377;Saulėtekis;GRŪDELIS;1180197203;Taip;0;5;0;5
10378;Saulėtekis;GRŪDELIS;1066191639;Taip;0;2;0;2
10379;Saulėtekis;GRŪDELIS;98936544904;Taip;0;0;1;1
10380;Saulėtekis;GRŪDELIS;22570044589;Taip;0;0;2;2
10381;Saulėtekis;GRŪDELIS;1865278537;Taip;0;7;0;7
10382;Saulėtekis;GRŪDELIS;1220962473;Taip;0;12;0;12
10383;Saulėtekis;GRŪDELIS;20534872540;Taip;20;0;0;20
10384;Saulėtekis;GRŪDELIS;53906058088;Taip;0;4;3;7
10385;Saulėtekis;GRŪDELIS;1646943569;Taip;0;2;0;2
10386;Saulėtekis;GRŪDELIS;7042842046;Taip;12;0;0;12
10387;Saulėtekis;JONVABALIS;5003645081;Taip;16;0;0;16
10388;Saulėtekis;JONVABALIS;21569877958;Taip;10;3;0;13
10389;Saulėtekis;JONVABALIS;6736441901;Taip;5;5;0;10
10390;Saulėtekis;JONVABALIS;1466627555;Taip;0;8;0;8
10391;Saulėtekis;JONVABALIS;1691667254;Taip;0;13;0;13
10392;Saulėtekis;JONVABALIS;1064355395;Taip;10;4;0;14
10393;Saulėtekis;JONVABALIS;1715634399;Taip;16;0;0;16
10394;Saulėtekis;JONVABALIS;1897872021;Taip;0;10;0;10
10395;Saulėtekis;JONVABALIS;1010906684;Taip;5;0;0;5
10396;Saulėtekis;JONVABALIS;97037457833;Taip;6;2;0;8
10397;Saulėtekis;JONVABALIS;1111323783;Taip;12;6;0;18
10398;Saulėtekis;JONVABALIS;84492261206;Taip;0;6;0;6
10399;Saulėtekis;JONVABALIS;72559769416;Taip;5;3;0;8
10400;Saulėtekis;JONVABALIS;29552225924;Taip;5;0;0;5
10401;Saulėtekis;JONVABALIS;1611009868;Taip;20;0;0;20
10402;Saulėtekis;JONVABALIS;7486742518;Taip;20;0;0;20
10403;Saulėtekis;JONVABALIS;4613040294;Taip;5;0;0;5
10404;Saulėtekis;JONVABALIS;1655720839;Taip;13;1;0;14
10405;Saulėtekis;SMALSUČIAI;40877542045;Taip;0;7;0;7
10406;Saulėtekis;SMALSUČIAI;9095968376;Taip;0;5;0;5
10407;Saulėtekis;SMALSUČIAI;7030227903;Taip;5;0;0;5
10408;Saulėtekis;SMALSUČIAI;81118611780;Taip;0;5;2;7
10409;Saulėtekis;SMALSUČIAI;32771808648;Taip;0;6;0;6
10410;Saulėtekis;SMALSUČIAI;38762730531;Taip;0;2;0;2
10411;Saulėtekis;SMALSUČIAI;1808644850;Taip;4;7;0;11
10412;Saulėtekis;SMALSUČIAI;1642031589;Taip;6;7;0;13
10413;Saulėtekis;SMALSUČIAI;29472863931;Taip;0;5;2;7
10414;Saulėtekis;SMALSUČIAI;1568300232;Taip;16;0;0;16
10415;Saulėtekis;SMALSUČIAI;8415116580;Taip;0;0;3;3
10416;Saulėtekis;SMALSUČIAI;97771948184;Taip;0;12;0;12
10417;Saulėtekis;SMALSUČIAI;7621094096;Taip;0;6;0;6
10418;Saulėtekis;SMALSUČIAI;13451381485;Taip;20;0;0;20
10419;Saulėtekis;SMALSUČIAI;19605249139;Taip;8;0;0;8
10420;Saulėtekis;SMALSUČIAI;1619134034;Taip;8;3;0;11
10421;Saulėtekis;SMALSUČIAI;8673024996;Taip;11;1;0;12
10422;Saulėtekis;SMALSUČIAI;1456865685;Taip;0;9;0;9
10423;Saulėtekis;BITUTĖS;7766084857;Taip;6;5;0;11
10424;Saulėtekis;BITUTĖS;4537254306;Taip;5;7;0;12
10425;Saulėtekis;BITUTĖS;60462712074;Taip;7;5;0;12
10426;Saulėtekis;BITUTĖS;1699576940;Taip;0;1;0;1
10427;Saulėtekis;BITUTĖS;9945647968;Taip;12;2;0;14
10428;Saulėtekis;BITUTĖS;1962914764;Taip;0;14;2;16
10429;Saulėtekis;BITUTĖS;1481503733;Taip;6;8;0;14
10430;Saulėtekis;BITUTĖS;8302260087;Taip;5;4;0;9
10431;Saulėtekis;BITUTĖS;2593106154;Taip;5;0;0;5
10432;Saulėtekis;BITUTĖS;2813949848;Taip;15;5;0;20
10433;Saulėtekis;BITUTĖS;6643388548;Taip;8;1;0;9
10434;Saulėtekis;BITUTĖS;9983577817;Taip;0;7;0;7
10435;Saulėtekis;BITUTĖS;7986712728;Taip;8;4;0;12
10436;Saulėtekis;BITUTĖS;6087170055;Taip;0;5;0;5
10437;Saulėtekis;BITUTĖS;7027103276;Taip;0;11;0;11
10438;Saulėtekis;BITUTĖS;7758268674;Taip;5;1;0;6
10439;Saulėtekis;BITUTĖS;2077976415;Taip;3;7;0;10
10440;Saulėtekis;BITUTĖS;9605052795;Taip;10;10;0;20
10441;Saulėtekis;BITUTĖS;7075757274;Taip;10;5;0;15
10442;Saulėtekis;RIEŠUTĖLIAI;3337160930;Taip;3;0;3;6
10443;Saulėtekis;RIEŠUTĖLIAI;2021901593;Taip;6;2;0;8
10444;Saulėtekis;RIEŠUTĖLIAI;7842280836;Taip;6;0;0;6
10445;Saulėtekis;RIEŠUTĖLIAI;2407911405;Taip;0;1;0;1
10446;Saulėtekis;RIEŠUTĖLIAI;6102064617;Taip;0;2;0;2
10447;Saulėtekis;RIEŠUTĖLIAI;2238947856;Taip;0;14;0;14
10448;Saulėtekis;RIEŠUTĖLIAI;84982517658;Taip;5;0;0;5
10449;Saulėtekis;RIEŠUTĖLIAI;3541535891;Taip;10;0;1;11
10450;Saulėtekis;RIEŠUTĖLIAI;8231869593;Taip;7;1;0;8
10451;Saulėtekis;RIEŠUTĖLIAI;36003078842;Taip;0;4;0;4
10452;Saulėtekis;RIEŠUTĖLIAI;4663268649;Taip;0;1;0;1
10453;Saulėtekis;RIEŠUTĖLIAI;81153273188;Taip;5;6;0;11
10454;Saulėtekis;RIEŠUTĖLIAI;1290215067;Taip;5;3;1;9
10455;Saulėtekis;RIEŠUTĖLIAI;4338502152;Taip;0;6;0;6
10456;Saulėtekis;RIEŠUTĖLIAI;8002806189;Taip;9;3;0;12
10457;Saulėtekis;RIEŠUTĖLIAI;9657195627;Taip;0;11;0;11
10458;Skroblinukas;SVIRPLIUKŲ;56496090956;Ne;0;0;5;5
10459;Skroblinukas;SVIRPLIUKŲ;27948464942;Taip;1;0;5;6
10460;Skroblinukas;SVIRPLIUKŲ;92096423589;Taip;3;2;0;5
10461;Skroblinukas;SVIRPLIUKŲ;5992090518;Taip;5;0;0;5
10462;Skroblinukas;SVIRPLIUKŲ;69303322030;Taip;0;0;1;1
10463;Skroblinukas;SVIRPLIUKŲ;2020866728;Taip;8;5;1;14
10464;Skroblinukas;SVIRPLIUKŲ;1059137398;Taip;5;0;0;5
10465;Skroblinukas;SVIRPLIUKŲ;91070212533;Taip;8;6;0;14
10466;Skroblinukas;SVIRPLIUKŲ;60291417607;Taip;0;6;0;6
10467;Skroblinukas;SVIRPLIUKŲ;31484348317;Taip;0;6;0;6
10468;Skroblinukas;SVIRPLIUKŲ;88601994922;Taip;0;12;0;12
10469;Skroblinukas;SVIRPLIUKŲ;1364608720;Taip;0;2;0;2
10470;Skroblinukas;SVIRPLIUKŲ;89356084678;Ne;3;1;0;4
10471;Skroblinukas;SVIRPLIUKŲ;93644867290;Ne;0;1;0;1
10472;Skroblinukas;SVIRPLIUKŲ;30925721180;Taip;0;4;2;6
10473;Skroblinukas;SVIRPLIUKŲ;87902801288;Taip;4;1;0;5
10474;Skroblinukas;SVIRPLIUKŲ;1462404838;Taip;0;7;0;7
10475;Skroblinukas;SVIRPLIUKŲ;23551272822;Taip;0;7;2;9
10476;Skroblinukas;SVIRPLIUKŲ;2105394649;Taip;9;0;0;9
10477;Skroblinukas;GANDRIUKŲ;9936253477;Taip;0;5;0;5
10478;Skroblinukas;GANDRIUKŲ;42828688990;Taip;0;5;0;5
10479;Skroblinukas;GANDRIUKŲ;11039821123;Taip;0;1;0;1
10480;Skroblinukas;GANDRIUKŲ;2574443420;Taip;2;5;0;7
10481;Skroblinukas;GANDRIUKŲ;47487985525;Taip;0;11;0;11
10482;Skroblinukas;GANDRIUKŲ;77924018810;Taip;0;5;0;5
10483;Skroblinukas;GANDRIUKŲ;21497082440;Taip;0;3;0;3
10484;Skroblinukas;GANDRIUKŲ;55187339508;Taip;0;8;0;8
10485;Skroblinukas;GANDRIUKŲ;1799813420;Taip;5;5;0;10
10486;Skroblinukas;GANDRIUKŲ;29786434898;Taip;6;0;0;6
10487;Skroblinukas;GANDRIUKŲ;1852949849;Taip;3;4;0;7
10488;Skroblinukas;GANDRIUKŲ;74443337196;Taip;10;0;0;10
10489;Skroblinukas;GANDRIUKŲ;33658383206;Taip;7;11;0;18
10490;Skroblinukas;GANDRIUKŲ;77076233947;Taip;0;7;0;7
10491;Skroblinukas;GANDRIUKŲ;28889483128;Taip;0;2;0;2
10492;Skroblinukas;GANDRIUKŲ;18613971878;Taip;0;5;0;5
10493;Skroblinukas;GANDRIUKŲ;19962514046;Taip;0;14;0;14
10494;Skroblinukas;GANDRIUKŲ;69558864958;Taip;10;2;0;12
10495;Skroblinukas;GANDRIUKŲ;68389194619;Taip;0;5;0;5
10496;Skroblinukas;GANDRIUKŲ;65724262749;Taip;0;6;0;6
10497;Skroblinukas;GANDRIUKŲ;6662751729;Ne;0;5;5;10
10498;Skroblinukas;GANDRIUKŲ;7616559972;Ne;0;5;0;5
10499;Skroblinukas;GANDRIUKŲ;3519615689;Ne;0;5;1;6
10500;Skroblinukas;VYTURIUKŲ;32625726014;Ne;0;5;1;6
10501;Skroblinukas;VYTURIUKŲ;40320573258;Taip;4;5;0;9
10502;Skroblinukas;VYTURIUKŲ;85882169908;Taip;9;6;0;15
10503;Skroblinukas;VYTURIUKŲ;98214579906;Taip;13;5;0;18
10504;Skroblinukas;VYTURIUKŲ;94897926442;Taip;0;3;7;10
10505;Skroblinukas;VYTURIUKŲ;30982591733;Taip;5;0;0;5
10506;Skroblinukas;VYTURIUKŲ;81438612530;Taip;0;1;5;6
10507;Skroblinukas;VYTURIUKŲ;778965033;Taip;0;3;0;3
10508;Skroblinukas;VYTURIUKŲ;89809217827;Taip;0;8;0;8
10509;Skroblinukas;VYTURIUKŲ;25474129751;Taip;0;5;0;5
10510;Skroblinukas;VYTURIUKŲ;9313338574;Ne;0;13;0;13
10511;Skroblinukas;VYTURIUKŲ;152535859;Taip;0;7;0;7
10512;Skroblinukas;VYTURIUKŲ;1935381164;Taip;3;5;0;8
10513;Skroblinukas;VYTURIUKŲ;24808850859;Taip;0;0;1;1
10514;Skroblinukas;VYTURIUKŲ;64034793218;Taip;0;1;3;4
10515;Skroblinukas;VYTURIUKŲ;52489636337;Taip;0;18;0;18
10516;Skroblinukas;VYTURIUKŲ;21966526141;Taip;0;5;1;6
10517;Skroblinukas;VYTURIUKŲ;55519865793;Taip;0;12;0;12
10518;Skroblinukas;VYTURIUKŲ;87202801900;Taip;0;4;0;4
10519;Skroblinukas;VYTURIUKŲ;58117699822;Ne;0;5;1;6
10520;Skroblinukas;VYTURIUKŲ;17906689562;Taip;0;1;1;2
10521;Skroblinukas;VYTURIUKŲ;84113655621;Taip;0;0;1;1
10522;Skroblinukas;VYTURIUKŲ;78319454763;Taip;0;5;2;7
10523;Skroblinukas;VYTURIUKŲ;6095946745;Taip;0;2;0;2
10524;Skroblinukas;GENIUKŲ;48655837755;Taip;6;0;0;6
10525;Skroblinukas;GENIUKŲ;1930578755;Taip;12;0;1;13
10526;Skroblinukas;GENIUKŲ;4393041946;Taip;0;5;15;20
10527;Skroblinukas;GENIUKŲ;2323980730;Taip;5;0;0;5
10528;Skroblinukas;GENIUKŲ;1325903217;Taip;0;10;0;10
10529;Skroblinukas;GENIUKŲ;8380073853;Taip;2;0;3;5
10530;Skroblinukas;GENIUKŲ;63112639332;Taip;5;1;1;7
10531;Skroblinukas;GENIUKŲ;1361836818;Ne;5;0;0;5
10532;Skroblinukas;GENIUKŲ;5766702969;Taip;20;0;0;20
10533;Skroblinukas;GENIUKŲ;4436698905;Taip;0;0;1;1
10534;Skroblinukas;GENIUKŲ;1905085978;Taip;0;0;1;1
10535;Skroblinukas;GENIUKŲ;1557733803;Taip;0;11;0;11
10536;Skroblinukas;GENIUKŲ;9433465007;Taip;0;3;1;4
10537;Skroblinukas;GENIUKŲ;9777300890;Taip;9;2;2;13
10538;Skroblinukas;GENIUKŲ;1696303051;Taip;0;7;0;7
10539;Skroblinukas;GENIUKŲ;9846569195;Taip;0;3;3;6
10540;Skroblinukas;GENIUKŲ;3746278003;Taip;15;5;0;20
10541;Skroblinukas;GENIUKŲ;4773576465;Taip;0;0;4;4
10542;Skroblinukas;GENIUKŲ;2704157855;Taip;0;1;0;1
10543;Skroblinukas;GENIUKŲ;9564385215;Taip;5;1;0;6
10544;Skroblinukas;GENIUKŲ;3128337104;Ne;8;1;0;9
10545;Skroblinukas;BITUČIŲ;1255323441;Taip;4;2;0;6
10546;Skroblinukas;BITUČIŲ;1934804499;Taip;15;1;0;16
10547;Skroblinukas;BITUČIŲ;2134821488;Taip;15;0;0;15
10548;Skroblinukas;BITUČIŲ;2071447940;Taip;5;5;0;10
10549;Skroblinukas;BITUČIŲ;1659335142;Taip;3;3;1;7
10550;Skroblinukas;BITUČIŲ;6604496585;Taip;14;1;0;15
10551;Skroblinukas;BITUČIŲ;3736883850;Taip;5;0;1;6
10552;Skroblinukas;BITUČIŲ;7191689856;Taip;20;0;0;20
10553;Skroblinukas;BITUČIŲ;5354082364;Taip;7;0;0;7
10554;Skroblinukas;BITUČIŲ;2032621707;Taip;13;0;0;13
10555;Skroblinukas;BITUČIŲ;8277152812;Taip;0;1;0;1
10556;Skroblinukas;BITUČIŲ;8374103872;Taip;0;3;0;3
10557;Skroblinukas;BITUČIŲ;8618587013;Taip;0;2;2;4
10558;Skroblinukas;BITUČIŲ;4945107862;Ne;5;0;4;9
10559;Skroblinukas;BITUČIŲ;9594078223;Taip;0;2;0;2
10560;Skroblinukas;BITUČIŲ;1432694920;Taip;10;0;0;10
10561;Skroblinukas;BITUČIŲ;1967305501;Taip;5;4;1;10
10562;Skroblinukas;BITUČIŲ;1688990637;Taip;10;0;0;10
10563;Skroblinukas;BITUČIŲ;1957488412;Taip;0;6;0;6
10564;Skroblinukas;BITUČIŲ;1000804920;Taip;9;0;0;9
10565;Skroblinukas;BITUČIŲ;1544346282;Taip;0;9;0;9
10566;Skroblinukas;BITUČIŲ;1711568129;Taip;10;5;0;15
10567;Skroblinukas;BORUŽĖLIŲ;2706526326;Taip;5;0;0;5
10568;Skroblinukas;BORUŽĖLIŲ;9661609284;Taip;20;0;0;20
10569;Skroblinukas;BORUŽĖLIŲ;1002570367;Taip;5;0;0;5
10570;Skroblinukas;BORUŽĖLIŲ;6293879765;Taip;10;0;0;10
10571;Skroblinukas;BORUŽĖLIŲ;9888115079;Taip;0;10;0;10
10572;Skroblinukas;BORUŽĖLIŲ;8576448571;Taip;0;0;2;2
10573;Skroblinukas;BORUŽĖLIŲ;8946940285;Taip;13;6;1;20
10574;Skroblinukas;BORUŽĖLIŲ;3290115134;Taip;5;5;0;10
10575;Skroblinukas;BORUŽĖLIŲ;9813249677;Taip;15;0;0;15
10576;Skroblinukas;BORUŽĖLIŲ;3461165182;Taip;0;0;4;4
10577;Skroblinukas;BORUŽĖLIŲ;5915278745;Taip;13;1;0;14
10578;Skroblinukas;BORUŽĖLIŲ;6433636135;Taip;9;7;0;16
10579;Skroblinukas;BORUŽĖLIŲ;9475514959;Ne;3;1;0;4
10580;Skroblinukas;SKRUZDĖLIUKŲ;1446835893;Taip;0;19;0;19
10581;Skroblinukas;SKRUZDĖLIUKŲ;2116630768;Taip;0;5;3;8
10582;Skroblinukas;SKRUZDĖLIUKŲ;1710559060;Taip;11;0;1;12
10583;Skroblinukas;SKRUZDĖLIUKŲ;1175660577;Taip;0;5;4;9
10584;Skroblinukas;SKRUZDĖLIUKŲ;21862553841;Taip;3;17;0;20
10585;Skroblinukas;SKRUZDĖLIUKŲ;1611685585;Taip;3;17;0;20
10586;Skroblinukas;SKRUZDĖLIUKŲ;1631945330;Taip;0;0;8;8
10587;Skroblinukas;SKRUZDĖLIUKŲ;58000101216;Taip;2;6;0;8
10588;Skroblinukas;SKRUZDĖLIUKŲ;85704624097;Taip;7;0;0;7
10589;Skroblinukas;SKRUZDĖLIUKŲ;91409992058;Taip;0;5;0;5
10590;Skroblinukas;SKRUZDĖLIUKŲ;60061213883;Taip;5;0;0;5
10591;Skroblinukas;SKRUZDĖLIUKŲ;1096323930;Taip;5;5;0;10
10592;Skroblinukas;SKRUZDĖLIUKŲ;50466456602;Taip;2;1;0;3
10593;Skroblinukas;SKRUZDĖLIUKŲ;40602768192;Taip;0;5;0;5
10594;Skroblinukas;SKRUZDĖLIUKŲ;87741312158;Taip;0;1;0;1
10595;Skroblinukas;SKRUZDĖLIUKŲ;3226377926;Taip;20;0;0;20
10596;Skroblinukas;SKRUZDĖLIUKŲ;42252673755;Taip;0;10;1;11
10597;Skroblinukas;SKRUZDĖLIUKŲ;7896922448;Taip;0;7;0;7
10598;Skroblinukas;SKRUZDĖLIUKŲ;2035304515;Taip;0;9;0;9
10599;Skroblinukas;SKRUZDĖLIUKŲ;1388763405;Taip;11;0;4;15
10600;Skroblinukas;SKRUZDĖLIUKŲ;60597534140;Taip;2;0;0;2
10601;Skroblinukas;SKRUZDĖLIUKŲ;82802300680;Taip;0;0;1;1
10602;Skroblinukas;SKRUZDĖLIUKŲ;7416993749;Taip;0;5;1;6
10603;Skroblinukas;ŽVIRBLIUKŲ;9045708140;Taip;0;6;0;6
10604;Skroblinukas;ŽVIRBLIUKŲ;6266609965;Taip;0;6;0;6
10605;Skroblinukas;ŽVIRBLIUKŲ;5646847921;Taip;18;0;0;18
10606;Skroblinukas;ŽVIRBLIUKŲ;1851920334;Ne;5;0;1;6
10607;Skroblinukas;ŽVIRBLIUKŲ;6640062847;Taip;3;2;3;8
10608;Skroblinukas;ŽVIRBLIUKŲ;4560580022;Taip;7;7;0;14
10609;Skroblinukas;ŽVIRBLIUKŲ;7921251819;Taip;5;5;2;12
10610;Skroblinukas;ŽVIRBLIUKŲ;5546256869;Taip;12;0;1;13
10611;Skroblinukas;ŽVIRBLIUKŲ;9572912046;Taip;10;4;0;14
10612;Skroblinukas;ŽVIRBLIUKŲ;2097758483;Taip;12;4;0;16
10613;Skroblinukas;ŽVIRBLIUKŲ;2406619611;Taip;9;0;0;9
10614;Skroblinukas;ŽVIRBLIUKŲ;3641822841;Taip;11;1;0;12
10615;Skroblinukas;ŽVIRBLIUKŲ;9377215921;Taip;20;0;0;20
10616;Skroblinukas;ŽIOGELIŲ;5157913924;Taip;11;5;0;16
10617;Skroblinukas;ŽIOGELIŲ;9368764758;Taip;10;2;0;12
10618;Skroblinukas;ŽIOGELIŲ;3006521657;Taip;0;7;0;7
10619;Skroblinukas;ŽIOGELIŲ;3771045336;Taip;0;2;0;2
10620;Skroblinukas;ŽIOGELIŲ;6890306112;Taip;10;7;0;17
10621;Skroblinukas;ŽIOGELIŲ;9958188318;Taip;8;1;2;11
10622;Skroblinukas;ŽIOGELIŲ;9448253468;Taip;0;2;0;2
10623;Skroblinukas;ŽIOGELIŲ;9634311146;Taip;2;1;0;3
10624;Skroblinukas;ŽIOGELIŲ;5688453546;Taip;0;7;7;14
10625;Skroblinukas;ŽIOGELIŲ;6445065388;Taip;17;0;0;17
10626;Skroblinukas;ŽIOGELIŲ;4424763028;Taip;5;11;0;16
10627;Skroblinukas;ŽIOGELIŲ;9353353289;Taip;5;3;2;10
10628;Skroblinukas;ŽIOGELIŲ;5252389111;Taip;5;0;0;5
10629;Skroblinukas;ŽIOGELIŲ;2883593274;Taip;5;1;0;6
10630;Skroblinukas;ŽIOGELIŲ;7493915017;Taip;10;0;0;10
10631;Skroblinukas;ŽIOGELIŲ;1970738675;Taip;0;0;19;19
10632;Skroblinukas;STRAZDELIŲ;1054097622;Taip;8;2;0;10
10633;Skroblinukas;STRAZDELIŲ;5433647187;Taip;11;2;0;13
10634;Skroblinukas;STRAZDELIŲ;9915130747;Taip;3;17;0;20
10635;Skroblinukas;STRAZDELIŲ;1159546580;Taip;15;0;1;16
10636;Skroblinukas;STRAZDELIŲ;2630699296;Taip;0;2;10;12
10637;Skroblinukas;STRAZDELIŲ;2310750833;Taip;8;2;1;11
10638;Skroblinukas;STRAZDELIŲ;2184711783;Taip;10;0;2;12
10639;Skroblinukas;STRAZDELIŲ;8875703109;Taip;8;5;0;13
10640;Skroblinukas;STRAZDELIŲ;3010510262;Taip;9;1;0;10
10641;Skroblinukas;STRAZDELIŲ;6489976163;Taip;7;1;1;9
10642;Skroblinukas;STRAZDELIŲ;1669610397;Taip;6;0;0;6
10643;Skroblinukas;STRAZDELIŲ;9541682085;Taip;14;0;0;14
10644;Skroblinukas;STRAZDELIŲ;5566457656;Ne;11;0;0;11
10645;Skroblinukas;STRAZDELIŲ;4571530482;Taip;15;0;0;15
10646;Skroblinukas;DRUGELIŲ;1792672886;Taip;3;3;8;14
10647;Skroblinukas;DRUGELIŲ;1979723351;Taip;0;0;3;3
10648;Skroblinukas;DRUGELIŲ;1964529755;Taip;11;3;0;14
10649;Skroblinukas;DRUGELIŲ;86231564690;Taip;5;0;0;5
10650;Skroblinukas;DRUGELIŲ;23687553212;Taip;11;0;0;11
10651;Skroblinukas;DRUGELIŲ;4532268875;Taip;10;0;1;11
10652;Skroblinukas;DRUGELIŲ;86542450905;Taip;9;2;3;14
10653;Skroblinukas;DRUGELIŲ;54750454175;Taip;0;0;1;1
10654;Skroblinukas;DRUGELIŲ;3636028890;Taip;10;0;0;10
10655;Skroblinukas;DRUGELIŲ;2079452635;Taip;0;0;4;4
10656;Skroblinukas;DRUGELIŲ;1510927547;Taip;0;0;4;4
10657;Skroblinukas;DRUGELIŲ;2325940694;Taip;17;2;0;19
10658;Skroblinukas;DRUGELIŲ;15977832913;Taip;5;6;1;12
10659;Skroblinukas;DRUGELIŲ;5068339590;Taip;0;6;0;6
10660;Skroblinukas;DRUGELIŲ;3580045988;Taip;0;4;0;4
10661;Skroblinukas;DRUGELIŲ;1791669956;Taip;10;0;0;10
10662;Skroblinukas;DRUGELIŲ;7184817010;Taip;0;5;1;6
10663;Skroblinukas;DRUGELIŲ;1109895463;Ne;0;7;0;7
10664;Skroblinukas;DRUGELIŲ;4272941994;Taip;15;2;2;19
10665;Skroblinukas;PELĖDŽIUKŲ;5975039463;Taip;8;0;0;8
10666;Skroblinukas;PELĖDŽIUKŲ;63514584063;Taip;0;15;0;15
10667;Skroblinukas;PELĖDŽIUKŲ;1000422430;Taip;4;2;0;6
10668;Skroblinukas;PELĖDŽIUKŲ;1556675902;Taip;11;5;0;16
10669;Skroblinukas;PELĖDŽIUKŲ;7666122737;Taip;4;0;2;6
10670;Skroblinukas;PELĖDŽIUKŲ;3864043251;Taip;0;2;1;3
10671;Skroblinukas;PELĖDŽIUKŲ;1759830058;Taip;0;12;0;12
10672;Skroblinukas;PELĖDŽIUKŲ;1471842192;Taip;0;10;0;10
10673;Skroblinukas;PELĖDŽIUKŲ;1382981497;Taip;0;2;0;2
10674;Skroblinukas;PELĖDŽIUKŲ;29908502973;Taip;0;11;0;11
10675;Skroblinukas;PELĖDŽIUKŲ;1220311458;Taip;0;7;0;7
10676;Skroblinukas;PELĖDŽIUKŲ;1599112927;Taip;0;4;1;5
10677;Skroblinukas;PELĖDŽIUKŲ;95946607624;Taip;0;3;0;3
10678;Skroblinukas;PELĖDŽIUKŲ;1898486832;Taip;0;0;1;1
10679;Skroblinukas;PELĖDŽIUKŲ;4221501092;Taip;0;1;1;2
10680;Skroblinukas;PELĖDŽIUKŲ;76523308405;Taip;0;14;0;14
10681;Skroblinukas;PELĖDŽIUKŲ;1602978649;Taip;0;6;0;6
10682;Skroblinukas;PELĖDŽIUKŲ;1258044022;Taip;0;1;2;3
10683;Skroblinukas;PELĖDŽIUKŲ;39209870512;Taip;0;5;3;8
10684;Skroblinukas;PELĖDŽIUKŲ;4914479407;Taip;3;0;0;3
10685;Skroblinukas;PELĖDŽIUKŲ;1847074960;Taip;6;1;1;8
10686;Smalsučiai;Žibuoklės;46376560575;Taip;4;6;0;10
10687;Smalsučiai;Žibuoklės;27034024515;Ne;0;0;2;2
10688;Smalsučiai;Žibuoklės;68726523946;Taip;0;4;0;4
10689;Smalsučiai;Žibuoklės;50803234873;Taip;5;0;0;5
10690;Smalsučiai;Žibuoklės;1760728524;Taip;4;10;0;14
10691;Smalsučiai;Žibuoklės;85358131888;Taip;3;5;0;8
10692;Smalsučiai;Žibuoklės;51861969442;Taip;0;3;1;4
10693;Smalsučiai;Žibuoklės;82746324948;Ne;0;5;0;5
10694;Smalsučiai;Žibuoklės;51889095612;Taip;5;0;0;5
10695;Smalsučiai;Žibuoklės;4258713607;Taip;0;17;0;17
10696;Smalsučiai;Žibuoklės;68097436766;Taip;0;13;0;13
10697;Smalsučiai;Žibuoklės;85352082436;Taip;0;0;7;7
10698;Smalsučiai;Žibuoklės;40922293471;Taip;0;9;0;9
10699;Smalsučiai;Žibuoklės;83056178108;Taip;5;0;0;5
10700;Smalsučiai;Žibuoklės;85342418658;Taip;0;1;1;2
10701;Smalsučiai;Žibuoklės;1023262986;Taip;15;0;0;15
10702;Smalsučiai;Žibuoklės;83033796468;Taip;15;0;0;15
10703;Smalsučiai;Žibuoklės;2099765750;Taip;8;0;0;8
10704;Smalsučiai;Žibuoklės;9512217842;Taip;9;5;0;14
10705;Smalsučiai;Žibuoklės;56779125767;Taip;10;3;0;13
10706;Smalsučiai;Žibuoklės;97809921080;Taip;0;5;0;5
10707;Smalsučiai;Aitvarų;53737587501;Taip;7;7;0;14
10708;Smalsučiai;Aitvarų;67243805772;Taip;13;0;0;13
10709;Smalsučiai;Aitvarų;71839472863;Taip;4;0;0;4
10710;Smalsučiai;Aitvarų;26007606072;Taip;0;4;0;4
10711;Smalsučiai;Aitvarų;55212746834;Taip;8;2;0;10
10712;Smalsučiai;Aitvarų;97665693700;Taip;8;7;0;15
10713;Smalsučiai;Aitvarų;70181610962;Ne;7;2;0;9
10714;Smalsučiai;Aitvarų;48426272721;Taip;6;2;6;14
10715;Smalsučiai;Aitvarų;12446167265;Taip;0;5;0;5
10716;Smalsučiai;Aitvarų;76405732236;Taip;0;2;4;6
10717;Smalsučiai;Aitvarų;68897306811;Taip;7;4;0;11
10718;Smalsučiai;Aitvarų;45731306499;Taip;7;1;0;8
10719;Smalsučiai;Aitvarų;1417945043;Taip;0;16;0;16
10720;Smalsučiai;Aitvarų;5631758578;Taip;0;8;0;8
10721;Smalsučiai;Aitvarų;95501158334;Taip;9;3;0;12
10722;Smalsučiai;Aitvarų;31748074403;Taip;0;3;0;3
10723;Smalsučiai;Aitvarų;1673246147;Taip;5;13;0;18
10724;Smalsučiai;Aitvarų;62387945180;Taip;0;3;5;8
10725;Smalsučiai;Aitvarų;1095159887;Taip;4;0;0;4
10726;Smalsučiai;Aitvarų;1424532027;Taip;2;2;3;7
10727;Smalsučiai;Aitvarų;1567576834;Taip;9;4;0;13
10728;Smalsučiai;Aitvarų;1965194010;Taip;6;3;0;9
10729;Smalsučiai;Sraigiukų;4004275398;Taip;5;3;1;9
10730;Smalsučiai;Sraigiukų;18980466605;Taip;2;5;1;8
10731;Smalsučiai;Sraigiukų;2036701320;Taip;0;5;6;11
10732;Smalsučiai;Sraigiukų;1597721199;Taip;6;5;0;11
10733;Smalsučiai;Sraigiukų;87920436781;Taip;5;0;0;5
10734;Smalsučiai;Sraigiukų;36701180571;Taip;0;10;0;10
10735;Smalsučiai;Sraigiukų;1968415573;Taip;5;0;0;5
10736;Smalsučiai;Sraigiukų;8572292571;Taip;1;5;1;7
10737;Smalsučiai;Sraigiukų;92460059853;Taip;6;5;0;11
10738;Smalsučiai;Sraigiukų;68583864690;Taip;10;5;0;15
10739;Smalsučiai;Sraigiukų;1830368274;Taip;0;1;6;7
10740;Smalsučiai;Sraigiukų;92129554371;Taip;5;3;0;8
10741;Smalsučiai;Sraigiukų;4655599359;Taip;6;4;1;11
10742;Smalsučiai;Sraigiukų;28055409190;Taip;0;6;0;6
10743;Smalsučiai;Sraigiukų;1504060488;Taip;3;0;5;8
10744;Smalsučiai;Sraigiukų;2112871055;Taip;0;7;0;7
10745;Smalsučiai;Sraigiukų;1453463899;Taip;5;1;4;10
10746;Smalsučiai;Sraigiukų;7037820869;Taip;0;4;5;9
10747;Smalsučiai;Sraigiukų;7450298541;Taip;5;0;0;5
10748;Smalsučiai;Sraigiukų;3792738445;Taip;7;0;0;7
10749;Smalsučiai;Saulučių;513516143;Taip;0;3;1;4
10750;Smalsučiai;Saulučių;32382108578;Taip;0;5;1;6
10751;Smalsučiai;Saulučių;38269797498;Taip;5;0;0;5
10752;Smalsučiai;Saulučių;99471280741;Taip;5;0;0;5
10753;Smalsučiai;Saulučių;25838645404;Taip;0;3;1;4
10754;Smalsučiai;Saulučių;54610929862;Taip;6;0;0;6
10755;Smalsučiai;Saulučių;96461087926;Taip;3;3;0;6
10756;Smalsučiai;Saulučių;98196404299;Taip;11;6;0;17
10757;Smalsučiai;Saulučių;66154228179;Taip;0;0;3;3
10758;Smalsučiai;Saulučių;59594678142;Taip;0;5;2;7
10759;Smalsučiai;Saulučių;94734585174;Taip;6;0;0;6
10760;Smalsučiai;Saulučių;73783991852;Taip;5;0;3;8
10761;Smalsučiai;Saulučių;47452987441;Taip;8;5;5;18
10762;Smalsučiai;Saulučių;81834985961;Taip;5;5;3;13
10763;Smalsučiai;Saulučių;1276659532;Taip;5;0;0;5
10764;Smalsučiai;Saulučių;55812291804;Taip;15;0;0;15
10765;Smalsučiai;Saulučių;16418705168;Taip;0;6;0;6
10766;Smalsučiai;Saulučių;63886240982;Taip;4;0;0;4
10767;Smalsučiai;Saulučių;57622458673;Taip;5;0;0;5
10768;Smalsučiai;Saulučių;73899364649;Taip;0;5;7;12
10769;Smalsučiai;Saulučių;1575017231;Taip;3;6;2;11
10770;Smalsučiai;Saulučių;6857124432;Taip;5;0;2;7
10771;Smalsučiai;Saulučių;1653798728;Taip;9;1;0;10
10772;Smalsučiai;Viščiukų;13763655324;Taip;0;3;0;3
10773;Smalsučiai;Viščiukų;2802867649;Taip;4;6;0;10
10774;Smalsučiai;Viščiukų;30592434971;Taip;5;5;0;10
10775;Smalsučiai;Viščiukų;26787916874;Taip;0;5;0;5
10776;Smalsučiai;Viščiukų;63575906792;Taip;11;8;0;19
10777;Smalsučiai;Viščiukų;27727844778;Taip;0;5;0;5
10778;Smalsučiai;Viščiukų;1514166474;Taip;0;5;0;5
10779;Smalsučiai;Viščiukų;37702522563;Taip;10;1;0;11
10780;Smalsučiai;Viščiukų;95945382872;Taip;5;0;0;5
10781;Smalsučiai;Viščiukų;96002139110;Taip;0;2;0;2
10782;Smalsučiai;Viščiukų;1893910089;Taip;2;0;0;2
10783;Smalsučiai;Viščiukų;55385713527;Taip;5;5;0;10
10784;Smalsučiai;Viščiukų;78496301809;Taip;14;3;0;17
10785;Smalsučiai;Viščiukų;92961881271;Taip;0;2;6;8
10786;Smalsučiai;Viščiukų;6264082741;Taip;15;2;0;17
10787;Smalsučiai;Viščiukų;30464130912;Taip;20;0;0;20
10788;Smalsučiai;Viščiukų;4732277124;Taip;0;3;0;3
10789;Smalsučiai;Boružėlių;9426629964;Taip;4;0;1;5
10790;Smalsučiai;Boružėlių;1703679877;Taip;2;0;1;3
10791;Smalsučiai;Boružėlių;2022025913;Taip;10;0;0;10
10792;Smalsučiai;Boružėlių;2208462326;Taip;0;8;0;8
10793;Smalsučiai;Boružėlių;6643253926;Taip;8;0;0;8
10794;Smalsučiai;Boružėlių;1473016908;Taip;5;3;0;8
10795;Smalsučiai;Boružėlių;6610166355;Taip;5;0;0;5
10796;Smalsučiai;Boružėlių;7226242747;Taip;6;0;0;6
10797;Smalsučiai;Boružėlių;6085020049;Taip;11;3;0;14
10798;Smalsučiai;Boružėlių;8340768848;Taip;14;0;0;14
10799;Smalsučiai;Boružėlių;6578328053;Taip;4;0;0;4
10800;Smalsučiai;Boružėlių;69450514879;Taip;6;6;0;12
10801;Smalsučiai;Boružėlių;4740303929;Taip;6;1;1;8
10802;Smalsučiai;Boružėlių;4046718551;Taip;5;0;2;7
10803;Smalsučiai;Boružėlių;7364431725;Taip;12;0;0;12
10804;Smalsučiai;Boružėlių;2694575252;Taip;15;0;1;16
10805;Smalsučiai;Boružėlių;2671403814;Taip;0;1;3;4
10806;Smalsučiai;Boružėlių;9654494235;Taip;3;0;0;3
10807;Smalsučiai;Boružėlių;2737886714;Taip;0;10;0;10
10808;Smalsučiai;Boružėlių;4858914868;Taip;17;0;0;17
10809;Smalsučiai;Zuikių;1335301931;Taip;15;3;0;18
10810;Smalsučiai;Zuikių;1154978396;Taip;10;5;1;16
10811;Smalsučiai;Zuikių;4930548597;Taip;0;6;0;6
10812;Smalsučiai;Zuikių;37584386087;Taip;0;3;0;3
10813;Smalsučiai;Zuikių;1384803468;Taip;12;5;0;17
10814;Smalsučiai;Zuikių;39786243301;Taip;0;4;0;4
10815;Smalsučiai;Zuikių;49637679464;Taip;5;1;0;6
10816;Smalsučiai;Zuikių;85935601752;Taip;0;6;0;6
10817;Smalsučiai;Zuikių;44282636010;Taip;5;5;0;10
10818;Smalsučiai;Zuikių;64619831879;Taip;5;5;0;10
10819;Smalsučiai;Zuikių;55334476483;Taip;5;5;0;10
10820;Smalsučiai;Zuikių;13761441573;Taip;0;5;2;7
10821;Smalsučiai;Zuikių;1445104610;Taip;0;5;0;5
10822;Smalsučiai;Zuikių;38212233932;Taip;10;4;0;14
10823;Smalsučiai;Zuikių;62371825718;Taip;5;0;0;5
10824;Smalsučiai;Zuikių;70572717101;Taip;5;0;0;5
10825;Smalsučiai;Zuikių;69940677093;Taip;0;6;1;7
10826;Smalsučiai;Zuikių;85617121883;Taip;0;5;0;5
10827;Smalsučiai;Zuikių;32121383319;Taip;10;5;0;15
10828;Smalsučiai;Nykštukų;2327930850;Taip;0;18;0;18
10829;Smalsučiai;Nykštukų;3787937467;Taip;7;8;0;15
10830;Smalsučiai;Nykštukų;9155011285;Taip;5;6;0;11
10831;Smalsučiai;Nykštukų;9582225178;Taip;7;0;0;7
10832;Smalsučiai;Nykštukų;4566816316;Taip;0;4;0;4
10833;Smalsučiai;Nykštukų;1471941426;Taip;6;5;0;11
10834;Smalsučiai;Nykštukų;1458544456;Taip;5;1;0;6
10835;Smalsučiai;Nykštukų;6469604093;Taip;2;0;0;2
10836;Smalsučiai;Nykštukų;6358800570;Taip;10;0;0;10
10837;Smalsučiai;Nykštukų;5184903287;Taip;11;0;0;11
10838;Smalsučiai;Nykštukų;7933302912;Taip;3;9;0;12
10839;Smalsučiai;Nykštukų;3757955200;Taip;10;5;0;15
10840;Smalsučiai;Nykštukų;5406430393;Taip;15;0;0;15
10841;Smalsučiai;Nykštukų;6899040199;Taip;4;0;0;4
10842;Smalsučiai;Nykštukų;9241738140;Taip;0;4;0;4
10843;Smalsučiai;Katinėlių;8259056296;Taip;15;0;1;16
10844;Smalsučiai;Katinėlių;9864518144;Taip;5;0;0;5
10845;Smalsučiai;Katinėlių;2958335372;Taip;5;5;0;10
10846;Smalsučiai;Katinėlių;7137550663;Taip;0;4;0;4
10847;Smalsučiai;Katinėlių;6090391818;Taip;8;0;2;10
10848;Smalsučiai;Katinėlių;6577214344;Taip;0;5;0;5
10849;Smalsučiai;Katinėlių;6505671642;Taip;5;0;0;5
10850;Smalsučiai;Katinėlių;7396172351;Taip;10;0;0;10
10851;Smalsučiai;Katinėlių;8977651419;Taip;10;5;1;16
10852;Smalsučiai;Katinėlių;6406285034;Taip;5;0;1;6
10853;Smalsučiai;Katinėlių;6006832443;Taip;10;5;0;15
10854;Smalsučiai;Katinėlių;7726086066;Taip;5;0;0;5
10855;Smalsučiai;Katinėlių;8128348060;Taip;0;0;15;15
10856;Smalsučiai;Katinėlių;9637877396;Taip;12;0;5;17
10857;Smalsučiai;PELĖDŽIUKAI;8794407618;Taip;7;5;0;12
10858;Smalsučiai;PELĖDŽIUKAI;1374075909;Taip;6;3;0;9
10859;Smalsučiai;PELĖDŽIUKAI;3543889830;Taip;0;4;0;4
10860;Smalsučiai;PELĖDŽIUKAI;86106357239;Taip;6;0;0;6
10861;Smalsučiai;PELĖDŽIUKAI;67362576311;Taip;0;11;0;11
10862;Smalsučiai;PELĖDŽIUKAI;43758366827;Taip;5;5;0;10
10863;Smalsučiai;PELĖDŽIUKAI;42287520446;Taip;0;8;0;8
10864;Smalsučiai;PELĖDŽIUKAI;30890983859;Taip;0;6;1;7
10865;Smalsučiai;PELĖDŽIUKAI;72912782044;Taip;0;8;0;8
10866;Smalsučiai;PELĖDŽIUKAI;81140813811;Taip;5;5;0;10
10867;Smalsučiai;PELĖDŽIUKAI;3103358607;Taip;6;5;1;12
10868;Smalsučiai;PELĖDŽIUKAI;59084242712;Taip;6;5;0;11
10869;Smalsučiai;PELĖDŽIUKAI;66765363937;Taip;0;5;0;5
10870;Smalsučiai;PELĖDŽIUKAI;90351836816;Taip;5;0;0;5
10871;Smalsučiai;PELĖDŽIUKAI;22888541896;Taip;5;3;2;10
10872;Smalsučiai;PELĖDŽIUKAI;69010502468;Taip;0;5;0;5
10873;Smalsučiai;PELĖDŽIUKAI;50426509300;Taip;9;5;0;14
10874;Smalsučiai;PELĖDŽIUKAI;49495262113;Taip;0;2;0;2
10875;Smalsučiai;PELĖDŽIUKAI;98465335011;Taip;5;8;0;13
10876;Smalsučiai;Pingvinukai;99467576480;Taip;5;5;0;10
10877;Smalsučiai;Pingvinukai;5441966713;Taip;9;2;0;11
10878;Smalsučiai;Pingvinukai;8306946163;Taip;4;3;0;7
10879;Smalsučiai;Pingvinukai;1997966082;Taip;5;7;0;12
10880;Smalsučiai;Pingvinukai;4795138729;Taip;6;2;0;8
10881;Smalsučiai;Pingvinukai;2638709634;Taip;5;1;4;10
10882;Smalsučiai;Pingvinukai;6469044880;Taip;5;3;0;8
10883;Smalsučiai;Pingvinukai;1775539505;Taip;0;10;0;10
10884;Smalsučiai;Pingvinukai;1316590100;Taip;1;9;0;10
10885;Smalsučiai;Pingvinukai;2059832436;Taip;15;0;0;15
10886;Smalsučiai;Pingvinukai;8810690546;Taip;5;8;0;13
10887;Smalsučiai;Pingvinukai;4585930202;Taip;12;0;0;12
10888;Smalsučiai;Pingvinukai;9632022271;Taip;0;5;2;7
10889;Smalsučiai;Pingvinukai;2136420967;Taip;5;0;0;5
10890;Smalsučiai;Pingvinukai;1372591510;Taip;3;10;1;14
10891;Smalsučiai;Pingvinukai;8193410963;Taip;5;0;1;6
10892;Smalsučiai;Pingvinukai;3644256220;Taip;0;0;1;1
10893;Smalsučiai;Pingvinukai;6536165801;Taip;3;0;0;3
10894;Smalsučiai;Pingvinukai;4909226602;Taip;20;0;0;20
10895;Smalsučiai;Pingvinukai;2365835087;Taip;6;0;0;6
10896;Smalsučiai;Pingvinukai;5761169841;Taip;5;0;0;5
10897;Smalsučiai;Voverikų;44888860122;Taip;0;0;10;10
10898;Smalsučiai;Voverikų;2618753095;Taip;15;0;0;15
10899;Smalsučiai;Voverikų;7713078413;Taip;4;8;0;12
10900;Smalsučiai;Voverikų;3607226859;Taip;12;2;0;14
10901;Smalsučiai;Voverikų;22791221635;Taip;0;1;1;2
10902;Smalsučiai;Voverikų;7794541741;Taip;18;0;0;18
10903;Smalsučiai;Voverikų;1467603676;Taip;13;0;0;13
10904;Smalsučiai;Voverikų;1982046497;Taip;13;0;0;13
10905;Smalsučiai;Voverikų;1181574676;Taip;0;12;0;12
10906;Smalsučiai;Voverikų;1599488035;Taip;7;5;0;12
10907;Smalsučiai;Voverikų;6207026048;Taip;0;2;5;7
10908;Smalsučiai;Voverikų;19592364606;Taip;7;0;1;8
10909;Smalsučiai;Voverikų;1668692281;Taip;6;0;0;6
10910;Smalsučiai;Voverikų;5730866119;Taip;5;0;2;7
10911;Smalsučiai;Voverikų;1824321380;Taip;0;5;0;5
10912;Smalsučiai;Voverikų;5611487967;Taip;13;0;0;13
10913;Spindulėlis;SAULUTĖS;6435045068;Taip;0;5;0;5
10914;Spindulėlis;SAULUTĖS;1821231102;Taip;1;0;0;1
10915;Spindulėlis;SAULUTĖS;1514479696;Taip;16;0;2;18
10916;Spindulėlis;SAULUTĖS;27408123487;Taip;0;19;0;19
10917;Spindulėlis;SAULUTĖS;1394918021;Taip;0;5;0;5
10918;Spindulėlis;SAULUTĖS;9977569249;Taip;8;0;2;10
10919;Spindulėlis;SAULUTĖS;1180176295;Taip;6;1;0;7
10920;Spindulėlis;SAULUTĖS;1730248631;Taip;5;0;0;5
10921;Spindulėlis;SAULUTĖS;21152690883;Taip;2;2;0;4
10922;Spindulėlis;SAULUTĖS;1391226466;Taip;4;5;6;15
10923;Spindulėlis;SAULUTĖS;1694423628;Taip;5;4;0;9
10924;Spindulėlis;SAULUTĖS;1679106754;Taip;0;5;0;5
10925;Spindulėlis;SAULUTĖS;72997461686;Taip;5;0;0;5
10926;Spindulėlis;SAULUTĖS;4353031174;Taip;12;0;0;12
10927;Spindulėlis;SAULUTĖS;1346035733;Taip;0;8;0;8
10928;Spindulėlis;SAULUTĖS;9903990297;Taip;5;0;0;5
10929;Spindulėlis;SAULUTĖS;92417802345;Taip;5;0;2;7
10930;Spindulėlis;DRUGELIAI;30036722764;Ne;0;0;11;11
10931;Spindulėlis;DRUGELIAI;19541905006;Taip;0;10;0;10
10932;Spindulėlis;DRUGELIAI;27928352319;Taip;6;7;0;13
10933;Spindulėlis;DRUGELIAI;64339072411;Taip;15;0;0;15
10934;Spindulėlis;DRUGELIAI;27520164282;Taip;4;0;0;4
10935;Spindulėlis;DRUGELIAI;1528496272;Taip;20;0;0;20
10936;Spindulėlis;DRUGELIAI;503164673;Taip;3;1;1;5
10937;Spindulėlis;DRUGELIAI;1763306358;Taip;0;12;0;12
10938;Spindulėlis;DRUGELIAI;1033202443;Taip;6;5;0;11
10939;Spindulėlis;DRUGELIAI;1939526832;Taip;0;0;12;12
10940;Spindulėlis;DRUGELIAI;2988630379;Taip;4;5;0;9
10941;Spindulėlis;DRUGELIAI;55250330957;Taip;9;3;0;12
10942;Spindulėlis;DRUGELIAI;80331157814;Taip;8;2;0;10
10943;Spindulėlis;DRUGELIAI;2137229669;Taip;0;6;0;6
10944;Spindulėlis;DRUGELIAI;60956380679;Taip;13;2;0;15
10945;Spindulėlis;DRUGELIAI;29747353664;Taip;0;0;5;5
10946;Spindulėlis;DRUGELIAI;97661389553;Taip;0;7;0;7
10947;Spindulėlis;DRUGELIAI;2131409282;Taip;15;0;0;15
10948;Spindulėlis;DRUGELIAI;9348576749;Taip;8;5;0;13
10949;Spindulėlis;DRUGELIAI;63344816879;Taip;11;0;5;16
10950;Spindulėlis;DRUGELIAI;18443825776;Taip;0;0;5;5
10951;Spindulėlis;DRUGELIAI;9145337789;Taip;0;0;6;6
10952;Spindulėlis;DRUGELIAI;96365393879;Taip;0;9;0;9
10953;Spindulėlis;DRUGELIAI;7757264510;Taip;0;0;4;4
10954;Spindulėlis;DRUGELIAI;5050019035;Taip;10;5;0;15
10955;Spindulėlis;BITUTĖS;9729955786;Taip;8;5;0;13
10956;Spindulėlis;BITUTĖS;74912418250;Taip;8;2;0;10
10957;Spindulėlis;BITUTĖS;16110787934;Taip;6;5;0;11
10958;Spindulėlis;BITUTĖS;19056425785;Taip;0;10;0;10
10959;Spindulėlis;BITUTĖS;17990017515;Taip;8;5;0;13
10960;Spindulėlis;BITUTĖS;83727622058;Taip;8;5;0;13
10961;Spindulėlis;BITUTĖS;34303994728;Taip;10;5;0;15
10962;Spindulėlis;BITUTĖS;75678343003;Taip;0;1;4;5
10963;Spindulėlis;BITUTĖS;4798024997;Taip;0;3;0;3
10964;Spindulėlis;BITUTĖS;20440477805;Taip;9;0;0;9
10965;Spindulėlis;BITUTĖS;4842304821;Taip;0;9;0;9
10966;Spindulėlis;BITUTĖS;1492573735;Taip;5;1;2;8
10967;Spindulėlis;BITUTĖS;92803008887;Taip;0;2;0;2
10968;Spindulėlis;BITUTĖS;35801673097;Taip;8;6;0;14
10969;Spindulėlis;BITUTĖS;85203448043;Taip;6;5;1;12
10970;Spindulėlis;BITUTĖS;4539792030;Taip;15;0;0;15
10971;Spindulėlis;BITUTĖS;16045001090;Taip;0;5;0;5
10972;Spindulėlis;BITUTĖS;54418444052;Taip;0;9;0;9
10973;Spindulėlis;BITUTĖS;8934483022;Taip;1;5;0;6
10974;Spindulėlis;BITUTĖS;60061983557;Taip;4;5;0;9
10975;Spindulėlis;VARPELIAI;5288557629;Taip;5;5;0;10
10976;Spindulėlis;VARPELIAI;5233044803;Taip;0;6;0;6
10977;Spindulėlis;VARPELIAI;8923393066;Taip;10;0;1;11
10978;Spindulėlis;VARPELIAI;8141324449;Taip;13;0;0;13
10979;Spindulėlis;VARPELIAI;6449284856;Taip;7;0;13;20
10980;Spindulėlis;VARPELIAI;4077985773;Taip;0;8;0;8
10981;Spindulėlis;VARPELIAI;6592057292;Taip;10;0;0;10
10982;Spindulėlis;VARPELIAI;2890377876;Taip;3;0;8;11
10983;Spindulėlis;VARPELIAI;1454039572;Taip;7;0;1;8
10984;Spindulėlis;VARPELIAI;9511051386;Taip;20;0;0;20
10985;Spindulėlis;VARPELIAI;9740815635;Taip;0;0;4;4
10986;Spindulėlis;VARPELIAI;7099787230;Taip;8;0;0;8
10987;Spindulėlis;VARPELIAI;4308169582;Taip;20;0;0;20
10988;Spindulėlis;VARPELIAI;3088386659;Taip;0;0;18;18
10989;Spragtukas;NYKŠTUKAI;1756340613;Taip;10;0;0;10
10990;Spragtukas;NYKŠTUKAI;8226921630;Taip;5;3;0;8
10991;Spragtukas;NYKŠTUKAI;5236797574;Taip;0;2;0;2
10992;Spragtukas;NYKŠTUKAI;9860876807;Taip;0;3;0;3
10993;Spragtukas;NYKŠTUKAI;5633883897;Taip;0;4;0;4
10994;Spragtukas;NYKŠTUKAI;4069044269;Taip;0;8;0;8
10995;Spragtukas;NYKŠTUKAI;1771141306;Taip;0;9;0;9
10996;Spragtukas;NYKŠTUKAI;1306663967;Taip;0;9;0;9
10997;Spragtukas;NYKŠTUKAI;9965087132;Taip;0;8;0;8
10998;Spragtukas;NYKŠTUKAI;5844437769;Taip;10;0;0;10
10999;Spragtukas;NYKŠTUKAI;2946297529;Taip;14;1;0;15
11000;Spragtukas;NYKŠTUKAI;1570206034;Taip;5;0;0;5
11001;Spragtukas;NYKŠTUKAI;9754594384;Taip;11;0;0;11
11002;Spragtukas;NYKŠTUKAI;2909322678;Taip;0;6;0;6
11003;Spragtukas;SAULUTĖ;89749837388;Taip;2;2;1;5
11004;Spragtukas;SAULUTĖ;92289435393;Taip;0;5;2;7
11005;Spragtukas;SAULUTĖ;3392224465;Taip;0;5;0;5
11006;Spragtukas;SAULUTĖ;1174566363;Taip;10;0;0;10
11007;Spragtukas;SAULUTĖ;10998123453;Taip;0;6;0;6
11008;Spragtukas;SAULUTĖ;48934106998;Taip;0;0;3;3
11009;Spragtukas;SAULUTĖ;34989165939;Ne;0;1;0;1
11010;Spragtukas;SAULUTĖ;1527719937;Taip;3;2;0;5
11011;Spragtukas;SAULUTĖ;59444737813;Taip;4;5;2;11
11012;Spragtukas;SAULUTĖ;45289621684;Taip;0;5;0;5
11013;Spragtukas;SAULUTĖ;4321780080;Taip;8;0;0;8
11014;Spragtukas;SAULUTĖ;51889437335;Taip;0;5;0;5
11015;Spragtukas;SAULUTĖ;94483480424;Taip;2;5;0;7
11016;Spragtukas;SAULUTĖ;7234682005;Taip;0;9;0;9
11017;Spragtukas;SAULUTĖ;42635888133;Taip;0;4;0;4
11018;Spragtukas;SAULUTĖ;80790750169;Taip;8;1;1;10
11019;Spragtukas;SAULUTĖ;96435499947;Taip;0;0;1;1
11020;Spragtukas;SAULUTĖ;94418271961;Taip;0;2;0;2
11021;Spragtukas;SAULUTĖ;5377198769;Taip;5;4;0;9
11022;Spragtukas;SAULUTĖ;14001343134;Taip;0;6;0;6
11023;Spragtukas;SPINDULĖLIAI;61759595543;Taip;0;10;0;10
11024;Spragtukas;SPINDULĖLIAI;35161123605;Taip;0;0;3;3
11025;Spragtukas;SPINDULĖLIAI;89128154852;Taip;0;2;0;2
11026;Spragtukas;SPINDULĖLIAI;1992644726;Taip;5;1;0;6
11027;Spragtukas;SPINDULĖLIAI;78367721963;Taip;0;5;12;17
11028;Spragtukas;SPINDULĖLIAI;67682738316;Taip;3;1;0;4
11029;Spragtukas;SPINDULĖLIAI;33470312355;Taip;3;8;0;11
11030;Spragtukas;SPINDULĖLIAI;75118912674;Taip;5;4;0;9
11031;Spragtukas;SPINDULĖLIAI;18431696631;Taip;0;0;1;1
11032;Spragtukas;SPINDULĖLIAI;7036136306;Taip;0;5;0;5
11033;Spragtukas;SPINDULĖLIAI;88682218237;Taip;0;2;0;2
11034;Spragtukas;SPINDULĖLIAI;56973077439;Taip;0;3;0;3
11035;Spragtukas;SPINDULĖLIAI;19772337903;Taip;16;0;0;16
11036;Spragtukas;SPINDULĖLIAI;84255109367;Taip;0;6;0;6
11037;Spragtukas;SPINDULĖLIAI;73746856181;Taip;5;4;0;9
11038;Spragtukas;SPINDULĖLIAI;25586950966;Taip;10;4;0;14
11039;Spragtukas;SPINDULĖLIAI;22707134829;Taip;0;14;0;14
11040;Spragtukas;SPINDULĖLIAI;54800087274;Taip;10;1;0;11
11041;Spragtukas;SPINDULĖLIAI;60622170765;Taip;3;5;0;8
11042;Spragtukas;SPINDULĖLIAI;71104002732;Taip;0;13;0;13
11043;Spragtukas;GINTARĖLIAI;96995930924;Taip;6;6;0;12
11044;Spragtukas;GINTARĖLIAI;42746731488;Taip;0;13;0;13
11045;Spragtukas;GINTARĖLIAI;38858500522;Taip;0;2;0;2
11046;Spragtukas;GINTARĖLIAI;1437794402;Taip;0;6;0;6
11047;Spragtukas;GINTARĖLIAI;60731415960;Taip;0;11;0;11
11048;Spragtukas;GINTARĖLIAI;29398129736;Taip;4;6;0;10
11049;Spragtukas;GINTARĖLIAI;15208696709;Taip;0;1;0;1
11050;Spragtukas;GINTARĖLIAI;82498261158;Taip;0;7;0;7
11051;Spragtukas;GINTARĖLIAI;32290835176;Taip;0;20;0;20
11052;Spragtukas;GINTARĖLIAI;68059396649;Taip;0;12;0;12
11053;Spragtukas;GINTARĖLIAI;52904691894;Taip;8;0;0;8
11054;Spragtukas;GINTARĖLIAI;39962240237;Taip;5;8;0;13
11055;Spragtukas;GINTARĖLIAI;49941944569;Taip;10;0;0;10
11056;Spragtukas;GINTARĖLIAI;40971977434;Taip;0;9;0;9
11057;Spragtukas;GINTARĖLIAI;1035579583;Taip;5;9;0;14
11058;Spragtukas;GINTARĖLIAI;95645593385;Taip;0;1;0;1
11059;Spragtukas;GINTARĖLIAI;8554047390;Taip;0;7;0;7
11060;Spragtukas;GINTARĖLIAI;16927181370;Taip;0;11;0;11
11061;Spragtukas;ČIPOLINO;2371848091;Taip;7;6;0;13
11062;Spragtukas;ČIPOLINO;6582680700;Taip;4;6;0;10
11063;Spragtukas;ČIPOLINO;1599958343;Taip;8;1;0;9
11064;Spragtukas;ČIPOLINO;1547670082;Taip;0;1;0;1
11065;Spragtukas;ČIPOLINO;7504632314;Taip;0;8;0;8
11066;Spragtukas;ČIPOLINO;4066969586;Taip;20;0;0;20
11067;Spragtukas;ČIPOLINO;1597988501;Taip;6;0;0;6
11068;Spragtukas;ČIPOLINO;6526633051;Taip;0;4;0;4
11069;Spragtukas;ČIPOLINO;1058970799;Taip;5;3;0;8
11070;Spragtukas;ČIPOLINO;45661532130;Taip;4;2;0;6
11071;Spragtukas;ČIPOLINO;1224648193;Taip;0;17;0;17
11072;Spragtukas;ČIPOLINO;3045382299;Taip;0;2;0;2
11073;Spragtukas;ČIPOLINO;1365907314;Taip;4;0;0;4
11074;Spragtukas;ČIPOLINO;4941531443;Taip;3;0;0;3
11075;Spragtukas;ČIPOLINO;3566797064;Taip;5;0;0;5
11076;Spragtukas;ČIPOLINO;3798118695;Taip;15;3;0;18
11077;Spragtukas;ČIPOLINO;69114720307;Taip;6;1;0;7
11078;Spragtukas;ČIPOLINO;9789977863;Taip;0;12;0;12
11079;Spragtukas;BORUŽĖLĖS;2063156696;Taip;0;3;0;3
11080;Spragtukas;BORUŽĖLĖS;6729635545;Taip;7;7;0;14
11081;Spragtukas;BORUŽĖLĖS;1615068173;Taip;4;7;0;11
11082;Spragtukas;BORUŽĖLĖS;90741594830;Taip;9;3;0;12
11083;Spragtukas;BORUŽĖLĖS;87500842251;Taip;0;2;0;2
11084;Spragtukas;BORUŽĖLĖS;9962282406;Ne;5;4;0;9
11085;Spragtukas;BORUŽĖLĖS;1701035826;Ne;0;6;0;6
11086;Spragtukas;BORUŽĖLĖS;4513335615;Taip;0;6;0;6
11087;Spragtukas;BORUŽĖLĖS;69086864157;Taip;5;0;0;5
11088;Spragtukas;BORUŽĖLĖS;8415429693;Taip;0;10;0;10
11089;Spragtukas;DRUGELIAI;1190479265;Taip;9;0;0;9
11090;Spragtukas;DRUGELIAI;61714170354;Taip;0;5;0;5
11091;Spragtukas;DRUGELIAI;1570209659;Taip;4;5;0;9
11092;Spragtukas;DRUGELIAI;58366763944;Taip;0;5;0;5
11093;Spragtukas;DRUGELIAI;1212579682;Taip;9;0;0;9
11094;Spragtukas;DRUGELIAI;44715566085;Taip;3;0;0;3
11095;Spragtukas;DRUGELIAI;1082350468;Taip;9;0;1;10
11096;Spragtukas;DRUGELIAI;1668434690;Taip;4;0;0;4
11097;Spragtukas;DRUGELIAI;2086501624;Taip;7;0;0;7
11098;Spragtukas;DRUGELIAI;1035631190;Taip;8;0;0;8
11099;Spragtukas;DRUGELIAI;1751370218;Taip;6;0;0;6
11100;Spragtukas;DRUGELIAI;3508228828;Taip;0;5;2;7
11101;Spragtukas;DRUGELIAI;1315478099;Taip;7;1;1;9
11102;Spragtukas;DRUGELIAI;1779321635;Taip;6;0;0;6
11103;Spragtukas;DRUGELIAI;4542067558;Taip;11;0;1;12
11104;Spragtukas;DRUGELIAI;1400542296;Taip;4;0;2;6
11105;Spragtukas;DRUGELIAI;8516003036;Taip;4;0;1;5
11106;Spragtukas;DRUGELIAI;3181801668;Taip;7;1;1;9
11107;Spragtukas;DRUGELIAI;8826099483;Taip;0;4;2;6
11108;Spragtukas;GAIDELIAI;7569802487;Taip;0;5;0;5
11109;Spragtukas;GAIDELIAI;71081903240;Taip;0;5;0;5
11110;Spragtukas;GAIDELIAI;1305123801;Taip;0;7;0;7
11111;Spragtukas;GAIDELIAI;79237309377;Taip;0;6;0;6
11112;Spragtukas;GAIDELIAI;54099559107;Taip;10;0;0;10
11113;Spragtukas;GAIDELIAI;19453957982;Taip;7;5;0;12
11114;Spragtukas;GAIDELIAI;1203266608;Taip;2;0;0;2
11115;Spragtukas;GAIDELIAI;11849369985;Taip;13;0;0;13
11116;Spragtukas;GAIDELIAI;2042294168;Taip;6;0;0;6
11117;Spragtukas;GAIDELIAI;1030566027;Taip;11;2;0;13
11118;Spragtukas;GAIDELIAI;78296815539;Taip;0;3;1;4
11119;Spragtukas;GAIDELIAI;8150653485;Taip;5;5;0;10
11120;Spragtukas;GAIDELIAI;1247838976;Taip;13;2;0;15
11121;Spragtukas;GAIDELIAI;2061441977;Taip;0;5;0;5
11122;Spragtukas;GAIDELIAI;2848207417;Taip;6;0;0;6
11123;Spragtukas;GAIDELIAI;1210698072;Taip;5;6;0;11
11124;Spragtukas;GAIDELIAI;38120721944;Taip;0;8;0;8
11125;Spragtukas;GAIDELIAI;1070119148;Taip;0;18;0;18
11126;Spragtukas;GAIDELIAI;9235972927;Taip;0;9;0;9
11127;Spragtukas;ŽUVELĖS;32858776091;Taip;2;4;0;6
11128;Spragtukas;ŽUVELĖS;91794949460;Taip;5;2;0;7
11129;Spragtukas;ŽUVELĖS;2118272247;Taip;0;9;0;9
11130;Spragtukas;ŽUVELĖS;46794033116;Taip;7;1;0;8
11131;Spragtukas;ŽUVELĖS;1418494757;Taip;0;6;0;6
11132;Spragtukas;ŽUVELĖS;60980580078;Taip;4;5;0;9
11133;Spragtukas;ŽUVELĖS;82801263312;Taip;5;5;0;10
11134;Spragtukas;ŽUVELĖS;56384144331;Taip;4;6;0;10
11135;Spragtukas;ŽUVELĖS;2032107153;Taip;0;5;0;5
11136;Spragtukas;ŽUVELĖS;20279570129;Taip;5;6;1;12
11137;Spragtukas;ŽUVELĖS;19580966465;Taip;10;1;0;11
11138;Spragtukas;ŽUVELĖS;1731215395;Taip;15;5;0;20
11139;Spragtukas;ŽUVELĖS;1138975383;Taip;8;0;0;8
11140;Spragtukas;ŽUVELĖS;67679737675;Taip;6;0;0;6
11141;Spragtukas;ŽUVELĖS;1953368351;Taip;12;0;0;12
11142;Spragtukas;ŽUVELĖS;271958429;Taip;4;0;1;5
11143;Spragtukas;ŽUVELĖS;1030688447;Taip;13;0;0;13
11144;Spragtukas;ŽUVELĖS;1883944064;Taip;0;6;0;6
11145;Spragtukas;ŽUVELĖS;99915428485;Taip;5;1;0;6
11146;Spragtukas;ŽUVELĖS;41147623084;Taip;8;0;0;8
11147;Spragtukas;ŽUVELĖS;22025568463;Taip;6;1;0;7
11148;Spragtukas;ŽUVELĖS;1491147348;Taip;4;6;0;10
11149;Spragtukas;RIEŠUTĖLIAI;8444759709;Taip;0;13;0;13
11150;Spragtukas;RIEŠUTĖLIAI;1384812263;Taip;2;0;0;2
11151;Spragtukas;RIEŠUTĖLIAI;8463747761;Taip;0;1;2;3
11152;Spragtukas;RIEŠUTĖLIAI;6800727630;Taip;0;6;0;6
11153;Spragtukas;RIEŠUTĖLIAI;4131998934;Taip;0;6;1;7
11154;Spragtukas;RIEŠUTĖLIAI;1690400583;Taip;8;2;0;10
11155;Spragtukas;RIEŠUTĖLIAI;6419503965;Taip;0;9;0;9
11156;Spragtukas;RIEŠUTĖLIAI;8246512283;Taip;0;6;0;6
11157;Spragtukas;RIEŠUTĖLIAI;1627243902;Taip;9;0;0;9
11158;Spragtukas;RIEŠUTĖLIAI;1326603216;Taip;5;0;0;5
11159;Spragtukas;RIEŠUTĖLIAI;72636559695;Taip;6;1;0;7
11160;Spragtukas;RIEŠUTĖLIAI;6573750143;Taip;0;5;0;5
11161;Spragtukas;RIEŠUTĖLIAI;5306883933;Taip;6;1;0;7
11162;Spragtukas;RIEŠUTĖLIAI;3654640843;Taip;0;4;0;4
11163;Spragtukas;RIEŠUTĖLIAI;1849644444;Taip;0;2;1;3
11164;Spragtukas;RIEŠUTĖLIAI;9045185920;Taip;5;9;0;14
11165;Spragtukas;RIEŠUTĖLIAI;1800927281;Taip;1;2;0;3
11166;Spragtukas;RIEŠUTĖLIAI;1514277186;Taip;0;4;0;4
11167;Spragtukas;RIEŠUTĖLIAI;4427123314;Taip;0;7;0;7
11168;Spragtukas;RIEŠUTĖLIAI;3504197974;Taip;5;3;0;8
11169;Spragtukas;RIEŠUTĖLIAI;6322121173;Taip;0;6;0;6
11170;Spragtukas;RIEŠUTĖLIAI;3113106252;Taip;0;2;0;2
11171;Spragtukas;RIEŠUTĖLIAI;9314811354;Taip;0;13;0;13
11172;Spragtukas;VIŠČIUKAI;8429135626;Taip;0;15;0;15
11173;Spragtukas;VIŠČIUKAI;2356476212;Taip;8;5;1;14
11174;Spragtukas;VIŠČIUKAI;7070881522;Taip;0;13;0;13
11175;Spragtukas;VIŠČIUKAI;8652973900;Taip;0;14;0;14
11176;Spragtukas;VIŠČIUKAI;4527798635;Taip;2;0;0;2
11177;Spragtukas;VIŠČIUKAI;8551195766;Taip;7;0;1;8
11178;Spragtukas;VIŠČIUKAI;3261213140;Taip;8;0;0;8
11179;Spragtukas;VIŠČIUKAI;8623311748;Taip;12;0;0;12
11180;Spragtukas;VIŠČIUKAI;2943832694;Taip;0;2;0;2
11181;Spragtukas;VIŠČIUKAI;8460527225;Taip;4;5;0;9
11182;Spragtukas;VIŠČIUKAI;8297700739;Taip;20;0;0;20
11183;Spragtukas;VIŠČIUKAI;9595221494;Taip;0;3;0;3
11184;Spragtukas;VIŠČIUKAI;6185016824;Taip;0;6;0;6
11185;Spragtukas;VIŠČIUKAI;8715073512;Taip;7;0;0;7
11186;Spragtukas;VIŠČIUKAI;6162830167;Taip;15;5;0;20
11187;Spragtukas;VIŠČIUKAI;5150028968;Taip;13;0;0;13
11188;Spragtukas;VIŠČIUKAI;5689392663;Taip;10;0;0;10
11189;Spragtukas;VIŠČIUKAI;9805841777;Taip;4;2;0;6
11190;Spragtukas;MEŠKIUKAI;4669257062;Taip;8;3;0;11
11191;Spragtukas;MEŠKIUKAI;9592271053;Taip;8;0;0;8
11192;Spragtukas;MEŠKIUKAI;3968434618;Taip;0;5;0;5
11193;Spragtukas;MEŠKIUKAI;1150727381;Taip;0;4;0;4
11194;Spragtukas;MEŠKIUKAI;9191831532;Taip;0;3;0;3
11195;Spragtukas;MEŠKIUKAI;1272075883;Taip;0;5;0;5
11196;Spragtukas;MEŠKIUKAI;6465991136;Taip;10;0;0;10
11197;Spragtukas;MEŠKIUKAI;9282940430;Taip;0;11;0;11
11198;Spragtukas;MEŠKIUKAI;6503842956;Taip;10;5;0;15
11199;Spragtukas;MEŠKIUKAI;3189741449;Taip;9;5;0;14
11200;Spragtukas;MEŠKIUKAI;4344537391;Taip;5;6;0;11
11201;Spragtukas;MEŠKIUKAI;6757604305;Taip;20;0;0;20
11202;Spragtukas;MEŠKIUKAI;2076126173;Taip;8;5;0;13
11203;Spragtukas;MEŠKIUKAI;7859959104;Taip;10;5;0;15
11204;Spragtukas;MEŠKIUKAI;4548945364;Taip;9;5;0;14
11205;Strazdelis;Žiogelių;59969322783;Taip;0;1;0;1
11206;Strazdelis;Žiogelių;48052363003;Taip;7;4;0;11
11207;Strazdelis;Žiogelių;12739940649;Taip;7;0;0;7
11208;Strazdelis;Žiogelių;79443961061;Taip;0;8;0;8
11209;Strazdelis;Žiogelių;84548133061;Taip;10;2;0;12
11210;Strazdelis;Žiogelių;4013389618;Ne;10;1;0;11
11211;Strazdelis;Žiogelių;5449465531;Taip;0;1;0;1
11212;Strazdelis;Žiogelių;57514782479;Taip;13;7;0;20
11213;Strazdelis;Žiogelių;53114476996;Taip;5;5;0;10
11214;Strazdelis;Žiogelių;50984917126;Taip;0;8;0;8
11215;Strazdelis;Žiogelių;43128715501;Taip;12;0;0;12
11216;Strazdelis;Žiogelių;1058210612;Taip;9;0;0;9
11217;Strazdelis;Žiogelių;85877157333;Taip;6;5;1;12
11218;Strazdelis;Žiogelių;2110092578;Taip;8;1;0;9
11219;Strazdelis;Žiogelių;90936509570;Taip;2;7;2;11
11220;Strazdelis;Žiogelių;64076729200;Taip;10;8;0;18
11221;Strazdelis;Žiogelių;1858519255;Taip;10;6;0;16
11222;Strazdelis;Žiogelių;20845810823;Taip;5;7;0;12
11223;Strazdelis;Žiogelių;98433672584;Taip;10;0;0;10
11224;Strazdelis;Žiogelių;2086723106;Taip;15;0;1;16
11225;Strazdelis;Žiogelių;20510560289;Taip;0;1;0;1
11226;Strazdelis;Šeimynėlės;4454199703;Taip;7;0;0;7
11227;Strazdelis;Šeimynėlės;3662217925;Taip;12;0;0;12
11228;Strazdelis;Šeimynėlės;4698566091;Taip;9;2;0;11
11229;Strazdelis;Šeimynėlės;8274897977;Taip;15;0;0;15
11230;Strazdelis;Šeimynėlės;45083023033;Taip;12;1;0;13
11231;Strazdelis;Šeimynėlės;5698472204;Taip;19;0;0;19
11232;Strazdelis;Šeimynėlės;29586826889;Taip;20;0;0;20
11233;Strazdelis;Šeimynėlės;6528024720;Taip;5;2;0;7
11234;Strazdelis;Šeimynėlės;9672736975;Taip;6;3;4;13
11235;Strazdelis;Šeimynėlės;43314069648;Taip;0;6;0;6
11236;Strazdelis;Šeimynėlės;4697537943;Taip;17;0;0;17
11237;Strazdelis;Šeimynėlės;9835716116;Taip;5;3;0;8
11238;Strazdelis;Šeimynėlės;3943578036;Taip;15;1;0;16
11239;Strazdelis;Šeimynėlės;2802486859;Taip;6;5;0;11
11240;Strazdelis;Šeimynėlės;4791752179;Taip;8;0;0;8
11241;Strazdelis;Šeimynėlės;7215063033;Taip;0;1;0;1
11242;Strazdelis;Šeimynėlės;7149827850;Taip;0;12;0;12
11243;Strazdelis;Šeimynėlės;1665134387;Taip;9;6;0;15
11244;Strazdelis;Šeimynėlės;1481671624;Taip;10;2;0;12
11245;Strazdelis;Šeimynėlės;6014213362;Taip;8;0;0;8
11246;Strazdelis;Genelio;8754275576;Taip;0;2;1;3
11247;Strazdelis;Genelio;7216768880;Taip;5;8;0;13
11248;Strazdelis;Genelio;1540973269;Taip;0;1;0;1
11249;Strazdelis;Genelio;7120717682;Taip;0;6;0;6
11250;Strazdelis;Genelio;50350281905;Taip;10;5;0;15
11251;Strazdelis;Genelio;1187534672;Taip;0;2;0;2
11252;Strazdelis;Genelio;9198429790;Taip;0;1;0;1
11253;Strazdelis;Genelio;2871673641;Taip;3;7;0;10
11254;Strazdelis;Genelio;6147183190;Taip;10;5;0;15
11255;Strazdelis;Genelio;2078150337;Taip;15;0;0;15
11256;Strazdelis;Genelio;18461074207;Taip;10;3;0;13
11257;Strazdelis;Genelio;1362428967;Taip;7;2;0;9
11258;Strazdelis;Genelio;8801420992;Taip;0;5;0;5
11259;Strazdelis;Genelio;8634815556;Taip;2;2;2;6
11260;Strazdelis;Genelio;9904719582;Taip;12;0;0;12
11261;Strazdelis;Genelio;7308925265;Taip;17;0;0;17
11262;Strazdelis;Genelio;4655931716;Taip;0;7;5;12
11263;Strazdelis;Genelio;8182994112;Taip;16;0;0;16
11264;Strazdelis;Genelio;5371939820;Taip;0;4;0;4
11265;Strazdelis;Genelio;68605763183;Taip;16;3;0;19
11266;Strazdelis;Vikruolių;58844235230;Taip;0;7;0;7
11267;Strazdelis;Vikruolių;7549142768;Ne;2;5;0;7
11268;Strazdelis;Vikruolių;62366722408;Taip;7;10;0;17
11269;Strazdelis;Vikruolių;98620402347;Taip;0;8;0;8
11270;Strazdelis;Vikruolių;79337959137;Taip;0;18;0;18
11271;Strazdelis;Vikruolių;56331124076;Taip;0;6;0;6
11272;Strazdelis;Vikruolių;14923406397;Taip;1;0;0;1
11273;Strazdelis;Vikruolių;70999059743;Taip;0;4;0;4
11274;Strazdelis;Vikruolių;33107603963;Ne;5;3;0;8
11275;Strazdelis;Vikruolių;29094108735;Taip;0;3;0;3
11276;Strazdelis;Vikruolių;1952649844;Taip;2;5;0;7
11277;Strazdelis;Vikruolių;90310485415;Taip;5;0;0;5
11278;Strazdelis;Vikruolių;97958963239;Taip;5;0;0;5
11279;Strazdelis;Vikruolių;75235370334;Taip;3;4;0;7
11280;Strazdelis;Vikruolių;42180634251;Taip;0;5;0;5
11281;Strazdelis;Vikruolių;54028832658;Taip;0;1;0;1
11282;Strazdelis;Vikruolių;30372050952;Taip;0;2;0;2
11283;Strazdelis;Vikruolių;39915650220;Ne;0;6;0;6
11284;Strazdelis;Vikruolių;3292943291;Taip;6;7;0;13
11285;Strazdelis;Vikruolių;75528880272;Taip;2;2;0;4
11286;Strazdelis;Vikruolių;97790033745;Taip;3;5;0;8
11287;Strazdelis;Vikruolių;96227697952;Taip;3;4;0;7
11288;Strazdelis;Vikruolių;83264226550;Taip;0;2;0;2
11289;Strazdelis;Vyturėlių;89976183528;Taip;10;0;0;10
11290;Strazdelis;Vyturėlių;67195412172;Taip;0;2;0;2
11291;Strazdelis;Vyturėlių;52370891798;Taip;4;6;0;10
11292;Strazdelis;Vyturėlių;21075820140;Taip;2;6;0;8
11293;Strazdelis;Vyturėlių;88801862582;Taip;0;6;0;6
11294;Strazdelis;Vyturėlių;33675356631;Ne;0;1;0;1
11295;Strazdelis;Vyturėlių;71377546049;Taip;13;0;0;13
11296;Strazdelis;Vyturėlių;1499287166;Taip;15;0;0;15
11297;Strazdelis;Vyturėlių;66353793576;Taip;0;16;0;16
11298;Strazdelis;Vyturėlių;38843113574;Taip;0;5;0;5
11299;Strazdelis;Vyturėlių;39525751316;Taip;0;5;0;5
11300;Strazdelis;Vyturėlių;24240557041;Taip;0;6;0;6
11301;Strazdelis;Vyturėlių;26311407354;Taip;4;0;0;4
11302;Strazdelis;Vyturėlių;60144664935;Taip;0;7;0;7
11303;Strazdelis;Vyturėlių;53302522911;Taip;4;2;0;6
11304;Strazdelis;Vyturėlių;1888068247;Taip;0;6;0;6
11305;Strazdelis;Vyturėlių;1347273712;Taip;7;5;0;12
11306;Strazdelis;Vyturėlių;1611711233;Taip;14;2;0;16
11307;Strazdelis;Vyturėlių;20384116848;Taip;9;0;0;9
11308;Strazdelis;Vyturėlių;41690491541;Taip;0;3;0;3
11309;Strazdelis;Vyturėlių;62150824334;Taip;11;2;0;13
11310;Strazdelis;Vyturėlių;3320884603;Taip;5;12;0;17
11311;Strazdelis;Varpelio;43722400626;Taip;1;7;0;8
11312;Strazdelis;Varpelio;39502125227;Taip;20;0;0;20
11313;Strazdelis;Varpelio;2502465398;Taip;4;3;0;7
11314;Strazdelis;Varpelio;83919699672;Taip;0;2;0;2
11315;Strazdelis;Varpelio;1426195737;Taip;0;9;0;9
11316;Strazdelis;Varpelio;86957187003;Taip;3;9;0;12
11317;Strazdelis;Varpelio;52211473547;Taip;0;14;0;14
11318;Strazdelis;Varpelio;54646720821;Taip;0;1;0;1
11319;Strazdelis;Varpelio;62063592887;Taip;0;7;0;7
11320;Strazdelis;Varpelio;95260832237;Taip;0;1;0;1
11321;Strazdelis;Varpelio;47899514138;Taip;11;0;0;11
11322;Strazdelis;Varpelio;3636163418;Taip;10;1;0;11
11323;Strazdelis;Varpelio;17045991832;Taip;0;6;0;6
11324;Strazdelis;Varpelio;58143176237;Taip;4;12;0;16
11325;Strazdelis;Varpelio;58440671129;Taip;5;5;0;10
11326;Strazdelis;Varpelio;1785962711;Taip;0;15;0;15
11327;Strazdelis;Varpelio;98818869900;Taip;0;6;0;6
11328;Strazdelis;Varpelio;1535288878;Taip;0;4;0;4
11329;Strazdelis;Varpelio;49277241025;Taip;0;6;0;6
11330;Strazdelis;Varpelio;1707225898;Taip;0;6;0;6
11331;Strazdelis;Pelėdžiukų;13220421668;Taip;0;2;0;2
11332;Strazdelis;Pelėdžiukų;13625184061;Taip;5;8;0;13
11333;Strazdelis;Pelėdžiukų;73711363249;Taip;3;5;0;8
11334;Strazdelis;Pelėdžiukų;66197587093;Taip;5;5;0;10
11335;Strazdelis;Pelėdžiukų;62754553467;Taip;6;5;0;11
11336;Strazdelis;Pelėdžiukų;16453584376;Taip;5;5;0;10
11337;Strazdelis;Pelėdžiukų;72069723016;Taip;5;8;0;13
11338;Strazdelis;Pelėdžiukų;63720428545;Taip;12;4;0;16
11339;Strazdelis;Pelėdžiukų;54050062292;Taip;0;9;0;9
11340;Strazdelis;Pelėdžiukų;10196561042;Taip;0;1;0;1
11341;Strazdelis;Pelėdžiukų;44566447637;Taip;5;5;0;10
11342;Strazdelis;Pelėdžiukų;64675347442;Taip;5;0;0;5
11343;Strazdelis;Pelėdžiukų;18595696353;Taip;10;1;0;11
11344;Strazdelis;Pelėdžiukų;23371576969;Ne;5;7;0;12
11345;Strazdelis;Pelėdžiukų;87689168341;Taip;0;6;0;6
11346;Strazdelis;Pelėdžiukų;23376659452;Taip;0;6;0;6
11347;Strazdelis;Pelėdžiukų;86783302100;Taip;3;4;0;7
11348;Strazdelis;Pelėdžiukų;56012252629;Taip;0;6;0;6
11349;Strazdelis;Pelėdžiukų;77589342371;Taip;0;8;0;8
11350;Strazdelis;Pelėdžiukų;52790577750;Taip;19;0;0;19
11351;Strazdelis;Pelėdžiukų;1140100663;Taip;5;4;0;9
11352;Strazdelis;Saulutės;1693309238;Taip;0;3;0;3
11353;Strazdelis;Saulutės;1474503932;Taip;6;2;0;8
11354;Strazdelis;Saulutės;27177757900;Taip;5;5;0;10
11355;Strazdelis;Saulutės;1886601605;Taip;0;3;0;3
11356;Strazdelis;Saulutės;40932140069;Taip;5;1;0;6
11357;Strazdelis;Saulutės;1523471662;Taip;12;4;0;16
11358;Strazdelis;Saulutės;2854642875;Taip;15;0;0;15
11359;Strazdelis;Saulutės;7578229276;Taip;5;0;0;5
11360;Strazdelis;Saulutės;8710848483;Taip;10;0;0;10
11361;Strazdelis;Saulutės;8808299050;Taip;5;0;0;5
11362;Strazdelis;Saulutės;6614184499;Taip;0;10;0;10
11363;Strazdelis;Saulutės;4129957131;Taip;8;0;0;8
11364;Strazdelis;Saulutės;3425430317;Taip;6;1;0;7
11365;Strazdelis;Saulutės;5059832307;Taip;9;0;0;9
11366;Strazdelis;Saulutės;7081517417;Taip;10;5;0;15
11367;Strazdelis;Saulutės;67641340859;Taip;6;1;0;7
11368;Strazdelis;Saulutės;15298412755;Taip;0;9;0;9
11369;Strazdelis;Saulutės;12713270671;Taip;5;0;0;5
11370;Strazdelis;Saulutės;6113491562;Taip;5;0;0;5
11371;Strazdelis;Saulutės;1802092125;Taip;10;0;0;10
11372;Strazdelis;Saulutės;1391009140;Taip;5;5;0;10
11373;Strazdelis;Saulutės;6779352728;Taip;10;0;0;10
11374;Strazdelis;Saulutės;29225108934;Taip;10;1;0;11
11375;Strazdelis;Bitutės;99973904527;Taip;5;5;0;10
11376;Strazdelis;Bitutės;92799934389;Taip;15;5;0;20
11377;Strazdelis;Bitutės;9065275674;Taip;10;0;0;10
11378;Strazdelis;Bitutės;33123804487;Taip;0;2;0;2
11379;Strazdelis;Bitutės;6523307315;Taip;20;0;0;20
11380;Strazdelis;Bitutės;15920566059;Taip;0;12;0;12
11381;Strazdelis;Bitutės;18222675927;Taip;0;10;0;10
11382;Strazdelis;Bitutės;47547568043;Ne;0;5;0;5
11383;Strazdelis;Bitutės;66254701944;Taip;0;11;0;11
11384;Strazdelis;Bitutės;24001445236;Taip;0;6;0;6
11385;Strazdelis;Bitutės;96062922228;Taip;0;5;0;5
11386;Strazdelis;Bitutės;24669852216;Taip;0;5;0;5
11387;Strazdelis;Bitutės;51702469375;Taip;0;1;0;1
11388;Strazdelis;Bitutės;59837435595;Taip;0;13;0;13
11389;Strazdelis;Bitutės;90089166514;Taip;20;0;0;20
11390;Strazdelis;Bitutės;1847755442;Taip;4;0;0;4
11391;Strazdelis;Bitutės;7812253305;Taip;0;5;0;5
11392;Strazdelis;Bitutės;61820727992;Taip;5;0;0;5
11393;Strazdelis;Bitutės;2673522432;Taip;6;6;0;12
11394;Strazdelis;Mažylių;1955166372;Taip;5;0;0;5
11395;Strazdelis;Mažylių;8415383526;Taip;5;7;0;12
11396;Strazdelis;Mažylių;2963535523;Taip;4;0;0;4
11397;Strazdelis;Mažylių;6931726275;Taip;20;0;0;20
11398;Strazdelis;Mažylių;6311710825;Taip;11;1;0;12
11399;Strazdelis;Mažylių;4873707286;Taip;10;2;0;12
11400;Strazdelis;Mažylių;4076266466;Taip;20;0;0;20
11401;Strazdelis;Mažylių;2824416350;Taip;13;1;0;14
11402;Strazdelis;Mažylių;3610250359;Taip;11;7;0;18
11403;Strazdelis;Mažylių;2580733127;Taip;8;0;0;8
11404;Strazdelis;Mažylių;2662549392;Taip;0;2;0;2
11405;Strazdelis;Mažylių;9502341478;Taip;3;2;0;5
11406;Strazdelis;Mažylių;2251157025;Taip;7;0;3;10
11407;Strazdelis;Mažylių;9401101407;Taip;0;13;0;13
11408;Strazdelis;Mažylių;6527855940;Taip;2;4;0;6
11409;Strazdelis;Pabiručių;1021364759;Taip;11;6;0;17
11410;Strazdelis;Pabiručių;8287554571;Taip;4;1;0;5
11411;Strazdelis;Pabiručių;1704292727;Taip;10;0;0;10
11412;Strazdelis;Pabiručių;4617237063;Taip;12;1;0;13
11413;Strazdelis;Pabiručių;3036380561;Taip;12;1;0;13
11414;Strazdelis;Pabiručių;4562530311;Taip;5;2;0;7
11415;Strazdelis;Pabiručių;6046139859;Taip;3;2;0;5
11416;Strazdelis;Pabiručių;4448556404;Taip;12;0;0;12
11417;Strazdelis;Pabiručių;8854150040;Taip;0;6;0;6
11418;Strazdelis;Pabiručių;1901641517;Taip;12;1;0;13
11419;Strazdelis;Pabiručių;8371999002;Taip;4;5;0;9
11420;Šermukšnėlė;MOLINUKAI;68060386099;Taip;0;0;1;1
11421;Šermukšnėlė;MOLINUKAI;28007013244;Taip;0;2;0;2
11422;Šermukšnėlė;MOLINUKAI;82928987881;Taip;0;1;2;3
11423;Šermukšnėlė;MOLINUKAI;42211665091;Taip;0;2;2;4
11424;Šermukšnėlė;MOLINUKAI;77238595800;Taip;3;0;0;3
11425;Šermukšnėlė;MOLINUKAI;87315703379;Taip;0;11;0;11
11426;Šermukšnėlė;MOLINUKAI;61809452162;Taip;0;2;0;2
11427;Šermukšnėlė;MOLINUKAI;60863269031;Taip;10;0;0;10
11428;Šermukšnėlė;MOLINUKAI;28087351377;Taip;10;5;0;15
11429;Šermukšnėlė;MOLINUKAI;63858537394;Taip;0;2;0;2
11430;Šermukšnėlė;MOLINUKAI;39534021804;Taip;16;0;0;16
11431;Šermukšnėlė;MOLINUKAI;54312555311;Taip;10;0;1;11
11432;Šermukšnėlė;MOLINUKAI;2100740973;Taip;4;5;1;10
11433;Šermukšnėlė;MOLINUKAI;3873114056;Taip;16;0;0;16
11434;Šermukšnėlė;MOLINUKAI;1561527473;Taip;0;1;2;3
11435;Šermukšnėlė;MOLINUKAI;1738008915;Taip;9;6;0;15
11436;Šermukšnėlė;MOLINUKAI;38451276871;Taip;10;0;1;11
11437;Šermukšnėlė;ŠIAUDINUKAI;85959255744;Taip;0;5;0;5
11438;Šermukšnėlė;ŠIAUDINUKAI;29600546074;Taip;5;6;0;11
11439;Šermukšnėlė;ŠIAUDINUKAI;61916462777;Taip;1;4;0;5
11440;Šermukšnėlė;ŠIAUDINUKAI;95999386401;Taip;13;0;0;13
11441;Šermukšnėlė;ŠIAUDINUKAI;26710222684;Taip;7;5;0;12
11442;Šermukšnėlė;ŠIAUDINUKAI;34526101469;Taip;0;10;0;10
11443;Šermukšnėlė;ŠIAUDINUKAI;2734502079;Taip;5;5;0;10
11444;Šermukšnėlė;ŠIAUDINUKAI;27112465050;Taip;0;10;0;10
11445;Šermukšnėlė;ŠIAUDINUKAI;33885733234;Taip;0;0;1;1
11446;Šermukšnėlė;ŠIAUDINUKAI;80780535536;Taip;0;5;0;5
11447;Šermukšnėlė;ŠIAUDINUKAI;4487587228;Taip;0;9;0;9
11448;Šermukšnėlė;ŠIAUDINUKAI;18100145020;Taip;4;0;0;4
11449;Šermukšnėlė;ŠIAUDINUKAI;63943361071;Taip;0;10;0;10
11450;Šermukšnėlė;ŠIAUDINUKAI;16859553972;Taip;5;5;0;10
11451;Šermukšnėlė;ŠIAUDINUKAI;32403224788;Taip;8;0;0;8
11452;Šermukšnėlė;ŠIAUDINUKAI;99444734331;Taip;5;0;0;5
11453;Šermukšnėlė;ŠIAUDINUKAI;3851927973;Taip;0;2;8;10
11454;Šermukšnėlė;TOŠINUKAI;8648722780;Taip;0;5;1;6
11455;Šermukšnėlė;TOŠINUKAI;10371439347;Taip;0;11;0;11
11456;Šermukšnėlė;TOŠINUKAI;53558901565;Taip;0;5;0;5
11457;Šermukšnėlė;TOŠINUKAI;5263529062;Taip;0;9;0;9
11458;Šermukšnėlė;TOŠINUKAI;70200454607;Taip;0;0;4;4
11459;Šermukšnėlė;TOŠINUKAI;91969292233;Taip;0;0;3;3
11460;Šermukšnėlė;TOŠINUKAI;7424170593;Taip;2;0;0;2
11461;Šermukšnėlė;TOŠINUKAI;1290319484;Taip;0;2;5;7
11462;Šermukšnėlė;TOŠINUKAI;1636627303;Taip;6;5;0;11
11463;Šermukšnėlė;TOŠINUKAI;1846720859;Taip;5;0;0;5
11464;Šermukšnėlė;TOŠINUKAI;51058072005;Taip;0;2;0;2
11465;Šermukšnėlė;TOŠINUKAI;2137141949;Taip;0;8;0;8
11466;Šermukšnėlė;TOŠINUKAI;1858862320;Taip;9;1;2;12
11467;Šermukšnėlė;TOŠINUKAI;1016403317;Taip;3;1;0;4
11468;Šermukšnėlė;TOŠINUKAI;42127117636;Taip;0;0;3;3
11469;Šermukšnėlė;TOŠINUKAI;2477657052;Taip;1;0;0;1
11470;Šermukšnėlė;TOŠINUKAI;85018940292;Taip;15;0;0;15
11471;Šermukšnėlė;ODINUKAI;9132691512;Taip;0;5;0;5
11472;Šermukšnėlė;ODINUKAI;33974692298;Taip;0;5;0;5
11473;Šermukšnėlė;ODINUKAI;41864110754;Taip;0;9;0;9
11474;Šermukšnėlė;ODINUKAI;33749192545;Taip;0;5;0;5
11475;Šermukšnėlė;ODINUKAI;52024313118;Taip;0;0;1;1
11476;Šermukšnėlė;ODINUKAI;56169221671;Taip;10;5;0;15
11477;Šermukšnėlė;ODINUKAI;17772742478;Taip;0;2;0;2
11478;Šermukšnėlė;ODINUKAI;74932757076;Taip;0;9;0;9
11479;Šermukšnėlė;ODINUKAI;29953350731;Taip;0;5;0;5
11480;Šermukšnėlė;ODINUKAI;33022961239;Taip;7;0;0;7
11481;Šermukšnėlė;ODINUKAI;72671813439;Taip;0;5;0;5
11482;Šermukšnėlė;ODINUKAI;87510707958;Taip;3;10;0;13
11483;Šermukšnėlė;ODINUKAI;12208634069;Taip;0;1;0;1
11484;Šermukšnėlė;ODINUKAI;54578226695;Taip;6;4;2;12
11485;Šermukšnėlė;ODINUKAI;29671788305;Taip;10;5;1;16
11486;Šermukšnėlė;ODINUKAI;89495591163;Taip;1;5;0;6
11487;Šermukšnėlė;ODINUKAI;53753895760;Taip;0;3;0;3
11488;Šermukšnėlė;ODINUKAI;1911285078;Taip;0;9;3;12
11489;Šermukšnėlė;KRIAUKLELĖS;98850511500;Taip;10;6;0;16
11490;Šermukšnėlė;KRIAUKLELĖS;26775257484;Taip;15;2;0;17
11491;Šermukšnėlė;KRIAUKLELĖS;11053850075;Taip;2;2;0;4
11492;Šermukšnėlė;KRIAUKLELĖS;88079185483;Taip;20;0;0;20
11493;Šermukšnėlė;KRIAUKLELĖS;80349025945;Taip;12;1;3;16
11494;Šermukšnėlė;KRIAUKLELĖS;2561033248;Taip;11;4;0;15
11495;Šermukšnėlė;KRIAUKLELĖS;48653098796;Taip;0;7;0;7
11496;Šermukšnėlė;KRIAUKLELĖS;8123096990;Taip;10;3;0;13
11497;Šermukšnėlė;KRIAUKLELĖS;1492328724;Taip;5;0;0;5
11498;Šermukšnėlė;KRIAUKLELĖS;82028252228;Taip;15;3;0;18
11499;Šermukšnėlė;KRIAUKLELĖS;1110375562;Taip;0;12;0;12
11500;Šermukšnėlė;KRIAUKLELĖS;23434568160;Taip;10;5;0;15
11501;Šermukšnėlė;KRIAUKLELĖS;1562494176;Taip;0;6;0;6
11502;Šermukšnėlė;KRIAUKLELĖS;3543061360;Taip;10;7;0;17
11503;Šermukšnėlė;KRIAUKLELĖS;8511421692;Taip;5;1;1;7
11504;Šermukšnėlė;KRIAUKLELĖS;6896990721;Taip;8;0;2;10
11505;Šermukšnėlė;KRIAUKLELĖS;7564745299;Taip;7;10;0;17
11506;Šermukšnėlė;KRIAUKLELĖS;6937555692;Taip;15;0;0;15
11507;Šermukšnėlė;KRIAUKLELĖS;9617044855;Taip;6;11;0;17
11508;Šermukšnėlė;VYTINUKAI;4601810772;Taip;11;4;0;15
11509;Šermukšnėlė;VYTINUKAI;97906920174;Taip;12;0;1;13
11510;Šermukšnėlė;VYTINUKAI;1523361932;Taip;0;0;2;2
11511;Šermukšnėlė;VYTINUKAI;8531953934;Taip;6;5;0;11
11512;Šermukšnėlė;VYTINUKAI;25189813939;Taip;6;10;0;16
11513;Šermukšnėlė;VYTINUKAI;83123267733;Taip;4;9;0;13
11514;Šermukšnėlė;VYTINUKAI;20028832329;Taip;3;1;0;4
11515;Šermukšnėlė;VYTINUKAI;8498288021;Taip;0;0;1;1
11516;Šermukšnėlė;VYTINUKAI;3751769136;Taip;8;5;1;14
11517;Šermukšnėlė;VYTINUKAI;5905000902;Taip;6;0;1;7
11518;Šermukšnėlė;VYTINUKAI;6291531570;Taip;5;0;0;5
11519;Šermukšnėlė;VYTINUKAI;8398961969;Taip;5;0;1;6
11520;Šermukšnėlė;VYTINUKAI;1244964311;Taip;10;0;0;10
11521;Šermukšnėlė;VYTINUKAI;83882579952;Taip;5;3;0;8
11522;Šermukšnėlė;VYTINUKAI;60840526220;Taip;0;0;1;1
11523;Šermukšnėlė;VYTINUKAI;8610668395;Taip;5;6;0;11
11524;Šermukšnėlė;VYTINUKAI;1025787925;Taip;7;0;0;7
11525;Šermukšnėlė;VYTINUKAI;1519623099;Taip;3;1;0;4
11526;Šermukšnėlė;GINTARĖLIAI;3147809450;Taip;0;1;0;1
11527;Šermukšnėlė;GINTARĖLIAI;1167696952;Taip;5;6;0;11
11528;Šermukšnėlė;GINTARĖLIAI;85062380771;Taip;1;4;2;7
11529;Šermukšnėlė;GINTARĖLIAI;35389950541;Taip;0;9;11;20
11530;Šermukšnėlė;GINTARĖLIAI;82240400954;Taip;0;6;1;7
11531;Šermukšnėlė;GINTARĖLIAI;17839725884;Taip;6;0;0;6
11532;Šermukšnėlė;GINTARĖLIAI;1944687724;Taip;10;0;0;10
11533;Šermukšnėlė;GINTARĖLIAI;1013698297;Taip;6;0;1;7
11534;Šermukšnėlė;GINTARĖLIAI;2094932013;Taip;5;2;0;7
11535;Šermukšnėlė;GINTARĖLIAI;1853346049;Taip;10;0;0;10
11536;Šermukšnėlė;GINTARĖLIAI;1851549466;Taip;6;0;0;6
11537;Šermukšnėlė;GINTARĖLIAI;3697936074;Taip;20;0;0;20
11538;Šermukšnėlė;GINTARĖLIAI;2686950289;Taip;10;1;0;11
11539;Šermukšnėlė;GINTARĖLIAI;27183547828;Taip;15;0;0;15
11540;Šermukšnėlė;GINTARĖLIAI;10728235594;Taip;16;0;4;20
11541;Šermukšnėlė;GINTARĖLIAI;42477406335;Taip;8;0;3;11
11542;Šermukšnėlė;GINTARĖLIAI;61300763004;Taip;8;0;0;8
11543;Šermukšnėlė;GINTARĖLIAI;1425285365;Taip;4;5;0;9
11544;Šermukšnėlė;GINTARĖLIAI;6279210465;Taip;6;5;2;13
11545;Šermukšnėlė;AKMENUKAI;17555989996;Taip;0;5;0;5
11546;Šermukšnėlė;AKMENUKAI;60154507177;Taip;0;2;4;6
11547;Šermukšnėlė;AKMENUKAI;6987675764;Taip;0;3;3;6
11548;Šermukšnėlė;AKMENUKAI;20272898512;Taip;0;5;2;7
11549;Šermukšnėlė;AKMENUKAI;6604797702;Taip;0;2;5;7
11550;Šermukšnėlė;AKMENUKAI;84341960638;Taip;0;1;1;2
11551;Šermukšnėlė;AKMENUKAI;95089450234;Taip;0;2;0;2
11552;Šermukšnėlė;AKMENUKAI;80199267729;Taip;0;1;0;1
11553;Šermukšnėlė;AKMENUKAI;1332354208;Taip;0;6;4;10
11554;Šermukšnėlė;AKMENUKAI;1175718969;Taip;4;6;0;10
11555;Šermukšnėlė;AKMENUKAI;27139089487;Taip;0;6;0;6
11556;Šermukšnėlė;AKMENUKAI;42520543068;Taip;0;5;3;8
11557;Šermukšnėlė;AKMENUKAI;76682206033;Taip;0;1;0;1
11558;Šermukšnėlė;AKMENUKAI;42192131599;Taip;0;5;0;5
11559;Šermukšnėlė;AKMENUKAI;1756560941;Taip;6;2;4;12
11560;Šermukšnėlė;AKMENUKAI;3628734426;Taip;7;3;0;10
11561;Šermukšnėlė;AKMENUKAI;82161996761;Taip;9;2;0;11
11562;Šermukšnėlė;SIŪLINUKAI;32417473492;Taip;6;5;0;11
11563;Šermukšnėlė;SIŪLINUKAI;35508499818;Taip;0;7;0;7
11564;Šermukšnėlė;SIŪLINUKAI;1054907277;Taip;0;5;0;5
11565;Šermukšnėlė;SIŪLINUKAI;30853722796;Taip;8;5;0;13
11566;Šermukšnėlė;SIŪLINUKAI;41661711151;Taip;6;7;0;13
11567;Šermukšnėlė;SIŪLINUKAI;62420710883;Taip;0;5;4;9
11568;Šermukšnėlė;SIŪLINUKAI;87646529363;Taip;0;5;0;5
11569;Šermukšnėlė;SIŪLINUKAI;25663713043;Taip;0;6;0;6
11570;Šermukšnėlė;SIŪLINUKAI;57211490716;Taip;0;5;0;5
11571;Šermukšnėlė;SIŪLINUKAI;88123535614;Taip;0;5;0;5
11572;Šermukšnėlė;SIŪLINUKAI;61911120798;Taip;10;3;0;13
11573;Šermukšnėlė;SIŪLINUKAI;3089008915;Taip;10;3;0;13
11574;Šermukšnėlė;SIŪLINUKAI;20160146304;Taip;8;0;2;10
11575;Šermukšnėlė;SIŪLINUKAI;1912938544;Taip;4;0;0;4
11576;Šermukšnėlė;SIŪLINUKAI;1127786451;Taip;0;6;0;6
11577;Šermukšnėlė;SIŪLINUKAI;18799838453;Taip;0;1;0;1
11578;Šermukšnėlė;SIŪLINUKAI;1891818706;Taip;5;0;0;5
11579;Šermukšnėlė;SIŪLINUKAI;78916223877;Taip;17;0;1;18
11580;Šermukšnėlė;SIŪLINUKAI;45632551657;Taip;7;5;0;12
11581;Šermukšnėlė;MEDINUKAi;2380988728;Taip;5;0;1;6
11582;Šermukšnėlė;MEDINUKAi;2529526401;Taip;0;5;1;6
11583;Šermukšnėlė;MEDINUKAi;8956573129;Taip;3;0;0;3
11584;Šermukšnėlė;MEDINUKAi;3222466449;Taip;0;0;3;3
11585;Šermukšnėlė;MEDINUKAi;5096946133;Taip;0;10;0;10
11586;Šermukšnėlė;MEDINUKAi;8279692394;Taip;5;0;0;5
11587;Šermukšnėlė;MEDINUKAi;2160616078;Taip;0;1;1;2
11588;Šermukšnėlė;MEDINUKAi;78341448188;Taip;5;2;0;7
11589;Šermukšnėlė;MEDINUKAi;1661977128;Taip;1;2;1;4
11590;Šermukšnėlė;MEDINUKAi;6430627501;Taip;0;5;0;5
11591;Šermukšnėlė;MEDINUKAi;5832072195;Taip;5;12;0;17
11592;Šermukšnėlė;MEDINUKAi;9035625467;Taip;0;0;2;2
11593;Šermukšnėlė;MEDINUKAi;7038705221;Taip;17;0;0;17
11594;Šermukšnėlė;MEDINUKAi;3081548524;Taip;5;5;0;10
11595;Šermukšnėlė;SKUDURINUKAI;2176788727;Taip;5;0;0;5
11596;Šermukšnėlė;SKUDURINUKAI;3949629658;Taip;0;5;0;5
11597;Šermukšnėlė;SKUDURINUKAI;7262199284;Taip;10;0;0;10
11598;Šermukšnėlė;SKUDURINUKAI;1148559284;Taip;10;0;0;10
11599;Šermukšnėlė;SKUDURINUKAI;3148857617;Taip;5;10;0;15
11600;Šermukšnėlė;SKUDURINUKAI;4201283154;Taip;5;0;0;5
11601;Šermukšnėlė;SKUDURINUKAI;5575518612;Taip;11;0;2;13
11602;Šermukšnėlė;SKUDURINUKAI;5733540837;Taip;9;0;0;9
11603;Šermukšnėlė;SKUDURINUKAI;5397385093;Taip;20;0;0;20
11604;Šermukšnėlė;SKUDURINUKAI;3322053946;Taip;3;3;0;6
11605;Šermukšnėlė;SKUDURINUKAI;5354978646;Taip;9;0;1;10
11606;Šermukšnėlė;SKUDURINUKAI;1882432812;Taip;8;0;1;9
11607;Šermukšnėlė;SKUDURINUKAI;5242187638;Taip;13;0;1;14
11608;Šermukšnėlė;SKUDURINUKAI;5545018656;Taip;0;0;1;1
11609;Šermukšnėlė;PAGRANDUKAI;7245206247;Taip;0;1;3;4
11610;Šermukšnėlė;PAGRANDUKAI;4569484117;Taip;5;6;0;11
11611;Šermukšnėlė;PAGRANDUKAI;5140264695;Taip;8;0;1;9
11612;Šermukšnėlė;PAGRANDUKAI;5159105661;Taip;12;2;0;14
11613;Šermukšnėlė;PAGRANDUKAI;7305013368;Taip;6;4;0;10
11614;Šermukšnėlė;PAGRANDUKAI;1437314920;Taip;12;0;0;12
11615;Šermukšnėlė;PAGRANDUKAI;7843128263;Taip;15;1;0;16
11616;Šermukšnėlė;PAGRANDUKAI;8407947566;Taip;10;2;0;12
11617;Šermukšnėlė;PAGRANDUKAI;2447547509;Taip;10;0;2;12
11618;Šermukšnėlė;PAGRANDUKAI;4086783761;Taip;0;1;2;3
11619;Šermukšnėlė;PAGRANDUKAI;9876533442;Taip;10;0;0;10
11620;Šermukšnėlė;PAGRANDUKAI;3513568460;Taip;6;2;3;11
11621;Šermukšnėlė;PAGRANDUKAI;8859731179;Taip;11;0;2;13
11622;Šermukšnėlė;PAGRANDUKAI;4230698872;Taip;9;0;0;9
11623;Šermukšnėlė;PAGRANDUKAI;6067298318;Taip;13;0;0;13
11624;Šypsena;NYKŠTUKAI;5985974927;Taip;5;3;0;8
11625;Šypsena;NYKŠTUKAI;4766170132;Ne;0;2;2;4
11626;Šypsena;NYKŠTUKAI;4936775366;Taip;10;10;0;20
11627;Šypsena;NYKŠTUKAI;7569495879;Taip;0;5;0;5
11628;Šypsena;NYKŠTUKAI;4635232236;Taip;0;5;0;5
11629;Šypsena;NYKŠTUKAI;6590285866;Taip;0;5;0;5
11630;Šypsena;NYKŠTUKAI;1343249939;Taip;0;4;3;7
11631;Šypsena;NYKŠTUKAI;3025437080;Taip;0;5;3;8
11632;Šypsena;NYKŠTUKAI;1669768648;Ne;3;3;2;8
11633;Šypsena;NYKŠTUKAI;1575413188;Taip;0;6;0;6
11634;Šypsena;NYKŠTUKAI;2005543016;Ne;6;5;0;11
11635;Šypsena;NYKŠTUKAI;6832433711;Taip;0;0;1;1
11636;Šypsena;NYKŠTUKAI;2248628927;Taip;0;2;0;2
11637;Šypsena;NYKŠTUKAI;2995753269;Taip;2;3;1;6
11638;Šypsena;NYKŠTUKAI;7251064118;Taip;0;2;3;5
11639;Šypsena;SPINDULIUKAI;3541189470;Taip;3;0;0;3
11640;Šypsena;SPINDULIUKAI;1659390234;Ne;0;2;0;2
11641;Šypsena;SPINDULIUKAI;1272973534;Ne;7;1;0;8
11642;Šypsena;SPINDULIUKAI;1767948457;Ne;0;14;0;14
11643;Šypsena;SPINDULIUKAI;1917246860;Ne;0;25;0;25
11644;Šypsena;SPINDULIUKAI;46569341613;Taip;5;0;0;5
11645;Šypsena;SPINDULIUKAI;42130115068;Taip;3;20;0;23
11646;Šypsena;SPINDULIUKAI;6444616846;Taip;20;0;0;20
11647;Šypsena;SPINDULIUKAI;1996746426;Taip;0;18;0;18
11648;Šypsena;SPINDULIUKAI;4017777389;Taip;11;3;0;14
11649;Šypsena;SPINDULIUKAI;70188972463;Taip;10;3;1;14
11650;Šypsena;SPINDULIUKAI;76332370575;Taip;16;0;0;16
11651;Šypsena;SPINDULIUKAI;1906529989;Taip;0;2;0;2
11652;Šypsena;SPINDULIUKAI;2099216049;Taip;6;19;0;25
11653;Šypsena;SPINDULIUKAI;89503728819;Ne;7;4;0;11
11654;Šypsena;SPINDULIUKAI;93678429536;Taip;0;4;0;4
11655;Šypsena;SPINDULIUKAI;8197460768;Taip;0;9;0;9
11656;Šypsena;SPINDULIUKAI;3431905515;Taip;0;25;0;25
11657;Šypsena;SPINDULIUKAI;1133113196;Ne;4;0;0;4
11658;Šypsena;SKRUZDELIUKAI;7591001646;Ne;0;5;0;5
11659;Šypsena;SKRUZDELIUKAI;17041968817;Taip;5;3;0;8
11660;Šypsena;SKRUZDELIUKAI;1369664461;Ne;0;1;0;1
11661;Šypsena;SKRUZDELIUKAI;1886141947;Taip;2;5;2;9
11662;Šypsena;SKRUZDELIUKAI;49812111803;Taip;0;2;1;3
11663;Šypsena;SKRUZDELIUKAI;1329170686;Taip;5;4;0;9
11664;Šypsena;SKRUZDELIUKAI;84526597847;Taip;12;0;0;12
11665;Šypsena;SKRUZDELIUKAI;39296351965;Taip;0;7;0;7
11666;Šypsena;SKRUZDELIUKAI;25175991441;Taip;0;1;0;1
11667;Šypsena;SKRUZDELIUKAI;91846404526;Ne;0;16;0;16
11668;Šypsena;SKRUZDELIUKAI;47729405181;Taip;0;5;0;5
11669;Šypsena;SKRUZDELIUKAI;1972212253;Taip;0;7;0;7
11670;Šypsena;SKRUZDELIUKAI;31833883832;Taip;0;3;0;3
11671;Šypsena;SKRUZDELIUKAI;5971488796;Taip;0;4;0;4
11672;Šypsena;SKRUZDELIUKAI;79177095462;Taip;6;0;0;6
11673;Šypsena;SKRUZDELIUKAI;39495782526;Taip;10;8;0;18
11674;Šypsena;SKRUZDELIUKAI;2117865969;Taip;0;2;0;2
11675;Šypsena;SKRUZDELIUKAI;1755934341;Taip;18;0;0;18
11676;Šypsena;SKRUZDELIUKAI;2119267347;Ne;2;0;0;2
11677;Šypsena;SKRUZDELIUKAI;5680397153;Taip;10;0;0;10
11678;Šypsena;SKRUZDELIUKAI;2368339278;Taip;0;5;0;5
11679;Šypsena;Bitutės;51581713246;Ne;0;5;1;6
11680;Šypsena;Bitutės;77031848208;Ne;0;5;1;6
11681;Šypsena;Bitutės;1720218822;Ne;0;4;0;4
11682;Šypsena;Bitutės;89119472685;Taip;0;14;0;14
11683;Šypsena;Bitutės;2040900989;Taip;0;20;0;20
11684;Šypsena;Bitutės;1872237094;Taip;0;0;3;3
11685;Šypsena;Bitutės;51099062216;Ne;7;1;1;9
11686;Šypsena;Bitutės;93544585309;Taip;5;0;7;12
11687;Šypsena;Bitutės;44505027442;Ne;0;12;0;12
11688;Šypsena;Bitutės;1505433574;Taip;0;0;5;5
11689;Šypsena;MEŠKIUKAI;8715718525;Taip;0;0;3;3
11690;Šypsena;MEŠKIUKAI;1422418997;Taip;5;4;0;9
11691;Šypsena;MEŠKIUKAI;7438060503;Taip;10;1;4;15
11692;Šypsena;MEŠKIUKAI;1515803985;Taip;4;3;0;7
11693;Šypsena;MEŠKIUKAI;5504570516;Taip;0;3;3;6
11694;Šypsena;MEŠKIUKAI;1063834589;Taip;5;6;0;11
11695;Šypsena;MEŠKIUKAI;1558614852;Taip;15;0;5;20
11696;Šypsena;MEŠKIUKAI;1897176871;Taip;0;6;0;6
11697;Šypsena;MEŠKIUKAI;1181590127;Taip;5;7;0;12
11698;Šypsena;MEŠKIUKAI;4808041625;Taip;0;0;1;1
11699;Šypsena;MEŠKIUKAI;5834057370;Taip;15;0;0;15
11700;Šypsena;MEŠKIUKAI;5928432220;Taip;0;1;0;1
11701;Šypsena;MEŠKIUKAI;2798819321;Taip;0;7;0;7
11702;Šypsena;BORUŽĖLĖS;5611440056;Ne;0;2;0;2
11703;Šypsena;BORUŽĖLĖS;7160466766;Taip;0;2;0;2
11704;Šypsena;BORUŽĖLĖS;4038279267;Taip;6;5;0;11
11705;Šypsena;BORUŽĖLĖS;3823623458;Ne;8;4;0;12
11706;Šypsena;BORUŽĖLĖS;8950694484;Taip;5;0;5;10
11707;Šypsena;BORUŽĖLĖS;4344780723;Taip;1;3;11;15
11708;Šypsena;BORUŽĖLĖS;7537442618;Taip;7;1;0;8
11709;Šypsena;BORUŽĖLĖS;3968514430;Taip;0;3;0;3
11710;Šypsena;BORUŽĖLĖS;1893123775;Taip;20;0;0;20
11711;Šypsena;BORUŽĖLĖS;6237208661;Taip;14;0;1;15
11712;Šypsena;BORUŽĖLĖS;6716558946;Taip;15;0;0;15
11713;Šypsena;BORUŽĖLĖS;7519967594;Taip;10;0;1;11
11714;Šnekutis;DRUGELIŲ;1245722149;Taip;7;6;0;13
11715;Šnekutis;DRUGELIŲ;1355103006;Taip;5;11;0;16
11716;Šnekutis;DRUGELIŲ;2000728679;Taip;10;0;4;14
11717;Šnekutis;DRUGELIŲ;54635137954;Taip;0;1;0;1
11718;Šnekutis;DRUGELIŲ;50017415248;Taip;11;0;0;11
11719;Šnekutis;DRUGELIŲ;1956224017;Taip;10;0;1;11
11720;Šnekutis;DRUGELIŲ;2049447215;Taip;4;0;0;4
11721;Šnekutis;DRUGELIŲ;1159232792;Taip;10;3;4;17
11722;Šnekutis;DRUGELIŲ;2092637040;Taip;18;1;1;20
11723;Šnekutis;DRUGELIŲ;94289379983;Taip;5;4;0;9
11724;Šnekutis;DRUGELIŲ;50085798686;Taip;13;0;2;15
11725;Šnekutis;DRUGELIŲ;13209811505;Taip;0;2;9;11
11726;Šnekutis;DRUGELIŲ;30932565379;Taip;14;1;0;15
11727;Šnekutis;DRUGELIŲ;1836892386;Taip;0;1;0;1
11728;Šnekutis;DRUGELIŲ;5962885680;Taip;5;10;0;15
11729;Šnekutis;DRUGELIŲ;4743885834;Taip;0;6;0;6
11730;Šnekutis;DRUGELIŲ;18354631454;Taip;0;2;2;4
11731;Šnekutis;DRUGELIŲ;5029631107;Taip;8;2;0;10
11732;Šnekutis;DRUGELIŲ;4104052524;Taip;0;13;2;15
11733;Šnekutis;DRUGELIŲ;46282997811;Taip;0;14;0;14
11734;Šnekutis;DRUGELIŲ;1867756701;Ne;0;3;2;5
11735;Šnekutis;DRUGELIŲ;2102893949;Taip;0;2;2;4
11736;Šnekutis;Kačiukų;1156210876;Taip;0;0;1;1
11737;Šnekutis;Kačiukų;1233059816;Taip;5;5;0;10
11738;Šnekutis;Kačiukų;50433076829;Taip;0;3;6;9
11739;Šnekutis;Kačiukų;1179210615;Taip;0;8;0;8
11740;Šnekutis;Kačiukų;1023572132;Taip;0;6;0;6
11741;Šnekutis;Kačiukų;13211267463;Taip;0;5;4;9
11742;Šnekutis;Kačiukų;1430904579;Taip;0;2;1;3
11743;Šnekutis;Kačiukų;1430790285;Taip;2;3;1;6
11744;Šnekutis;Kačiukų;2027114365;Taip;10;0;0;10
11745;Šnekutis;Kačiukų;41323355319;Taip;0;5;0;5
11746;Šnekutis;Kačiukų;21847996888;Taip;5;6;0;11
11747;Šnekutis;Kačiukų;2026314698;Taip;0;0;1;1
11748;Šnekutis;Kačiukų;1498045991;Taip;0;2;0;2
11749;Šnekutis;Kačiukų;93604802567;Taip;2;6;0;8
11750;Šnekutis;Kačiukų;88609559814;Taip;0;11;0;11
11751;Šnekutis;Kačiukų;5052576808;Taip;5;0;3;8
11752;Šnekutis;Kačiukų;11446344891;Taip;2;0;0;2
11753;Šnekutis;Kačiukų;32806315077;Taip;3;0;0;3
11754;Šnekutis;Pėlėdžiukų;5188035949;Taip;9;0;0;9
11755;Šnekutis;Pėlėdžiukų;3068754741;Taip;2;0;0;2
11756;Šnekutis;Pėlėdžiukų;4334155280;Taip;0;3;8;11
11757;Šnekutis;Pėlėdžiukų;77534335117;Taip;0;3;12;15
11758;Šnekutis;Pėlėdžiukų;3312928478;Taip;0;0;2;2
11759;Šnekutis;Pėlėdžiukų;42697936562;Taip;15;0;0;15
11760;Šnekutis;Pėlėdžiukų;7507857415;Taip;0;0;11;11
11761;Šnekutis;Pėlėdžiukų;8866360301;Taip;0;11;0;11
11762;Šnekutis;Pėlėdžiukų;8745465796;Taip;0;20;0;20
11763;Šnekutis;Pėlėdžiukų;3170928052;Taip;12;0;0;12
11764;Šnekutis;Pėlėdžiukų;5321817615;Taip;6;0;0;6
11765;Šnekutis;Pėlėdžiukų;2233161242;Taip;8;0;0;8
11766;Šnekutis;Pėlėdžiukų;3578045341;Taip;17;0;0;17
11767;Šnekutis;Pėlėdžiukų;5117544317;Taip;6;0;0;6
11768;Šnekutis;Pėlėdžiukų;2446630485;Taip;4;0;0;4
11769;Šnekutis;Pėlėdžiukų;1835450318;Taip;5;0;2;7
11770;Šnekutis;Pėlėdžiukų;6754580614;Taip;10;0;0;10
11771;Šnekutis;Pėlėdžiukų;1507200600;Taip;5;0;2;7
11772;Šnekutis;Pėlėdžiukų;5615869149;Taip;8;4;0;12
11773;Šnekutis;Pėlėdžiukų;1329958641;Taip;6;0;0;6
11774;Šnekutis;Pėlėdžiukų;5457906245;Taip;8;4;0;12
11775;Šnekutis;Pėlėdžiukų;9511116249;Taip;12;0;0;12
11776;Šnekutis;Pėlėdžiukų;1369660223;Taip;6;2;2;10
11777;Šnekutis;Pėlėdžiukų;1682748852;Taip;6;0;0;6
11778;Šnekutis;Pėlėdžiukų;1447824885;Taip;0;7;0;7
11779;Šnekutis;Boružėlių;1818789769;Taip;0;3;0;3
11780;Šnekutis;Boružėlių;4557629310;Taip;20;0;0;20
11781;Šnekutis;Boružėlių;5711964409;Taip;10;0;7;17
11782;Šnekutis;Boružėlių;37382772659;Taip;5;0;2;7
11783;Šnekutis;Boružėlių;84241751923;Taip;0;1;2;3
11784;Šnekutis;Boružėlių;79174984189;Taip;0;0;6;6
11785;Šnekutis;Boružėlių;1666811336;Taip;5;0;0;5
11786;Šnekutis;Boružėlių;1249451765;Taip;0;13;0;13
11787;Šnekutis;Boružėlių;1031911012;Taip;0;3;2;5
11788;Šnekutis;Boružėlių;1451503127;Taip;20;0;0;20
11789;Šnekutis;Boružėlių;1738802158;Taip;0;10;5;15
11790;Šnekutis;Boružėlių;1744313172;Taip;0;5;0;5
11791;Šnekutis;Boružėlių;1620268693;Taip;10;0;10;20
11792;Šnekutis;Boružėlių;22757448235;Ne;6;1;0;7
11793;Šnekutis;Boružėlių;2259206809;Taip;0;3;4;7
11794;Šnekutis;Boružėlių;54532738133;Taip;0;0;4;4
11795;Šnekutis;Boružėlių;1370696345;Taip;7;0;0;7
11796;Šnekutis;Boružėlių;5973303255;Taip;0;5;4;9
11797;Šnekutis;Boružėlių;27150074287;Taip;6;0;2;8
11798;Šnekutis;Boružėlių;1622660874;Taip;0;0;1;1
11799;Šnekutis;Boružėlių;7514753023;Taip;6;2;3;11
11800;Šnekutis;Boružėlių;6828079735;Taip;5;5;0;10
11801;Šnekutis;Meškučių;4835202527;Taip;19;0;0;19
11802;Šnekutis;Meškučių;5052137859;Taip;5;0;1;6
11803;Šnekutis;Meškučių;2822538227;Taip;5;0;0;5
11804;Šnekutis;Meškučių;5597629090;Taip;11;0;1;12
11805;Šnekutis;Meškučių;8531521901;Taip;0;9;1;10
11806;Šnekutis;Meškučių;9670205249;Taip;1;1;0;2
11807;Šnekutis;Meškučių;6684395256;Taip;0;4;0;4
11808;Šnekutis;Meškučių;3271262071;Taip;0;1;0;1
11809;Šnekutis;Meškučių;8440160819;Taip;0;5;7;12
11810;Šnekutis;Meškučių;9862362744;Taip;10;0;1;11
11811;Šnekutis;Meškučių;8486136697;Taip;13;0;1;14
11812;Šnekutis;Meškučių;9780684867;Taip;0;7;2;9
11813;Šnekutis;Meškučių;7615716438;Taip;0;0;1;1
11814;Šnekutis;Meškučių;7622868249;Taip;0;3;7;10
11815;Šnekutis;Meškučių;5970951526;Taip;7;0;0;7
11816;Šnekutis;Meškučių;3336605264;Taip;4;5;0;9
11817;Šnekutis;Viščiukų;7434438142;Taip;0;11;0;11
11818;Šnekutis;Viščiukų;9312935803;Taip;0;5;7;12
11819;Šnekutis;Viščiukų;9157136735;Taip;0;1;2;3
11820;Šnekutis;Viščiukų;7089000987;Taip;2;0;0;2
11821;Šnekutis;Viščiukų;5049964996;Taip;0;10;0;10
11822;Šnekutis;Viščiukų;4143844589;Taip;15;0;0;15
11823;Šnekutis;Viščiukų;7638626055;Taip;0;1;1;2
11824;Šnekutis;Viščiukų;4992188525;Taip;5;1;0;6
11825;Šnekutis;Viščiukų;7236658561;Taip;0;0;1;1
11826;Šnekutis;Viščiukų;4405567649;Taip;10;0;0;10
11827;Šnekutis;Viščiukų;6578568418;Taip;0;0;5;5
11828;Šnekutis;Viščiukų;9896249776;Taip;6;0;1;7
11829;Šnekutis;Viščiukų;9790803767;Taip;0;5;0;5
11830;Užupiukas;VYTURĖLIŲ;51802714332;Taip;0;5;0;5
11831;Užupiukas;VYTURĖLIŲ;67899352746;Taip;6;0;0;6
11832;Užupiukas;VYTURĖLIŲ;78184067796;Taip;0;12;0;12
11833;Užupiukas;VYTURĖLIŲ;31338755810;Taip;0;12;0;12
11834;Užupiukas;VYTURĖLIŲ;33629222941;Taip;10;6;0;16
11835;Užupiukas;VYTURĖLIŲ;85492444123;Taip;0;1;1;2
11836;Užupiukas;VYTURĖLIŲ;91115810366;Taip;0;1;0;1
11837;Užupiukas;VYTURĖLIŲ;266671806;Taip;0;10;0;10
11838;Užupiukas;VYTURĖLIŲ;29207590902;Taip;0;1;0;1
11839;Užupiukas;VYTURĖLIŲ;37684526869;Taip;0;6;0;6
11840;Užupiukas;VYTURĖLIŲ;39058613355;Taip;6;1;0;7
11841;Užupiukas;VYTURĖLIŲ;77255831055;Taip;0;5;0;5
11842;Užupiukas;VYTURĖLIŲ;23371854830;Taip;0;3;0;3
11843;Užupiukas;VYTURĖLIŲ;75976703580;Taip;0;4;0;4
11844;Užupiukas;VYTURĖLIŲ;3663596268;Taip;5;0;0;5
11845;Užupiukas;VYTURĖLIŲ;39079421361;Taip;0;1;8;9
11846;Užupiukas;VYTURĖLIŲ;12401560384;Taip;0;1;1;2
11847;Užupiukas;VYTURĖLIŲ;53974652901;Taip;0;1;0;1
11848;Užupiukas;VYTURĖLIŲ;44770930654;Taip;0;1;7;8
11849;Užupiukas;VYTURĖLIŲ;7060019183;Taip;4;3;0;7
11850;Užupiukas;KAČIUKŲ;68898413144;Taip;4;3;1;8
11851;Užupiukas;KAČIUKŲ;68812682685;Taip;9;4;0;13
11852;Užupiukas;KAČIUKŲ;97966482763;Taip;0;4;0;4
11853;Užupiukas;KAČIUKŲ;9263601354;Taip;0;5;0;5
11854;Užupiukas;KAČIUKŲ;84367190618;Taip;0;5;0;5
11855;Užupiukas;KAČIUKŲ;19777635011;Taip;0;5;0;5
11856;Užupiukas;KAČIUKŲ;12905151141;Taip;6;5;0;11
11857;Užupiukas;KAČIUKŲ;86504628397;Taip;0;5;0;5
11858;Užupiukas;KAČIUKŲ;10715755079;Taip;0;5;1;6
11859;Užupiukas;KAČIUKŲ;78675007424;Taip;10;0;1;11
11860;Užupiukas;KAČIUKŲ;95445743970;Taip;10;0;1;11
11861;Užupiukas;KAČIUKŲ;42027395287;Taip;10;3;0;13
11862;Užupiukas;KAČIUKŲ;74913928694;Taip;0;5;0;5
11863;Užupiukas;KAČIUKŲ;31618737243;Taip;8;5;1;14
11864;Užupiukas;KAČIUKŲ;42772205412;Taip;8;5;0;13
11865;Užupiukas;KAČIUKŲ;22839159539;Taip;7;5;0;12
11866;Užupiukas;KAČIUKŲ;32651983670;Taip;5;0;1;6
11867;Užupiukas;KAČIUKŲ;27226172373;Taip;0;5;2;7
11868;Užupiukas;KAČIUKŲ;30335529070;Taip;4;2;1;7
11869;Užupiukas;KAČIUKŲ;1700750771;Taip;0;5;3;8
11870;Užupiukas;KAČIUKŲ;31668159620;Ne;5;5;0;10
11871;Užupiukas;DRUGELIŲ;1772019951;Taip;11;0;0;11
11872;Užupiukas;DRUGELIŲ;9655636851;Taip;11;0;0;11
11873;Užupiukas;DRUGELIŲ;1662564735;Taip;4;0;7;11
11874;Užupiukas;DRUGELIŲ;9863097416;Taip;1;0;0;1
11875;Užupiukas;DRUGELIŲ;7298322865;Taip;20;0;0;20
11876;Užupiukas;DRUGELIŲ;7056737587;Taip;0;0;11;11
11877;Užupiukas;DRUGELIŲ;8734960045;Taip;7;13;0;20
11878;Užupiukas;DRUGELIŲ;8724566014;Taip;5;0;2;7
11879;Užupiukas;DRUGELIŲ;14139543365;Taip;6;0;1;7
11880;Užupiukas;DRUGELIŲ;1554333137;Taip;6;0;0;6
11881;Užupiukas;DRUGELIŲ;3298267311;Taip;3;0;0;3
11882;Užupiukas;DRUGELIŲ;8341598147;Taip;15;5;0;20
11883;Užupiukas;DRUGELIŲ;9782972949;Taip;9;5;0;14
11884;Užupiukas;DRUGELIŲ;3579499796;Taip;8;0;0;8
11885;Užupiukas;DRUGELIŲ;2348243399;Taip;15;0;0;15
11886;Užupiukas;DRUGELIŲ;8870229834;Taip;5;5;10;20
11887;Užupiukas;DRUGELIŲ;1679324943;Taip;0;1;0;1
11888;Užupiukas;DRUGELIŲ;9617597828;Taip;9;0;0;9
11889;Užupiukas;DRUGELIŲ;9096157655;Ne;5;0;1;6
11890;Užupiukas;EŽIUKŲ;73657553075;Taip;5;0;3;8
11891;Užupiukas;EŽIUKŲ;1159892685;Taip;0;5;0;5
11892;Užupiukas;EŽIUKŲ;79908666651;Taip;10;5;0;15
11893;Užupiukas;EŽIUKŲ;95981297986;Taip;5;15;0;20
11894;Užupiukas;EŽIUKŲ;27438104059;Taip;7;0;3;10
11895;Užupiukas;EŽIUKŲ;94857555708;Taip;15;5;0;20
11896;Užupiukas;EŽIUKŲ;12023740118;Taip;0;2;5;7
11897;Užupiukas;EŽIUKŲ;6442996343;Taip;5;0;0;5
11898;Užupiukas;EŽIUKŲ;9843068906;Taip;8;2;2;12
11899;Užupiukas;EŽIUKŲ;1481021352;Taip;0;5;12;17
11900;Užupiukas;EŽIUKŲ;17473949362;Taip;0;11;1;12
11901;Užupiukas;EŽIUKŲ;1593878778;Taip;15;5;0;20
11902;Užupiukas;EŽIUKŲ;1535952427;Taip;5;0;5;10
11903;Užupiukas;EŽIUKŲ;1102150432;Taip;0;5;3;8
11904;Užupiukas;EŽIUKŲ;3785893846;Taip;10;0;0;10
11905;Užupiukas;EŽIUKŲ;1891595719;Taip;0;0;2;2
11906;Užupiukas;EŽIUKŲ;2419842168;Taip;11;5;1;17
11907;Užupiukas;EŽIUKŲ;30379165882;Taip;0;0;3;3
11908;Užupiukas;EŽIUKŲ;7616817709;Taip;5;5;0;10
11909;Užupiukas;EŽIUKŲ;1850295450;Taip;5;0;3;8
11910;Užupiukas;BORUŽĖLIŲ;6828175620;Taip;0;0;2;2
11911;Užupiukas;BORUŽĖLIŲ;9791681813;Taip;8;5;0;13
11912;Užupiukas;BORUŽĖLIŲ;1503714343;Taip;4;5;0;9
11913;Užupiukas;BORUŽĖLIŲ;8313812681;Taip;0;0;16;16
11914;Užupiukas;BORUŽĖLIŲ;9932910870;Taip;0;0;20;20
11915;Užupiukas;BORUŽĖLIŲ;9906475253;Taip;0;5;15;20
11916;Užupiukas;BORUŽĖLIŲ;9677572224;Taip;9;5;1;15
11917;Užupiukas;BORUŽĖLIŲ;12787288319;Taip;0;0;4;4
11918;Užupiukas;BORUŽĖLIŲ;2445335267;Taip;15;0;0;15
11919;Užupiukas;BORUŽĖLIŲ;1108744283;Taip;0;0;4;4
11920;Užupiukas;BORUŽĖLIŲ;38066177076;Taip;0;2;0;2
11921;Užupiukas;BORUŽĖLIŲ;1514268763;Taip;5;5;0;10
11922;Užupiukas;BORUŽĖLIŲ;1582921323;Taip;1;0;0;1
11923;Užupiukas;BORUŽĖLIŲ;6526550727;Taip;11;0;1;12
11924;Užupiukas;BORUŽĖLIŲ;9735462228;Taip;0;5;0;5
11925;Užupiukas;BORUŽĖLIŲ;7555702944;Taip;6;0;7;13
11926;Užupiukas;BORUŽĖLIŲ;2307600884;Taip;10;1;0;11
11927;Užupiukas;BORUŽĖLIŲ;6073039842;Taip;11;0;1;12
11928;Užupiukas;BORUŽĖLIŲ;3038973312;Taip;5;1;0;6
11929;Užupiukas;BORUŽĖLIŲ;7861121290;Taip;0;0;1;1
11930;Užupiukas;SPINDULIUKŲ;67395713156;Taip;2;5;0;7
11931;Užupiukas;SPINDULIUKŲ;51983057814;Taip;7;0;1;8
11932;Užupiukas;SPINDULIUKŲ;86921401020;Taip;0;5;0;5
11933;Užupiukas;SPINDULIUKŲ;90438855641;Taip;0;7;0;7
11934;Užupiukas;SPINDULIUKŲ;65677644430;Taip;2;5;0;7
11935;Užupiukas;SPINDULIUKŲ;84336476482;Taip;4;5;0;9
11936;Užupiukas;SPINDULIUKŲ;80007333669;Taip;4;6;0;10
11937;Užupiukas;SPINDULIUKŲ;15724999714;Taip;0;2;0;2
11938;Užupiukas;SPINDULIUKŲ;26339684743;Taip;0;5;2;7
11939;Užupiukas;SPINDULIUKŲ;9827529278;Taip;0;6;0;6
11940;Užupiukas;SPINDULIUKŲ;90077603800;Taip;6;0;0;6
11941;Užupiukas;SPINDULIUKŲ;84075926264;Taip;6;5;0;11
11942;Užupiukas;SPINDULIUKŲ;37017020021;Taip;0;2;0;2
11943;Užupiukas;SPINDULIUKŲ;26118376709;Taip;0;2;5;7
11944;Užupiukas;SPINDULIUKŲ;30335969437;Taip;0;6;1;7
11945;Užupiukas;SPINDULIUKŲ;34512830427;Taip;5;5;0;10
11946;Užupiukas;SPINDULIUKŲ;39837224579;Taip;0;0;9;9
11947;Užupiukas;SPINDULIUKŲ;33716467388;Taip;0;5;4;9
11948;Užupiukas;SPINDULIUKŲ;4322004071;Taip;0;5;0;5
11949;Užupiukas;SPINDULIUKŲ;59095867565;Taip;0;5;1;6
11950;Užupiukas;SPINDULIUKŲ;54802123672;Taip;10;5;0;15
11951;Užupiukas;SPINDULIUKŲ;3087557445;Taip;11;5;0;16
11952;Užupiukas;ŽVIRBLIUKŲ;66976483535;Taip;10;1;1;12
11953;Užupiukas;ŽVIRBLIUKŲ;74109296784;Taip;0;1;5;6
11954;Užupiukas;ŽVIRBLIUKŲ;30079394090;Taip;10;1;0;11
11955;Užupiukas;ŽVIRBLIUKŲ;41589248540;Taip;0;0;3;3
11956;Užupiukas;ŽVIRBLIUKŲ;6945412270;Taip;15;5;0;20
11957;Užupiukas;ŽVIRBLIUKŲ;29120240155;Taip;0;0;7;7
11958;Užupiukas;ŽVIRBLIUKŲ;77360572295;Taip;8;10;0;18
11959;Užupiukas;ŽVIRBLIUKŲ;12930564771;Taip;7;5;2;14
11960;Užupiukas;ŽVIRBLIUKŲ;39154080649;Taip;0;5;5;10
11961;Užupiukas;ŽVIRBLIUKŲ;66563646874;Taip;7;2;0;9
11962;Užupiukas;ŽVIRBLIUKŲ;53620240721;Taip;0;2;0;2
11963;Užupiukas;ŽVIRBLIUKŲ;54388164264;Taip;11;2;0;13
11964;Užupiukas;ŽVIRBLIUKŲ;77859943014;Taip;0;5;1;6
11965;Užupiukas;ŽVIRBLIUKŲ;78093835821;Taip;12;0;0;12
11966;Užupiukas;ŽVIRBLIUKŲ;9621834194;Taip;0;4;0;4
11967;Užupiukas;ŽVIRBLIUKŲ;2261114370;Taip;0;5;0;5
11968;Užupiukas;ŽVIRBLIUKŲ;55851979501;Taip;15;5;0;20
11969;Užupiukas;ŽVIRBLIUKŲ;50633300666;Taip;0;6;0;6
11970;Užupiukas;ŽVIRBLIUKŲ;81516820215;Taip;10;0;0;10
11971;Užupiukas;ŽVIRBLIUKŲ;80569399641;Taip;0;5;1;6
11972;Užupiukas;ŽVIRBLIUKŲ;1961593235;Taip;5;5;9;19
11973;Užupiukas;ŽVIRBLIUKŲ;11261333632;Taip;0;3;9;12
11974;Užupiukas;ŽVIRBLIUKŲ;4310051789;Taip;8;5;1;14
11975;Užupiukas;PELĖDŽIUKŲ;94936980824;Taip;3;5;1;9
11976;Užupiukas;PELĖDŽIUKŲ;51703520898;Taip;0;6;0;6
11977;Užupiukas;PELĖDŽIUKŲ;4147741857;Taip;6;1;0;7
11978;Užupiukas;PELĖDŽIUKŲ;40697997174;Taip;0;10;0;10
11979;Užupiukas;PELĖDŽIUKŲ;6447998472;Taip;0;5;2;7
11980;Užupiukas;PELĖDŽIUKŲ;79539936850;Taip;5;5;2;12
11981;Užupiukas;PELĖDŽIUKŲ;91266096205;Taip;0;5;1;6
11982;Užupiukas;PELĖDŽIUKŲ;29433022056;Taip;0;5;0;5
11983;Užupiukas;PELĖDŽIUKŲ;61722030522;Taip;0;5;2;7
11984;Užupiukas;PELĖDŽIUKŲ;25194791061;Taip;0;3;0;3
11985;Užupiukas;PELĖDŽIUKŲ;55760273994;Taip;0;1;2;3
11986;Užupiukas;PELĖDŽIUKŲ;91904601102;Taip;0;5;0;5
11987;Užupiukas;PELĖDŽIUKŲ;91632804337;Taip;0;5;0;5
11988;Užupiukas;PELĖDŽIUKŲ;97373228204;Taip;6;1;1;8
11989;Užupiukas;PELĖDŽIUKŲ;43231263535;Taip;6;5;0;11
11990;Užupiukas;PELĖDŽIUKŲ;38236870957;Taip;0;5;0;5
11991;Užupiukas;PELĖDŽIUKŲ;70640896909;Taip;15;5;0;20
11992;Užupiukas;PELĖDŽIUKŲ;47039147715;Taip;0;5;3;8
11993;Užupiukas;PELĖDŽIUKŲ;41047619045;Taip;0;1;1;2
11994;Užupiukas;PELĖDŽIUKŲ;8865442531;Taip;0;5;0;5
11995;Užupiukas;PELĖDŽIUKŲ;22644512133;Taip;10;1;0;11
11996;Užupiukas;VARPELIŲ;6790700398;Taip;5;5;0;10
11997;Užupiukas;VARPELIŲ;23723147269;Taip;7;5;0;12
11998;Užupiukas;VARPELIŲ;7874627355;Taip;0;9;0;9
11999;Užupiukas;VARPELIŲ;51243697666;Taip;0;0;1;1
12000;Užupiukas;VARPELIŲ;81986379983;Taip;4;0;0;4
12001;Užupiukas;VARPELIŲ;17651645880;Taip;10;0;0;10
12002;Užupiukas;VARPELIŲ;50797530294;Taip;0;0;3;3
12003;Užupiukas;VARPELIŲ;98428714407;Taip;0;4;0;4
12004;Užupiukas;VARPELIŲ;57439594934;Taip;0;0;4;4
12005;Užupiukas;VARPELIŲ;1103878937;Taip;7;4;1;12
12006;Užupiukas;VARPELIŲ;1294561841;Taip;5;0;2;7
12007;Užupiukas;VARPELIŲ;2031306814;Taip;5;5;0;10
12008;Užupiukas;VARPELIŲ;82632886488;Taip;11;0;1;12
12009;Užupiukas;VARPELIŲ;77950386276;Taip;0;0;12;12
12010;Užupiukas;VARPELIŲ;79092366287;Taip;0;6;0;6
12011;Užupiukas;VARPELIŲ;6188599930;Taip;5;0;3;8
12012;Užupiukas;VARPELIŲ;8358242714;Taip;9;5;0;14
12013;Užupiukas;SAULUČIŲ;10681040398;Taip;6;0;0;6
12014;Užupiukas;SAULUČIŲ;55683021710;Taip;5;5;2;12
12015;Užupiukas;SAULUČIŲ;64774033504;Taip;5;0;5;10
12016;Užupiukas;SAULUČIŲ;1656658765;Taip;2;5;0;7
12017;Užupiukas;SAULUČIŲ;52047323776;Taip;20;0;0;20
12018;Užupiukas;SAULUČIŲ;25118968273;Taip;6;0;4;10
12019;Užupiukas;SAULUČIŲ;1307564992;Taip;5;0;0;5
12020;Užupiukas;SAULUČIŲ;2740412091;Taip;20;0;0;20
12021;Užupiukas;SAULUČIŲ;1577630991;Taip;15;0;5;20
12022;Užupiukas;SAULUČIŲ;1158250810;Taip;5;8;0;13
12023;Užupiukas;SAULUČIŲ;48886679788;Taip;6;5;0;11
12024;Užupiukas;SAULUČIŲ;53272114855;Taip;6;0;0;6
12025;Užupiukas;SAULUČIŲ;36820708170;Taip;0;2;1;3
12026;Užupiukas;SAULUČIŲ;52600923918;Taip;0;5;1;6
12027;Užupiukas;SAULUČIŲ;10522364665;Taip;5;5;0;10
12028;Užupiukas;SAULUČIŲ;31471265444;Taip;5;1;0;6
12029;Užupiukas;SAULUČIŲ;87017671664;Taip;6;14;0;20
12030;Užupiukas;SAULUČIŲ;15815468617;Taip;5;5;0;10
12031;Užupiukas;SAULUČIŲ;73039119839;Taip;6;0;2;8
12032;Užupiukas;SAULUČIŲ;1592276956;Taip;6;5;0;11
12033;Užupiukas;SAULUČIŲ;6467238027;Taip;5;0;0;5
12034;Užupiukas;SAULUČIŲ;57642636356;Taip;6;4;0;10
12035;Užupiukas;SAULUČIŲ;2499414724;Taip;6;5;0;11
12036;Užupiukas;LAPIUKŲ;79442829922;Taip;0;0;1;1
12037;Užupiukas;LAPIUKŲ;3309195572;Taip;0;5;0;5
12038;Užupiukas;LAPIUKŲ;7563497568;Taip;0;0;6;6
12039;Užupiukas;LAPIUKŲ;2821350355;Taip;0;5;12;17
12040;Užupiukas;LAPIUKŲ;5665323444;Taip;5;0;3;8
12041;Užupiukas;LAPIUKŲ;3774364829;Taip;5;0;1;6
12042;Užupiukas;LAPIUKŲ;6236652118;Taip;0;3;1;4
12043;Užupiukas;LAPIUKŲ;4247280316;Taip;0;10;0;10
12044;Užupiukas;LAPIUKŲ;2938276316;Taip;5;0;5;10
12045;Užupiukas;LAPIUKŲ;6478702476;Taip;0;10;1;11
12046;Užupiukas;LAPIUKŲ;4132760111;Taip;10;5;0;15
12047;Užupiukas;LAPIUKŲ;53412835151;Taip;0;0;5;5
12048;Užupiukas;LAPIUKŲ;9197242545;Taip;0;0;4;4
12049;Užupiukas;LAPIUKŲ;3205769002;Taip;1;0;15;16
12050;Užupiukas;LAPIUKŲ;5498369850;Taip;5;0;5;10
12051;Užupiukas;LAPIUKŲ;3043079398;Taip;0;0;3;3
12052;Užupiukas;LAPIUKŲ;4608233152;Taip;11;0;0;11
12053;Užupiukas;NYKŠTUKŲ;3905448176;Taip;10;0;4;14
12054;Užupiukas;NYKŠTUKŲ;4710910251;Taip;4;5;6;15
12055;Užupiukas;NYKŠTUKŲ;1718518621;Taip;10;0;0;10
12056;Užupiukas;NYKŠTUKŲ;9991552624;Taip;0;5;0;5
12057;Užupiukas;NYKŠTUKŲ;3048959458;Taip;5;0;4;9
12058;Užupiukas;NYKŠTUKŲ;3080668107;Taip;0;3;0;3
12059;Užupiukas;NYKŠTUKŲ;1651249962;Taip;0;5;0;5
12060;Užupiukas;NYKŠTUKŲ;2390955083;Taip;15;4;0;19
12061;Užupiukas;NYKŠTUKŲ;1809036046;Taip;2;0;8;10
12062;Užupiukas;NYKŠTUKŲ;1100574872;Taip;4;6;0;10
12063;Užupiukas;NYKŠTUKŲ;3861173268;Taip;10;5;1;16
12064;Užupiukas;NYKŠTUKŲ;9813360176;Taip;0;4;0;4
12065;Užupiukas;NYKŠTUKŲ;5116564840;Taip;15;0;0;15
12066;Užupiukas;NYKŠTUKŲ;6119222293;Ne;5;9;0;14
12067;Užupiukas;NYKŠTUKŲ;2724216446;Taip;10;4;0;14
12068;Užupiukas;NYKŠTUKŲ;1684901495;Taip;10;0;0;10
12069;Vaidilutė;Žiogelis;83446186815;Taip;7;5;0;12
12070;Vaidilutė;Žiogelis;51568574636;Taip;0;3;0;3
12071;Vaidilutė;Žiogelis;45619465634;Taip;6;0;0;6
12072;Vaidilutė;Žiogelis;1587658785;Taip;1;1;0;2
12073;Vaidilutė;Žiogelis;72508198771;Taip;7;0;0;7
12074;Vaidilutė;Žiogelis;36995673806;Taip;5;3;0;8
12075;Vaidilutė;Žiogelis;26144399724;Taip;8;5;0;13
12076;Vaidilutė;Žiogelis;76095903956;Taip;16;0;0;16
12077;Vaidilutė;Žiogelis;25736859991;Taip;5;0;0;5
12078;Vaidilutė;Žiogelis;37065810950;Taip;7;5;0;12
12079;Vaidilutė;Žiogelis;93941932893;Taip;7;5;0;12
12080;Vaidilutė;Žiogelis;11736298044;Taip;6;1;0;7
12081;Vaidilutė;Žiogelis;60118349568;Taip;8;0;1;9
12082;Vaidilutė;Žiogelis;9616432332;Taip;11;0;1;12
12083;Vaidilutė;Žiogelis;65596730863;Taip;0;3;0;3
12084;Vaidilutė;Žiogelis;69907222472;Taip;2;7;3;12
12085;Vaidilutė;Žiogelis;63465904558;Taip;5;1;0;6
12086;Vaidilutė;Žiogelis;52281826464;Taip;6;0;1;7
12087;Vaidilutė;Žiogelis;98760023673;Taip;8;0;0;8
12088;Vaidilutė;Žiogelis;1254377446;Taip;11;0;0;11
12089;Vaidilutė;Žiogelis;80628141893;Taip;11;0;0;11
12090;Vaidilutė;Rūtelė;12982620392;Taip;0;5;0;5
12091;Vaidilutė;Rūtelė;34945009241;Taip;0;0;2;2
12092;Vaidilutė;Rūtelė;83614804593;Taip;0;0;3;3
12093;Vaidilutė;Rūtelė;95291858283;Taip;0;8;0;8
12094;Vaidilutė;Rūtelė;70241443027;Taip;0;1;3;4
12095;Vaidilutė;Rūtelė;2176694565;Taip;3;3;0;6
12096;Vaidilutė;Rūtelė;15308595647;Taip;0;5;0;5
12097;Vaidilutė;Rūtelė;36162605033;Taip;0;5;2;7
12098;Vaidilutė;Rūtelė;41202484982;Taip;10;2;2;14
12099;Vaidilutė;Rūtelė;1347860031;Taip;0;4;0;4
12100;Vaidilutė;Rūtelė;70281031575;Taip;9;0;0;9
12101;Vaidilutė;Rūtelė;87617273304;Taip;5;0;4;9
12102;Vaidilutė;Rūtelė;92269487538;Taip;10;2;3;15
12103;Vaidilutė;Rūtelė;57981568010;Taip;15;0;0;15
12104;Vaidilutė;Rūtelė;29245907351;Taip;0;8;0;8
12105;Vaidilutė;Rūtelė;13343473227;Taip;0;4;0;4
12106;Vaidilutė;Rūtelė;99220518506;Taip;3;6;2;11
12107;Vaidilutė;Rūtelė;8611047350;Taip;0;3;9;12
12108;Vaidilutė;Rūtelė;38331934468;Taip;0;12;0;12
12109;Vaidilutė;Rūtelė;5737042516;Taip;5;0;2;7
12110;Vaidilutė;Rūtelė;5785964650;Taip;10;5;0;15
12111;Vaidilutė;Rūtelė;7036490032;Taip;6;2;0;8
12112;Vaidilutė;Voveraitė;1993403692;Taip;16;0;0;16
12113;Vaidilutė;Voveraitė;42503303158;Taip;10;0;0;10
12114;Vaidilutė;Voveraitė;9948685221;Taip;6;2;3;11
12115;Vaidilutė;Voveraitė;9869134464;Taip;12;2;0;14
12116;Vaidilutė;Voveraitė;29153363263;Taip;9;0;0;9
12117;Vaidilutė;Voveraitė;3069613102;Taip;6;0;0;6
12118;Vaidilutė;Voveraitė;5177060346;Taip;0;1;0;1
12119;Vaidilutė;Voveraitė;19402768340;Taip;5;6;0;11
12120;Vaidilutė;Voveraitė;4671287016;Taip;12;0;4;16
12121;Vaidilutė;Voveraitė;3600181974;Taip;0;0;1;1
12122;Vaidilutė;Voveraitė;7419525100;Taip;5;0;0;5
12123;Vaidilutė;Voveraitė;1363913645;Taip;5;1;4;10
12124;Vaidilutė;Voveraitė;5252637701;Taip;12;0;1;13
12125;Vaidilutė;Voveraitė;1320999237;Taip;5;0;0;5
12126;Vaidilutė;Voveraitė;1691407801;Taip;0;0;3;3
12127;Vaidilutė;Voveraitė;1704155743;Taip;0;0;7;7
12128;Vaidilutė;Voveraitė;1139332221;Taip;11;0;0;11
12129;Vaidilutė;Voveraitė;1297817018;Taip;7;0;0;7
12130;Vaidilutė;Voveraitė;9124975928;Taip;10;0;1;11
12131;Vaidilutė;Voveraitė;3202508790;Taip;6;0;2;8
12132;Vaidilutė;Saulutė;20442760894;Taip;7;1;1;9
12133;Vaidilutė;Saulutė;72152961395;Taip;7;4;2;13
12134;Vaidilutė;Saulutė;43033298395;Taip;5;0;0;5
12135;Vaidilutė;Saulutė;11703710695;Taip;5;0;0;5
12136;Vaidilutė;Saulutė;96226651021;Taip;5;1;0;6
12137;Vaidilutė;Saulutė;68447810501;Taip;2;3;0;5
12138;Vaidilutė;Saulutė;66561742513;Taip;0;5;2;7
12139;Vaidilutė;Saulutė;73529326579;Taip;0;8;0;8
12140;Vaidilutė;Saulutė;36989740131;Taip;0;2;2;4
12141;Vaidilutė;Saulutė;70212515559;Ne;6;1;0;7
12142;Vaidilutė;Saulutė;70452446276;Ne;7;1;0;8
12143;Vaidilutė;Saulutė;13456910631;Taip;6;1;0;7
12144;Vaidilutė;Saulutė;91922432702;Taip;0;2;0;2
12145;Vaidilutė;Saulutė;26069775295;Taip;9;5;2;16
12146;Vaidilutė;Saulutė;1928414100;Taip;6;5;0;11
12147;Vaidilutė;Saulutė;1477466080;Taip;2;5;5;12
12148;Vaidilutė;Saulutė;4593200817;Taip;7;1;1;9
12149;Vaidilutė;Saulutė;9994830892;Taip;0;2;1;3
12150;Vaidilutė;Saulutė;1554014622;Taip;0;5;0;5
12151;Vaidilutė;Žibutė;5686463470;Taip;7;2;0;9
12152;Vaidilutė;Žibutė;1430802591;Taip;0;3;5;8
12153;Vaidilutė;Žibutė;7843388119;Taip;5;5;0;10
12154;Vaidilutė;Žibutė;2041126370;Taip;10;1;0;11
12155;Vaidilutė;Žibutė;16491592864;Taip;5;2;0;7
12156;Vaidilutė;Žibutė;45949026707;Taip;14;0;0;14
12157;Vaidilutė;Žibutė;4259585225;Taip;0;4;0;4
12158;Vaidilutė;Žibutė;4334934114;Taip;10;0;0;10
12159;Vaidilutė;Žibutė;3152118407;Taip;15;5;0;20
12160;Vaidilutė;Žibutė;9669118189;Taip;0;2;0;2
12161;Vaidilutė;Žibutė;5203062837;Taip;17;0;0;17
12162;Vaidilutė;Žibutė;1266927367;Taip;10;0;0;10
12163;Vaidilutė;Žibutė;2941550026;Taip;5;0;0;5
12164;Vaidilutė;Žibutė;1871542885;Taip;15;1;0;16
12165;Vaidilutė;Žibutė;4362797606;Taip;3;0;0;3
12166;Vaidilutė;Žibutė;6322986820;Taip;9;1;0;10
12167;Vaidilutė;Žibutė;5620009051;Taip;5;0;1;6
12168;Vaidilutė;Žibutė;1853463568;Taip;15;0;0;15
12169;Vaidilutė;Žibutė;9556632708;Taip;15;1;0;16
12170;Vaidilutė;Žibutė;3990013866;Taip;5;0;0;5
12171;Vaidilutė;"Ąžuoliukas ";2037322108;Taip;6;1;0;7
12172;Vaidilutė;"Ąžuoliukas ";1179339231;Taip;6;1;0;7
12173;Vaidilutė;"Ąžuoliukas ";92610870394;Taip;3;5;2;10
12174;Vaidilutė;"Ąžuoliukas ";53984070163;Taip;3;2;1;6
12175;Vaidilutė;"Ąžuoliukas ";27368743235;Taip;4;1;0;5
12176;Vaidilutė;"Ąžuoliukas ";68303177058;Taip;5;1;0;6
12177;Vaidilutė;"Ąžuoliukas ";14996785673;Taip;0;0;1;1
12178;Vaidilutė;"Ąžuoliukas ";78917497586;Taip;7;0;2;9
12179;Vaidilutė;"Ąžuoliukas ";31536755228;Ne;5;6;0;11
12180;Vaidilutė;"Ąžuoliukas ";47216762092;Taip;5;6;0;11
12181;Vaidilutė;"Ąžuoliukas ";84643800952;Taip;9;5;0;14
12182;Vaidilutė;"Ąžuoliukas ";20252774403;Taip;0;5;2;7
12183;Vaidilutė;"Ąžuoliukas ";34289554601;Taip;0;0;4;4
12184;Vaidilutė;"Ąžuoliukas ";93447858384;Taip;0;5;0;5
12185;Vaidilutė;"Ąžuoliukas ";52258675795;Taip;5;0;0;5
12186;Vaidilutė;"Ąžuoliukas ";51588667084;Taip;10;1;0;11
12187;Vaidilutė;"Ąžuoliukas ";3358680107;Taip;0;1;6;7
12188;Vaidilutė;"Ąžuoliukas ";6742144586;Taip;5;5;0;10
12189;Vaidilutė;"Ąžuoliukas ";7593066460;Ne;5;0;2;7
12190;Vaidilutė;"Žemuogėlė ";57518887320;Taip;0;3;3;6
12191;Vaidilutė;"Žemuogėlė ";56696406197;Taip;4;0;1;5
12192;Vaidilutė;"Žemuogėlė ";1982165935;Taip;0;1;3;4
12193;Vaidilutė;"Žemuogėlė ";77677139178;Taip;0;0;1;1
12194;Vaidilutė;"Žemuogėlė ";14568483659;Taip;0;5;0;5
12195;Vaidilutė;"Žemuogėlė ";59140652359;Ne;8;0;2;10
12196;Vaidilutė;"Žemuogėlė ";88260968683;Taip;0;0;6;6
12197;Vaidilutė;"Žemuogėlė ";95465325875;Taip;0;10;0;10
12198;Vaidilutė;"Žemuogėlė ";83311343448;Taip;5;1;1;7
12199;Vaidilutė;"Žemuogėlė ";68611593221;Taip;0;2;2;4
12200;Vaidilutė;"Žemuogėlė ";41921356356;Taip;0;1;0;1
12201;Vaidilutė;"Žemuogėlė ";2372340492;Taip;0;0;2;2
12202;Vaidilutė;"Žemuogėlė ";36049149219;Taip;0;0;3;3
12203;Vaidilutė;"Žemuogėlė ";2089569687;Taip;15;0;0;15
12204;Vaidilutė;"Žemuogėlė ";2040610033;Taip;10;0;0;10
12205;Vaidilutė;"Žemuogėlė ";4237534907;Taip;0;5;0;5
12206;Vaidilutė;"Vyturėlis ";5821467408;Taip;5;0;0;5
12207;Vaidilutė;"Vyturėlis ";24445906930;Taip;9;0;0;9
12208;Vaidilutė;"Vyturėlis ";83944413409;Taip;7;5;0;12
12209;Vaidilutė;"Vyturėlis ";5116482125;Taip;5;2;0;7
12210;Vaidilutė;"Vyturėlis ";25654419755;Taip;6;1;1;8
12211;Vaidilutė;"Vyturėlis ";79061542327;Taip;5;0;0;5
12212;Vaidilutė;"Vyturėlis ";2099647381;Taip;0;10;0;10
12213;Vaidilutė;"Vyturėlis ";72248829784;Taip;5;0;1;6
12214;Vaidilutė;"Vyturėlis ";34492341585;Taip;0;1;4;5
12215;Vaidilutė;"Vyturėlis ";79694144428;Taip;5;0;1;6
12216;Vaidilutė;"Vyturėlis ";27107732357;Taip;0;5;2;7
12217;Vaidilutė;"Vyturėlis ";79964507480;Taip;4;1;3;8
12218;Vaidilutė;"Vyturėlis ";10737417556;Taip;3;0;0;3
12219;Vaidilutė;"Vyturėlis ";1416870651;Taip;3;8;0;11
12220;Vaidilutė;"Vyturėlis ";77020716708;Taip;7;0;0;7
12221;Vaidilutė;"Vyturėlis ";87401758633;Taip;20;0;0;20
12222;Vaidilutė;"Vyturėlis ";2067604305;Taip;0;6;0;6
12223;Vaidilutė;"Vyturėlis ";3220471656;Taip;11;0;0;11
12224;Vaidilutė;"Vyturėlis ";94210720777;Taip;4;0;0;4
12225;Vaidilutė;"Vyturėlis ";1315347184;Taip;5;0;0;5
12226;Vaidilutė;"Vyturėlis ";1692795486;Taip;5;0;1;6
12227;Vaidilutė;"Varpelis ";1470597477;Taip;4;1;3;8
12228;Vaidilutė;"Varpelis ";36556774940;Taip;0;5;0;5
12229;Vaidilutė;"Varpelis ";84723450591;Taip;10;5;0;15
12230;Vaidilutė;"Varpelis ";2852550471;Taip;0;6;0;6
12231;Vaidilutė;"Varpelis ";1047235238;Taip;4;0;1;5
12232;Vaidilutė;"Varpelis ";2033196214;Taip;4;1;3;8
12233;Vaidilutė;"Varpelis ";98968425270;Taip;0;0;3;3
12234;Vaidilutė;"Varpelis ";26241930203;Taip;0;1;0;1
12235;Vaidilutė;"Varpelis ";37901356592;Taip;0;0;1;1
12236;Vaidilutė;"Varpelis ";1564429390;Taip;7;1;3;11
12237;Vaidilutė;"Varpelis ";42328411019;Taip;0;2;0;2
12238;Vaidilutė;"Varpelis ";96794583279;Taip;5;0;2;7
12239;Vaidilutė;"Varpelis ";1974967085;Taip;0;2;6;8
12240;Vaidilutė;"Varpelis ";6758078068;Taip;0;0;2;2
12241;Vaidilutė;"Varpelis ";48928174623;Taip;0;1;0;1
12242;Vaidilutė;"Varpelis ";1556646493;Taip;5;1;2;8
12243;Vaidilutė;"Varpelis ";82558684054;Taip;0;2;5;7
12244;Vaidilutė;"Varpelis ";25071409492;Taip;15;0;1;16
12245;Vaidilutė;"Varpelis ";55183164909;Taip;10;0;1;11
12246;Vaidilutė;"Boružėlių ";8789527552;Taip;3;2;0;5
12247;Vaidilutė;"Boružėlių ";7319037375;Taip;0;2;0;2
12248;Vaidilutė;"Boružėlių ";4838951446;Taip;10;0;0;10
12249;Vaidilutė;"Boružėlių ";7494818866;Taip;2;5;0;7
12250;Vaidilutė;"Boružėlių ";4954285515;Taip;0;20;0;20
12251;Vaidilutė;"Boružėlių ";1516903980;Taip;20;0;0;20
12252;Vaidilutė;"Boružėlių ";1140011879;Taip;6;0;0;6
12253;Vaidilutė;"Boružėlių ";9563257771;Taip;9;0;0;9
12254;Vaidilutė;"Boružėlių ";2024078532;Taip;15;0;0;15
12255;Vaidilutė;"Boružėlių ";8505156287;Taip;0;2;0;2
12256;Vaidilutė;"Boružėlių ";9652684068;Taip;11;0;0;11
12257;Vaidilutė;"Boružėlių ";6630603158;Taip;4;0;0;4
12258;Vaidilutė;"Malūnelis ";2763266518;Taip;0;1;0;1
12259;Vaidilutė;"Malūnelis ";6250831269;Taip;5;0;0;5
12260;Vaidilutė;"Malūnelis ";4430382895;Taip;18;0;0;18
12261;Vaidilutė;"Malūnelis ";4159072583;Taip;0;9;0;9
12262;Vaidilutė;"Malūnelis ";6701103931;Taip;7;0;0;7
12263;Vaidilutė;"Malūnelis ";5276088687;Taip;13;5;0;18
12264;Vaidilutė;"Malūnelis ";8882402632;Taip;2;4;4;10
12265;Vaidilutė;"Malūnelis ";6037349527;Taip;0;0;5;5
12266;Vaidilutė;"Malūnelis ";3832349858;Taip;10;0;2;12
12267;Vaidilutė;"Malūnelis ";9317774960;Taip;14;1;0;15
12268;Vaidilutė;"Malūnelis ";5448014291;Taip;0;1;1;2
12269;Vaidilutė;"Malūnelis ";3497795848;Taip;9;0;0;9
12270;Vaidilutė;"Malūnelis ";4280822951;Taip;3;0;0;3
12271;Vaidilutė;"Malūnelis ";5867501558;Taip;15;5;0;20
12272;Vaidilutė;"Riešutėlis ";1986162951;Taip;7;0;4;11
12273;Vaidilutė;"Riešutėlis ";1941081703;Taip;8;0;0;8
12274;Vaidilutė;"Riešutėlis ";87621682081;Taip;5;1;1;7
12275;Vaidilutė;"Riešutėlis ";76613866916;Taip;10;5;0;15
12276;Vaidilutė;"Riešutėlis ";1942402815;Taip;16;0;0;16
12277;Vaidilutė;"Riešutėlis ";13133501690;Taip;3;0;4;7
12278;Vaidilutė;"Riešutėlis ";8543285470;Taip;20;0;0;20
12279;Vaidilutė;"Riešutėlis ";19413698194;Taip;11;0;0;11
12280;Vaidilutė;"Riešutėlis ";83887347923;Taip;16;0;0;16
12281;Vaidilutė;"Riešutėlis ";69452750985;Taip;11;0;1;12
12282;Vaidilutė;"Riešutėlis ";44867291232;Taip;6;0;0;6
12283;Vaidilutė;"Riešutėlis ";17497609539;Taip;3;2;0;5
12284;Vaidilutė;"Riešutėlis ";38698526742;Taip;6;4;0;10
12285;Vaidilutė;"Riešutėlis ";1664595920;Taip;10;0;1;11
12286;Vaidilutė;"Riešutėlis ";1608286003;Taip;5;0;4;9
12287;Vaidilutė;"Riešutėlis ";1083096707;Taip;11;0;5;16
12288;Vaidilutė;"Riešutėlis ";2397776116;Taip;10;0;9;19
12289;Vaidilutė;"Riešutėlis ";1405802722;Taip;2;0;0;2
12290;Vaidilutė;"Riešutėlis ";67830476121;Taip;13;0;2;15
12291;Vaidilutė;"Riešutėlis ";3243266869;Taip;6;0;1;7
12292;Vandenis;ŽUVĖDRŲ;52063106839;Taip;0;2;0;2
12293;Vandenis;ŽUVĖDRŲ;83799061370;Taip;5;0;0;5
12294;Vandenis;ŽUVĖDRŲ;72923438583;Taip;0;6;0;6
12295;Vandenis;ŽUVĖDRŲ;86007123;Taip;0;3;0;3
12296;Vandenis;ŽUVĖDRŲ;96459201904;Taip;10;3;0;13
12297;Vandenis;ŽUVĖDRŲ;49204161380;Taip;0;3;0;3
12298;Vandenis;ŽUVĖDRŲ;67472126318;Taip;0;1;0;1
12299;Vandenis;ŽUVĖDRŲ;4045401354;Taip;2;0;0;2
12300;Vandenis;ŽUVĖDRŲ;41376432095;Taip;0;7;0;7
12301;Vandenis;ŽUVĖDRŲ;62877843868;Taip;0;1;0;1
12302;Vandenis;ŽUVĖDRŲ;85287618619;Taip;0;16;0;16
12303;Vandenis;ŽUVĖDRŲ;3639803910;Taip;0;5;0;5
12304;Vandenis;ŽUVĖDRŲ;35581230147;Taip;0;5;0;5
12305;Vandenis;ŽUVĖDRŲ;22764351701;Taip;0;3;0;3
12306;Vandenis;ŽUVĖDRŲ;92857304500;Taip;11;5;0;16
12307;Vandenis;ŽUVĖDRŲ;55952119623;Taip;10;4;0;14
12308;Vandenis;ŽUVĖDRŲ;58324898715;Taip;0;1;0;1
12309;Vandenis;ŽUVĖDRŲ;56648967396;Taip;0;7;0;7
12310;Vandenis;ŽUVĖDRŲ;87398241763;Taip;5;0;0;5
12311;Vandenis;ŽUVĖDRŲ;48908599635;Taip;5;6;0;11
12312;Vandenis;RUONIUKŲ;2422642232;Taip;5;0;5;10
12313;Vandenis;RUONIUKŲ;1051281257;Taip;5;0;5;10
12314;Vandenis;RUONIUKŲ;7565308536;Taip;5;5;0;10
12315;Vandenis;RUONIUKŲ;9518434896;Taip;6;6;0;12
12316;Vandenis;RUONIUKŲ;2638433939;Taip;0;2;2;4
12317;Vandenis;RUONIUKŲ;1120907086;Taip;0;5;1;6
12318;Vandenis;RUONIUKŲ;1563710105;Taip;0;2;0;2
12319;Vandenis;RUONIUKŲ;7702272913;Taip;8;0;0;8
12320;Vandenis;RUONIUKŲ;6476051751;Taip;0;5;0;5
12321;Vandenis;RUONIUKŲ;9162936403;Taip;0;0;4;4
12322;Vandenis;RUONIUKŲ;4713395766;Taip;5;1;0;6
12323;Vandenis;RUONIUKŲ;6986724058;Taip;2;3;0;5
12324;Vandenis;RUONIUKŲ;7754158588;Taip;0;0;4;4
12325;Vandenis;RUONIUKŲ;9527253920;Taip;10;0;0;10
12326;Vandenis;RUONIUKŲ;8971291182;Taip;3;2;0;5
12327;Vandenis;ŽUVYČIŲ;1381872682;Taip;0;15;0;15
12328;Vandenis;ŽUVYČIŲ;46710726661;Taip;0;2;0;2
12329;Vandenis;ŽUVYČIŲ;36923046515;Taip;0;7;0;7
12330;Vandenis;ŽUVYČIŲ;73799053361;Taip;0;5;0;5
12331;Vandenis;ŽUVYČIŲ;18019716512;Taip;0;8;0;8
12332;Vandenis;ŽUVYČIŲ;11100629204;Taip;0;6;0;6
12333;Vandenis;ŽUVYČIŲ;50378723799;Taip;0;5;0;5
12334;Vandenis;ŽUVYČIŲ;50682359453;Taip;0;7;0;7
12335;Vandenis;ŽUVYČIŲ;25215508382;Taip;0;7;0;7
12336;Vandenis;ŽUVYČIŲ;93927825477;Taip;0;5;0;5
12337;Vandenis;ŽUVYČIŲ;32076192238;Taip;2;1;0;3
12338;Vandenis;ŽUVYČIŲ;42672846405;Taip;0;5;0;5
12339;Vandenis;ŽUVYČIŲ;48268115297;Taip;10;5;0;15
12340;Vandenis;ŽUVYČIŲ;67325111493;Taip;0;5;0;5
12341;Vandenis;ŽUVYČIŲ;888708348;Taip;0;5;1;6
12342;Vandenis;ŽUVYČIŲ;57050923237;Taip;0;4;0;4
12343;Vandenis;ŽUVYČIŲ;32078254928;Taip;0;5;0;5
12344;Vandenis;PERLIUKŲ;28286348996;Taip;0;7;0;7
12345;Vandenis;PERLIUKŲ;2494327284;Taip;0;14;0;14
12346;Vandenis;PERLIUKŲ;20458211098;Taip;0;2;0;2
12347;Vandenis;PERLIUKŲ;47333381244;Taip;0;4;0;4
12348;Vandenis;PERLIUKŲ;95498596116;Taip;0;9;0;9
12349;Vandenis;PERLIUKŲ;39662768043;Taip;1;0;1;2
12350;Vandenis;PERLIUKŲ;391453841;Taip;0;11;0;11
12351;Vandenis;PERLIUKŲ;32087433270;Taip;8;1;0;9
12352;Vandenis;PERLIUKŲ;50009330411;Taip;0;2;0;2
12353;Vandenis;PERLIUKŲ;318399174;Taip;0;1;0;1
12354;Vandenis;PERLIUKŲ;57251416305;Taip;15;0;0;15
12355;Vandenis;PERLIUKŲ;54659569326;Taip;15;0;0;15
12356;Vandenis;PERLIUKŲ;69485657846;Taip;0;1;0;1
12357;Vandenis;PERLIUKŲ;54762939917;Taip;0;2;0;2
12358;Vandenis;PERLIUKŲ;45362889638;Taip;2;2;2;6
12359;Vandenis;PERLIUKŲ;33177236893;Taip;9;1;0;10
12360;Vandenis;PERLIUKŲ;23752943243;Taip;0;2;0;2
12361;Vandenis;PERLIUKŲ;35977990277;Ne;0;12;0;12
12362;Vandenis;PERLIUKŲ;66499269949;Taip;0;2;0;2
12363;Vandenis;PERLIUKŲ;59487083886;Taip;2;2;0;4
12364;Vandenis;PERLIUKŲ;51472939588;Taip;5;7;1;13
12365;Vandenis;PERLIUKŲ;83480564066;Taip;0;2;0;2
12366;Vandenis;PERLIUKŲ;1493719754;Taip;9;1;0;10
12367;Vandenis;ANČIUKŲ;8233407105;Taip;0;9;0;9
12368;Vandenis;ANČIUKŲ;1282499654;Taip;14;2;0;16
12369;Vandenis;ANČIUKŲ;3578947540;Taip;0;6;0;6
12370;Vandenis;ANČIUKŲ;5395847317;Taip;4;5;0;9
12371;Vandenis;ANČIUKŲ;3243079651;Taip;0;5;0;5
12372;Vandenis;ANČIUKŲ;3938359901;Taip;10;5;0;15
12373;Vandenis;ANČIUKŲ;1314724267;Taip;5;5;0;10
12374;Vandenis;ANČIUKŲ;8251169901;Ne;10;7;0;17
12375;Vandenis;ANČIUKŲ;4750141780;Taip;5;3;0;8
12376;Vandenis;ANČIUKŲ;6181866272;Taip;0;10;0;10
12377;Vandenis;ANČIUKŲ;7522472652;Taip;5;7;0;12
12378;Vandenis;ANČIUKŲ;7630017843;Taip;4;1;0;5
12379;Vandenis;ANČIUKŲ;1222539247;Taip;10;0;0;10
12380;Vandenis;ANČIUKŲ;3067868099;Taip;0;8;0;8
12381;Vandenis;ANČIUKŲ;8511948282;Taip;7;7;0;14
12382;Vandenis;ANČIUKŲ;33317650043;Taip;3;3;1;7
12383;Vandenis;ANČIUKŲ;1739780612;Taip;12;0;0;12
12384;Vandenis;ANČIUKŲ;2489776665;Taip;0;2;1;3
12385;Vandenis;ANČIUKŲ;71786730314;Taip;8;0;0;8
12386;Vandenis;ANČIUKŲ;1621481561;Taip;16;0;0;16
12387;Vandenis;ANČIUKŲ;33782837791;Taip;0;2;0;2
12388;Vandenis;VĖŽLIUKŲ;39832993343;Taip;0;9;0;9
12389;Vandenis;VĖŽLIUKŲ;69715525764;Taip;0;5;0;5
12390;Vandenis;VĖŽLIUKŲ;7801129545;Taip;0;1;0;1
12391;Vandenis;VĖŽLIUKŲ;2120420294;Taip;0;5;0;5
12392;Vandenis;VĖŽLIUKŲ;70732367996;Ne;0;5;0;5
12393;Vandenis;VĖŽLIUKŲ;88097898349;Taip;0;4;0;4
12394;Vandenis;VĖŽLIUKŲ;20843785079;Taip;0;0;1;1
12395;Vandenis;VĖŽLIUKŲ;56883076424;Taip;0;5;0;5
12396;Vandenis;VĖŽLIUKŲ;16402149104;Taip;0;5;0;5
12397;Vandenis;VĖŽLIUKŲ;17644420312;Taip;0;4;0;4
12398;Vandenis;VĖŽLIUKŲ;26057060619;Taip;0;3;0;3
12399;Vandenis;VĖŽLIUKŲ;55331810310;Taip;0;11;0;11
12400;Vandenis;VĖŽLIUKŲ;48194812760;Taip;1;5;0;6
12401;Vandenis;VĖŽLIUKŲ;84025519453;Taip;0;6;0;6
12402;Vandenis;VĖŽLIUKŲ;5363853315;Taip;9;5;0;14
12403;Vandenis;VĖŽLIUKŲ;85054617489;Taip;0;12;0;12
12404;Vandenis;VĖŽLIUKŲ;61521559336;Taip;0;5;0;5
12405;Vandenis;VĖŽLIUKŲ;87310831307;Taip;0;5;0;5
12406;Vandenis;VĖŽLIUKŲ;63629799884;Taip;0;5;1;6
12407;Vandenis;VĖŽLIUKŲ;8447593747;Taip;11;0;0;11
12408;Vandenis;VĖŽLIUKŲ;1646554203;Taip;10;5;0;15
12409;Vandenis;VĖŽLIUKŲ;2056980868;Taip;10;0;1;11
12410;Vandenis;VĖŽLIUKŲ;92286914041;Taip;0;5;1;6
12411;Vandenis;AŠTUNKOJŲ;56729656278;Taip;0;5;0;5
12412;Vandenis;AŠTUNKOJŲ;39139875955;Taip;0;8;0;8
12413;Vandenis;AŠTUNKOJŲ;57302718152;Taip;0;5;0;5
12414;Vandenis;AŠTUNKOJŲ;6799539977;Taip;0;5;0;5
12415;Vandenis;AŠTUNKOJŲ;69980435432;Taip;0;5;0;5
12416;Vandenis;AŠTUNKOJŲ;83350314727;Taip;0;5;0;5
12417;Vandenis;AŠTUNKOJŲ;91232893198;Ne;5;5;0;10
12418;Vandenis;AŠTUNKOJŲ;56253560020;Taip;8;1;0;9
12419;Vandenis;AŠTUNKOJŲ;2576662589;Taip;0;3;0;3
12420;Vandenis;AŠTUNKOJŲ;40001674016;Ne;0;17;0;17
12421;Vandenis;AŠTUNKOJŲ;42776106653;Taip;0;1;0;1
12422;Vandenis;AŠTUNKOJŲ;66990746959;Taip;0;6;0;6
12423;Vandenis;AŠTUNKOJŲ;44991747012;Taip;0;5;0;5
12424;Vandenis;AŠTUNKOJŲ;93109763820;Taip;0;6;0;6
12425;Vandenis;AŠTUNKOJŲ;42690205977;Taip;0;1;0;1
12426;Vandenis;AŠTUNKOJŲ;37019206511;Taip;0;10;0;10
12427;Vandenis;AŠTUNKOJŲ;88415992702;Taip;0;2;0;2
12428;Vandenis;AŠTUNKOJŲ;68749162348;Taip;0;1;0;1
12429;Vandenis;GANDRIUKŲ;1455424753;Taip;15;5;0;20
12430;Vandenis;GANDRIUKŲ;6048257249;Taip;0;1;0;1
12431;Vandenis;GANDRIUKŲ;1029909269;Taip;6;6;0;12
12432;Vandenis;GANDRIUKŲ;11961797041;Taip;0;0;2;2
12433;Vandenis;GANDRIUKŲ;16608149961;Taip;0;5;0;5
12434;Vandenis;GANDRIUKŲ;80422278900;Taip;0;10;0;10
12435;Vandenis;GANDRIUKŲ;33029527496;Taip;0;8;0;8
12436;Vandenis;GANDRIUKŲ;83265714438;Taip;0;5;0;5
12437;Vandenis;GANDRIUKŲ;4633003964;Taip;0;5;0;5
12438;Vandenis;GANDRIUKŲ;89197182757;Taip;0;6;0;6
12439;Vandenis;GANDRIUKŲ;1498815019;Taip;0;7;0;7
12440;Vandenis;GANDRIUKŲ;1397176489;Taip;0;1;0;1
12441;Vandenis;GANDRIUKŲ;54770618599;Taip;0;8;0;8
12442;Vandenis;GANDRIUKŲ;10538645159;Ne;2;7;3;12
12443;Vandenis;GANDRIUKŲ;20957822945;Taip;0;7;0;7
12444;Vandenis;GANDRIUKŲ;13943773510;Taip;4;5;0;9
12445;Vandenis;GANDRIUKŲ;47997751365;Taip;0;7;0;7
12446;Vandenis;GANDRIUKŲ;91684805923;Taip;0;2;0;2
12447;Vandenis;GANDRIUKŲ;48076017461;Taip;0;5;0;5
12448;Vandenis;ŽĄSIUKAI;80643665990;Taip;0;2;0;2
12449;Vandenis;ŽĄSIUKAI;74138671368;Taip;0;3;0;3
12450;Vandenis;ŽĄSIUKAI;25459674313;Taip;0;5;0;5
12451;Vandenis;ŽĄSIUKAI;2812520834;Taip;0;5;0;5
12452;Vandenis;ŽĄSIUKAI;1286716632;Taip;10;0;0;10
12453;Vandenis;ŽĄSIUKAI;1373653402;Taip;5;1;0;6
12454;Vandenis;ŽĄSIUKAI;65840410497;Taip;3;7;0;10
12455;Vandenis;ŽĄSIUKAI;53658866238;Taip;0;20;0;20
12456;Vandenis;ŽĄSIUKAI;1217508516;Taip;0;9;0;9
12457;Vandenis;ŽĄSIUKAI;55238344586;Taip;0;4;0;4
12458;Vandenis;ŽĄSIUKAI;25934798454;Taip;6;0;0;6
12459;Vandenis;ŽĄSIUKAI;23439586487;Taip;0;1;0;1
12460;Vandenis;ŽĄSIUKAI;78917527699;Taip;0;1;1;2
12461;Vandenis;ŽĄSIUKAI;1397125827;Taip;0;5;0;5
12462;Vandenis;ŽĄSIUKAI;46916815441;Taip;4;0;0;4
12463;Vandenis;ŽĄSIUKAI;1155423158;Taip;0;13;0;13
12464;Vandenis;ŽĄSIUKAI;7333587583;Taip;0;5;0;5
12465;Vandenis;PURIENŲ;2114436962;Taip;0;7;0;7
12466;Vandenis;PURIENŲ;877974909;Taip;3;6;0;9
12467;Vandenis;PURIENŲ;3823382249;Taip;0;11;0;11
12468;Vandenis;PURIENŲ;43295720034;Taip;4;5;0;9
12469;Vandenis;PURIENŲ;84636435681;Taip;3;3;0;6
12470;Vandenis;PURIENŲ;1958929302;Taip;8;1;0;9
12471;Vandenis;PURIENŲ;39973189502;Taip;1;0;0;1
12472;Vandenis;PURIENŲ;2096950367;Taip;0;6;0;6
12473;Vandenis;PURIENŲ;1633589144;Taip;6;2;0;8
12474;Vandenis;PURIENŲ;1854498462;Taip;10;1;0;11
12475;Vandenis;PURIENŲ;7467699979;Taip;2;1;1;4
12476;Vandenis;PURIENŲ;6673346389;Taip;6;0;0;6
12477;Vandenis;PURIENŲ;7168910452;Taip;5;1;0;6
12478;Vandenis;PURIENŲ;58997790744;Taip;0;8;0;8
12479;Vandenis;PURIENŲ;2073785910;Taip;0;1;0;1
12480;Vandenis;PURIENŲ;1245031666;Taip;3;1;0;4
12481;Vandenis;PURIENŲ;61120985165;Taip;0;3;0;3
12482;Vandenis;PURIENŲ;38137368394;Taip;5;1;0;6
12483;Vandenis;PURIENŲ;81817138188;Taip;7;1;0;8
12484;Vandenis;PURIENŲ;86947904365;Taip;5;3;0;8
12485;Vandenis;PURIENŲ;1395272045;Taip;15;2;0;17
12486;Vandenis;PURIENŲ;3740778932;Taip;15;0;0;15
12487;Vandenis;VARLIUKAI;5126732658;Taip;5;2;0;7
12488;Vandenis;VARLIUKAI;7091356848;Taip;0;6;0;6
12489;Vandenis;VARLIUKAI;8116532445;Taip;16;0;0;16
12490;Vandenis;VARLIUKAI;7069369080;Taip;16;0;0;16
12491;Vandenis;VARLIUKAI;7924399684;Taip;0;7;0;7
12492;Vandenis;VARLIUKAI;2872343656;Taip;5;0;1;6
12493;Vandenis;VARLIUKAI;5454049563;Taip;8;2;1;11
12494;Vandenis;VARLIUKAI;9805578141;Taip;8;2;1;11
12495;Vandenis;VARLIUKAI;8921666108;Taip;10;5;0;15
12496;Vandenis;VARLIUKAI;6011280420;Taip;15;0;0;15
12497;Vandenis;VARLIUKAI;1187395353;Taip;12;0;0;12
12498;Vandenis;VARLIUKAI;1081385111;Taip;11;0;0;11
12499;Vandenis;VARLIUKAI;9158541919;Taip;5;0;0;5
12500;Vandenis;VARLIUKAI;5959181898;Taip;5;0;0;5
12501;Vandenis;VARLIUKAI;7059385610;Taip;0;1;0;1
12502;Vandenis;VARLIUKAI;2645775090;Taip;0;3;0;3
12503;Vandenis;PINGVINAI;9994373029;Taip;20;0;0;20
12504;Vandenis;PINGVINAI;3544717790;Taip;0;7;0;7
12505;Vandenis;PINGVINAI;4085256182;Taip;5;2;0;7
12506;Vandenis;PINGVINAI;18336904438;Taip;0;2;0;2
12507;Vandenis;PINGVINAI;8689134931;Taip;0;6;0;6
12508;Vandenis;PINGVINAI;9608871155;Taip;0;2;0;2
12509;Vandenis;PINGVINAI;64711327503;Taip;13;3;0;16
12510;Vandenis;PINGVINAI;71513217054;Taip;10;2;0;12
12511;Vandenis;PINGVINAI;55421695186;Taip;2;2;0;4
12512;Vandenis;PINGVINAI;24217366528;Taip;10;5;0;15
12513;Vandenis;PINGVINAI;5549292096;Taip;0;7;0;7
12514;Vandenis;PINGVINAI;4643267945;Taip;1;10;0;11
12515;Vandenis;PINGVINAI;8430706407;Taip;0;1;0;1
12516;Vandenis;PINGVINAI;35673258175;Taip;6;1;1;8
12517;Vandenis;PINGVINAI;27409922803;Taip;16;0;0;16
12518;Vėjelis;Pumpurėliai;58369004570;Taip;0;1;0;1
12519;Vėjelis;Pumpurėliai;54924516732;Taip;0;6;0;6
12520;Vėjelis;Pumpurėliai;38106696628;Taip;0;12;0;12
12521;Vėjelis;Pumpurėliai;8653964270;Taip;0;9;0;9
12522;Vėjelis;Pumpurėliai;88817521596;Taip;0;2;0;2
12523;Vėjelis;Pumpurėliai;53270546031;Taip;5;6;0;11
12524;Vėjelis;Pumpurėliai;16294883533;Taip;0;1;0;1
12525;Vėjelis;Pumpurėliai;53587810020;Taip;0;1;0;1
12526;Vėjelis;Pumpurėliai;58314846835;Taip;0;6;0;6
12527;Vėjelis;Pumpurėliai;34584409245;Taip;0;5;0;5
12528;Vėjelis;Pumpurėliai;63893850632;Taip;0;1;0;1
12529;Vėjelis;Pumpurėliai;95469370742;Taip;10;0;0;10
12530;Vėjelis;Pumpurėliai;14212441124;Taip;0;2;0;2
12531;Vėjelis;Pumpurėliai;53379180843;Taip;0;9;0;9
12532;Vėjelis;Pumpurėliai;17523450164;Taip;0;6;0;6
12533;Vėjelis;Pumpurėliai;5365237487;Taip;0;0;1;1
12534;Vėjelis;Pumpurėliai;3965445196;Taip;6;1;0;7
12535;Vėjelis;Pumpurėliai;2301011427;Taip;0;14;0;14
12536;Vėjelis;Drugeliai;4746932126;Taip;8;3;0;11
12537;Vėjelis;Drugeliai;1978952781;Taip;10;0;0;10
12538;Vėjelis;Drugeliai;8353084814;Taip;0;15;0;15
12539;Vėjelis;Drugeliai;1115802837;Taip;15;5;0;20
12540;Vėjelis;Drugeliai;2416832899;Taip;7;0;0;7
12541;Vėjelis;Drugeliai;4741154518;Taip;0;9;0;9
12542;Vėjelis;Drugeliai;1494531065;Taip;7;0;1;8
12543;Vėjelis;Drugeliai;3276062426;Taip;17;0;0;17
12544;Vėjelis;Drugeliai;9298789434;Taip;15;0;0;15
12545;Vėjelis;Drugeliai;2734024890;Taip;10;2;0;12
12546;Vėjelis;Drugeliai;7981032872;Taip;15;5;0;20
12547;Vėjelis;Drugeliai;7133454882;Taip;7;5;1;13
12548;Vėjelis;Drugeliai;2000277444;Taip;10;0;0;10
12549;Vėjelis;Drugeliai;7752923796;Taip;11;0;3;14
12550;Vėjelis;Drugeliai;7594586198;Taip;9;0;0;9
12551;Vėjelis;Drugeliai;7697394469;Taip;20;0;0;20
12552;Vėjelis;Drugeliai;4066956765;Taip;10;0;0;10
12553;Vėjelis;Drugeliai;9696910320;Taip;5;0;2;7
12554;Vėjelis;Malūnėlis;63002531941;Taip;0;5;0;5
12555;Vėjelis;Malūnėlis;16498317981;Taip;9;1;0;10
12556;Vėjelis;Malūnėlis;93859592652;Taip;5;1;0;6
12557;Vėjelis;Malūnėlis;12149443904;Taip;0;4;0;4
12558;Vėjelis;Malūnėlis;76098853911;Ne;0;4;1;5
12559;Vėjelis;Malūnėlis;74207410750;Taip;0;9;0;9
12560;Vėjelis;Malūnėlis;69740475863;Ne;0;5;0;5
12561;Vėjelis;Malūnėlis;20148908290;Taip;10;4;0;14
12562;Vėjelis;Malūnėlis;90926729186;Taip;0;1;0;1
12563;Vėjelis;Malūnėlis;39671245978;Taip;0;1;0;1
12564;Vėjelis;Malūnėlis;1209526192;Taip;0;5;0;5
12565;Vėjelis;Malūnėlis;58121447313;Taip;6;5;0;11
12566;Vėjelis;Malūnėlis;68958036563;Taip;5;1;0;6
12567;Vėjelis;Malūnėlis;20593684676;Taip;0;2;0;2
12568;Vėjelis;Malūnėlis;64104308245;Taip;6;0;0;6
12569;Vėjelis;Malūnėlis;14502736200;Taip;3;2;5;10
12570;Vėjelis;Malūnėlis;98024305748;Taip;10;1;0;11
12571;Vėjelis;Malūnėlis;5735207486;Taip;0;1;0;1
12572;Vėjelis;Malūnėlis;4194366404;Taip;10;5;5;20
12573;Vėjelis;Malūnėlis;1603377234;Taip;13;0;0;13
12574;Vėjelis;Malūnėlis;87555226002;Taip;0;5;0;5
12575;Vėjelis;Žvaigždutės;1295818672;Taip;4;6;0;10
12576;Vėjelis;Žvaigždutės;1930159743;Taip;0;1;1;2
12577;Vėjelis;Žvaigždutės;1540879634;Taip;10;0;0;10
12578;Vėjelis;Žvaigždutės;1612878387;Taip;0;9;0;9
12579;Vėjelis;Žvaigždutės;3485366651;Taip;4;7;0;11
12580;Vėjelis;Žvaigždutės;5139323880;Taip;3;5;0;8
12581;Vėjelis;Žvaigždutės;2363974247;Taip;9;2;0;11
12582;Vėjelis;Žvaigždutės;86337749074;Taip;0;2;0;2
12583;Vėjelis;Žvaigždutės;8379298947;Taip;9;2;0;11
12584;Vėjelis;Žvaigždutės;47986392996;Taip;7;0;0;7
12585;Vėjelis;Žvaigždutės;7610485310;Taip;0;14;0;14
12586;Vėjelis;Žvaigždutės;90647333398;Taip;4;7;0;11
12587;Vėjelis;Žvaigždutės;40744700561;Taip;0;9;0;9
12588;Vėjelis;Žvaigždutės;26328498777;Taip;6;0;0;6
12589;Vėjelis;Žvaigždutės;47143492836;Taip;15;5;0;20
12590;Vėjelis;Žvaigždutės;69341469387;Taip;0;12;0;12
12591;Vėjelis;Žvaigždutės;9190085358;Taip;0;20;0;20
12592;Vėjelis;Žvaigždutės;56520156825;Taip;10;6;0;16
12593;Vėjelis;Žvaigždutės;90103717718;Taip;5;0;0;5
12594;Vėjelis;Žvaigždutės;8949760376;Taip;0;0;1;1
12595;Vėjelis;Žvaigždutės;6002719498;Taip;10;6;0;16
12596;Vėjelis;Žvaigždutės;9000966115;Taip;0;5;0;5
12597;Vėjelis;Varpeliai;2759958482;Taip;5;5;1;11
12598;Vėjelis;Varpeliai;898039829;Taip;0;7;0;7
12599;Vėjelis;Varpeliai;58968869099;Taip;0;7;0;7
12600;Vėjelis;Varpeliai;25190615976;Taip;0;5;3;8
12601;Vėjelis;Varpeliai;19701264312;Taip;4;1;0;5
12602;Vėjelis;Varpeliai;28696711850;Taip;0;5;0;5
12603;Vėjelis;Varpeliai;47402024682;Taip;0;5;0;5
12604;Vėjelis;Varpeliai;8787363287;Taip;0;11;0;11
12605;Vėjelis;Varpeliai;90573854976;Taip;0;4;0;4
12606;Vėjelis;Varpeliai;83608030842;Taip;0;4;0;4
12607;Vėjelis;Varpeliai;53440131428;Taip;0;5;1;6
12608;Vėjelis;Varpeliai;71456994638;Taip;0;4;0;4
12609;Vėjelis;Varpeliai;14157070764;Taip;0;5;2;7
12610;Vėjelis;Varpeliai;90996312461;Taip;0;11;0;11
12611;Vėjelis;Varpeliai;86680640521;Taip;0;6;0;6
12612;Vėjelis;Varpeliai;46016776013;Taip;0;7;0;7
12613;Vėjelis;Varpeliai;1944266562;Taip;0;5;2;7
12614;Vėjelis;Varpeliai;94214534219;Taip;1;6;0;7
12615;Vėjelis;Varpeliai;89044270439;Taip;3;5;1;9
12616;Vėjelis;Varpeliai;3214710339;Taip;0;8;0;8
12617;Vėjelis;Varpeliai;80942260332;Taip;0;7;0;7
12618;Vėjelis;Varpeliai;80423879616;Taip;0;7;0;7
12619;Vėjelis;Pelėdžiukų;1563935993;Taip;9;5;0;14
12620;Vėjelis;Pelėdžiukų;1454662113;Taip;8;0;0;8
12621;Vėjelis;Pelėdžiukų;1467023330;Taip;0;1;0;1
12622;Vėjelis;Pelėdžiukų;1238171728;Taip;3;0;0;3
12623;Vėjelis;Pelėdžiukų;5992665537;Taip;0;10;0;10
12624;Vėjelis;Pelėdžiukų;4024898537;Taip;6;2;0;8
12625;Vėjelis;Pelėdžiukų;24011371444;Taip;4;2;0;6
12626;Vėjelis;Pelėdžiukų;2819491961;Taip;17;0;0;17
12627;Vėjelis;Pelėdžiukų;1990674632;Taip;6;0;0;6
12628;Vėjelis;Pelėdžiukų;1783878104;Taip;9;3;0;12
12629;Vėjelis;Pelėdžiukų;55075988807;Taip;11;0;0;11
12630;Vėjelis;Pelėdžiukų;8033732937;Taip;0;1;0;1
12631;Vėjelis;Pelėdžiukų;6618114389;Taip;15;2;0;17
12632;Vėjelis;Pelėdžiukų;1510415602;Taip;10;0;0;10
12633;Vėjelis;Pelėdžiukų;2042863944;Taip;0;5;0;5
12634;Vėjelis;Pelėdžiukų;1347855869;Taip;0;2;4;6
12635;Vėjelis;Pelėdžiukų;1719502147;Taip;0;5;0;5
12636;Vėjelis;Pelėdžiukų;2128818222;Taip;12;0;0;12
12637;Vėjelis;Pelėdžiukų;4930807661;Taip;10;5;0;15
12638;Vėjelis;Pelėdžiukų;1518855620;Taip;10;1;0;11
12639;Vėjelis;Skruzdeliukų;2021887954;Taip;0;1;0;1
12640;Vėjelis;Skruzdeliukų;1267672356;Taip;10;0;0;10
12641;Vėjelis;Skruzdeliukų;5468993286;Taip;9;3;0;12
12642;Vėjelis;Skruzdeliukų;46167493039;Taip;0;3;0;3
12643;Vėjelis;Skruzdeliukų;90185075321;Taip;4;0;0;4
12644;Vėjelis;Skruzdeliukų;1640356242;Taip;0;10;0;10
12645;Vėjelis;Skruzdeliukų;86128256406;Taip;8;6;0;14
12646;Vėjelis;Skruzdeliukų;41268510292;Taip;0;3;0;3
12647;Vėjelis;Skruzdeliukų;1921039937;Taip;6;1;1;8
12648;Vėjelis;Skruzdeliukų;57285479257;Taip;0;1;0;1
12649;Vėjelis;Skruzdeliukų;44482585723;Taip;0;5;0;5
12650;Vėjelis;Skruzdeliukų;77205958956;Taip;16;0;1;17
12651;Vėjelis;Skruzdeliukų;2718251356;Taip;0;5;5;10
12652;Vėjelis;Skruzdeliukų;1988459596;Taip;9;0;0;9
12653;Vėjelis;Skruzdeliukų;1934426525;Taip;0;13;0;13
12654;Vėjelis;Skruzdeliukų;64339770365;Taip;0;17;0;17
12655;Vėjelis;Skruzdeliukų;44153389025;Taip;2;4;0;6
12656;Vėjelis;Skruzdeliukų;1284286578;Taip;11;5;1;17
12657;Vėjelis;Skruzdeliukų;1789982154;Taip;0;14;0;14
12658;Vėjelis;Skruzdeliukų;75596757609;Taip;13;0;0;13
12659;Vėjelis;Pieštukų;3255066035;Taip;16;0;0;16
12660;Vėjelis;Pieštukų;76305473353;Taip;0;5;3;8
12661;Vėjelis;Pieštukų;50124109589;Taip;0;16;0;16
12662;Vėjelis;Pieštukų;4853650350;Taip;0;5;0;5
12663;Vėjelis;Pieštukų;73287916371;Taip;10;4;0;14
12664;Vėjelis;Pieštukų;60890519853;Taip;0;6;0;6
12665;Vėjelis;Pieštukų;78490601352;Taip;6;0;0;6
12666;Vėjelis;Pieštukų;8386409466;Taip;0;0;20;20
12667;Vėjelis;Pieštukų;8938491367;Taip;5;0;0;5
12668;Vėjelis;Pieštukų;9492690970;Taip;0;5;0;5
12669;Vėjelis;Pieštukų;6386092350;Taip;10;10;0;20
12670;Vėjelis;Pieštukų;8684461171;Taip;0;12;0;12
12671;Vėjelis;Pieštukų;8973530484;Taip;0;1;1;2
12672;Vėjelis;Pieštukų;98588113289;Taip;0;6;0;6
12673;Vėjelis;Pieštukų;4067153819;Taip;10;0;7;17
12674;Vėjelis;Pieštukų;9395929106;Taip;17;0;0;17
12675;Vėjelis;Pieštukų;1205392813;Taip;0;12;0;12
12676;Vėjelis;Pieštukų;5031781196;Taip;5;0;0;5
12677;Vėjelis;Ramunėlių;5987294293;Taip;0;11;0;11
12678;Vėjelis;Ramunėlių;8047799576;Taip;15;1;0;16
12679;Vėjelis;Ramunėlių;4745262277;Taip;5;1;0;6
12680;Vėjelis;Ramunėlių;4353239658;Taip;3;0;0;3
12681;Vėjelis;Ramunėlių;7178844364;Taip;8;2;0;10
12682;Vėjelis;Ramunėlių;2164009051;Taip;5;0;0;5
12683;Vėjelis;Ramunėlių;2386927970;Taip;17;3;0;20
12684;Vėjelis;Ramunėlių;2124857941;Taip;6;3;0;9
12685;Vėjelis;Ramunėlių;6455798848;Taip;8;0;0;8
12686;Vėjelis;Ramunėlių;2999425729;Taip;10;1;0;11
12687;Vėjelis;Ramunėlių;6996900411;Taip;0;7;0;7
12688;Vėjelis;Ramunėlių;2289954824;Taip;15;2;0;17
12689;Vėjelis;Ramunėlių;1717847351;Taip;10;1;0;11
12690;Vėjelis;Ramunėlių;6777528441;Taip;0;5;0;5
12691;Vėjelis;Ramunėlių;6891260701;Taip;0;6;0;6
12692;Vėjelis;Ramunėlių;2151737048;Taip;8;10;0;18
12693;Vėjelis;Ramunėlių;7836199284;Taip;20;0;0;20
12694;Vėjelis;Nykštukai;43342043904;Taip;0;5;0;5
12695;Vėjelis;Nykštukai;22865699640;Taip;9;5;0;14
12696;Vėjelis;Nykštukai;12487059850;Taip;0;6;0;6
12697;Vėjelis;Nykštukai;20492762368;Taip;0;9;0;9
12698;Vėjelis;Nykštukai;1008705526;Taip;0;8;0;8
12699;Vėjelis;Nykštukai;1251348150;Taip;5;3;0;8
12700;Vėjelis;Nykštukai;85352317063;Taip;0;8;0;8
12701;Vėjelis;Nykštukai;41673970488;Taip;0;5;0;5
12702;Vėjelis;Nykštukai;89943712210;Taip;0;7;0;7
12703;Vėjelis;Nykštukai;64628040227;Taip;4;7;0;11
12704;Vėjelis;Nykštukai;33235320630;Taip;0;8;0;8
12705;Vėjelis;Nykštukai;29087363179;Taip;0;11;0;11
12706;Vėjelis;Nykštukai;2132492766;Taip;0;3;5;8
12707;Vėjelis;Nykštukai;8226906949;Taip;5;1;0;6
12708;Vėjelis;Nykštukai;5207473829;Taip;5;0;0;5
12709;Vėjelis;Nykštukai;4938939921;Taip;0;12;0;12
12710;Vėjelis;Nykštukai;72881976363;Taip;5;3;0;8
12711;Vėjelis;Nykštukai;78465993753;Ne;4;10;0;14
12712;Vėjelis;Nykštukai;63900641942;Taip;5;3;0;8
12713;Vėjelis;Nykštukai;14754302946;Taip;0;5;0;5
12714;Vėjelis;Nykštukai;1053502203;Ne;7;6;0;13
12715;Vėjelis;Nykštukai;1481976292;Taip;0;3;0;3
12716;Vėjelis;Nykštukai;47716333909;Taip;0;13;0;13
12717;Vėjelis;BITUTĖS;5902455219;Taip;0;10;0;10
12718;Vėjelis;BITUTĖS;4831426440;Taip;0;6;5;11
12719;Vėjelis;BITUTĖS;74475070018;Taip;6;6;0;12
12720;Vėjelis;BITUTĖS;5517128872;Taip;5;3;0;8
12721;Vėjelis;BITUTĖS;6724813553;Taip;5;5;0;10
12722;Vėjelis;BITUTĖS;4451119031;Taip;0;12;0;12
12723;Vėjelis;BITUTĖS;8721116918;Taip;13;0;0;13
12724;Vėjelis;BITUTĖS;1270627404;Taip;5;0;0;5
12725;Vėjelis;BITUTĖS;2575398136;Taip;5;0;0;5
12726;Vėjelis;BITUTĖS;3584347608;Taip;0;8;0;8
12727;Vėjelis;BITUTĖS;9108653045;Taip;15;5;0;20
12728;Vėjelis;BITUTĖS;5508269515;Taip;19;0;0;19
12729;Vėjelis;BITUTĖS;9672929606;Taip;0;6;5;11
12730;Vėjelis;BITUTĖS;6451722893;Taip;20;0;0;20
12731;Vėjelis;BITUTĖS;5909697341;Taip;0;10;0;10
12732;Vėjelis;BITUTĖS;8668671325;Taip;20;0;0;20
12733;Vėjelis;BITUTĖS;9754373141;Taip;10;0;1;11
12734;Vėjelis;BITUTĖS;4906958328;Taip;7;1;0;8
12735;Vėjelis;Boruželės;2199680661;Taip;5;0;0;5
12736;Vėjelis;Boruželės;5325081841;Taip;0;1;0;1
12737;Vėjelis;Boruželės;5381588565;Taip;12;0;0;12
12738;Vėjelis;Boruželės;1863210064;Taip;0;6;0;6
12739;Vėjelis;Boruželės;9037622738;Taip;11;0;0;11
12740;Vėjelis;Boruželės;8553966497;Taip;0;6;0;6
12741;Vėjelis;Boruželės;1751533938;Taip;0;6;0;6
12742;Vėjelis;Boruželės;4733227215;Taip;6;5;0;11
12743;Vėjelis;Boruželės;1429496839;Taip;0;3;0;3
12744;Vėjelis;Boruželės;1931659200;Taip;16;0;0;16
12745;Vėjelis;Boruželės;1076538028;Taip;19;0;0;19
12746;Vėjelis;Boruželės;6658178519;Taip;11;0;0;11
12747;Vėjelis;Boruželės;8666759391;Taip;0;2;0;2
12748;Vėjelis;Boruželės;3844131154;Taip;4;0;0;4
12749;Vėjelis;Boruželės;1312784365;Taip;0;1;0;1
12750;Vėjelis;Boruželės;4747466651;Taip;3;1;0;4
12751;Vėjelis;Boruželės;3473416323;Taip;0;4;0;4
12752;Vėjelis;Boruželės;8141198449;Taip;6;7;0;13
12753;Vėjelis;Boruželės;8121537795;Taip;6;7;0;13
12754;Vėtrungė;Debesėlių;62501279379;Taip;8;7;0;15
12755;Vėtrungė;Debesėlių;684188851;Taip;10;1;0;11
12756;Vėtrungė;Debesėlių;1833285759;Taip;0;7;0;7
12757;Vėtrungė;Debesėlių;31644585040;Ne;0;15;0;15
12758;Vėtrungė;Debesėlių;68262180072;Taip;0;8;0;8
12759;Vėtrungė;Debesėlių;18747550179;Taip;0;7;1;8
12760;Vėtrungė;Debesėlių;63472451321;Taip;8;5;0;13
12761;Vėtrungė;Debesėlių;97059033453;Ne;10;0;0;10
12762;Vėtrungė;Debesėlių;30792456956;Taip;5;1;0;6
12763;Vėtrungė;Debesėlių;28780493289;Taip;7;10;0;17
12764;Vėtrungė;Debesėlių;65861118217;Taip;0;1;0;1
12765;Vėtrungė;Debesėlių;48935809458;Ne;0;2;0;2
12766;Vėtrungė;Debesėlių;92977432447;Ne;0;9;0;9
12767;Vėtrungė;Debesėlių;11835082526;Taip;4;1;0;5
12768;Vėtrungė;Debesėlių;92266460791;Taip;8;3;0;11
12769;Vėtrungė;Debesėlių;30561569339;Ne;13;2;0;15
12770;Vėtrungė;Debesėlių;31570905515;Ne;13;2;0;15
12771;Vėtrungė;Debesėlių;4547247726;Taip;0;16;0;16
12772;Vėtrungė;Debesėlių;1918866964;Taip;19;2;0;21
12773;Vėtrungė;Debesėlių;22961558196;Taip;2;6;0;8
12774;Vėtrungė;Debesėlių;96980344422;Taip;8;1;0;9
12775;Vėtrungė;Zuikių;8493950205;Taip;3;0;0;3
12776;Vėtrungė;Zuikių;7585075881;Taip;23;0;0;23
12777;Vėtrungė;Zuikių;4874628984;Taip;10;1;0;11
12778;Vėtrungė;Zuikių;9332362038;Taip;10;1;0;11
12779;Vėtrungė;Zuikių;9407558097;Taip;10;9;0;19
12780;Vėtrungė;Zuikių;2985829593;Taip;5;11;0;16
12781;Vėtrungė;Zuikių;4121886031;Taip;0;10;15;25
12782;Vėtrungė;Zuikių;4080895256;Taip;5;1;2;8
12783;Vėtrungė;Zuikių;7573021445;Taip;0;6;0;6
12784;Vėtrungė;Zuikių;3335047815;Taip;6;0;0;6
12785;Vėtrungė;Zuikių;8157356569;Taip;5;1;0;6
12786;Vėtrungė;Zuikių;9742099165;Taip;20;2;0;22
12787;Vėtrungė;Drugelių;98795465390;Taip;6;0;0;6
12788;Vėtrungė;Drugelių;34534856875;Ne;7;0;0;7
12789;Vėtrungė;Drugelių;1019550327;Taip;5;0;3;8
12790;Vėtrungė;Drugelių;26126038013;Taip;0;15;0;15
12791;Vėtrungė;Drugelių;40200404538;Taip;5;5;0;10
12792;Vėtrungė;Drugelių;96815788666;Taip;10;0;0;10
12793;Vėtrungė;Drugelių;72462689908;Taip;5;3;0;8
12794;Vėtrungė;Drugelių;38583821324;Ne;0;15;0;15
12795;Vėtrungė;Drugelių;42353807206;Taip;5;12;0;17
12796;Vėtrungė;Drugelių;68573318766;Ne;0;15;0;15
12797;Vėtrungė;Drugelių;76967115688;Taip;0;3;0;3
12798;Vėtrungė;Drugelių;68938242748;Taip;10;5;0;15
12799;Vėtrungė;Drugelių;93587767496;Taip;11;6;0;17
12800;Vėtrungė;Drugelių;45715910769;Taip;5;0;0;5
12801;Vėtrungė;Drugelių;1111688152;Taip;9;6;0;15
12802;Vėtrungė;Drugelių;1752676956;Taip;0;11;0;11
12803;Vėtrungė;Drugelių;1128961321;Taip;14;0;0;14
12804;Vėtrungė;Drugelių;88062307371;Taip;12;1;0;13
12805;Vėtrungė;Drugelių;99423172685;Ne;6;5;0;11
12806;Vėtrungė;Drugelių;58224525427;Taip;3;14;0;17
12807;Vėtrungė;Drugelių;1533796435;Taip;0;12;0;12
12808;Vėtrungė;Do-re-mi;6449124019;Taip;10;1;1;12
12809;Vėtrungė;Do-re-mi;3278452234;Taip;8;6;1;15
12810;Vėtrungė;Do-re-mi;9324733839;Taip;0;6;0;6
12811;Vėtrungė;Do-re-mi;2287044278;Taip;7;0;0;7
12812;Vėtrungė;Do-re-mi;2928868412;Taip;8;1;0;9
12813;Vėtrungė;Do-re-mi;2883254822;Taip;10;0;0;10
12814;Vėtrungė;Do-re-mi;3404120492;Taip;13;0;0;13
12815;Vėtrungė;Do-re-mi;9518734260;Taip;15;0;0;15
12816;Vėtrungė;Do-re-mi;7782972361;Taip;8;8;0;16
12817;Vėtrungė;Do-re-mi;7496582551;Taip;7;0;0;7
12818;Vėtrungė;Do-re-mi;5430818470;Taip;25;0;0;25
12819;Vėtrungė;Do-re-mi;9527296531;Taip;0;11;2;13
12820;Vėtrungė;Do-re-mi;1088517019;Ne;18;0;0;18
12821;Vėtrungė;Do-re-mi;5832298824;Ne;7;0;0;7
12822;Vėtrungė;Do-re-mi;7895027909;Taip;6;2;0;8
12823;Vėtrungė;Smalsučių;1024966114;Taip;10;0;3;13
12824;Vėtrungė;Smalsučių;70341931369;Ne;0;2;0;2
12825;Vėtrungė;Smalsučių;12552330015;Taip;5;7;0;12
12826;Vėtrungė;Smalsučių;43313050517;Taip;2;3;2;7
12827;Vėtrungė;Smalsučių;1096312626;Taip;0;10;0;10
12828;Vėtrungė;Smalsučių;58071867972;Taip;0;15;3;18
12829;Vėtrungė;Smalsučių;25185803642;Taip;0;8;0;8
12830;Vėtrungė;Smalsučių;8303270253;Taip;0;1;0;1
12831;Vėtrungė;Smalsučių;10642323891;Taip;0;10;0;10
12832;Vėtrungė;Smalsučių;1637718306;Taip;0;11;0;11
12833;Vėtrungė;Smalsučių;37534609024;Taip;5;5;3;13
12834;Vėtrungė;Smalsučių;18697110620;Taip;5;4;0;9
12835;Vėtrungė;Smalsučių;55178408212;Taip;5;0;2;7
12836;Vėtrungė;Smalsučių;22272024279;Taip;0;2;0;2
12837;Vėtrungė;Smalsučių;1828688039;Taip;0;6;2;8
12838;Vėtrungė;Gudručių;39325086836;Taip;10;10;0;20
12839;Vėtrungė;Gudručių;9097027948;Taip;3;1;0;4
12840;Vėtrungė;Gudručių;71205463603;Taip;0;6;0;6
12841;Vėtrungė;Gudručių;37846747830;Taip;7;0;0;7
12842;Vėtrungė;Gudručių;53452204630;Taip;0;10;0;10
12843;Vėtrungė;Gudručių;63918616201;Taip;0;6;0;6
12844;Vėtrungė;Gudručių;71037045946;Taip;0;17;0;17
12845;Vėtrungė;Gudručių;50620488812;Taip;0;10;3;13
12846;Vėtrungė;Gudručių;17639791114;Taip;0;7;0;7
12847;Vėtrungė;Gudručių;45652505960;Taip;10;7;0;17
12848;Vėtrungė;Gudručių;79959834921;Ne;7;13;0;20
12849;Vėtrungė;Gudručių;32639429554;Taip;11;0;0;11
12850;Vėtrungė;Gudručių;72698261170;Taip;0;17;0;17
12851;Vėtrungė;Gudručių;34053590435;Ne;0;2;0;2
12852;Vėtrungė;Gudručių;74200855756;Taip;0;3;0;3
12853;Vėtrungė;Gudručių;13233957713;Ne;0;14;0;14
12854;Vėtrungė;Gudručių;29414532281;Ne;0;8;0;8
12855;Vėtrungė;Gudručių;16576620734;Ne;0;12;0;12
12856;Vėtrungė;Gudručių;1120374635;Taip;15;5;0;20
12857;Vėtrungė;Gudručių;77759679609;Taip;6;12;0;18
12858;Vėtrungė;Kodėlčių;1366458234;Taip;10;1;0;11
12859;Vėtrungė;Kodėlčių;1021458176;Taip;0;25;0;25
12860;Vėtrungė;Kodėlčių;1267104594;Taip;0;8;0;8
12861;Vėtrungė;Kodėlčių;1022530443;Taip;5;0;0;5
12862;Vėtrungė;Kodėlčių;1283685496;Taip;6;6;0;12
12863;Vėtrungė;Kodėlčių;20608668180;Taip;11;1;0;12
12864;Vėtrungė;Kodėlčių;3980104822;Taip;0;9;0;9
12865;Vėtrungė;Kodėlčių;31133574731;Taip;0;22;0;22
12866;Vėtrungė;Kodėlčių;49220186521;Taip;0;17;0;17
12867;Vėtrungė;Kodėlčių;41508942219;Taip;5;13;0;18
12868;Vėtrungė;Kodėlčių;1662123237;Taip;0;9;0;9
12869;Vėtrungė;Kodėlčių;1456877681;Taip;5;20;0;25
12870;Vėtrungė;Kodėlčių;90528749634;Taip;0;2;0;2
12871;Vėtrungė;Kodėlčių;1487142899;Taip;3;4;0;7
12872;Vėtrungė;Kodėlčių;19486911273;Taip;9;6;0;15
12873;Vėtrungė;Kodėlčių;56266349747;Taip;10;0;0;10
12874;Vėtrungė;Kodėlčių;1902101426;Taip;8;10;0;18
12875;Vėtrungė;Kodėlčių;9395706055;Taip;15;2;0;17
12876;Vėtrungė;Kodėlčių;3231167303;Taip;0;4;0;4
12877;Vėtrungė;Kodėlčių;4291687553;Taip;17;2;0;19
12878;Vėtrungė;Kodėlčių;18426639118;Taip;4;5;0;9
12879;Vėtrungė;Kodėlčių;1383686133;Taip;12;0;0;12
12880;Vėtrungė;Kodėlčių;6563805572;Taip;13;7;0;20
12881;Vėtrungė;Kodėlčių;1395153496;Taip;12;10;0;22
12882;Vėtrungė;Paukštelių;63512524250;Ne;5;4;7;16
12883;Vėtrungė;Paukštelių;5012599400;Taip;0;1;2;3
12884;Vėtrungė;Paukštelių;1769926207;Taip;5;5;1;11
12885;Vėtrungė;Paukštelių;1322617786;Taip;10;5;0;15
12886;Vėtrungė;Paukštelių;2864217098;Taip;0;5;0;5
12887;Vėtrungė;Paukštelių;7921863675;Taip;4;4;0;8
12888;Vėtrungė;Paukštelių;4091719904;Taip;12;2;0;14
12889;Vėtrungė;Paukštelių;4347810256;Taip;3;0;1;4
12890;Vėtrungė;Paukštelių;8915159672;Taip;15;1;0;16
12891;Vėtrungė;Paukštelių;2482436192;Taip;10;5;0;15
12892;Vėtrungė;Paukštelių;6732632515;Taip;22;0;0;22
12893;Vėtrungė;Paukštelių;8897558066;Taip;12;0;0;12
12894;Vėtrungė;Paukštelių;3721504364;Taip;10;5;0;15
12895;Vėtrungė;Paukštelių;4115995882;Taip;2;11;0;13
12896;Vėtrungė;Paukštelių;1357603285;Taip;0;8;0;8
12897;Vėtrungė;Paukštelių;5994465833;Taip;10;2;0;12
12898;Vėtrungė;Paukštelių;8721035192;Taip;0;19;0;19
12899;Vėtrungė;Paukštelių;6964225210;Taip;8;0;0;8
12900;Vėtrungė;Viščiukų;2809555356;Taip;22;0;0;22
12901;Vėtrungė;Viščiukų;8571622921;Taip;0;17;0;17
12902;Vėtrungė;Viščiukų;3369970611;Taip;0;5;0;5
12903;Vėtrungė;Viščiukų;3200251047;Taip;10;0;0;10
12904;Vėtrungė;Viščiukų;7749675589;Taip;10;0;0;10
12905;Vėtrungė;Viščiukų;8538678373;Taip;3;6;0;9
12906;Vėtrungė;Viščiukų;1934540281;Ne;5;10;3;18
12907;Vėtrungė;Viščiukų;7483624989;Taip;25;0;0;25
12908;Vėtrungė;Viščiukų;5670113882;Taip;7;3;0;10
12909;Vėtrungė;Viščiukų;1808699695;Taip;10;10;0;20
12910;Vėtrungė;Viščiukų;7807708310;Taip;11;8;1;20
12911;Vėtrungė;Viščiukų;8961791293;Taip;10;3;0;13
12912;Vėtrungė;Viščiukų;4916692634;Taip;0;2;0;2
12913;Vėtrungė;Viščiukų;9533901360;Taip;11;0;0;11
12914;Vėtrungė;Viščiukų;6416245099;Ne;10;2;0;12
12915;Vėtrungė;Viščiukų;8742161467;Taip;10;7;0;17
12916;Vėtrungė;Viščiukų;7558548846;Taip;7;2;0;9
12917;Vėtrungė;Viščiukų;1007578933;Taip;7;2;0;9
12918;Vėtrungė;Nykštukų;29699317546;Taip;0;9;0;9
12919;Vėtrungė;Nykštukų;1474010989;Taip;9;12;0;21
12920;Vėtrungė;Nykštukų;47141854213;Taip;10;11;0;21
12921;Vėtrungė;Nykštukų;76708504248;Taip;8;0;0;8
12922;Vėtrungė;Nykštukų;1754493671;Ne;10;6;0;16
12923;Vėtrungė;Nykštukų;1843306606;Taip;15;0;1;16
12924;Vėtrungė;Nykštukų;5198153485;Taip;9;0;0;9
12925;Vėtrungė;Nykštukų;1630866223;Taip;7;6;5;18
12926;Vėtrungė;Nykštukų;1529226569;Taip;0;6;0;6
12927;Vėtrungė;Nykštukų;1690268842;Taip;5;1;0;6
12928;Vėtrungė;Nykštukų;1279678980;Taip;6;1;0;7
12929;Vėtrungė;Nykštukų;1370336984;Taip;10;3;0;13
12930;Vėtrungė;Nykštukų;78016704795;Taip;6;6;0;12
12931;Vėtrungė;Nykštukų;68628872682;Taip;0;5;4;9
12932;Vėtrungė;Nykštukų;54494917364;Taip;4;5;0;9
12933;Vėtrungė;Nykštukų;87686013986;Taip;7;4;0;11
12934;Vėtrungė;Nykštukų;70610257897;Taip;6;5;0;11
12935;Vėtrungė;Nykštukų;2715736596;Taip;8;7;0;15
12936;Vėtrungė;Nykštukų;1744400765;Taip;10;4;0;14
12937;Vėtrungė;Nykštukų;1360031121;Taip;7;5;0;12
12938;Vėtrungė;Nykštukų;2145081325;Taip;9;7;5;21
12939;Vėtrungė;Nykštukų;2529102855;Taip;4;4;0;8
12940;Vėtrungė;Nykštukų;1611274573;Taip;10;10;0;20
12941;Vėtrungė;Nykštukų;7792694801;Ne;20;0;0;20
12942;Vėtrungė;Meškiukų;2510763357;Taip;19;0;0;19
12943;Vėtrungė;Meškiukų;4713420194;Taip;19;0;0;19
12944;Vėtrungė;Meškiukų;2226654309;Taip;10;0;0;10
12945;Vėtrungė;Meškiukų;7270370939;Taip;0;6;0;6
12946;Vėtrungė;Meškiukų;9543456295;Taip;8;0;0;8
12947;Vėtrungė;Meškiukų;9207846866;Taip;15;0;0;15
12948;Vėtrungė;Meškiukų;9065848425;Taip;7;2;0;9
12949;Vėtrungė;Meškiukų;9491661945;Taip;5;2;0;7
12950;Vėtrungė;Meškiukų;3328447991;Taip;6;0;0;6
12951;Vėtrungė;Meškiukų;9685389270;Ne;0;15;0;15
12952;Vėtrungė;Meškiukų;9313438768;Taip;15;1;0;16
12953;Vėtrungė;Meškiukų;9070732925;Taip;12;2;0;14
12954;Vėtrungė;Meškiukų;3122948974;Taip;0;2;0;2
12955;Vėtrungė;Meškiukų;2880342138;Taip;10;1;0;11
12956;Vėtrungė;Meškiukų;2520926439;Taip;10;8;0;18
12957;Vėtrungė;Meškiukų;7704497739;Taip;0;4;0;4
12958;Vėtrungė;Meškiukų;7143997258;Taip;13;5;0;18
12959;Vėtrungė;Meškiukų;5123894802;Taip;5;3;0;8
12960;Vėtrungė;Meškiukų;4394100006;Taip;20;4;0;24
12961;Vėtrungė;Ąžuoliukų;7813907852;Taip;5;0;0;5
12962;Vėtrungė;Ąžuoliukų;2471926240;Taip;0;4;0;4
12963;Vėtrungė;Ąžuoliukų;3249689008;Taip;14;5;0;19
12964;Vėtrungė;Ąžuoliukų;6599281163;Taip;18;0;5;23
12965;Vėtrungė;Ąžuoliukų;7295216791;Taip;0;1;0;1
12966;Vėtrungė;Ąžuoliukų;2440001662;Taip;14;0;0;14
12967;Vėtrungė;Ąžuoliukų;1636432189;Taip;10;2;0;12
12968;Vėtrungė;Ąžuoliukų;7803736567;Taip;10;3;0;13
12969;Vėtrungė;Ąžuoliukų;1042333710;Ne;8;11;0;19
12970;Vėtrungė;Ąžuoliukų;9795630131;Taip;5;0;0;5
12971;Vėtrungė;Ąžuoliukų;7129180154;Taip;6;0;0;6
12972;Vėtrungė;Ąžuoliukų;16216365941;Taip;0;4;0;4
12973;Vėtrungė;Ąžuoliukų;6356914122;Ne;4;6;0;10
12974;Vėtrungė;Ąžuoliukų;2636219826;Taip;7;0;0;7
12975;Vėtrungė;Ąžuoliukų;6479094819;Taip;21;0;0;21
12976;Vėtrungė;Ąžuoliukų;5367369908;Taip;10;0;0;10
12977;Vėtrungė;Ąžuoliukų;4000379945;Taip;0;10;0;10
12978;Vėtrungė;Ąžuoliukų;1789419548;Ne;5;9;0;14
12979;Vėtrungė;Ąžuoliukų;7363490503;Taip;5;1;0;6
12980;Vilnelė;Lakštutė;9657350714;Taip;5;5;0;10
12981;Vilnelė;Lakštutė;1720695615;Taip;0;20;0;20
12982;Vilnelė;Lakštutė;2121071276;Taip;4;0;0;4
12983;Vilnelė;Lakštutė;6047375980;Taip;20;0;0;20
12984;Vilnelė;Lakštutė;1065422209;Taip;2;3;0;5
12985;Vilnelė;Lakštutė;1607330769;Taip;0;13;0;13
12986;Vilnelė;Lakštutė;66992481918;Taip;1;0;0;1
12987;Vilnelė;Lakštutė;3316451889;Taip;0;9;0;9
12988;Vilnelė;Lakštutė;8820091584;Taip;10;0;0;10
12989;Vilnelė;Lakštutė;8270866998;Taip;0;20;0;20
12990;Vilnelė;Lakštutė;2990112955;Taip;0;7;0;7
12991;Vilnelė;Lakštutė;3454141069;Taip;15;0;0;15
12992;Vilnelė;Lakštutė;9618342480;Taip;5;2;0;7
12993;Vilnelė;Lakštutė;9369955153;Taip;0;9;0;9
12994;Vilnelė;Lakštutė;2311184444;Taip;16;0;0;16
12995;Vilnelė;Lakštutė;6155522893;Taip;7;0;0;7
12996;Vilnelė;Lakštutė;6898685834;Taip;8;0;0;8
12997;Vilnelė;Lakštutė;6318246517;Taip;15;1;0;16
12998;Vilnelė;Lakštutė;7387394504;Taip;4;11;0;15
12999;Vilnelė;Vyturėlis;9643543101;Taip;15;0;0;15
13000;Vilnelė;Vyturėlis;6707161045;Taip;0;0;2;2
13001;Vilnelė;Vyturėlis;5091272908;Taip;8;3;0;11
13002;Vilnelė;Vyturėlis;2696565855;Taip;13;1;0;14
13003;Vilnelė;Vyturėlis;3009064105;Taip;0;1;0;1
13004;Vilnelė;Vyturėlis;1674551092;Taip;0;7;0;7
13005;Vilnelė;Vyturėlis;3743740372;Taip;7;0;0;7
13006;Vilnelė;Vyturėlis;2131599015;Taip;10;5;0;15
13007;Vilnelė;Vyturėlis;9460789751;Taip;10;2;0;12
13008;Vilnelė;Vyturėlis;6954102486;Taip;20;0;0;20
13009;Vilnelė;Vyturėlis;7057183482;Taip;5;8;0;13
13010;Vilnelė;Vyturėlis;8725191514;Taip;8;3;0;11
13011;Vilnelė;Vyturėlis;6308015852;Taip;15;5;0;20
13012;Vilnelė;Vyturėlis;7963783957;Taip;17;0;0;17
13013;Vilnelė;Vyturėlis;1545570307;Taip;10;5;0;15
13014;Vilnelė;Vyturėlis;5540359276;Taip;0;7;0;7
13015;Vilnelė;Vyturėlis;1966090625;Taip;7;5;0;12
13016;Vilnelė;Vyturėlis;8740717061;Taip;0;7;0;7
13017;Vilnelė;Pagrandukas;47862530763;Taip;0;5;2;7
13018;Vilnelė;Pagrandukas;86632916976;Taip;0;14;0;14
13019;Vilnelė;Pagrandukas;22292043530;Taip;1;0;0;1
13020;Vilnelė;Pagrandukas;56581871326;Taip;0;6;0;6
13021;Vilnelė;Pagrandukas;99862516414;Taip;5;5;0;10
13022;Vilnelė;Pagrandukas;71697587760;Ne;0;10;0;10
13023;Vilnelė;Pagrandukas;15544719839;Taip;1;2;0;3
13024;Vilnelė;Pagrandukas;66846020652;Taip;0;5;1;6
13025;Vilnelė;Pagrandukas;6165517230;Taip;0;1;0;1
13026;Vilnelė;Pagrandukas;49625837016;Taip;0;5;4;9
13027;Vilnelė;Pagrandukas;97156084547;Taip;0;5;0;5
13028;Vilnelė;Pagrandukas;2783445497;Taip;6;0;0;6
13029;Vilnelė;Pagrandukas;5818753821;Taip;0;9;0;9
13030;Vilnelė;Pagrandukas;97511728967;Taip;10;1;0;11
13031;Vilnelė;Pagrandukas;37597237480;Taip;0;8;0;8
13032;Vilnelė;Pagrandukas;58925096937;Taip;0;7;0;7
13033;Vilnelė;Pagrandukas;71382526127;Taip;0;4;0;4
13034;Vilnelė;Pagrandukas;36889106081;Taip;0;1;0;1
13035;Vilnelė;Pagrandukas;22563964459;Taip;0;2;0;2
13036;Vilnelė;Bitutė;57355144827;Taip;3;5;0;8
13037;Vilnelė;Bitutė;31456400596;Ne;0;5;0;5
13038;Vilnelė;Bitutė;98916301986;Ne;0;7;0;7
13039;Vilnelė;Bitutė;5689110144;Taip;0;5;0;5
13040;Vilnelė;Bitutė;14782861836;Taip;0;4;0;4
13041;Vilnelė;Bitutė;81251620413;Taip;3;5;0;8
13042;Vilnelė;Bitutė;1401796093;Ne;5;5;0;10
13043;Vilnelė;Bitutė;5431869792;Ne;8;5;0;13
13044;Vilnelė;Bitutė;19340293938;Taip;10;8;0;18
13045;Vilnelė;Bitutė;57150212991;Ne;0;5;0;5
13046;Vilnelė;Bitutė;79392670872;Taip;5;5;0;10
13047;Vilnelė;Bitutė;57958541549;Taip;0;1;0;1
13048;Vilnelė;Bitutė;66330140933;Taip;0;1;0;1
13049;Vilnelė;Bitutė;63559597074;Taip;0;0;7;7
13050;Vilnelė;Bitutė;65986476721;Taip;10;5;0;15
13051;Vilnelė;Bitutė;69506303971;Ne;7;5;0;12
13052;Vilnelė;Bitutė;70908264075;Taip;8;6;0;14
13053;Vilnelė;Bitutė;28905654375;Taip;0;7;0;7
13054;Vilnelė;Šaltinėlis;1783854203;Taip;0;4;0;4
13055;Vilnelė;Šaltinėlis;5013418313;Taip;0;6;0;6
13056;Vilnelė;Šaltinėlis;42835212158;Taip;19;0;0;19
13057;Vilnelė;Šaltinėlis;1255849405;Taip;8;9;0;17
13058;Vilnelė;Šaltinėlis;11430703629;Taip;0;5;0;5
13059;Vilnelė;Šaltinėlis;7292043157;Taip;0;2;0;2
13060;Vilnelė;Šaltinėlis;6327531229;Taip;5;0;2;7
13061;Vilnelė;Šaltinėlis;10345875729;Taip;0;0;2;2
13062;Vilnelė;Šaltinėlis;1572818047;Taip;0;6;0;6
13063;Vilnelė;Šaltinėlis;2130482375;Taip;0;1;0;1
13064;Vilnelė;Šaltinėlis;4480175299;Taip;0;11;0;11
13065;Vilnelė;Šaltinėlis;9058632601;Taip;0;1;0;1
13066;Vilnelė;Šaltinėlis;1507865281;Taip;0;4;3;7
13067;Vilnelė;Šaltinėlis;39494954188;Taip;0;11;0;11
13068;Vilnelė;Šaltinėlis;8615257084;Taip;6;0;0;6
13069;Vilnelė;Šaltinėlis;6146514112;Taip;6;1;0;7
13070;Vilnelė;Šaltinėlis;9016832316;Taip;10;1;0;11
13071;Vilnelė;Šaltinėlis;1281521052;Taip;19;1;0;20
13072;Vilnelė;Riešutėllis;55974182996;Taip;0;1;0;1
13073;Vilnelė;Riešutėllis;67561845041;Taip;5;2;0;7
13074;Vilnelė;Riešutėllis;85568332595;Taip;0;5;0;5
13075;Vilnelė;Riešutėllis;22516605873;Taip;0;16;0;16
13076;Vilnelė;Riešutėllis;64066480740;Taip;5;4;0;9
13077;Vilnelė;Riešutėllis;16272480270;Taip;0;6;0;6
13078;Vilnelė;Riešutėllis;1859757115;Taip;0;9;0;9
13079;Vilnelė;Riešutėllis;1450994872;Taip;0;0;15;15
13080;Vilnelė;Riešutėllis;9331404812;Taip;0;7;0;7
13081;Vilnelė;Riešutėllis;11702051319;Taip;0;1;0;1
13082;Vilnelė;Riešutėllis;41536662155;Taip;6;0;0;6
13083;Vilnelė;Riešutėllis;69413564937;Taip;3;1;0;4
13084;Vilnelė;Riešutėllis;71906228270;Taip;0;2;0;2
13085;Vilnelė;Riešutėllis;7916632244;Taip;8;0;0;8
13086;Vilnelė;Riešutėllis;20639648308;Taip;0;6;0;6
13087;Vilnelė;Riešutėllis;73658263243;Taip;0;8;0;8
13088;Vilnelė;Riešutėllis;8889469645;Taip;5;6;0;11
13089;Vilnelė;Riešutėllis;1522056886;Taip;6;0;1;7
13090;Vilnelė;Riešutėllis;77461494667;Taip;0;7;0;7
13091;Vilnelė;Riešutėllis;1321202650;Taip;3;5;0;8
13092;Vilnelė;Nykštukas;53049214510;Taip;0;4;0;4
13093;Vilnelė;Nykštukas;1336497125;Taip;0;1;0;1
13094;Vilnelė;Nykštukas;34859308729;Taip;4;0;0;4
13095;Vilnelė;Nykštukas;32988468324;Taip;0;11;0;11
13096;Vilnelė;Nykštukas;89748262997;Taip;2;7;0;9
13097;Vilnelė;Nykštukas;87406093438;Taip;2;7;0;9
13098;Vilnelė;Nykštukas;13583637193;Taip;0;8;0;8
13099;Vilnelė;Nykštukas;23442711820;Taip;5;1;0;6
13100;Vilnelė;Nykštukas;47863474499;Taip;5;5;0;10
13101;Vilnelė;Nykštukas;13231410969;Taip;10;0;0;10
13102;Vilnelė;Nykštukas;62208863766;Taip;5;3;0;8
13103;Vilnelė;Nykštukas;36905818484;Taip;5;3;0;8
13104;Vilnelė;Nykštukas;1845336128;Taip;0;6;0;6
13105;Vilnelė;Nykštukas;87094375121;Taip;0;12;0;12
13106;Vilnelė;Nykštukas;42526993637;Taip;3;0;0;3
13107;Vilnelė;Nykštukas;58422521907;Taip;0;3;0;3
13108;Vilnelė;Nykštukas;15265621906;Taip;0;10;0;10
13109;Vilnelė;Nykštukas;5198859945;Taip;0;11;0;11
13110;Vilnelė;Nykštukas;2131603460;Taip;3;1;0;4
13111;Vilnelė;Nykštukas;59579013512;Taip;0;17;0;17
13112;Vilnelė;Pieštukas;1061139491;Taip;5;0;0;5
13113;Vilnelė;Pieštukas;79700582010;Taip;0;8;0;8
13114;Vilnelė;Pieštukas;60707257606;Taip;0;12;0;12
13115;Vilnelė;Pieštukas;1957418704;Taip;0;5;0;5
13116;Vilnelė;Pieštukas;96611892032;Taip;0;4;0;4
13117;Vilnelė;Pieštukas;2864763106;Taip;3;2;0;5
13118;Vilnelė;Pieštukas;10333554439;Taip;0;16;0;16
13119;Vilnelė;Pieštukas;624138880;Taip;0;5;0;5
13120;Vilnelė;Pieštukas;31701260922;Taip;0;5;0;5
13121;Vilnelė;Pieštukas;87237045379;Taip;7;2;0;9
13122;Vilnelė;Pieštukas;985960052;Taip;0;6;0;6
13123;Vilnelė;Pieštukas;90173852512;Taip;0;11;0;11
13124;Vilnelė;Pieštukas;95736417954;Taip;0;5;0;5
13125;Vilnelė;Pieštukas;53990457379;Taip;5;0;0;5
13126;Vilnelė;Pieštukas;78753442031;Taip;15;1;0;16
13127;Vilnelė;Pieštukas;1051858780;Taip;7;0;3;10
13128;Vilnelė;Pieštukas;98404616387;Taip;2;8;0;10
13129;Vilnelė;Pieštukas;2138907190;Taip;0;12;0;12
13130;Vilnelė;Pieštukas;5936699300;Taip;5;6;0;11
13131;Vilnelė;Pieštukas;77572611171;Taip;5;0;0;5
13132;Vilnelė;Voverytė;1702224809;Taip;5;0;3;8
13133;Vilnelė;Voverytė;2812680090;Taip;5;0;0;5
13134;Vilnelė;Voverytė;1594154669;Taip;5;0;1;6
13135;Vilnelė;Voverytė;32662933313;Taip;6;0;1;7
13136;Vilnelė;Voverytė;1410511913;Taip;0;0;4;4
13137;Vilnelė;Voverytė;48926369907;Taip;12;0;0;12
13138;Vilnelė;Voverytė;13646307629;Taip;5;7;0;12
13139;Vilnelė;Voverytė;1680411448;Taip;5;1;0;6
13140;Vilnelė;Voverytė;1294194561;Taip;0;1;0;1
13141;Vilnelė;Voverytė;1111397062;Taip;0;5;0;5
13142;Vilnelė;Voverytė;1230072125;Taip;0;0;2;2
13143;Vilnelė;Voverytė;1733279710;Taip;0;20;0;20
13144;Vilnelė;Voverytė;91933747502;Taip;0;9;0;9
13145;Vilnelė;Voverytė;1346145809;Taip;0;0;1;1
13146;Vilnelė;Voverytė;1498777674;Taip;8;0;3;11
13147;Vilnelė;Voverytė;1932829642;Taip;2;0;1;3
13148;Vilnelė;Voverytė;5480363267;Taip;0;3;0;3
13149;Vilnelė;Voverytė;1422040758;Taip;6;6;0;12
13150;Vilnelė;Kodėlčiukas;85452254846;Taip;0;3;0;3
13151;Vilnelė;Kodėlčiukas;6289991945;Taip;0;5;0;5
13152;Vilnelė;Kodėlčiukas;1448257490;Taip;0;3;0;3
13153;Vilnelė;Kodėlčiukas;69532393507;Taip;0;7;0;7
13154;Vilnelė;Kodėlčiukas;1160794222;Taip;0;7;0;7
13155;Vilnelė;Kodėlčiukas;64950604083;Taip;0;11;0;11
13156;Vilnelė;Kodėlčiukas;99580393765;Taip;1;1;0;2
13157;Vilnelė;Kodėlčiukas;36561742487;Taip;0;8;0;8
13158;Vilnelė;Kodėlčiukas;96900970284;Taip;15;0;0;15
13159;Vilnelė;Kodėlčiukas;85391221236;Taip;0;10;0;10
13160;Vilnelė;Kodėlčiukas;39412868538;Taip;0;2;0;2
13161;Vilnelė;Kodėlčiukas;67110179640;Ne;0;6;0;6
13162;Vilnelė;Kodėlčiukas;35546482171;Taip;0;1;0;1
13163;Vilnelė;Kodėlčiukas;90980722090;Taip;5;5;0;10
13164;Vilnelė;Kodėlčiukas;33652235251;Taip;0;6;0;6
13165;Vilnelė;Kodėlčiukas;91413844614;Taip;3;0;0;3
13166;Vilnelė;Kodėlčiukas;24746064267;Taip;0;5;0;5
13167;Vilnelė;Kodėlčiukas;18238619578;Taip;10;7;0;17
13168;Vilnelė;Žirniukas;3945921490;Taip;5;14;0;19
13169;Vilnelė;Žirniukas;6798728562;Taip;12;1;0;13
13170;Vilnelė;Žirniukas;3781595939;Taip;0;11;0;11
13171;Vilnelė;Žirniukas;1580287517;Taip;5;4;0;9
13172;Vilnelė;Žirniukas;9879688569;Taip;0;9;0;9
13173;Vilnelė;Žirniukas;5473379559;Taip;0;14;0;14
13174;Vilnelė;Žirniukas;1462397783;Taip;15;1;0;16
13175;Vilnelė;Žirniukas;1792586468;Taip;0;6;0;6
13176;Vilnelė;Žirniukas;8086759121;Taip;7;3;0;10
13177;Vilnelė;Žirniukas;1975954784;Taip;7;2;0;9
13178;Vilnelė;Žirniukas;7199490431;Taip;0;1;0;1
13179;Vilnelė;Žirniukas;4328263940;Taip;20;0;0;20
13180;Vilnelė;Žirniukas;9884955712;Taip;5;9;0;14
13181;Vilnelė;Pipiras;7536603663;Taip;15;1;0;16
13182;Vilnelė;Pipiras;3503461211;Taip;20;0;0;20
13183;Vilnelė;Pipiras;3993826389;Taip;8;0;0;8
13184;Vilnelė;Pipiras;7388336851;Taip;13;0;0;13
13185;Vilnelė;Pipiras;8667403338;Taip;6;1;0;7
13186;Vilnelė;Pipiras;7883724600;Taip;6;1;0;7
13187;Vilnelė;Pipiras;4166351390;Taip;0;5;0;5
13188;Vilnelė;Pipiras;1351798589;Taip;0;2;0;2
13189;Vilnelė;Pipiras;9162681538;Taip;0;3;0;3
13190;Vilnelė;Pipiras;3075681823;Taip;0;2;0;2
13191;Vilnelė;Pipiras;6342242777;Taip;5;0;0;5
13192;Vilnelė;Pipiras;3843064564;Taip;0;4;1;5
13193;Vilnelė;Pipiras;7085972543;Taip;20;0;0;20
13194;Vilnelė;Pipiras;7642022439;Taip;13;1;0;14
13195;Vilnelė;Pipiras;4838684336;Taip;7;1;0;8
13196;Vėrinėlis;GAIDELIAI;2774618380;Taip;15;0;0;15
13197;Vėrinėlis;GAIDELIAI;5429955166;Taip;10;1;0;11
13198;Vėrinėlis;GAIDELIAI;5209398043;Taip;10;5;0;15
13199;Vėrinėlis;GAIDELIAI;1060619471;Taip;14;0;0;14
13200;Vėrinėlis;GAIDELIAI;8885866108;Taip;0;20;0;20
13201;Vėrinėlis;GAIDELIAI;8213498951;Taip;10;0;0;10
13202;Vėrinėlis;GAIDELIAI;6136232912;Taip;16;0;0;16
13203;Vėrinėlis;GAIDELIAI;6058712578;Taip;5;0;2;7
13204;Vėrinėlis;GAIDELIAI;6496291933;Taip;5;0;0;5
13205;Vėrinėlis;GAIDELIAI;1164396960;Taip;11;0;4;15
13206;Vėrinėlis;GAIDELIAI;8091400240;Taip;0;6;0;6
13207;Vėrinėlis;GAIDELIAI;8728166391;Taip;11;0;0;11
13208;Vėrinėlis;GAIDELIAI;4415030161;Taip;6;10;0;16
13209;Vėrinėlis;GAIDELIAI;8100283579;Taip;8;0;0;8
13210;Vėrinėlis;SAULUTĖ;71830611159;Taip;7;0;0;7
13211;Vėrinėlis;SAULUTĖ;6148700823;Taip;0;20;0;20
13212;Vėrinėlis;SAULUTĖ;1086306523;Ne;9;0;0;9
13213;Vėrinėlis;SAULUTĖ;11343969028;Taip;10;1;0;11
13214;Vėrinėlis;SAULUTĖ;6004379115;Taip;0;9;0;9
13215;Vėrinėlis;SAULUTĖ;39153716711;Taip;14;2;0;16
13216;Vėrinėlis;SAULUTĖ;9751494612;Taip;0;1;0;1
13217;Vėrinėlis;SAULUTĖ;1897451825;Taip;4;0;0;4
13218;Vėrinėlis;SAULUTĖ;4727265555;Taip;0;13;0;13
13219;Vėrinėlis;SAULUTĖ;1047139776;Taip;0;8;0;8
13220;Vėrinėlis;SAULUTĖ;1493604303;Taip;5;4;0;9
13221;Vėrinėlis;SAULUTĖ;5561043797;Taip;5;0;0;5
13222;Vėrinėlis;SAULUTĖ;9500715949;Taip;0;10;0;10
13223;Vėrinėlis;SAULUTĖ;1803838403;Taip;0;5;0;5
13224;Vėrinėlis;SAULUTĖ;8922728881;Taip;9;2;0;11
13225;Vėrinėlis;SAULUTĖ;9391697537;Taip;10;6;0;16
13226;Vėrinėlis;SAULUTĖ;7071043164;Taip;0;12;0;12
13227;Vėrinėlis;NYKŠTUKAI;7168682238;Taip;0;2;0;2
13228;Vėrinėlis;NYKŠTUKAI;668239862;Taip;0;5;0;5
13229;Vėrinėlis;NYKŠTUKAI;8197177876;Taip;15;5;0;20
13230;Vėrinėlis;NYKŠTUKAI;1518907235;Taip;0;5;0;5
13231;Vėrinėlis;NYKŠTUKAI;6065348004;Taip;0;1;2;3
13232;Vėrinėlis;NYKŠTUKAI;3563944204;Taip;8;0;0;8
13233;Vėrinėlis;NYKŠTUKAI;7436873997;Taip;0;10;0;10
13234;Vėrinėlis;NYKŠTUKAI;63333257753;Taip;6;5;0;11
13235;Vėrinėlis;NYKŠTUKAI;1592544116;Taip;0;0;1;1
13236;Vėrinėlis;NYKŠTUKAI;1261337457;Taip;5;5;3;13
13237;Vėrinėlis;NYKŠTUKAI;1804757495;Taip;0;5;0;5
13238;Vėrinėlis;NYKŠTUKAI;11459693163;Taip;0;0;1;1
13239;Vėrinėlis;NYKŠTUKAI;1295435839;Taip;0;6;0;6
13240;Vėrinėlis;NYKŠTUKAI;1791124205;Taip;0;1;0;1
13241;Vėrinėlis;NYKŠTUKAI;92480758419;Taip;0;2;4;6
13242;Vėrinėlis;NYKŠTUKAI;38428514086;Taip;3;5;0;8
13243;Vėrinėlis;NYKŠTUKAI;27431479888;Taip;12;0;0;12
13244;Vėrinėlis;NYKŠTUKAI;41029899086;Taip;0;0;3;3
13245;Vėrinėlis;NYKŠTUKAI;1251822610;Taip;16;0;0;16
13246;Vėrinėlis;NYKŠTUKAI;22535431362;Taip;0;0;3;3
13247;Vėrinėlis;BURATINAS;1001125426;Taip;0;16;0;16
13248;Vėrinėlis;BURATINAS;99734698213;Taip;0;5;2;7
13249;Vėrinėlis;BURATINAS;58909000723;Taip;0;17;0;17
13250;Vėrinėlis;BURATINAS;42875958735;Taip;0;5;0;5
13251;Vėrinėlis;BURATINAS;4541318324;Taip;0;10;0;10
13252;Vėrinėlis;BURATINAS;78121632796;Taip;0;0;3;3
13253;Vėrinėlis;BURATINAS;25734061057;Taip;0;3;0;3
13254;Vėrinėlis;BURATINAS;68027880109;Taip;0;0;1;1
13255;Vėrinėlis;BURATINAS;1876456237;Taip;0;2;0;2
13256;Vėrinėlis;BURATINAS;12363691267;Taip;0;5;0;5
13257;Vėrinėlis;BURATINAS;99325931907;Taip;0;3;0;3
13258;Vėrinėlis;BURATINAS;40706531692;Taip;0;5;1;6
13259;Vėrinėlis;BURATINAS;3044373634;Taip;0;0;3;3
13260;Vėrinėlis;BURATINAS;24888549934;Taip;10;4;0;14
13261;Vėrinėlis;BURATINAS;38831165210;Taip;0;9;0;9
13262;Vėrinėlis;BURATINAS;37600982027;Ne;0;1;0;1
13263;Vėrinėlis;BURATINAS;8978798314;Taip;3;0;3;6
13264;Vėrinėlis;BURATINAS;1953362884;Taip;5;0;2;7
13265;Vėrinėlis;BURATINAS;79317384797;Taip;0;5;0;5
13266;Vėrinėlis;BURATINAS;31300715730;Taip;0;2;18;20
13267;Vėrinėlis;GINTARĖLIAI;79005449877;Taip;0;5;0;5
13268;Vėrinėlis;GINTARĖLIAI;98927850113;Taip;10;5;0;15
13269;Vėrinėlis;GINTARĖLIAI;85276333294;Taip;5;0;0;5
13270;Vėrinėlis;GINTARĖLIAI;18285098778;Ne;0;3;0;3
13271;Vėrinėlis;GINTARĖLIAI;94043814995;Taip;3;5;2;10
13272;Vėrinėlis;GINTARĖLIAI;81355372884;Taip;0;5;1;6
13273;Vėrinėlis;GINTARĖLIAI;2241971642;Taip;0;5;0;5
13274;Vėrinėlis;GINTARĖLIAI;1200426264;Taip;5;5;0;10
13275;Vėrinėlis;GINTARĖLIAI;9935381405;Taip;0;5;0;5
13276;Vėrinėlis;GINTARĖLIAI;78383742417;Taip;0;1;1;2
13277;Vėrinėlis;GINTARĖLIAI;1039691410;Taip;0;5;0;5
13278;Vėrinėlis;GINTARĖLIAI;63260347010;Taip;0;2;1;3
13279;Vėrinėlis;GINTARĖLIAI;53823221730;Taip;2;5;0;7
13280;Vėrinėlis;GINTARĖLIAI;85102847167;Taip;0;5;2;7
13281;Vėrinėlis;GINTARĖLIAI;64791543104;Taip;1;0;0;1
13282;Vėrinėlis;GINTARĖLIAI;63357719105;Taip;0;1;0;1
13283;Vėrinėlis;GINTARĖLIAI;96157891711;Taip;0;7;0;7
13284;Vėrinėlis;GINTARĖLIAI;76043900105;Taip;0;3;0;3
13285;Vėrinėlis;GINTARĖLIAI;38154356317;Taip;0;0;4;4
13286;Vėrinėlis;GINTARĖLIAI;19538705090;Taip;2;6;0;8
13287;Vėrinėlis;GINTARĖLIAI;3183131197;Taip;0;3;0;3
13288;Vėrinėlis;GINTARĖLIAI;2023475725;Taip;6;5;0;11
13289;Vėrinėlis;GINTARĖLIAI;1028694005;Taip;0;5;2;7
13290;Vėrinėlis;RAMUNĖLĖS;65742227705;Taip;0;1;0;1
13291;Vėrinėlis;RAMUNĖLĖS;36051993269;Taip;0;5;0;5
13292;Vėrinėlis;RAMUNĖLĖS;71959077340;Taip;1;5;0;6
13293;Vėrinėlis;RAMUNĖLĖS;36922560017;Taip;0;5;0;5
13294;Vėrinėlis;RAMUNĖLĖS;22573601173;Taip;0;7;0;7
13295;Vėrinėlis;RAMUNĖLĖS;1540708366;Taip;0;13;0;13
13296;Vėrinėlis;RAMUNĖLĖS;7178943357;Taip;0;4;0;4
13297;Vėrinėlis;RAMUNĖLĖS;1292880457;Taip;12;0;0;12
13298;Vėrinėlis;RAMUNĖLĖS;36138794708;Taip;0;5;1;6
13299;Vėrinėlis;RAMUNĖLĖS;91754828102;Taip;0;9;0;9
13300;Vėrinėlis;RAMUNĖLĖS;41342430019;Taip;0;5;0;5
13301;Vėrinėlis;RAMUNĖLĖS;56656769188;Taip;0;5;1;6
13302;Vėrinėlis;RAMUNĖLĖS;1792855817;Taip;6;1;0;7
13303;Vėrinėlis;RAMUNĖLĖS;1979643933;Taip;6;1;0;7
13304;Vėrinėlis;RAMUNĖLĖS;1398564881;Taip;5;2;0;7
13305;Vėrinėlis;RAMUNĖLĖS;1133491927;Taip;0;6;0;6
13306;Vėrinėlis;RAMUNĖLĖS;1268710930;Taip;0;9;0;9
13307;Vėrinėlis;RAMUNĖLĖS;1477336890;Taip;5;3;0;8
13308;Vėrinėlis;RAMUNĖLĖS;25415760747;Taip;0;5;1;6
13309;Vėrinėlis;KODELČIUKŲ;67846281580;Taip;5;5;0;10
13310;Vėrinėlis;KODELČIUKŲ;88831634291;Taip;1;10;0;11
13311;Vėrinėlis;KODELČIUKŲ;6798167004;Taip;5;5;0;10
13312;Vėrinėlis;KODELČIUKŲ;7561194911;Taip;0;7;0;7
13313;Vėrinėlis;KODELČIUKŲ;67977504520;Taip;0;11;0;11
13314;Vėrinėlis;KODELČIUKŲ;8080337820;Taip;3;5;0;8
13315;Vėrinėlis;KODELČIUKŲ;51807139150;Taip;0;14;0;14
13316;Vėrinėlis;KODELČIUKŲ;9955087519;Ne;0;5;2;7
13317;Vėrinėlis;KODELČIUKŲ;1129067900;Taip;15;2;0;17
13318;Vėrinėlis;KODELČIUKŲ;43944804765;Taip;5;10;0;15
13319;Vėrinėlis;KODELČIUKŲ;62639454640;Taip;0;5;0;5
13320;Vėrinėlis;KODELČIUKŲ;17400501595;Taip;0;7;0;7
13321;Vėrinėlis;KODELČIUKŲ;20342193231;Taip;8;0;1;9
13322;Vėrinėlis;KODELČIUKŲ;47633572816;Taip;0;5;1;6
13323;Vėrinėlis;KODELČIUKŲ;6088489477;Taip;0;4;0;4
13324;Vėrinėlis;KODELČIUKŲ;38040256220;Taip;0;13;0;13
13325;Vėrinėlis;KODELČIUKŲ;1481003777;Taip;5;0;0;5
13326;Vėrinėlis;KODELČIUKŲ;9930767796;Taip;0;14;0;14
13327;Vėrinėlis;KODELČIUKŲ;74375362661;Taip;0;9;0;9
13328;Vėrinėlis;KODELČIUKŲ;1680155836;Taip;6;0;0;6
13329;Vėrinėlis;ŽIRNIUKAI;3074835599;Taip;12;0;0;12
13330;Vėrinėlis;ŽIRNIUKAI;4981127515;Taip;10;0;0;10
13331;Vėrinėlis;ŽIRNIUKAI;7845985650;Taip;15;0;0;15
13332;Vėrinėlis;ŽIRNIUKAI;2815770695;Taip;0;1;3;4
13333;Vėrinėlis;ŽIRNIUKAI;9604483237;Taip;4;0;2;6
13334;Vėrinėlis;ŽIRNIUKAI;9419245081;Taip;0;1;3;4
13335;Vėrinėlis;ŽIRNIUKAI;3202518504;Taip;5;0;2;7
13336;Vėrinėlis;ŽIRNIUKAI;8824435889;Taip;5;0;4;9
13337;Vėrinėlis;ŽIRNIUKAI;4752902173;Taip;0;5;0;5
13338;Vėrinėlis;ŽIRNIUKAI;7237945125;Taip;14;1;2;17
13339;Vėrinėlis;ŽIRNIUKAI;5600815908;Taip;14;0;1;15
13340;Vėrinėlis;ŽIRNIUKAI;6779005350;Taip;1;0;1;2
13341;Vėrinėlis;ŽIRNIUKAI;7367485961;Taip;0;0;2;2
13342;Vėrinėlis;ŽIRNIUKAI;9340167973;Taip;15;0;0;15
13343;Vėrinėlis;ŽIRNIUKAI;1736733257;Taip;15;0;0;15
13344;Vėrinėlis;VARPELIAI;3316897176;Taip;5;0;3;8
13345;Vėrinėlis;VARPELIAI;3882915774;Taip;0;9;0;9
13346;Vėrinėlis;VARPELIAI;7233139048;Taip;5;1;0;6
13347;Vėrinėlis;VARPELIAI;3130841241;Taip;10;0;0;10
13348;Vėrinėlis;VARPELIAI;6435612222;Taip;8;0;2;10
13349;Vėrinėlis;VARPELIAI;2337883071;Taip;7;0;4;11
13350;Vėrinėlis;VARPELIAI;6913001318;Taip;8;6;0;14
13351;Vėrinėlis;VARPELIAI;4728119881;Taip;0;2;0;2
13352;Vėrinėlis;VARPELIAI;7224418233;Taip;15;0;5;20
13353;Vėrinėlis;VARPELIAI;3239370561;Taip;11;1;2;14
13354;Vėrinėlis;VARPELIAI;1894717954;Taip;0;2;9;11
13355;Vėrinėlis;VARPELIAI;3667953591;Taip;5;0;0;5
13356;Vėrinėlis;VARPELIAI;8318388772;Taip;8;0;1;9
13357;Vėrinėlis;VARPELIAI;4191386053;Taip;0;2;2;4
13358;Vėrinėlis;VARPELIAI;2633143128;Taip;10;0;1;11
13359;Vėrinėlis;BORUŽĖLĖS;54666417396;Taip;0;7;0;7
13360;Vėrinėlis;BORUŽĖLĖS;57498275265;Taip;5;11;0;16
13361;Vėrinėlis;BORUŽĖLĖS;3703886468;Taip;0;5;0;5
13362;Vėrinėlis;BORUŽĖLĖS;1170817811;Taip;12;1;1;14
13363;Vėrinėlis;BORUŽĖLĖS;1410929889;Taip;0;3;0;3
13364;Vėrinėlis;BORUŽĖLĖS;65408541019;Taip;8;5;0;13
13365;Vėrinėlis;BORUŽĖLĖS;22726982138;Taip;0;0;1;1
13366;Vėrinėlis;BORUŽĖLĖS;39884473503;Taip;2;0;0;2
13367;Vėrinėlis;BORUŽĖLĖS;25071096491;Taip;0;8;0;8
13368;Vėrinėlis;BORUŽĖLĖS;67282950717;Taip;2;2;7;11
13369;Vėrinėlis;BORUŽĖLĖS;7431541945;Taip;0;5;0;5
13370;Vėrinėlis;BORUŽĖLĖS;90264493281;Taip;0;9;0;9
13371;Vėrinėlis;BORUŽĖLĖS;89785057363;Taip;0;19;0;19
13372;Vėrinėlis;BORUŽĖLĖS;1028568095;Taip;0;10;0;10
13373;Vėrinėlis;BORUŽĖLĖS;4789626884;Taip;8;0;4;12
13374;Vėrinėlis;BORUŽĖLĖS;90979069296;Taip;5;0;0;5
13375;Vėrinėlis;BORUŽĖLĖS;67987598880;Taip;0;18;0;18
13376;Vėrinėlis;BORUŽĖLĖS;73256255966;Taip;8;0;0;8
13377;Vėrinėlis;SVEIKUOLIAI;8964088661;Taip;0;0;20;20
13378;Vėrinėlis;SVEIKUOLIAI;19865450007;Taip;3;6;3;12
13379;Vėrinėlis;SVEIKUOLIAI;6869951613;Taip;5;5;0;10
13380;Vėrinėlis;SVEIKUOLIAI;1395590011;Taip;12;1;1;14
13381;Vėrinėlis;SVEIKUOLIAI;3975934329;Taip;0;1;0;1
13382;Vėrinėlis;SVEIKUOLIAI;9751037428;Taip;0;5;0;5
13383;Vėrinėlis;SVEIKUOLIAI;1513856520;Taip;11;0;0;11
13384;Vėrinėlis;SVEIKUOLIAI;3562371502;Taip;12;0;0;12
13385;Vėrinėlis;SVEIKUOLIAI;4089567420;Taip;8;0;0;8
13386;Vėrinėlis;SVEIKUOLIAI;5960946826;Taip;0;9;0;9
13387;Vėrinėlis;SVEIKUOLIAI;5496928903;Taip;20;0;0;20
13388;Vėrinėlis;SVEIKUOLIAI;7865276052;Taip;0;0;2;2
13389;Vėrinėlis;SVEIKUOLIAI;7981261038;Taip;2;2;0;4
13390;Vėrinėlis;SVEIKUOLIAI;6278738058;Taip;5;0;0;5
13391;Vėrinėlis;SVEIKUOLIAI;5511584499;Taip;5;0;0;5
13392;Vėrinėlis;SVEIKUOLIAI;6644892686;Taip;4;0;0;4
13393;Vėrinėlis;SVEIKUOLIAI;1338287524;Taip;6;5;0;11
13394;Vėrinėlis;ŠIRDELĖS;8579819581;Taip;0;8;0;8
13395;Vėrinėlis;ŠIRDELĖS;2944010445;Taip;0;2;6;8
13396;Vėrinėlis;ŠIRDELĖS;8195455092;Taip;0;1;0;1
13397;Vėrinėlis;ŠIRDELĖS;96779456411;Taip;5;0;0;5
13398;Vėrinėlis;ŠIRDELĖS;7167034587;Taip;0;6;0;6
13399;Vėrinėlis;ŠIRDELĖS;5712568063;Taip;5;2;3;10
13400;Vėrinėlis;ŠIRDELĖS;3049346950;Taip;10;0;3;13
13401;Vėrinėlis;ŠIRDELĖS;7070058961;Taip;0;1;0;1
13402;Vėrinėlis;ŠIRDELĖS;7130691686;Taip;4;0;2;6
13403;Vėrinėlis;ŠIRDELĖS;3308843618;Taip;0;7;0;7
13404;Vėrinėlis;ŠIRDELĖS;85262495209;Taip;0;12;0;12
13405;Vėrinėlis;ŠIRDELĖS;4039903678;Taip;0;2;0;2
13406;Vėrinėlis;ŠIRDELĖS;9119967823;Taip;0;5;0;5
13407;Vėrinėlis;ŠIRDELĖS;1467899937;Taip;0;1;1;2
13408;Vėrinėlis;ŠIRDELĖS;7634939364;Taip;6;0;0;6
13409;Vėrinėlis;ŠIRDELĖS;54361215161;Taip;0;2;0;2
13410;Vėrinėlis;ŠIRDELĖS;1135386852;Taip;2;0;3;5
13411;Vėrinėlis;ŠIRDELĖS;1535567719;Taip;5;3;0;8
13412;Viltenė;Drugeliai;7961006993;Taip;0;2;0;2
13413;Viltenė;Drugeliai;79464006792;Taip;0;7;0;7
13414;Viltenė;Drugeliai;70813966825;Taip;11;3;0;14
13415;Viltenė;Drugeliai;1936464823;Taip;2;7;0;9
13416;Viltenė;Drugeliai;50489733849;Ne;0;7;0;7
13417;Viltenė;Drugeliai;69838945768;Ne;0;2;0;2
13418;Viltenė;Drugeliai;54422258148;Taip;5;6;0;11
13419;Viltenė;Drugeliai;4322306031;Taip;3;0;0;3
13420;Viltenė;Drugeliai;82849073169;Taip;5;3;0;8
13421;Viltenė;Drugeliai;39676814294;Ne;1;1;0;2
13422;Viltenė;Drugeliai;47885567334;Taip;0;6;0;6
13423;Viltenė;Drugeliai;45275376273;Taip;2;0;0;2
13424;Viltenė;Drugeliai;68110722913;Taip;0;1;0;1
13425;Viltenė;Drugeliai;21489308130;Taip;5;0;0;5
13426;Viltenė;Drugeliai;16461652415;Taip;0;7;0;7
13427;Viltenė;Drugeliai;91847807834;Taip;0;1;0;1
13428;Viltenė;Drugeliai;34691221253;Taip;5;7;0;12
13429;Viltenė;Drugeliai;75637599543;Taip;4;0;0;4
13430;Viltenė;Drugeliai;33159619580;Taip;5;6;0;11
13431;Viltenė;Drugeliai;4586042895;Taip;3;5;0;8
13432;Viltenė;Drugeliai;7169597620;Taip;5;0;0;5
13433;Viltenė;Drugeliai;25504337581;Taip;0;2;0;2
13434;Viltenė;Drugeliai;1739353382;Taip;0;3;0;3
13435;Viltenė;Bitučių;21665885641;Taip;0;1;0;1
13436;Viltenė;Bitučių;1747442313;Taip;0;13;0;13
13437;Viltenė;Bitučių;61093082990;Taip;0;3;0;3
13438;Viltenė;Bitučių;13157765051;Taip;5;0;0;5
13439;Viltenė;Bitučių;46245753187;Taip;0;1;0;1
13440;Viltenė;Bitučių;2046122804;Taip;0;8;0;8
13441;Viltenė;Bitučių;74464437862;Taip;0;1;0;1
13442;Viltenė;Bitučių;93664116601;Ne;1;3;0;4
13443;Viltenė;Bitučių;86055366818;Taip;2;1;0;3
13444;Viltenė;Bitučių;66587678111;Taip;5;0;0;5
13445;Viltenė;Bitučių;65252989761;Taip;0;7;0;7
13446;Viltenė;Bitučių;84451732377;Taip;0;3;0;3
13447;Viltenė;Bitučių;1702925444;Taip;0;3;0;3
13448;Viltenė;Bitučių;1165480440;Taip;0;3;0;3
13449;Viltenė;Bitučių;8985943715;Taip;4;1;0;5
13450;Viltenė;Bitučių;1798739406;Taip;0;2;0;2
13451;Viltenė;Bitučių;1656026241;Taip;5;5;0;10
13452;Viltenė;Bitučių;4554162475;Taip;0;5;0;5
13453;Viltenė;Bitučių;1291605426;Taip;0;2;0;2
13454;Viltenė;Bitučių;6322746293;Taip;0;5;0;5
13455;Viltenė;Bitučių;4334881910;Taip;0;12;0;12
13456;Viltenė;Boružėlių;97823483581;Taip;0;5;0;5
13457;Viltenė;Boružėlių;27743584566;Taip;1;0;0;1
13458;Viltenė;Boružėlių;1657346055;Taip;8;6;0;14
13459;Viltenė;Boružėlių;24165965719;Taip;0;5;0;5
13460;Viltenė;Boružėlių;45338320216;Taip;0;2;0;2
13461;Viltenė;Boružėlių;9858448228;Taip;7;5;0;12
13462;Viltenė;Boružėlių;58371160698;Taip;0;9;0;9
13463;Viltenė;Boružėlių;48048883203;Taip;0;1;0;1
13464;Viltenė;Boružėlių;50651685299;Taip;5;7;0;12
13465;Viltenė;Boružėlių;43591393680;Taip;11;1;0;12
13466;Viltenė;Boružėlių;4053036431;Taip;4;0;0;4
13467;Viltenė;Boružėlių;27950438672;Taip;3;10;0;13
13468;Viltenė;Boružėlių;73607402351;Taip;2;0;0;2
13469;Viltenė;Boružėlių;1963420643;Taip;0;6;0;6
13470;Viltenė;Boružėlių;4548358886;Taip;0;2;0;2
13471;Viltenė;Boružėlių;4361513192;Taip;0;1;0;1
13472;Viltenė;Boružėlių;1830978436;Taip;0;2;0;2
13473;Viltenė;Boružėlių;9535128551;Taip;0;20;0;20
13474;Viltenė;Boružėlių;4119912673;Taip;1;0;0;1
13475;Viltenė;Gandriukų;48816849840;Taip;0;6;0;6
13476;Viltenė;Gandriukų;65109318544;Taip;2;0;0;2
13477;Viltenė;Gandriukų;64883562677;Taip;0;5;0;5
13478;Viltenė;Gandriukų;14178563941;Taip;0;2;0;2
13479;Viltenė;Gandriukų;1658242811;Taip;0;3;0;3
13480;Viltenė;Gandriukų;55479966961;Taip;10;1;0;11
13481;Viltenė;Gandriukų;69267964826;Taip;5;4;0;9
13482;Viltenė;Gandriukų;54622802635;Ne;0;10;0;10
13483;Viltenė;Gandriukų;15315166069;Taip;5;1;0;6
13484;Viltenė;Gandriukų;96889901141;Taip;5;1;0;6
13485;Viltenė;Gandriukų;35607778200;Taip;0;9;0;9
13486;Viltenė;Gandriukų;11271646485;Taip;0;6;0;6
13487;Viltenė;Gandriukų;40901810557;Ne;0;1;0;1
13488;Viltenė;Gandriukų;69157590882;Taip;7;2;0;9
13489;Viltenė;Gandriukų;16356755996;Taip;4;1;0;5
13490;Viltenė;Gandriukų;34334946258;Taip;2;0;0;2
13491;Viltenė;Gandriukų;8975037678;Taip;0;20;0;20
13492;Viltenė;Gandriukų;50612310300;Taip;15;0;0;15
13493;Viltenė;Gandriukų;31216445971;Ne;0;6;0;6
13494;Viltenė;Gandriukų;1487205453;Taip;10;0;0;10
13495;Viltenė;Gandriukų;1898136396;Taip;0;4;0;4
13496;Viltenė;Gandriukų;86027570047;Taip;7;1;0;8
13497;Viltenė;Gandriukų;98690857297;Taip;0;2;0;2
13498;Viltenė;Aitvariukai;8367775964;Taip;6;5;0;11
13499;Viltenė;Aitvariukai;95537304111;Taip;5;4;1;10
13500;Viltenė;Aitvariukai;51598096361;Taip;5;13;0;18
13501;Viltenė;Aitvariukai;15218988953;Taip;9;1;0;10
13502;Viltenė;Aitvariukai;9155192250;Taip;0;13;2;15
13503;Viltenė;Aitvariukai;5304966336;Taip;0;9;0;9
13504;Viltenė;Aitvariukai;3057761137;Taip;10;1;1;12
13505;Viltenė;Aitvariukai;6160715081;Taip;15;5;0;20
13506;Viltenė;Aitvariukai;5919786939;Taip;0;5;0;5
13507;Viltenė;Aitvariukai;17844870669;Taip;0;16;0;16
13508;Viltenė;Aitvariukai;56293220882;Taip;15;0;0;15
13509;Viltenė;Aitvariukai;96366849694;Taip;20;0;0;20
13510;Viltenė;Aitvariukai;8259812812;Taip;10;1;0;11
13511;Viltenė;Aitvariukai;23233966729;Taip;0;7;1;8
13512;Viltenė;Aitvariukai;99398043638;Taip;9;5;0;14
13513;Viltenė;Aitvariukai;55514676697;Taip;1;4;1;6
13514;Viltenė;Aitvariukai;14831307307;Taip;0;2;0;2
13515;Viltenė;Geniukų;5604263567;Taip;5;6;0;11
13516;Viltenė;Geniukų;1822220265;Taip;7;5;0;12
13517;Viltenė;Geniukų;9613791189;Taip;0;7;0;7
13518;Viltenė;Geniukų;6349032936;Taip;0;1;0;1
13519;Viltenė;Geniukų;1423254631;Taip;2;4;0;6
13520;Viltenė;Geniukų;3002690526;Taip;5;2;0;7
13521;Viltenė;Geniukų;3711956659;Taip;0;5;0;5
13522;Viltenė;Geniukų;1054469254;Taip;13;1;0;14
13523;Viltenė;Geniukų;4295285885;Taip;10;6;0;16
13524;Viltenė;Geniukų;6063181025;Taip;5;0;0;5
13525;Viltenė;Geniukų;1672091332;Taip;9;0;0;9
13526;Viltenė;Geniukų;9396183748;Taip;5;3;0;8
13527;Viltenė;Geniukų;3018271511;Taip;4;1;0;5
13528;Viltenė;Geniukų;49998813869;Taip;0;4;0;4
13529;Viltenė;Geniukų;3389110405;Taip;13;0;0;13
13530;Viltenė;Geniukų;4319685140;Taip;0;17;0;17
13531;Viltenė;Geniukų;6693601673;Taip;16;0;0;16
13532;Viltenė;Geniukų;8329611036;Taip;7;5;0;12
13533;Viltenė;Geniukų;8125023386;Taip;0;7;0;7
13534;Viltenė;Geniukų;8085993647;Taip;5;0;0;5
13535;Viltenė;Geniukų;9035687504;Taip;11;3;0;14
13536;Viltenė;Geniukų;5664573939;Taip;9;6;0;15
13537;Viltenė;Saulutės;2044754943;Taip;10;0;0;10
13538;Viltenė;Saulutės;6848403057;Taip;0;2;0;2
13539;Viltenė;Saulutės;1615415742;Taip;0;3;0;3
13540;Viltenė;Saulutės;7994367286;Taip;10;0;0;10
13541;Viltenė;Saulutės;9935236068;Taip;0;1;0;1
13542;Viltenė;Saulutės;2141002432;Taip;0;9;0;9
13543;Viltenė;Saulutės;1362308882;Taip;4;1;0;5
13544;Viltenė;Saulutės;5024192785;Taip;0;6;0;6
13545;Viltenė;Saulutės;92968672028;Taip;7;6;0;13
13546;Viltenė;Saulutės;1918867591;Taip;0;14;0;14
13547;Viltenė;Saulutės;1844509355;Taip;6;10;0;16
13548;Viltenė;Saulutės;7559243300;Taip;5;6;0;11
13549;Viltenė;Saulutės;3560474943;Taip;0;7;0;7
13550;Viltenė;Saulutės;2840208662;Taip;10;0;0;10
13551;Viltenė;Saulutės;1252657362;Taip;5;0;0;5
13552;Viltenė;Saulutės;2559945034;Taip;0;1;0;1
13553;Viltenė;Saulutės;2546789906;Taip;15;0;0;15
13554;Viltenė;Saulutės;3401975301;Taip;11;3;0;14
13555;Viltenė;Saulutės;9381280809;Taip;10;9;0;19
13556;Viltenė;Saulutės;7726650894;Taip;0;7;0;7
13557;Viltenė;Saulutės;3709362712;Taip;0;2;0;2
13558;Viltenė;Saulutės;1841732416;Taip;0;3;0;3
13559;Viltenė;Lapiukų;2016636764;Taip;5;1;1;7
13560;Viltenė;Lapiukų;1650304982;Taip;10;5;0;15
13561;Viltenė;Lapiukų;89844531860;Taip;0;1;0;1
13562;Viltenė;Lapiukų;8261531943;Taip;5;0;0;5
13563;Viltenė;Lapiukų;1884043126;Taip;5;2;0;7
13564;Viltenė;Lapiukų;60092202534;Taip;0;5;0;5
13565;Viltenė;Lapiukų;22318027000;Taip;4;0;0;4
13566;Viltenė;Lapiukų;1559623914;Taip;0;6;0;6
13567;Viltenė;Lapiukų;1503728117;Taip;0;11;0;11
13568;Viltenė;Lapiukų;1042196397;Taip;8;0;0;8
13569;Viltenė;Lapiukų;1210824560;Taip;5;6;0;11
13570;Viltenė;Lapiukų;2065651722;Taip;5;1;0;6
13571;Viltenė;Lapiukų;87698700338;Taip;5;2;0;7
13572;Viltenė;Lapiukų;3526237179;Taip;9;0;0;9
13573;Viltenė;Lapiukų;1662950901;Taip;11;2;0;13
13574;Viltenė;Lapiukų;1350487577;Taip;5;4;0;9
13575;Viltenė;Lapiukų;1592077335;Taip;16;0;0;16
13576;Viltenė;Lapiukų;1281808784;Taip;0;20;0;20
13577;Viltenė;Lapiukų;1726174128;Taip;5;1;0;6
13578;Viltenė;Lapiukų;4470172666;Taip;19;0;0;19
13579;Viltenė;Lapiukų;2527648089;Taip;2;4;0;6
13580;Viltenė;Lapiukų;93894985640;Taip;5;7;0;12
13581;Viltenė;Lapiukų;3259114583;Taip;6;8;0;14
13582;Viltenė;Voveriukai;8732323660;Taip;0;5;0;5
13583;Viltenė;Voveriukai;13795858727;Ne;0;2;0;2
13584;Viltenė;Voveriukai;1306624353;Taip;7;2;0;9
13585;Viltenė;Voveriukai;46757944454;Taip;11;5;0;16
13586;Viltenė;Voveriukai;69918162258;Taip;0;3;0;3
13587;Viltenė;Voveriukai;76569470768;Taip;4;1;0;5
13588;Viltenė;Voveriukai;1262222404;Taip;4;1;0;5
13589;Viltenė;Voveriukai;69882566734;Taip;0;2;0;2
13590;Viltenė;Voveriukai;7245395388;Ne;0;6;0;6
13591;Viltenė;Voveriukai;77847693433;Taip;4;0;0;4
13592;Viltenė;Voveriukai;46252876577;Taip;0;0;1;1
13593;Viltenė;Voveriukai;92175043385;Taip;2;0;2;4
13594;Viltenė;Voveriukai;35466181637;Taip;0;1;8;9
13595;Viltenė;Voveriukai;68243828276;Taip;0;1;2;3
13596;Viltenė;Voveriukai;1615151982;Taip;0;5;0;5
13597;Viltenė;Voveriukai;87296434240;Taip;0;2;0;2
13598;Viltenė;Voveriukai;51997485918;Ne;0;8;0;8
13599;Viltenė;Voveriukai;1872042290;Taip;4;5;0;9
13600;Viltenė;Voveriukai;2008408325;Ne;0;10;0;10
13601;Viltenė;Voveriukai;4441280059;Taip;0;4;0;4
13602;Viltenė;Triušikai;5280690534;Taip;3;0;0;3
13603;Viltenė;Triušikai;9242034622;Taip;1;0;0;1
13604;Viltenė;Triušikai;4388770140;Taip;0;1;0;1
13605;Viltenė;Triušikai;4604298036;Taip;16;0;0;16
13606;Viltenė;Triušikai;8110413064;Taip;0;2;0;2
13607;Viltenė;Triušikai;7693789849;Taip;0;20;0;20
13608;Viltenė;Triušikai;4036109404;Taip;5;3;0;8
13609;Viltenė;Triušikai;9756519374;Taip;16;3;0;19
13610;Viltenė;Triušikai;9820462941;Taip;10;0;0;10
13611;Viltenė;Triušikai;8527270437;Taip;10;2;0;12
13612;Viltenė;Triušikai;6621273812;Taip;15;0;0;15
13613;Viltenė;Triušikai;3278842582;Taip;0;1;0;1
13614;Viltenė;Triušikai;2026654467;Taip;0;14;0;14
13615;Viltenė;Triušikai;1598785483;Taip;16;0;0;16
13616;Viltenė;Triušikai;3073228245;Taip;17;0;0;17
13617;Viltenė;Triušikai;2383607612;Taip;7;0;2;9
13618;Viltenė;Triušikai;9197007374;Taip;10;0;0;10
13619;Viltenė;Triušikai;5522245968;Taip;10;0;0;10
13620;Viltenė;Kiškučiai;8549631247;Taip;0;2;0;2
13621;Viltenė;Kiškučiai;2884698447;Taip;7;8;0;15
13622;Viltenė;Kiškučiai;7092857844;Taip;9;0;0;9
13623;Viltenė;Kiškučiai;9217178863;Taip;7;1;0;8
13624;Viltenė;Kiškučiai;6355569231;Taip;0;20;0;20
13625;Viltenė;Kiškučiai;1126409020;Taip;11;1;0;12
13626;Viltenė;Kiškučiai;6555035887;Taip;11;2;0;13
13627;Viltenė;Kiškučiai;9228677568;Taip;0;4;0;4
13628;Viltenė;Kiškučiai;1840626621;Taip;5;6;0;11
13629;Viltenė;Kiškučiai;2815105107;Taip;15;1;0;16
13630;Viltenė;Kiškučiai;6511850468;Taip;20;0;0;20
13631;Viltenė;Kiškučiai;8477241365;Taip;16;0;0;16
13632;Viltenė;Kiškučiai;5850652322;Taip;0;11;0;11
13633;Viltenė;Kiškučiai;9187671201;Taip;0;5;0;5
13634;Viltenė;Kiškučiai;4616047113;Taip;9;0;0;9
13635;Viltenė;Kiškučiai;6060648988;Taip;17;0;0;17
13636;Viltenė;Kiškučiai;7796422726;Taip;20;0;0;20
13637;Viltenė;Nykštukų;4003018966;Taip;5;0;2;7
13638;Viltenė;Nykštukų;7912396297;Taip;12;3;0;15
13639;Viltenė;Nykštukų;3738838707;Taip;5;0;0;5
13640;Viltenė;Nykštukų;3777544301;Taip;15;0;0;15
13641;Viltenė;Nykštukų;9597857664;Taip;0;0;1;1
13642;Viltenė;Nykštukų;6642790962;Taip;7;0;0;7
13643;Viltenė;Nykštukų;9572407405;Taip;9;0;0;9
13644;Viltenė;Nykštukų;8473588098;Taip;13;0;0;13
13645;Viltenė;Nykštukų;1399653129;Taip;6;0;3;9
13646;Viltenė;Nykštukų;4121448859;Taip;10;0;2;12
13647;Viltenė;Nykštukų;5599943846;Taip;10;0;1;11
13648;Viltenė;Nykštukų;8603418399;Taip;20;0;0;20
13649;Viltenė;Nykštukų;5379804362;Taip;10;0;0;10
13650;Viltenė;Nykštukų;1936628249;Taip;9;5;0;14
13651;Viltenė;Nykštukų;7526555727;Taip;9;0;0;9
13652;Viltenė;Nykštukų;5552217000;Taip;9;6;0;15
13653;Voveraitė;ŽVIRBLIUKŲ;46063615245;Taip;0;5;0;5
13654;Voveraitė;ŽVIRBLIUKŲ;63276868064;Taip;4;8;0;12
13655;Voveraitė;ŽVIRBLIUKŲ;12366200545;Taip;0;6;0;6
13656;Voveraitė;ŽVIRBLIUKŲ;34170702690;Taip;0;7;0;7
13657;Voveraitė;ŽVIRBLIUKŲ;6903776113;Taip;7;5;0;12
13658;Voveraitė;ŽVIRBLIUKŲ;15716865051;Ne;0;8;0;8
13659;Voveraitė;ŽVIRBLIUKŲ;14865004407;Taip;0;6;0;6
13660;Voveraitė;ŽVIRBLIUKŲ;39956224681;Taip;15;5;0;20
13661;Voveraitė;ŽVIRBLIUKŲ;74403080901;Taip;0;2;0;2
13662;Voveraitė;ŽVIRBLIUKŲ;1261834247;Taip;0;11;0;11
13663;Voveraitė;ŽVIRBLIUKŲ;1055423524;Taip;0;19;0;19
13664;Voveraitė;ŽVIRBLIUKŲ;3137529068;Taip;0;9;0;9
13665;Voveraitė;ŽVIRBLIUKŲ;65838266846;Taip;11;0;0;11
13666;Voveraitė;ŽVIRBLIUKŲ;69198613700;Taip;0;1;0;1
13667;Voveraitė;ŽVIRBLIUKŲ;5357569948;Taip;0;7;0;7
13668;Voveraitė;VOVERIUKŲ;26264960973;Taip;5;3;0;8
13669;Voveraitė;VOVERIUKŲ;46318035221;Taip;9;0;0;9
13670;Voveraitė;VOVERIUKŲ;3818120898;Taip;20;0;0;20
13671;Voveraitė;VOVERIUKŲ;90300459408;Taip;20;0;0;20
13672;Voveraitė;VOVERIUKŲ;57033218205;Taip;0;2;0;2
13673;Voveraitė;VOVERIUKŲ;64724933885;Taip;5;1;0;6
13674;Voveraitė;VOVERIUKŲ;1587569563;Taip;5;2;0;7
13675;Voveraitė;VOVERIUKŲ;89873985894;Taip;1;6;0;7
13676;Voveraitė;VOVERIUKŲ;89216481616;Taip;0;2;0;2
13677;Voveraitė;VOVERIUKŲ;69797506996;Taip;10;4;0;14
13678;Voveraitė;VOVERIUKŲ;76074825733;Taip;0;2;0;2
13679;Voveraitė;VOVERIUKŲ;49205285378;Taip;6;4;0;10
13680;Voveraitė;VOVERIUKŲ;84508228457;Taip;11;4;0;15
13681;Voveraitė;VOVERIUKŲ;61376515242;Taip;9;6;0;15
13682;Voveraitė;VOVERIUKŲ;47111956594;Taip;8;2;0;10
13683;Voveraitė;VOVERIUKŲ;16514161872;Taip;0;2;0;2
13684;Voveraitė;VOVERIUKŲ;22913200509;Taip;5;5;0;10
13685;Voveraitė;VOVERIUKŲ;26080915874;Taip;5;3;0;8
13686;Voveraitė;VOVERIUKŲ;59442802443;Taip;13;0;0;13
13687;Voveraitė;VOVERIUKŲ;1398043988;Taip;10;1;0;11
13688;Voveraitė;VOVERIUKŲ;53801893219;Taip;7;3;0;10
13689;Voveraitė;KIŠKUČIŲ;3615729576;Ne;8;0;0;8
13690;Voveraitė;KIŠKUČIŲ;9231751171;Taip;7;0;0;7
13691;Voveraitė;KIŠKUČIŲ;4338861332;Taip;0;4;0;4
13692;Voveraitė;KIŠKUČIŲ;9933037872;Taip;7;4;0;11
13693;Voveraitė;KIŠKUČIŲ;3113780055;Taip;0;2;0;2
13694;Voveraitė;KIŠKUČIŲ;65926130735;Taip;5;0;0;5
13695;Voveraitė;KIŠKUČIŲ;7069780513;Taip;16;1;0;17
13696;Voveraitė;KIŠKUČIŲ;9997346812;Taip;10;6;0;16
13697;Voveraitė;KIŠKUČIŲ;9703726869;Taip;3;0;0;3
13698;Voveraitė;KIŠKUČIŲ;7314148938;Taip;2;4;0;6
13699;Voveraitė;KIŠKUČIŲ;4511771924;Taip;2;4;0;6
13700;Voveraitė;KIŠKUČIŲ;5521756833;Taip;20;0;0;20
13701;Voveraitė;KIŠKUČIŲ;9007031372;Taip;20;0;0;20
13702;Voveraitė;KIŠKUČIŲ;6369860178;Taip;15;5;0;20
13703;Voveraitė;KIŠKUČIŲ;6649068571;Taip;0;7;0;7
13704;Voveraitė;KIŠKUČIŲ;1775800865;Taip;0;3;0;3
13705;Voveraitė;KIŠKUČIŲ;6433760749;Taip;11;4;0;15
13706;Voveraitė;KODĖLČIUKŲ;3469734853;Taip;11;4;0;15
13707;Voveraitė;KODĖLČIUKŲ;9117809080;Taip;2;0;0;2
13708;Voveraitė;KODĖLČIUKŲ;5467979968;Taip;11;0;0;11
13709;Voveraitė;KODĖLČIUKŲ;46205148458;Taip;0;1;0;1
13710;Voveraitė;KODĖLČIUKŲ;1772758517;Taip;0;5;0;5
13711;Voveraitė;KODĖLČIUKŲ;51213803814;Taip;0;5;0;5
13712;Voveraitė;KODĖLČIUKŲ;36749754999;Taip;0;4;0;4
13713;Voveraitė;KODĖLČIUKŲ;6653141009;Taip;0;0;6;6
13714;Voveraitė;KODĖLČIUKŲ;4045121781;Taip;10;1;0;11
13715;Voveraitė;KODĖLČIUKŲ;2304004487;Taip;8;2;0;10
13716;Voveraitė;KODĖLČIUKŲ;2208396431;Taip;0;4;4;8
13717;Voveraitė;KODĖLČIUKŲ;6361417566;Taip;5;0;1;6
13718;Voveraitė;KODĖLČIUKŲ;5296850349;Taip;0;9;0;9
13719;Voveraitė;KODĖLČIUKŲ;2763656717;Taip;19;0;0;19
13720;Voveraitė;KODĖLČIUKŲ;4468214107;Taip;20;0;0;20
13721;Voveraitė;KODĖLČIUKŲ;9921313716;Taip;0;0;12;12
13722;Voveraitė;KODĖLČIUKŲ;5449490074;Taip;10;0;6;16
13723;Voveraitė;KODĖLČIUKŲ;7786378018;Taip;5;0;3;8
13724;Voveraitė;MEŠKIUKŲ;4079618555;Taip;0;3;0;3
13725;Voveraitė;MEŠKIUKŲ;3987058753;Taip;0;2;0;2
13726;Voveraitė;MEŠKIUKŲ;3381417855;Taip;0;2;0;2
13727;Voveraitė;MEŠKIUKŲ;3703062195;Taip;0;3;0;3
13728;Voveraitė;MEŠKIUKŲ;8438876806;Taip;5;6;0;11
13729;Voveraitė;MEŠKIUKŲ;1058273156;Taip;3;2;0;5
13730;Voveraitė;MEŠKIUKŲ;9149748841;Taip;7;1;0;8
13731;Voveraitė;MEŠKIUKŲ;5576058454;Taip;0;8;0;8
13732;Voveraitė;MEŠKIUKŲ;1629942114;Taip;0;15;0;15
13733;Voveraitė;MEŠKIUKŲ;6359983706;Taip;0;3;0;3
13734;Voveraitė;MEŠKIUKŲ;1592633500;Taip;3;3;0;6
13735;Voveraitė;MEŠKIUKŲ;5437283673;Taip;5;1;0;6
13736;Voveraitė;MEŠKIUKŲ;7797966139;Taip;0;14;0;14
13737;Voveraitė;MEŠKIUKŲ;3029983180;Taip;4;4;0;8
13738;Voveraitė;MEŠKIUKŲ;9900940313;Taip;12;0;0;12
13739;Voveraitė;MEŠKIUKŲ;4680264973;Taip;5;4;0;9
13740;Voveraitė;MEŠKIUKŲ;6886337758;Taip;8;9;0;17
13741;Voveraitė;BORUŽĖLIŲ;28598946561;Taip;0;2;0;2
13742;Voveraitė;BORUŽĖLIŲ;97620560960;Ne;8;7;0;15
13743;Voveraitė;BORUŽĖLIŲ;81073619227;Taip;10;6;0;16
13744;Voveraitė;BORUŽĖLIŲ;77602038332;Taip;10;2;0;12
13745;Voveraitė;BORUŽĖLIŲ;66403987802;Taip;0;2;0;2
13746;Voveraitė;BORUŽĖLIŲ;89152921324;Taip;10;0;0;10
13747;Voveraitė;BORUŽĖLIŲ;34369856708;Taip;5;7;0;12
13748;Voveraitė;BORUŽĖLIŲ;97109418554;Taip;5;6;0;11
13749;Voveraitė;BORUŽĖLIŲ;90671659606;Taip;6;2;0;8
13750;Voveraitė;BORUŽĖLIŲ;45746249613;Taip;9;2;0;11
13751;Voveraitė;BORUŽĖLIŲ;32041841165;Taip;10;5;0;15
13752;Voveraitė;BORUŽĖLIŲ;33234062327;Taip;10;0;0;10
13753;Voveraitė;BORUŽĖLIŲ;95730702606;Taip;0;3;0;3
13754;Voveraitė;BORUŽĖLIŲ;4440929639;Taip;10;10;0;20
13755;Voveraitė;BORUŽĖLIŲ;14945425849;Taip;0;9;0;9
13756;Voveraitė;BORUŽĖLIŲ;63634109515;Taip;0;1;0;1
13757;Voveraitė;BORUŽĖLIŲ;47199214035;Ne;0;7;0;7
13758;Voveraitė;BORUŽĖLIŲ;31214112756;Taip;0;2;0;2
13759;Voveraitė;BORUŽĖLIŲ;36024562927;Taip;5;0;0;5
13760;Voveraitė;BORUŽĖLIŲ;9288862466;Taip;6;5;0;11
13761;Voveraitė;PELĖDŽIUKŲ;59718931996;Taip;0;3;0;3
13762;Voveraitė;PELĖDŽIUKŲ;86565940690;Taip;5;5;0;10
13763;Voveraitė;PELĖDŽIUKŲ;2611108856;Taip;0;3;0;3
13764;Voveraitė;PELĖDŽIUKŲ;2009943498;Taip;0;1;0;1
13765;Voveraitė;PELĖDŽIUKŲ;6947553594;Taip;3;0;0;3
13766;Voveraitė;PELĖDŽIUKŲ;3114586597;Taip;0;11;0;11
13767;Voveraitė;PELĖDŽIUKŲ;76432985710;Taip;6;0;0;6
13768;Voveraitė;PELĖDŽIUKŲ;74161507529;Ne;8;0;0;8
13769;Voveraitė;PELĖDŽIUKŲ;85594406820;Taip;0;1;0;1
13770;Voveraitė;PELĖDŽIUKŲ;30591405375;Taip;0;12;0;12
13771;Voveraitė;PELĖDŽIUKŲ;42683378356;Taip;0;11;0;11
13772;Voveraitė;PELĖDŽIUKŲ;12670469264;Taip;7;5;0;12
13773;Voveraitė;PELĖDŽIUKŲ;68005956631;Taip;0;2;0;2
13774;Voveraitė;PELĖDŽIUKŲ;5232316253;Taip;10;3;0;13
13775;Voveraitė;PELĖDŽIUKŲ;32030461873;Taip;0;4;0;4
13776;Voveraitė;PELĖDŽIUKŲ;1273652060;Taip;7;7;0;14
13777;Voveraitė;PELĖDŽIUKŲ;68050017530;Taip;5;5;0;10
13778;Voveraitė;DRUGELIŲ;9623406874;Taip;5;11;0;16
13779;Voveraitė;DRUGELIŲ;1668695462;Taip;5;12;0;17
13780;Voveraitė;DRUGELIŲ;1753442884;Taip;0;19;0;19
13781;Voveraitė;DRUGELIŲ;63032690186;Taip;0;6;0;6
13782;Voveraitė;DRUGELIŲ;7974406524;Taip;8;7;0;15
13783;Voveraitė;DRUGELIŲ;1032086466;Taip;0;7;0;7
13784;Voveraitė;DRUGELIŲ;8538259157;Taip;0;1;0;1
13785;Voveraitė;DRUGELIŲ;81628846458;Taip;14;0;0;14
13786;Voveraitė;DRUGELIŲ;2044914624;Taip;0;12;0;12
13787;Voveraitė;DRUGELIŲ;5037713667;Taip;0;1;0;1
13788;Voveraitė;DRUGELIŲ;2031078156;Taip;5;10;0;15
13789;Voveraitė;DRUGELIŲ;80330740714;Taip;8;5;0;13
13790;Voveraitė;DRUGELIŲ;6729475469;Taip;0;7;0;7
13791;Voveraitė;DRUGELIŲ;1397274691;Taip;10;8;0;18
13792;Voveraitė;DRUGELIŲ;1612322367;Taip;0;6;0;6
13793;Voveraitė;DRUGELIŲ;6847620019;Taip;0;15;0;15
13794;Voveraitė;DRUGELIŲ;53507758884;Taip;5;5;0;10
13795;Voveraitė;DRUGELIŲ;1780573926;Taip;15;0;0;15
13796;Voveraitė;DRUGELIŲ;8443005812;Taip;2;0;0;2
13797;Voveraitė;NYKŠTUKŲ;59346262217;Taip;5;4;0;9
13798;Voveraitė;NYKŠTUKŲ;44115826781;Taip;0;4;0;4
13799;Voveraitė;NYKŠTUKŲ;67851579200;Taip;0;9;0;9
13800;Voveraitė;NYKŠTUKŲ;2902148527;Taip;0;3;0;3
13801;Voveraitė;NYKŠTUKŲ;28656009009;Taip;0;3;0;3
13802;Voveraitė;NYKŠTUKŲ;1704834744;Taip;0;6;0;6
13803;Voveraitė;NYKŠTUKŲ;35549553867;Taip;8;5;0;13
13804;Voveraitė;NYKŠTUKŲ;49924157014;Taip;5;0;0;5
13805;Voveraitė;NYKŠTUKŲ;41182124889;Taip;0;2;0;2
13806;Voveraitė;NYKŠTUKŲ;13173711840;Taip;10;2;0;12
13807;Voveraitė;NYKŠTUKŲ;602726070;Taip;0;10;0;10
13808;Voveraitė;NYKŠTUKŲ;27132982320;Taip;0;3;0;3
13809;Voveraitė;NYKŠTUKŲ;107968318;Taip;5;6;0;11
13810;Voveraitė;NYKŠTUKŲ;2762066479;Taip;5;0;0;5
13811;Voveraitė;NYKŠTUKŲ;66612277823;Taip;0;4;0;4
13812;Voveraitė;NYKŠTUKŲ;82642244788;Taip;4;7;0;11
13813;Voveraitė;NYKŠTUKŲ;1022447432;Taip;11;7;0;18
13814;Voveraitė;NYKŠTUKŲ;8666880821;Taip;6;12;0;18
13815;Voveraitė;NYKŠTUKŲ;2051732666;Taip;5;6;0;11
13816;Voveraitė;GENIUKŲ;23764078403;Taip;0;16;0;16
13817;Voveraitė;GENIUKŲ;29342867028;Taip;5;5;0;10
13818;Voveraitė;GENIUKŲ;78138420154;Taip;0;3;0;3
13819;Voveraitė;GENIUKŲ;18103338554;Taip;0;5;0;5
13820;Voveraitė;GENIUKŲ;54804373335;Taip;0;1;0;1
13821;Voveraitė;GENIUKŲ;92953475852;Taip;6;1;0;7
13822;Voveraitė;GENIUKŲ;3092390110;Taip;0;6;0;6
13823;Voveraitė;GENIUKŲ;6272832397;Taip;0;6;0;6
13824;Voveraitė;GENIUKŲ;6190239742;Taip;0;6;0;6
13825;Voveraitė;GENIUKŲ;90596813791;Taip;0;3;0;3
13826;Voveraitė;GENIUKŲ;1281767120;Taip;0;4;0;4
13827;Voveraitė;GENIUKŲ;52600331650;Taip;0;3;0;3
13828;Voveraitė;GENIUKŲ;9980142483;Taip;0;5;0;5
13829;Voveraitė;GENIUKŲ;1279597695;Taip;3;0;0;3
13830;Voveraitė;GENIUKŲ;59078135624;Taip;0;3;0;3
13831;Voveraitė;GENIUKŲ;57470452892;Taip;0;5;0;5
13832;Voveraitė;GENIUKŲ;67618706684;Taip;4;7;0;11
13833;Voveraitė;GENIUKŲ;50076604267;Taip;0;8;0;8
13834;Voveraitė;GENIUKŲ;3603951917;Taip;0;4;0;4
13835;Voveraitė;LAPIUKŲ;8925151080;Taip;0;0;2;2
13836;Voveraitė;LAPIUKŲ;4300235743;Taip;5;0;7;12
13837;Voveraitė;LAPIUKŲ;6684234832;Taip;5;1;3;9
13838;Voveraitė;LAPIUKŲ;9715405072;Taip;0;5;0;5
13839;Voveraitė;LAPIUKŲ;1441921029;Taip;10;0;0;10
13840;Voveraitė;LAPIUKŲ;8119493388;Taip;0;5;2;7
13841;Voveraitė;LAPIUKŲ;5804351872;Taip;0;0;4;4
13842;Voveraitė;LAPIUKŲ;2450726148;Taip;0;5;2;7
13843;Voveraitė;LAPIUKŲ;7531020548;Taip;10;5;0;15
13844;Voveraitė;LAPIUKŲ;7244142828;Taip;5;15;0;20
13845;Voveraitė;LAPIUKŲ;5510544648;Taip;7;0;0;7
13846;Voveraitė;LAPIUKŲ;3582805599;Taip;3;1;0;4
13847;Voveraitė;LAPIUKŲ;1988082807;Taip;0;0;3;3
13848;Voveraitė;LAPIUKŲ;6994680282;Taip;0;1;4;5
13849;Voveraitė;LAPIUKŲ;5705303891;Taip;15;0;2;17
13850;Voveraitė;LAPIUKŲ;6959751328;Taip;5;0;0;5
13851;Voveraitė;EŽIUKŲ;8373093305;Taip;12;1;0;13
13852;Voveraitė;EŽIUKŲ;2246291631;Taip;8;2;0;10
13853;Voveraitė;EŽIUKŲ;1960385335;Taip;17;0;0;17
13854;Voveraitė;EŽIUKŲ;2322594823;Taip;6;1;0;7
13855;Voveraitė;EŽIUKŲ;6007396459;Taip;13;0;0;13
13856;Voveraitė;EŽIUKŲ;6073270223;Taip;3;0;0;3
13857;Voveraitė;EŽIUKŲ;2662384275;Taip;14;5;0;19
13858;Voveraitė;EŽIUKŲ;4563198733;Taip;5;15;0;20
13859;Voveraitė;EŽIUKŲ;7746424196;Taip;12;0;5;17
13860;Voveraitė;EŽIUKŲ;2594535017;Taip;13;0;0;13
13861;Voveraitė;EŽIUKŲ;9912862474;Taip;1;9;0;10
13862;Voveraitė;EŽIUKŲ;1340379090;Taip;16;0;0;16
13863;Voveraitė;EŽIUKŲ;5138855000;Taip;2;0;0;2
13864;Voveraitė;EŽIUKŲ;9195700962;Taip;0;14;0;14
13865;Voveraitė;EŽIUKŲ;1515087924;Taip;5;7;0;12
13866;"Trakų Vokė";Voveriukų;7858812338;Taip;10;0;4;14
13867;"Trakų Vokė";Voveriukų;2730385281;Taip;11;0;0;11
13868;"Trakų Vokė";Voveriukų;4854440884;Taip;20;0;0;20
13869;"Trakų Vokė";Voveriukų;2761614687;Taip;20;0;0;20
13870;"Trakų Vokė";Voveriukų;6234943180;Taip;14;0;5;19
13871;"Trakų Vokė";Voveriukų;5909584565;Taip;14;0;5;19
13872;"Trakų Vokė";Voveriukų;3913623741;Taip;0;0;5;5
13873;"Trakų Vokė";Voveriukų;6732422645;Taip;13;0;0;13
13874;"Trakų Vokė";Voveriukų;2516219363;Taip;10;0;0;10
13875;"Trakų Vokė";Voveriukų;3209594216;Taip;8;0;1;9
13876;"Trakų Vokė";Voveriukų;5338798362;Taip;20;0;0;20
13877;"Trakų Vokė";Voveriukų;4040038648;Taip;9;0;4;13
13878;"Trakų Vokė";Voveriukų;3319243283;Taip;15;0;0;15
13879;"Trakų Vokė";Voveriukų;7727246187;Taip;6;0;2;8
13880;"Trakų Vokė";Voveriukų;3611639112;Taip;9;0;0;9
13881;"Trakų Vokė";Voveriukų;5206616285;Taip;11;0;1;12
13882;"Trakų Vokė";Boružėlių;84749146259;Taip;4;5;0;9
13883;"Trakų Vokė";Boružėlių;41050699676;Taip;7;0;0;7
13884;"Trakų Vokė";Boružėlių;1100961040;Taip;5;0;0;5
13885;"Trakų Vokė";Boružėlių;38738283929;Taip;10;4;0;14
13886;"Trakų Vokė";Boružėlių;71993634591;Taip;0;0;3;3
13887;"Trakų Vokė";Boružėlių;1809637955;Taip;5;5;0;10
13888;"Trakų Vokė";Boružėlių;2052523633;Taip;6;0;0;6
13889;"Trakų Vokė";Boružėlių;32336388708;Taip;10;0;0;10
13890;"Trakų Vokė";Boružėlių;1994808263;Taip;4;0;0;4
13891;"Trakų Vokė";Boružėlių;76399539244;Taip;0;13;0;13
13892;"Trakų Vokė";Boružėlių;39658854196;Taip;10;5;0;15
13893;"Trakų Vokė";Boružėlių;92262591306;Taip;5;5;0;10
13894;"Trakų Vokė";Boružėlių;37080835526;Taip;0;6;0;6
13895;"Trakų Vokė";Boružėlių;9642375918;Taip;4;3;0;7
13896;"Trakų Vokė";Boružėlių;89851471527;Taip;5;12;0;17
13897;"Trakų Vokė";Boružėlių;96632696431;Taip;5;0;0;5
13898;"Trakų Vokė";Boružėlių;43780546254;Taip;9;5;0;14
13899;"Trakų Vokė";Boružėlių;1805549433;Taip;5;4;0;9
13900;"Trakų Vokė";Boružėlių;66607811394;Taip;9;0;0;9
13901;"Trakų Vokė";Boružėlių;66867557436;Taip;2;0;2;4
13902;"Trakų Vokė";Boružėlių;68968521202;Taip;7;5;0;12
13903;"Trakų Vokė";Boružėlių;95403241312;Taip;10;5;0;15
13904;"Trakų Vokė";Boružėlių;1837766168;Taip;6;0;7;13
13905;"Trakų Vokė";Boružėlių;1858168427;Taip;0;7;0;7
13906;"Trakų Vokė";Boružėlių;49616069190;Taip;5;0;2;7
13907;"Trakų Vokė";Boružėlių;4409993300;Taip;16;0;1;17
13908;"Trakų Vokė";Boružėlių;2466258377;Ne;4;7;0;11
13909;"Trakų Vokė";BITUTUČIŲ;4903261568;Taip;10;1;1;12
13910;"Trakų Vokė";BITUTUČIŲ;4846130117;Taip;12;2;0;14
13911;"Trakų Vokė";BITUTUČIŲ;1461337199;Taip;8;0;0;8
13912;"Trakų Vokė";BITUTUČIŲ;7792654474;Taip;10;5;0;15
13913;"Trakų Vokė";BITUTUČIŲ;39255784762;Taip;9;0;2;11
13914;"Trakų Vokė";BITUTUČIŲ;50553766116;Taip;12;0;0;12
13915;"Trakų Vokė";BITUTUČIŲ;1433982328;Taip;10;5;0;15
13916;"Trakų Vokė";BITUTUČIŲ;2918937134;Taip;11;4;0;15
13917;"Trakų Vokė";BITUTUČIŲ;8542147751;Taip;0;2;3;5
13918;"Trakų Vokė";BITUTUČIŲ;1623166260;Taip;15;0;1;16
13919;"Trakų Vokė";BITUTUČIŲ;3406479364;Taip;10;3;0;13
13920;"Trakų Vokė";BITUTUČIŲ;1339594734;Taip;0;0;3;3
13921;"Trakų Vokė";BITUTUČIŲ;5526830430;Taip;7;0;2;9
13922;"Trakų Vokė";BITUTUČIŲ;4914675622;Taip;10;4;1;15
13923;"Trakų Vokė";BITUTUČIŲ;1590598232;Taip;13;0;0;13
13924;"Trakų Vokė";BITUTUČIŲ;6593654477;Taip;9;0;0;9
13925;"Trakų Vokė";BITUTUČIŲ;3373764541;Taip;10;5;0;15
13926;"Trakų Vokė";BITUTUČIŲ;2839396687;Taip;5;5;0;10
13927;"Trakų Vokė";BITUTUČIŲ;4849992906;Taip;10;6;0;16
13928;"Trakų Vokė";BITUTUČIŲ;8857529726;Taip;13;0;0;13
13929;"Trakų Vokė";BITUTUČIŲ;6221283878;Taip;11;0;1;12
13930;"Trakų Vokė";BITUTUČIŲ;7566567901;Taip;10;0;2;12
13931;"Trakų Vokė";BITUTUČIŲ;3098390989;Taip;16;0;0;16
13932;"Trakų Vokė";BITUTUČIŲ;8997890367;Taip;14;0;0;14
13933;"Trakų Vokė";KIŠKUČIŲ;15897808544;Taip;5;5;2;12
13934;"Trakų Vokė";KIŠKUČIŲ;88989814775;Taip;0;5;5;10
13935;"Trakų Vokė";KIŠKUČIŲ;6675993703;Taip;5;5;0;10
13936;"Trakų Vokė";KIŠKUČIŲ;87781186373;Taip;5;5;0;10
13937;"Trakų Vokė";KIŠKUČIŲ;69866048102;Taip;7;0;0;7
13938;"Trakų Vokė";KIŠKUČIŲ;64083541565;Taip;5;5;0;10
13939;"Trakų Vokė";KIŠKUČIŲ;67434532111;Taip;10;6;0;16
13940;"Trakų Vokė";KIŠKUČIŲ;26598573711;Taip;12;0;0;12
13941;"Trakų Vokė";KIŠKUČIŲ;69311478204;Taip;10;0;3;13
13942;"Trakų Vokė";KIŠKUČIŲ;71417288063;Taip;0;0;17;17
13943;"Trakų Vokė";KIŠKUČIŲ;40200309769;Taip;4;0;0;4
13944;"Trakų Vokė";KIŠKUČIŲ;9705561511;Taip;10;0;0;10
13945;"Trakų Vokė";KIŠKUČIŲ;44023296535;Taip;7;2;0;9
13946;"Trakų Vokė";KIŠKUČIŲ;6418198934;Taip;20;0;0;20
13947;"Trakų Vokė";KIŠKUČIŲ;50697040061;Taip;0;12;0;12
13948;"Trakų Vokė";KIŠKUČIŲ;9135918587;Taip;0;5;0;5
13949;"Trakų Vokė";KIŠKUČIŲ;6362889550;Taip;9;0;3;12
13950;"Trakų Vokė";KIŠKUČIŲ;64019248229;Taip;4;0;0;4
13951;"Trakų Vokė";KIŠKUČIŲ;18796898215;Taip;5;5;0;10
13952;"Trakų Vokė";KIŠKUČIŲ;86504089176;Taip;8;0;1;9
13953;"Trakų Vokė";KIŠKUČIŲ;21329819892;Taip;19;0;0;19
13954;"Trakų Vokė";KIŠKUČIŲ;3210453801;Taip;5;5;0;10
13955;"Trakų Vokė";KIŠKUČIŲ;7753488216;Taip;17;0;1;18
13956;Zylutė;"Vesole misiaki";15597884044;Taip;1;2;0;3
13957;Zylutė;"Vesole misiaki";84947394033;Taip;0;6;0;6
13958;Zylutė;"Vesole misiaki";52918539110;Taip;4;3;0;7
13959;Zylutė;"Vesole misiaki";66338689682;Taip;0;9;0;9
13960;Zylutė;"Vesole misiaki";5323116194;Taip;9;1;0;10
13961;Zylutė;"Vesole misiaki";74314676598;Taip;0;4;0;4
13962;Zylutė;"Vesole misiaki";1911748280;Taip;6;0;0;6
13963;Zylutė;"Vesole misiaki";62887824954;Taip;18;0;0;18
13964;Zylutė;"Vesole misiaki";92871710315;Taip;8;0;0;8
13965;Zylutė;"Vesole misiaki";86301183281;Taip;0;7;0;7
13966;Zylutė;"Vesole misiaki";1623576857;Taip;7;0;0;7
13967;Zylutė;"Vesole misiaki";43690245314;Taip;0;6;0;6
13968;Zylutė;"Vesole misiaki";1256879956;Taip;2;1;0;3
13969;Zylutė;"Vesole misiaki";3126726854;Taip;12;0;0;12
13970;Zylutė;"Vesole misiaki";9484752315;Taip;0;9;0;9
13971;Zylutė;"Vesole misiaki";7140223126;Taip;0;6;0;6
13972;Zylutė;"Vesole misiaki";81796510706;Taip;2;2;0;4
13973;Zylutė;"Vesole misiaki";7606434084;Taip;0;3;0;3
13974;Zylutė;"Vesole misiaki";6299191475;Taip;0;8;0;8
13975;Zylutė;NYKŠTUKAI;88823731584;Ne;0;7;0;7
13976;Zylutė;NYKŠTUKAI;91938227358;Taip;0;16;0;16
13977;Zylutė;NYKŠTUKAI;55672880453;Taip;6;0;1;7
13978;Zylutė;NYKŠTUKAI;63798640792;Taip;0;9;0;9
13979;Zylutė;NYKŠTUKAI;19429820228;Taip;0;9;0;9
13980;Zylutė;NYKŠTUKAI;46013925783;Taip;5;0;0;5
13981;Zylutė;NYKŠTUKAI;89083249598;Taip;5;0;0;5
13982;Zylutė;NYKŠTUKAI;53165044678;Taip;0;5;0;5
13983;Zylutė;NYKŠTUKAI;42712894954;Taip;0;8;0;8
13984;Zylutė;NYKŠTUKAI;87231809477;Taip;0;0;10;10
13985;Zylutė;NYKŠTUKAI;1584743051;Taip;0;1;3;4
13986;Zylutė;NYKŠTUKAI;55136247841;Taip;0;5;1;6
13987;Zylutė;NYKŠTUKAI;1187261223;Taip;3;0;0;3
13988;Zylutė;NYKŠTUKAI;2276463136;Taip;10;5;0;15
13989;Zylutė;NYKŠTUKAI;7042731356;Taip;6;5;0;11
13990;Zylutė;NYKŠTUKAI;27488840113;Taip;0;5;0;5
13991;Zylutė;NYKŠTUKAI;35300054087;Taip;0;6;0;6
13992;Zylutė;NYKŠTUKAI;15110117571;Taip;20;0;0;20
13993;Zylutė;NYKŠTUKAI;1699222615;Taip;6;0;2;8
13994;Zylutė;NYKŠTUKAI;3246229837;Taip;0;3;3;6
13995;Zylutė;Ručijok;9913001904;Taip;10;9;0;19
13996;Zylutė;Ručijok;4415020772;Taip;6;0;0;6
13997;Zylutė;Ručijok;6221528830;Taip;20;0;0;20
13998;Zylutė;Ručijok;3608920051;Taip;0;3;0;3
13999;Zylutė;Ručijok;3117948118;Taip;0;8;0;8
14000;Zylutė;Ručijok;7241045507;Taip;0;1;4;5
14001;Zylutė;Ručijok;3826815202;Taip;8;5;0;13
14002;Zylutė;Ručijok;3943002728;Taip;10;0;0;10
14003;Zylutė;Ručijok;9381656201;Taip;0;7;0;7
14004;Zylutė;Ručijok;2654373943;Taip;5;0;0;5
14005;Zylutė;Ručijok;9325387975;Taip;10;2;0;12
14006;Zylutė;Ručijok;4497904128;Taip;13;6;0;19
14007;Zylutė;Ručijok;1423890598;Taip;10;0;0;10
14008;Zylutė;Ručijok;5264930854;Taip;0;10;0;10
14009;Zylutė;Ručijok;6569135467;Taip;10;0;3;13
14010;Zylutė;Ručijok;3363212754;Taip;0;2;6;8
14011;Zylutė;Raduga;31724596372;Taip;0;1;0;1
14012;Zylutė;Raduga;1598044320;Taip;9;0;0;9
14013;Zylutė;Raduga;1756267879;Taip;15;2;0;17
14014;Zylutė;Raduga;42101273435;Taip;7;1;0;8
14015;Zylutė;Raduga;71494345484;Taip;0;8;0;8
14016;Zylutė;Raduga;24566804095;Taip;10;6;0;16
14017;Zylutė;Raduga;54294082958;Taip;7;0;0;7
14018;Zylutė;Raduga;27116746304;Taip;2;14;0;16
14019;Zylutė;Raduga;31057429533;Taip;0;10;0;10
14020;Zylutė;Raduga;1035415228;Taip;0;8;0;8
14021;Zylutė;Raduga;1059365398;Taip;5;7;0;12
14022;Zylutė;Raduga;2092027180;Taip;0;13;0;13
14023;Zylutė;Raduga;60768660940;Taip;0;13;0;13
14024;Zylutė;Raduga;1840757726;Taip;5;9;0;14
14025;Zylutė;Raduga;78048289126;Taip;20;0;0;20
14026;Zylutė;Raduga;86343860903;Taip;0;9;0;9
14027;Zylutė;Raduga;6965021762;Taip;5;6;0;11
14028;Zylutė;Raduga;3179737181;Ne;5;5;0;10
14029;Zylutė;Raduga;1098174103;Taip;4;9;0;13
14030;Zylutė;Raduga;5202483589;Taip;0;6;0;6
14031;Zylutė;"Miki Maus";9457189905;Taip;15;1;0;16
14032;Zylutė;"Miki Maus";9664467134;Taip;7;0;0;7
14033;Zylutė;"Miki Maus";8336138549;Taip;0;10;0;10
14034;Zylutė;"Miki Maus";8638652914;Taip;0;7;0;7
14035;Zylutė;"Miki Maus";9953834483;Taip;0;5;0;5
14036;Zylutė;"Miki Maus";2445444641;Taip;10;7;0;17
14037;Zylutė;"Miki Maus";9908198854;Taip;5;6;0;11
14038;Zylutė;"Miki Maus";4493469560;Taip;20;0;0;20
14039;Zylutė;"Miki Maus";5027134228;Taip;0;13;0;13
14040;Zylutė;"Miki Maus";4715704693;Taip;0;5;0;5
14041;Zylutė;"Miki Maus";4543822765;Taip;0;8;0;8
14042;Zylutė;"Miki Maus";2968625045;Taip;5;0;0;5
14043;Zylutė;"Miki Maus";5369445077;Taip;0;5;1;6
14044;Zylutė;"Miki Maus";2092319455;Taip;20;0;0;20
14045;Zylutė;Solnyško;52293061924;Taip;0;16;0;16
14046;Zylutė;Solnyško;50784859977;Taip;0;5;0;5
14047;Zylutė;Solnyško;1212526573;Taip;0;4;0;4
14048;Zylutė;Solnyško;2020113161;Taip;3;0;0;3
14049;Zylutė;Solnyško;2058827699;Taip;0;10;0;10
14050;Zylutė;Solnyško;1328824849;Ne;0;1;0;1
14051;Zylutė;Solnyško;37968324911;Taip;0;6;0;6
14052;Zylutė;Solnyško;64228069840;Taip;2;0;0;2
14053;Zylutė;Solnyško;98295398362;Taip;6;7;0;13
14054;Zylutė;Solnyško;63287117036;Taip;0;7;0;7
14055;Zylutė;Solnyško;8582483538;Taip;10;2;0;12
14056;Zylutė;Solnyško;2910542367;Taip;0;5;0;5
14057;Zylutė;Solnyško;1979823314;Taip;9;10;0;19
14058;Zylutė;Solnyško;9728065395;Taip;0;5;0;5
14059;Zylutė;Solnyško;5090740854;Taip;5;12;0;17
14060;Zylutė;Motyliok;45252076215;Ne;15;3;0;18
14061;Zylutė;Motyliok;45779928616;Taip;10;5;0;15
14062;Zylutė;Motyliok;1001570452;Taip;4;0;0;4
14063;Zylutė;Motyliok;35364823312;Taip;0;7;0;7
14064;Zylutė;Motyliok;20333534526;Taip;5;7;0;12
14065;Zylutė;Motyliok;1897162912;Taip;4;0;0;4
14066;Zylutė;Motyliok;1801436436;Taip;0;14;0;14
14067;Zylutė;Motyliok;1445891751;Taip;2;4;0;6
14068;Zylutė;Motyliok;1284845681;Taip;9;5;0;14
14069;Zylutė;Motyliok;1873200936;Taip;5;2;0;7
14070;Zylutė;Motyliok;7298260831;Taip;0;2;0;2
14071;Zylutė;Motyliok;2306517891;Taip;10;4;0;14
14072;Zylutė;Motyliok;5803032683;Taip;10;0;0;10
14073;Zylutė;Motyliok;3089235413;Taip;20;0;0;20
14074;Zylutė;Motyliok;23826981323;Taip;18;0;0;18
14075;Zylutė;Motyliok;1094217042;Taip;18;0;0;18
14076;Zylutė;Motyliok;1145364380;Taip;18;0;0;18
14077;Zylutė;Motyliok;7712651566;Ne;0;9;0;9
14078;Zylutė;ŽVIRBLIUKAI;20569748356;Taip;5;1;0;6
14079;Zylutė;ŽVIRBLIUKAI;8783866036;Taip;5;1;0;6
14080;Zylutė;ŽVIRBLIUKAI;2274290871;Taip;0;13;0;13
14081;Zylutė;ŽVIRBLIUKAI;4154010905;Taip;8;0;0;8
14082;Zylutė;ŽVIRBLIUKAI;1972826928;Taip;0;2;0;2
14083;Zylutė;ŽVIRBLIUKAI;8018865138;Taip;6;3;0;9
14084;Zylutė;ŽVIRBLIUKAI;3074954453;Taip;5;0;0;5
14085;Zylutė;ŽVIRBLIUKAI;6865973084;Taip;0;1;5;6
14086;Zylutė;ŽVIRBLIUKAI;2744516236;Taip;0;3;0;3
14087;Zylutė;ŽVIRBLIUKAI;1939618217;Taip;5;1;0;6
14088;Zylutė;ŽVIRBLIUKAI;8627523283;Taip;5;0;2;7
14089;Zylutė;ŽVIRBLIUKAI;3606566852;Taip;6;5;0;11
14090;Zylutė;ŽVIRBLIUKAI;8874692591;Taip;5;5;0;10
14091;Zylutė;ŽVIRBLIUKAI;5431521522;Taip;18;2;0;20
14092;Zylutė;ŽVIRBLIUKAI;5386710069;Taip;20;0;0;20
14093;Zylutė;ŽVIRBLIUKAI;2792217953;Taip;3;1;0;4
14094;Zylutė;"DRUŽNYJE REBIATA";12377363480;Taip;16;0;0;16
14095;Zylutė;"DRUŽNYJE REBIATA";1428614163;Taip;11;1;0;12
14096;Zylutė;"DRUŽNYJE REBIATA";1674095701;Taip;10;0;0;10
14097;Zylutė;"DRUŽNYJE REBIATA";3379725202;Taip;6;0;0;6
14098;Zylutė;"DRUŽNYJE REBIATA";3843999609;Taip;4;5;0;9
14099;Zylutė;"DRUŽNYJE REBIATA";3036582121;Taip;0;10;0;10
14100;Zylutė;"DRUŽNYJE REBIATA";9163527400;Taip;0;10;0;10
14101;Zylutė;"DRUŽNYJE REBIATA";2157398751;Taip;0;0;1;1
14102;Zylutė;"DRUŽNYJE REBIATA";4302751308;Taip;0;14;0;14
14103;Zylutė;"DRUŽNYJE REBIATA";5452659798;Taip;0;9;0;9
14104;Zylutė;"DRUŽNYJE REBIATA";9589810356;Taip;6;1;0;7
14105;Zylutė;"DRUŽNYJE REBIATA";5224781417;Ne;7;4;0;11
14106;Zylutė;"DRUŽNYJE REBIATA";5162635301;Taip;2;6;0;8
14107;Zylutė;"DRUŽNYJE REBIATA";7023565057;Taip;5;6;0;11
14108;Zylutė;"DRUŽNYJE REBIATA";5641148690;Taip;7;8;0;15
14109;Zylutė;"DRUŽNYJE REBIATA";7804533930;Taip;6;0;0;6
14110;Zylutė;VIEVERSĖLIAI;2125519672;Taip;0;7;0;7
14111;Zylutė;VIEVERSĖLIAI;4505081448;Taip;5;0;0;5
14112;Zylutė;VIEVERSĖLIAI;2104570334;Taip;0;10;0;10
14113;Zylutė;VIEVERSĖLIAI;72716975865;Taip;0;1;0;1
14114;Zylutė;VIEVERSĖLIAI;3055559237;Taip;4;0;0;4
14115;Zylutė;VIEVERSĖLIAI;2125424949;Taip;10;2;0;12
14116;Zylutė;VIEVERSĖLIAI;6275164528;Taip;0;4;0;4
14117;Zylutė;VIEVERSĖLIAI;5172154642;Taip;7;2;0;9
14118;Zylutė;VIEVERSĖLIAI;2943888466;Taip;13;0;0;13
14119;Zylutė;VIEVERSĖLIAI;6907378757;Taip;0;1;0;1
14120;Zylutė;VIEVERSĖLIAI;6723650872;Taip;0;1;0;1
14121;Zylutė;VIEVERSĖLIAI;3810636967;Taip;20;0;0;20
14122;Zylutė;VIEVERSĖLIAI;6154352500;Taip;0;15;0;15
14123;Zylutė;VIEVERSĖLIAI;4016518230;Taip;10;0;0;10
14124;Zylutė;VIEVERSĖLIAI;9660898505;Taip;0;11;0;11
14125;Zylutė;VIEVERSĖLIAI;57138305703;Taip;0;9;0;9
14126;Zylutė;VIEVERSĖLIAI;5544338521;Taip;7;1;0;8
14127;Zylutė;VIEVERSĖLIAI;1897871944;Taip;0;5;0;5
14128;Zylutė;VIEVERSĖLIAI;4764295850;Taip;20;0;0;20
14129;Zylutė;VIEVERSĖLIAI;5687201052;Taip;0;5;0;5
14130;Zylutė;VIEVERSĖLIAI;1750040659;Taip;7;0;0;7
14131;Želmenėliai;Bitučių;43295789978;Taip;10;5;0;15
14132;Želmenėliai;Bitučių;97786398830;Taip;0;9;0;9
14133;Želmenėliai;Bitučių;66377316300;Taip;0;6;0;6
14134;Želmenėliai;Bitučių;8440363769;Taip;0;8;0;8
14135;Želmenėliai;Bitučių;14467050269;Taip;0;1;0;1
14136;Želmenėliai;Bitučių;77393977996;Taip;0;1;0;1
14137;Želmenėliai;Bitučių;36928282518;Taip;0;1;0;1
14138;Želmenėliai;Bitučių;1342057909;Taip;8;3;0;11
14139;Želmenėliai;Bitučių;83607110446;Taip;5;0;0;5
14140;Želmenėliai;Bitučių;93445022509;Taip;0;5;0;5
14141;Želmenėliai;Bitučių;1158828889;Taip;0;5;0;5
14142;Želmenėliai;Bitučių;3039903984;Ne;7;5;0;12
14143;Želmenėliai;Bitučių;5501491970;Taip;0;5;0;5
14144;Želmenėliai;Bitučių;1063647379;Ne;0;7;0;7
14145;Želmenėliai;Bitučių;71088679480;Taip;5;2;0;7
14146;Želmenėliai;Bitučių;7911857247;Taip;0;1;0;1
14147;Želmenėliai;Kačiukų;55423287751;Taip;0;12;0;12
14148;Želmenėliai;Kačiukų;53611793303;Taip;3;1;0;4
14149;Želmenėliai;Kačiukų;6806260100;Taip;0;5;0;5
14150;Želmenėliai;Kačiukų;25991128602;Taip;5;2;0;7
14151;Želmenėliai;Kačiukų;50204719384;Taip;0;12;0;12
14152;Želmenėliai;Kačiukų;54492404542;Taip;5;0;0;5
14153;Želmenėliai;Kačiukų;40147904205;Taip;3;1;0;4
14154;Želmenėliai;Kačiukų;84671486637;Taip;0;4;0;4
14155;Želmenėliai;Kačiukų;75215159489;Taip;0;11;0;11
14156;Želmenėliai;Kačiukų;68168210430;Taip;9;1;1;11
14157;Želmenėliai;Kačiukų;52474082386;Taip;0;6;0;6
14158;Želmenėliai;Kačiukų;32945118976;Taip;20;0;0;20
14159;Želmenėliai;Kačiukų;72091418618;Taip;0;1;0;1
14160;Želmenėliai;Kačiukų;72029098066;Taip;0;5;0;5
14161;Želmenėliai;Kačiukų;80129197524;Ne;8;1;0;9
14162;Želmenėliai;Kačiukų;59968327015;Taip;10;0;0;10
14163;Želmenėliai;Kačiukų;93374623931;Ne;0;1;0;1
14164;Želmenėliai;Kačiukų;25744693727;Taip;9;5;0;14
14165;Želmenėliai;Kačiukų;41941728755;Taip;0;0;1;1
14166;Želmenėliai;Kačiukų;2005437403;Taip;0;12;0;12
14167;Želmenėliai;Kačiukų;1744939559;Taip;0;2;0;2
14168;Želmenėliai;Kačiukų;27187464726;Taip;7;0;0;7
14169;Želmenėliai;Voveriukų;1064518850;Taip;0;2;0;2
14170;Želmenėliai;Voveriukų;11316462529;Taip;4;0;1;5
14171;Želmenėliai;Voveriukų;2066711124;Taip;6;1;0;7
14172;Želmenėliai;Voveriukų;5696221669;Taip;0;5;0;5
14173;Želmenėliai;Voveriukų;51689349222;Taip;4;1;0;5
14174;Želmenėliai;Voveriukų;1799477959;Taip;0;6;0;6
14175;Želmenėliai;Voveriukų;98487229210;Taip;0;5;0;5
14176;Želmenėliai;Voveriukų;56814748796;Taip;0;6;0;6
14177;Želmenėliai;Voveriukų;39766114351;Taip;4;2;0;6
14178;Želmenėliai;Voveriukų;21263242044;Taip;0;5;0;5
14179;Želmenėliai;Voveriukų;68226657214;Taip;0;2;0;2
14180;Želmenėliai;Voveriukų;1619190849;Taip;0;12;0;12
14181;Želmenėliai;Voveriukų;1868937175;Taip;10;0;0;10
14182;Želmenėliai;Voveriukų;77946540922;Taip;5;0;0;5
14183;Želmenėliai;Voveriukų;8218755050;Taip;6;5;0;11
14184;Želmenėliai;Voveriukų;3258904017;Taip;0;8;0;8
14185;Želmenėliai;Voveriukų;6783113916;Taip;0;13;0;13
14186;Želmenėliai;Ežiukų;63879513374;Ne;0;9;0;9
14187;Želmenėliai;Ežiukų;12336777368;Ne;0;2;0;2
14188;Želmenėliai;Ežiukų;65633625929;Taip;0;7;0;7
14189;Želmenėliai;Ežiukų;5345737656;Taip;0;8;0;8
14190;Želmenėliai;Ežiukų;34529381726;Taip;0;0;4;4
14191;Želmenėliai;Ežiukų;21874165481;Taip;0;2;0;2
14192;Želmenėliai;Ežiukų;16400566719;Taip;10;6;0;16
14193;Želmenėliai;Ežiukų;2265545469;Taip;5;8;0;13
14194;Želmenėliai;Ežiukų;28030110904;Taip;0;14;0;14
14195;Želmenėliai;Ežiukų;22209426414;Taip;0;6;0;6
14196;Želmenėliai;Ežiukų;95095279050;Taip;0;6;0;6
14197;Želmenėliai;Ežiukų;21636460884;Taip;0;9;0;9
14198;Želmenėliai;Ežiukų;4699944934;Taip;0;1;0;1
14199;Želmenėliai;Ežiukų;90992236935;Taip;5;6;0;11
14200;Želmenėliai;Ežiukų;8394779853;Taip;0;20;0;20
14201;Želmenėliai;Ežiukų;1425695010;Taip;0;6;0;6
14202;Želmenėliai;Ežiukų;9234190447;Taip;0;2;0;2
14203;Želmenėliai;Ežiukų;69811395333;Taip;5;7;0;12
14204;Želmenėliai;Ežiukų;1369976001;Taip;0;15;0;15
14205;Želmenėliai;Ežiukų;8478954608;Taip;0;15;0;15
14206;Želmenėliai;Ežiukų;1799391978;Taip;0;15;0;15
14207;Želmenėliai;Ežiukų;10686783804;Taip;4;7;0;11
14208;Želmenėliai;Peledžiukų;4206128805;Taip;9;6;0;15
14209;Želmenėliai;Peledžiukų;6816346946;Taip;5;2;0;7
14210;Želmenėliai;Peledžiukų;9359070885;Taip;8;0;0;8
14211;Želmenėliai;Peledžiukų;2727113833;Taip;9;0;0;9
14212;Želmenėliai;Peledžiukų;2428447892;Taip;6;7;0;13
14213;Želmenėliai;Peledžiukų;5787772212;Taip;6;5;0;11
14214;Želmenėliai;Peledžiukų;1239398642;Taip;5;6;0;11
14215;Želmenėliai;Peledžiukų;29112205705;Taip;5;1;0;6
14216;Želmenėliai;Peledžiukų;1248541555;Taip;5;1;0;6
14217;Želmenėliai;Peledžiukų;8995804360;Taip;0;5;0;5
14218;Želmenėliai;Peledžiukų;1522141057;Taip;10;5;0;15
14219;Želmenėliai;Peledžiukų;5616709457;Taip;15;0;0;15
14220;Želmenėliai;Peledžiukų;8300887366;Taip;5;1;0;6
14221;Želmenėliai;Peledžiukų;96660519820;Taip;6;5;0;11
14222;Želmenėliai;Peledžiukų;5842563754;Taip;11;2;0;13
14223;Želmenėliai;Peledžiukų;9375550172;Taip;5;3;0;8
14224;Želmenėliai;Peledžiukų;8478564831;Taip;6;2;0;8
14225;Želmenėliai;Peledžiukų;5638817349;Taip;5;1;0;6
14226;Želmenėliai;Peledžiukų;1941723687;Taip;14;1;0;15
14227;Želmenėliai;Peledžiukų;8590746750;Taip;5;0;0;5
14228;Želmenėliai;Drugelių;7664430346;Taip;15;0;0;15
14229;Želmenėliai;Drugelių;3417538909;Taip;0;2;0;2
14230;Želmenėliai;Drugelių;3295852546;Taip;9;0;0;9
14231;Želmenėliai;Drugelių;4739083871;Taip;6;0;0;6
14232;Želmenėliai;Drugelių;3379266015;Taip;0;7;0;7
14233;Želmenėliai;Drugelių;3737786832;Taip;14;0;0;14
14234;Želmenėliai;Drugelių;5633127620;Taip;0;18;0;18
14235;Želmenėliai;Drugelių;1984105453;Taip;11;5;0;16
14236;Želmenėliai;Drugelių;1920917916;Taip;11;2;0;13
14237;Želmenėliai;Drugelių;4652412483;Taip;0;0;5;5
14238;Želmenėliai;Drugelių;1652949383;Taip;0;4;0;4
14239;Želmenėliai;Drugelių;5046836398;Taip;5;1;0;6
14240;Želmenėliai;Drugelių;9237611484;Taip;6;8;1;15
14241;Želmenėliai;Drugelių;13558387807;Taip;3;6;0;9
14242;Želmenėliai;Drugelių;5143554665;Taip;6;3;0;9
14243;Želmenėliai;Drugelių;7585159351;Taip;6;6;0;12
14244;Želmenėliai;Drugelių;9207984505;Taip;5;0;0;5
14245;Želmenėliai;Drugelių;4634346755;Taip;5;6;1;12
14246;Želmenėliai;Drugelių;4916436238;Taip;0;14;0;14
14247;Želmenėliai;Drugelių;5558795651;Taip;18;0;0;18
14248;Želmenėliai;Voriukų;94772390737;Taip;0;2;0;2
14249;Želmenėliai;Voriukų;95258645888;Taip;10;7;0;17
14250;Želmenėliai;Voriukų;52040816124;Taip;0;6;0;6
14251;Želmenėliai;Voriukų;26335599312;Taip;2;6;0;8
14252;Želmenėliai;Voriukų;13690223482;Taip;2;0;0;2
14253;Želmenėliai;Voriukų;92945999406;Ne;1;5;0;6
14254;Želmenėliai;Voriukų;26377076407;Taip;0;4;0;4
14255;Želmenėliai;Voriukų;25839440205;Taip;0;4;0;4
14256;Želmenėliai;Voriukų;1494996935;Taip;0;13;0;13
14257;Želmenėliai;Voriukų;7587565685;Taip;3;2;4;9
14258;Želmenėliai;Voriukų;1299167028;Taip;0;8;0;8
14259;Želmenėliai;Boružėlių;51756630728;Taip;0;12;0;12
14260;Želmenėliai;Boružėlių;22539846993;Taip;10;0;0;10
14261;Želmenėliai;Boružėlių;91372955120;Taip;10;1;0;11
14262;Želmenėliai;Boružėlių;2898358705;Taip;0;1;0;1
14263;Želmenėliai;Boružėlių;63043069680;Taip;4;1;0;5
14264;Želmenėliai;Boružėlių;10462964817;Taip;0;2;0;2
14265;Želmenėliai;Boružėlių;2103938312;Taip;0;5;0;5
14266;Želmenėliai;Boružėlių;35901929384;Taip;0;6;0;6
14267;Želmenėliai;Boružėlių;39675390598;Taip;0;1;0;1
14268;Želmenėliai;Boružėlių;1290780920;Taip;10;5;0;15
14269;Želmenėliai;Boružėlių;1699958696;Taip;0;14;0;14
14270;Želmenėliai;Boružėlių;98852944217;Taip;0;5;0;5
14271;Želmenėliai;Boružėlių;7502363323;Ne;6;6;0;12
14272;Želmenėliai;Boružėlių;1009164107;Taip;0;17;0;17
14273;Želmenėliai;Boružėlių;92486344928;Taip;0;11;0;11
14274;Želmenėliai;Boružėlių;1802714172;Taip;0;5;0;5
14275;Želmenėliai;Boružėlių;1686751892;Taip;20;0;0;20
14276;Želmenėliai;Boružėlių;1044902564;Ne;5;5;0;10
14277;Želmenėliai;Boružėlių;1933769076;Taip;10;0;0;10
14278;Želmenėliai;Boružėlių;1134743316;Taip;0;2;0;2
14279;Želmenėliai;Boružėlių;9414488405;Taip;15;5;0;20
14280;Želmenėliai;Pūkuotukų;73813829491;Taip;20;0;0;20
14281;Želmenėliai;Pūkuotukų;79879695958;Taip;0;9;0;9
14282;Želmenėliai;Pūkuotukų;54536849345;Taip;0;10;0;10
14283;Želmenėliai;Pūkuotukų;8936734213;Taip;12;0;0;12
14284;Želmenėliai;Pūkuotukų;1213403598;Taip;15;0;0;15
14285;Želmenėliai;Pūkuotukų;1803684569;Taip;5;5;0;10
14286;Želmenėliai;Pūkuotukų;1716801722;Taip;0;16;0;16
14287;Želmenėliai;Pūkuotukų;45440599686;Taip;0;5;0;5
14288;Želmenėliai;Pūkuotukų;50805473649;Taip;0;10;0;10
14289;Želmenėliai;Pūkuotukų;1405460015;Taip;0;5;0;5
14290;Želmenėliai;Pūkuotukų;85619767784;Taip;6;7;0;13
14291;Želmenėliai;Pūkuotukų;1800724034;Taip;0;7;0;7
14292;Želmenėliai;Pūkuotukų;74037118861;Taip;0;7;0;7
14293;Želmenėliai;Pūkuotukų;8706951420;Taip;10;2;0;12
14294;Želmenėliai;Pūkuotukų;7737877729;Taip;0;4;0;4
14295;Želmenėliai;Pūkuotukų;1426827854;Taip;0;6;0;6
14296;Želmenėliai;Pūkuotukų;1619412305;Taip;0;2;0;2
14297;Želmenėliai;Pūkuotukų;75198661944;Taip;0;7;0;7
14298;Želmenėliai;Pūkuotukų;2036184590;Taip;4;5;0;9
14299;Želmenėliai;Pūkuotukų;72855365141;Taip;0;1;0;1
14300;Želmenėliai;Pūkuotukų;22138795060;Taip;0;7;0;7
14301;Želmenėliai;Pūkuotukų;37152467004;Taip;0;4;0;4
14302;Želmenėliai;Ančiukų;1203343580;Taip;2;6;0;8
14303;Želmenėliai;Ančiukų;1614791794;Taip;0;1;0;1
14304;Želmenėliai;Ančiukų;4264751761;Taip;0;5;0;5
14305;Želmenėliai;Ančiukų;7940403585;Taip;6;5;0;11
14306;Želmenėliai;Ančiukų;3184074698;Taip;3;1;0;4
14307;Želmenėliai;Ančiukų;2570248893;Taip;0;11;0;11
14308;Želmenėliai;Ančiukų;3014568232;Taip;4;1;0;5
14309;Želmenėliai;Ančiukų;7563461821;Taip;0;19;0;19
14310;Želmenėliai;Ančiukų;4545012342;Taip;0;5;0;5
14311;Želmenėliai;Ančiukų;8504963337;Taip;0;10;0;10
14312;Želmenėliai;Ančiukų;9351650342;Taip;10;6;0;16
14313;Želmenėliai;Ančiukų;2577850672;Taip;13;0;0;13
14314;Želmenėliai;Ančiukų;4534946646;Taip;20;0;0;20
14315;Želmenėliai;Ančiukų;2111008869;Taip;3;5;0;8
14316;Želmenėliai;Ančiukų;4075533071;Taip;6;7;0;13
14317;Želmenėliai;Ančiukų;6916426436;Taip;0;2;0;2
14318;Želmenėliai;Nykštukų;9611741258;Taip;5;3;0;8
14319;Želmenėliai;Nykštukų;1619143702;Taip;10;5;0;15
14320;Želmenėliai;Nykštukų;9825545754;Taip;15;2;0;17
14321;Želmenėliai;Nykštukų;2794274146;Taip;13;2;0;15
14322;Želmenėliai;Nykštukų;3810550099;Taip;20;0;0;20
14323;Želmenėliai;Nykštukų;2846903449;Taip;10;0;0;10
14324;Želmenėliai;Nykštukų;4473677352;Taip;15;1;0;16
14325;Želmenėliai;Nykštukų;8973215240;Taip;9;1;0;10
14326;Želmenėliai;Nykštukų;7505996978;Taip;14;5;0;19
14327;Želmenėliai;Nykštukų;7955645490;Taip;0;8;0;8
14328;Želmenėliai;Nykštukų;5314438217;Taip;5;2;0;7
14329;Želmenėliai;Nykštukų;9995500724;Taip;0;8;0;8
14330;Želmenėliai;Lašelių;6799702725;Taip;10;2;0;12
14331;Želmenėliai;Lašelių;7423900312;Taip;10;5;0;15
14332;Želmenėliai;Lašelių;8358780570;Taip;7;0;0;7
14333;Želmenėliai;Lašelių;2122665619;Taip;2;0;0;2
14334;Želmenėliai;Lašelių;9006406225;Taip;3;7;0;10
14335;Želmenėliai;Lašelių;2102401372;Taip;8;0;0;8
14336;Želmenėliai;Lašelių;5171736943;Taip;0;9;0;9
14337;Želmenėliai;Lašelių;4931835807;Taip;0;8;0;8
14338;Želmenėliai;Lašelių;5147895081;Taip;12;0;0;12
14339;Želmenėliai;Lašelių;7957790300;Taip;5;5;0;10
14340;Želmenėliai;Lašelių;6481952132;Taip;10;0;0;10
14341;Želmenėliai;Lašelių;9126715074;Taip;3;2;0;5
14342;Želmenėliai;Lašelių;2563117992;Taip;7;0;0;7
14343;Želmenėliai;Lašelių;6180553648;Taip;0;10;0;10
14344;Želmenėliai;Lašelių;5211426226;Taip;16;0;0;16
14345;Žemyna;Čiauškučiai;85617781303;Taip;0;0;1;1
14346;Žemyna;Čiauškučiai;62565967575;Taip;5;1;0;6
14347;Žemyna;Čiauškučiai;25099273803;Taip;0;5;0;5
14348;Žemyna;Čiauškučiai;49793977825;Taip;0;8;0;8
14349;Žemyna;Čiauškučiai;10288969939;Taip;1;5;0;6
14350;Žemyna;Čiauškučiai;40843229500;Taip;5;4;0;9
14351;Žemyna;Čiauškučiai;69690099920;Taip;4;1;0;5
14352;Žemyna;Čiauškučiai;98477626952;Taip;0;5;3;8
14353;Žemyna;Čiauškučiai;71013970407;Taip;0;6;0;6
14354;Žemyna;Čiauškučiai;56418377668;Taip;0;5;0;5
14355;Žemyna;Čiauškučiai;46550223916;Taip;1;0;0;1
14356;Žemyna;Čiauškučiai;98919412716;Taip;2;0;2;4
14357;Žemyna;Čiauškučiai;1535497308;Taip;3;0;0;3
14358;Žemyna;Čiauškučiai;89754744294;Taip;0;5;0;5
14359;Žemyna;Čiauškučiai;1790109762;Taip;0;1;0;1
14360;Žemyna;Čiauškučiai;83056273504;Taip;2;5;0;7
14361;Žemyna;Čiauškučiai;1866645242;Taip;0;0;3;3
14362;Žemyna;Čiauškučiai;1609941314;Taip;5;0;0;5
14363;Žemyna;Čiauškučiai;1917294883;Taip;0;2;0;2
14364;Žemyna;Čiauškučiai;1393006122;Taip;0;0;2;2
14365;Žemyna;Čiauškučiai;9409512255;Taip;2;15;0;17
14366;Žemyna;Nykštukai;69634515292;Taip;0;2;0;2
14367;Žemyna;Nykštukai;65677663175;Taip;18;0;0;18
14368;Žemyna;Nykštukai;74969696164;Taip;0;7;0;7
14369;Žemyna;Nykštukai;47974278492;Taip;0;5;2;7
14370;Žemyna;Nykštukai;92159859248;Taip;5;5;1;11
14371;Žemyna;Nykštukai;10344263960;Taip;7;0;1;8
14372;Žemyna;Nykštukai;54029612806;Taip;0;8;0;8
14373;Žemyna;Nykštukai;93378737171;Taip;0;1;0;1
14374;Žemyna;Nykštukai;5204796908;Taip;0;5;0;5
14375;Žemyna;Nykštukai;9556275322;Taip;4;1;0;5
14376;Žemyna;Nykštukai;81683768388;Taip;6;0;0;6
14377;Žemyna;Nykštukai;65117735882;Taip;10;5;0;15
14378;Žemyna;Nykštukai;59441904717;Taip;5;0;0;5
14379;Žemyna;Nykštukai;97712802830;Taip;5;2;0;7
14380;Žemyna;Nykštukai;70694756261;Taip;7;5;1;13
14381;Žemyna;Nykštukai;30518889603;Taip;0;0;1;1
14382;Žemyna;Nykštukai;7670120949;Taip;11;0;1;12
14383;Žemyna;Nykštukai;78280621543;Taip;4;6;0;10
14384;Žemyna;Nykštukai;68982161758;Taip;3;0;2;5
14385;Žemyna;Nykštukai;1674165765;Taip;7;6;0;13
14386;Žemyna;Nykštukai;43708641831;Taip;20;0;0;20
14387;Žemyna;Nykštukai;2033947862;Taip;5;5;0;10
14388;Žemyna;Nykštukai;1337500221;Taip;4;3;0;7
14389;Žemyna;Voveriukai;3135562485;Taip;2;0;0;2
14390;Žemyna;Voveriukai;2976467316;Taip;4;0;1;5
14391;Žemyna;Voveriukai;5940619734;Taip;4;0;0;4
14392;Žemyna;Voveriukai;6812823390;Taip;3;1;0;4
14393;Žemyna;Voveriukai;8500642069;Taip;10;1;0;11
14394;Žemyna;Voveriukai;6430348135;Taip;5;0;0;5
14395;Žemyna;Voveriukai;7925774308;Taip;0;0;1;1
14396;Žemyna;Voveriukai;2412956023;Taip;3;1;0;4
14397;Žemyna;Voveriukai;3938938667;Taip;5;0;0;5
14398;Žemyna;Voveriukai;9958040413;Taip;17;0;1;18
14399;Žemyna;Voveriukai;1531980297;Taip;10;0;5;15
14400;Žemyna;Voveriukai;1114714466;Taip;5;0;5;10
14401;Žemyna;Voveriukai;1807466584;Taip;4;0;2;6
14402;Žemyna;Voveriukai;1543415914;Taip;3;0;5;8
14403;Žemyna;Voveriukai;9148594407;Taip;15;1;3;19
14404;Žemyna;Voveriukai;6701717634;Taip;5;5;0;10
14405;Žemyna;Voveriukai;9866110744;Taip;0;0;2;2
14406;Žemyna;Voveriukai;1118997229;Taip;11;0;1;12
14407;Žemyna;Kiškučiai;85577156077;Taip;0;5;2;7
14408;Žemyna;Kiškučiai;99073448709;Taip;0;2;0;2
14409;Žemyna;Kiškučiai;48525793006;Taip;2;5;0;7
14410;Žemyna;Kiškučiai;34426901653;Taip;3;0;5;8
14411;Žemyna;Kiškučiai;10048697347;Taip;10;5;1;16
14412;Žemyna;Kiškučiai;11629931607;Taip;0;3;0;3
14413;Žemyna;Kiškučiai;26634432947;Taip;4;9;0;13
14414;Žemyna;Kiškučiai;35576046194;Taip;0;1;0;1
14415;Žemyna;Kiškučiai;70742074799;Taip;5;0;0;5
14416;Žemyna;Kiškučiai;81211805661;Taip;6;0;0;6
14417;Žemyna;Kiškučiai;54667537300;Taip;0;3;0;3
14418;Žemyna;Kiškučiai;81784082355;Taip;0;0;4;4
14419;Žemyna;Kiškučiai;57614960761;Taip;5;0;5;10
14420;Žemyna;Kiškučiai;83232054566;Taip;4;0;1;5
14421;Žemyna;Kiškučiai;5140727629;Taip;0;3;0;3
14422;Žemyna;Kiškučiai;89531266711;Taip;0;0;5;5
14423;Žemyna;Kiškučiai;5730670827;Taip;6;6;0;12
14424;Žemyna;Kiškučiai;6766660258;Taip;10;5;0;15
14425;Žemyna;Kiškučiai;17162551563;Taip;2;0;0;2
14426;Žemyna;Kiškučiai;69734268809;Taip;5;1;0;6
14427;Žemyna;Kiškučiai;4928267472;Taip;6;5;3;14
14428;Žemyna;Vyturiukai;9232638767;Taip;6;0;4;10
14429;Žemyna;Vyturiukai;38769607968;Taip;6;6;0;12
14430;Žemyna;Vyturiukai;47470155594;Taip;3;0;5;8
14431;Žemyna;Vyturiukai;17098859260;Taip;7;4;0;11
14432;Žemyna;Vyturiukai;1687206394;Taip;10;0;2;12
14433;Žemyna;Vyturiukai;5508251792;Taip;2;0;0;2
14434;Žemyna;Vyturiukai;85135645557;Taip;5;2;1;8
14435;Žemyna;Vyturiukai;59506345859;Taip;0;4;0;4
14436;Žemyna;Vyturiukai;89787441782;Taip;5;1;0;6
14437;Žemyna;Vyturiukai;41538301616;Taip;5;3;2;10
14438;Žemyna;Vyturiukai;5506889213;Taip;0;2;0;2
14439;Žemyna;Vyturiukai;5306392307;Taip;9;6;0;15
14440;Žemyna;Vyturiukai;37570629861;Taip;5;11;0;16
14441;Žemyna;Vyturiukai;13242930752;Taip;2;5;0;7
14442;Žemyna;Vyturiukai;96473502730;Taip;12;0;2;14
14443;Žemyna;Vyturiukai;94548785045;Taip;9;0;0;9
14444;Žemyna;Vyturiukai;93423088394;Taip;0;12;0;12
14445;Žemyna;Vyturiukai;8040359407;Taip;8;0;0;8
14446;Žemyna;Vyturiukai;55161890341;Taip;10;5;0;15
14447;Žemyna;Vyturiukai;6618285685;Taip;0;0;3;3
14448;Žemyna;Vyturiukai;4524929331;Taip;9;0;0;9
14449;Žemyna;Pelėdžiukai;8415482981;Taip;5;5;1;11
14450;Žemyna;Pelėdžiukai;24282185059;Taip;0;0;1;1
14451;Žemyna;Pelėdžiukai;91945722729;Taip;0;10;0;10
14452;Žemyna;Pelėdžiukai;74855676264;Taip;0;5;0;5
14453;Žemyna;Pelėdžiukai;36180811193;Taip;0;2;0;2
14454;Žemyna;Pelėdžiukai;80111906824;Taip;8;1;0;9
14455;Žemyna;Pelėdžiukai;61994998037;Taip;1;0;0;1
14456;Žemyna;Pelėdžiukai;36616512238;Taip;3;6;0;9
14457;Žemyna;Pelėdžiukai;30019743988;Taip;0;4;0;4
14458;Žemyna;Pelėdžiukai;29377805386;Taip;2;0;0;2
14459;Žemyna;Pelėdžiukai;51131984130;Ne;0;1;0;1
14460;Žemyna;Pelėdžiukai;68149716927;Taip;5;1;0;6
14461;Žemyna;Pelėdžiukai;67275465624;Taip;0;3;0;3
14462;Žemyna;Pelėdžiukai;55015285610;Taip;8;3;0;11
14463;Žemyna;Pelėdžiukai;46049323529;Taip;14;0;0;14
14464;Žemyna;Pelėdžiukai;4680528929;Taip;8;8;0;16
14465;Žemyna;Pelėdžiukai;1218163998;Taip;10;0;4;14
14466;Žemyna;Pelėdžiukai;5183028594;Taip;0;5;2;7
14467;Žemyna;Pelėdžiukai;1717113454;Taip;0;5;1;6
14468;Žemyna;Vijurkai;3601375855;Taip;11;5;0;16
14469;Žemyna;Vijurkai;64499886011;Taip;0;10;0;10
14470;Žemyna;Vijurkai;38602852015;Taip;9;0;0;9
14471;Žemyna;Vijurkai;95274028121;Taip;0;0;2;2
14472;Žemyna;Vijurkai;1015193590;Taip;8;5;1;14
14473;Žemyna;Vijurkai;64066518112;Taip;0;5;1;6
14474;Žemyna;Vijurkai;62651324131;Taip;10;5;0;15
14475;Žemyna;Vijurkai;38352111116;Taip;0;4;1;5
14476;Žemyna;Vijurkai;43441615793;Taip;9;0;0;9
14477;Žemyna;Vijurkai;1197264568;Taip;0;3;0;3
14478;Žemyna;Vijurkai;36873572743;Taip;6;2;0;8
14479;Žemyna;Vijurkai;63747644828;Taip;0;6;0;6
14480;Žemyna;Vijurkai;1725097139;Taip;0;0;2;2
14481;Žemyna;Vijurkai;31365442622;Taip;0;2;0;2
14482;Žemyna;Vijurkai;76258813568;Taip;8;0;0;8
14483;Žemyna;Vijurkai;42384634418;Taip;8;0;0;8
14484;Žemyna;Vijurkai;38576112962;Taip;8;0;0;8
14485;Žemyna;Vijurkai;22741981912;Taip;0;5;0;5
14486;Žemyna;Vijurkai;80070453149;Taip;0;2;0;2
14487;Žemyna;Vijurkai;60321336886;Taip;8;5;0;13
14488;Žemyna;Šnekučiai;88775150201;Taip;5;0;1;6
14489;Žemyna;Šnekučiai;8096035110;Taip;3;0;1;4
14490;Žemyna;Šnekučiai;1694969407;Taip;0;0;1;1
14491;Žemyna;Šnekučiai;58578414067;Taip;0;0;1;1
14492;Žemyna;Šnekučiai;9130965949;Taip;0;5;0;5
14493;Žemyna;Šnekučiai;1683299408;Taip;2;7;0;9
14494;Žemyna;Šnekučiai;39175264243;Taip;0;1;0;1
14495;Žemyna;Šnekučiai;35462796459;Taip;0;0;1;1
14496;Žemyna;Šnekučiai;50543973728;Taip;6;0;0;6
14497;Žemyna;Šnekučiai;6448628301;Taip;5;3;0;8
14498;Žemyna;Šnekučiai;47562685723;Taip;1;5;1;7
14499;Žemyna;Šnekučiai;32755929074;Taip;0;10;0;10
14500;Žemyna;Šnekučiai;54253890981;Taip;5;0;1;6
14501;Žemyna;Šnekučiai;54823974018;Taip;6;0;0;6
14502;Žemyna;Šnekučiai;1049546597;Taip;3;5;0;8
14503;Žemyna;Šnekučiai;99015221693;Taip;0;4;1;5
14504;Žemyna;Šnekučiai;38604851102;Taip;10;0;2;12
14505;Žemyna;Šnekučiai;2003368811;Taip;2;0;0;2
14506;Žemyna;Šnekučiai;1305667359;Taip;0;0;3;3
14507;Žemyna;Šnekučiai;6089122225;Taip;0;5;0;5
14508;Žemyna;Šnekučiai;55748223762;Taip;0;3;0;3
14509;Žemyna;Pabiručiai;88687293547;Taip;7;1;0;8
14510;Žemyna;Pabiručiai;43607772302;Taip;0;5;0;5
14511;Žemyna;Pabiručiai;1210307182;Taip;0;4;0;4
14512;Žemyna;Pabiručiai;1265326169;Taip;6;0;0;6
14513;Žemyna;Pabiručiai;4570281722;Taip;20;0;0;20
14514;Žemyna;Pabiručiai;2073608501;Taip;7;4;0;11
14515;Žemyna;Pabiručiai;92534877861;Taip;3;0;0;3
14516;Žemyna;Pabiručiai;75681135185;Taip;8;5;0;13
14517;Žemyna;Pabiručiai;3596822649;Taip;5;0;0;5
14518;Žemyna;Pabiručiai;86746604640;Taip;6;0;0;6
14519;Žemyna;Pabiručiai;82507236376;Taip;1;5;0;6
14520;Žemyna;Pabiručiai;84955588471;Taip;8;0;0;8
14521;Žemyna;Pabiručiai;80737839511;Taip;5;1;0;6
14522;Žemyna;Pabiručiai;82479499709;Taip;2;0;0;2
14523;Žemyna;Pabiručiai;60610765717;Taip;6;0;1;7
14524;Žemyna;Pabiručiai;14902924855;Taip;8;4;1;13
14525;Žemyna;Pabiručiai;1847882950;Taip;0;0;2;2
14526;Žemyna;Pabiručiai;15573695823;Taip;0;5;0;5
14527;Žemyna;Pabiručiai;2072914123;Taip;0;5;0;5
14528;Žemyna;Pabiručiai;50687988382;Taip;3;7;0;10
14529;Žemyna;Drugeliai;72801825176;Taip;3;6;0;9
14530;Žemyna;Drugeliai;2100326039;Taip;12;0;0;12
14531;Žemyna;Drugeliai;1571182096;Taip;0;6;1;7
14532;Žemyna;Drugeliai;1471204471;Taip;5;4;0;9
14533;Žemyna;Drugeliai;1882507954;Taip;8;0;0;8
14534;Žemyna;Drugeliai;1607110213;Taip;4;0;0;4
14535;Žemyna;Drugeliai;1623854426;Taip;0;1;0;1
14536;Žemyna;Drugeliai;50369667193;Taip;5;4;0;9
14537;Žemyna;Drugeliai;1705971732;Taip;0;0;1;1
14538;Žemyna;Drugeliai;17784132877;Taip;8;0;2;10
14539;Žemyna;Drugeliai;97625732866;Taip;5;0;1;6
14540;Žemyna;Drugeliai;45222048620;Taip;0;0;1;1
14541;Žemyna;Drugeliai;1654912072;Taip;5;0;0;5
14542;Žemyna;Drugeliai;1968337404;Taip;0;6;0;6
14543;Žemyna;Drugeliai;51870099224;Taip;6;1;0;7
14544;Žemyna;Drugeliai;1941650167;Taip;0;0;6;6
14545;Žemyna;Drugeliai;9970500518;Taip;10;0;2;12
14546;Žemyna;Drugeliai;1541156624;Taip;10;0;0;10
14547;Žemyna;Drugeliai;2113826378;Taip;0;12;4;16
14548;Žemyna;Drugeliai;1867198805;Taip;7;2;0;9
14549;Žemyna;"ŽIRNIUKAI ";6116581655;Taip;10;0;0;10
14550;Žemyna;"ŽIRNIUKAI ";6856737270;Taip;3;0;1;4
14551;Žemyna;"ŽIRNIUKAI ";9912869400;Taip;16;0;1;17
14552;Žemyna;"ŽIRNIUKAI ";9818711030;Taip;6;0;2;8
14553;Žemyna;"ŽIRNIUKAI ";9219519029;Taip;12;4;0;16
14554;Žemyna;"ŽIRNIUKAI ";6293560729;Taip;15;0;0;15
14555;Žemyna;"ŽIRNIUKAI ";5868208651;Taip;10;0;1;11
14556;Žemyna;"ŽIRNIUKAI ";5188496664;Taip;13;0;0;13
14557;Žemyna;"ŽIRNIUKAI ";7764615445;Taip;9;0;2;11
14558;Žemyna;"ŽIRNIUKAI ";9668975591;Taip;7;0;0;7
14559;Žemyna;"ŽIRNIUKAI ";7367602247;Taip;3;4;0;7
14560;Žemyna;"ŽIRNIUKAI ";7280740926;Taip;14;0;0;14
14561;Žemyna;"ŽIRNIUKAI ";6419974691;Taip;5;0;0;5
14562;Žemyna;"ŽIRNIUKAI ";2006173745;Taip;0;0;1;1
14563;Žemyna;"ŽIRNIUKAI ";5727308039;Taip;8;3;0;11
14564;Žemyna;"ŽIRNIUKAI ";2792702536;Taip;15;0;0;15
14565;Žemyna;"ŽIRNIUKAI ";5714771643;Taip;12;0;0;12
14566;Žemyna;"ŽIRNIUKAI ";3992383447;Taip;10;2;0;12
14567;Žemyna;"ŽIRNIUKAI ";4693414703;Taip;12;0;1;13
14568;Žemyna;"ŽIOGELIAI ";3643594001;Taip;4;11;0;15
14569;Žemyna;"ŽIOGELIAI ";7508491119;Taip;4;0;1;5
14570;Žemyna;"ŽIOGELIAI ";4821941126;Taip;9;0;0;9
14571;Žemyna;"ŽIOGELIAI ";7781924111;Taip;5;0;0;5
14572;Žemyna;"ŽIOGELIAI ";3519840747;Taip;10;0;0;10
14573;Žemyna;"ŽIOGELIAI ";8622780639;Taip;17;0;0;17
14574;Žemyna;"ŽIOGELIAI ";6958537154;Taip;9;4;0;13
14575;Žemyna;"ŽIOGELIAI ";4444870782;Taip;10;6;0;16
14576;Žemyna;"ŽIOGELIAI ";2034162734;Taip;2;9;0;11
14577;Žemyna;"ŽIOGELIAI ";9182709647;Taip;5;1;0;6
14578;Žemyna;"ŽIOGELIAI ";7121742098;Taip;11;0;0;11
14579;Žemyna;"ŽIOGELIAI ";1468040559;Taip;12;0;0;12
14580;Žemyna;"ŽIOGELIAI ";4322192775;Taip;13;0;0;13
14581;Žemyna;"ŽIOGELIAI ";9653530823;Taip;3;0;1;4
14582;Žemyna;"ŽIOGELIAI ";5114094924;Taip;3;7;0;10
14583;Žemuogėlė;Boružiukai;64182347253;Taip;0;7;0;7
14584;Žemuogėlė;Boružiukai;89682626079;Taip;0;2;0;2
14585;Žemuogėlė;Boružiukai;21886029194;Taip;0;3;0;3
14586;Žemuogėlė;Boružiukai;95070515682;Taip;0;2;0;2
14587;Žemuogėlė;Boružiukai;7503799036;Taip;0;0;1;1
14588;Žemuogėlė;Boružiukai;3208009994;Taip;0;7;1;8
14589;Žemuogėlė;Boružiukai;1099252682;Taip;0;3;0;3
14590;Žemuogėlė;Boružiukai;2320908623;Taip;0;1;0;1
14591;Žemuogėlė;Boružiukai;1550066922;Taip;0;3;0;3
14592;Žemuogėlė;Boružiukai;1354590098;Taip;0;7;3;10
14593;Žemuogėlė;Boružiukai;1543283524;Taip;5;1;0;6
14594;Žemuogėlė;Boružiukai;1085793430;Taip;0;5;0;5
14595;Žemuogėlė;Boružiukai;1970687025;Taip;0;2;1;3
14596;Žemuogėlė;Boružiukai;52842591023;Taip;6;0;0;6
14597;Žemuogėlė;Boružiukai;97014601220;Taip;7;0;0;7
14598;Žemuogėlė;Boružiukai;5911529759;Taip;0;13;0;13
14599;Žemuogėlė;Boružiukai;31450036105;Taip;11;4;0;15
14600;Žemuogėlė;Boružiukai;93523683833;Taip;0;7;0;7
14601;Žemuogėlė;Boružiukai;1093128368;Taip;0;9;0;9
14602;Žemuogėlė;Boružiukai;70054283264;Taip;10;5;0;15
14603;Žemuogėlė;Boružiukai;40590616715;Taip;0;1;0;1
14604;Žemuogėlė;Boružiukai;1248683052;Taip;0;5;3;8
14605;Žemuogėlė;Boružiukai;2146044539;Taip;5;0;0;5
14606;Žemuogėlė;Šviesuliukai;4766971363;Taip;5;3;0;8
14607;Žemuogėlė;Šviesuliukai;3697024369;Taip;0;5;0;5
14608;Žemuogėlė;Šviesuliukai;8187939143;Taip;10;4;0;14
14609;Žemuogėlė;Šviesuliukai;96167322031;Taip;4;1;1;6
14610;Žemuogėlė;Šviesuliukai;73679997517;Taip;3;1;0;4
14611;Žemuogėlė;Šviesuliukai;29436958034;Taip;5;5;0;10
14612;Žemuogėlė;Šviesuliukai;1608544032;Taip;5;3;4;12
14613;Žemuogėlė;Šviesuliukai;9042246873;Taip;12;0;3;15
14614;Žemuogėlė;Šviesuliukai;1859848343;Taip;0;16;0;16
14615;Žemuogėlė;Šviesuliukai;4810459063;Taip;0;7;0;7
14616;Žemuogėlė;Šviesuliukai;57783467185;Taip;3;3;0;6
14617;Žemuogėlė;Šviesuliukai;75012082294;Taip;9;0;0;9
14618;Žemuogėlė;Šviesuliukai;5395954931;Taip;10;4;0;14
14619;Žemuogėlė;Šviesuliukai;1833523282;Taip;0;10;0;10
14620;Žemuogėlė;Šviesuliukai;3062268362;Taip;10;0;0;10
14621;Žemuogėlė;Šviesuliukai;9864664937;Taip;8;0;0;8
14622;Žemuogėlė;Šviesuliukai;3868254757;Taip;7;6;0;13
14623;Žemuogėlė;Šviesuliukai;9255723192;Taip;0;7;4;11
14624;Žemuogėlė;Šviesuliukai;2740942924;Taip;13;0;0;13
14625;Žemuogėlė;Šviesuliukai;5972567526;Taip;15;0;0;15
14626;Žemuogėlė;Šviesuliukai;1910570858;Taip;9;4;0;13
14627;Žemuogėlė;Lašiukai;88840615083;Ne;0;6;0;6
14628;Žemuogėlė;Lašiukai;32491995013;Taip;14;0;0;14
14629;Žemuogėlė;Lašiukai;1674933700;Taip;0;2;1;3
14630;Žemuogėlė;Lašiukai;10671271979;Taip;0;7;0;7
14631;Žemuogėlė;Lašiukai;91107541015;Taip;3;0;0;3
14632;Žemuogėlė;Lašiukai;53837299006;Taip;0;1;0;1
14633;Žemuogėlė;Lašiukai;12747214926;Taip;0;2;0;2
14634;Žemuogėlė;Lašiukai;51367008137;Taip;1;0;1;2
14635;Žemuogėlė;Lašiukai;46391565859;Taip;0;6;0;6
14636;Žemuogėlė;Lašiukai;23836253539;Taip;2;0;0;2
14637;Žemuogėlė;Lašiukai;86574419074;Taip;0;2;2;4
14638;Žemuogėlė;Lašiukai;71173323434;Taip;4;0;0;4
14639;Žemuogėlė;Lašiukai;84708796864;Taip;3;1;0;4
14640;Žemuogėlė;Lašiukai;98534411354;Taip;5;6;0;11
14641;Žemuogėlė;Lašiukai;78872439982;Taip;0;4;0;4
14642;Žemuogėlė;Skambaliukai;66580736408;Taip;3;11;0;14
14643;Žemuogėlė;Skambaliukai;9595187690;Taip;5;3;0;8
14644;Žemuogėlė;Skambaliukai;5784013969;Taip;5;4;0;9
14645;Žemuogėlė;Skambaliukai;4102456092;Taip;7;0;0;7
14646;Žemuogėlė;Skambaliukai;3937319656;Taip;5;1;0;6
14647;Žemuogėlė;Skambaliukai;7593612588;Taip;0;15;0;15
14648;Žemuogėlė;Skambaliukai;9932212577;Taip;3;2;3;8
14649;Žemuogėlė;Skambaliukai;1461676033;Taip;14;2;0;16
14650;Žemuogėlė;Skambaliukai;8499817876;Taip;3;0;0;3
14651;Žemuogėlė;Skambaliukai;37376794703;Taip;0;2;1;3
14652;Žemuogėlė;Skambaliukai;8208792552;Taip;5;4;0;9
14653;Žemuogėlė;Skambaliukai;48157970479;Taip;0;1;0;1
14654;Žemuogėlė;Skambaliukai;42192628191;Taip;2;0;3;5
14655;Žemuogėlė;Skambaliukai;2692095829;Taip;4;6;0;10
14656;Žemuogėlė;Skambaliukai;13566201686;Taip;3;4;0;7
14657;Žemuogėlė;Skambaliukai;2661677897;Taip;0;5;0;5
14658;Žemuogėlė;Spinduliukai;36386223863;Taip;10;0;0;10
14659;Žemuogėlė;Spinduliukai;50649509868;Taip;0;4;0;4
14660;Žemuogėlė;Spinduliukai;62971657427;Taip;0;1;0;1
14661;Žemuogėlė;Spinduliukai;62210251654;Taip;3;0;0;3
14662;Žemuogėlė;Spinduliukai;5888483930;Ne;0;12;0;12
14663;Žemuogėlė;Spinduliukai;24111477729;Taip;0;5;0;5
14664;Žemuogėlė;Spinduliukai;91720422401;Taip;0;4;0;4
14665;Žemuogėlė;Spinduliukai;11571302488;Taip;0;14;0;14
14666;Žemuogėlė;Spinduliukai;15246943974;Taip;4;5;0;9
14667;Žemuogėlė;Spinduliukai;54745410330;Taip;0;9;0;9
14668;Žemuogėlė;Spinduliukai;33317814956;Taip;0;2;0;2
14669;Žemuogėlė;Spinduliukai;97511628790;Taip;0;14;0;14
14670;Žemuogėlė;Spinduliukai;38094866639;Taip;0;9;0;9
14671;Žemuogėlė;Spinduliukai;23112873505;Taip;2;0;0;2
14672;Žemuogėlė;Spinduliukai;89316574266;Taip;0;5;0;5
14673;Žemuogėlė;Spinduliukai;89042677798;Taip;0;8;0;8
14674;Žemuogėlė;Spinduliukai;64042870424;Taip;0;10;0;10
14675;Žemuogėlė;Spinduliukai;3718360972;Ne;16;0;0;16
14676;Žemuogėlė;Perliukai;37726841145;Taip;1;0;0;1
14677;Žemuogėlė;Perliukai;33112231008;Taip;0;4;0;4
14678;Žemuogėlė;Perliukai;28795421460;Taip;4;2;0;6
14679;Žemuogėlė;Perliukai;92317183904;Taip;0;1;0;1
14680;Žemuogėlė;Perliukai;98006600854;Taip;18;0;0;18
14681;Žemuogėlė;Perliukai;66464155865;Taip;5;2;0;7
14682;Žemuogėlė;Perliukai;97664138036;Taip;0;1;0;1
14683;Žemuogėlė;Perliukai;87719167969;Taip;0;5;0;5
14684;Žemuogėlė;Perliukai;58604834495;Taip;1;5;0;6
14685;Žemuogėlė;Perliukai;1366286798;Taip;5;2;0;7
14686;Žemuogėlė;Perliukai;29973978107;Taip;6;0;0;6
14687;Žemuogėlė;Perliukai;8952696734;Taip;15;5;0;20
14688;Žemuogėlė;Perliukai;10356039859;Taip;10;1;0;11
14689;Žemuogėlė;Perliukai;1844596636;Taip;0;11;0;11
14690;Žemuogėlė;Perliukai;96539338587;Taip;3;1;0;4
14691;Žemuogėlė;Perliukai;13768771915;Taip;8;1;0;9
14692;Žemuogėlė;Perliukai;22761916112;Taip;5;4;0;9
14693;Žemuogėlė;Perliukai;60841198741;Taip;0;6;0;6
14694;Žemuogėlė;Perliukai;58679808617;Taip;11;0;0;11
14695;Žemuogėlė;Drugeliai;3854265246;Taip;1;3;0;4
14696;Žemuogėlė;Drugeliai;94792383091;Taip;0;2;0;2
14697;Žemuogėlė;Drugeliai;54663750186;Taip;10;5;0;15
14698;Žemuogėlė;Drugeliai;7403172794;Taip;14;0;0;14
14699;Žemuogėlė;Drugeliai;8023936861;Taip;13;0;0;13
14700;Žemuogėlė;Drugeliai;1608506638;Taip;5;3;0;8
14701;Žemuogėlė;Drugeliai;1448477562;Taip;5;3;0;8
14702;Žemuogėlė;Drugeliai;1223819270;Taip;15;1;0;16
14703;Žemuogėlė;Drugeliai;3134493860;Taip;5;1;0;6
14704;Žemuogėlė;Drugeliai;711908013;Taip;6;1;0;7
14705;Žemuogėlė;Drugeliai;1628749648;Taip;2;0;0;2
14706;Žemuogėlė;Drugeliai;6962103028;Taip;9;1;0;10
14707;Žemuogėlė;Drugeliai;38870047353;Taip;16;1;0;17
14708;Žemuogėlė;Drugeliai;3977351017;Taip;8;2;0;10
14709;Žemuogėlė;Drugeliai;4231767115;Taip;8;2;0;10
14710;Žemuogėlė;Drugeliai;8737612457;Taip;7;4;0;11
14711;Žemuogėlė;Drugeliai;5147617128;Taip;5;8;0;13
14712;Žemuogėlė;Drugeliai;5625943720;Taip;0;5;7;12
14713;Žemuogėlė;Drugeliai;1058207935;Taip;5;1;0;6
14714;Žemuogėlė;Drugeliai;7714826773;Taip;13;0;0;13
14715;Žemuogėlė;Drugeliai;1907004376;Taip;5;2;0;7
14716;Žemuogėlė;Drugeliai;9315711142;Taip;0;4;3;7
14717;Žemuogėlė;Drugeliai;2102057496;Taip;0;5;0;5
14718;Žemuogėlė;"VIEVERSIUKAI ";7804015060;Taip;0;5;0;5
14719;Žemuogėlė;"VIEVERSIUKAI ";3706531223;Taip;8;3;0;11
14720;Žemuogėlė;"VIEVERSIUKAI ";4565097904;Taip;15;5;0;20
14721;Žemuogėlė;"VIEVERSIUKAI ";1049009199;Taip;1;1;0;2
14722;Žemuogėlė;"VIEVERSIUKAI ";8644564820;Taip;20;0;0;20
14723;Žemuogėlė;"VIEVERSIUKAI ";9378432383;Taip;7;0;0;7
14724;Žemuogėlė;"VIEVERSIUKAI ";6747566307;Taip;2;0;0;2
14725;Žemuogėlė;"VIEVERSIUKAI ";3714945248;Taip;15;0;0;15
14726;Žemuogėlė;"VIEVERSIUKAI ";2001471529;Taip;4;3;0;7
14727;Žemuogėlė;"VIEVERSIUKAI ";2841634296;Taip;5;2;0;7
14728;Žemuogėlė;"VIEVERSIUKAI ";9579921777;Taip;3;3;0;6
14729;Žemuogėlė;"VIEVERSIUKAI ";6169845677;Taip;8;0;0;8
14730;Žemuogėlė;"VIEVERSIUKAI ";5532053268;Taip;0;1;0;1
14731;Žemuogėlė;"VIEVERSIUKAI ";1356340471;Taip;10;9;0;19
14732;Žemuogėlė;"NYKŠTUKAI ";3458374439;Taip;2;1;0;3
14733;Žemuogėlė;"NYKŠTUKAI ";3765022476;Taip;3;0;0;3
14734;Žemuogėlė;"NYKŠTUKAI ";9693894254;Taip;0;7;0;7
14735;Žemuogėlė;"NYKŠTUKAI ";2555902309;Taip;5;0;1;6
14736;Žemuogėlė;"NYKŠTUKAI ";4536398519;Taip;5;2;0;7
14737;Žemuogėlė;"NYKŠTUKAI ";8757701456;Taip;4;0;0;4
14738;Žemuogėlė;"NYKŠTUKAI ";1844299594;Taip;0;4;0;4
14739;Žemuogėlė;"NYKŠTUKAI ";2132549536;Taip;3;7;0;10
14740;Žemuogėlė;"NYKŠTUKAI ";8496353410;Taip;0;9;0;9
14741;Žemuogėlė;"NYKŠTUKAI ";9592456683;Taip;0;4;0;4
14742;Žemuogėlė;"NYKŠTUKAI ";6581889641;Taip;0;4;1;5
14743;Žemuogėlė;"NYKŠTUKAI ";5266493632;Taip;1;1;2;4
14744;Žemuogėlė;"NYKŠTUKAI ";3237083654;Taip;0;1;2;3
14745;Žemuogėlė;"NYKŠTUKAI ";2259779058;Taip;16;0;0;16
14746;Žemuogėlė;"NYKŠTUKAI ";5418395023;Taip;7;6;0;13
14747;Žemuogėlė;"NYKŠTUKAI ";1733808230;Taip;0;1;0;1
14748;Žemuogėlė;"NYKŠTUKAI ";1713927628;Taip;0;0;1;1
14749;Žemuogėlė;KIŠKUČIAI;9311520300;Taip;8;3;0;11
14750;Žemuogėlė;KIŠKUČIAI;3411390558;Taip;11;0;0;11
14751;Žemuogėlė;KIŠKUČIAI;6963684639;Taip;7;5;0;12
14752;Žemuogėlė;KIŠKUČIAI;1377813636;Taip;9;1;0;10
14753;Žemuogėlė;KIŠKUČIAI;9689082202;Taip;15;0;0;15
14754;Žemuogėlė;KIŠKUČIAI;8409711622;Taip;9;2;0;11
14755;Žemuogėlė;KIŠKUČIAI;9955429241;Taip;5;0;0;5
14756;Žemuogėlė;KIŠKUČIAI;5770044886;Taip;11;4;0;15
14757;Žemuogėlė;KIŠKUČIAI;6726124641;Taip;14;2;0;16
14758;Žemuogėlė;KIŠKUČIAI;5127370193;Taip;13;0;0;13
14759;Žemuogėlė;KIŠKUČIAI;5126348190;Taip;16;0;0;16
14760;Žemuogėlė;KIŠKUČIAI;7177725663;Taip;7;4;0;11
14761;Žemuogėlė;KIŠKUČIAI;9534937419;Taip;6;4;0;10
14762;Žemuogėlė;KIŠKUČIAI;2481547868;Taip;10;0;0;10
14763;Žemuogėlė;KIŠKUČIAI;3612833383;Taip;15;0;0;15
14764;Žemuogėlė;KIŠKUČIAI;3000676765;Taip;12;5;0;17
14765;Žemuogėlė;KIŠKUČIAI;4317453894;Taip;10;3;0;13
14766;Žemuogėlė;KIŠKUČIAI;1275552038;Taip;15;5;0;20
14767;Žibutė;PELĖDŽIUKAI;5811023607;Taip;6;0;2;8
14768;Žibutė;PELĖDŽIUKAI;62146271609;Taip;3;5;0;8
14769;Žibutė;PELĖDŽIUKAI;85042822872;Taip;5;0;0;5
14770;Žibutė;PELĖDŽIUKAI;59824395612;Taip;8;0;1;9
14771;Žibutė;PELĖDŽIUKAI;2361682400;Taip;5;0;1;6
14772;Žibutė;PELĖDŽIUKAI;1259481487;Taip;0;5;0;5
14773;Žibutė;PELĖDŽIUKAI;3826875107;Taip;5;6;0;11
14774;Žibutė;PELĖDŽIUKAI;3186792146;Taip;5;0;1;6
14775;Žibutė;PELĖDŽIUKAI;1226458088;Taip;0;0;6;6
14776;Žibutė;PELĖDŽIUKAI;7344095020;Taip;5;10;0;15
14777;Žibutė;PELĖDŽIUKAI;1078105287;Taip;0;13;0;13
14778;Žibutė;PELĖDŽIUKAI;2152452830;Taip;0;0;5;5
14779;Žibutė;PELĖDŽIUKAI;2236930916;Taip;8;0;0;8
14780;Žibutė;PELĖDŽIUKAI;7095870173;Taip;0;7;0;7
14781;Žibutė;PELĖDŽIUKAI;2840754631;Taip;20;0;0;20
14782;Žibutė;PELĖDŽIUKAI;6089325755;Taip;17;0;0;17
14783;Žibutė;PELĖDŽIUKAI;1274409680;Taip;4;0;0;4
14784;Žibutė;KREGŽDUTĖS;65354441552;Taip;0;5;1;6
14785;Žibutė;KREGŽDUTĖS;41927765047;Taip;3;5;1;9
14786;Žibutė;KREGŽDUTĖS;27934987411;Taip;0;3;0;3
14787;Žibutė;KREGŽDUTĖS;58408466259;Taip;0;5;0;5
14788;Žibutė;KREGŽDUTĖS;76429804560;Taip;2;5;0;7
14789;Žibutė;KREGŽDUTĖS;70602200548;Taip;0;4;1;5
14790;Žibutė;KREGŽDUTĖS;27387035728;Taip;3;7;0;10
14791;Žibutė;KREGŽDUTĖS;16188398138;Taip;0;4;4;8
14792;Žibutė;KREGŽDUTĖS;74637399002;Taip;3;1;2;6
14793;Žibutė;KREGŽDUTĖS;72101352091;Taip;6;5;0;11
14794;Žibutė;KREGŽDUTĖS;61878941621;Taip;4;0;0;4
14795;Žibutė;KREGŽDUTĖS;68830297615;Taip;0;11;0;11
14796;Žibutė;KREGŽDUTĖS;89599338661;Taip;0;7;0;7
14797;Žibutė;KREGŽDUTĖS;30268398324;Taip;0;6;0;6
14798;Žibutė;KREGŽDUTĖS;19878972163;Taip;0;5;4;9
14799;Žibutė;KREGŽDUTĖS;23824219807;Taip;4;5;0;9
14800;Žibutė;KREGŽDUTĖS;5026713257;Taip;4;5;0;9
14801;Žibutė;KREGŽDUTĖS;21619209538;Taip;5;0;0;5
14802;Žibutė;KREGŽDUTĖS;72754807096;Taip;9;2;1;12
14803;Žibutė;KREGŽDUTĖS;2027777207;Taip;5;0;0;5
14804;Žibutė;KREGŽDUTĖS;1735074467;Taip;5;5;1;11
14805;Žibutė;BORUŽĖLĖS;3268141759;Taip;0;1;4;5
14806;Žibutė;BORUŽĖLĖS;7774532200;Taip;0;5;0;5
14807;Žibutė;BORUŽĖLĖS;1366469428;Taip;16;0;0;16
14808;Žibutė;BORUŽĖLĖS;2607509585;Taip;0;1;0;1
14809;Žibutė;BORUŽĖLĖS;4825064521;Taip;9;7;0;16
14810;Žibutė;BORUŽĖLĖS;5826523148;Taip;0;7;0;7
14811;Žibutė;BORUŽĖLĖS;5806696915;Taip;2;5;0;7
14812;Žibutė;BORUŽĖLĖS;3957898269;Taip;4;0;0;4
14813;Žibutė;BORUŽĖLĖS;4814936645;Taip;5;0;0;5
14814;Žibutė;BORUŽĖLĖS;4382812297;Taip;1;0;2;3
14815;Žibutė;BORUŽĖLĖS;5591698130;Taip;11;0;0;11
14816;Žibutė;BORUŽĖLĖS;1004098038;Taip;10;10;0;20
14817;Žibutė;BORUŽĖLĖS;2880593326;Taip;2;0;1;3
14818;Žibutė;BORUŽĖLĖS;7479437931;Taip;20;0;0;20
14819;Žibutė;BITUTĖS;3194445795;Taip;5;0;0;5
14820;Žibutė;BITUTĖS;14091973543;Taip;11;0;0;11
14821;Žibutė;BITUTĖS;24818054845;Taip;7;0;0;7
14822;Žibutė;BITUTĖS;29414890756;Taip;7;5;0;12
14823;Žibutė;BITUTĖS;9591439732;Taip;8;0;1;9
14824;Žibutė;BITUTĖS;90040902859;Taip;0;3;0;3
14825;Žibutė;BITUTĖS;12087873516;Taip;5;7;0;12
14826;Žibutė;BITUTĖS;39367516353;Taip;6;0;0;6
14827;Žibutė;BITUTĖS;1192143609;Taip;6;0;0;6
14828;Žibutė;BITUTĖS;72357016152;Taip;8;4;0;12
14829;Žibutė;BITUTĖS;1054908586;Taip;7;0;0;7
14830;Žibutė;BITUTĖS;2603387036;Taip;3;0;0;3
14831;Žibutė;BITUTĖS;1215072172;Taip;5;6;0;11
14832;Žibutė;BITUTĖS;1317512329;Taip;0;5;0;5
14833;Žibutė;BITUTĖS;2144866874;Ne;0;5;0;5
14834;Žibutė;BITUTĖS;2062794337;Taip;6;0;0;6
14835;Žibutė;BITUTĖS;1010766308;Taip;1;5;0;6
14836;Žibutė;BITUTĖS;1749323904;Taip;5;1;0;6
14837;Žibutė;BITUTĖS;19558564943;Taip;9;1;0;10
14838;Žibutė;BITUTĖS;9109825948;Taip;5;0;0;5
14839;Žibutė;BITUTĖS;6958822972;Taip;0;5;0;5
14840;Žibutė;BITUTĖS;62187632470;Taip;13;1;0;14
14841;Žibutė;KAČIUKAI;65433129636;Taip;0;0;5;5
14842;Žibutė;KAČIUKAI;94054589778;Taip;0;0;5;5
14843;Žibutė;KAČIUKAI;25658034484;Taip;0;1;4;5
14844;Žibutė;KAČIUKAI;9982611436;Taip;0;0;2;2
14845;Žibutė;KAČIUKAI;6736950445;Taip;0;0;6;6
14846;Žibutė;KAČIUKAI;2089960385;Taip;0;0;11;11
14847;Žibutė;KAČIUKAI;30838051846;Taip;0;5;5;10
14848;Žibutė;KAČIUKAI;29408732286;Taip;0;6;0;6
14849;Žibutė;KAČIUKAI;35959201106;Taip;0;4;0;4
14850;Žibutė;KAČIUKAI;67702702073;Taip;0;0;9;9
14851;Žibutė;KAČIUKAI;60756444655;Taip;0;0;3;3
14852;Žibutė;KAČIUKAI;33367530216;Taip;5;0;4;9
14853;Žibutė;KAČIUKAI;97730387781;Taip;0;0;5;5
14854;Žibutė;KAČIUKAI;51435935201;Taip;0;5;0;5
14855;Žibutė;KAČIUKAI;14243834326;Taip;5;0;1;6
14856;Žibutė;KAČIUKAI;19029125959;Taip;0;0;5;5
14857;Žibutė;KAČIUKAI;1683770314;Taip;0;6;0;6
14858;Žibutė;KAČIUKAI;99502912405;Ne;0;0;1;1
14859;Žibutė;KAČIUKAI;10269347801;Taip;0;5;4;9
14860;Žibutė;KAČIUKAI;76137370554;Taip;0;2;5;7
14861;Žibutė;KAČIUKAI;4475507372;Taip;0;0;6;6
14862;Žibutė;KAČIUKAI;2120935059;Taip;0;5;0;5
14863;Žibutė;KAČIUKAI;9655499291;Taip;0;12;3;15
14864;Žibutė;KAČIUKAI;31084244709;Taip;0;0;9;9
14865;Žibutė;ZUIKIAI;6495108202;Taip;0;5;0;5
14866;Žibutė;ZUIKIAI;8715912139;Taip;6;0;0;6
14867;Žibutė;ZUIKIAI;5416015554;Taip;0;0;2;2
14868;Žibutė;ZUIKIAI;2406005105;Taip;3;0;1;4
14869;Žibutė;ZUIKIAI;3555071718;Taip;15;0;1;16
14870;Žibutė;ZUIKIAI;7531027545;Taip;0;0;4;4
14871;Žibutė;ZUIKIAI;3645481894;Taip;1;1;0;2
14872;Žibutė;ZUIKIAI;6074488747;Taip;0;0;3;3
14873;Žibutė;ZUIKIAI;8880329060;Taip;10;0;0;10
14874;Žibutė;ZUIKIAI;2957525481;Taip;8;3;0;11
14875;Žibutė;ZUIKIAI;5009495840;Taip;5;0;0;5
14876;Žibutė;ZUIKIAI;5575614158;Taip;5;0;10;15
14877;Žibutė;ZUIKIAI;5190377896;Taip;2;5;2;9
14878;Žibutė;ZUIKIAI;3191351976;Taip;0;0;13;13
14879;Žibutė;ZUIKIAI;9498011134;Taip;0;4;0;4
14880;Žiedas;Bitutės;569146317;Taip;10;6;0;16
14881;Žiedas;Bitutės;61612709115;Ne;10;0;0;10
14882;Žiedas;Bitutės;52916954220;Taip;5;2;0;7
14883;Žiedas;Bitutės;94672053787;Taip;11;6;0;17
14884;Žiedas;Bitutės;70618764845;Ne;0;9;0;9
14885;Žiedas;Bitutės;86696082162;Ne;0;5;0;5
14886;Žiedas;Bitutės;59723024689;Taip;0;6;0;6
14887;Žiedas;Bitutės;14576604550;Taip;9;1;0;10
14888;Žiedas;Bitutės;35737299683;Taip;10;2;0;12
14889;Žiedas;Bitutės;35961318907;Ne;0;6;0;6
14890;Žiedas;Bitutės;4246111136;Ne;10;0;0;10
14891;Žiedas;Bitutės;55194855496;Taip;0;2;0;2
14892;Žiedas;Bitutės;69138351989;Taip;0;5;0;5
14893;Žiedas;Bitutės;31072310441;Taip;4;5;0;9
14894;Žiedas;Bitutės;54614633445;Taip;5;0;1;6
14895;Žiedas;Bitutės;42649178759;Taip;0;1;0;1
14896;Žiedas;Bitutės;1529539343;Taip;0;5;0;5
14897;Žiedas;Bitutės;4753427269;Taip;0;7;1;8
14898;Žiedas;Bitutės;45167345380;Taip;10;5;0;15
14899;Žiedas;Bitutės;20748238520;Taip;10;5;0;15
14900;Žiedas;Bitutės;53409153553;Taip;5;5;0;10
14901;Žiedas;Bitutės;7708303405;Taip;0;1;0;1
14902;Žiedas;Bitutės;79291005378;Taip;0;3;6;9
14903;Žiedas;Varpeliai;32671505578;Taip;11;5;0;16
14904;Žiedas;Varpeliai;50534384762;Taip;16;0;0;16
14905;Žiedas;Varpeliai;5835879070;Taip;0;1;0;1
14906;Žiedas;Varpeliai;1733596148;Taip;0;4;1;5
14907;Žiedas;Varpeliai;55459877940;Taip;17;0;0;17
14908;Žiedas;Varpeliai;50069962197;Taip;12;2;0;14
14909;Žiedas;Varpeliai;59092030605;Taip;0;7;3;10
14910;Žiedas;Varpeliai;1748932818;Taip;4;2;0;6
14911;Žiedas;Varpeliai;17275054601;Taip;18;0;0;18
14912;Žiedas;Varpeliai;1897597456;Taip;0;3;0;3
14913;Žiedas;Varpeliai;1443451076;Taip;5;7;0;12
14914;Žiedas;Varpeliai;1491929025;Taip;9;5;0;14
14915;Žiedas;Varpeliai;2075892389;Taip;6;3;0;9
14916;Žiedas;Varpeliai;9044903345;Taip;11;0;0;11
14917;Žiedas;Varpeliai;85152640431;Taip;7;4;0;11
14918;Žiedas;Varpeliai;2147350804;Taip;11;6;0;17
14919;Žiedas;Varpeliai;1366570116;Taip;20;0;0;20
14920;Žiedas;Varpeliai;37314210812;Taip;5;5;0;10
14921;Žiedas;Varpeliai;52683198809;Taip;16;0;0;16
14922;Žiedas;Varpeliai;99985645406;Taip;0;3;3;6
14923;Žiedas;Varpeliai;39022317368;Taip;10;1;0;11
14924;Žiedas;Varpeliai;1618815502;Taip;12;0;0;12
14925;Žiedas;Varpeliai;1332249885;Taip;8;0;0;8
14926;Žiedas;Varpeliai;12622490543;Ne;15;5;0;20
14927;Žiedas;Varpeliai;1120478375;Taip;5;9;0;14
14928;Žiedas;Varpeliai;2081656643;Taip;0;4;0;4
14929;Žiedas;Žirniukai;43123840066;Taip;0;1;0;1
14930;Žiedas;Žirniukai;65264733887;Ne;9;6;0;15
14931;Žiedas;Žirniukai;80003937908;Taip;0;5;0;5
14932;Žiedas;Žirniukai;4665596321;Taip;0;6;0;6
14933;Žiedas;Žirniukai;29411390190;Taip;15;0;1;16
14934;Žiedas;Žirniukai;20740539606;Taip;16;1;0;17
14935;Žiedas;Žirniukai;226707253;Taip;4;5;2;11
14936;Žiedas;Žirniukai;81304970766;Taip;0;2;0;2
14937;Žiedas;Žirniukai;66729734455;Taip;5;5;0;10
14938;Žiedas;Žirniukai;28885468502;Ne;0;10;4;14
14939;Žiedas;Žirniukai;50295529511;Taip;8;10;0;18
14940;Žiedas;Žirniukai;23936058075;Taip;5;0;0;5
14941;Žiedas;Žirniukai;29665685563;Taip;0;5;2;7
14942;Žiedas;Žirniukai;22305887643;Taip;0;5;0;5
14943;Žiedas;Žirniukai;83630991208;Taip;2;5;0;7
14944;Žiedas;Žirniukai;38427730823;Taip;4;0;0;4
14945;Žiedas;Žirniukai;33966765931;Taip;0;7;1;8
14946;Žiedas;Žirniukai;56303923223;Taip;6;5;0;11
14947;Žiedas;Žirniukai;39792014616;Taip;14;3;0;17
14948;Žiedas;Žirniukai;31369021056;Taip;10;10;0;20
14949;Žiedas;Žirniukai;34178608904;Taip;5;10;1;16
14950;Žiedas;Žirniukai;1398197280;Taip;0;3;0;3
14951;Žiedas;Žirniukai;1288374706;Taip;0;6;0;6
14952;Žiedas;Žirniukai;1631546874;Ne;0;8;0;8
14953;Žiedas;Žirniukai;1817676038;Taip;0;5;0;5
14954;Žiedas;Žirniukai;85519253910;Taip;0;0;2;2
14955;Žiedas;Žirniukai;2063680054;Taip;10;10;0;20
14956;Žiedas;Ramunėlės;9648580306;Taip;5;2;0;7
14957;Žiedas;Ramunėlės;9736967156;Taip;10;4;0;14
14958;Žiedas;Ramunėlės;4922560649;Taip;5;7;2;14
14959;Žiedas;Ramunėlės;2511423525;Taip;0;2;0;2
14960;Žiedas;Ramunėlės;7814504623;Taip;11;4;1;16
14961;Žiedas;Ramunėlės;2095655987;Taip;5;2;0;7
14962;Žiedas;Ramunėlės;6703889237;Taip;0;0;2;2
14963;Žiedas;Ramunėlės;7954517383;Taip;8;5;0;13
14964;Žiedas;Ramunėlės;7016509405;Taip;0;4;1;5
14965;Žiedas;Ramunėlės;9247088735;Taip;9;1;1;11
14966;Žiedas;Ramunėlės;9699668892;Taip;8;5;0;13
14967;Žiedas;Ramunėlės;6432090199;Taip;5;2;0;7
14968;Žiedas;Ramunėlės;1139186052;Taip;0;7;5;12
14969;Žiedas;Ramunėlės;5653785844;Taip;10;0;0;10
14970;Žiedas;Ramunėlės;5588136738;Taip;0;10;0;10
14971;Žiedas;Ramunėlės;5626494892;Taip;9;5;0;14
14972;Žiedas;Ramunėlės;1794393042;Taip;4;0;0;4
14973;Žiedas;Ramunėlės;2083493509;Taip;0;7;0;7
14974;Žiedas;Ramunėlės;7708360056;Taip;0;5;0;5
14975;Žiedas;Ramunėlės;7396006218;Taip;10;5;0;15
14976;Žiedas;Ramunėlės;3586376571;Taip;15;0;0;15
14977;Žiedas;Ramunėlės;6786526552;Taip;6;7;7;20
14978;Žiedas;Ramunėlės;3702078720;Taip;5;2;0;7
14979;Žiedas;Bruknelės;1772492727;Taip;8;0;4;12
14980;Žiedas;Bruknelės;6925923143;Taip;20;0;0;20
14981;Žiedas;Bruknelės;1781950568;Taip;3;0;0;3
14982;Žiedas;Bruknelės;1453937876;Taip;6;0;1;7
14983;Žiedas;Bruknelės;9573180529;Taip;20;0;0;20
14984;Žiedas;Bruknelės;3385568839;Taip;10;6;0;16
14985;Žiedas;Bruknelės;2718046390;Taip;9;1;0;10
14986;Žiedas;Bruknelės;9757771445;Taip;0;8;0;8
14987;Žiedas;Bruknelės;4749655084;Taip;0;13;0;13
14988;Žiedas;Bruknelės;5570910138;Taip;0;9;0;9
14989;Žiedas;Bruknelės;73923918829;Taip;3;5;0;8
14990;Žiedas;Bruknelės;3641595127;Taip;9;0;0;9
14991;Žiedas;Bruknelės;9894489800;Taip;5;0;0;5
14992;Žiedas;Bruknelės;6945326867;Taip;8;0;0;8
14993;Žiedas;Bruknelės;3613860509;Taip;5;8;0;13
14994;Žiedas;Bruknelės;9702211410;Taip;10;0;1;11
14995;Žiedas;Bruknelės;3370495317;Taip;5;5;0;10
14996;Žiedas;Bruknelės;2026462074;Taip;20;0;0;20
14997;Žiedas;Bruknelės;1856012121;Taip;14;0;0;14
14998;Žiedas;Bruknelės;1534169381;Taip;10;5;0;15
14999;Žiedas;Bruknelės;4521161684;Taip;0;8;0;8
15000;Žiedas;Bruknelės;9415269410;Taip;8;0;0;8
15001;Žiedas;Bruknelės;5537717174;Taip;0;11;0;11
15002;Žiedas;Bruknelės;8372385066;Taip;5;0;2;7
15003;Žiedas;Pakalnutės;1063755068;Taip;5;1;0;6
15004;Žiedas;Pakalnutės;42049755986;Taip;11;7;0;18
15005;Žiedas;Pakalnutės;52721173922;Taip;0;5;0;5
15006;Žiedas;Pakalnutės;58252361010;Taip;13;5;0;18
15007;Žiedas;Pakalnutės;2060067625;Taip;0;9;0;9
15008;Žiedas;Pakalnutės;2434909184;Taip;6;3;0;9
15009;Žiedas;Pakalnutės;3616767119;Taip;6;3;0;9
15010;Žiedas;Pakalnutės;1835889494;Taip;10;7;0;17
15011;Žiedas;Pakalnutės;1600420971;Taip;12;5;0;17
15012;Žiedas;Pakalnutės;3930283171;Taip;13;6;0;19
15013;Žiedas;Pakalnutės;1985949180;Taip;8;0;0;8
15014;Žiedas;Pakalnutės;1708363648;Taip;7;0;0;7
15015;Žiedas;Pakalnutės;1779122644;Taip;0;8;0;8
15016;Žiedas;Pakalnutės;9940683245;Taip;3;3;0;6
15017;Žiedas;Pakalnutės;1200692015;Taip;5;0;0;5
15018;Žiedas;Pakalnutės;1013773415;Taip;6;4;0;10
15019;Žiedas;Pakalnutės;27339844730;Taip;13;3;0;16
15020;Žiedas;Pakalnutės;5812737969;Taip;5;1;0;6
15021;Žiedas;Pakalnutės;1127645903;Taip;12;1;0;13
15022;Žiedas;Pakalnutės;1219022794;Taip;6;9;0;15
15023;Žiedas;Pakalnutės;7647496475;Taip;6;9;0;15
15024;Žiedas;Pakalnutės;1785446716;Taip;13;0;0;13
15025;Žiedas;Pakalnutės;2094277643;Taip;6;0;0;6
15026;Žiedas;Pakalnutės;12960180114;Taip;15;1;0;16
15027;Žiedas;Spanguolytės;73847154996;Taip;10;7;0;17
15028;Žiedas;Spanguolytės;1215443920;Taip;0;2;0;2
15029;Žiedas;Spanguolytės;5282211767;Taip;0;12;0;12
15030;Žiedas;Spanguolytės;53090437775;Taip;9;4;0;13
15031;Žiedas;Spanguolytės;69245659818;Taip;3;13;0;16
15032;Žiedas;Spanguolytės;9363714015;Taip;10;5;0;15
15033;Žiedas;Spanguolytės;1318132922;Taip;0;3;0;3
15034;Žiedas;Spanguolytės;2037477873;Taip;0;1;0;1
15035;Žiedas;Spanguolytės;1450251779;Taip;0;3;0;3
15036;Žiedas;Spanguolytės;4502784565;Taip;0;5;0;5
15037;Žiedas;Spanguolytės;7136135394;Taip;0;5;0;5
15038;Žiedas;Spanguolytės;6964047214;Taip;10;1;0;11
15039;Žiedas;Spanguolytės;8517250094;Taip;10;3;2;15
15040;Žiedas;Spanguolytės;6815408748;Taip;4;1;0;5
15041;Žiedas;Spanguolytės;36350993825;Taip;8;8;0;16
15042;Žiedas;Spanguolytės;2391924358;Taip;0;1;0;1
15043;Žiedas;Spanguolytės;8172222365;Taip;2;4;0;6
15044;Žiedas;Spanguolytės;9259436243;Taip;9;0;0;9
15045;Žiedas;Spanguolytės;3346603228;Taip;8;7;0;15
15046;Žiedas;Spanguolytės;5451923881;Taip;15;1;0;16
15047;Žiedas;Rožytės;4016573192;Taip;0;5;0;5
15048;Žiedas;Rožytės;1771805131;Taip;5;8;0;13
15049;Žiedas;Rožytės;83777073799;Taip;5;7;0;12
15050;Žiedas;Rožytės;65360328423;Taip;0;8;0;8
15051;Žiedas;Rožytės;8241660222;Taip;17;0;0;17
15052;Žiedas;Rožytės;4621822895;Ne;5;5;0;10
15053;Žiedas;Rožytės;18236935510;Taip;0;8;0;8
15054;Žiedas;Rožytės;37978194696;Taip;5;0;0;5
15055;Žiedas;Rožytės;98235996578;Taip;0;5;0;5
15056;Žiedas;Rožytės;1971475040;Taip;0;5;1;6
15057;Žiedas;Rožytės;2098165226;Taip;10;5;0;15
15058;Žiedas;Rožytės;1079445123;Taip;0;5;0;5
15059;Žiedas;Rožytės;6745229012;Taip;3;5;0;8
15060;Žiedas;Rožytės;1136010138;Taip;0;12;0;12
15061;Žiedas;Rožytės;74421578926;Taip;0;7;0;7
15062;Žiedas;Rožytės;1618505155;Taip;7;5;0;12
15063;Žiedas;Rožytės;47457128214;Taip;3;5;1;9
15064;Žiedas;Rožytės;40744263923;Taip;0;2;0;2
15065;Žiedas;Rožytės;33135652351;Taip;13;2;0;15
15066;Žiedas;Rožytės;87240375524;Taip;0;8;0;8
15067;Žiedas;Rožytės;1508800551;Taip;0;5;2;7
15068;Žiedas;Rožytės;1893226570;Taip;13;0;0;13
15069;Žiedas;Rožytės;54324583490;Taip;0;5;8;13
15070;Žiedas;Rožytės;7283725455;Taip;15;5;0;20
15071;Žiedas;Rožytės;56707734658;Taip;4;5;0;9
15072;Žiedas;Rožytės;2157262849;Taip;9;3;3;15
15073;Žiedas;Pumpurėliai;5647232875;Taip;12;0;0;12
15074;Žiedas;Pumpurėliai;1048272199;Taip;7;0;0;7
15075;Žiedas;Pumpurėliai;5126173608;Taip;16;0;0;16
15076;Žiedas;Pumpurėliai;6443633568;Taip;15;5;0;20
15077;Žiedas;Pumpurėliai;5959899914;Taip;9;1;0;10
15078;Žiedas;Pumpurėliai;5885209631;Taip;8;5;0;13
15079;Žiedas;Pumpurėliai;7578964555;Taip;4;2;0;6
15080;Žiedas;Pumpurėliai;2134466899;Taip;6;6;0;12
15081;Žiedas;Pumpurėliai;7491134119;Taip;9;1;0;10
15082;Žiedas;Pumpurėliai;6658762922;Taip;16;0;0;16
15083;Žiedas;Pumpurėliai;1253833615;Taip;16;0;0;16
15084;Žiedas;Pumpurėliai;4497634040;Taip;6;0;0;6
15085;Žiedas;Pumpurėliai;5108263139;Taip;16;0;0;16
15086;Žiedas;Pumpurėliai;5703750436;Taip;5;0;0;5
15087;Žiedas;Pumpurėliai;3857121753;Taip;8;0;1;9
15088;Žiedas;Pumpurėliai;3715928992;Taip;17;0;0;17
15089;Žiedas;Pumpurėliai;1737296046;Taip;10;0;0;10
15090;Žiedas;Pumpurėliai;9352485926;Taip;16;0;0;16
15091;Žiedas;Pumpurėliai;7333813704;Taip;12;0;0;12
15092;Žiedas;Žemuogėlės;7672879525;Taip;12;0;0;12
15093;Žiedas;Žemuogėlės;7097790025;Taip;5;4;0;9
15094;Žiedas;Žemuogėlės;3387263016;Taip;3;0;0;3
15095;Žiedas;Žemuogėlės;1219634640;Taip;0;0;6;6
15096;Žiedas;Žemuogėlės;8927034492;Taip;0;20;0;20
15097;Žiedas;Žemuogėlės;8208331527;Taip;20;0;0;20
15098;Žiedas;Žemuogėlės;1738121071;Taip;18;0;0;18
15099;Žiedas;Žemuogėlės;9037835899;Ne;10;0;0;10
15100;Žiedas;Žemuogėlės;5652936425;Taip;5;0;0;5
15101;Žiedas;Žemuogėlės;1583038469;Taip;6;10;0;16
15102;Žiedas;Žemuogėlės;8812316692;Taip;14;0;0;14
15103;Žiedas;Žemuogėlės;3178778438;Taip;10;2;0;12
15104;Žiedas;Žemuogėlės;2849254119;Taip;20;0;0;20
15105;Žiedas;Žemuogėlės;5914428064;Taip;9;6;0;15
15106;Žiedas;Žemuogėlės;3900091129;Taip;10;2;0;12
15107;Žiedas;Žemuogėlės;3067962647;Ne;0;0;2;2
15108;Žiedas;Žemuogėlės;9587581470;Taip;5;5;0;10
15109;Žiedas;Žemuogėlės;9218388800;Taip;10;2;1;13
15110;Žiedas;Žemuogėlės;9140396365;Taip;0;1;0;1
15111;Žiedas;Žemuogėlės;6444377924;Taip;8;0;0;8
15112;Žiedas;Žemuogėlės;7172793351;Taip;10;0;0;10
15113;Žiedas;Žemuogėlės;5578227349;Taip;7;1;0;8
15114;Žiedas;"Žibutė ";4983852075;Taip;10;3;0;13
15115;Žiedas;"Žibutė ";9129315784;Taip;15;1;0;16
15116;Žiedas;"Žibutė ";9750690920;Taip;0;12;0;12
15117;Žiedas;"Žibutė ";1333233100;Taip;9;1;0;10
15118;Žiedas;"Žibutė ";8645771800;Taip;6;0;0;6
15119;Žiedas;"Žibutė ";4556559021;Taip;16;0;0;16
15120;Žiedas;"Žibutė ";7942276632;Taip;5;1;0;6
15121;Žiedas;"Žibutė ";6041919197;Taip;17;0;0;17
15122;Žiedas;"Žibutė ";7187176169;Taip;10;0;0;10
15123;Žiedas;"Žibutė ";4222689492;Taip;10;1;0;11
15124;Žiedas;"Žibutė ";2182381160;Taip;5;0;0;5
15125;Žiedas;"Žibutė ";4284627073;Taip;20;0;0;20
15126;Žiedas;"Žibutė ";8822472312;Taip;10;1;0;11
15127;Žiedas;"Žibutė ";7952899220;Taip;4;1;0;5
15128;Žiedas;"Žibutė ";5020148822;Taip;7;1;0;8
15129;Žiedas;"Žibutė ";1777501190;Taip;7;6;0;13
15130;Žiedas;"Žibutė ";1043230748;Taip;9;0;0;9
15131;Žiedas;"Žibutė ";1844621525;Taip;8;7;0;15
15132;Žiedas;"Žibutė ";9021286246;Taip;11;1;0;12
15133;Žiedas;"Žibutė ";6175213274;Taip;8;0;0;8
15134;Žiedas;"Dobiliukai ";88471315730;Taip;5;7;0;12
15135;Žiedas;"Dobiliukai ";1484464986;Taip;5;5;0;10
15136;Žiedas;"Dobiliukai ";34193530;Taip;10;5;0;15
15137;Žiedas;"Dobiliukai ";1529988412;Taip;5;0;0;5
15138;Žiedas;"Dobiliukai ";1550350520;Taip;11;0;0;11
15139;Žiedas;"Dobiliukai ";2763469583;Taip;0;5;0;5
15140;Žiedas;"Dobiliukai ";86877563124;Taip;2;5;0;7
15141;Žiedas;"Dobiliukai ";1458152054;Taip;0;18;0;18
15142;Žiedas;"Dobiliukai ";3414702993;Taip;6;4;0;10
15143;Žiedas;"Dobiliukai ";69485023219;Taip;10;4;0;14
15144;Žiedas;"Dobiliukai ";1007894628;Taip;9;7;0;16
15145;Žiedas;"Dobiliukai ";1625009666;Taip;10;4;0;14
15146;Žiedas;"Dobiliukai ";1868951268;Taip;8;5;0;13
15147;Žiedas;"Dobiliukai ";1824692620;Taip;11;0;0;11
15148;Žiedas;"Dobiliukai ";9058688663;Taip;0;7;0;7
15149;Žiedas;"Dobiliukai ";7150433256;Taip;0;2;0;2
15150;Žiedas;"Dobiliukai ";6145720452;Taip;0;11;0;11
15151;Žiedas;"Dobiliukai ";1030089009;Taip;5;1;0;6
15152;Žiedas;"Dobiliukai ";4807479784;Taip;5;1;0;6
15153;Žiedas;"Dobiliukai ";2507543124;Taip;15;5;0;20
15154;Žiedas;Boružėlės;49024435947;Taip;8;7;0;15
15155;Žiedas;Boružėlės;39480704602;Taip;4;6;0;10
15156;Žiedas;Boružėlės;48191698488;Taip;9;5;0;14
15157;Žiedas;Boružėlės;18549289812;Taip;0;5;0;5
15158;Žiedas;Boružėlės;71843517726;Taip;0;5;0;5
15159;Žiedas;Boružėlės;9117238535;Taip;10;2;0;12
15160;Žiedas;Boružėlės;23799596522;Ne;12;0;0;12
15161;Žiedas;Boružėlės;71876894781;Ne;5;5;0;10
15162;Žiedas;Boružėlės;18469282227;Taip;7;2;0;9
15163;Žiedas;Boružėlės;13070834235;Taip;12;5;0;17
15164;Žiedas;Boružėlės;74893931156;Taip;2;5;1;8
15165;Žiedas;Boružėlės;25196433027;Taip;0;7;0;7
15166;Žiedas;Boružėlės;71241692542;Taip;0;1;1;2
15167;Žiedas;Boružėlės;2025846226;Taip;9;7;0;16
15168;Žiedas;Boružėlės;1748516954;Taip;5;6;0;11
15169;Žiedas;Boružėlės;57434309890;Taip;5;7;1;13
15170;Žiedas;Boružėlės;55246099530;Taip;13;5;0;18
15171;Žiedas;Boružėlės;26141244088;Taip;10;2;3;15
15172;Žiedas;Boružėlės;62185387860;Taip;5;5;0;10
15173;Žiedas;Boružėlės;95883894012;Ne;0;6;3;9
15174;Žiogelis;SKRUZDELYTĖS;4508141956;Taip;5;9;2;16
15175;Žiogelis;SKRUZDELYTĖS;4343510173;Taip;0;15;0;15
15176;Žiogelis;SKRUZDELYTĖS;6346503991;Taip;8;0;2;10
15177;Žiogelis;SKRUZDELYTĖS;18018505301;Taip;0;5;0;5
15178;Žiogelis;SKRUZDELYTĖS;3503872654;Taip;1;0;0;1
15179;Žiogelis;SKRUZDELYTĖS;6067622823;Taip;5;0;0;5
15180;Žiogelis;SKRUZDELYTĖS;8702710674;Taip;0;18;0;18
15181;Žiogelis;SKRUZDELYTĖS;4671356872;Taip;15;1;0;16
15182;Žiogelis;SKRUZDELYTĖS;7881358741;Taip;4;1;0;5
15183;Žiogelis;SKRUZDELYTĖS;3750023611;Taip;1;5;0;6
15184;Žiogelis;SKRUZDELYTĖS;3609961581;Taip;12;5;0;17
15185;Žiogelis;SKRUZDELYTĖS;64865699245;Taip;9;1;0;10
15186;Žiogelis;SKRUZDELYTĖS;60959051938;Taip;5;0;0;5
15187;Žiogelis;SKRUZDELYTĖS;95713316600;Taip;0;6;0;6
15188;Žiogelis;SKRUZDELYTĖS;4445888917;Taip;2;1;0;3
15189;Žiogelis;SKRUZDELYTĖS;24941867247;Taip;0;0;2;2
15190;Žiogelis;SKRUZDELYTĖS;6659086172;Taip;19;0;0;19
15191;Žiogelis;SKRUZDELYTĖS;2883732914;Taip;4;0;0;4
15192;Žiogelis;SKRUZDELYTĖS;3189872952;Taip;4;0;0;4
15193;Žiogelis;SKRUZDELYTĖS;9295720241;Taip;12;0;1;13
15194;Žiogelis;SKRUZDELYTĖS;1568915914;Taip;5;5;0;10
15195;Žiogelis;SKRUZDELYTĖS;3203359908;Taip;12;1;0;13
15196;Žiogelis;SKRUZDELYTĖS;3320077143;Taip;6;0;0;6
15197;Žiogelis;ŽIRNIUKAI;7704256764;Taip;6;5;0;11
15198;Žiogelis;ŽIRNIUKAI;6701809272;Taip;8;1;1;10
15199;Žiogelis;ŽIRNIUKAI;2233244282;Taip;5;0;0;5
15200;Žiogelis;ŽIRNIUKAI;8675451323;Taip;6;0;1;7
15201;Žiogelis;ŽIRNIUKAI;85437321236;Taip;17;0;0;17
15202;Žiogelis;ŽIRNIUKAI;1660784232;Taip;15;0;0;15
15203;Žiogelis;ŽIRNIUKAI;1320651707;Taip;6;0;0;6
15204;Žiogelis;ŽIRNIUKAI;1235203700;Taip;11;0;0;11
15205;Žiogelis;ŽIRNIUKAI;1551989977;Taip;5;0;1;6
15206;Žiogelis;ŽIRNIUKAI;3310492752;Taip;11;0;0;11
15207;Žiogelis;ŽIRNIUKAI;5557800297;Taip;5;1;6;12
15208;Žiogelis;ŽIRNIUKAI;3392582853;Taip;5;1;6;12
15209;Žiogelis;ŽIRNIUKAI;2366095661;Taip;5;0;1;6
15210;Žiogelis;ŽIRNIUKAI;1320126836;Taip;3;0;0;3
15211;Žiogelis;ŽIRNIUKAI;1442866468;Taip;11;0;5;16
15212;Žiogelis;ŽIRNIUKAI;6697117406;Taip;12;0;0;12
15213;Žiogelis;ŽIRNIUKAI;9862582346;Taip;6;0;5;11
15214;Žiogelis;ŽIRNIUKAI;7087781379;Taip;10;5;0;15
15215;Žiogelis;ŽIRNIUKAI;4015109974;Taip;10;5;0;15
15216;Žiogelis;ŽIRNIUKAI;9406830518;Taip;10;0;3;13
15217;Žiogelis;ŽIRNIUKAI;3910954904;Taip;18;0;0;18
15218;Žiogelis;ŽIRNIUKAI;4713696984;Taip;9;0;1;10
15219;Žiogelis;DOBILĖLIAI;48593529087;Taip;0;1;0;1
15220;Žiogelis;DOBILĖLIAI;66336692039;Taip;0;6;0;6
15221;Žiogelis;DOBILĖLIAI;80149085891;Taip;5;8;0;13
15222;Žiogelis;DOBILĖLIAI;62821992692;Taip;0;5;1;6
15223;Žiogelis;DOBILĖLIAI;54215852783;Taip;4;0;0;4
15224;Žiogelis;DOBILĖLIAI;90670160456;Taip;0;3;0;3
15225;Žiogelis;DOBILĖLIAI;93657289013;Ne;12;0;0;12
15226;Žiogelis;DOBILĖLIAI;86956642477;Taip;3;2;0;5
15227;Žiogelis;DOBILĖLIAI;71044761864;Taip;0;0;3;3
15228;Žiogelis;DOBILĖLIAI;52411020277;Taip;7;0;0;7
15229;Žiogelis;DOBILĖLIAI;30708203430;Taip;5;4;0;9
15230;Žiogelis;DOBILĖLIAI;75553027681;Taip;0;5;0;5
15231;Žiogelis;DOBILĖLIAI;98097805447;Taip;6;6;0;12
15232;Žiogelis;DOBILĖLIAI;50662980044;Taip;4;1;0;5
15233;Žiogelis;DOBILĖLIAI;41857562297;Taip;5;0;0;5
15234;Žiogelis;DOBILĖLIAI;78375291773;Taip;0;0;1;1
15235;Žiogelis;DOBILĖLIAI;3820146581;Taip;5;1;0;6
15236;Žiogelis;DOBILĖLIAI;82777324022;Taip;13;3;0;16
15237;Žiogelis;DOBILĖLIAI;1970044099;Taip;0;5;0;5
15238;Žiogelis;DOBILĖLIAI;1100192617;Taip;5;0;0;5
15239;Žiogelis;DOBILĖLIAI;41258844862;Taip;10;2;0;12
15240;Žiogelis;BORUŽĖLĖS;49537204301;Taip;0;7;0;7
15241;Žiogelis;BORUŽĖLĖS;79801107515;Taip;0;2;1;3
15242;Žiogelis;BORUŽĖLĖS;48952047191;Taip;0;6;0;6
15243;Žiogelis;BORUŽĖLĖS;57076857319;Taip;10;0;0;10
15244;Žiogelis;BORUŽĖLĖS;64779912059;Taip;5;5;0;10
15245;Žiogelis;BORUŽĖLĖS;3136149837;Taip;0;5;0;5
15246;Žiogelis;BORUŽĖLĖS;96860756761;Taip;3;0;0;3
15247;Žiogelis;BORUŽĖLĖS;76191564181;Taip;4;7;0;11
15248;Žiogelis;BORUŽĖLĖS;41126779124;Taip;2;2;0;4
15249;Žiogelis;BORUŽĖLĖS;33241743715;Taip;0;5;1;6
15250;Žiogelis;BORUŽĖLĖS;57249343296;Taip;5;5;0;10
15251;Žiogelis;BORUŽĖLĖS;85673565399;Taip;5;7;0;12
15252;Žiogelis;BORUŽĖLĖS;30819925055;Taip;4;5;0;9
15253;Žiogelis;BORUŽĖLĖS;81464649021;Taip;0;5;5;10
15254;Žiogelis;BORUŽĖLĖS;35891668864;Taip;0;6;0;6
15255;Žiogelis;BORUŽĖLĖS;74697514256;Ne;0;5;1;6
15256;Žiogelis;BORUŽĖLĖS;18978600625;Taip;5;6;0;11
15257;Žiogelis;BORUŽĖLĖS;89033004994;Taip;10;5;0;15
15258;Žiogelis;BORUŽĖLĖS;32543247974;Taip;3;0;0;3
15259;Žiogelis;BORUŽĖLĖS;73146584544;Taip;9;8;0;17
15260;Žiogelis;BORUŽĖLĖS;86839909955;Taip;0;5;0;5
15261;Žiogelis;BORUŽĖLĖS;78885512443;Ne;6;3;0;9
15262;Žiogelis;BORUŽĖLĖS;2000906677;Taip;0;7;0;7
15263;Žiogelis;BORUŽĖLĖS;52901528922;Taip;5;0;0;5
15264;Žiogelis;DRUGELIAI;9826756136;Taip;10;0;0;10
15265;Žiogelis;DRUGELIAI;40049935108;Taip;2;15;0;17
15266;Žiogelis;DRUGELIAI;37505015919;Taip;11;5;0;16
15267;Žiogelis;DRUGELIAI;85453441005;Taip;5;0;0;5
15268;Žiogelis;DRUGELIAI;25631779076;Taip;16;2;0;18
15269;Žiogelis;DRUGELIAI;91499233609;Taip;0;5;0;5
15270;Žiogelis;DRUGELIAI;40186714037;Taip;5;4;0;9
15271;Žiogelis;DRUGELIAI;52847485981;Taip;5;2;0;7
15272;Žiogelis;DRUGELIAI;96793345108;Taip;10;5;0;15
15273;Žiogelis;DRUGELIAI;96369154198;Taip;5;3;0;8
15274;Žiogelis;DRUGELIAI;56579227266;Taip;10;0;0;10
15275;Žiogelis;DRUGELIAI;66037746045;Taip;5;4;0;9
15276;Žiogelis;DRUGELIAI;68621438109;Taip;5;5;1;11
15277;Žiogelis;DRUGELIAI;18225364866;Taip;5;1;0;6
15278;Žiogelis;DRUGELIAI;15810442449;Taip;20;0;0;20
15279;Žiogelis;DRUGELIAI;18957711548;Taip;6;0;0;6
15280;Žiogelis;DRUGELIAI;52855728176;Ne;0;8;0;8
15281;Žiogelis;DRUGELIAI;35609682774;Taip;5;5;0;10
15282;Žiogelis;DRUGELIAI;1096666450;Taip;10;2;0;12
15283;Žiogelis;DRUGELIAI;1237788562;Taip;0;8;0;8
15284;Žiogelis;DRUGELIAI;1867019234;Taip;0;6;0;6
15285;Žiogelis;DRUGELIAI;1082983134;Taip;10;5;0;15
15286;Žiogelis;DRUGELIAI;97696839366;Taip;14;0;1;15
15287;Žiogelis;PELĖDŽIUKAI;25765405268;Taip;0;4;0;4
15288;Žiogelis;PELĖDŽIUKAI;40656416455;Taip;7;6;0;13
15289;Žiogelis;PELĖDŽIUKAI;65431295185;Taip;2;0;0;2
15290;Žiogelis;PELĖDŽIUKAI;54157468880;Taip;0;5;0;5
15291;Žiogelis;PELĖDŽIUKAI;90856268042;Taip;8;7;0;15
15292;Žiogelis;PELĖDŽIUKAI;4546122149;Taip;0;4;0;4
15293;Žiogelis;PELĖDŽIUKAI;677032532;Taip;0;0;3;3
15294;Žiogelis;PELĖDŽIUKAI;75990939732;Taip;0;5;0;5
15295;Žiogelis;PELĖDŽIUKAI;99706324340;Taip;5;0;0;5
15296;Žiogelis;PELĖDŽIUKAI;87136010729;Taip;5;1;0;6
15297;Žiogelis;PELĖDŽIUKAI;83065651470;Taip;12;0;0;12
15298;Žiogelis;PELĖDŽIUKAI;5564124076;Taip;0;2;0;2
15299;Žiogelis;PELĖDŽIUKAI;88467192459;Taip;8;10;0;18
15300;Žiogelis;PELĖDŽIUKAI;23052639699;Taip;2;0;1;3
15301;Žiogelis;PELĖDŽIUKAI;30153333482;Taip;6;0;1;7
15302;Žiogelis;PELĖDŽIUKAI;9520854450;Taip;0;6;2;8
15303;Žiogelis;PELĖDŽIUKAI;46938187629;Taip;8;7;0;15
15304;Žiogelis;PELĖDŽIUKAI;65284631135;Taip;2;1;0;3
15305;Žiogelis;PELĖDŽIUKAI;1303123383;Taip;0;6;2;8
15306;Žiogelis;PELĖDŽIUKAI;62633906174;Taip;0;5;0;5
15307;Žiogelis;PELĖDŽIUKAI;2100993889;Taip;0;10;0;10
15308;Žiogelis;PELĖDŽIUKAI;82738581846;Taip;5;5;0;10
15309;Žiogelis;PELĖDŽIUKAI;80050087040;Taip;0;18;0;18
15310;Žiogelis;VARPELIAI;98313060080;Taip;0;5;0;5
15311;Žiogelis;VARPELIAI;63443494015;Taip;10;2;0;12
15312;Žiogelis;VARPELIAI;1069475442;Ne;0;19;0;19
15313;Žiogelis;VARPELIAI;81691405176;Taip;4;6;0;10
15314;Žiogelis;VARPELIAI;72043183625;Taip;0;7;0;7
15315;Žiogelis;VARPELIAI;42165847795;Taip;10;5;0;15
15316;Žiogelis;VARPELIAI;1198917418;Taip;0;5;0;5
15317;Žiogelis;VARPELIAI;1261679627;Taip;11;1;0;12
15318;Žiogelis;VARPELIAI;42895811959;Taip;0;1;0;1
15319;Žiogelis;VARPELIAI;44118139818;Taip;0;1;0;1
15320;Žiogelis;VARPELIAI;7708273984;Taip;6;2;0;8
15321;Žiogelis;VARPELIAI;12932356909;Taip;10;5;0;15
15322;Žiogelis;VARPELIAI;1060830668;Taip;18;0;0;18
15323;Žiogelis;VARPELIAI;9871477318;Taip;17;0;0;17
15324;Žiogelis;VARPELIAI;7824632294;Taip;4;2;0;6
15325;Žiogelis;VARPELIAI;6225523016;Taip;6;5;0;11
15326;Žiogelis;VARPELIAI;9436611716;Taip;5;5;0;10
15327;Žiogelis;VARPELIAI;2575280329;Taip;9;0;0;9
15328;Žiogelis;VARPELIAI;4402777236;Taip;17;0;0;17
15329;Žiogelis;VARPELIAI;1370071592;Taip;5;1;0;6
15330;Žiogelis;VARPELIAI;9416538794;Taip;0;2;0;2
15331;Žiogelis;KREGŽDUTĖS;20399291813;Taip;0;12;0;12
15332;Žiogelis;KREGŽDUTĖS;1521276302;Taip;0;7;0;7
15333;Žiogelis;KREGŽDUTĖS;52932005977;Taip;0;13;0;13
15334;Žiogelis;KREGŽDUTĖS;28585504631;Taip;17;0;0;17
15335;Žiogelis;KREGŽDUTĖS;43521866470;Taip;0;0;12;12
15336;Žiogelis;KREGŽDUTĖS;71387182665;Taip;20;0;0;20
15337;Žiogelis;KREGŽDUTĖS;94690046398;Taip;0;6;0;6
15338;Žiogelis;KREGŽDUTĖS;94313785346;Taip;11;1;3;15
15339;Žiogelis;KREGŽDUTĖS;88933947850;Taip;0;4;1;5
15340;Žiogelis;KREGŽDUTĖS;22969768169;Taip;0;7;0;7
15341;Žiogelis;KREGŽDUTĖS;18304908981;Taip;1;5;3;9
15342;Žiogelis;KREGŽDUTĖS;1042591705;Taip;0;11;0;11
15343;Žiogelis;KREGŽDUTĖS;1160064257;Taip;10;0;0;10
15344;Žiogelis;KREGŽDUTĖS;1162630845;Taip;0;1;3;4
15345;Žiogelis;KREGŽDUTĖS;2072071751;Taip;0;1;1;2
15346;Žiogelis;KREGŽDUTĖS;1200247527;Taip;20;0;0;20
15347;Žiogelis;KREGŽDUTĖS;41448152472;Taip;0;4;2;6
15348;Žiogelis;KREGŽDUTĖS;44023584723;Taip;6;5;0;11
15349;Žiogelis;KREGŽDUTĖS;1915370991;Taip;0;2;0;2
15350;Žiogelis;KREGŽDUTĖS;1821759690;Taip;0;1;0;1
15351;Žiogelis;KREGŽDUTĖS;24010106626;Taip;0;11;0;11
15352;Žiogelis;ŽVIRBLIUKAI;5364996984;Taip;20;0;0;20
15353;Žiogelis;ŽVIRBLIUKAI;9568208184;Taip;20;0;0;20
15354;Žiogelis;ŽVIRBLIUKAI;2117192553;Taip;5;0;0;5
15355;Žiogelis;ŽVIRBLIUKAI;5961630249;Taip;0;0;1;1
15356;Žiogelis;ŽVIRBLIUKAI;8683148826;Taip;8;0;2;10
15357;Žiogelis;ŽVIRBLIUKAI;3502278745;Taip;6;0;0;6
15358;Žiogelis;ŽVIRBLIUKAI;5054228916;Taip;3;3;0;6
15359;Žiogelis;ŽVIRBLIUKAI;3308563362;Taip;10;0;0;10
15360;Žiogelis;ŽVIRBLIUKAI;3928697936;Taip;9;0;0;9
15361;Žiogelis;ŽVIRBLIUKAI;1190395481;Taip;10;0;0;10
15362;Žiogelis;ŽVIRBLIUKAI;8715501524;Taip;20;0;0;20
15363;Žiogelis;ŽVIRBLIUKAI;1465027680;Taip;7;0;1;8
15364;Žiogelis;ŽVIRBLIUKAI;6495456608;Taip;13;0;0;13
15365;Žiogelis;ŽVIRBLIUKAI;6340620973;Taip;9;0;0;9
15366;Žiogelis;ŽVIRBLIUKAI;3426813997;Taip;12;0;1;13
15367;Žiogelis;ŽVIRBLIUKAI;3852211212;Taip;0;3;0;3
15368;Žiogelis;ŽVIRBLIUKAI;1468658102;Taip;20;0;0;20
15369;Žiogelis;ŽVIRBLIUKAI;9813150014;Taip;9;0;0;9
15370;Žiogelis;BITUTĖS;5639046412;Ne;0;15;0;15
15371;Žiogelis;BITUTĖS;65387706999;Taip;0;0;6;6
15372;Žiogelis;BITUTĖS;1649910477;Taip;20;0;0;20
15373;Žiogelis;BITUTĖS;98660118094;Taip;20;0;0;20
15374;Žiogelis;BITUTĖS;6963163354;Taip;5;5;0;10
15375;Žiogelis;BITUTĖS;29876596658;Taip;6;3;0;9
15376;Žiogelis;BITUTĖS;8169022043;Taip;10;5;0;15
15377;Žiogelis;BITUTĖS;84919810287;Taip;4;3;0;7
15378;Žiogelis;BITUTĖS;14932261911;Taip;5;2;0;7
15379;Žiogelis;BITUTĖS;67475530006;Taip;0;10;0;10
15380;Žiogelis;BITUTĖS;49836275638;Taip;0;1;0;1
15381;Žiogelis;BITUTĖS;63719135594;Taip;8;0;0;8
15382;Žiogelis;BITUTĖS;8819549855;Taip;1;2;0;3
15383;Žiogelis;BITUTĖS;81608736626;Taip;5;5;0;10
15384;Žiogelis;BITUTĖS;39293593638;Taip;2;0;0;2
15385;Žiogelis;BITUTĖS;1617516552;Taip;0;0;5;5
15386;Žiogelis;BITUTĖS;63956907259;Taip;5;7;0;12
15387;Žiogelis;BITUTĖS;73793165310;Taip;0;6;0;6
15388;Žiogelis;BITUTĖS;28788742249;Taip;0;6;0;6
15389;Žiogelis;BITUTĖS;4465151986;Taip;0;5;7;12
15390;Žiogelis;BITUTĖS;45051106222;Taip;0;3;0;3
15391;Žiogelis;BITUTĖS;87755643169;Taip;0;0;8;8
15392;Žiogelis;RIEŠUTĖLIAI;9981130790;Taip;20;0;0;20
15393;Žiogelis;RIEŠUTĖLIAI;9627583831;Taip;15;1;0;16
15394;Žiogelis;RIEŠUTĖLIAI;3420228264;Taip;5;0;0;5
15395;Žiogelis;RIEŠUTĖLIAI;5042341085;Taip;11;0;0;11
15396;Žiogelis;RIEŠUTĖLIAI;3752355139;Taip;10;0;3;13
15397;Žiogelis;RIEŠUTĖLIAI;3296450902;Taip;13;0;0;13
15398;Žiogelis;RIEŠUTĖLIAI;3820534331;Taip;4;0;0;4
15399;Žiogelis;RIEŠUTĖLIAI;1996517542;Taip;7;0;0;7
15400;Žiogelis;RIEŠUTĖLIAI;5545581078;Taip;7;1;0;8
15401;Žiogelis;RIEŠUTĖLIAI;4630381709;Taip;6;6;0;12
15402;Žiogelis;RIEŠUTĖLIAI;9790463889;Taip;17;0;0;17
15403;Žiogelis;RIEŠUTĖLIAI;6024752960;Taip;12;2;0;14
15404;Žiogelis;RIEŠUTĖLIAI;8853905367;Taip;12;2;0;14
15405;Žiogelis;RIEŠUTĖLIAI;1397686161;Taip;10;1;0;11
15406;Žiogelis;RIEŠUTĖLIAI;6760074113;Taip;14;1;0;15
15407;Žiogelis;RIEŠUTĖLIAI;3792114246;Taip;9;7;0;16
15408;Žiogelis;RIEŠUTĖLIAI;8293687695;Taip;10;5;0;15
15409;Žiogelis;RIEŠUTĖLIAI;2455244286;Taip;7;4;0;11
15410;Žolynėlis;Spanguolėlė;25151683915;Taip;0;1;0;1
15411;Žolynėlis;Spanguolėlė;8104525380;Taip;0;2;0;2
15412;Žolynėlis;Spanguolėlė;24353356454;Taip;0;12;0;12
15413;Žolynėlis;Spanguolėlė;97976573561;Taip;0;9;0;9
15414;Žolynėlis;Spanguolėlė;1920564803;Taip;1;6;0;7
15415;Žolynėlis;Spanguolėlė;92615552899;Taip;3;8;0;11
15416;Žolynėlis;Spanguolėlė;82641799101;Taip;0;6;0;6
15417;Žolynėlis;Spanguolėlė;4109395683;Taip;0;0;5;5
15418;Žolynėlis;Spanguolėlė;5901704055;Taip;0;4;0;4
15419;Žolynėlis;Spanguolėlė;5717038791;Taip;0;0;5;5
15420;Žolynėlis;Spanguolėlė;15306882704;Taip;0;1;0;1
15421;Žolynėlis;Spanguolėlė;9128728457;Taip;0;1;0;1
15422;Žolynėlis;Spanguolėlė;1216568014;Taip;0;4;0;4
15423;Žolynėlis;Spanguolėlė;7438853916;Taip;0;6;2;8
15424;Žolynėlis;Spanguolėlė;44063150309;Taip;0;3;0;3
15425;Žolynėlis;Spanguolėlė;8700231970;Taip;0;11;5;16
15426;Žolynėlis;Spanguolėlė;7831076713;Ne;0;4;2;6
15427;Žolynėlis;Spanguolėlė;1901979061;Taip;5;1;1;7
15428;Žolynėlis;Spanguolėlė;2984354887;Taip;0;1;0;1
15429;Žolynėlis;"RŪTELĖ (spec)";49076759224;Taip;0;14;0;14
15430;Žolynėlis;"RŪTELĖ (spec)";48837362422;Taip;0;6;0;6
15431;Žolynėlis;"RŪTELĖ (spec)";44929463545;Taip;2;5;0;7
15432;Žolynėlis;"RŪTELĖ (spec)";88879292846;Taip;0;6;0;6
15433;Žolynėlis;"RŪTELĖ (spec)";1954888655;Taip;4;1;0;5
15434;Žolynėlis;"SAULUTĖ (spec)";89488434450;Ne;0;2;0;2
15435;Žolynėlis;"SAULUTĖ (spec)";78150115970;Taip;0;1;0;1
15436;Žolynėlis;"SAULUTĖ (spec)";9468040148;Taip;5;7;0;12
15437;Žolynėlis;"SAULUTĖ (spec)";4438939800;Taip;5;2;1;8
15438;Žolynėlis;"LINELIS (spec)";7717415005;Taip;15;1;0;16
15439;Žolynėlis;"LINELIS (spec)";2665355759;Taip;15;1;0;16
15440;Žolynėlis;"RASAKILA (spec)";4971887781;Taip;3;0;0;3
15441;Žolynėlis;"RASAKILA (spec)";3337602618;Ne;8;0;0;8
15442;Žolynėlis;"RAMUNĖLĖS (spec)";43729773415;Taip;0;2;0;2
15443;Žolynėlis;"RAMUNĖLĖS (spec)";17307655696;Taip;0;2;0;2
15444;Žolynėlis;"RAMUNĖLĖS (spec)";91598708166;Taip;1;3;0;4
15445;Žolynėlis;"RAMUNĖLĖS (spec)";42425570226;Taip;0;1;0;1
15446;Žolynėlis;"RAMUNĖLĖS (spec)";6080154964;Taip;0;4;10;14
15447;Žolynėlis;"RAMUNĖLĖS (spec)";67411709338;Taip;2;1;0;3
15448;Žolynėlis;Dobiliukai;59125596894;Taip;0;7;0;7
15449;Žolynėlis;Dobiliukai;1123243743;Taip;7;0;1;8
15450;Žolynėlis;Dobiliukai;1655571687;Taip;8;6;0;14
15451;Žolynėlis;Dobiliukai;1197188528;Taip;0;7;1;8
15452;Žolynėlis;Dobiliukai;79759781705;Taip;0;1;0;1
15453;Žolynėlis;Dobiliukai;1833898567;Taip;4;6;0;10
15454;Žolynėlis;Dobiliukai;89750778560;Taip;0;7;8;15
15455;Žolynėlis;Dobiliukai;76688557717;Taip;5;1;0;6
15456;Žolynėlis;Dobiliukai;47442048515;Taip;0;2;0;2
15457;Žolynėlis;Dobiliukai;75335374706;Taip;5;6;0;11
15458;Žolynėlis;Dobiliukai;29420971822;Taip;0;2;4;6
15459;Žolynėlis;Dobiliukai;1080834237;Taip;7;0;0;7
15460;Žolynėlis;Dobiliukai;1619061427;Taip;20;0;0;20
15461;Žolynėlis;Dobiliukai;71887799705;Taip;0;5;0;5
15462;Žolynėlis;Dobiliukai;8872394996;Taip;6;7;4;17
15463;Žolynėlis;Dobiliukai;39450377869;Taip;20;0;0;20
15464;Žolynėlis;Dobiliukai;1933377698;Taip;0;1;0;1
15465;Žolynėlis;Aguonėlė;7313345140;Taip;0;1;0;1
15466;Žolynėlis;Aguonėlė;1620578562;Taip;5;8;0;13
15467;Žolynėlis;Aguonėlė;77707724932;Taip;0;2;1;3
15468;Žolynėlis;Aguonėlė;66167062016;Taip;0;6;0;6
15469;Žolynėlis;Aguonėlė;4545601535;Taip;0;11;0;11
15470;Žolynėlis;Aguonėlė;95007685205;Taip;0;4;0;4
15471;Žolynėlis;Aguonėlė;61475380296;Taip;0;5;0;5
15472;Žolynėlis;Aguonėlė;2051626484;Taip;13;3;0;16
15473;Žolynėlis;Aguonėlė;8027151284;Taip;0;11;0;11
15474;Žolynėlis;Aguonėlė;47825918748;Taip;0;11;0;11
15475;Žolynėlis;Aguonėlė;6169887781;Taip;5;0;2;7
15476;Žolynėlis;Aguonėlė;28730145668;Taip;0;0;2;2
15477;Žolynėlis;Aguonėlė;14877714964;Taip;0;1;0;1
15478;Žolynėlis;Aguonėlė;84849092452;Taip;0;1;0;1
15479;Žolynėlis;Aguonėlė;1257427271;Taip;9;3;0;12
15480;Žolynėlis;Aguonėlė;3263848791;Taip;0;0;7;7
15481;Žolynėlis;Aguonėlė;5827146071;Taip;0;9;1;10
15482;Žolynėlis;Aguonėlė;7256502393;Taip;0;2;4;6
15483;Žolynėlis;Aguonėlė;79704789499;Taip;0;2;1;3
15484;Žolynėlis;Pienė;3088932720;Taip;0;4;0;4
15485;Žolynėlis;Pienė;2108221942;Taip;2;5;0;7
15486;Žolynėlis;Pienė;7980206574;Taip;10;1;0;11
15487;Žolynėlis;Pienė;2460982987;Taip;0;0;1;1
15488;Žolynėlis;Pienė;6763515483;Taip;5;5;0;10
15489;Žolynėlis;Pienė;8215427354;Taip;0;6;0;6
15490;Žolynėlis;Pienė;1485195267;Taip;5;1;0;6
15491;Žolynėlis;Pienė;1163753820;Taip;6;7;0;13
15492;Žolynėlis;Pienė;9106152447;Taip;13;0;0;13
15493;Žolynėlis;Pienė;9941248291;Taip;20;0;0;20
15494;Žolynėlis;Pienė;7827343027;Taip;9;0;6;15
15495;Žolynėlis;Pienė;1338278043;Taip;0;0;12;12
15496;Žolynėlis;Čiobreliai;68439377746;Taip;3;1;0;4
15497;Žolynėlis;Čiobreliai;4379062413;Taip;0;6;0;6
15498;Žolynėlis;Čiobreliai;96960531652;Taip;0;6;0;6
15499;Žolynėlis;Čiobreliai;1135293576;Taip;0;5;0;5
15500;Žolynėlis;Čiobreliai;1188610173;Taip;5;7;0;12
15501;Žolynėlis;Čiobreliai;5262662371;Taip;9;4;0;13
15502;Žolynėlis;Čiobreliai;52441582081;Taip;0;8;0;8
15503;Žolynėlis;Čiobreliai;56001262869;Taip;0;1;0;1
15504;Žolynėlis;Čiobreliai;80589192193;Taip;0;3;0;3
15505;Žolynėlis;Čiobreliai;69270565365;Taip;8;4;0;12
15506;Žolynėlis;Čiobreliai;32852326605;Taip;0;1;0;1
15507;Žolynėlis;Čiobreliai;67610580721;Taip;0;13;0;13
15508;Žolynėlis;Čiobreliai;2142241983;Ne;20;0;0;20
15509;Žolynėlis;Čiobreliai;93243311709;Taip;0;11;0;11
15510;Žolynėlis;Čiobreliai;91866724044;Taip;0;14;0;14
15511;Žolynėlis;Čiobreliai;28388449859;Ne;0;1;0;1
15512;Žolynėlis;Čiobreliai;16469644694;Taip;0;5;0;5
15513;Žolynėlis;Čiobreliai;58271736414;Taip;0;5;0;5
15514;Žolynėlis;Čiobreliai;76160324851;Taip;0;8;0;8
15515;Žolynėlis;Avietėlė;9207088786;Taip;0;1;2;3
15516;Žolynėlis;Avietėlė;1337138547;Taip;9;1;0;10
15517;Žolynėlis;Avietėlė;5432464074;Taip;15;5;0;20
15518;Žolynėlis;Avietėlė;3192462197;Taip;9;0;1;10
15519;Žolynėlis;Avietėlė;1189484802;Taip;0;2;3;5
15520;Žolynėlis;Avietėlė;2881461471;Taip;0;11;0;11
15521;Žolynėlis;Avietėlė;5173171444;Taip;0;7;0;7
15522;Žolynėlis;Avietėlė;3984024179;Taip;11;0;0;11
15523;Žolynėlis;Avietėlė;6829144389;Taip;0;0;7;7
15524;Žolynėlis;Avietėlė;6416217971;Taip;5;0;3;8
15525;Žolynėlis;Avietėlė;8646095992;Taip;20;0;0;20
15526;Žolynėlis;Rugiagėlė;5767549779;Taip;6;2;0;8
15527;Žolynėlis;Rugiagėlė;1223126521;Taip;0;12;0;12
15528;Žolynėlis;Rugiagėlė;8547773739;Taip;0;7;2;9
15529;Žolynėlis;Rugiagėlė;25487230804;Taip;11;2;0;13
15530;Žolynėlis;Rugiagėlė;7870236961;Taip;0;2;3;5
15531;Žolynėlis;Rugiagėlė;2785156297;Taip;0;15;0;15
15532;Žolynėlis;Rugiagėlė;3198470147;Taip;0;11;0;11
15533;Žolynėlis;Rugiagėlė;2779563503;Taip;0;15;0;15
15534;Žolynėlis;Rugiagėlė;3422605135;Taip;5;2;0;7
15535;Žolynėlis;Rugiagėlė;5650427433;Taip;15;1;0;16
15536;Žolynėlis;Rugiagėlė;1473516753;Taip;5;0;0;5
15537;Žolynėlis;Rugiagėlė;5668288544;Taip;0;11;0;11
15538;Žolynėlis;Rugiagėlė;9997358375;Taip;5;2;4;11
15539;Žuvėdra;"JŪROS ŽVAIGŽDUTĖS";91701621174;Taip;0;2;6;8
15540;Žuvėdra;"JŪROS ŽVAIGŽDUTĖS";64256836669;Taip;0;3;6;9
15541;Žuvėdra;"JŪROS ŽVAIGŽDUTĖS";27394642359;Taip;11;3;0;14
15542;Žuvėdra;"JŪROS ŽVAIGŽDUTĖS";74637620163;Ne;0;2;3;5
15543;Žuvėdra;"JŪROS ŽVAIGŽDUTĖS";8495976081;Ne;0;10;0;10
15544;Žuvėdra;"JŪROS ŽVAIGŽDUTĖS";35541220076;Taip;0;4;1;5
15545;Žuvėdra;"JŪROS ŽVAIGŽDUTĖS";61744715160;Taip;0;8;0;8
15546;Žuvėdra;"JŪROS ŽVAIGŽDUTĖS";16298551647;Taip;0;5;0;5
15547;Žuvėdra;"JŪROS ŽVAIGŽDUTĖS";12396055288;Taip;0;1;0;1
15548;Žuvėdra;"JŪROS ŽVAIGŽDUTĖS";88986915159;Taip;5;5;0;10
15549;Žuvėdra;"JŪROS ŽVAIGŽDUTĖS";3516571980;Taip;0;5;2;7
15550;Žuvėdra;"JŪROS ŽVAIGŽDUTĖS";69459090757;Taip;0;9;0;9
15551;Žuvėdra;"JŪROS ŽVAIGŽDUTĖS";1088862044;Taip;7;11;0;18
15552;Žuvėdra;"JŪROS ŽVAIGŽDUTĖS";63818919795;Ne;10;0;0;10
15553;Žuvėdra;"JŪROS ŽVAIGŽDUTĖS";1132159017;Taip;9;0;0;9
15554;Žuvėdra;"JŪROS ŽVAIGŽDUTĖS";1553949223;Taip;0;5;1;6
15555;Žuvėdra;"JŪROS ŽVAIGŽDUTĖS";3960330875;Ne;0;10;2;12
15556;Žuvėdra;"JŪROS ŽVAIGŽDUTĖS";83557400243;Taip;5;6;0;11
15557;Žuvėdra;"JŪROS ŽVAIGŽDUTĖS";4572580937;Taip;0;5;0;5
15558;Žuvėdra;"JŪROS ŽVAIGŽDUTĖS";97427805302;Taip;0;0;1;1
15559;Žuvėdra;"JŪROS ŽVAIGŽDUTĖS";83890207087;Taip;0;13;0;13
15560;Žuvėdra;DELFINUKAI;1298316563;Ne;0;15;0;15
15561;Žuvėdra;DELFINUKAI;23851864127;Taip;0;4;3;7
15562;Žuvėdra;DELFINUKAI;8843700949;Ne;0;1;0;1
15563;Žuvėdra;DELFINUKAI;1203660127;Taip;5;7;0;12
15564;Žuvėdra;DELFINUKAI;87882215162;Taip;0;1;0;1
15565;Žuvėdra;DELFINUKAI;67652620656;Taip;5;0;0;5
15566;Žuvėdra;DELFINUKAI;9911525172;Taip;0;9;0;9
15567;Žuvėdra;DELFINUKAI;34574939898;Taip;0;11;0;11
15568;Žuvėdra;DELFINUKAI;11300891895;Taip;0;6;0;6
15569;Žuvėdra;DELFINUKAI;42069870710;Taip;9;5;0;14
15570;Žuvėdra;DELFINUKAI;19471902337;Taip;0;18;0;18
15571;Žuvėdra;DELFINUKAI;28021807339;Taip;0;6;0;6
15572;Žuvėdra;DELFINUKAI;8096854841;Taip;13;5;0;18
15573;Žuvėdra;DELFINUKAI;3148638780;Taip;0;12;0;12
15574;Žuvėdra;DELFINUKAI;17110908746;Taip;0;4;0;4
15575;Žuvėdra;DELFINUKAI;3943563359;Taip;0;4;0;4
15576;Žuvėdra;DELFINUKAI;41258849574;Taip;0;0;2;2
15577;Žuvėdra;DELFINUKAI;5472830961;Ne;1;0;0;1
15578;Žuvėdra;DELFINUKAI;1938808693;Taip;2;0;0;2
15579;Žuvėdra;DELFINUKAI;1147279898;Taip;0;2;0;2
15580;Žuvėdra;DELFINUKAI;2334342995;Taip;13;0;0;13
15581;Žuvėdra;DELFINUKAI;5558584030;Taip;5;0;2;7
15582;Žuvėdra;DELFINUKAI;5049101816;Taip;0;12;0;12
15583;Žuvėdra;OSMINOŽKI;3069966490;Taip;20;0;0;20
15584;Žuvėdra;OSMINOŽKI;27467834587;Taip;0;5;6;11
15585;Žuvėdra;OSMINOŽKI;65157356661;Taip;0;10;0;10
15586;Žuvėdra;OSMINOŽKI;47125994363;Taip;0;7;0;7
15587;Žuvėdra;OSMINOŽKI;21905924984;Taip;0;2;0;2
15588;Žuvėdra;OSMINOŽKI;82141291604;Taip;2;4;0;6
15589;Žuvėdra;OSMINOŽKI;64732685802;Taip;8;5;0;13
15590;Žuvėdra;OSMINOŽKI;1434244321;Taip;9;5;1;15
15591;Žuvėdra;OSMINOŽKI;960934150;Taip;10;0;0;10
15592;Žuvėdra;OSMINOŽKI;51868435508;Taip;0;6;0;6
15593;Žuvėdra;OSMINOŽKI;1762760384;Taip;5;0;0;5
15594;Žuvėdra;OSMINOŽKI;1963584073;Taip;20;0;0;20
15595;Žuvėdra;OSMINOŽKI;2136463079;Taip;7;5;0;12
15596;Žuvėdra;OSMINOŽKI;74446494235;Taip;0;15;0;15
15597;Žuvėdra;OSMINOŽKI;41564122720;Taip;5;0;0;5
15598;Žuvėdra;OSMINOŽKI;1639340750;Taip;0;1;2;3
15599;Žuvėdra;OSMINOŽKI;3487938908;Taip;5;0;0;5
15600;Žuvėdra;OSMINOŽKI;66236924555;Taip;0;8;0;8
15601;Žuvėdra;OSMINOŽKI;66973380124;Taip;8;5;3;16
15602;Žuvėdra;OSMINOŽKI;3862711062;Ne;5;3;0;8
15603;Žuvėdra;OSMINOŽKI;8134671188;Taip;0;3;8;11
15604;Žuvėdra;OSMINOŽKI;4588593273;Taip;5;5;1;11
15605;Žuvėdra;OSMINOŽKI;55687216943;Taip;0;8;0;8
15606;Žuvėdra;OSMINOŽKI;1236696072;Taip;5;5;0;10
15607;Žuvėdra;RUSALAČKA;24915726868;Taip;7;5;0;12
15608;Žuvėdra;RUSALAČKA;1116645502;Taip;5;8;0;13
15609;Žuvėdra;RUSALAČKA;1195732987;Taip;12;1;0;13
15610;Žuvėdra;RUSALAČKA;1312918359;Taip;5;1;0;6
15611;Žuvėdra;RUSALAČKA;1923452638;Taip;8;0;0;8
15612;Žuvėdra;RUSALAČKA;6468506668;Ne;10;1;0;11
15613;Žuvėdra;RUSALAČKA;8408371550;Taip;7;1;0;8
15614;Žuvėdra;RUSALAČKA;2731016281;Taip;9;7;0;16
15615;Žuvėdra;RUSALAČKA;1164464390;Taip;5;7;0;12
15616;Žuvėdra;RUSALAČKA;1340241206;Taip;8;1;0;9
15617;Žuvėdra;RUSALAČKA;5021263583;Taip;13;3;0;16
15618;Žuvėdra;RUSALAČKA;5489757084;Taip;0;6;0;6
15619;Žuvėdra;RUSALAČKA;14760907606;Taip;3;3;0;6
15620;Žuvėdra;RUSALAČKA;1632308084;Taip;5;2;0;7
15621;Žuvėdra;RUSALAČKA;4011849839;Taip;6;10;0;16
15622;Žuvėdra;RUSALAČKA;75901332720;Taip;5;4;0;9
15623;Žuvėdra;RUSALAČKA;5684848140;Taip;4;12;0;16
15624;Žuvėdra;RUSALAČKA;5496071972;Taip;13;0;0;13
15625;Žuvėdra;RUSALAČKA;6612880861;Taip;10;0;0;10
15626;Žuvėdra;RUSALAČKA;1941428466;Taip;10;0;0;10
15627;Žuvėdra;RUSALAČKA;6007871092;Taip;10;0;0;10
15628;Žuvėdra;RUSALAČKA;63053155507;Taip;0;5;0;5
15629;Žuvėdra;JANTARIKI;5674529681;Taip;11;5;0;16
15630;Žuvėdra;JANTARIKI;9421259943;Taip;6;0;0;6
15631;Žuvėdra;JANTARIKI;1509519996;Taip;0;20;0;20
15632;Žuvėdra;JANTARIKI;6537464526;Taip;0;20;0;20
15633;Žuvėdra;JANTARIKI;9870595577;Taip;8;1;0;9
15634;Žuvėdra;JANTARIKI;6294045755;Taip;10;5;0;15
15635;Žuvėdra;JANTARIKI;7710853637;Taip;10;0;0;10
15636;Žuvėdra;JANTARIKI;7630057671;Taip;5;1;0;6
15637;Žuvėdra;JANTARIKI;7368183516;Taip;0;20;0;20
15638;Žuvėdra;JANTARIKI;3068069755;Taip;0;8;0;8
15639;Žuvėdra;JANTARIKI;5151984122;Taip;7;0;0;7
15640;Žuvėdra;JANTARIKI;3185158741;Taip;3;5;0;8
15641;Žuvėdra;JANTARIKI;1200084485;Taip;10;0;4;14
15642;Žuvėdra;JANTARIKI;2694424532;Taip;15;5;0;20
15643;Žuvėdra;JANTARIKI;5198825127;Taip;15;5;0;20
15644;Žuvėdra;JANTARIKI;4177319374;Taip;0;0;1;1
15645;Žuvėdra;JANTARIKI;5561903903;Taip;9;0;0;9
15646;Žuvėdra;"AUKSINĖ ŽUVELĖ";6547167325;Taip;15;0;0;15
15647;Žuvėdra;"AUKSINĖ ŽUVELĖ";8434697374;Taip;15;4;0;19
15648;Žuvėdra;"AUKSINĖ ŽUVELĖ";5157814568;Taip;10;1;0;11
15649;Žuvėdra;"AUKSINĖ ŽUVELĖ";7916717208;Taip;0;5;0;5
15650;Žuvėdra;"AUKSINĖ ŽUVELĖ";4497938258;Taip;0;8;0;8
15651;Žuvėdra;"AUKSINĖ ŽUVELĖ";2092890028;Taip;7;4;0;11
15652;Žuvėdra;"AUKSINĖ ŽUVELĖ";1311162040;Taip;0;19;0;19
15653;Žuvėdra;"AUKSINĖ ŽUVELĖ";3853045274;Taip;7;1;0;8
15654;Žuvėdra;"AUKSINĖ ŽUVELĖ";4864834075;Taip;0;2;0;2
15655;Žuvėdra;"AUKSINĖ ŽUVELĖ";5764128482;Taip;6;5;2;13
15656;Žuvėdra;"AUKSINĖ ŽUVELĖ";8512570256;Taip;0;2;0;2
15657;Žuvėdra;"AUKSINĖ ŽUVELĖ";9593426121;Taip;15;5;0;20
15658;Žuvėdra;"AUKSINĖ ŽUVELĖ";2019806688;Taip;15;5;0;20
15659;Žuvėdra;"AUKSINĖ ŽUVELĖ";3445649442;Taip;5;0;0;5
15660;Žuvėdra;"AUKSINĖ ŽUVELĖ";6602037942;Taip;20;0;0;20
15661;Žuvėdra;"AUKSINĖ ŽUVELĖ";3464935314;Taip;5;5;0;10
15662;Žvangutis;PELIUKŲ;1265027238;Taip;0;5;0;5
15663;Žvangutis;PELIUKŲ;6701947168;Taip;0;6;0;6
15664;Žvangutis;PELIUKŲ;6068428687;Taip;5;5;1;11
15665;Žvangutis;PELIUKŲ;50889154641;Taip;10;0;0;10
15666;Žvangutis;PELIUKŲ;1165172787;Taip;0;5;0;5
15667;Žvangutis;PELIUKŲ;1339151674;Taip;11;3;1;15
15668;Žvangutis;PELIUKŲ;1310113034;Taip;3;2;1;6
15669;Žvangutis;PELIUKŲ;7202747419;Taip;5;0;0;5
15670;Žvangutis;PELIUKŲ;9149037184;Taip;0;9;0;9
15671;Žvangutis;PELIUKŲ;3665275100;Taip;5;0;0;5
15672;Žvangutis;PELIUKŲ;7320625500;Taip;0;5;0;5
15673;Žvangutis;PELIUKŲ;3513746926;Taip;19;0;0;19
15674;Žvangutis;PELIUKŲ;4053450010;Taip;5;0;0;5
15675;Žvangutis;PELIUKŲ;9408369641;Taip;6;4;4;14
15676;Žvangutis;PELIUKŲ;5012996199;Taip;12;0;0;12
15677;Žvangutis;PELIUKŲ;8288997508;Taip;0;15;0;15
15678;Žvangutis;PELIUKŲ;6844824726;Taip;0;14;0;14
15679;Žvangutis;PELIUKŲ;3315858185;Taip;20;0;0;20
15680;Žvangutis;PELIUKŲ;92356998180;Taip;10;3;0;13
15681;Žvangutis;PELIUKŲ;5683601025;Taip;0;3;0;3
15682;Žvangutis;PELIUKŲ;8617941954;Taip;0;1;0;1
15683;Žvangutis;ANČIUKŲ;63793471104;Taip;0;2;0;2
15684;Žvangutis;ANČIUKŲ;10323604113;Taip;0;5;0;5
15685;Žvangutis;ANČIUKŲ;26860427962;Taip;0;4;0;4
15686;Žvangutis;ANČIUKŲ;4211541351;Taip;0;0;10;10
15687;Žvangutis;ANČIUKŲ;3753209769;Taip;10;0;0;10
15688;Žvangutis;ANČIUKŲ;5959638828;Ne;8;0;0;8
15689;Žvangutis;ANČIUKŲ;1008391034;Taip;0;3;0;3
15690;Žvangutis;ANČIUKŲ;1648977542;Taip;0;4;0;4
15691;Žvangutis;ANČIUKŲ;59628443049;Taip;0;11;0;11
15692;Žvangutis;ANČIUKŲ;72773865306;Taip;0;18;0;18
15693;Žvangutis;ANČIUKŲ;48094219446;Taip;0;9;0;9
15694;Žvangutis;ANČIUKŲ;40512304884;Taip;6;2;0;8
15695;Žvangutis;ANČIUKŲ;44414276315;Taip;0;2;0;2
15696;Žvangutis;ANČIUKŲ;607103192;Ne;0;11;0;11
15697;Žvangutis;ANČIUKŲ;78462097679;Taip;0;1;0;1
15698;Žvangutis;ANČIUKŲ;77005496286;Taip;0;1;0;1
15699;Žvangutis;ANČIUKŲ;90542583948;Taip;3;0;0;3
15700;Žvangutis;ANČIUKŲ;40872355721;Taip;0;5;5;10
15701;Žvangutis;ANČIUKŲ;29578115987;Taip;0;5;0;5
15702;Žvangutis;ANČIUKŲ;7611207661;Taip;0;8;0;8
15703;Žvangutis;ANČIUKŲ;1416765181;Taip;8;1;0;9
15704;Žvangutis;ANČIUKŲ;1647547244;Taip;0;5;1;6
15705;Žvangutis;ANČIUKŲ;4181261835;Taip;0;1;0;1
15706;Žvangutis;PELĖDŽIUKŲ;95130491335;Taip;2;6;1;9
15707;Žvangutis;PELĖDŽIUKŲ;16003414040;Taip;0;1;7;8
15708;Žvangutis;PELĖDŽIUKŲ;93175189832;Taip;0;1;0;1
15709;Žvangutis;PELĖDŽIUKŲ;1353686877;Taip;0;2;1;3
15710;Žvangutis;PELĖDŽIUKŲ;98607926663;Taip;0;1;0;1
15711;Žvangutis;PELĖDŽIUKŲ;9618217868;Taip;0;8;2;10
15712;Žvangutis;PELĖDŽIUKŲ;91140904183;Taip;0;5;3;8
15713;Žvangutis;PELĖDŽIUKŲ;30697407645;Ne;0;1;0;1
15714;Žvangutis;PELĖDŽIUKŲ;86145834840;Taip;4;6;0;10
15715;Žvangutis;PELĖDŽIUKŲ;93894162596;Taip;4;1;0;5
15716;Žvangutis;PELĖDŽIUKŲ;38451136109;Taip;4;2;0;6
15717;Žvangutis;PELĖDŽIUKŲ;39364323060;Taip;0;10;0;10
15718;Žvangutis;PELĖDŽIUKŲ;57033172828;Taip;14;6;0;20
15719;Žvangutis;PELĖDŽIUKŲ;80054829676;Taip;15;0;0;15
15720;Žvangutis;PELĖDŽIUKŲ;11053503331;Taip;0;1;0;1
15721;Žvangutis;PELĖDŽIUKŲ;96992002828;Taip;0;11;0;11
15722;Žvangutis;PELĖDŽIUKŲ;41703990445;Taip;10;7;0;17
15723;Žvangutis;PELĖDŽIUKŲ;5929099485;Taip;0;4;0;4
15724;Žvangutis;PELĖDŽIUKŲ;77044982999;Taip;20;0;0;20
15725;Žvangutis;PELĖDŽIUKŲ;46410307693;Taip;5;5;1;11
15726;Žvangutis;PELĖDŽIUKŲ;3049348955;Taip;0;8;0;8
15727;Žvangutis;PELĖDŽIUKŲ;5616640228;Taip;0;6;1;7
15728;Žvangutis;PELĖDŽIUKŲ;1898484868;Taip;0;5;0;5
15729;Žvangutis;PELĖDŽIUKŲ;77459956838;Taip;0;8;0;8
15730;Žvangutis;PELĖDŽIUKŲ;46159057420;Taip;2;5;5;12
15731;Žvangutis;PELĖDŽIUKŲ;12457255518;Taip;6;2;0;8
15732;Žvangutis;KAČIUKŲ;1882797491;Taip;0;3;0;3
15733;Žvangutis;KAČIUKŲ;65598561926;Taip;2;7;0;9
15734;Žvangutis;KAČIUKŲ;87842631698;Taip;2;7;0;9
15735;Žvangutis;KAČIUKŲ;52676408047;Taip;7;0;0;7
15736;Žvangutis;KAČIUKŲ;1845521463;Taip;8;0;0;8
15737;Žvangutis;KAČIUKŲ;52544167449;Taip;0;1;0;1
15738;Žvangutis;KAČIUKŲ;8697156717;Taip;0;6;1;7
15739;Žvangutis;KAČIUKŲ;23369081648;Taip;0;3;0;3
15740;Žvangutis;KAČIUKŲ;6989839997;Taip;0;7;1;8
15741;Žvangutis;KAČIUKŲ;1065463278;Ne;0;11;0;11
15742;Žvangutis;KAČIUKŲ;1369424754;Taip;7;9;0;16
15743;Žvangutis;KAČIUKŲ;1823402065;Taip;2;0;0;2
15744;Žvangutis;KAČIUKŲ;6343552093;Taip;5;11;0;16
15745;Žvangutis;KAČIUKŲ;2145325174;Taip;5;5;1;11
15746;Žvangutis;KAČIUKŲ;7267340112;Taip;0;5;1;6
15747;Žvangutis;KAČIUKŲ;2251482949;Taip;0;9;0;9
15748;Žvangutis;KAČIUKŲ;45857502483;Taip;4;0;0;4
15749;Žvangutis;KAČIUKŲ;1642007971;Taip;0;13;0;13
15750;Žvangutis;KAČIUKŲ;1862121693;Taip;0;3;0;3
15751;Žvangutis;KAČIUKŲ;9145365865;Taip;8;0;0;8
15752;Žvangutis;KAČIUKŲ;619059820;Taip;0;1;0;1
15753;Žvangutis;MEŠKUČIŲ;2755838558;Taip;0;12;0;12
15754;Žvangutis;MEŠKUČIŲ;2411307963;Taip;9;0;0;9
15755;Žvangutis;MEŠKUČIŲ;1324948757;Taip;9;0;0;9
15756;Žvangutis;MEŠKUČIŲ;7581320158;Taip;5;0;0;5
15757;Žvangutis;MEŠKUČIŲ;1322688456;Taip;15;0;0;15
15758;Žvangutis;MEŠKUČIŲ;9468660351;Taip;15;0;0;15
15759;Žvangutis;MEŠKUČIŲ;1185135525;Taip;0;7;0;7
15760;Žvangutis;MEŠKUČIŲ;7721746116;Taip;13;0;0;13
15761;Žvangutis;MEŠKUČIŲ;2598842770;Taip;0;15;0;15
15762;Žvangutis;MEŠKUČIŲ;2570379643;Taip;15;0;0;15
15763;Žvangutis;MEŠKUČIŲ;9036869235;Taip;0;12;0;12
15764;Žvangutis;MEŠKUČIŲ;2922083476;Taip;11;1;0;12
15765;Žvangutis;MEŠKUČIŲ;7483570779;Taip;0;12;0;12
15766;Žvangutis;MEŠKUČIŲ;1282567366;Taip;13;1;0;14
15767;Žvangutis;KIŠKUČIŲ;1687362077;Taip;0;7;0;7
15768;Žvangutis;KIŠKUČIŲ;1886637245;Taip;12;0;0;12
15769;Žvangutis;KIŠKUČIŲ;96443240617;Taip;0;5;0;5
15770;Žvangutis;KIŠKUČIŲ;4249416168;Taip;0;12;0;12
15771;Žvangutis;KIŠKUČIŲ;1096499939;Taip;0;10;0;10
15772;Žvangutis;KIŠKUČIŲ;1481786579;Taip;5;2;0;7
15773;Žvangutis;KIŠKUČIŲ;1334567751;Taip;0;8;0;8
15774;Žvangutis;KIŠKUČIŲ;2138652487;Taip;15;2;0;17
15775;Žvangutis;KIŠKUČIŲ;1693249341;Taip;0;9;0;9
15776;Žvangutis;KIŠKUČIŲ;4798540560;Taip;0;10;0;10
15777;Žvangutis;KIŠKUČIŲ;1847928083;Taip;0;1;0;1
15778;Žvangutis;KIŠKUČIŲ;1665136168;Taip;0;8;0;8
15779;Žvangutis;KIŠKUČIŲ;1251015310;Taip;2;5;0;7
15780;Žvangutis;KIŠKUČIŲ;5563516622;Taip;0;11;0;11
15781;Žvangutis;KIŠKUČIŲ;74528704135;Taip;0;8;0;8
15782;Žvangutis;KIŠKUČIŲ;57385778197;Taip;0;4;14;18
15783;Žvangutis;KIŠKUČIŲ;3775960571;Taip;0;14;0;14
15784;Žvangutis;KIŠKUČIŲ;11567978993;Taip;8;0;3;11
15785;Žvangutis;KIŠKUČIŲ;79808715852;Taip;0;9;0;9
15786;Žvangutis;KIŠKUČIŲ;9134683276;Taip;0;13;0;13
15787;Žirniukas;Boružiukų;38558266443;Taip;0;2;0;2
15788;Žirniukas;Boružiukų;85078595504;Ne;5;5;0;10
15789;Žirniukas;Boružiukų;87149595988;Taip;0;11;0;11
15790;Žirniukas;Boružiukų;57130875338;Taip;0;4;1;5
15791;Žirniukas;Boružiukų;63316123515;Taip;7;2;0;9
15792;Žirniukas;Boružiukų;7648905323;Taip;5;6;0;11
15793;Žirniukas;Boružiukų;25844087366;Taip;0;3;0;3
15794;Žirniukas;Boružiukų;37993215508;Taip;0;1;0;1
15795;Žirniukas;Boružiukų;86712175200;Taip;0;8;0;8
15796;Žirniukas;Boružiukų;68085114059;Ne;6;7;0;13
15797;Žirniukas;Boružiukų;79871296529;Taip;5;4;0;9
15798;Žirniukas;Boružiukų;74201207995;Taip;5;2;2;9
15799;Žirniukas;Boružiukų;77137353896;Taip;0;5;0;5
15800;Žirniukas;Boružiukų;5797345627;Taip;7;6;0;13
15801;Žirniukas;Boružiukų;27435013977;Taip;0;5;0;5
15802;Žirniukas;Boružiukų;93794255172;Taip;20;0;0;20
15803;Žirniukas;Boružiukų;63115775194;Taip;11;1;0;12
15804;Žirniukas;Boružiukų;97256249008;Taip;4;0;0;4
15805;Žirniukas;Boružiukų;70866622909;Taip;5;1;0;6
15806;Žirniukas;Boružiukų;35928289177;Taip;0;6;0;6
15807;Žirniukas;Boružiukų;67770044313;Taip;9;0;0;9
15808;Žirniukas;Boružiukų;52079839837;Taip;0;5;1;6
15809;Žirniukas;Boružiukų;1746748097;Taip;5;1;0;6
15810;Žirniukas;Smalsučiai;1701389895;Taip;0;4;2;6
15811;Žirniukas;Smalsučiai;65471257240;Taip;15;0;0;15
15812;Žirniukas;Smalsučiai;99019576563;Taip;4;1;0;5
15813;Žirniukas;Smalsučiai;56948775759;Taip;0;5;0;5
15814;Žirniukas;Smalsučiai;83035751096;Taip;0;10;2;12
15815;Žirniukas;Smalsučiai;29792078209;Taip;0;1;2;3
15816;Žirniukas;Smalsučiai;23221186484;Taip;7;5;0;12
15817;Žirniukas;Smalsučiai;43241022100;Taip;0;0;4;4
15818;Žirniukas;Smalsučiai;54285529186;Taip;8;0;0;8
15819;Žirniukas;Smalsučiai;1382313386;Taip;5;1;5;11
15820;Žirniukas;Smalsučiai;49058747304;Taip;0;6;7;13
15821;Žirniukas;Smalsučiai;6718181545;Taip;5;0;0;5
15822;Žirniukas;Smalsučiai;54685058502;Taip;3;0;2;5
15823;Žirniukas;Smalsučiai;59972903968;Taip;0;3;2;5
15824;Žirniukas;Smalsučiai;4377015113;Taip;1;0;0;1
15825;Žirniukas;Smalsučiai;37416946100;Taip;0;7;1;8
15826;Žirniukas;Smalsučiai;3723155762;Taip;5;3;1;9
15827;Žirniukas;Smalsučiai;3239212369;Taip;0;5;0;5
15828;Žirniukas;Smalsučiai;15527206706;Taip;0;2;0;2
15829;Žirniukas;Smalsučiai;83997736517;Taip;0;1;0;1
15830;Žirniukas;Smalsučiai;1150580143;Taip;12;2;0;14
15831;Žirniukas;Smalsučiai;7739943293;Taip;0;7;0;7
15832;Žirniukas;Smalsučiai;89146903524;Taip;0;4;0;4
15833;Žirniukas;Gėlyčių;86374817570;Taip;1;5;6;12
15834;Žirniukas;Gėlyčių;51940895885;Taip;5;5;1;11
15835;Žirniukas;Gėlyčių;469740948;Taip;0;4;0;4
15836;Žirniukas;Gėlyčių;1514883654;Ne;0;13;0;13
15837;Žirniukas;Gėlyčių;3807957588;Taip;15;3;0;18
15838;Žirniukas;Gėlyčių;57834170089;Taip;0;7;0;7
15839;Žirniukas;Gėlyčių;9192660067;Taip;4;2;3;9
15840;Žirniukas;Gėlyčių;74425301830;Taip;8;4;0;12
15841;Žirniukas;Gėlyčių;3763537106;Taip;11;0;0;11
15842;Žirniukas;Gėlyčių;7809088591;Taip;10;0;0;10
15843;Žirniukas;Gėlyčių;6649555415;Ne;4;2;6;12
15844;Žirniukas;Gėlyčių;59028339197;Taip;10;0;0;10
15845;Žirniukas;Gėlyčių;32583177093;Taip;0;3;0;3
15846;Žirniukas;Gėlyčių;1804181833;Taip;4;0;0;4
15847;Žirniukas;Gėlyčių;47573534391;Taip;6;3;0;9
15848;Žirniukas;Gėlyčių;1878369945;Taip;17;0;0;17
15849;Žirniukas;Gėlyčių;2072018782;Taip;0;4;0;4
15850;Žirniukas;Gėlyčių;1378845384;Taip;8;5;0;13
15851;Žirniukas;Nykštukų;2309995947;Taip;8;4;0;12
15852;Žirniukas;Nykštukų;1944169398;Taip;0;15;0;15
15853;Žirniukas;Nykštukų;1514504241;Taip;0;0;5;5
15854;Žirniukas;Nykštukų;1064894307;Taip;7;1;0;8
15855;Žirniukas;Nykštukų;1162904969;Taip;0;14;0;14
15856;Žirniukas;Nykštukų;2049123663;Taip;0;0;7;7
15857;Žirniukas;Nykštukų;1017483419;Taip;6;1;0;7
15858;Žirniukas;Nykštukų;6957047759;Taip;6;1;0;7
15859;Žirniukas;Nykštukų;2151329751;Taip;0;9;0;9
15860;Žirniukas;Nykštukų;5939918015;Taip;10;5;0;15
15861;Žirniukas;Nykštukų;3010062747;Taip;6;0;0;6
15862;Žirniukas;Nykštukų;2162238771;Taip;0;3;1;4
15863;Žirniukas;Nykštukų;2029018108;Taip;6;0;0;6
15864;Žirniukas;Nykštukų;5987510202;Taip;13;0;0;13
15865;Žirniukas;Nykštukų;5104110821;Taip;10;2;0;12
15866;Žirniukas;Nykštukų;5471647472;Taip;8;3;0;11
15867;Žirniukas;Nykštukų;7644911127;Taip;14;0;0;14
15868;Žirniukas;Nykštukų;6180439078;Taip;6;0;0;6
15869;Žirniukas;Nykštukų;3808838764;Taip;10;5;1;16
15870;Žirniukas;Nykštukų;7975957714;Taip;5;0;1;6
15871;Žirniukas;Saulytės;37852143615;Taip;8;5;3;16
15872;Žirniukas;Saulytės;1409567693;Taip;5;3;0;8
15873;Žirniukas;Saulytės;2022475049;Taip;14;0;0;14
15874;Žirniukas;Saulytės;32419042337;Taip;10;1;0;11
15875;Žirniukas;Saulytės;65003409430;Taip;12;1;0;13
15876;Žirniukas;Saulytės;71263500233;Taip;5;4;10;19
15877;Žirniukas;Saulytės;65898776759;Taip;7;5;0;12
15878;Žirniukas;Saulytės;51172128673;Taip;6;2;2;10
15879;Žirniukas;Saulytės;85066293475;Taip;10;0;0;10
15880;Žirniukas;Saulytės;29420916883;Taip;7;0;0;7
15881;Žirniukas;Saulytės;5189034384;Taip;15;4;0;19
15882;Žirniukas;Saulytės;68565861419;Taip;13;0;0;13
15883;Žirniukas;Saulytės;2294854901;Taip;6;0;3;9
15884;Žirniukas;Saulytės;5188013194;Taip;0;7;1;8
15885;Žirniukas;Saulytės;69810421328;Taip;13;1;0;14
15886;Žirniukas;Saulytės;66153778144;Taip;0;2;8;10
15887;Žirniukas;Saulytės;47491327916;Taip;10;2;1;13
15888;Žirniukas;Saulytės;98028824068;Taip;16;0;0;16
15889;Žirniukas;Saulytės;28992463324;Taip;11;0;0;11
15890;Žirniukas;Saulytės;60060805955;Taip;10;0;0;10
15891;Žirniukas;Saulytės;71922426195;Taip;0;15;0;15
15892;Žirniukas;Drugelių;2141162140;Taip;0;10;0;10
15893;Žirniukas;Drugelių;1294183547;Taip;0;16;0;16
15894;Žirniukas;Drugelių;2557138057;Taip;5;0;5;10
15895;Žirniukas;Drugelių;3068684150;Taip;15;1;0;16
15896;Žirniukas;Drugelių;8644938346;Taip;3;8;0;11
15897;Žirniukas;Drugelių;2867806329;Taip;0;15;0;15
15898;Žirniukas;Drugelių;8190751348;Taip;13;1;3;17
15899;Žirniukas;Drugelių;1991599271;Taip;5;1;0;6
15900;Žirniukas;Drugelių;2282495237;Taip;0;17;0;17
15901;Žirniukas;Drugelių;1961708150;Taip;0;19;0;19
15902;Žirniukas;Drugelių;98962928727;Taip;5;0;2;7
15903;Žirniukas;Drugelių;6409900451;Taip;10;0;0;10
15904;Žirniukas;Drugelių;46265018782;Taip;5;3;0;8
15905;Žirniukas;Drugelių;7190628011;Taip;0;12;0;12
15906;Žirniukas;Drugelių;3248779733;Taip;0;1;1;2
15907;Žirniukas;Drugelių;5434774408;Taip;0;5;0;5
15908;Žirniukas;Drugelių;9374080010;Taip;5;2;0;7
15909;Žirniukas;Drugelių;1095501791;Taip;5;1;0;6
15910;Žirniukas;Pelėdžiukai;1685677297;Taip;5;1;0;6
15911;Žirniukas;Pelėdžiukai;9424009308;Taip;0;5;7;12
15912;Žirniukas;Pelėdžiukai;1542257475;Taip;5;1;0;6
15913;Žirniukas;Pelėdžiukai;98781117814;Taip;0;14;0;14
15914;Žirniukas;Pelėdžiukai;1158530590;Taip;0;0;5;5
15915;Žirniukas;Pelėdžiukai;1352159915;Taip;0;0;1;1
15916;Žirniukas;Pelėdžiukai;1096649614;Taip;0;8;0;8
15917;Žirniukas;Pelėdžiukai;1699821845;Taip;15;0;0;15
15918;Žirniukas;Pelėdžiukai;52845409413;Taip;7;5;0;12
15919;Žirniukas;Pelėdžiukai;1609778506;Taip;0;1;2;3
15920;Žirniukas;Pelėdžiukai;1506642709;Taip;5;1;0;6
15921;Žirniukas;Pelėdžiukai;98441955394;Taip;4;1;0;5
15922;Žirniukas;Pelėdžiukai;4789330923;Taip;0;16;0;16
15923;Žirniukas;Pelėdžiukai;2118772211;Taip;8;0;0;8
15924;Žirniukas;Pelėdžiukai;1788183728;Taip;5;0;5;10
15925;Žirniukas;Pelėdžiukai;1607867151;Taip;5;0;0;5
15926;Žirniukas;Pelėdžiukai;1586083174;Taip;0;14;0;14
15927;Žirniukas;Pelėdžiukai;52181077421;Taip;0;1;7;8
15928;Žirniukas;Pelėdžiukai;5479153220;Taip;12;1;0;13
15929;Žirniukas;Pelėdžiukai;4842182809;Taip;20;0;0;20
15930;Žirniukas;ZUIKUČIAI;6624263476;Taip;6;1;0;7
15931;Žirniukas;ZUIKUČIAI;2785102131;Taip;4;1;0;5
15932;Žirniukas;ZUIKUČIAI;6641200341;Taip;5;3;0;8
15933;Žirniukas;ZUIKUČIAI;9647374339;Taip;10;0;0;10
15934;Žirniukas;ZUIKUČIAI;6268788036;Taip;5;6;0;11
15935;Žirniukas;ZUIKUČIAI;1867254291;Taip;7;5;0;12
15936;Žirniukas;ZUIKUČIAI;8148254025;Taip;5;3;0;8
15937;Žirniukas;ZUIKUČIAI;6834792589;Ne;15;0;0;15
15938;Žirniukas;ZUIKUČIAI;2348752207;Taip;0;0;12;12
15939;Žirniukas;ZUIKUČIAI;7872611724;Taip;18;0;0;18
15940;Žirniukas;ZUIKUČIAI;2636634198;Taip;0;0;8;8
15941;Žirniukas;ZUIKUČIAI;6531175340;Taip;8;0;0;8
15942;Žirniukas;ZUIKUČIAI;8213507698;Taip;6;1;0;7
15943;Žirniukas;ZUIKUČIAI;2528905738;Taip;9;2;0;11
15944;Žirniukas;ZUIKUČIAI;6363169823;Taip;5;0;0;5
15945;Žirniukas;ZUIKUČIAI;5058103759;Taip;6;5;0;11
15946;Žirniukas;ZUIKUČIAI;3610402086;Taip;10;0;0;10
15947;Aušra;Kodėlčiukai;40714551025;Taip;0;6;0;6
15948;Aušra;Kodėlčiukai;40499781883;Taip;0;7;5;12
15949;Aušra;Kodėlčiukai;27091243109;Taip;0;1;0;1
15950;Aušra;Kodėlčiukai;9605206310;Taip;0;5;0;5
15951;Aušra;Kodėlčiukai;19504477542;Taip;0;2;1;3
15952;Aušra;Kodėlčiukai;88655846176;Taip;6;2;0;8
15953;Aušra;Kodėlčiukai;13157844661;Taip;0;5;0;5
15954;Aušra;Kodėlčiukai;22032396703;Taip;8;5;0;13
15955;Aušra;Kodėlčiukai;43666690361;Taip;0;7;0;7
15956;Aušra;Kodėlčiukai;97781409787;Ne;0;3;0;3
15957;Aušra;Kodėlčiukai;68160889669;Taip;0;6;0;6
15958;Aušra;Kodėlčiukai;69081281749;Taip;0;12;0;12
15959;Aušra;Kodėlčiukai;8510995681;Taip;0;5;0;5
15960;Aušra;Kodėlčiukai;18987709566;Taip;0;11;0;11
15961;Aušra;Kodėlčiukai;10347002342;Taip;0;10;0;10
15962;Aušra;Kodėlčiukai;8913242414;Taip;7;0;0;7
15963;Aušra;Kodėlčiukai;73509864636;Ne;0;5;0;5
15964;Aušra;Kodėlčiukai;52958921337;Taip;0;7;0;7
15965;Aušra;Kodėlčiukai;3284383302;Taip;0;2;0;2
15966;Aušra;Pelėdžiukai;8686777160;Taip;0;2;0;2
15967;Aušra;Pelėdžiukai;15657824495;Taip;6;8;0;14
15968;Aušra;Pelėdžiukai;1385844067;Taip;0;4;0;4
15969;Aušra;Pelėdžiukai;35429495907;Taip;0;1;0;1
15970;Aušra;Pelėdžiukai;79051821501;Taip;0;5;0;5
15971;Aušra;Pelėdžiukai;3001784066;Taip;0;5;0;5
15972;Aušra;Pelėdžiukai;14343589644;Taip;0;12;0;12
15973;Aušra;Pelėdžiukai;21234588466;Taip;8;0;0;8
15974;Aušra;Pelėdžiukai;5815377310;Taip;13;0;0;13
15975;Aušra;Pelėdžiukai;23609052737;Taip;0;7;0;7
15976;Aušra;Pelėdžiukai;3823619675;Taip;0;8;0;8
15977;Aušra;Pelėdžiukai;41017803426;Taip;0;1;3;4
15978;Aušra;Pelėdžiukai;13825730049;Taip;0;2;0;2
15979;Aušra;Pelėdžiukai;58254707316;Taip;0;1;0;1
15980;Aušra;Pelėdžiukai;18943927144;Taip;9;2;4;15
15981;Aušra;Pelėdžiukai;1623803107;Taip;6;2;0;8
15982;Aušra;Pelėdžiukai;57469542504;Taip;3;0;0;3
15983;Aušra;Pelėdžiukai;5409157554;Taip;0;0;2;2
15984;Aušra;Pelėdžiukai;2227238810;Taip;4;1;0;5
15985;Aušra;Pelėdžiukai;2000206874;Taip;6;2;4;12
15986;Aušra;Pelėdžiukai;59267104215;Taip;4;0;0;4
15987;Aušra;Smalsučiai;1049364899;Taip;0;4;0;4
15988;Aušra;Smalsučiai;1154675251;Taip;0;5;0;5
15989;Aušra;Smalsučiai;1473962346;Taip;0;4;0;4
15990;Aušra;Smalsučiai;2128822237;Taip;0;6;0;6
15991;Aušra;Smalsučiai;81510885976;Taip;0;3;0;3
15992;Aušra;Smalsučiai;76979979920;Taip;0;4;2;6
15993;Aušra;Smalsučiai;97571593143;Taip;0;7;0;7
15994;Aušra;Smalsučiai;59235411329;Taip;0;7;0;7
15995;Aušra;Smalsučiai;42344686036;Taip;0;4;0;4
15996;Aušra;Smalsučiai;62209740677;Taip;7;0;0;7
15997;Aušra;Smalsučiai;2019580127;Taip;15;5;0;20
15998;Aušra;Smalsučiai;95586246863;Taip;5;0;4;9
15999;Aušra;Smalsučiai;66203768924;Taip;4;0;0;4
16000;Aušra;Smalsučiai;7962184651;Taip;0;3;0;3
16001;Aušra;Smalsučiai;12689030409;Taip;0;2;3;5
16002;Aušra;Smalsučiai;98150444770;Taip;0;7;0;7
16003;Aušra;Smalsučiai;1167565535;Taip;0;12;0;12
16004;Aušra;Smalsučiai;52044254281;Taip;4;5;4;13
16005;Aušra;Smalsučiai;1831747749;Taip;10;5;0;15
16006;Aušra;Smalsučiai;5447986535;Taip;0;7;2;9
16007;Aušra;Smalsučiai;4645855409;Taip;0;13;0;13
16008;Aušra;Pagrandukai;7043021721;Taip;7;7;0;14
16009;Aušra;Pagrandukai;2023718424;Taip;0;0;4;4
16010;Aušra;Pagrandukai;8709340592;Taip;0;3;0;3
16011;Aušra;Pagrandukai;5524681006;Taip;7;5;6;18
16012;Aušra;Pagrandukai;4404047456;Taip;6;0;1;7
16013;Aušra;Pagrandukai;3680329197;Taip;8;3;2;13
16014;Aušra;Pagrandukai;2288159223;Taip;5;7;0;12
16015;Aušra;Pagrandukai;4805298824;Taip;0;5;2;7
16016;Aušra;Pagrandukai;29499576216;Taip;7;1;3;11
16017;Aušra;Pagrandukai;1940882109;Taip;0;2;5;7
16018;Aušra;Pagrandukai;7814902928;Taip;8;0;4;12
16019;Aušra;Pagrandukai;9702136789;Taip;4;0;0;4
16020;Aušra;Pagrandukai;6384243597;Taip;16;0;0;16
16021;Aušra;Pagrandukai;1612662076;Taip;0;3;1;4
16022;Aušra;Pagrandukai;3898178166;Taip;5;0;0;5
16023;Aušra;Pagrandukai;4352174590;Taip;18;0;0;18
16024;Aušra;Pagrandukai;1575761029;Taip;4;2;0;6
16025;Aušra;Pagrandukai;5673568541;Taip;0;5;0;5
16026;Aušra;Pagrandukai;1717797530;Taip;5;5;5;15
16027;Aušra;Pagrandukai;97102749430;Taip;0;1;0;1
16028;Aušra;Pagrandukai;5777939563;Taip;5;5;1;11
16029;Aušra;Pagrandukai;1956830515;Taip;4;1;0;5
16030;Aušra;Pagrandukai;8740755922;Taip;5;5;5;15
16031;Aušra;"1A klasė";81428848455;Taip;1;5;0;6
16032;Aušra;"1A klasė";52864653926;Taip;0;5;0;5
16033;Aušra;"1A klasė";5166358753;Taip;1;5;0;6
16034;Aušra;"1A klasė";78030425432;Taip;2;5;0;7
16035;Aušra;"1A klasė";77425098448;Taip;0;5;0;5
16036;Aušra;"1A klasė";13361663464;Taip;3;5;0;8
16037;Aušra;"1A klasė";21856009403;Taip;0;5;0;5
16038;Aušra;"1A klasė";93365393803;Taip;0;5;0;5
16039;Aušra;"1A klasė";44870195034;Taip;0;5;0;5
16040;Aušra;"1A klasė";10272136932;Taip;4;5;0;9
16041;Aušra;"1A klasė";29636399665;Taip;1;5;0;6
16042;Aušra;"1A klasė";42015974556;Taip;0;5;0;5
16043;Aušra;"1A klasė";26101766284;Taip;1;5;0;6
16044;Aušra;"1A klasė";19718806057;Taip;0;5;0;5
16045;Aušra;"1A klasė";19920237804;Taip;1;5;0;6
16046;Aušra;"1A klasė";2113586354;Taip;6;5;0;11
16047;Aušra;"1A klasė";70687041413;Taip;0;5;0;5
16048;Aušra;"1A klasė";47725613978;Taip;4;5;0;9
16049;Aušra;"1A klasė";94704151051;Taip;2;5;0;7
16050;Aušra;"1A klasė";20550256232;Taip;7;5;0;12
16051;Aušra;"1B klasė";35703433862;Taip;0;5;0;5
16052;Aušra;"1B klasė";41039525379;Taip;0;5;0;5
16053;Aušra;"1B klasė";59107169775;Taip;0;5;0;5
16054;Aušra;"1B klasė";41852924528;Taip;0;5;0;5
16055;Aušra;"1B klasė";58526614808;Taip;0;5;0;5
16056;Aušra;"1B klasė";64562667133;Taip;0;5;0;5
16057;Aušra;"1B klasė";36899257479;Ne;0;5;0;5
16058;Aušra;"1B klasė";95076478544;Ne;2;5;0;7
16059;Aušra;"1B klasė";83119050626;Taip;0;5;0;5
16060;Aušra;"1B klasė";52332096506;Taip;0;5;0;5
16061;Aušra;"1B klasė";45165946624;Taip;0;5;0;5
16062;Aušra;"1B klasė";22923377435;Taip;2;5;0;7
16063;Aušra;"1B klasė";71596384638;Taip;1;5;0;6
16064;Aušra;"1B klasė";36889923728;Taip;0;5;0;5
16065;Aušra;"1B klasė";48349819906;Ne;0;5;0;5
16066;Aušra;"1B klasė";92119607174;Taip;0;5;0;5
16067;Aušra;"1B klasė";37339481276;Taip;1;5;0;6
16068;Aušra;"1B klasė";8901585006;Taip;4;5;0;9
16069;Aušra;"2A klasė";8497743711;Ne;4;5;0;9
16070;Aušra;"2A klasė";9510786725;Ne;0;5;0;5
16071;Aušra;"2A klasė";5770340819;Ne;1;5;0;6
16072;Aušra;"2A klasė";5792862565;Ne;0;5;0;5
16073;Aušra;"2A klasė";8892613555;Ne;0;5;0;5
16074;Aušra;"2A klasė";7931858964;Ne;0;5;0;5
16075;Aušra;"2A klasė";4399210916;Ne;6;5;0;11
16076;Aušra;"2A klasė";1585279799;Ne;0;5;0;5
16077;Aušra;"2A klasė";2796012982;Ne;0;5;0;5
16078;Aušra;"2A klasė";9584232864;Ne;1;5;0;6
16079;Aušra;"2A klasė";7113793626;Ne;0;5;0;5
16080;Aušra;"2A klasė";2908360090;Ne;0;5;0;5
16081;Aušra;"2A klasė";5825720308;Ne;0;5;0;5
16082;Aušra;"2A klasė";8367064629;Ne;2;5;0;7
16083;Aušra;"2A klasė";8632721907;Ne;0;5;0;5
16084;Aušra;"2A klasė";3435983733;Ne;1;5;0;6
16085;Aušra;"2A klasė";7313001921;Ne;0;5;0;5
16086;Aušra;"2A klasė";6942076490;Ne;2;5;0;7
16087;Aušra;"2A klasė";6534693192;Ne;2;5;0;7
16088;Aušra;"2A klasė";7439801986;Ne;0;5;0;5
16089;Aušra;"2A klasė";4952796453;Ne;0;5;0;5
16090;Aušra;"2A klasė";1404310604;Ne;0;5;0;5
16091;Aušra;"2A klasė";2280410145;Ne;0;5;0;5
16092;Aušra;"2A klasė";75839555732;Taip;0;5;0;5
16093;Aušra;"3A klasė";2863356239;Ne;1;5;0;6
16094;Aušra;"3A klasė";6540515450;Ne;4;5;0;9
16095;Aušra;"3A klasė";6232778631;Ne;0;5;0;5
16096;Aušra;"3A klasė";3115696927;Ne;2;5;0;7
16097;Aušra;"3A klasė";8543429220;Ne;3;5;0;8
16098;Aušra;"3A klasė";1685764132;Ne;0;5;0;5
16099;Aušra;"3A klasė";5340257141;Ne;0;5;0;5
16100;Aušra;"3A klasė";4341245904;Ne;0;5;0;5
16101;Aušra;"3A klasė";9430084940;Ne;1;5;0;6
16102;Aušra;"3A klasė";2942755846;Ne;2;5;0;7
16103;Aušra;"3A klasė";3749854924;Ne;0;5;0;5
16104;Aušra;"3A klasė";2951199272;Ne;3;5;0;8
16105;Aušra;"3A klasė";2072790876;Ne;0;5;0;5
16106;Aušra;"3A klasė";1414034080;Ne;3;5;0;8
16107;Aušra;"3A klasė";8550981774;Ne;2;5;0;7
16108;Aušra;"3A klasė";4257487788;Ne;0;5;0;5
16109;Aušra;"3A klasė";9332506542;Ne;0;5;0;5
16110;Aušra;"3A klasė";7499852390;Ne;6;5;0;11
16111;Aušra;"3A klasė";8801106119;Ne;0;5;0;5
16112;Aušra;"3A klasė";7435902333;Ne;7;5;0;12
16113;Aušra;"3A klasė";4073898542;Ne;0;5;0;5
16114;Aušra;"4A klasė";7968234670;Ne;0;5;0;5
16115;Aušra;"4A klasė";5809362777;Ne;6;5;0;11
16116;Aušra;"4A klasė";6160171536;Ne;3;5;0;8
16117;Aušra;"4A klasė";6846696720;Ne;4;5;0;9
16118;Aušra;"4A klasė";7665944746;Ne;2;5;0;7
16119;Aušra;"4A klasė";1523223244;Ne;0;5;0;5
16120;Aušra;"4A klasė";4708591140;Ne;1;5;0;6
16121;Aušra;"4A klasė";6865621533;Ne;6;5;0;11
16122;Aušra;"4A klasė";9176277054;Ne;0;5;0;5
16123;Aušra;"4A klasė";1996371462;Ne;1;5;0;6
16124;Aušra;"4A klasė";4682402426;Ne;0;5;0;5
16125;Aušra;"4A klasė";3917149879;Ne;0;5;0;5
16126;Aušra;"4A klasė";6022331977;Ne;1;5;0;6
16127;Aušra;"4A klasė";3215515556;Ne;0;5;0;5
16128;Aušra;"2B klasė";7075053685;Ne;0;5;0;5
16129;Aušra;"2B klasė";8476695862;Ne;2;5;0;7
16130;Aušra;"2B klasė";2893668707;Ne;0;5;0;5
16131;Aušra;"2B klasė";7321317333;Ne;3;5;0;8
16132;Aušra;"2B klasė";9736905104;Ne;0;5;0;5
16133;Aušra;"2B klasė";4979458559;Ne;1;5;0;6
16134;Aušra;"2B klasė";2075587354;Ne;3;5;0;8
16135;Aušra;"2B klasė";2610054474;Ne;1;5;0;6
16136;Aušra;"2B klasė";2412235474;Ne;6;5;0;11
16137;Aušra;"2B klasė";9695887585;Ne;0;5;0;5
16138;Aušra;"2B klasė";7697924792;Ne;0;5;0;5
16139;Aušra;"2B klasė";7553225340;Ne;0;5;0;5
16140;Aušra;"2B klasė";5005513948;Ne;0;5;0;5
16141;Aušra;"2B klasė";3225989797;Ne;1;5;0;6
16142;Aušra;"2B klasė";3114317363;Ne;15;5;0;20
16143;Aušra;"2B klasė";7713995959;Ne;4;5;0;9
16144;Aušra;"2B klasė";9600565378;Ne;0;5;0;5
16145;Aušra;"2B klasė";65535488153;Taip;4;5;0;9
16146;Aušra;"2B klasė";11449775297;Taip;0;5;0;5
16147;Aušra;"2B klasė";2401823401;Ne;0;5;0;5
16148;Aušra;"2B klasė";70054065156;Taip;3;5;0;8
16149;Berželis;"BOŽJI KOROVKI";1612263252;Taip;0;4;0;4
16150;Berželis;"BOŽJI KOROVKI";59374659821;Taip;4;5;1;10
16151;Berželis;"BOŽJI KOROVKI";69799827219;Taip;0;2;5;7
16152;Berželis;"BOŽJI KOROVKI";75750848557;Ne;0;5;0;5
16153;Berželis;"BOŽJI KOROVKI";56738219250;Taip;0;15;0;15
16154;Berželis;"BOŽJI KOROVKI";56482980062;Ne;0;8;0;8
16155;Berželis;"BOŽJI KOROVKI";77431203813;Taip;5;0;0;5
16156;Berželis;"BOŽJI KOROVKI";27150769109;Taip;8;5;0;13
16157;Berželis;"BOŽJI KOROVKI";58375151019;Taip;8;5;0;13
16158;Berželis;"BOŽJI KOROVKI";33843845240;Taip;5;0;0;5
16159;Berželis;"BOŽJI KOROVKI";62619974918;Taip;10;1;0;11
16160;Berželis;"BOŽJI KOROVKI";88322206113;Taip;8;0;0;8
16161;Berželis;"BOŽJI KOROVKI";19460486970;Taip;5;1;0;6
16162;Berželis;"BOŽJI KOROVKI";9901922166;Taip;0;3;0;3
16163;Berželis;"BOŽJI KOROVKI";8942344021;Taip;20;0;0;20
16164;Berželis;PČIOLKI;1923453586;Taip;6;5;3;14
16165;Berželis;PČIOLKI;91965136118;Taip;0;5;2;7
16166;Berželis;PČIOLKI;83552840429;Taip;13;5;0;18
16167;Berželis;PČIOLKI;86666390300;Taip;9;5;0;14
16168;Berželis;PČIOLKI;93628329777;Taip;0;5;0;5
16169;Berželis;PČIOLKI;13541556141;Taip;6;5;0;11
16170;Berželis;PČIOLKI;4330158489;Taip;3;5;2;10
16171;Berželis;PČIOLKI;95780247776;Taip;6;5;1;12
16172;Berželis;PČIOLKI;79546239108;Taip;2;5;0;7
16173;Berželis;PČIOLKI;6959738006;Taip;5;5;0;10
16174;Berželis;PČIOLKI;37637382978;Taip;4;5;0;9
16175;Berželis;PČIOLKI;41988540665;Taip;0;5;5;10
16176;Berželis;PČIOLKI;44215014337;Taip;3;5;0;8
16177;Berželis;PČIOLKI;2066819593;Taip;0;5;0;5
16178;Berželis;PČIOLKI;84379482983;Taip;0;9;0;9
16179;Berželis;PČIOLKI;37451475613;Taip;6;5;1;12
16180;Berželis;PČIOLKI;95587380846;Taip;4;5;1;10
16181;Berželis;PČIOLKI;48161697699;Taip;0;5;1;6
16182;Berželis;PČIOLKI;18002985276;Taip;4;7;0;11
16183;Berželis;PČIOLKI;1776837439;Taip;7;5;0;12
16184;Berželis;PČIOLKI;17710158252;Taip;4;5;0;9
16185;Berželis;PČIOLKI;7277445666;Taip;3;5;2;10
16186;Berželis;PČIOLKI;36854023525;Taip;7;5;0;12
16187;Berželis;PČIOLKI;7512720601;Taip;5;4;0;9
16188;Berželis;SOLNYŠKO;1740077377;Taip;5;10;0;15
16189;Berželis;SOLNYŠKO;1855559693;Taip;0;9;0;9
16190;Berželis;SOLNYŠKO;91676607875;Taip;0;13;0;13
16191;Berželis;SOLNYŠKO;1729593575;Taip;5;8;0;13
16192;Berželis;SOLNYŠKO;4605587503;Taip;0;8;0;8
16193;Berželis;SOLNYŠKO;2069597007;Taip;7;11;0;18
16194;Berželis;SOLNYŠKO;97145959022;Taip;7;6;0;13
16195;Berželis;SOLNYŠKO;4422816945;Taip;8;3;0;11
16196;Berželis;SOLNYŠKO;5747645162;Taip;6;5;0;11
16197;Berželis;SOLNYŠKO;7334971595;Taip;7;2;0;9
16198;Berželis;SOLNYŠKO;3923999931;Ne;7;5;0;12
16199;Berželis;SOLNYŠKO;9022925550;Taip;0;20;0;20
16200;Berželis;SOLNYŠKO;68853290649;Taip;0;9;0;9
16201;Berželis;SOLNYŠKO;5332069480;Taip;0;5;0;5
16202;Berželis;SOLNYŠKO;1929783185;Taip;0;11;0;11
16203;Berželis;SOLNYŠKO;1136612100;Taip;7;10;0;17
16204;Berželis;SOLNYŠKO;7713921014;Ne;13;0;0;13
16205;Berželis;SOLNYŠKO;50400542457;Taip;0;3;0;3
16206;Berželis;BABOČKI;5371508044;Taip;15;0;0;15
16207;Berželis;BABOČKI;1076719080;Taip;20;0;0;20
16208;Berželis;BABOČKI;2016194182;Taip;0;3;2;5
16209;Berželis;BABOČKI;2030770943;Taip;5;5;0;10
16210;Berželis;BABOČKI;1750209600;Taip;6;5;0;11
16211;Berželis;BABOČKI;9839929976;Taip;20;0;0;20
16212;Berželis;BABOČKI;4100740863;Taip;1;19;0;20
16213;Berželis;BABOČKI;2667957070;Taip;5;0;0;5
16214;Berželis;BABOČKI;7781031211;Taip;6;0;0;6
16215;Berželis;BABOČKI;2493612905;Taip;7;5;0;12
16216;Berželis;BABOČKI;5688897783;Taip;0;14;0;14
16217;Berželis;BABOČKI;6942559693;Taip;6;5;0;11
16218;Berželis;BABOČKI;9245706377;Taip;6;0;0;6
16219;Berželis;BABOČKI;6352635742;Taip;5;0;0;5
16220;Berželis;BABOČKI;3097809074;Taip;5;3;0;8
16221;Berželis;BABOČKI;8448872491;Taip;5;10;0;15
16222;Berželis;BABOČKI;5069322062;Taip;0;1;0;1
16223;Berželis;BABOČKI;2954451168;Taip;0;4;0;4
16224;Berželis;BABOČKI;4312062240;Taip;0;1;0;1
16225;Berželis;SOVUŠKI;8939353460;Taip;15;3;0;18
16226;Berželis;SOVUŠKI;5879965735;Taip;5;1;4;10
16227;Berželis;SOVUŠKI;1183377037;Taip;5;0;0;5
16228;Berželis;SOVUŠKI;61614684164;Taip;5;0;0;5
16229;Berželis;SOVUŠKI;1573177287;Taip;12;0;0;12
16230;Berželis;SOVUŠKI;48932211843;Taip;20;0;0;20
16231;Berželis;SOVUŠKI;11671380984;Taip;0;2;2;4
16232;Berželis;SOVUŠKI;1927042277;Taip;6;4;0;10
16233;Berželis;SOVUŠKI;1566912722;Taip;5;0;0;5
16234;Berželis;SOVUŠKI;1865658456;Taip;13;0;0;13
16235;Berželis;SOVUŠKI;1061894314;Taip;8;0;0;8
16236;Berželis;SOVUŠKI;5739686368;Taip;5;0;0;5
16237;Berželis;SOVUŠKI;25985469678;Taip;16;1;0;17
16238;Berželis;SOVUŠKI;2028316867;Ne;13;2;0;15
16239;Berželis;SOVUŠKI;83253240251;Taip;20;0;0;20
16240;Berželis;SOVUŠKI;1470907829;Taip;6;0;0;6
16241;Berželis;SOVUŠKI;9134420285;Taip;5;0;0;5
16242;Berželis;SOVUŠKI;9894036261;Taip;10;0;0;10
16243;Berželis;SOVUŠKI;4080387580;Taip;20;0;0;20
16244;Berželis;SOVUŠKI;5337604370;Taip;1;0;0;1
16245;Berželis;SOVUŠKI;1492203156;Taip;7;0;0;7
16246;Berželis;PODSOLNUŠKI;4521372127;Taip;5;3;0;8
16247;Berželis;PODSOLNUŠKI;2214171136;Taip;0;5;0;5
16248;Berželis;PODSOLNUŠKI;97218091736;Taip;7;8;0;15
16249;Berželis;PODSOLNUŠKI;1521982237;Taip;11;0;0;11
16250;Berželis;PODSOLNUŠKI;4013215941;Taip;0;3;1;4
16251;Berželis;PODSOLNUŠKI;7526006253;Taip;7;5;0;12
16252;Berželis;PODSOLNUŠKI;64214150955;Taip;6;5;0;11
16253;Berželis;PODSOLNUŠKI;9024992452;Taip;10;0;0;10
16254;Berželis;PODSOLNUŠKI;9644196870;Taip;5;0;0;5
16255;Berželis;PODSOLNUŠKI;5084171353;Taip;5;0;0;5
16256;Berželis;PODSOLNUŠKI;1225018351;Taip;7;0;0;7
16257;Berželis;PODSOLNUŠKI;6473498471;Taip;18;0;0;18
16258;Berželis;PODSOLNUŠKI;1067618571;Taip;6;6;0;12
16259;Berželis;PODSOLNUŠKI;3772780161;Taip;11;1;0;12
16260;Berželis;PODSOLNUŠKI;4563582416;Taip;11;1;0;12
16261;Berželis;PODSOLNUŠKI;7227603702;Taip;5;1;0;6
16262;Berželis;PODSOLNUŠKI;6113571093;Taip;12;0;0;12
16263;Berželis;PODSOLNUŠKI;1036370516;Taip;5;5;0;10
16264;Berželis;PODSOLNUŠKI;4284157599;Taip;11;0;0;11
16265;Berželis;PODSOLNUŠKI;2615440913;Taip;20;0;0;20
16266;Berželis;"1 klasė";93543942806;Taip;6;5;0;11
16267;Berželis;"1 klasė";68739754511;Taip;0;5;0;5
16268;Berželis;"1 klasė";5442568208;Taip;0;5;0;5
16269;Berželis;"1 klasė";34721593327;Taip;5;5;0;10
16270;Berželis;"1 klasė";40956353978;Taip;5;5;0;10
16271;Berželis;"1 klasė";12564193771;Taip;2;5;0;7
16272;Berželis;"1 klasė";3658542055;Taip;2;5;0;7
16273;Berželis;"1 klasė";945754955;Taip;15;5;0;20
16274;Berželis;"1 klasė";84043380820;Taip;0;5;0;5
16275;Berželis;"2 klasė";4263364972;Taip;2;5;0;7
16276;Berželis;"2 klasė";4381565277;Ne;0;5;0;5
16277;Berželis;"2 klasė";7489328291;Ne;10;5;0;15
16278;Berželis;"2 klasė";8888053187;Ne;0;5;0;5
16279;Berželis;"2 klasė";6442475480;Ne;2;5;0;7
16280;Berželis;"2 klasė";3576772433;Ne;0;5;0;5
16281;Berželis;"2 klasė";7835087499;Ne;7;5;0;12
16282;Berželis;"2 klasė";5004603567;Ne;1;5;0;6
16283;Berželis;"2 klasė";9657020323;Ne;0;5;0;5
16284;Berželis;"2 klasė";8433247380;Ne;0;5;0;5
16285;Berželis;"2 klasė";4941738193;Ne;1;5;0;6
16286;Berželis;"2 klasė";1448407405;Ne;0;5;0;5
16287;Berželis;"3 klasė";8102357654;Ne;3;5;0;8
16288;Berželis;"3 klasė";2501433917;Ne;0;5;0;5
16289;Berželis;"3 klasė";1161378829;Ne;0;5;0;5
16290;Berželis;"3 klasė";8322372921;Ne;0;5;0;5
16291;Berželis;"3 klasė";5856177876;Ne;7;5;0;12
16292;Berželis;"3 klasė";6702857359;Ne;0;5;0;5
16293;Berželis;"3 klasė";4245771747;Ne;1;5;0;6
16294;Berželis;"3 klasė";3149377224;Ne;0;5;0;5
16295;Berželis;"3 klasė";3064700283;Ne;3;5;0;8
16296;Berželis;"3 klasė";9998560354;Ne;1;5;0;6
16297;Berželis;"3 klasė";8143634742;Ne;0;5;0;5
16298;Berželis;"3 klasė";9486991928;Ne;0;5;0;5
16299;Berželis;"3 klasė";8921842915;Ne;0;5;0;5
16300;Berželis;"3 klasė";7728620622;Ne;0;5;0;5
16301;Berželis;"3 klasė";2691853015;Ne;3;5;0;8
16302;Berželis;"3 klasė";2955045450;Ne;0;5;0;5
16303;Berželis;"3 klasė";62987603892;Taip;0;5;0;5
16304;Berželis;"3 klasė";50930845005;Taip;0;5;0;5
16305;Berželis;"4 klasė";2332539534;Ne;0;5;0;5
16306;Berželis;"4 klasė";5637244096;Ne;2;5;0;7
16307;Berželis;"4 klasė";3565822447;Ne;4;5;0;9
16308;Berželis;"4 klasė";9635029366;Ne;5;5;0;10
16309;Berželis;"4 klasė";3773489172;Ne;0;5;0;5
16310;Berželis;"4 klasė";4354272806;Ne;0;5;0;5
16311;Berželis;"4 klasė";2827130989;Ne;5;5;0;10
16312;Berželis;"4 klasė";2155354527;Ne;0;5;0;5
16313;Berželis;"4 klasė";5467777166;Ne;5;5;0;10
16314;Berželis;"4 klasė";6588688183;Taip;4;5;0;9
16315;Saulutė;Drugeliai;66108847230;Taip;10;6;3;19
16316;Saulutė;Drugeliai;1513449225;Taip;8;1;1;10
16317;Saulutė;Drugeliai;1556270046;Taip;6;4;0;10
16318;Saulutė;Drugeliai;3064199909;Taip;8;0;5;13
16319;Saulutė;Drugeliai;2097055107;Taip;5;3;0;8
16320;Saulutė;Drugeliai;1717909005;Taip;17;0;0;17
16321;Saulutė;Drugeliai;1283800571;Taip;6;0;3;9
16322;Saulutė;Drugeliai;8599199376;Taip;10;0;0;10
16323;Saulutė;Drugeliai;1750571258;Taip;6;0;0;6
16324;Saulutė;Drugeliai;87814849917;Taip;10;5;0;15
16325;Saulutė;Drugeliai;1609952589;Taip;5;3;0;8
16326;Saulutė;Drugeliai;1386800520;Taip;6;5;0;11
16327;Saulutė;Drugeliai;1261384337;Taip;10;5;0;15
16328;Saulutė;Drugeliai;1320018338;Taip;0;0;20;20
16329;Saulutė;Drugeliai;1291318940;Taip;20;0;0;20
16330;Saulutė;Drugeliai;2162114750;Ne;0;0;10;10
16331;Saulutė;Drugeliai;9550046358;Taip;9;0;1;10
16332;Saulutė;Drugeliai;1391904744;Taip;12;1;0;13
16333;Saulutė;Drugeliai;8944601874;Taip;11;2;0;13
16334;Saulutė;Drugeliai;1421523719;Taip;10;0;0;10
16335;Saulutė;Drugeliai;67332285574;Taip;5;0;1;6
16336;Saulutė;Drugeliai;4272320685;Taip;10;5;0;15
16337;Saulutė;Drugeliai;1020606591;Taip;10;5;0;15
16338;Saulutė;"Saulės zuikučiai";8946107286;Taip;10;0;0;10
16339;Saulutė;"Saulės zuikučiai";2397257894;Taip;11;0;0;11
16340;Saulutė;"Saulės zuikučiai";1888990522;Taip;0;5;0;5
16341;Saulutė;"Saulės zuikučiai";1686338325;Taip;0;0;2;2
16342;Saulutė;"Saulės zuikučiai";2010774109;Taip;6;14;0;20
16343;Saulutė;"Saulės zuikučiai";3089541630;Taip;10;0;0;10
16344;Saulutė;"Saulės zuikučiai";5148542811;Taip;0;20;0;20
16345;Saulutė;"Saulės zuikučiai";1562393383;Taip;11;0;0;11
16346;Saulutė;"Saulės zuikučiai";9269501176;Taip;16;0;0;16
16347;Saulutė;"Saulės zuikučiai";2259917151;Taip;4;5;0;9
16348;Saulutė;"Saulės zuikučiai";3691381351;Taip;15;0;0;15
16349;Saulutė;"Saulės zuikučiai";3749374270;Taip;0;5;2;7
16350;Saulutė;"Saulės zuikučiai";9146298505;Taip;0;1;4;5
16351;Saulutė;"Saulės zuikučiai";6754944061;Taip;9;5;0;14
16352;Saulutė;"Saulės zuikučiai";8242602551;Taip;10;0;1;11
16353;Saulutė;"Saulės zuikučiai";1324799653;Taip;5;12;0;17
16354;Saulutė;"Saulės zuikučiai";5247769309;Taip;5;5;0;10
16355;Saulutė;"Saulės zuikučiai";1855999738;Ne;9;0;0;9
16356;Saulutė;"Saulės zuikučiai";2816806902;Taip;7;2;0;9
16357;Saulutė;"Saulės zuikučiai";7844396402;Taip;4;4;1;9
16358;Saulutė;"Saulės zuikučiai";2781003892;Taip;7;0;0;7
16359;Saulutė;Boružėlės;36955032265;Taip;0;5;4;9
16360;Saulutė;Boružėlės;44452051978;Ne;0;5;0;5
16361;Saulutė;Boružėlės;25124975646;Taip;0;6;1;7
16362;Saulutė;Boružėlės;36414547943;Taip;0;5;4;9
16363;Saulutė;Boružėlės;54950572289;Taip;0;4;1;5
16364;Saulutė;Boružėlės;92695618159;Taip;0;3;0;3
16365;Saulutė;Boružėlės;87409240076;Taip;0;5;0;5
16366;Saulutė;Boružėlės;1337654926;Taip;0;8;0;8
16367;Saulutė;Boružėlės;76744652185;Taip;0;20;0;20
16368;Saulutė;Boružėlės;97296161595;Taip;0;3;0;3
16369;Saulutė;Boružėlės;1804521229;Taip;0;15;0;15
16370;Saulutė;Boružėlės;1005459768;Taip;0;5;12;17
16371;Saulutė;Boružėlės;1205642335;Taip;6;5;0;11
16372;Saulutė;Boružėlės;43512415452;Taip;0;5;0;5
16373;Saulutė;Boružėlės;1644704074;Taip;0;5;2;7
16374;Saulutė;Boružėlės;1217446865;Taip;0;5;3;8
16375;Saulutė;Boružėlės;89710141573;Taip;5;5;3;13
16376;Saulutė;Boružėlės;46280382280;Taip;0;5;0;5
16377;Saulutė;Boružėlės;10893091651;Taip;0;1;1;2
16378;Saulutė;Boružėlės;70392220915;Taip;0;13;0;13
16379;Saulutė;Nykštukai;34712531615;Taip;0;5;2;7
16380;Saulutė;Nykštukai;10407286767;Taip;0;5;1;6
16381;Saulutė;Nykštukai;95826894716;Taip;0;7;1;8
16382;Saulutė;Nykštukai;6406135063;Ne;12;0;0;12
16383;Saulutė;Nykštukai;59825470089;Taip;0;5;3;8
16384;Saulutė;Nykštukai;65195759604;Taip;14;1;0;15
16385;Saulutė;Nykštukai;84984808072;Taip;5;5;0;10
16386;Saulutė;Nykštukai;46092441981;Taip;5;5;0;10
16387;Saulutė;Nykštukai;37119876987;Taip;0;2;0;2
16388;Saulutė;Nykštukai;63869261653;Taip;14;0;0;14
16389;Saulutė;Nykštukai;9583443237;Taip;0;11;0;11
16390;Saulutė;Nykštukai;10595557639;Taip;0;2;0;2
16391;Saulutė;Nykštukai;7318452189;Taip;11;0;4;15
16392;Saulutė;Nykštukai;5745065672;Taip;0;0;2;2
16393;Saulutė;Nykštukai;78558743548;Taip;2;3;2;7
16394;Saulutė;Nykštukai;91371507376;Ne;5;5;0;10
16395;Saulutė;Nykštukai;1332002470;Taip;15;0;0;15
16396;Saulutė;Nykštukai;3183309722;Ne;5;5;0;10
16397;Saulutė;Nykštukai;1911318708;Taip;16;0;0;16
16398;Saulutė;Nykštukai;9081236999;Ne;0;6;0;6
16399;Saulutė;Nykštukai;9565528566;Taip;20;0;0;20
16400;Saulutė;Meškiukai;8433646525;Taip;10;0;0;10
16401;Saulutė;Meškiukai;3410606033;Taip;7;0;0;7
16402;Saulutė;Meškiukai;9314889468;Taip;10;0;0;10
16403;Saulutė;Meškiukai;6608003946;Taip;7;13;0;20
16404;Saulutė;Meškiukai;8257363228;Taip;20;0;0;20
16405;Saulutė;Meškiukai;7764493159;Taip;11;0;3;14
16406;Saulutė;Meškiukai;5565832676;Taip;11;0;3;14
16407;Saulutė;Meškiukai;9173336078;Taip;3;2;0;5
16408;Saulutė;Meškiukai;3026114869;Taip;10;0;0;10
16409;Saulutė;Meškiukai;6057668143;Taip;1;0;5;6
16410;Saulutė;Meškiukai;8736917541;Taip;15;0;0;15
16411;Saulutė;Meškiukai;7413098580;Taip;2;7;0;9
16412;Saulutė;Meškiukai;2813274509;Taip;14;0;0;14
16413;Saulutė;Meškiukai;5999318972;Taip;3;0;0;3
16414;Saulutė;Meškiukai;2074473832;Taip;10;0;2;12
16415;Saulutė;Ežiukai;19918665437;Taip;14;0;0;14
16416;Saulutė;Ežiukai;63481737955;Taip;0;0;1;1
16417;Saulutė;Ežiukai;55160240384;Taip;0;8;0;8
16418;Saulutė;Ežiukai;1861612651;Taip;7;0;0;7
16419;Saulutė;Ežiukai;19852146326;Taip;7;1;0;8
16420;Saulutė;Ežiukai;1745560688;Taip;3;0;1;4
16421;Saulutė;Ežiukai;32539394191;Taip;11;1;0;12
16422;Saulutė;Ežiukai;1913500127;Taip;0;5;0;5
16423;Saulutė;Ežiukai;3608072547;Taip;4;0;2;6
16424;Saulutė;Ežiukai;1579654900;Taip;7;0;0;7
16425;Saulutė;Ežiukai;6099238784;Taip;0;0;6;6
16426;Saulutė;Ežiukai;12674831673;Taip;5;0;10;15
16427;Saulutė;Ežiukai;1546200973;Taip;0;0;1;1
16428;Saulutė;Ežiukai;8497765010;Taip;6;0;14;20
16429;Saulutė;Ežiukai;1077526046;Taip;17;0;0;17
16430;Saulutė;Ežiukai;1917058710;Taip;6;0;2;8
16431;Saulutė;Ežiukai;2059267616;Taip;15;0;0;15
16432;Saulutė;Ežiukai;1212865434;Ne;6;0;1;7
16433;Saulutė;Ežiukai;2190922941;Taip;15;0;0;15
16434;Saulutė;Ežiukai;3268714222;Taip;0;15;5;20
16435;Saulutė;Ežiukai;5326279083;Taip;7;0;0;7
16436;Saulutė;Bitutės;9892855816;Taip;5;0;0;5
16437;Saulutė;Bitutės;4510990261;Taip;6;0;0;6
16438;Saulutė;Bitutės;3272296969;Taip;0;8;0;8
16439;Saulutė;Bitutės;2545930114;Taip;20;0;0;20
16440;Saulutė;Bitutės;2140277182;Taip;20;0;0;20
16441;Saulutė;Bitutės;6044672321;Taip;4;0;0;4
16442;Saulutė;Bitutės;6396954377;Taip;20;0;0;20
16443;Saulutė;Bitutės;3295289082;Taip;1;0;0;1
16444;Saulutė;Bitutės;8390767549;Taip;6;0;7;13
16445;Saulutė;Bitutės;1056158093;Taip;5;0;5;10
16446;Saulutė;Bitutės;7888435573;Taip;2;0;2;4
16447;Saulutė;Bitutės;7297886198;Taip;15;0;4;19
16448;Saulutė;Bitutės;7576532632;Taip;0;0;7;7
16449;Saulutė;Bitutės;8708184278;Taip;1;0;0;1
16450;Saulutė;Bitutės;8040751073;Taip;9;0;1;10
16451;Saulutė;Bitutės;1587328722;Taip;6;0;3;9
16452;Saulutė;Bitutės;7574225926;Taip;1;0;0;1
16453;Saulutė;Bitutės;8512137633;Taip;20;0;0;20
16454;Saulutė;Bitutės;2725491887;Taip;0;0;1;1
16455;Saulutė;Pelėdžiukai;3445723020;Ne;0;5;2;7
16456;Saulutė;Pelėdžiukai;1785740531;Taip;0;5;0;5
16457;Saulutė;Pelėdžiukai;1534183935;Taip;13;0;0;13
16458;Saulutė;Pelėdžiukai;27386434894;Taip;6;1;1;8
16459;Saulutė;Pelėdžiukai;23640604487;Taip;5;0;3;8
16460;Saulutė;Pelėdžiukai;27752316336;Taip;7;3;0;10
16461;Saulutė;Pelėdžiukai;7539721995;Taip;7;5;0;12
16462;Saulutė;Pelėdžiukai;65492344097;Taip;8;0;3;11
16463;Saulutė;Pelėdžiukai;1935503629;Taip;5;5;1;11
16464;Saulutė;Pelėdžiukai;77923802656;Taip;10;0;0;10
16465;Saulutė;Pelėdžiukai;79919438191;Taip;10;0;1;11
16466;Saulutė;Pelėdžiukai;31705050946;Taip;5;11;0;16
16467;Saulutė;Pelėdžiukai;45306237230;Taip;0;5;0;5
16468;Saulutė;Pelėdžiukai;14195215027;Taip;14;0;0;14
16469;Saulutė;Pelėdžiukai;28772515317;Ne;0;5;1;6
16470;Saulutė;Pelėdžiukai;50944263059;Taip;0;0;9;9
16471;Saulutė;Pelėdžiukai;1510434265;Taip;10;0;0;10
16472;Saulutė;Pelėdžiukai;5574049005;Taip;3;0;5;8
16473;Saulutė;Pelėdžiukai;77170708225;Taip;8;0;0;8
16474;Saulutė;Pelėdžiukai;4312318284;Taip;20;0;0;20
16475;Saulutė;Zylutės;91834332717;Taip;0;13;0;13
16476;Saulutė;Zylutės;1277263391;Taip;7;5;1;13
16477;Saulutė;Zylutės;37315117916;Taip;0;5;3;8
16478;Saulutė;Zylutės;75405796772;Taip;6;2;2;10
16479;Saulutė;Zylutės;35570367633;Taip;5;0;4;9
16480;Saulutė;Zylutės;2098990667;Taip;12;5;0;17
16481;Saulutė;Zylutės;6557918941;Taip;0;5;0;5
16482;Saulutė;Zylutės;78967475616;Ne;5;5;4;14
16483;Saulutė;Zylutės;1786491396;Taip;0;10;0;10
16484;Saulutė;Zylutės;55982591521;Taip;12;3;0;15
16485;Saulutė;Zylutės;3246485288;Taip;0;5;6;11
16486;Saulutė;Zylutės;21703177024;Taip;5;2;4;11
16487;Saulutė;Zylutės;54373231773;Taip;0;2;0;2
16488;Saulutė;Zylutės;88168936754;Taip;0;7;0;7
16489;Saulutė;Zylutės;85182498024;Taip;0;5;0;5
16490;Saulutė;Zylutės;98979263108;Taip;0;12;0;12
16491;Saulutė;Zylutės;16622528829;Taip;5;15;0;20
16492;Saulutė;Zylutės;1475031090;Taip;8;0;2;10
16493;Saulutė;Zylutės;57283533169;Taip;4;5;0;9
16494;Saulutė;Zylutės;3450668814;Taip;5;7;0;12
16495;Saulutė;Zylutės;13147367113;Taip;5;6;0;11
16496;Saulutė;"1 klasė";5997216605;Taip;15;5;0;20
16497;Saulutė;"1 klasė";92198716772;Taip;5;5;0;10
16498;Saulutė;"1 klasė";8632066475;Ne;15;5;0;20
16499;Saulutė;"1 klasė";67739063665;Taip;1;5;0;6
16500;Saulutė;"1 klasė";50110262859;Taip;4;5;0;9
16501;Saulutė;"1 klasė";6469772450;Taip;15;5;0;20
16502;Saulutė;"1 klasė";4302511346;Ne;15;5;0;20
16503;Saulutė;"1 klasė";18122758338;Taip;5;5;0;10
16504;Saulutė;"1 klasė";8962761979;Taip;15;5;0;20
16505;Saulutė;"1 klasė";7785909571;Ne;4;5;0;9
16506;Saulutė;"1 klasė";5822529731;Taip;5;5;0;10
16507;Saulutė;"1 klasė";2095347468;Taip;2;5;0;7
16508;Saulutė;"1 klasė";56289088231;Taip;1;5;0;6
16509;Saulutė;"1 klasė";1418237274;Taip;1;5;0;6
16510;Saulutė;"1 klasė";13916981850;Taip;0;5;0;5
16511;Saulutė;"1 klasė";61123463673;Taip;5;5;0;10
16512;Saulutė;"1 klasė";39606108938;Ne;2;5;0;7
16513;Saulutė;"1 klasė";82106514982;Taip;5;5;0;10
16514;Saulutė;"1 klasė";58163470119;Taip;5;5;0;10
16515;Saulutė;"1 klasė";81191097069;Taip;0;5;0;5
16516;Saulutė;"1 klasė";37839378248;Taip;0;5;0;5
16517;Saulutė;"1 klasė";90078805222;Taip;5;5;0;10
16518;Saulutė;"1 klasė";61113930769;Taip;0;5;0;5
16519;Saulutė;"1 klasė";42204884890;Ne;4;5;0;9
16520;Saulutė;"1 klasė";12964000357;Taip;4;5;0;9
16521;Saulutė;"1 klasė";25720655179;Taip;2;5;0;7
16522;Saulutė;"1 klasė";30863736694;Taip;6;5;0;11
16523;Saulutė;"1 klasė";45877127245;Taip;8;5;0;13
16524;Saulutė;"1 klasė";8308288099;Ne;1;5;0;6
16525;Saulutė;"1 klasė";54726632101;Taip;0;5;0;5
16526;Saulutė;"1 klasė";16523279366;Taip;5;5;0;10
16527;Saulutė;"2 klasė";1701868565;Taip;1;5;0;6
16528;Saulutė;"2 klasė";6924270821;Ne;1;5;0;6
16529;Saulutė;"2 klasė";3450860412;Ne;4;5;0;9
16530;Saulutė;"2 klasė";1081812391;Taip;5;5;0;10
16531;Saulutė;"2 klasė";1436690766;Taip;0;5;0;5
16532;Saulutė;"2 klasė";7577219457;Taip;0;5;0;5
16533;Saulutė;"2 klasė";2517511237;Taip;0;5;0;5
16534;Saulutė;"2 klasė";1153099638;Taip;0;5;0;5
16535;Saulutė;"2 klasė";5786453424;Taip;0;5;0;5
16536;Saulutė;"2 klasė";8531372660;Taip;0;5;0;5
16537;Saulutė;"2 klasė";1117229507;Taip;2;5;0;7
16538;Saulutė;"2 klasė";4342595483;Taip;5;5;0;10
16539;Saulutė;"2 klasė";3614749034;Taip;5;5;0;10
16540;Saulutė;"2 klasė";3937034221;Ne;2;5;0;7
16541;Saulutė;"2 klasė";7543978588;Taip;0;5;0;5
16542;Saulutė;"2 klasė";7696948081;Taip;0;5;0;5
16543;Saulutė;"2 klasė";4252242862;Taip;5;5;0;10
16544;Saulutė;"2 klasė";2957436888;Taip;0;5;0;5
16545;Saulutė;"2 klasė";1312993030;Taip;9;5;0;14
16546;Saulutė;"2 klasė";3755300838;Taip;5;5;0;10
16547;Saulutė;"2 klasė";9744870287;Taip;0;5;0;5
16548;Saulutė;"2 klasė";8953313952;Ne;0;5;0;5
16549;Saulutė;"2 klasė";8192525690;Taip;0;5;0;5
16550;Saulutė;"2 klasė";6025668467;Taip;2;5;0;7
16551;Saulutė;"3 klasė";1604607524;Ne;5;5;0;10
16552;Saulutė;"3 klasė";1787634725;Ne;0;5;0;5
16553;Saulutė;"3 klasė";6128992723;Ne;0;5;0;5
16554;Saulutė;"3 klasė";3806787884;Ne;0;5;0;5
16555;Saulutė;"3 klasė";9155511473;Ne;5;5;0;10
16556;Saulutė;"3 klasė";3302267009;Ne;0;5;0;5
16557;Saulutė;"3 klasė";1659579883;Ne;15;5;0;20
16558;Saulutė;"3 klasė";9833653313;Ne;0;5;0;5
16559;Saulutė;"3 klasė";5193599921;Ne;0;5;0;5
16560;Saulutė;"3 klasė";2246292466;Ne;0;5;0;5
16561;Saulutė;"3 klasė";9113434597;Ne;0;5;0;5
16562;Saulutė;"3 klasė";8601544457;Taip;0;5;0;5
16563;Saulutė;"3 klasė";8506064421;Ne;0;5;0;5
16564;Saulutė;"3 klasė";7700196440;Ne;0;5;0;5
16565;Saulutė;"3 klasė";9621988308;Ne;15;5;0;20
16566;Saulutė;"3 klasė";4189732482;Ne;15;5;0;20
16567;Saulutė;"3 klasė";2638495931;Ne;15;5;0;20
16568;Saulutė;"3 klasė";6797161399;Ne;2;5;0;7
16569;Saulutė;"3 klasė";9885756874;Ne;3;5;0;8
16570;Saulutė;"3 klasė";6957680310;Ne;15;5;0;20
16571;Saulutė;"3 klasė";7343265118;Ne;15;5;0;20
16572;Saulutė;"3 klasė";2374587130;Ne;0;5;0;5
16573;Saulutė;"4 klasė";5056875822;Ne;7;5;0;12
16574;Saulutė;"4 klasė";9319954066;Ne;0;5;0;5
16575;Saulutė;"4 klasė";6584576600;Ne;0;5;0;5
16576;Saulutė;"4 klasė";5395865996;Ne;0;5;0;5
16577;Saulutė;"4 klasė";7115874340;Ne;6;5;0;11
16578;Saulutė;"4 klasė";4407219804;Ne;13;5;0;18
16579;Saulutė;"4 klasė";7050670622;Ne;0;5;0;5
16580;Saulutė;"4 klasė";4724713439;Ne;3;5;0;8
16581;Saulutė;"4 klasė";7656351068;Ne;1;5;0;6
16582;Saulutė;"4 klasė";3798600407;Ne;5;5;0;10
16583;Saulutė;"4 klasė";9802910644;Ne;0;5;0;5
16584;Saulutė;"4 klasė";4804531706;Ne;0;5;0;5
16585;Saulutė;"4 klasė";2876473029;Ne;1;5;0;6
16586;Svaja;SAULĖGRĄŽA;1649920341;Taip;0;11;0;11
16587;Svaja;SAULĖGRĄŽA;54462393937;Taip;5;1;0;6
16588;Svaja;SAULĖGRĄŽA;57216299421;Ne;2;12;0;14
16589;Svaja;SAULĖGRĄŽA;1181877436;Taip;0;1;0;1
16590;Svaja;SAULĖGRĄŽA;64487515384;Taip;8;0;1;9
16591;Svaja;SAULĖGRĄŽA;25578518444;Taip;5;1;0;6
16592;Svaja;SAULĖGRĄŽA;93651139102;Taip;5;4;0;9
16593;Svaja;SAULĖGRĄŽA;1470843400;Taip;0;0;1;1
16594;Svaja;SAULĖGRĄŽA;6057524892;Taip;12;0;0;12
16595;Svaja;SAULĖGRĄŽA;63346231562;Taip;13;2;0;15
16596;Svaja;SAULĖGRĄŽA;73391331150;Taip;8;0;0;8
16597;Svaja;SAULĖGRĄŽA;41183537732;Taip;7;0;2;9
16598;Svaja;SAULĖGRĄŽA;30833178157;Taip;1;0;1;2
16599;Svaja;SAULĖGRĄŽA;70507326327;Taip;0;1;3;4
16600;Svaja;SAULĖGRĄŽA;25934507261;Taip;5;0;1;6
16601;Svaja;SAULĖGRĄŽA;70506691027;Taip;4;5;0;9
16602;Svaja;SAULĖGRĄŽA;89047123808;Taip;6;0;1;7
16603;Svaja;SAULĖGRĄŽA;7348182434;Taip;0;2;0;2
16604;Svaja;SAULĖGRĄŽA;1795682827;Taip;7;2;0;9
16605;Svaja;SAULĖGRĄŽA;8011137572;Taip;0;1;0;1
16606;Svaja;SAULĖGRĄŽA;3499148291;Taip;15;0;0;15
16607;Svaja;SAULĖGRĄŽA;4416877973;Taip;0;5;0;5
16608;Svaja;SAULĖGRĄŽA;99005386537;Taip;11;3;0;14
16609;Svaja;SAULUTĖ;50207734108;Taip;6;5;0;11
16610;Svaja;SAULUTĖ;20473739993;Taip;0;5;0;5
16611;Svaja;SAULUTĖ;2493749424;Taip;6;7;2;15
16612;Svaja;SAULUTĖ;30719991872;Taip;20;0;0;20
16613;Svaja;SAULUTĖ;6665752307;Taip;15;5;0;20
16614;Svaja;SAULUTĖ;80459437057;Taip;8;1;0;9
16615;Svaja;SAULUTĖ;4968201186;Taip;0;7;0;7
16616;Svaja;SAULUTĖ;8689706130;Taip;0;6;0;6
16617;Svaja;SAULUTĖ;6807834176;Taip;0;5;0;5
16618;Svaja;SAULUTĖ;7020342969;Taip;6;6;0;12
16619;Svaja;SAULUTĖ;3633996231;Taip;8;1;1;10
16620;Svaja;SAULUTĖ;2750615517;Taip;9;0;0;9
16621;Svaja;SAULUTĖ;3049808328;Taip;6;5;0;11
16622;Svaja;SAULUTĖ;4341042027;Taip;9;5;0;14
16623;Svaja;SAULUTĖ;3802996573;Taip;10;0;1;11
16624;Svaja;SAULUTĖ;6676145522;Taip;10;0;0;10
16625;Svaja;SAULUTĖ;7936765752;Taip;0;5;0;5
16626;Svaja;SAULUTĖ;4293339784;Taip;16;0;0;16
16627;Svaja;SAULUTĖ;9475971731;Taip;7;1;1;9
16628;Svaja;SAULUTĖ;5479482244;Ne;16;0;0;16
16629;Svaja;SAULUTĖ;7473493846;Taip;0;5;0;5
16630;Svaja;SAULUTĖ;5443682744;Taip;15;1;0;16
16631;Svaja;SAULUTĖ;9112198914;Taip;0;5;1;6
16632;Svaja;"AUKSINĖ ŽUVELĖ";43307670660;Taip;9;5;0;14
16633;Svaja;"AUKSINĖ ŽUVELĖ";25194696146;Taip;0;5;0;5
16634;Svaja;"AUKSINĖ ŽUVELĖ";55925058866;Taip;8;3;1;12
16635;Svaja;"AUKSINĖ ŽUVELĖ";1704075006;Taip;9;2;0;11
16636;Svaja;"AUKSINĖ ŽUVELĖ";8875237023;Taip;8;0;2;10
16637;Svaja;"AUKSINĖ ŽUVELĖ";8279605005;Taip;8;0;2;10
16638;Svaja;"AUKSINĖ ŽUVELĖ";1437557657;Taip;15;1;0;16
16639;Svaja;"AUKSINĖ ŽUVELĖ";87432529423;Taip;10;0;0;10
16640;Svaja;"AUKSINĖ ŽUVELĖ";36505115395;Taip;5;5;0;10
16641;Svaja;"AUKSINĖ ŽUVELĖ";58102699652;Taip;0;5;0;5
16642;Svaja;"AUKSINĖ ŽUVELĖ";6593047776;Taip;0;4;1;5
16643;Svaja;"AUKSINĖ ŽUVELĖ";5335776957;Ne;14;3;0;17
16644;Svaja;"AUKSINĖ ŽUVELĖ";8242667827;Taip;0;9;5;14
16645;Svaja;"AUKSINĖ ŽUVELĖ";6211339131;Taip;0;9;5;14
16646;Svaja;"AUKSINĖ ŽUVELĖ";7911488445;Taip;10;2;0;12
16647;Svaja;"AUKSINĖ ŽUVELĖ";1295012978;Taip;1;4;6;11
16648;Svaja;"AUKSINĖ ŽUVELĖ";64196174690;Taip;9;0;0;9
16649;Svaja;"AUKSINĖ ŽUVELĖ";97298858365;Taip;0;5;0;5
16650;Svaja;"AUKSINĖ ŽUVELĖ";22702341083;Taip;4;2;0;6
16651;Svaja;"AUKSINĖ ŽUVELĖ";3077814152;Taip;20;0;0;20
16652;Svaja;"AUKSINĖ ŽUVELĖ";2076060840;Taip;0;9;0;9
16653;Svaja;"AUKSINĖ ŽUVELĖ";43223177664;Taip;8;0;0;8
16654;Svaja;"AUKSINĖ ŽUVELĖ";27445299450;Taip;0;5;0;5
16655;Svaja;"PRIE ĮLANKOS";2165716699;Taip;6;0;3;9
16656;Svaja;"PRIE ĮLANKOS";6020060540;Taip;0;20;0;20
16657;Svaja;"PRIE ĮLANKOS";94449039022;Taip;0;3;3;6
16658;Svaja;"PRIE ĮLANKOS";1367687415;Taip;0;4;0;4
16659;Svaja;"PRIE ĮLANKOS";85150525696;Taip;5;0;1;6
16660;Svaja;"PRIE ĮLANKOS";74904581010;Taip;7;3;0;10
16661;Svaja;"PRIE ĮLANKOS";44418402260;Taip;5;0;0;5
16662;Svaja;"PRIE ĮLANKOS";8828911320;Taip;5;0;0;5
16663;Svaja;"PRIE ĮLANKOS";54328462992;Taip;0;5;0;5
16664;Svaja;"PRIE ĮLANKOS";18238622848;Taip;4;4;1;9
16665;Svaja;"PRIE ĮLANKOS";4617061890;Taip;10;0;0;10
16666;Svaja;"PRIE ĮLANKOS";71708072632;Taip;0;5;3;8
16667;Svaja;"PRIE ĮLANKOS";56506642672;Taip;5;5;0;10
16668;Svaja;"PRIE ĮLANKOS";34141773112;Ne;0;1;0;1
16669;Svaja;"PRIE ĮLANKOS";5522433229;Taip;15;0;0;15
16670;Svaja;"PRIE ĮLANKOS";40856210635;Taip;5;0;6;11
16671;Svaja;"PRIE ĮLANKOS";3604946305;Taip;5;2;0;7
16672;Svaja;"PRIE ĮLANKOS";6905550313;Taip;0;0;3;3
16673;Svaja;"1 B klasė";8876971658;Taip;0;20;0;20
16674;Svaja;"1 B klasė";30200636424;Ne;0;6;0;6
16675;Svaja;"1 B klasė";8802243719;Taip;0;5;0;5
16676;Svaja;"1 B klasė";9401605132;Taip;0;5;0;5
16677;Svaja;"1 B klasė";77796846388;Taip;0;5;0;5
16678;Svaja;"1 B klasė";71840791098;Taip;0;5;0;5
16679;Svaja;"1 B klasė";5712106350;Taip;0;20;0;20
16680;Svaja;"1 B klasė";57983452414;Taip;0;5;0;5
16681;Svaja;"1 B klasė";71086654007;Taip;0;10;0;10
16682;Svaja;"1 B klasė";29972474690;Taip;0;5;0;5
16683;Svaja;"1 B klasė";38464012322;Taip;0;5;0;5
16684;Svaja;"1 B klasė";15871540340;Taip;0;12;0;12
16685;Svaja;"1 B klasė";47441661801;Ne;0;5;0;5
16686;Svaja;"1 B klasė";68894832324;Taip;0;6;0;6
16687;Svaja;"1 B klasė";7747921362;Ne;0;6;0;6
16688;Svaja;"1 B klasė";21035820496;Taip;0;14;0;14
16689;Svaja;"1 B klasė";61996055386;Taip;0;7;0;7
16690;Svaja;"1 B klasė";59707838958;Taip;0;6;0;6
16691;Svaja;"1 B klasė";62579722313;Taip;0;7;0;7
16692;Svaja;"1 B klasė";77712240909;Taip;0;5;0;5
16693;Svaja;"1 B klasė";27313057222;Taip;0;6;0;6
16694;Svaja;"1 B klasė";97651620085;Taip;0;8;0;8
16695;Svaja;"1 A klasė";28311552445;Taip;0;11;0;11
16696;Svaja;"1 A klasė";88447528808;Taip;0;5;0;5
16697;Svaja;"1 A klasė";21534170175;Taip;0;5;0;5
16698;Svaja;"1 A klasė";89075087937;Taip;0;20;0;20
16699;Svaja;"1 A klasė";72655912805;Taip;0;7;0;7
16700;Svaja;"1 A klasė";16955510836;Taip;0;8;0;8
16701;Svaja;"1 A klasė";49184638535;Taip;0;20;0;20
16702;Svaja;"1 A klasė";66507774550;Taip;0;5;0;5
16703;Svaja;"1 A klasė";2019179013;Taip;0;5;0;5
16704;Svaja;"1 A klasė";69928474471;Taip;0;7;0;7
16705;Svaja;"1 A klasė";56095979514;Taip;0;5;0;5
16706;Svaja;"1 A klasė";24812635291;Taip;0;8;0;8
16707;Svaja;"1 A klasė";99157757025;Ne;0;5;0;5
16708;Svaja;"1 A klasė";89627730276;Taip;0;5;0;5
16709;Svaja;"1 A klasė";48859926231;Taip;0;10;0;10
16710;Svaja;"1 A klasė";20363553383;Taip;0;15;0;15
16711;Svaja;"1 A klasė";70513111186;Ne;0;5;0;5
16712;Svaja;"1 A klasė";31604152893;Taip;0;9;0;9
16713;Svaja;"1 A klasė";76101749947;Taip;0;20;0;20
16714;Svaja;"1 A klasė";96680395594;Taip;0;5;0;5
16715;Svaja;"1 A klasė";58497063533;Taip;0;11;0;11
16716;Svaja;"1 A klasė";38781141060;Taip;0;10;0;10
16717;Svaja;"1 C klasė";2018073862;Taip;0;8;0;8
16718;Svaja;"1 C klasė";70157518595;Taip;0;7;0;7
16719;Svaja;"1 C klasė";73691352138;Taip;0;5;0;5
16720;Svaja;"1 C klasė";6613028133;Taip;0;5;0;5
16721;Svaja;"1 C klasė";5288858941;Ne;0;5;0;5
16722;Svaja;"1 C klasė";5975083034;Taip;0;20;0;20
16723;Svaja;"1 C klasė";94437606762;Taip;0;5;0;5
16724;Svaja;"1 C klasė";25585032766;Taip;0;20;0;20
16725;Svaja;"1 C klasė";79572045341;Taip;0;5;0;5
16726;Svaja;"1 C klasė";50116820543;Taip;0;5;0;5
16727;Svaja;"1 C klasė";1869833113;Taip;0;12;0;12
16728;Svaja;"1 C klasė";66967032561;Taip;0;20;0;20
16729;Svaja;"1 C klasė";79260508923;Taip;0;5;0;5
16730;Svaja;"1 C klasė";3909240894;Taip;0;5;0;5
16731;Svaja;"1 C klasė";82358174131;Taip;0;8;0;8
16732;Svaja;"1 C klasė";53352329988;Taip;0;10;0;10
16733;Svaja;"1 C klasė";59917024948;Taip;0;5;0;5
16734;Svaja;"1 C klasė";48888360976;Taip;0;5;0;5
16735;Svaja;"1 C klasė";76871144487;Taip;0;14;0;14
16736;Svaja;"1 C klasė";73440582394;Taip;0;12;0;12
16737;Svaja;"1 C klasė";60982723867;Taip;0;20;0;20
16738;Svaja;"1 C klasė";12226488343;Taip;0;10;0;10
16739;Svaja;"2 A klasė";9170681988;Taip;0;7;0;7
16740;Svaja;"2 A klasė";6331528628;Taip;0;8;0;8
16741;Svaja;"2 A klasė";3545160978;Taip;0;20;0;20
16742;Svaja;"2 A klasė";3812365439;Taip;0;5;0;5
16743;Svaja;"2 A klasė";4732976577;Ne;0;6;0;6
16744;Svaja;"2 A klasė";4819506647;Taip;0;5;0;5
16745;Svaja;"2 A klasė";7374204735;Taip;0;6;0;6
16746;Svaja;"2 A klasė";4147975771;Taip;0;5;0;5
16747;Svaja;"2 A klasė";5355661673;Taip;0;7;0;7
16748;Svaja;"2 A klasė";8907191675;Taip;0;5;0;5
16749;Svaja;"2 A klasė";7406969545;Taip;0;7;0;7
16750;Svaja;"2 A klasė";6182584108;Taip;0;7;0;7
16751;Svaja;"2 A klasė";6561055995;Taip;0;5;0;5
16752;Svaja;"2 A klasė";7745440861;Taip;0;6;0;6
16753;Svaja;"2 A klasė";3100769948;Taip;0;9;0;9
16754;Svaja;"2 A klasė";1932041952;Taip;0;20;0;20
16755;Svaja;"2 A klasė";2963665708;Taip;0;7;0;7
16756;Svaja;"2 A klasė";6166818062;Taip;0;6;0;6
16757;Svaja;"2 A klasė";5400447747;Taip;0;14;0;14
16758;Svaja;"2 A klasė";4677183471;Taip;0;5;0;5
16759;Svaja;"2 A klasė";3876795349;Taip;0;9;0;9
16760;Svaja;"2 A klasė";4570702330;Taip;0;8;0;8
16761;Svaja;"2 A klasė";4559408388;Taip;0;5;0;5
16762;Svaja;"2 A klasė";1851430613;Taip;0;5;0;5
16763;Svaja;"2 A klasė";6301200166;Ne;0;6;0;6
16764;Svaja;"2 B klasė";6685023540;Taip;0;5;0;5
16765;Svaja;"2 B klasė";3917545035;Taip;0;20;0;20
16766;Svaja;"2 B klasė";3154268090;Taip;0;6;0;6
16767;Svaja;"2 B klasė";9833804885;Taip;0;5;0;5
16768;Svaja;"2 B klasė";7137011094;Taip;0;10;0;10
16769;Svaja;"2 B klasė";8497722175;Taip;0;5;0;5
16770;Svaja;"2 B klasė";1949789571;Taip;0;5;0;5
16771;Svaja;"2 B klasė";5316972581;Taip;0;20;0;20
16772;Svaja;"2 B klasė";5304302886;Taip;0;5;0;5
16773;Svaja;"2 B klasė";9390649669;Ne;0;6;0;6
16774;Svaja;"2 B klasė";2543801351;Taip;0;5;0;5
16775;Svaja;"2 B klasė";2768998567;Taip;0;6;0;6
16776;Svaja;"2 B klasė";5417233257;Taip;0;5;0;5
16777;Svaja;"2 B klasė";8934053695;Ne;0;9;0;9
16778;Svaja;"2 B klasė";6888324693;Taip;0;5;0;5
16779;Svaja;"2 B klasė";9741563523;Taip;0;10;0;10
16780;Svaja;"2 B klasė";9474581791;Taip;0;5;0;5
16781;Svaja;"2 B klasė";7185891478;Ne;0;20;0;20
16782;Svaja;"2 B klasė";6949932613;Taip;0;5;0;5
16783;Svaja;"2 B klasė";9227257148;Taip;0;8;0;8
16784;Svaja;"2 B klasė";7403841330;Taip;0;13;0;13
16785;Svaja;"2 B klasė";6387070757;Taip;0;5;0;5
16786;Svaja;"2 B klasė";4859522896;Taip;0;6;0;6
16787;Svaja;"2 B klasė";7165840275;Taip;0;5;0;5
16788;Svaja;"2 B klasė";4858401763;Taip;0;5;0;5
16789;Svaja;"2 B klasė";986820082;Taip;0;10;0;10
16790;Svaja;"3 A klasė";6890796785;Taip;0;5;0;5
16791;Svaja;"3 A klasė";4321787638;Taip;0;5;0;5
16792;Svaja;"3 A klasė";8045419081;Taip;0;5;0;5
16793;Svaja;"3 A klasė";3060720122;Taip;0;8;0;8
16794;Svaja;"3 A klasė";4191652201;Taip;0;20;0;20
16795;Svaja;"3 A klasė";2408787820;Taip;0;6;0;6
16796;Svaja;"3 A klasė";2143707618;Taip;0;7;0;7
16797;Svaja;"3 A klasė";9922327181;Taip;0;5;0;5
16798;Svaja;"3 A klasė";7360643147;Taip;0;5;0;5
16799;Svaja;"3 A klasė";9431617139;Taip;0;20;0;20
16800;Svaja;"3 A klasė";5072924063;Taip;0;5;0;5
16801;Svaja;"3 A klasė";1224863574;Ne;0;5;0;5
16802;Svaja;"3 A klasė";5866029763;Ne;0;20;0;20
16803;Svaja;"3 A klasė";5224191012;Taip;0;5;0;5
16804;Svaja;"3 A klasė";2396489897;Taip;0;5;0;5
16805;Svaja;"3 A klasė";3362976996;Taip;0;11;0;11
16806;Svaja;"3 A klasė";6924433006;Taip;0;13;0;13
16807;Svaja;"3 A klasė";6379522088;Taip;0;20;0;20
16808;Svaja;"3 A klasė";6859893256;Taip;0;20;0;20
16809;Svaja;"3 A klasė";7222472406;Taip;0;5;0;5
16810;Svaja;"3 A klasė";8566329547;Taip;0;20;0;20
16811;Svaja;"3 A klasė";8014577929;Taip;0;10;0;10
16812;Svaja;"3 A klasė";5916292577;Taip;0;20;0;20
16813;Svaja;"3 B klasė";4730576902;Taip;0;6;0;6
16814;Svaja;"3 B klasė";1717017574;Taip;0;20;0;20
16815;Svaja;"3 B klasė";6738703814;Taip;0;8;0;8
16816;Svaja;"2 C klasė";4022762780;Taip;0;20;0;20
16817;Svaja;"2 C klasė";5749575112;Taip;0;7;0;7
16818;Svaja;"2 C klasė";8150945946;Taip;0;20;0;20
16819;Svaja;"2 C klasė";1915009909;Taip;0;5;0;5
16820;Svaja;"2 C klasė";4310597965;Taip;0;7;0;7
16821;Svaja;"2 C klasė";8274918664;Taip;0;5;0;5
16822;Svaja;"2 C klasė";4333896021;Taip;0;5;0;5
16823;Svaja;"2 C klasė";5467666579;Taip;0;7;0;7
16824;Svaja;"2 C klasė";5453168902;Taip;0;5;0;5
16825;Svaja;"2 C klasė";1750972673;Taip;0;5;0;5
16826;Svaja;"2 C klasė";5633989310;Taip;0;5;0;5
16827;Svaja;"2 C klasė";4807854408;Taip;0;20;0;20
16828;Svaja;"2 C klasė";9653780566;Taip;0;5;0;5
16829;Svaja;"2 C klasė";8556383911;Ne;0;5;0;5
16830;Svaja;"2 C klasė";5736016717;Taip;0;20;0;20
16831;Svaja;"2 C klasė";6956015602;Taip;0;20;0;20
16832;Svaja;"2 C klasė";4196053724;Taip;0;9;0;9
16833;Svaja;"2 C klasė";6155277279;Ne;0;20;0;20
16834;Svaja;"2 C klasė";6750156163;Taip;0;7;0;7
16835;Svaja;"2 C klasė";3466700144;Taip;0;5;0;5
16836;Svaja;"2 C klasė";9961965117;Taip;0;20;0;20
16837;Svaja;"2 C klasė";4809644609;Taip;0;6;0;6
16838;Svaja;"2 C klasė";1910435736;Taip;0;7;0;7
16839;Svaja;"2 C klasė";5205253544;Taip;0;7;0;7
16840;Svaja;"2 C klasė";6958729265;Taip;0;5;0;5
16841;Šilelis;PAUKŠTELIAI;1048576329;Taip;7;5;2;14
16842;Šilelis;PAUKŠTELIAI;15636728118;Taip;5;1;0;6
16843;Šilelis;PAUKŠTELIAI;79937811039;Taip;0;4;0;4
16844;Šilelis;PAUKŠTELIAI;2478018487;Taip;0;0;1;1
16845;Šilelis;PAUKŠTELIAI;43394471973;Taip;0;12;0;12
16846;Šilelis;PAUKŠTELIAI;78892676375;Ne;0;9;0;9
16847;Šilelis;PAUKŠTELIAI;2033871385;Taip;0;1;4;5
16848;Šilelis;PAUKŠTELIAI;5025537628;Taip;0;5;1;6
16849;Šilelis;PAUKŠTELIAI;8969858170;Taip;0;0;1;1
16850;Šilelis;PAUKŠTELIAI;2078673522;Taip;2;1;3;6
16851;Šilelis;PAUKŠTELIAI;1150836049;Taip;11;5;0;16
16852;Šilelis;PAUKŠTELIAI;33018110830;Taip;9;0;0;9
16853;Šilelis;PAUKŠTELIAI;9756832600;Taip;0;5;0;5
16854;Šilelis;PAUKŠTELIAI;3847912854;Taip;8;0;4;12
16855;Šilelis;PAUKŠTELIAI;38884246104;Taip;5;6;0;11
16856;Šilelis;PAUKŠTELIAI;8337759186;Taip;0;5;1;6
16857;Šilelis;PAUKŠTELIAI;79806281817;Taip;0;5;1;6
16858;Šilelis;PAUKŠTELIAI;89770278636;Taip;7;0;1;8
16859;Šilelis;SKRUZDELIUKAI;20231469825;Taip;9;3;0;12
16860;Šilelis;SKRUZDELIUKAI;38262299304;Taip;2;5;0;7
16861;Šilelis;SKRUZDELIUKAI;45002017060;Taip;6;5;2;13
16862;Šilelis;SKRUZDELIUKAI;80919252085;Taip;0;17;0;17
16863;Šilelis;SKRUZDELIUKAI;1801211208;Taip;7;0;1;8
16864;Šilelis;SKRUZDELIUKAI;46216564439;Taip;0;3;0;3
16865;Šilelis;SKRUZDELIUKAI;43285060688;Taip;0;3;0;3
16866;Šilelis;SKRUZDELIUKAI;1176917186;Taip;5;5;5;15
16867;Šilelis;SKRUZDELIUKAI;1462541640;Taip;0;2;0;2
16868;Šilelis;SKRUZDELIUKAI;2105377652;Taip;0;2;0;2
16869;Šilelis;SKRUZDELIUKAI;1146878499;Taip;0;5;2;7
16870;Šilelis;SKRUZDELIUKAI;1807785773;Taip;6;4;0;10
16871;Šilelis;SKRUZDELIUKAI;7488080791;Taip;8;4;0;12
16872;Šilelis;SKRUZDELIUKAI;2756742620;Taip;0;1;11;12
16873;Šilelis;SKRUZDELIUKAI;1483339314;Taip;0;9;0;9
16874;Šilelis;SKRUZDELIUKAI;53707043315;Taip;0;3;8;11
16875;Šilelis;SKRUZDELIUKAI;97609897018;Taip;0;8;0;8
16876;Šilelis;SKRUZDELIUKAI;9141446821;Taip;5;0;0;5
16877;Šilelis;SKRUZDELIUKAI;9690607334;Taip;0;5;7;12
16878;Šilelis;SMERFY;2957745091;Taip;10;0;0;10
16879;Šilelis;SMERFY;8471020975;Taip;9;5;2;16
16880;Šilelis;SMERFY;1246899777;Taip;8;3;0;11
16881;Šilelis;SMERFY;93686653078;Taip;6;5;5;16
16882;Šilelis;SMERFY;8980788109;Taip;5;5;0;10
16883;Šilelis;SMERFY;30180586342;Taip;5;5;0;10
16884;Šilelis;SMERFY;7936978436;Taip;9;5;0;14
16885;Šilelis;SMERFY;7126070419;Ne;4;5;3;12
16886;Šilelis;SMERFY;8100789958;Taip;10;0;0;10
16887;Šilelis;SMERFY;6572969153;Taip;0;7;0;7
16888;Šilelis;SMERFY;5036549574;Taip;12;5;0;17
16889;Šilelis;SMERFY;74190923349;Taip;5;7;0;12
16890;Šilelis;SMERFY;5665331529;Taip;6;1;0;7
16891;Šilelis;SMERFY;6773906184;Ne;9;0;2;11
16892;Šilelis;SMERFY;3089270468;Taip;15;5;0;20
16893;Šilelis;SMERFY;7824279279;Ne;0;7;0;7
16894;Šilelis;SMERFY;5496605727;Taip;5;0;0;5
16895;Šilelis;EŽIUKAI;6336168033;Taip;0;0;1;1
16896;Šilelis;EŽIUKAI;8416126751;Taip;11;0;1;12
16897;Šilelis;EŽIUKAI;8328948120;Taip;4;5;3;12
16898;Šilelis;EŽIUKAI;6359318134;Taip;12;0;1;13
16899;Šilelis;EŽIUKAI;4494932923;Taip;5;1;0;6
16900;Šilelis;EŽIUKAI;7534468539;Taip;16;0;0;16
16901;Šilelis;EŽIUKAI;1165219272;Taip;6;2;0;8
16902;Šilelis;EŽIUKAI;4504627601;Taip;11;6;0;17
16903;Šilelis;EŽIUKAI;3234612149;Taip;9;0;0;9
16904;Šilelis;EŽIUKAI;4702068672;Taip;19;1;0;20
16905;Šilelis;EŽIUKAI;1724976098;Taip;17;0;3;20
16906;Šilelis;EŽIUKAI;5598152793;Taip;0;7;0;7
16907;Šilelis;EŽIUKAI;1586414960;Taip;11;0;0;11
16908;Šilelis;EŽIUKAI;5020209473;Taip;4;0;0;4
16909;Šilelis;EŽIUKAI;2397366916;Taip;12;0;0;12
16910;Šilelis;NYKŠTUKAI;53418739087;Taip;10;0;1;11
16911;Šilelis;NYKŠTUKAI;47822247496;Taip;5;0;2;7
16912;Šilelis;NYKŠTUKAI;26500981786;Taip;10;0;0;10
16913;Šilelis;NYKŠTUKAI;51144587636;Taip;0;3;0;3
16914;Šilelis;NYKŠTUKAI;54390109952;Taip;10;0;0;10
16915;Šilelis;NYKŠTUKAI;23708962006;Taip;8;0;1;9
16916;Šilelis;NYKŠTUKAI;17041507614;Ne;0;9;0;9
16917;Šilelis;NYKŠTUKAI;70854637761;Taip;3;5;0;8
16918;Šilelis;NYKŠTUKAI;46963038100;Taip;0;1;0;1
16919;Šilelis;NYKŠTUKAI;36489228256;Taip;0;7;0;7
16920;Šilelis;NYKŠTUKAI;88867863035;Taip;10;5;0;15
16921;Šilelis;NYKŠTUKAI;11569489731;Taip;8;6;0;14
16922;Šilelis;NYKŠTUKAI;1062766090;Taip;0;0;2;2
16923;Šilelis;NYKŠTUKAI;1740251009;Taip;8;0;6;14
16924;Šilelis;NYKŠTUKAI;1291493034;Taip;8;0;0;8
16925;Šilelis;NYKŠTUKAI;1525689616;Taip;0;13;0;13
16926;Šilelis;NYKŠTUKAI;6000255910;Taip;20;0;0;20
16927;Šilelis;NYKŠTUKAI;90624206653;Taip;10;4;0;14
16928;Šilelis;NYKŠTUKAI;96137271177;Taip;5;4;0;9
16929;Šilelis;NYKŠTUKAI;38324408521;Taip;0;0;2;2
16930;Šilelis;NYKŠTUKAI;4263665228;Taip;0;10;0;10
16931;Šilelis;ANČIUKAI;3489973354;Taip;5;0;0;5
16932;Šilelis;ANČIUKAI;56024407115;Taip;1;0;0;1
16933;Šilelis;ANČIUKAI;13655605764;Taip;0;4;2;6
16934;Šilelis;ANČIUKAI;5489571459;Taip;7;0;0;7
16935;Šilelis;ANČIUKAI;34382940842;Taip;5;8;1;14
16936;Šilelis;ANČIUKAI;942416614;Ne;5;0;0;5
16937;Šilelis;ANČIUKAI;37050806780;Taip;9;5;0;14
16938;Šilelis;ANČIUKAI;1490838609;Taip;5;0;1;6
16939;Šilelis;ANČIUKAI;1621768113;Taip;0;5;0;5
16940;Šilelis;ANČIUKAI;3892886609;Taip;0;5;1;6
16941;Šilelis;ANČIUKAI;1257686463;Taip;20;0;0;20
16942;Šilelis;ANČIUKAI;1633933962;Taip;9;0;4;13
16943;Šilelis;ANČIUKAI;8127562502;Taip;0;13;0;13
16944;Šilelis;ANČIUKAI;7201199871;Taip;0;10;0;10
16945;Šilelis;ANČIUKAI;5003717844;Taip;12;0;6;18
16946;Šilelis;KAČIUKAI;44480420068;Taip;0;0;2;2
16947;Šilelis;KAČIUKAI;23606747301;Taip;0;4;0;4
16948;Šilelis;KAČIUKAI;79896955546;Ne;0;12;0;12
16949;Šilelis;KAČIUKAI;1738220599;Taip;0;5;3;8
16950;Šilelis;KAČIUKAI;29262195378;Taip;0;8;0;8
16951;Šilelis;KAČIUKAI;36678503356;Taip;0;4;0;4
16952;Šilelis;KAČIUKAI;1106460550;Taip;13;0;2;15
16953;Šilelis;KAČIUKAI;41839221589;Taip;5;0;0;5
16954;Šilelis;KAČIUKAI;21170737202;Taip;0;2;5;7
16955;Šilelis;KAČIUKAI;61499715350;Ne;0;5;0;5
16956;Šilelis;KAČIUKAI;56287881538;Taip;0;1;1;2
16957;Šilelis;KAČIUKAI;11738059485;Ne;0;2;3;5
16958;Šilelis;KAČIUKAI;2112799379;Taip;0;11;0;11
16959;Šilelis;KAČIUKAI;56920875808;Taip;0;6;0;6
16960;Šilelis;KAČIUKAI;82621352730;Taip;0;0;1;1
16961;Šilelis;KIŠKUČIAI;62991250307;Taip;0;6;0;6
16962;Šilelis;KIŠKUČIAI;65917456866;Taip;0;6;3;9
16963;Šilelis;KIŠKUČIAI;193181908;Taip;3;0;0;3
16964;Šilelis;KIŠKUČIAI;21871530266;Taip;0;1;4;5
16965;Šilelis;KIŠKUČIAI;1747920772;Taip;5;0;0;5
16966;Šilelis;KIŠKUČIAI;1640789816;Taip;0;7;0;7
16967;Šilelis;KIŠKUČIAI;6061033736;Taip;0;10;0;10
16968;Šilelis;KIŠKUČIAI;1976745574;Taip;0;5;1;6
16969;Šilelis;KIŠKUČIAI;88436890881;Taip;5;1;0;6
16970;Šilelis;KIŠKUČIAI;29368876227;Taip;7;0;0;7
16971;Šilelis;KIŠKUČIAI;4580716838;Taip;0;0;2;2
16972;Šilelis;KIŠKUČIAI;20920553773;Taip;0;0;2;2
16973;Šilelis;KIŠKUČIAI;8399364170;Taip;0;12;0;12
16974;Šilelis;KIŠKUČIAI;5478094866;Taip;5;0;2;7
16975;Šilelis;KIŠKUČIAI;6096639483;Taip;19;1;0;20
16976;Šilelis;KREGŽDUTĖS;3655800765;Taip;15;0;0;15
16977;Šilelis;KREGŽDUTĖS;50209412455;Taip;0;14;0;14
16978;Šilelis;KREGŽDUTĖS;1719681061;Taip;5;4;0;9
16979;Šilelis;KREGŽDUTĖS;2049105004;Taip;9;1;0;10
16980;Šilelis;KREGŽDUTĖS;36811772392;Taip;0;4;0;4
16981;Šilelis;KREGŽDUTĖS;19141613082;Taip;0;5;0;5
16982;Šilelis;KREGŽDUTĖS;1958785859;Taip;0;6;0;6
16983;Šilelis;KREGŽDUTĖS;89194687299;Taip;0;10;0;10
16984;Šilelis;KREGŽDUTĖS;4187993554;Taip;10;0;0;10
16985;Šilelis;KREGŽDUTĖS;1571063782;Taip;4;0;0;4
16986;Šilelis;KREGŽDUTĖS;1930906118;Taip;10;0;0;10
16987;Šilelis;KREGŽDUTĖS;82928837930;Taip;0;9;0;9
16988;Šilelis;KREGŽDUTĖS;5186367833;Taip;9;4;1;14
16989;Šilelis;KREGŽDUTĖS;1984731000;Taip;6;0;0;6
16990;Šilelis;KREGŽDUTĖS;75274553746;Taip;0;0;7;7
16991;Šilelis;KREGŽDUTĖS;7542121945;Taip;5;0;2;7
16992;Šilelis;KREGŽDUTĖS;20994727549;Taip;10;3;0;13
16993;Šilelis;KREGŽDUTĖS;8915228012;Taip;20;0;0;20
16994;Šilelis;KREGŽDUTĖS;8012626513;Taip;10;0;0;10
16995;Šilelis;PAGRANDUKAI;43259107285;Taip;2;10;0;12
16996;Šilelis;PAGRANDUKAI;8491275729;Taip;0;0;1;1
16997;Šilelis;PAGRANDUKAI;3660152224;Taip;7;0;0;7
16998;Šilelis;PAGRANDUKAI;4814863979;Taip;15;1;2;18
16999;Šilelis;PAGRANDUKAI;9670243727;Taip;0;6;0;6
17000;Šilelis;PAGRANDUKAI;8357287467;Taip;5;9;0;14
17001;Šilelis;PAGRANDUKAI;20525573092;Taip;7;3;0;10
17002;Šilelis;PAGRANDUKAI;2897196188;Taip;15;0;0;15
17003;Šilelis;PAGRANDUKAI;1288690113;Taip;0;6;0;6
17004;Šilelis;PAGRANDUKAI;3583955729;Taip;5;10;0;15
17005;Šilelis;PAGRANDUKAI;5324806808;Taip;13;0;1;14
17006;Šilelis;PAGRANDUKAI;8199573104;Taip;11;0;0;11
17007;Šilelis;PAGRANDUKAI;9113098594;Taip;17;0;0;17
17008;Šilelis;PAGRANDUKAI;3485639108;Taip;7;5;0;12
17009;Šilelis;PAGRANDUKAI;1468050550;Taip;6;0;1;7
17010;Šilelis;PAGRANDUKAI;56885383122;Taip;0;0;3;3
17011;Šilelis;PAGRANDUKAI;8265212749;Taip;0;1;5;6
17012;Šilelis;PAGRANDUKAI;9081488972;Taip;6;0;2;8
17013;Šilelis;PAGRANDUKAI;55396452032;Taip;16;0;0;16
17014;Šilelis;PAGRANDUKAI;7623203279;Taip;5;0;2;7
17015;Šilelis;PAGRANDUKAI;2397630691;Taip;13;2;0;15
17016;Šilelis;PAGRANDUKAI;4340856490;Taip;15;0;0;15
17017;Šilelis;PAGRANDUKAI;3807787648;Taip;5;2;1;8
17018;Šilelis;PAGRANDUKAI;2354942164;Taip;10;0;0;10
17019;Šilelis;BITUTĖS;2948291866;Taip;0;11;0;11
17020;Šilelis;BITUTĖS;4682742121;Taip;0;1;0;1
17021;Šilelis;BITUTĖS;5835209357;Taip;0;1;0;1
17022;Šilelis;BITUTĖS;7512731255;Taip;4;0;0;4
17023;Šilelis;BITUTĖS;1268335563;Taip;10;0;0;10
17024;Šilelis;BITUTĖS;4781652156;Taip;0;13;0;13
17025;Šilelis;BITUTĖS;6104538160;Taip;0;4;0;4
17026;Šilelis;BITUTĖS;3686287802;Taip;9;1;0;10
17027;Šilelis;BITUTĖS;1821827154;Taip;7;0;2;9
17028;Šilelis;BITUTĖS;8271830626;Taip;19;0;0;19
17029;Šilelis;BITUTĖS;1142044361;Taip;10;0;0;10
17030;Šilelis;BITUTĖS;7814807923;Taip;8;0;0;8
17031;Šilelis;BITUTĖS;9071963194;Taip;5;0;2;7
17032;Šilelis;BITUTĖS;3685607529;Taip;0;2;2;4
17033;Šilelis;BITUTĖS;1306672095;Taip;0;5;0;5
17034;Šilelis;BITUTĖS;6297546907;Taip;7;5;7;19
17035;Šilelis;DRUGELIAI;1877467761;Taip;11;2;0;13
17036;Šilelis;DRUGELIAI;3598370884;Taip;7;5;0;12
17037;Šilelis;DRUGELIAI;1618432877;Taip;5;0;0;5
17038;Šilelis;DRUGELIAI;1347150938;Taip;5;0;0;5
17039;Šilelis;DRUGELIAI;7636725161;Taip;8;0;0;8
17040;Šilelis;DRUGELIAI;9256656029;Taip;0;2;0;2
17041;Šilelis;DRUGELIAI;5759824196;Taip;15;0;1;16
17042;Šilelis;DRUGELIAI;31906089315;Taip;0;9;0;9
17043;Šilelis;DRUGELIAI;5415411238;Taip;12;0;0;12
17044;Šilelis;DRUGELIAI;4115738520;Taip;0;3;2;5
17045;Šilelis;DRUGELIAI;3824174896;Taip;0;3;2;5
17046;Šilelis;DRUGELIAI;8090765017;Taip;6;6;0;12
17047;Šilelis;DRUGELIAI;54633547799;Taip;12;1;0;13
17048;Šilelis;DRUGELIAI;9100047520;Taip;10;0;0;10
17049;Šilelis;DRUGELIAI;6201567680;Taip;12;0;1;13
17050;Šilelis;DRUGELIAI;1019874215;Taip;0;1;0;1
17051;Šilelis;DRUGELIAI;5863425750;Taip;16;0;0;16
17052;Šilelis;DRUGELIAI;1448291886;Taip;0;2;0;2
17053;Šilelis;DRUGELIAI;1638362625;Taip;10;0;1;11
17054;Šilelis;DRUGELIAI;9482667810;Taip;4;0;3;7
17055;Šilelis;DRUGELIAI;5379171382;Taip;0;2;4;6
17056;Šilelis;DRUGELIAI;6230566495;Taip;9;0;2;11
17057;Šilelis;DRUGELIAI;6523676718;Taip;6;1;2;9
17058;Vaduvos;PAGRANDUKAI;1048630061;Taip;11;0;0;11
17059;Vaduvos;PAGRANDUKAI;1431863758;Taip;0;6;0;6
17060;Vaduvos;PAGRANDUKAI;8408017356;Taip;0;6;0;6
17061;Vaduvos;PAGRANDUKAI;72724196791;Taip;0;15;0;15
17062;Vaduvos;PAGRANDUKAI;9371067563;Taip;8;0;0;8
17063;Vaduvos;PAGRANDUKAI;9987311980;Taip;10;5;0;15
17064;Vaduvos;PAGRANDUKAI;6425640531;Taip;10;0;0;10
17065;Vaduvos;PAGRANDUKAI;4029586203;Taip;11;0;1;12
17066;Vaduvos;PAGRANDUKAI;73800920781;Taip;0;5;3;8
17067;Vaduvos;PAGRANDUKAI;18035723255;Taip;9;3;0;12
17068;Vaduvos;PAGRANDUKAI;5954492368;Taip;5;4;0;9
17069;Vaduvos;PAGRANDUKAI;7397068779;Ne;0;8;0;8
17070;Vaduvos;PAGRANDUKAI;8875709110;Taip;0;14;0;14
17071;Vaduvos;PAGRANDUKAI;4789480822;Taip;16;0;0;16
17072;Vaduvos;PAGRANDUKAI;7305111076;Taip;14;0;0;14
17073;Vaduvos;PAGRANDUKAI;2897226343;Taip;0;0;5;5
17074;Vaduvos;PAGRANDUKAI;68848152670;Taip;10;1;0;11
17075;Vaduvos;PAGRANDUKAI;4105978403;Taip;0;9;0;9
17076;Vaduvos;PAGRANDUKAI;3111866557;Taip;15;0;0;15
17077;Vaduvos;PAGRANDUKAI;5428067167;Taip;0;8;0;8
17078;Vaduvos;PAGRANDUKAI;3699578284;Taip;9;0;0;9
17079;Vaduvos;KODĖLČIUKAI;53866301875;Ne;13;0;0;13
17080;Vaduvos;KODĖLČIUKAI;67324784528;Taip;0;9;0;9
17081;Vaduvos;KODĖLČIUKAI;78245732319;Taip;8;0;2;10
17082;Vaduvos;KODĖLČIUKAI;17473821556;Taip;0;4;0;4
17083;Vaduvos;KODĖLČIUKAI;41272273463;Taip;10;0;1;11
17084;Vaduvos;KODĖLČIUKAI;1532675814;Taip;0;1;0;1
17085;Vaduvos;KODĖLČIUKAI;33277362439;Ne;0;5;0;5
17086;Vaduvos;KODĖLČIUKAI;61243424057;Taip;5;0;2;7
17087;Vaduvos;KODĖLČIUKAI;81605493207;Taip;7;5;0;12
17088;Vaduvos;KODĖLČIUKAI;36931517006;Taip;0;12;0;12
17089;Vaduvos;KODĖLČIUKAI;90211578805;Taip;0;2;0;2
17090;Vaduvos;KODĖLČIUKAI;30979103892;Taip;0;5;0;5
17091;Vaduvos;KODĖLČIUKAI;2019573643;Taip;0;5;0;5
17092;Vaduvos;KODĖLČIUKAI;42498568346;Taip;14;0;0;14
17093;Vaduvos;KODĖLČIUKAI;96148085691;Taip;0;2;0;2
17094;Vaduvos;KODĖLČIUKAI;2181614424;Taip;7;1;0;8
17095;Vaduvos;KODĖLČIUKAI;97878811046;Taip;0;1;1;2
17096;Vaduvos;KODĖLČIUKAI;89793734700;Taip;0;5;0;5
17097;Vaduvos;KODĖLČIUKAI;48433447683;Taip;0;7;0;7
17098;Vaduvos;KODĖLČIUKAI;32138087379;Taip;0;10;0;10
17099;Vaduvos;SMALSUČIAI;7786986697;Taip;5;1;1;7
17100;Vaduvos;SMALSUČIAI;12330772986;Taip;7;5;0;12
17101;Vaduvos;SMALSUČIAI;25732368565;Taip;0;0;20;20
17102;Vaduvos;SMALSUČIAI;54606265707;Taip;7;5;0;12
17103;Vaduvos;SMALSUČIAI;85090873161;Taip;10;3;1;14
17104;Vaduvos;SMALSUČIAI;98259624669;Taip;0;10;0;10
17105;Vaduvos;SMALSUČIAI;8183322974;Taip;0;5;3;8
17106;Vaduvos;SMALSUČIAI;78931952732;Taip;0;5;6;11
17107;Vaduvos;SMALSUČIAI;3632802933;Ne;0;5;2;7
17108;Vaduvos;SMALSUČIAI;1107557891;Ne;14;3;0;17
17109;Vaduvos;SMALSUČIAI;4807104855;Taip;0;5;7;12
17110;Vaduvos;SMALSUČIAI;19683758416;Taip;15;5;0;20
17111;Vaduvos;SMALSUČIAI;2605583220;Taip;14;0;0;14
17112;Vaduvos;SMALSUČIAI;54193761898;Taip;5;3;1;9
17113;Vaduvos;SMALSUČIAI;5307128703;Taip;5;1;0;6
17114;Vaduvos;SMALSUČIAI;1139509471;Taip;10;5;0;15
17115;Vaduvos;SMALSUČIAI;13178417729;Taip;8;5;0;13
17116;Vaduvos;SMALSUČIAI;72018210447;Taip;0;7;0;7
17117;Vaduvos;SMALSUČIAI;6121365922;Taip;6;0;0;6
17118;Vaduvos;SMALSUČIAI;62183976729;Taip;10;5;0;15
17119;Vaduvos;GILIUKAI;11202010413;Taip;10;5;0;15
17120;Vaduvos;GILIUKAI;1046867513;Ne;0;2;0;2
17121;Vaduvos;GILIUKAI;4342471835;Taip;2;0;0;2
17122;Vaduvos;GILIUKAI;15757662594;Taip;5;3;0;8
17123;Vaduvos;GILIUKAI;41870343319;Taip;0;4;0;4
17124;Vaduvos;GILIUKAI;97007740148;Taip;14;0;2;16
17125;Vaduvos;GILIUKAI;93702732546;Taip;5;0;0;5
17126;Vaduvos;GILIUKAI;1464016847;Taip;13;2;0;15
17127;Vaduvos;GILIUKAI;2006018986;Taip;0;1;0;1
17128;Vaduvos;GILIUKAI;46608435244;Taip;12;1;0;13
17129;Vaduvos;GILIUKAI;86095539298;Taip;5;0;2;7
17130;Vaduvos;GILIUKAI;21499108813;Taip;5;5;0;10
17131;Vaduvos;GILIUKAI;59616893535;Taip;14;0;0;14
17132;Vaduvos;GILIUKAI;22641388717;Taip;2;0;0;2
17133;Vaduvos;GILIUKAI;61046090149;Taip;14;0;0;14
17134;Vaduvos;GILIUKAI;87008942241;Taip;7;0;0;7
17135;Vaduvos;GILIUKAI;56280470781;Taip;10;0;0;10
17136;Vaduvos;GILIUKAI;79437154441;Taip;4;1;0;5
17137;Vaduvos;GILIUKAI;68937983441;Taip;10;4;0;14
17138;Vaduvos;GILIUKAI;1176603533;Taip;5;0;0;5
17139;Vaduvos;GILIUKAI;1703266825;Taip;10;0;0;10
17140;Vaduvos;GILIUKAI;65843855427;Taip;8;5;0;13
17141;Vaduvos;GILIUKAI;1825188497;Taip;9;2;0;11
17142;Vaduvos;BORUŽĖLĖS;24887196729;Taip;0;7;0;7
17143;Vaduvos;BORUŽĖLĖS;16882774330;Taip;8;5;0;13
17144;Vaduvos;BORUŽĖLĖS;70693742936;Taip;5;6;0;11
17145;Vaduvos;BORUŽĖLĖS;4670249904;Taip;0;0;1;1
17146;Vaduvos;BORUŽĖLĖS;1385184350;Taip;0;2;1;3
17147;Vaduvos;BORUŽĖLĖS;65647119496;Taip;0;2;0;2
17148;Vaduvos;BORUŽĖLĖS;96803174459;Taip;5;2;0;7
17149;Vaduvos;BORUŽĖLĖS;19390879176;Taip;8;2;0;10
17150;Vaduvos;BORUŽĖLĖS;47465933557;Taip;8;7;0;15
17151;Vaduvos;BORUŽĖLĖS;16006064074;Taip;0;1;0;1
17152;Vaduvos;BORUŽĖLĖS;55138588393;Taip;0;7;0;7
17153;Vaduvos;BORUŽĖLĖS;3172047211;Taip;3;0;0;3
17154;Vaduvos;BORUŽĖLĖS;93924290247;Taip;0;6;0;6
17155;Vaduvos;BORUŽĖLĖS;29983824202;Taip;0;5;0;5
17156;Vaduvos;BORUŽĖLĖS;61243200177;Taip;0;8;0;8
17157;Vaduvos;BORUŽĖLĖS;95104294893;Taip;8;5;0;13
17158;Vaduvos;BORUŽĖLĖS;6155494370;Ne;9;5;0;14
17159;Vaduvos;BORUŽĖLĖS;97423576166;Taip;8;2;0;10
17160;Vaduvos;BORUŽĖLĖS;94906586734;Taip;7;6;0;13
17161;Vaduvos;DRUGELIAI;1010061503;Taip;13;4;1;18
17162;Vaduvos;DRUGELIAI;39687066893;Taip;5;0;1;6
17163;Vaduvos;DRUGELIAI;6192828320;Taip;0;1;0;1
17164;Vaduvos;DRUGELIAI;87671358423;Taip;0;5;0;5
17165;Vaduvos;DRUGELIAI;62703428759;Taip;6;0;1;7
17166;Vaduvos;DRUGELIAI;40872193458;Taip;0;1;0;1
17167;Vaduvos;DRUGELIAI;76644896831;Taip;0;5;0;5
17168;Vaduvos;DRUGELIAI;1241148402;Taip;0;0;1;1
17169;Vaduvos;DRUGELIAI;93406851755;Taip;5;0;0;5
17170;Vaduvos;DRUGELIAI;14297366745;Taip;0;2;0;2
17171;Vaduvos;DRUGELIAI;13888236429;Taip;5;0;0;5
17172;Vaduvos;DRUGELIAI;64074141491;Taip;0;15;0;15
17173;Vaduvos;DRUGELIAI;66359913774;Taip;0;10;1;11
17174;Vaduvos;DRUGELIAI;49738318631;Taip;2;1;0;3
17175;Vaduvos;DRUGELIAI;3722349868;Taip;0;5;0;5
17176;Vaduvos;DRUGELIAI;3174998523;Taip;5;0;0;5
17177;Vaduvos;DRUGELIAI;96892752634;Taip;5;0;0;5
17178;Vaduvos;DRUGELIAI;8802765960;Taip;0;1;0;1
17179;Vaduvos;RIEŠUTĖLIAI;9429028460;Taip;10;5;0;15
17180;Vaduvos;RIEŠUTĖLIAI;9072097216;Taip;10;1;0;11
17181;Vaduvos;RIEŠUTĖLIAI;9178907705;Taip;12;0;2;14
17182;Vaduvos;RIEŠUTĖLIAI;6210729584;Taip;9;6;0;15
17183;Vaduvos;RIEŠUTĖLIAI;4365144594;Taip;14;0;0;14
17184;Vaduvos;RIEŠUTĖLIAI;9606193112;Taip;11;0;0;11
17185;Vaduvos;RIEŠUTĖLIAI;9540008495;Taip;7;1;0;8
17186;Vaduvos;RIEŠUTĖLIAI;4177935331;Taip;9;1;0;10
17187;Vaduvos;RIEŠUTĖLIAI;9983148737;Taip;10;0;0;10
17188;Vaduvos;RIEŠUTĖLIAI;9062135043;Taip;6;6;0;12
17189;Vaduvos;RIEŠUTĖLIAI;1422507884;Taip;5;0;0;5
17190;Vaduvos;RIEŠUTĖLIAI;6810198013;Taip;11;0;0;11
17191;Vaduvos;RIEŠUTĖLIAI;4270137614;Taip;0;2;1;3
17192;Vaduvos;RIEŠUTĖLIAI;3682708061;Taip;9;2;0;11
17193;Vaduvos;RIEŠUTĖLIAI;7181151562;Taip;8;3;0;11
17194;Vaduvos;"1 klasė";96473212525;Taip;0;5;0;5
17195;Vaduvos;"1 klasė";75428164558;Taip;0;5;0;5
17196;Vaduvos;"1 klasė";13721939854;Taip;0;5;0;5
17197;Vaduvos;"1 klasė";35999855339;Taip;0;20;0;20
17198;Vaduvos;"1 klasė";62612515593;Taip;0;20;0;20
17199;Vaduvos;"1 klasė";61830127618;Taip;0;5;0;5
17200;Vaduvos;"1 klasė";4591744662;Taip;0;20;0;20
17201;Vaduvos;"1 klasė";9149523910;Taip;0;20;0;20
17202;Vaduvos;"1 klasė";76662161382;Taip;0;9;0;9
17203;Vaduvos;"1 klasė";18300713872;Taip;0;20;0;20
17204;Vaduvos;"1 klasė";1768173501;Taip;0;13;0;13
17205;Vaduvos;"1 klasė";768455288;Ne;0;5;0;5
17206;Vaduvos;"1 klasė";60531886576;Taip;0;8;0;8
17207;Vaduvos;"1 klasė";38462664426;Ne;0;7;0;7
17208;Vaduvos;"1 klasė";63286903462;Taip;0;14;0;14
17209;Vaduvos;"1 klasė";20841176336;Taip;0;9;0;9
17210;Vaduvos;"1 klasė";6049882391;Ne;0;6;0;6
17211;Vaduvos;"1 klasė";38013859931;Taip;0;5;0;5
17212;Vaduvos;"1 klasė";2004208381;Taip;0;5;0;5
17213;Vaduvos;"1 klasė";1821644443;Ne;0;15;0;15
17214;Vaduvos;"1 klasė";26934740147;Taip;0;20;0;20
17215;Vaduvos;"1 klasė";7172286009;Taip;0;7;0;7
17216;Vaduvos;"1 klasė";2029363844;Taip;0;20;0;20
17217;Vaduvos;"1 klasė";8188624118;Ne;0;20;0;20
17218;Vaduvos;"2 klasė";8594896510;Taip;0;5;0;5
17219;Vaduvos;"2 klasė";8009941823;Taip;0;11;0;11
17220;Vaduvos;"2 klasė";1060727236;Taip;0;17;0;17
17221;Vaduvos;"2 klasė";2423925079;Taip;0;20;0;20
17222;Vaduvos;"2 klasė";7410760461;Taip;0;20;0;20
17223;Vaduvos;"2 klasė";6487033699;Taip;0;7;0;7
17224;Vaduvos;"2 klasė";1671409152;Taip;0;6;0;6
17225;Vaduvos;"2 klasė";5072769647;Taip;0;5;0;5
17226;Vaduvos;"2 klasė";4637670260;Taip;0;5;0;5
17227;Vaduvos;"2 klasė";7236550835;Taip;0;9;0;9
17228;Vaduvos;"2 klasė";9372936408;Taip;0;5;0;5
17229;Vaduvos;"2 klasė";7243175751;Taip;0;7;0;7
17230;Vaduvos;"2 klasė";2482212122;Taip;0;5;0;5
17231;Vaduvos;"2 klasė";1982860223;Taip;0;5;0;5
17232;Vaduvos;"2 klasė";4447152355;Taip;0;5;0;5
17233;Vaduvos;"2 klasė";2584358725;Taip;0;6;0;6
17234;Vaduvos;"2 klasė";3325229112;Taip;0;5;0;5
17235;Vaduvos;"2 klasė";5531150399;Taip;0;20;0;20
17236;Vaduvos;"2 klasė";6980440631;Taip;0;7;0;7
17237;Vaduvos;"2 klasė";1091221509;Taip;0;7;0;7
17238;Vaduvos;"2 klasė";7614692200;Taip;0;5;0;5
17239;Vaduvos;"2 klasė";8216757208;Taip;0;20;0;20
17240;Vaduvos;"2 klasė";5459268700;Taip;0;20;0;20
17241;Vaduvos;"2 klasė";5593756016;Taip;0;7;0;7
17242;Vaduvos;"2 klasė";1642242442;Taip;0;5;0;5
17243;Vaduvos;"2 klasė";8928517238;Taip;0;5;0;5
17244;Vaduvos;"2 klasė";5099560123;Taip;0;9;0;9
17245;Vaduvos;"2 klasė";7899239147;Taip;0;10;0;10
17246;Vaduvos;"3 klasė";9644782309;Taip;0;5;0;5
17247;Vaduvos;"3 klasė";7719637673;Taip;0;10;0;10
17248;Vaduvos;"3 klasė";3784730324;Taip;0;5;0;5
17249;Vaduvos;"3 klasė";6964778383;Taip;0;5;0;5
17250;Vaduvos;"3 klasė";1841919654;Taip;0;9;0;9
17251;Vaduvos;"3 klasė";8241399720;Taip;0;5;0;5
17252;Vaduvos;"3 klasė";1086186628;Taip;0;16;0;16
17253;Vaduvos;"3 klasė";7838224919;Ne;0;7;0;7
17254;Vaduvos;"3 klasė";9494193819;Taip;0;20;0;20
17255;Vaduvos;"3 klasė";3755145838;Taip;0;20;0;20
17256;Vaduvos;"3 klasė";2149582337;Taip;0;10;0;10
17257;Vaduvos;"3 klasė";6896561963;Taip;0;7;0;7
17258;Vaduvos;"3 klasė";6748405557;Taip;0;5;0;5
17259;Vaduvos;"3 klasė";5523290081;Taip;0;5;0;5
17260;Vaduvos;"3 klasė";5786723345;Ne;0;5;0;5
17261;Vaduvos;"3 klasė";1730710569;Taip;0;7;0;7
17262;Vaduvos;"3 klasė";1461738157;Taip;0;8;0;8
17263;Vaduvos;"3 klasė";6744521293;Taip;0;5;0;5
17264;Vaduvos;"3 klasė";7786044620;Taip;0;20;0;20
17265;Vaduvos;"3 klasė";4347558872;Taip;0;7;0;7
17266;Vaduvos;"3 klasė";1954540001;Taip;0;8;0;8
17267;Vaduvos;"3 klasė";8801412437;Taip;0;6;0;6
17268;Vaduvos;"3 klasė";3583694770;Taip;0;5;0;5
17269;Vaduvos;"3 klasė";9271050464;Taip;0;5;0;5
17270;Vaduvos;"3 klasė";9441676636;Ne;0;5;0;5
17271;Vaduvos;"4 klasė";6654601642;Taip;0;11;0;11
17272;Vaduvos;"4 klasė";8237000050;Taip;0;6;0;6
17273;Vaduvos;"4 klasė";3145407318;Ne;0;5;0;5
17274;Vaduvos;"4 klasė";3333293097;Taip;0;5;0;5
17275;Vaduvos;"4 klasė";5309061557;Taip;0;14;0;14
17276;Vaduvos;"4 klasė";9693003688;Taip;0;7;0;7
17277;Vaduvos;"4 klasė";6371618427;Taip;0;9;0;9
17278;Vaduvos;"4 klasė";4965870077;Taip;0;20;0;20
17279;Vaduvos;"4 klasė";3290259977;Taip;0;5;0;5
17280;Vaduvos;"4 klasė";7585921384;Taip;0;6;0;6
17281;Vaduvos;"4 klasė";8971158534;Taip;0;11;0;11
17282;Vaduvos;"4 klasė";4629364623;Taip;0;7;0;7
17283;Vaduvos;"4 klasė";4106358850;Taip;0;7;0;7
17284;Vaduvos;"4 klasė";7163757633;Taip;0;5;0;5
17285;Vaduvos;"4 klasė";3710305066;Taip;0;5;0;5
17286;Vaduvos;"4 klasė";8401121977;Taip;0;9;0;9
17287;Vaduvos;"4 klasė";1682529973;Ne;0;20;0;20
17288;Vaduvos;"4 klasė";5094558878;Taip;0;6;0;6
17289;Vaduvos;"4 klasė";1741464526;Taip;0;13;0;13
17290;Vaduvos;"4 klasė";3868511136;Taip;0;5;0;5
17291;Vaduvos;"4 klasė";9224232442;Taip;0;6;0;6
17292;Vaduvos;"4 klasė";6583877755;Taip;0;20;0;20
17293;Vilkpėdės;BORUŽĖLĖS;79390794424;Taip;11;0;0;11
17294;Vilkpėdės;BORUŽĖLĖS;61899409496;Ne;0;3;0;3
17295;Vilkpėdės;BORUŽĖLĖS;64143309761;Taip;12;3;0;15
17296;Vilkpėdės;BORUŽĖLĖS;34554036711;Ne;0;6;0;6
17297;Vilkpėdės;BORUŽĖLĖS;64276583853;Taip;9;5;0;14
17298;Vilkpėdės;BORUŽĖLĖS;93369779426;Taip;5;0;0;5
17299;Vilkpėdės;BORUŽĖLĖS;18177210107;Taip;9;2;0;11
17300;Vilkpėdės;BORUŽĖLĖS;94327243660;Taip;0;5;0;5
17301;Vilkpėdės;BORUŽĖLĖS;25560685550;Taip;7;1;0;8
17302;Vilkpėdės;BORUŽĖLĖS;69023855545;Taip;5;1;0;6
17303;Vilkpėdės;BORUŽĖLĖS;72601980553;Taip;6;1;0;7
17304;Vilkpėdės;BORUŽĖLĖS;40684269684;Taip;6;4;0;10
17305;Vilkpėdės;BORUŽĖLĖS;18795042529;Taip;10;1;0;11
17306;Vilkpėdės;BORUŽĖLĖS;77110534762;Taip;0;6;0;6
17307;Vilkpėdės;BORUŽĖLĖS;18926013798;Taip;0;7;0;7
17308;Vilkpėdės;BORUŽĖLĖS;96241777448;Ne;0;2;0;2
17309;Vilkpėdės;BORUŽĖLĖS;40831777471;Taip;0;2;0;2
17310;Vilkpėdės;BORUŽĖLĖS;73735463059;Taip;0;20;0;20
17311;Vilkpėdės;BORUŽĖLĖS;12155790021;Taip;0;4;0;4
17312;Vilkpėdės;SKRUZDĖLIUKAI;32683398503;Taip;0;2;0;2
17313;Vilkpėdės;SKRUZDĖLIUKAI;41394645789;Taip;0;5;0;5
17314;Vilkpėdės;SKRUZDĖLIUKAI;61457409195;Taip;3;9;0;12
17315;Vilkpėdės;SKRUZDĖLIUKAI;90226911248;Taip;0;14;0;14
17316;Vilkpėdės;SKRUZDĖLIUKAI;73812058890;Taip;0;7;0;7
17317;Vilkpėdės;SKRUZDĖLIUKAI;18860888473;Taip;0;11;0;11
17318;Vilkpėdės;SKRUZDĖLIUKAI;19719432462;Taip;0;13;0;13
17319;Vilkpėdės;SKRUZDĖLIUKAI;93775558547;Taip;6;1;0;7
17320;Vilkpėdės;SKRUZDĖLIUKAI;90816091771;Taip;0;0;2;2
17321;Vilkpėdės;SKRUZDĖLIUKAI;26983231264;Taip;16;4;0;20
17322;Vilkpėdės;SKRUZDĖLIUKAI;89124218945;Taip;0;8;0;8
17323;Vilkpėdės;SKRUZDĖLIUKAI;21841574426;Taip;0;12;0;12
17324;Vilkpėdės;SKRUZDĖLIUKAI;89601406730;Taip;0;13;0;13
17325;Vilkpėdės;SKRUZDĖLIUKAI;81712437117;Taip;1;2;0;3
17326;Vilkpėdės;SKRUZDĖLIUKAI;60687258266;Taip;5;7;0;12
17327;Vilkpėdės;SKRUZDĖLIUKAI;95408044297;Taip;5;5;0;10
17328;Vilkpėdės;SKRUZDĖLIUKAI;58037049872;Taip;0;13;0;13
17329;Vilkpėdės;SKRUZDĖLIUKAI;63180329851;Ne;5;6;0;11
17330;Vilkpėdės;SKRUZDĖLIUKAI;3001209213;Taip;9;0;0;9
17331;Vilkpėdės;SKRUZDĖLIUKAI;95615604947;Taip;0;6;0;6
17332;Vilkpėdės;SKRUZDĖLIUKAI;25846393751;Taip;5;0;0;5
17333;Vilkpėdės;SKRUZDĖLIUKAI;33842357499;Taip;0;7;0;7
17334;Vilkpėdės;"1 klasė";61833757576;Taip;4;5;0;9
17335;Vilkpėdės;"1 klasė";88279045901;Taip;2;5;0;7
17336;Vilkpėdės;"1 klasė";78547386756;Taip;0;5;0;5
17337;Vilkpėdės;"1 klasė";66451097025;Taip;0;5;0;5
17338;Vilkpėdės;"1 klasė";45308906788;Taip;0;5;0;5
17339;Vilkpėdės;"1 klasė";66356984763;Taip;1;5;0;6
17340;Vilkpėdės;"1 klasė";31260025568;Taip;1;5;0;6
17341;Vilkpėdės;"1 klasė";1636921006;Ne;7;5;0;12
17342;Vilkpėdės;"1 klasė";51286525404;Taip;0;5;0;5
17343;Vilkpėdės;"1 klasė";90217345315;Taip;0;5;0;5
17344;Vilkpėdės;"1 klasė";37450374921;Taip;2;5;0;7
17345;Vilkpėdės;"1 klasė";25167535799;Taip;2;5;0;7
17346;Vilkpėdės;"1 klasė";79269485254;Taip;0;5;0;5
17347;Vilkpėdės;"1 klasė";1032216128;Taip;0;5;0;5
17348;Vilkpėdės;"1 klasė";49513181091;Taip;0;5;0;5
17349;Vilkpėdės;"1 klasė";64216245300;Taip;0;5;0;5
17350;Vilkpėdės;"1 klasė";64898472080;Taip;3;5;0;8
17351;Vilkpėdės;"1 klasė";2806307083;Taip;7;5;0;12
17352;Vilkpėdės;DRUGELIAI;2420271759;Taip;18;0;0;18
17353;Vilkpėdės;DRUGELIAI;9294350205;Taip;0;13;0;13
17354;Vilkpėdės;DRUGELIAI;2377248778;Taip;0;11;0;11
17355;Vilkpėdės;DRUGELIAI;7698759895;Taip;0;10;0;10
17356;Vilkpėdės;DRUGELIAI;3351309750;Taip;3;0;1;4
17357;Vilkpėdės;DRUGELIAI;1019057127;Taip;8;5;0;13
17358;Vilkpėdės;DRUGELIAI;1807884737;Taip;12;5;0;17
17359;Vilkpėdės;DRUGELIAI;9894466439;Taip;13;0;0;13
17360;Vilkpėdės;DRUGELIAI;6816745585;Taip;11;0;0;11
17361;Vilkpėdės;DRUGELIAI;9460356725;Taip;9;0;0;9
17362;Vilkpėdės;DRUGELIAI;8015392054;Taip;8;5;0;13
17363;Vilkpėdės;DRUGELIAI;8693750994;Taip;15;5;0;20
17364;Vilkpėdės;DRUGELIAI;2320350937;Taip;12;5;0;17
17365;Vilkpėdės;DRUGELIAI;7795186132;Taip;15;0;1;16
17366;Vilkpėdės;DRUGELIAI;6762306583;Taip;14;0;0;14
17367;Vilkpėdės;DRUGELIAI;9795696242;Taip;7;4;1;12
17368;Vilkpėdės;DRUGELIAI;8581661608;Taip;1;1;1;3
17369;Vilkpėdės;DRUGELIAI;6261547304;Taip;8;0;0;8
17370;Vilkpėdės;ŽIOGELIAI;2065010940;Taip;0;8;0;8
17371;Vilkpėdės;ŽIOGELIAI;1137529145;Taip;0;1;0;1
17372;Vilkpėdės;ŽIOGELIAI;13241568469;Taip;0;5;0;5
17373;Vilkpėdės;ŽIOGELIAI;1052719398;Taip;5;0;0;5
17374;Vilkpėdės;ŽIOGELIAI;1145968615;Taip;5;1;0;6
17375;Vilkpėdės;ŽIOGELIAI;1598018406;Taip;0;1;0;1
17376;Vilkpėdės;ŽIOGELIAI;55747681017;Taip;5;2;2;9
17377;Vilkpėdės;ŽIOGELIAI;1136036746;Taip;8;6;0;14
17378;Vilkpėdės;ŽIOGELIAI;51976067616;Taip;10;1;3;14
17379;Vilkpėdės;ŽIOGELIAI;73470824566;Taip;13;0;0;13
17380;Vilkpėdės;ŽIOGELIAI;5912919726;Taip;5;0;0;5
17381;Vilkpėdės;ŽIOGELIAI;40385792431;Taip;3;3;0;6
17382;Vilkpėdės;ŽIOGELIAI;72227817278;Taip;7;5;0;12
17383;Vilkpėdės;ŽIOGELIAI;1795879331;Taip;10;0;0;10
17384;Vilkpėdės;ŽIOGELIAI;1042000830;Taip;0;0;2;2
17385;Vilkpėdės;ŽIOGELIAI;72899151328;Taip;0;3;0;3
17386;Vilkpėdės;ŽIOGELIAI;1527272055;Ne;5;5;0;10
17387;Vilkpėdės;ŽIOGELIAI;1384224802;Taip;0;10;0;10
17388;Vilkpėdės;ŽIOGELIAI;25008201566;Taip;0;5;1;6
17389;Vilkpėdės;ŽIOGELIAI;9393571483;Taip;0;4;6;10
17390;Vilkpėdės;BITUTĖS;9605399822;Taip;3;5;0;8
17391;Vilkpėdės;BITUTĖS;9589862809;Taip;0;3;0;3
17392;Vilkpėdės;BITUTĖS;7875898177;Taip;15;0;0;15
17393;Vilkpėdės;BITUTĖS;3935245964;Taip;2;6;0;8
17394;Vilkpėdės;BITUTĖS;9867411687;Taip;10;0;0;10
17395;Vilkpėdės;BITUTĖS;4735164204;Taip;5;3;0;8
17396;Vilkpėdės;BITUTĖS;46561435465;Taip;7;7;0;14
17397;Vilkpėdės;BITUTĖS;48059844727;Taip;0;20;0;20
17398;Vilkpėdės;BITUTĖS;1195392132;Taip;10;0;0;10
17399;Vilkpėdės;BITUTĖS;7634355147;Taip;0;2;0;2
17400;Vilkpėdės;BITUTĖS;4392760215;Taip;10;4;0;14
17401;Vilkpėdės;BITUTĖS;2955411131;Taip;5;2;0;7
17402;Vilkpėdės;BITUTĖS;2736368118;Taip;1;4;0;5
17403;Vilkpėdės;BITUTĖS;4515945951;Taip;0;3;0;3
17404;Vilkpėdės;BITUTĖS;2900581406;Taip;3;1;0;4
17405;Vilkpėdės;BITUTĖS;7527929277;Taip;2;2;0;4
17406;Vilkpėdės;BITUTĖS;8865545376;Taip;1;8;0;9
17407;Vilkpėdės;BITUTĖS;4276158771;Taip;5;0;0;5
17408;Vilkpėdės;BITUTĖS;7889480219;Taip;11;2;0;13
17409;Vilkpėdės;BITUTĖS;8128254701;Taip;6;6;0;12
17410;Vilkpėdės;"2 klasė";4562930821;Ne;1;5;0;6
17411;Vilkpėdės;"2 klasė";4450490805;Ne;0;5;0;5
17412;Vilkpėdės;"2 klasė";5753361387;Ne;0;5;0;5
17413;Vilkpėdės;"2 klasė";3330174377;Ne;0;5;0;5
17414;Vilkpėdės;"2 klasė";7678586010;Ne;0;5;0;5
17415;Vilkpėdės;"2 klasė";9422266523;Ne;0;5;0;5
17416;Vilkpėdės;"2 klasė";7567054902;Ne;2;5;0;7
17417;Vilkpėdės;"2 klasė";1894949069;Ne;0;6;0;6
17418;Vilkpėdės;"2 klasė";6750171948;Ne;1;5;0;6
17419;Vilkpėdės;"2 klasė";2877690064;Ne;0;5;0;5
17420;Vilkpėdės;"2 klasė";4975532783;Ne;3;5;0;8
17421;Vilkpėdės;"2 klasė";3096541013;Ne;0;5;0;5
17422;Vilkpėdės;"2 klasė";4467711387;Ne;0;5;0;5
17423;Vilkpėdės;"2 klasė";6334059519;Ne;0;5;0;5
17424;Vilkpėdės;"3 klasė";1827316635;Ne;0;5;0;5
17425;Vilkpėdės;"3 klasė";5788552120;Ne;1;5;0;6
17426;Vilkpėdės;"3 klasė";3972086732;Ne;4;5;0;9
17427;Vilkpėdės;"3 klasė";3008839195;Ne;0;5;0;5
17428;Vilkpėdės;"3 klasė";2097704371;Ne;0;5;0;5
17429;Vilkpėdės;"3 klasė";5948799757;Ne;1;5;0;6
17430;Vilkpėdės;"3 klasė";7851213782;Ne;1;5;0;6
17431;Vilkpėdės;"3 klasė";8214989068;Ne;0;5;0;5
17432;Vilkpėdės;"3 klasė";6408620430;Ne;6;5;0;11
17433;Vilkpėdės;"3 klasė";2407908295;Ne;4;5;0;9
17434;Vilkpėdės;"3 klasė";6786266832;Ne;5;5;0;10
17435;Vilkpėdės;"4 klasė";5691976624;Ne;0;5;0;5
17436;Vilkpėdės;"4 klasė";5064616447;Ne;1;5;0;6
17437;Vilkpėdės;"4 klasė";5959800100;Ne;0;6;0;6
17438;Vilkpėdės;"4 klasė";9264492438;Ne;4;5;0;9
17439;Vilkpėdės;"4 klasė";4656816734;Ne;2;5;0;7
17440;Vilkpėdės;"4 klasė";3688858757;Ne;1;6;0;7
17441;Vilkpėdės;"4 klasė";5115595730;Ne;0;5;0;5
17442;Vilkpėdės;"4 klasė";5877781210;Ne;4;5;0;9
17443;Vilkpėdės;"4 klasė";6917717899;Ne;0;6;0;6
17444;Vilkpėdės;"4 klasė";4672603333;Ne;1;5;0;6
17445;Vilkpėdės;"4 klasė";9436443664;Ne;6;5;0;11
17446;Vilkpėdės;"4 klasė";5522788819;Ne;0;5;0;5
17447;Vilkpėdės;"4 klasė";1115530668;Ne;0;5;0;5
17448;Vilkpėdės;"4 klasė";6851966570;Ne;0;5;0;5
17449;Vilkpėdės;"4 klasė";5191937870;Ne;0;5;0;5
17450;Vilkpėdės;"4 klasė";9953554437;Taip;9;5;0;14
17451;Žiburėlis;Nykštukai;45509849089;Taip;0;5;0;5
17452;Žiburėlis;Nykštukai;32837087738;Taip;0;5;0;5
17453;Žiburėlis;Nykštukai;57892276898;Taip;7;6;1;14
17454;Žiburėlis;Nykštukai;87417486808;Taip;3;5;0;8
17455;Žiburėlis;Nykštukai;82679341920;Taip;5;0;1;6
17456;Žiburėlis;Nykštukai;73054546792;Taip;8;8;0;16
17457;Žiburėlis;Nykštukai;98670272543;Taip;0;8;0;8
17458;Žiburėlis;Nykštukai;64418469679;Taip;0;7;0;7
17459;Žiburėlis;Nykštukai;61148040564;Taip;3;1;2;6
17460;Žiburėlis;Nykštukai;77674964341;Taip;0;6;0;6
17461;Žiburėlis;Nykštukai;16215414453;Taip;0;5;0;5
17462;Žiburėlis;Nykštukai;16721946185;Taip;0;6;0;6
17463;Žiburėlis;Nykštukai;58253869146;Taip;0;8;0;8
17464;Žiburėlis;Nykštukai;49081936325;Taip;0;9;0;9
17465;Žiburėlis;Nykštukai;25826760783;Taip;12;1;0;13
17466;Žiburėlis;Nykštukai;78861342608;Taip;0;1;0;1
17467;Žiburėlis;Nykštukai;50484332477;Taip;0;5;0;5
17468;Žiburėlis;Nykštukai;90296810303;Taip;6;0;0;6
17469;Žiburėlis;Nykštukai;13256396372;Taip;0;6;0;6
17470;Žiburėlis;Nykštukai;78896331135;Taip;6;0;0;6
17471;Žiburėlis;Nykštukai;68423991252;Taip;0;14;0;14
17472;Žiburėlis;Nykštukai;7135920347;Taip;0;8;0;8
17473;Žiburėlis;Nykštukai;1133294157;Taip;5;0;0;5
17474;Žiburėlis;Nykštukai;25079486133;Taip;5;1;0;6
17475;Žiburėlis;Nykštukai;9918037209;Taip;0;2;2;4
17476;Žiburėlis;"Žiniukai ";18125169377;Taip;3;4;0;7
17477;Žiburėlis;"Žiniukai ";29552486526;Taip;0;20;0;20
17478;Žiburėlis;"Žiniukai ";92036821482;Taip;4;5;0;9
17479;Žiburėlis;"Žiniukai ";70925677727;Taip;15;5;0;20
17480;Žiburėlis;"Žiniukai ";1858285649;Taip;0;6;0;6
17481;Žiburėlis;"Žiniukai ";41774939326;Taip;0;6;0;6
17482;Žiburėlis;"Žiniukai ";5412445634;Taip;0;5;1;6
17483;Žiburėlis;"Žiniukai ";1673061718;Taip;4;5;0;9
17484;Žiburėlis;"Žiniukai ";4454602197;Taip;4;0;0;4
17485;Žiburėlis;"Žiniukai ";6517292491;Taip;3;11;0;14
17486;Žiburėlis;"Žiniukai ";70987307796;Taip;0;5;0;5
17487;Žiburėlis;"Žiniukai ";5778346952;Taip;0;5;1;6
17488;Žiburėlis;"Žiniukai ";1770523114;Ne;0;1;0;1
17489;Žiburėlis;"Žiniukai ";90967310390;Taip;0;3;0;3
17490;Žiburėlis;"Žiniukai ";19010380383;Taip;5;6;0;11
17491;Žiburėlis;"Smalsiukai ";5914668910;Ne;2;5;0;7
17492;Žiburėlis;"Smalsiukai ";1673873271;Ne;0;16;0;16
17493;Žiburėlis;"Smalsiukai ";3128936681;Ne;20;0;0;20
17494;Žiburėlis;"Smalsiukai ";31082738591;Taip;15;5;0;20
17495;Žiburėlis;"Smalsiukai ";78850854161;Taip;0;5;1;6
17496;Žiburėlis;"Smalsiukai ";95216886081;Taip;5;7;0;12
17497;Žiburėlis;"Smalsiukai ";37375035477;Taip;0;1;0;1
17498;Žiburėlis;"Smalsiukai ";87512265546;Taip;0;5;0;5
17499;Žiburėlis;"Smalsiukai ";69181720507;Taip;0;5;0;5
17500;Žiburėlis;"Smalsiukai ";54487369856;Taip;0;7;0;7
17501;Žiburėlis;"Smalsiukai ";81892440397;Taip;0;1;0;1
17502;Žiburėlis;"Smalsiukai ";89219215887;Taip;0;1;0;1
17503;Žiburėlis;"Smalsiukai ";1483522393;Taip;0;5;0;5
17504;Žiburėlis;"Smalsiukai ";93584914250;Taip;0;2;0;2
17505;Žiburėlis;"Smalsiukai ";58094756644;Taip;0;6;0;6
17506;Žiburėlis;"Giliukai ";52216192635;Taip;10;0;0;10
17507;Žiburėlis;"Giliukai ";4355778076;Taip;5;0;1;6
17508;Žiburėlis;"Giliukai ";67168630669;Taip;4;3;0;7
17509;Žiburėlis;"Giliukai ";3867540155;Taip;0;17;0;17
17510;Žiburėlis;"Giliukai ";7578655857;Taip;0;11;0;11
17511;Žiburėlis;"Giliukai ";75538036055;Taip;0;1;0;1
17512;Žiburėlis;"Giliukai ";9253393819;Taip;5;1;0;6
17513;Žiburėlis;"Giliukai ";8677998615;Taip;5;0;0;5
17514;Žiburėlis;"Giliukai ";2796489509;Taip;3;5;0;8
17515;Žiburėlis;"Giliukai ";18739941845;Taip;7;5;0;12
17516;Žiburėlis;"Giliukai ";24639355056;Taip;0;4;0;4
17517;Žiburėlis;"Giliukai ";6519139977;Taip;0;13;0;13
17518;Žiburėlis;"Giliukai ";7861704875;Taip;7;4;0;11
17519;Žiburėlis;"Giliukai ";34873231652;Taip;4;6;0;10
17520;Žiburėlis;"Giliukai ";1125662904;Taip;20;0;0;20
17521;Žiburėlis;"Giliukai ";8531121002;Taip;20;0;0;20
17522;Žiburėlis;"Giliukai ";28985997205;Taip;16;0;0;16
17523;Žiburėlis;"1 klasė";1551527192;Ne;0;5;0;5
17524;Žiburėlis;"1 klasė";9177048702;Taip;0;20;0;20
17525;Žiburėlis;"1 klasė";40167464240;Taip;0;5;0;5
17526;Žiburėlis;"1 klasė";91489560481;Taip;6;5;0;11
17527;Žiburėlis;"1 klasė";83887875309;Taip;2;5;0;7
17528;Žiburėlis;"1 klasė";50386629614;Taip;0;5;0;5
17529;Žiburėlis;"1 klasė";78965453247;Ne;0;5;0;5
17530;Žiburėlis;"1 klasė";29289711001;Ne;0;5;0;5
17531;Žiburėlis;"1 klasė";67880120356;Taip;0;5;0;5
17532;Žiburėlis;"1 klasė";97596344387;Taip;4;5;0;9
17533;Žiburėlis;"1 klasė";75779767358;Taip;0;5;0;5
17534;Žiburėlis;"1 klasė";19924188057;Taip;0;5;0;5
17535;Žiburėlis;"1 klasė";56929631997;Taip;0;5;0;5
17536;Žiburėlis;"1 klasė";10039457828;Taip;0;5;0;5
17537;Žiburėlis;"1 klasė";33877368082;Taip;0;5;0;5
17538;Žiburėlis;"1 klasė";1266445858;Taip;0;5;0;5
17539;Žiburėlis;"1 klasė";23334642950;Taip;0;5;0;5
17540;Žiburėlis;"1 klasė";86214644730;Taip;0;5;0;5
17541;Žiburėlis;"1 klasė";91397954329;Taip;7;5;0;12
17542;Žiburėlis;"1 klasė";16657264022;Taip;0;5;0;5
17543;Žiburėlis;"1 klasė";3462265950;Taip;0;20;0;20
17544;Žiburėlis;"1 klasė";4909760547;Taip;0;5;0;5
17545;Žiburėlis;Meškiukai;7070952018;Taip;0;5;0;5
17546;Žiburėlis;Meškiukai;874653320;Taip;0;1;0;1
17547;Žiburėlis;Meškiukai;38096163093;Taip;3;0;0;3
17548;Žiburėlis;Meškiukai;96004573835;Taip;0;9;0;9
17549;Žiburėlis;Meškiukai;549348368;Taip;0;2;0;2
17550;Žiburėlis;Meškiukai;2270893326;Taip;0;3;0;3
17551;Žiburėlis;Meškiukai;1728059994;Taip;1;0;0;1
17552;Žiburėlis;Meškiukai;1523632106;Taip;15;0;0;15
17553;Žiburėlis;Meškiukai;9069606713;Taip;0;6;0;6
17554;Žiburėlis;Meškiukai;46449810717;Taip;0;1;1;2
17555;Žiburėlis;Meškiukai;3678560815;Taip;10;0;0;10
17556;Žiburėlis;Meškiukai;57749440744;Taip;10;3;0;13
17557;Žiburėlis;Meškiukai;1614403409;Taip;0;8;0;8
17558;Žiburėlis;Meškiukai;808556747;Taip;0;17;0;17
17559;Žiburėlis;Meškiukai;43206636255;Taip;2;1;0;3
17560;Žiburėlis;Meškiukai;60150682872;Taip;0;4;0;4
17561;Žiburėlis;Meškiukai;50869669391;Taip;0;12;0;12
17562;Žiburėlis;Meškiukai;31669188580;Taip;0;1;0;1
17563;Žiburėlis;Meškiukai;30337030701;Taip;5;1;0;6
17564;Žiburėlis;Meškiukai;1612968712;Taip;0;5;0;5
17565;Žiburėlis;Meškiukai;5495813195;Taip;5;5;0;10
17566;Žiburėlis;Meškiukai;42442737710;Taip;12;0;0;12
17567;Žiburėlis;Viščiukai;7402647048;Taip;13;2;0;15
17568;Žiburėlis;Viščiukai;8215816053;Taip;0;6;0;6
17569;Žiburėlis;Viščiukai;9352485231;Taip;2;0;0;2
17570;Žiburėlis;Viščiukai;4710995351;Taip;3;6;0;9
17571;Žiburėlis;Viščiukai;3646988912;Taip;11;0;0;11
17572;Žiburėlis;Viščiukai;7633450988;Taip;6;0;0;6
17573;Žiburėlis;Viščiukai;2292895729;Taip;5;1;0;6
17574;Žiburėlis;Viščiukai;1411830789;Taip;7;6;0;13
17575;Žiburėlis;Viščiukai;7273838695;Taip;0;10;0;10
17576;Žiburėlis;Viščiukai;5098955523;Taip;0;20;0;20
17577;Žiburėlis;Viščiukai;6250610187;Taip;5;9;0;14
17578;Žiburėlis;Viščiukai;5629404179;Taip;20;0;0;20
17579;Žiburėlis;Viščiukai;9806454408;Taip;0;6;0;6
17580;Žiburėlis;Viščiukai;1764592065;Taip;0;3;0;3
17581;Žiburėlis;Viščiukai;8686565770;Taip;5;5;0;10
17582;Žiburėlis;Viščiukai;6696156248;Taip;10;5;0;15
17583;Žiburėlis;Viščiukai;3938379566;Taip;20;0;0;20
17584;Žiburėlis;Viščiukai;5556807335;Taip;8;0;0;8
17585;Žiburėlis;"Drambliukai ";8902837168;Taip;20;0;0;20
17586;Žiburėlis;"Drambliukai ";7862546963;Taip;20;0;0;20
17587;Žiburėlis;"Drambliukai ";8535429783;Taip;6;0;0;6
17588;Žiburėlis;"Drambliukai ";9670396828;Taip;20;0;0;20
17589;Žiburėlis;"Drambliukai ";1720078356;Taip;15;5;0;20
17590;Žiburėlis;"Drambliukai ";5517458323;Taip;10;0;0;10
17591;Žiburėlis;"Drambliukai ";7424129974;Taip;4;3;0;7
17592;Žiburėlis;"Drambliukai ";5816890413;Taip;10;0;0;10
17593;Žiburėlis;"Drambliukai ";9336617879;Taip;4;2;0;6
17594;Žiburėlis;"Drambliukai ";2928528630;Taip;0;6;0;6
17595;Žiburėlis;"Drambliukai ";8109335587;Taip;0;2;0;2
17596;Žiburėlis;"Drambliukai ";4187381976;Taip;15;5;0;20
17597;Žiburėlis;"Drambliukai ";2624326930;Taip;20;0;0;20
17598;Žiburėlis;"Drambliukai ";6300247811;Taip;15;0;0;15
17599;Žiburėlis;"Drambliukai ";3033049328;Taip;5;6;0;11
17600;Žiburėlis;"Drambliukai ";3687703187;Taip;5;1;0;6
17601;Žiburėlis;"Drambliukai ";1876645582;Taip;0;1;0;1
17602;Žiburėlis;"Drambliukai ";5006361324;Taip;6;5;0;11
17603;Žiburėlis;"Drambliukai ";5303511810;Taip;10;0;0;10
17604;Žiburėlis;"Drambliukai ";3262856058;Taip;20;0;0;20
17605;Žiburėlis;"Drambliukai ";7211961512;Taip;6;7;0;13
17606;Žiburėlis;"2 klasė";5587135070;Ne;2;5;0;7
17607;Žiburėlis;"2 klasė";5154752431;Ne;0;5;0;5
17608;Žiburėlis;"2 klasė";2980656238;Ne;0;5;0;5
17609;Žiburėlis;"2 klasė";9444201589;Ne;3;5;0;8
17610;Žiburėlis;"2 klasė";4955196776;Ne;2;5;0;7
17611;Žiburėlis;"2 klasė";7328501055;Ne;0;5;0;5
17612;Žiburėlis;"2 klasė";6555937866;Ne;0;5;0;5
17613;Žiburėlis;"2 klasė";6532799193;Ne;0;5;0;5
17614;Žiburėlis;"2 klasė";5801758386;Ne;0;5;0;5
17615;Žiburėlis;"2 klasė";8108287017;Ne;5;5;1;11
17616;Žiburėlis;"2 klasė";9986286327;Ne;0;5;0;5
17617;Žiburėlis;"2 klasė";8967516850;Ne;5;5;0;10
17618;Žiburėlis;"2 klasė";5730454385;Ne;3;5;0;8
17619;Žiburėlis;"2 klasė";7420310542;Ne;5;5;0;10
17620;Žiburėlis;"2 klasė";9030168070;Ne;3;5;0;8
17621;Žiburėlis;"2 klasė";1040139766;Ne;3;5;0;8
17622;Žiburėlis;"2 klasė";2895056046;Ne;9;5;0;14
17623;Žiburėlis;"2 klasė";7971654401;Ne;0;20;0;20
17624;Žiburėlis;"2 klasė";7244452816;Ne;0;5;0;5
17625;Žiburėlis;"2 klasė";5120367724;Ne;7;5;0;12
17626;Žiburėlis;"3 klasė";8539444386;Ne;0;5;0;5
17627;Žiburėlis;"3 klasė";2145461317;Ne;2;5;0;7
17628;Žiburėlis;"3 klasė";9676316394;Ne;2;5;0;7
17629;Žiburėlis;"3 klasė";4612471196;Ne;0;5;0;5
17630;Žiburėlis;"3 klasė";8942909201;Ne;0;5;0;5
17631;Žiburėlis;"3 klasė";6088424692;Ne;0;20;0;20
17632;Žiburėlis;"3 klasė";3493549126;Ne;0;20;0;20
17633;Žiburėlis;"3 klasė";4444164248;Ne;0;5;0;5
17634;Žiburėlis;"3 klasė";1769155142;Ne;0;5;0;5
17635;Žiburėlis;"3 klasė";8755335337;Ne;0;5;0;5
17636;Žiburėlis;"3 klasė";7451312098;Ne;5;5;0;10
17637;Žiburėlis;"3 klasė";7239532785;Ne;0;5;0;5
17638;Žiburėlis;"3 klasė";5999075406;Ne;0;20;0;20
17639;Žiburėlis;"3 klasė";6548933505;Ne;0;5;0;5
17640;Žiburėlis;"3 klasė";9803636658;Ne;0;20;0;20
17641;Žiburėlis;"3 klasė";6992801094;Ne;0;5;0;5
17642;Žiburėlis;"3 klasė";3931688013;Ne;2;5;0;7
17643;Žiburėlis;"4 klasė";7864773283;Ne;0;5;0;5
17644;Žiburėlis;"4 klasė";5224982445;Ne;0;5;0;5
17645;Žiburėlis;"4 klasė";9535229323;Ne;0;5;0;5
17646;Žiburėlis;"4 klasė";6872226065;Ne;0;5;0;5
17647;Žiburėlis;"4 klasė";9952387998;Ne;0;5;0;5
17648;Žiburėlis;"4 klasė";8525158050;Ne;0;5;0;5
17649;Žiburėlis;"4 klasė";6800376566;Ne;4;5;0;9
17650;Žiburėlis;"4 klasė";4261473166;Ne;0;5;0;5
17651;Žiburėlis;"4 klasė";4768463997;Ne;0;5;0;5
17652;Žiburėlis;"4 klasė";5990820199;Ne;0;5;0;5
17653;Žiburėlis;"4 klasė";2645591088;Ne;0;5;0;5
17654;Žiburėlis;"4 klasė";6362934592;Ne;0;24;0;24
17655;Žiburėlis;"4 klasė";8758526732;Ne;0;24;0;24
17656;Žiburėlis;"4 klasė";2638686151;Ne;4;5;0;9
17657;Žiburėlis;"4 klasė";8496410382;Ne;0;5;0;5
17658;Žiburėlis;"4 klasė";4067505776;Ne;0;5;0;5
17659;Žiburėlis;"4 klasė";6388681440;Ne;0;5;0;5
17660;Žiburėlis;"4 klasė";5014047026;Ne;8;5;0;13
17661;Žiburėlis;"4 klasė";4827287214;Ne;2;5;0;7
17662;Žiburėlis;"4 klasė";5943397400;Ne;0;5;0;5
17663;Žiburėlis;"4 klasė";8711998371;Ne;0;5;0;5
17664;Žiburėlis;"4 klasė";2354284014;Ne;0;24;0;24
17665;Justinukas;SMALSUČIŲ;7005815238;Taip;16;0;0;16
17666;Justinukas;SMALSUČIŲ;13170636069;Taip;0;13;3;16
17667;Justinukas;SMALSUČIŲ;3118698712;Taip;0;7;0;7
17668;Justinukas;SMALSUČIŲ;3312575449;Taip;5;1;0;6
17669;Justinukas;SMALSUČIŲ;1773690115;Taip;16;0;0;16
17670;Justinukas;SMALSUČIŲ;46705419124;Taip;0;11;0;11
17671;Justinukas;SMALSUČIŲ;49343952061;Taip;0;6;0;6
17672;Justinukas;SMALSUČIŲ;8741735734;Taip;20;0;0;20
17673;Justinukas;SMALSUČIŲ;2160609412;Taip;0;2;0;2
17674;Justinukas;SMALSUČIŲ;8529082669;Taip;6;3;0;9
17675;Justinukas;SMALSUČIŲ;7678062264;Taip;10;6;0;16
17676;Justinukas;SMALSUČIŲ;1830060403;Taip;4;5;0;9
17677;Justinukas;SMALSUČIŲ;67366895767;Taip;5;5;0;10
17678;Justinukas;SMALSUČIŲ;9349373645;Taip;0;1;0;1
17679;Justinukas;SMALSUČIŲ;8848775795;Taip;0;3;0;3
17680;Justinukas;SMALSUČIŲ;3062444365;Taip;10;1;0;11
17681;Justinukas;SMALSUČIŲ;93600065957;Taip;0;5;0;5
17682;Justinukas;SMALSUČIŲ;2317566323;Taip;8;0;0;8
17683;Justinukas;SMALSUČIŲ;1704933971;Taip;10;0;0;10
17684;Justinukas;SVAJOKLIŲ;9822696769;Taip;0;20;0;20
17685;Justinukas;SVAJOKLIŲ;34905919221;Taip;0;1;0;1
17686;Justinukas;SVAJOKLIŲ;1627717901;Taip;0;1;0;1
17687;Justinukas;SVAJOKLIŲ;6234625191;Taip;10;3;0;13
17688;Justinukas;SVAJOKLIŲ;752609119;Taip;0;4;0;4
17689;Justinukas;SVAJOKLIŲ;5225263863;Taip;0;5;0;5
17690;Justinukas;SVAJOKLIŲ;3863971540;Taip;8;4;0;12
17691;Justinukas;SVAJOKLIŲ;43527855441;Taip;8;5;0;13
17692;Justinukas;SVAJOKLIŲ;16029286933;Taip;4;4;0;8
17693;Justinukas;SVAJOKLIŲ;8971898312;Taip;3;16;0;19
17694;Justinukas;SVAJOKLIŲ;48101258124;Taip;0;6;0;6
17695;Justinukas;SVAJOKLIŲ;1216138998;Taip;9;3;0;12
17696;Justinukas;SVAJOKLIŲ;7316804839;Taip;8;1;0;9
17697;Justinukas;SVAJOKLIŲ;3790209561;Taip;15;3;0;18
17698;Justinukas;SVAJOKLIŲ;9558483512;Taip;0;6;0;6
17699;Justinukas;SVAJOKLIŲ;1814943669;Taip;7;10;0;17
17700;Justinukas;SVAJOKLIŲ;37288931495;Taip;10;1;0;11
17701;Justinukas;SVAJOKLIŲ;8636869322;Taip;17;0;0;17
17702;Justinukas;SVAJOKLIŲ;6766493175;Taip;4;2;0;6
17703;Justinukas;SVAJOKLIŲ;5494500249;Taip;4;2;0;6
17704;Justinukas;SVAJOKLIŲ;6816901962;Taip;3;6;0;9
17705;Justinukas;SVAJOKLIŲ;3657642693;Taip;7;4;0;11
17706;Justinukas;"SAULĖS ZUIKIŲ";1550323727;Taip;0;2;4;6
17707;Justinukas;"SAULĖS ZUIKIŲ";1801800210;Taip;0;5;0;5
17708;Justinukas;"SAULĖS ZUIKIŲ";40999006978;Taip;0;2;0;2
17709;Justinukas;"SAULĖS ZUIKIŲ";29875250126;Taip;0;0;2;2
17710;Justinukas;"SAULĖS ZUIKIŲ";3813820356;Taip;0;17;0;17
17711;Justinukas;"SAULĖS ZUIKIŲ";3215259838;Taip;20;0;0;20
17712;Justinukas;"SAULĖS ZUIKIŲ";66240994100;Taip;0;4;0;4
17713;Justinukas;"SAULĖS ZUIKIŲ";8350429513;Taip;0;5;0;5
17714;Justinukas;"SAULĖS ZUIKIŲ";2532510817;Taip;0;13;0;13
17715;Justinukas;"SAULĖS ZUIKIŲ";52253951149;Taip;0;10;0;10
17716;Justinukas;"SAULĖS ZUIKIŲ";9411813711;Taip;0;2;0;2
17717;Justinukas;"SAULĖS ZUIKIŲ";4887565054;Taip;5;7;0;12
17718;Justinukas;"SAULĖS ZUIKIŲ";1806484271;Taip;11;0;0;11
17719;Justinukas;"SAULĖS ZUIKIŲ";8716574742;Taip;11;0;0;11
17720;Justinukas;"SAULĖS ZUIKIŲ";78270625975;Taip;11;5;0;16
17721;Justinukas;"SAULĖS ZUIKIŲ";5215250778;Taip;10;0;0;10
17722;Justinukas;"SAULĖS ZUIKIŲ";2018007566;Taip;3;5;0;8
17723;Justinukas;"SAULĖS ZUIKIŲ";1590855655;Taip;0;0;1;1
17724;Justinukas;"SAULĖS ZUIKIŲ";49880907488;Taip;0;1;0;1
17725;Justinukas;"SAULĖS ZUIKIŲ";76257661228;Taip;0;1;0;1
17726;Justinukas;"SAULĖS ZUIKIŲ";1967313365;Taip;0;0;1;1
17727;Justinukas;"SAULĖS ZUIKIŲ";56402748009;Taip;0;2;1;3
17728;Justinukas;PABIRUČIŲ;1996480143;Taip;0;3;0;3
17729;Justinukas;PABIRUČIŲ;76659578448;Taip;0;7;2;9
17730;Justinukas;PABIRUČIŲ;1655237708;Taip;0;5;0;5
17731;Justinukas;PABIRUČIŲ;1206482166;Taip;14;2;0;16
17732;Justinukas;PABIRUČIŲ;20865224818;Taip;10;0;0;10
17733;Justinukas;PABIRUČIŲ;37019368317;Taip;5;0;0;5
17734;Justinukas;PABIRUČIŲ;53571863888;Ne;0;1;0;1
17735;Justinukas;PABIRUČIŲ;23762150256;Taip;0;1;0;1
17736;Justinukas;PABIRUČIŲ;28457909446;Ne;0;12;0;12
17737;Justinukas;PABIRUČIŲ;70334519732;Taip;15;0;0;15
17738;Justinukas;PABIRUČIŲ;94562009887;Taip;0;6;0;6
17739;Justinukas;PABIRUČIŲ;31817312555;Taip;0;2;2;4
17740;Justinukas;PABIRUČIŲ;16910061636;Taip;0;6;0;6
17741;Justinukas;PABIRUČIŲ;46373287636;Taip;10;0;0;10
17742;Justinukas;PABIRUČIŲ;72517122863;Taip;0;15;0;15
17743;Justinukas;PABIRUČIŲ;90159009940;Taip;5;1;0;6
17744;Justinukas;PABIRUČIŲ;42486181827;Taip;0;1;0;1
17745;Justinukas;PABIRUČIŲ;45490599266;Taip;0;7;0;7
17746;Justinukas;PABIRUČIŲ;10573989701;Taip;0;1;0;1
17747;Justinukas;PABIRUČIŲ;41914970891;Taip;10;1;0;11
17748;Justinukas;PABIRUČIŲ;1557388485;Taip;1;2;0;3
17749;Justinukas;VYTURIUKŲ;1319540676;Taip;0;1;0;1
17750;Justinukas;VYTURIUKŲ;1585956968;Taip;10;3;0;13
17751;Justinukas;VYTURIUKŲ;4056697803;Taip;10;0;0;10
17752;Justinukas;VYTURIUKŲ;1181972027;Taip;6;8;0;14
17753;Justinukas;VYTURIUKŲ;59176678396;Taip;0;5;0;5
17754;Justinukas;VYTURIUKŲ;1598234416;Taip;0;5;0;5
17755;Justinukas;VYTURIUKŲ;1511044883;Taip;9;4;0;13
17756;Justinukas;VYTURIUKŲ;1555183700;Taip;0;5;0;5
17757;Justinukas;VYTURIUKŲ;1785794727;Taip;8;5;0;13
17758;Justinukas;VYTURIUKŲ;28095047700;Taip;10;0;0;10
17759;Justinukas;VYTURIUKŲ;91620507403;Taip;10;1;1;12
17760;Justinukas;VYTURIUKŲ;26842499755;Taip;0;7;1;8
17761;Justinukas;VYTURIUKŲ;35192728896;Taip;3;2;0;5
17762;Justinukas;VYTURIUKŲ;1005872691;Taip;10;1;0;11
17763;Justinukas;VYTURIUKŲ;13774489893;Taip;20;0;0;20
17764;Justinukas;VYTURIUKŲ;2002649360;Taip;0;6;0;6
17765;Justinukas;VYTURIUKŲ;30823793919;Taip;5;0;0;5
17766;Justinukas;VYTURIUKŲ;1956705813;Taip;8;0;0;8
17767;Justinukas;VYTURIUKŲ;89330918024;Taip;10;0;0;10
17768;Justinukas;VYTURIUKŲ;49578167204;Taip;0;19;0;19
17769;Justinukas;KODĖLČIUKŲ;1378219785;Taip;5;0;0;5
17770;Justinukas;KODĖLČIUKŲ;4946448574;Taip;0;1;0;1
17771;Justinukas;KODĖLČIUKŲ;1418462058;Taip;0;1;0;1
17772;Justinukas;KODĖLČIUKŲ;1022310072;Taip;10;2;0;12
17773;Justinukas;KODĖLČIUKŲ;33481357566;Taip;0;17;0;17
17774;Justinukas;KODĖLČIUKŲ;67436657541;Taip;12;0;0;12
17775;Justinukas;KODĖLČIUKŲ;29009575642;Taip;15;0;0;15
17776;Justinukas;KODĖLČIUKŲ;55428936508;Taip;3;0;0;3
17777;Justinukas;KODĖLČIUKŲ;60187200;Taip;0;0;3;3
17778;Justinukas;KODĖLČIUKŲ;11824002845;Taip;12;3;0;15
17779;Justinukas;KODĖLČIUKŲ;29696816177;Taip;5;7;0;12
17780;Justinukas;KODĖLČIUKŲ;50050288702;Taip;8;0;0;8
17781;Justinukas;KODĖLČIUKŲ;65541524010;Taip;0;13;0;13
17782;Justinukas;KODĖLČIUKŲ;70144957042;Taip;7;0;0;7
17783;Justinukas;KODĖLČIUKŲ;89566764594;Taip;0;0;2;2
17784;Justinukas;KODĖLČIUKŲ;21904117684;Taip;10;6;0;16
17785;Justinukas;KODĖLČIUKŲ;95563958391;Taip;5;0;1;6
17786;Justinukas;KODĖLČIUKŲ;38087400506;Taip;10;0;0;10
17787;Justinukas;KODĖLČIUKŲ;51111749099;Taip;0;1;0;1
17788;Justinukas;KODĖLČIUKŲ;79380650760;Taip;0;7;0;7
17789;Justinukas;KODĖLČIUKŲ;42959183109;Taip;0;6;0;6
17790;Justinukas;KODĖLČIUKŲ;84179174899;Taip;13;0;0;13
17791;Justinukas;KODĖLČIUKŲ;1820490979;Taip;0;1;0;1
17792;Justinukas;KODĖLČIUKŲ;1962802968;Taip;8;10;0;18
17793;Justinukas;VIKRUOLIŲ;57621616956;Taip;5;2;0;7
17794;Justinukas;VIKRUOLIŲ;59108759161;Taip;19;0;0;19
17795;Justinukas;VIKRUOLIŲ;2776259830;Taip;5;3;0;8
17796;Justinukas;VIKRUOLIŲ;79934530654;Taip;8;2;0;10
17797;Justinukas;VIKRUOLIŲ;95467011497;Taip;5;1;0;6
17798;Justinukas;VIKRUOLIŲ;48732379120;Ne;0;6;0;6
17799;Justinukas;VIKRUOLIŲ;1844038414;Taip;5;4;0;9
17800;Justinukas;VIKRUOLIŲ;2952798555;Taip;20;0;0;20
17801;Justinukas;VIKRUOLIŲ;54102488427;Taip;15;5;0;20
17802;Justinukas;VIKRUOLIŲ;28543773229;Taip;3;2;0;5
17803;Justinukas;VIKRUOLIŲ;68853730495;Taip;6;4;1;11
17804;Justinukas;VIKRUOLIŲ;70062275466;Taip;10;6;0;16
17805;Justinukas;VIKRUOLIŲ;80827159258;Taip;6;0;0;6
17806;Justinukas;VIKRUOLIŲ;311074533;Taip;8;0;0;8
17807;Justinukas;VIKRUOLIŲ;7120661911;Taip;9;0;0;9
17808;Justinukas;VIKRUOLIŲ;55151392377;Taip;0;1;0;1
17809;Justinukas;VIKRUOLIŲ;97284171512;Taip;20;0;0;20
17810;Justinukas;VIKRUOLIŲ;1955952962;Taip;5;1;0;6
17811;Justinukas;VIKRUOLIŲ;1480054888;Taip;13;4;1;18
17812;Justinukas;VIKRUOLIŲ;5199005933;Taip;4;8;0;12
17813;Justinukas;VIKRUOLIŲ;2120659659;Taip;7;5;1;13
17814;Justinukas;PELEDŽIUKŲ;1789533195;Taip;7;7;0;14
17815;Justinukas;PELEDŽIUKŲ;1937753510;Taip;10;0;0;10
17816;Justinukas;PELEDŽIUKŲ;6268022925;Taip;10;3;0;13
17817;Justinukas;PELEDŽIUKŲ;1405642653;Taip;0;5;0;5
17818;Justinukas;PELEDŽIUKŲ;1976450069;Taip;0;5;2;7
17819;Justinukas;PELEDŽIUKŲ;89934673064;Taip;5;0;0;5
17820;Justinukas;PELEDŽIUKŲ;90692179185;Taip;0;10;0;10
17821;Justinukas;PELEDŽIUKŲ;61301662234;Taip;10;3;0;13
17822;Justinukas;PELEDŽIUKŲ;2027779101;Taip;7;0;1;8
17823;Justinukas;PELEDŽIUKŲ;12741015006;Taip;0;11;0;11
17824;Justinukas;PELEDŽIUKŲ;6961211392;Taip;9;1;0;10
17825;Justinukas;PELEDŽIUKŲ;48908098476;Taip;0;6;0;6
17826;Justinukas;PELEDŽIUKŲ;6604163285;Taip;0;8;0;8
17827;Justinukas;PELEDŽIUKŲ;1266695122;Taip;12;0;0;12
17828;Justinukas;PELEDŽIUKŲ;1956136425;Taip;20;0;0;20
17829;Justinukas;PELEDŽIUKŲ;1264545164;Taip;0;14;0;14
17830;Justinukas;PELEDŽIUKŲ;1846303993;Taip;11;0;0;11
17831;Justinukas;ŽIRNIUKŲ;5876182759;Taip;0;4;0;4
17832;Justinukas;ŽIRNIUKŲ;8566530492;Taip;4;0;0;4
17833;Justinukas;ŽIRNIUKŲ;2900181358;Taip;5;0;5;10
17834;Justinukas;ŽIRNIUKŲ;5978993456;Taip;15;1;0;16
17835;Justinukas;ŽIRNIUKŲ;5870609685;Taip;11;0;0;11
17836;Justinukas;ŽIRNIUKŲ;8965456115;Taip;11;0;0;11
17837;Justinukas;ŽIRNIUKŲ;8455069158;Taip;15;0;0;15
17838;Justinukas;ŽIRNIUKŲ;8874979704;Taip;12;5;0;17
17839;Justinukas;ŽIRNIUKŲ;3193143474;Taip;20;0;0;20
17840;Justinukas;ŽIRNIUKŲ;1540892686;Taip;10;6;0;16
17841;Justinukas;ŽIRNIUKŲ;1341026177;Taip;5;0;0;5
17842;Justinukas;ŽIRNIUKŲ;3729297918;Taip;0;2;3;5
17843;Justinukas;ŽIRNIUKŲ;2268124610;Taip;0;4;1;5
17844;Justinukas;GUDRUČIŲ;2241816838;Taip;8;2;0;10
17845;Justinukas;GUDRUČIŲ;6482808707;Taip;5;0;0;5
17846;Justinukas;GUDRUČIŲ;4756483798;Taip;15;1;0;16
17847;Justinukas;GUDRUČIŲ;3206751576;Taip;5;1;0;6
17848;Justinukas;GUDRUČIŲ;6470287041;Taip;10;2;0;12
17849;Justinukas;GUDRUČIŲ;3268913601;Taip;12;0;0;12
17850;Justinukas;GUDRUČIŲ;2017929633;Taip;13;3;0;16
17851;Justinukas;GUDRUČIŲ;7710916537;Taip;11;3;0;14
17852;Justinukas;GUDRUČIŲ;4194429972;Taip;6;7;0;13
17853;Justinukas;GUDRUČIŲ;8913463448;Taip;13;0;0;13
17854;Justinukas;GUDRUČIŲ;1426415687;Taip;10;4;0;14
17855;Justinukas;GUDRUČIŲ;7854674833;Taip;6;5;0;11
17856;Justinukas;GUDRUČIŲ;3768735503;Taip;5;0;0;5
17857;Justinukas;GUDRUČIŲ;8086378912;Taip;12;4;0;16
17858;Justinukas;GUDRUČIŲ;4271601149;Taip;5;6;0;11
17859;Justinukas;BORUŽIUKŲ;4542350401;Taip;0;3;0;3
17860;Justinukas;BORUŽIUKŲ;4347647695;Taip;0;13;0;13
17861;Justinukas;BORUŽIUKŲ;3388483002;Taip;13;0;1;14
17862;Justinukas;BORUŽIUKŲ;9998493076;Taip;0;1;0;1
17863;Justinukas;BORUŽIUKŲ;1129392970;Taip;0;0;5;5
17864;Justinukas;BORUŽIUKŲ;1398976932;Taip;5;0;0;5
17865;Justinukas;BORUŽIUKŲ;9823188609;Taip;0;0;1;1
17866;Justinukas;BORUŽIUKŲ;1977242147;Taip;11;0;0;11
17867;Justinukas;BORUŽIUKŲ;29165025048;Taip;5;0;1;6
17868;Justinukas;BORUŽIUKŲ;5258444578;Taip;0;1;2;3
17869;Justinukas;BORUŽIUKŲ;4574673585;Taip;0;3;0;3
17870;Justinukas;BORUŽIUKŲ;7006338378;Taip;0;5;0;5
17871;Justinukas;BORUŽIUKŲ;7166828675;Taip;0;3;3;6
17872;Justinukas;BORUŽIUKŲ;39916867354;Taip;5;1;0;6
17873;Justinukas;BORUŽIUKŲ;4010638658;Taip;0;1;0;1
17874;Justinukas;BORUŽIUKŲ;1172609518;Taip;10;0;4;14
17875;Justinukas;BORUŽIUKŲ;1616324236;Taip;0;2;2;4
17876;Justinukas;BORUŽIUKŲ;3030820917;Taip;6;0;0;6
17877;Aidas;Boružėlių;3748420427;Taip;9;0;0;9
17878;Aidas;Boružėlių;2027860670;Taip;20;0;0;20
17879;Aidas;Boružėlių;8915901727;Taip;0;6;0;6
17880;Aidas;Boružėlių;5311183877;Taip;0;9;0;9
17881;Aidas;Drugelių;1505697405;Ne;10;1;0;11
17882;Aidas;Drugelių;5346078886;Taip;0;3;0;3
17883;Aidas;Drugelių;1001916537;Taip;0;1;0;1
17884;Aidas;Drugelių;15257986685;Taip;0;1;0;1
17885;Aidas;Drugelių;1653793823;Taip;0;2;0;2
17886;Aidas;Drugelių;2954393415;Taip;5;1;0;6
17887;Aidas;Aitvariukų;17920063762;Taip;0;2;0;2
17888;Aidas;Aitvariukų;30954912922;Taip;9;6;0;15
17889;Aidas;Aitvariukų;3127870635;Taip;0;1;0;1
17890;Aidas;"Meškučių kl.";9456640135;Ne;10;6;0;16
17891;Aidas;"Meškučių kl.";3496627131;Ne;0;5;0;5
17892;Aidas;"Meškučių kl.";2970002617;Ne;0;5;0;5
17893;Aidas;"Meškučių kl.";3094228969;Ne;0;20;0;20
17894;Aidas;"Meškučių kl.";8177181962;Ne;0;5;0;5
17895;Aidas;"Meškučių kl.";4980030389;Ne;0;5;0;5
17896;Aidas;"Gaidelių kl.";5100740847;Ne;0;5;0;5
17897;Aidas;"Gaidelių kl.";3808707012;Ne;0;5;0;5
17898;Aidas;"Gaidelių kl.";1322335360;Taip;0;5;0;5
17899;Aidas;"Gaidelių kl.";8642665550;Ne;5;6;0;11
17900;Aidas;"Gaidelių kl.";5806540190;Ne;0;5;0;5
17901;Aidas;"Gaidelių kl.";7803641933;Ne;0;5;0;5
17902;Aidas;"Gaidelių kl.";8056436399;Ne;0;5;0;5
17903;Aidas;"Gaidelių kl.";2501187241;Ne;20;0;0;20
17904;Aidas;"Kiškelių kl";6213577188;Ne;0;6;0;6
17905;Aidas;"Kiškelių kl";7740504510;Ne;0;5;0;5
17906;Aidas;"Kiškelių kl";9057435844;Ne;0;1;0;1
17907;Aidas;"Kiškelių kl";2681438925;Taip;0;5;0;5
17908;Aidas;"Kiškelių kl";2234931428;Ne;0;5;0;5
17909;Aidas;"Kiškelių kl";5388697695;Ne;0;5;0;5
17910;Aidas;"Kiškelių kl";7354905114;Ne;8;0;0;8
17911;Aidas;"Kiškelių kl";6868265902;Ne;0;5;0;5
17912;Aidas;"Kiškelių kl";2446003793;Ne;0;7;0;7
17913;Aidas;"Kiškelių kl";4738867530;Taip;0;5;0;5
17914;Aidas;"Ančiukų kl.";4081645294;Ne;12;0;0;12
17915;Aidas;"Ančiukų kl.";1742331213;Ne;5;0;0;5
17916;Aidas;"Ančiukų kl.";92425322676;Ne;0;5;0;5
17917;Aidas;"Ančiukų kl.";81654551230;Taip;10;5;0;15
17918;Aidas;"Ančiukų kl.";9816043688;Ne;0;5;0;5
17919;Aidas;"Ančiukų kl.";20604410476;Ne;5;5;0;10
17920;Aidas;"Ančiukų kl.";63508565206;Ne;0;5;0;5
17921;Aidas;"Ančiukų kl.";1079077463;Taip;0;8;0;8
17922;Aidas;"Ančiukų kl.";3194974747;Taip;5;5;0;10
17923;Aidas;"Ančiukų kl.";72751441075;Taip;0;1;0;1
17924;Aidas;"Pelėdžiukų kl.";2991400032;Ne;0;5;0;5
17925;Aidas;"Pelėdžiukų kl.";5326012529;Ne;0;5;0;5
17926;Aidas;"Pelėdžiukų kl.";5655286565;Ne;0;5;0;5
17927;Aidas;"Pelėdžiukų kl.";3279914631;Ne;0;1;0;1
17928;Aidas;"Pelėdžiukų kl.";7148658584;Ne;0;5;0;5
17929;Aidas;"Pelėdžiukų kl.";3808657280;Ne;0;5;0;5
17930;Aidas;"Pelėdžiukų kl.";2945444897;Taip;0;5;0;5
17931;Aidas;"Papūgėlių kl.";3447250754;Ne;0;5;0;5
17932;Aidas;"Papūgėlių kl.";2184123290;Taip;0;5;0;5
17933;Aidas;"Papūgėlių kl.";3352587395;Ne;0;5;0;5
17934;Aidas;"Papūgėlių kl.";4372628947;Ne;0;9;0;9
17935;Aidas;"Papūgėlių kl.";3442250711;Ne;0;5;0;5
17936;Aidas;"Papūgėlių kl.";5905008395;Ne;5;5;0;10
17937;Aidas;"Papūgėlių kl.";9613466086;Taip;0;10;0;10
17938;Aidas;"Saulutės kl.";1535004699;Ne;0;11;0;11
17939;Aidas;"Saulutės kl.";6356218442;Ne;0;5;0;5
17940;Aidas;"Saulutės kl.";9944901942;Ne;0;4;0;4
17941;Aidas;"Saulutės kl.";4890362155;Taip;0;5;0;5
17942;Aidas;"Saulutės kl.";6778658540;Taip;0;5;0;5
17943;Aidas;"Saulutės kl.";7329254454;Taip;0;2;0;2
17944;Aidas;"Saulutės kl.";2000234311;Taip;10;2;0;12
17945;Aidas;"Saulutės kl.";4990112920;Taip;0;5;0;5
17946;Aidas;"Saulutės kl.";88721781220;Ne;3;0;0;3
17947;Aidas;"Katinėlių kl.";4367406525;Taip;2;0;0;2
17948;Aidas;"Katinėlių kl.";1010885560;Ne;0;5;0;5
17949;Aidas;"Katinėlių kl.";7821044288;Taip;0;6;0;6
17950;Aidas;"Katinėlių kl.";8377829773;Ne;0;5;0;5
17951;Bangelė;Aštuonkojai;20827674346;Taip;0;8;0;8
17952;Bangelė;Aštuonkojai;68082711504;Taip;0;4;0;4
17953;Bangelė;Aštuonkojai;51571795638;Ne;13;0;0;13
17954;Bangelė;Aštuonkojai;8280327053;Taip;15;0;2;17
17955;Bangelė;Aštuonkojai;61812452736;Taip;16;0;1;17
17956;Bangelė;Aštuonkojai;81379253837;Taip;17;0;0;17
17957;Bangelė;Aštuonkojai;5142785037;Taip;0;10;0;10
17958;Bangelė;Aštuonkojai;83691968186;Taip;9;6;0;15
17959;Bangelė;Aštuonkojai;76618850202;Taip;6;0;0;6
17960;Bangelė;Aštuonkojai;84855013193;Taip;8;0;0;8
17961;Bangelė;Aštuonkojai;69413101571;Taip;0;6;0;6
17962;Bangelė;Aštuonkojai;24209781144;Taip;10;1;0;11
17963;Bangelė;Aštuonkojai;18979714088;Taip;0;6;0;6
17964;Bangelė;Aštuonkojai;89458174517;Taip;0;2;0;2
17965;Bangelė;Aštuonkojai;70270153561;Ne;0;4;2;6
17966;Bangelė;Aštuonkojai;13284428796;Taip;18;0;0;18
17967;Bangelė;Aštuonkojai;7957072941;Taip;8;2;2;12
17968;Bangelė;Aštuonkojai;24895047229;Taip;6;4;0;10
17969;Bangelė;Aštuonkojai;1593861817;Taip;8;1;0;9
17970;Bangelė;Aštuonkojai;45145282759;Taip;5;0;3;8
17971;Bangelė;Aštuonkojai;2067377559;Taip;13;0;0;13
17972;Bangelė;Aštuonkojai;1598526615;Taip;12;0;0;12
17973;Bangelė;Aštuonkojai;1312545465;Taip;8;3;0;11
17974;Bangelė;Aštuonkojai;1862514267;Taip;0;4;0;4
17975;Bangelė;Delfinukai,;7263228478;Taip;0;5;1;6
17976;Bangelė;Delfinukai,;1296464444;Taip;0;2;3;5
17977;Bangelė;Delfinukai,;1953702121;Taip;15;3;0;18
17978;Bangelė;Delfinukai,;1594486275;Taip;0;7;0;7
17979;Bangelė;Delfinukai,;3505492809;Taip;0;0;12;12
17980;Bangelė;Delfinukai,;22773040549;Taip;5;0;4;9
17981;Bangelė;Delfinukai,;6508452044;Taip;0;9;0;9
17982;Bangelė;Delfinukai,;2045465669;Taip;10;5;0;15
17983;Bangelė;Delfinukai,;1177022224;Taip;0;4;0;4
17984;Bangelė;Delfinukai,;95548866362;Taip;0;9;0;9
17985;Bangelė;Delfinukai,;1377575533;Taip;0;12;0;12
17986;Bangelė;Delfinukai,;3044914280;Taip;0;6;0;6
17987;Bangelė;Delfinukai,;2032075296;Taip;8;3;0;11
17988;Bangelė;Delfinukai,;7059603451;Taip;5;8;0;13
17989;Bangelė;Delfinukai,;4342844311;Taip;10;0;0;10
17990;Bangelė;Delfinukai,;1053744221;Taip;20;0;0;20
17991;Bangelė;Delfinukai,;4187165474;Taip;0;7;0;7
17992;Bangelė;"Saulės spindulėliai";7324007016;Taip;8;6;0;14
17993;Bangelė;"Saulės spindulėliai";8693782399;Taip;0;8;0;8
17994;Bangelė;"Saulės spindulėliai";8183516661;Taip;0;9;0;9
17995;Bangelė;"Saulės spindulėliai";65814392847;Taip;0;6;0;6
17996;Bangelė;"Saulės spindulėliai";47925578720;Taip;0;6;1;7
17997;Bangelė;"Saulės spindulėliai";99763916617;Taip;0;7;0;7
17998;Bangelė;"Saulės spindulėliai";22633862463;Taip;10;0;0;10
17999;Bangelė;"Saulės spindulėliai";30494044355;Taip;0;11;0;11
18000;Bangelė;"Saulės spindulėliai";49086959518;Taip;1;5;0;6
18001;Bangelė;"Saulės spindulėliai";97482799588;Taip;0;4;0;4
18002;Bangelė;"Saulės spindulėliai";83292810870;Taip;7;4;0;11
18003;Bangelė;"Saulės spindulėliai";32763572364;Taip;0;1;1;2
18004;Bangelė;"Saulės spindulėliai";17203636760;Ne;0;12;0;12
18005;Bangelė;"Saulės spindulėliai";21078822314;Taip;0;6;0;6
18006;Bangelė;"Saulės spindulėliai";95340587554;Taip;7;0;0;7
18007;Bangelė;"Saulės spindulėliai";27628473523;Taip;5;0;0;5
18008;Bangelė;"Saulės spindulėliai";75561871028;Taip;0;10;0;10
18009;Bangelė;"Saulės spindulėliai";26684336190;Taip;0;12;0;12
18010;Bangelė;"Saulės spindulėliai";50893212045;Taip;5;12;0;17
18011;Bangelė;"Saulės spindulėliai";83733094674;Taip;0;16;0;16
18012;Bangelė;"Pingvinukai ";1728085772;Taip;13;5;0;18
18013;Bangelė;"Pingvinukai ";9150185864;Taip;15;1;0;16
18014;Bangelė;"Pingvinukai ";6173470021;Taip;14;0;0;14
18015;Bangelė;"Pingvinukai ";55668308050;Taip;10;8;0;18
18016;Bangelė;"Pingvinukai ";2503946448;Taip;15;0;0;15
18017;Bangelė;"Pingvinukai ";6026399355;Taip;0;3;4;7
18018;Bangelė;"Pingvinukai ";3338203753;Taip;9;2;3;14
18019;Bangelė;"Pingvinukai ";1377734102;Taip;5;5;0;10
18020;Bangelė;"Pingvinukai ";9788923823;Taip;20;0;0;20
18021;Bangelė;"Pingvinukai ";9341038058;Taip;4;5;0;9
18022;Bangelė;"Pingvinukai ";5950451237;Taip;9;5;0;14
18023;Bangelė;"Pingvinukai ";2027892816;Taip;10;0;1;11
18024;Bangelė;"Pingvinukai ";1447396084;Taip;4;0;0;4
18025;Bangelė;"Pingvinukai ";5034268767;Taip;7;0;1;8
18026;Bangelė;"Pingvinukai ";4204797742;Taip;9;9;0;18
18027;Bangelė;"Pingvinukai ";1661384764;Taip;12;3;2;17
18028;Bangelė;"Pingvinukai ";1032881464;Taip;15;0;0;15
18029;Bangelė;"Pingvinukai ";9464115339;Taip;15;5;0;20
18030;Bangelė;"Jūros žvaigždutės ";2872188915;Taip;10;0;0;10
18031;Bangelė;"Jūros žvaigždutės ";7723290276;Taip;0;0;2;2
18032;Bangelė;"Jūros žvaigždutės ";4401389067;Taip;2;5;2;9
18033;Bangelė;"Jūros žvaigždutės ";1528387105;Taip;0;3;4;7
18034;Bangelė;"Jūros žvaigždutės ";6712145066;Taip;10;0;0;10
18035;Bangelė;"Jūros žvaigždutės ";9822287576;Taip;0;5;8;13
18036;Bangelė;"Jūros žvaigždutės ";7375004714;Taip;7;0;0;7
18037;Bangelė;"Jūros žvaigždutės ";7701956270;Taip;0;2;1;3
18038;Bangelė;"Jūros žvaigždutės ";1367082230;Taip;0;12;0;12
18039;Bangelė;"Jūros žvaigždutės ";1348995498;Ne;0;10;0;10
18040;Bangelė;"Jūros žvaigždutės ";3900236858;Taip;5;3;0;8
18041;Bangelė;"Jūros žvaigždutės ";4571869439;Taip;0;5;0;5
18042;Bangelė;"Jūros žvaigždutės ";4122927034;Ne;10;1;0;11
18043;Bangelė;"Jūros žvaigždutės ";8758933649;Taip;15;0;0;15
18044;Bangelė;"Jūros žvaigždutės ";9041585534;Taip;15;0;0;15
18045;Bangelė;"Jūros žvaigždutės ";4506651162;Taip;0;0;3;3
18046;Bangelė;"Jūros žvaigždutės ";9672505885;Taip;20;0;0;20
18047;Bangelė;"Jūros žvaigždutės ";4338067260;Taip;13;0;1;14
18048;Bangelė;Žuvytės;77615973000;Taip;10;5;0;15
18049;Bangelė;Žuvytės;411039166;Taip;15;0;0;15
18050;Bangelė;Žuvytės;7114709352;Taip;11;5;0;16
18051;Bangelė;Žuvytės;28845494407;Taip;10;5;0;15
18052;Bangelė;Žuvytės;2195543161;Ne;9;2;0;11
18053;Bangelė;Žuvytės;9983202427;Ne;5;2;2;9
18054;Bangelė;Žuvytės;3115177810;Taip;13;0;2;15
18055;Bangelė;Žuvytės;1790881495;Taip;1;0;7;8
18056;Bangelė;Žuvytės;1683377649;Taip;0;4;0;4
18057;Bangelė;Žuvytės;6739499483;Taip;3;0;12;15
18058;Bangelė;Žuvytės;47454787439;Taip;2;0;5;7
18059;Bangelė;Žuvytės;5573145836;Taip;12;5;2;19
18060;Bangelė;Žuvytės;3961043533;Taip;12;5;0;17
18061;Bangelė;Žuvytės;5159962168;Taip;10;2;0;12
18062;Bangelė;Žuvytės;1766156349;Taip;11;5;0;16
18063;Bangelė;Žuvytės;2112394008;Taip;6;5;1;12
18064;Bangelė;Žuvytės;1065164865;Taip;0;0;17;17
18065;Bangelė;Žuvytės;42739113312;Ne;13;0;0;13
18066;Bangelė;Ruoniai;77600323792;Taip;10;0;0;10
18067;Bangelė;Ruoniai;78837447598;Taip;5;1;0;6
18068;Bangelė;Ruoniai;34804550825;Taip;0;2;1;3
18069;Bangelė;Ruoniai;7559190407;Taip;0;5;5;10
18070;Bangelė;Ruoniai;1656261128;Taip;0;12;0;12
18071;Bangelė;Ruoniai;11083985386;Taip;0;7;0;7
18072;Bangelė;Ruoniai;76353372848;Taip;5;0;0;5
18073;Bangelė;Ruoniai;99771696381;Taip;9;1;0;10
18074;Bangelė;Ruoniai;17608442103;Taip;6;5;0;11
18075;Bangelė;Ruoniai;60823401986;Taip;0;0;2;2
18076;Bangelė;Ruoniai;84620904798;Taip;5;0;8;13
18077;Bangelė;Ruoniai;37790897510;Taip;7;0;2;9
18078;Bangelė;Ruoniai;84797019693;Ne;6;4;0;10
18079;Bangelė;Ruoniai;2749669816;Taip;7;0;0;7
18080;Bangelė;Ruoniai;1258870576;Taip;0;5;4;9
18081;Bangelė;Ruoniai;91953522637;Taip;11;0;0;11
18082;Bangelė;Ruoniai;99823581960;Taip;0;8;0;8
18083;Bangelė;Ruoniai;2423625777;Taip;0;13;2;15
18084;Bangelė;Ruoniai;1823592268;Taip;4;3;0;7
18085;Bangelė;"Pagrandukai ";6861123988;Taip;15;1;0;16
18086;Bangelė;"Pagrandukai ";1351714626;Taip;18;0;0;18
18087;Bangelė;"Pagrandukai ";1754002501;Taip;8;0;0;8
18088;Bangelė;"Pagrandukai ";6953698592;Taip;8;3;3;14
18089;Bangelė;"Pagrandukai ";6216334243;Taip;0;6;0;6
18090;Bangelė;"Pagrandukai ";3063439996;Taip;16;1;0;17
18091;Bangelė;"Pagrandukai ";2156837975;Taip;3;0;0;3
18092;Bangelė;"Pagrandukai ";9801978617;Taip;0;9;0;9
18093;Bangelė;"Pagrandukai ";3634678954;Taip;12;1;0;13
18094;Bangelė;"Pagrandukai ";7434879947;Taip;17;0;0;17
18095;Bangelė;"Pagrandukai ";1390623903;Taip;5;3;0;8
18096;Bangelė;"Pagrandukai ";7136625230;Taip;5;1;0;6
18097;Bangelė;"Pagrandukai ";5761137540;Taip;5;7;0;12
18098;Bangelė;"Pagrandukai ";8316505307;Taip;10;0;0;10
18099;Bangelė;"Pagrandukai ";6145050734;Taip;7;0;0;7
18100;Bangelė;"Zuikučiai ";9706351115;Taip;10;2;0;12
18101;Bangelė;"Zuikučiai ";4412780063;Taip;10;10;0;20
18102;Bangelė;"Zuikučiai ";9009809585;Ne;8;5;0;13
18103;Bangelė;"Zuikučiai ";8734511431;Taip;10;4;0;14
18104;Bangelė;"Zuikučiai ";6044653707;Taip;17;0;0;17
18105;Bangelė;"Zuikučiai ";1915827035;Taip;17;0;0;17
18106;Bangelė;"Zuikučiai ";7685394517;Taip;10;0;0;10
18107;Bangelė;"Zuikučiai ";6693019825;Taip;6;1;0;7
18108;Bangelė;"Zuikučiai ";3991021350;Taip;11;2;0;13
18109;Bangelė;"Zuikučiai ";3990966706;Taip;15;2;0;17
18110;Bangelė;"Zuikučiai ";2764009011;Taip;6;0;0;6
18111;Bangelė;"Zuikučiai ";8799415648;Taip;0;1;10;11
18112;Bangelė;"Zuikučiai ";3334029244;Taip;8;2;0;10
18113;Bangelė;"Zuikučiai ";7230987338;Taip;10;0;0;10
18114;Bangelė;"Zuikučiai ";7337449523;Taip;14;0;2;16
18115;Bangelė;"Zuikučiai ";7174742281;Taip;9;2;0;11
18116;Bangelė;"Zuikučiai ";3579974049;Taip;20;0;0;20
18117;Gėlynas;PAKALNUTĖ;95681874019;Taip;4;0;0;4
18118;Gėlynas;PAKALNUTĖ;22067595840;Taip;10;0;1;11
18119;Gėlynas;PAKALNUTĖ;99637531213;Taip;9;2;0;11
18120;Gėlynas;PAKALNUTĖ;7735904549;Taip;10;0;0;10
18121;Gėlynas;PAKALNUTĖ;72991081966;Taip;7;0;0;7
18122;Gėlynas;PAKALNUTĖ;85912494214;Taip;0;10;0;10
18123;Gėlynas;PAKALNUTĖ;23134075402;Taip;4;0;0;4
18124;Gėlynas;PAKALNUTĖ;93919808581;Taip;0;6;0;6
18125;Gėlynas;PAKALNUTĖ;65634206992;Taip;8;4;0;12
18126;Gėlynas;PAKALNUTĖ;14307514975;Taip;0;2;0;2
18127;Gėlynas;PAKALNUTĖ;31532261756;Taip;0;9;0;9
18128;Gėlynas;PAKALNUTĖ;91530210644;Taip;6;1;0;7
18129;Gėlynas;PAKALNUTĖ;72544014665;Taip;0;2;3;5
18130;Gėlynas;PAKALNUTĖ;40702362906;Taip;0;5;0;5
18131;Gėlynas;PAKALNUTĖ;75222833700;Taip;0;3;0;3
18132;Gėlynas;PAKALNUTĖ;55177015936;Taip;0;3;0;3
18133;Gėlynas;PAKALNUTĖ;58542813068;Taip;5;0;0;5
18134;Gėlynas;PAKALNUTĖ;1406567756;Taip;3;1;0;4
18135;Gėlynas;PAKALNUTĖ;6375754699;Taip;9;0;0;9
18136;Gėlynas;VARPELIS;10328968209;Taip;5;2;0;7
18137;Gėlynas;VARPELIS;31203005706;Taip;0;10;0;10
18138;Gėlynas;VARPELIS;25587271237;Taip;0;4;0;4
18139;Gėlynas;VARPELIS;69440015944;Taip;10;5;1;16
18140;Gėlynas;VARPELIS;88267408077;Taip;0;1;1;2
18141;Gėlynas;VARPELIS;79659995227;Taip;0;7;0;7
18142;Gėlynas;VARPELIS;83480285704;Taip;1;0;0;1
18143;Gėlynas;VARPELIS;32029146963;Taip;3;10;0;13
18144;Gėlynas;VARPELIS;49356547308;Taip;0;9;0;9
18145;Gėlynas;VARPELIS;2694971710;Taip;4;0;0;4
18146;Gėlynas;VARPELIS;96358879500;Taip;5;8;0;13
18147;Gėlynas;VARPELIS;81669521777;Ne;0;9;0;9
18148;Gėlynas;VARPELIS;51078077889;Taip;7;0;0;7
18149;Gėlynas;VARPELIS;95226235881;Taip;5;5;0;10
18150;Gėlynas;VARPELIS;1321152075;Taip;0;10;0;10
18151;Gėlynas;VARPELIS;87982340000;Taip;5;0;0;5
18152;Gėlynas;VARPELIS;53718930602;Taip;0;4;0;4
18153;Gėlynas;VARPELIS;85776411183;Taip;3;5;0;8
18154;Gėlynas;RAKTAŽOLĖ;1418321973;Taip;0;5;0;5
18155;Gėlynas;RAKTAŽOLĖ;93572183033;Taip;0;8;0;8
18156;Gėlynas;RAKTAŽOLĖ;84522552145;Taip;0;10;0;10
18157;Gėlynas;RAKTAŽOLĖ;63379609794;Taip;0;8;0;8
18158;Gėlynas;RAKTAŽOLĖ;33068084227;Taip;0;5;2;7
18159;Gėlynas;RAKTAŽOLĖ;1797681067;Taip;0;1;0;1
18160;Gėlynas;RAKTAŽOLĖ;1117528954;Taip;0;6;0;6
18161;Gėlynas;RAKTAŽOLĖ;57429063547;Taip;12;6;0;18
18162;Gėlynas;RAKTAŽOLĖ;1483072450;Taip;10;0;0;10
18163;Gėlynas;RAKTAŽOLĖ;7796794153;Taip;0;5;0;5
18164;Gėlynas;RAKTAŽOLĖ;6264361257;Taip;8;5;0;13
18165;Gėlynas;RAKTAŽOLĖ;1047462165;Taip;0;6;0;6
18166;Gėlynas;RAKTAŽOLĖ;1754734306;Taip;6;5;0;11
18167;Gėlynas;RAKTAŽOLĖ;9780911032;Taip;0;8;0;8
18168;Gėlynas;RAKTAŽOLĖ;84546885977;Taip;0;5;0;5
18169;Gėlynas;RAKTAŽOLĖ;5135747448;Taip;0;5;0;5
18170;Gėlynas;RAKTAŽOLĖ;7808971151;Taip;0;4;0;4
18171;Gėlynas;SAULĖGRĄŽA;1995694892;Taip;7;0;0;7
18172;Gėlynas;SAULĖGRĄŽA;1191494598;Taip;0;0;3;3
18173;Gėlynas;SAULĖGRĄŽA;1407350449;Taip;15;0;0;15
18174;Gėlynas;SAULĖGRĄŽA;1676904275;Taip;5;0;0;5
18175;Gėlynas;SAULĖGRĄŽA;1338585475;Ne;9;6;0;15
18176;Gėlynas;SAULĖGRĄŽA;2050384850;Taip;4;0;1;5
18177;Gėlynas;SAULĖGRĄŽA;85310323038;Taip;0;10;0;10
18178;Gėlynas;SAULĖGRĄŽA;47220216751;Taip;0;10;0;10
18179;Gėlynas;SAULĖGRĄŽA;2099722437;Taip;2;2;1;5
18180;Gėlynas;SAULĖGRĄŽA;86881175896;Taip;9;0;0;9
18181;Gėlynas;SAULĖGRĄŽA;1053422007;Taip;10;0;0;10
18182;Gėlynas;SAULĖGRĄŽA;1608626732;Taip;18;2;0;20
18183;Gėlynas;SAULĖGRĄŽA;44391516295;Taip;12;0;0;12
18184;Gėlynas;SAULĖGRĄŽA;17587435701;Taip;5;0;0;5
18185;Gėlynas;SAULĖGRĄŽA;1363040744;Taip;0;5;3;8
18186;Gėlynas;SAULĖGRĄŽA;2018911523;Taip;3;5;0;8
18187;Gėlynas;SAULĖGRĄŽA;1881249769;Taip;3;0;0;3
18188;Gėlynas;SAULĖGRĄŽA;15277524754;Taip;9;0;1;10
18189;Gėlynas;SAULĖGRĄŽA;8324564359;Taip;11;0;0;11
18190;Gėlynas;RAMUNĖLĖ;4382465307;Taip;0;17;0;17
18191;Gėlynas;RAMUNĖLĖ;7814357385;Taip;0;3;0;3
18192;Gėlynas;RAMUNĖLĖ;8464074679;Taip;4;6;0;10
18193;Gėlynas;RAMUNĖLĖ;7562201835;Taip;0;10;0;10
18194;Gėlynas;RAMUNĖLĖ;8615943743;Taip;0;6;0;6
18195;Gėlynas;RAMUNĖLĖ;3572020585;Taip;0;1;0;1
18196;Gėlynas;RAMUNĖLĖ;1674569569;Taip;0;10;0;10
18197;Gėlynas;RAMUNĖLĖ;5695333666;Taip;5;0;0;5
18198;Gėlynas;RAMUNĖLĖ;90046802421;Taip;0;4;0;4
18199;Gėlynas;RAMUNĖLĖ;1557503831;Taip;5;0;0;5
18200;Gėlynas;RAMUNĖLĖ;2230224971;Taip;0;4;0;4
18201;Gėlynas;RAMUNĖLĖ;5395474698;Taip;0;8;0;8
18202;Gėlynas;RAMUNĖLĖ;2348787949;Taip;5;2;0;7
18203;Gėlynas;RAMUNĖLĖ;3890687425;Taip;16;0;0;16
18204;Gėlynas;RAMUNĖLĖ;5124029118;Taip;0;17;0;17
18205;Gėlynas;RAMUNĖLĖ;9026298982;Taip;0;7;0;7
18206;Gėlynas;RAMUNĖLĖ;6815740588;Taip;7;0;0;7
18207;Gėlynas;RAMUNĖLĖ;5541707540;Taip;8;0;0;8
18208;Gėlynas;ŽIBUTĖ;6898127005;Taip;0;1;0;1
18209;Gėlynas;ŽIBUTĖ;77283628988;Taip;4;0;0;4
18210;Gėlynas;ŽIBUTĖ;2417880374;Taip;0;0;17;17
18211;Gėlynas;ŽIBUTĖ;4445250490;Taip;0;0;2;2
18212;Gėlynas;ŽIBUTĖ;6528464599;Taip;0;0;7;7
18213;Gėlynas;ŽIBUTĖ;2906909558;Taip;5;0;3;8
18214;Gėlynas;ŽIBUTĖ;9911225363;Taip;5;0;3;8
18215;Gėlynas;ŽIBUTĖ;2400929266;Taip;9;0;0;9
18216;Gėlynas;ŽIBUTĖ;1897547388;Taip;0;8;0;8
18217;Gėlynas;ŽIBUTĖ;3365442661;Taip;16;0;0;16
18218;Gėlynas;ŽIBUTĖ;7337987259;Taip;0;7;0;7
18219;Gėlynas;ŽIBUTĖ;6042268146;Taip;4;0;0;4
18220;Gėlynas;ŽIBUTĖ;5634213306;Taip;4;0;0;4
18221;Gėlynas;ŽIBUTĖ;5320531856;Taip;0;2;0;2
18222;Gėlynas;ŽIBUTĖ;9724668402;Taip;4;0;1;5
18223;Gėlynas;ŽIBUTĖ;2520059010;Taip;0;15;0;15
18224;Obelėlė;Bildukai;43664898514;Taip;13;0;0;13
18225;Obelėlė;Bildukai;58388471530;Taip;4;0;0;4
18226;Obelėlė;Bildukai;34628612328;Taip;10;1;1;12
18227;Obelėlė;Bildukai;2024391462;Taip;11;0;0;11
18228;Obelėlė;Bildukai;15196087730;Taip;10;3;3;16
18229;Obelėlė;Bildukai;75737109657;Taip;5;4;0;9
18230;Obelėlė;Bildukai;1466324860;Taip;10;0;0;10
18231;Obelėlė;Bildukai;52857531341;Taip;19;0;0;19
18232;Obelėlė;Bildukai;68222818886;Taip;0;1;2;3
18233;Obelėlė;Bildukai;1831642058;Taip;0;11;0;11
18234;Obelėlė;Bildukai;13913516066;Taip;11;0;0;11
18235;Obelėlė;Bildukai;50077685481;Taip;2;3;0;5
18236;Obelėlė;Bildukai;14986936220;Taip;0;3;1;4
18237;Obelėlė;Bildukai;88058597079;Taip;5;0;0;5
18238;Obelėlė;Bildukai;22986329944;Ne;15;2;1;18
18239;Obelėlė;Bildukai;29677456066;Taip;10;0;0;10
18240;Obelėlė;Bildukai;646883449;Taip;8;5;0;13
18241;Obelėlė;Bildukai;89380447507;Taip;9;0;0;9
18242;Obelėlė;Bildukai;65936525141;Taip;0;5;0;5
18243;Obelėlė;Bildukai;1816297607;Taip;15;0;1;16
18244;Obelėlė;Bildukai;19376935875;Taip;0;1;3;4
18245;Obelėlė;Bičiuliai;9031690002;Taip;11;0;0;11
18246;Obelėlė;Bičiuliai;3425736276;Taip;13;0;0;13
18247;Obelėlė;Bičiuliai;1507072248;Taip;13;0;0;13
18248;Obelėlė;Bičiuliai;5776116844;Taip;8;0;2;10
18249;Obelėlė;Bičiuliai;8487088625;Taip;20;0;0;20
18250;Obelėlė;Bičiuliai;1630067014;Taip;5;0;0;5
18251;Obelėlė;Bičiuliai;1537769810;Taip;10;0;0;10
18252;Obelėlė;Bičiuliai;8371648703;Taip;3;0;0;3
18253;Obelėlė;Bičiuliai;3517342646;Taip;2;0;0;2
18254;Obelėlė;Bičiuliai;8757731600;Taip;10;0;2;12
18255;Obelėlė;Bičiuliai;2329734472;Taip;0;1;0;1
18256;Obelėlė;Bičiuliai;1419189517;Taip;20;0;0;20
18257;Obelėlė;Bičiuliai;5933910526;Taip;11;0;0;11
18258;Obelėlė;Bičiuliai;4220808775;Taip;2;5;0;7
18259;Obelėlė;Bičiuliai;8155712451;Taip;0;1;3;4
18260;Obelėlė;Bičiuliai;4849175527;Taip;8;0;0;8
18261;Obelėlė;Bičiuliai;9805481603;Taip;8;0;0;8
18262;Spygliukas;Bitutės;49406606185;Taip;10;5;3;18
18263;Spygliukas;Bitutės;97773415559;Taip;1;5;0;6
18264;Spygliukas;Bitutės;48097650803;Taip;4;0;0;4
18265;Spygliukas;Bitutės;68487983068;Taip;5;5;1;11
18266;Spygliukas;Bitutės;47077562116;Taip;10;0;0;10
18267;Spygliukas;Bitutės;56991221970;Taip;0;5;2;7
18268;Spygliukas;Bitutės;21074122407;Taip;1;0;0;1
18269;Spygliukas;Bitutės;12711940653;Taip;13;0;0;13
18270;Spygliukas;Bitutės;26697357569;Taip;0;9;0;9
18271;Spygliukas;Bitutės;77970187363;Taip;0;0;1;1
18272;Spygliukas;Bitutės;94937084882;Ne;0;5;0;5
18273;Spygliukas;Bitutės;1076152986;Taip;8;0;0;8
18274;Spygliukas;Bitutės;1122973994;Taip;6;0;4;10
18275;Spygliukas;Bitutės;1341415412;Taip;8;0;0;8
18276;Spygliukas;Bitutės;1227595604;Ne;5;6;0;11
18277;Spygliukas;Bitutės;1971162865;Taip;6;5;2;13
18278;Spygliukas;Bitutės;7020789651;Taip;0;5;0;5
18279;Spygliukas;Kiškučiai;9001243644;Taip;16;0;0;16
18280;Spygliukas;Kiškučiai;2058015313;Taip;7;0;0;7
18281;Spygliukas;Kiškučiai;2980459339;Taip;15;0;0;15
18282;Spygliukas;Kiškučiai;4430242310;Taip;5;3;0;8
18283;Spygliukas;Kiškučiai;7250958367;Taip;3;5;0;8
18284;Spygliukas;Kiškučiai;9392554576;Taip;5;0;0;5
18285;Spygliukas;Kiškučiai;8646122773;Taip;10;0;0;10
18286;Spygliukas;Kiškučiai;1940209166;Taip;5;0;0;5
18287;Spygliukas;Kiškučiai;2935281062;Taip;7;0;0;7
18288;Spygliukas;Kiškučiai;8048474808;Taip;2;5;1;8
18289;Spygliukas;Kiškučiai;1679263120;Taip;0;5;0;5
18290;Spygliukas;Kiškučiai;5022615426;Taip;9;0;0;9
18291;Spygliukas;Kiškučiai;4933577424;Taip;4;0;0;4
18292;Spygliukas;Kiškučiai;1855897974;Taip;20;0;0;20
18293;Spygliukas;Kiškučiai;1228469923;Taip;10;3;0;13
18294;Spygliukas;Kiškučiai;8103481313;Taip;20;0;0;20
18295;Spygliukas;Kiškučiai;8992822256;Taip;5;15;0;20
18296;Spygliukas;Kiškučiai;7421000718;Taip;10;0;0;10
18297;Spygliukas;Boružėlės;1939828587;Taip;0;0;4;4
18298;Spygliukas;Boružėlės;1238940921;Taip;6;7;0;13
18299;Spygliukas;Boružėlės;1163722642;Taip;4;3;2;9
18300;Spygliukas;Boružėlės;9288806012;Taip;0;1;0;1
18301;Spygliukas;Boružėlės;1151844475;Taip;0;5;1;6
18302;Spygliukas;Boružėlės;4104158994;Taip;4;2;0;6
18303;Spygliukas;Boružėlės;10858715103;Taip;0;7;0;7
18304;Spygliukas;Boružėlės;1002603766;Taip;14;2;0;16
18305;Spygliukas;Boružėlės;34209607173;Taip;0;5;0;5
18306;Spygliukas;Boružėlės;1842315404;Taip;10;6;0;16
18307;Spygliukas;Boružėlės;73047963456;Taip;0;5;3;8
18308;Spygliukas;Boružėlės;7114613140;Taip;0;2;0;2
18309;Spygliukas;Boružėlės;92279064240;Taip;0;8;0;8
18310;Spygliukas;Boružėlės;30201229961;Taip;0;1;3;4
18311;Spygliukas;Boružėlės;79584454527;Taip;0;2;0;2
18312;Spygliukas;Boružėlės;47977103711;Taip;4;0;1;5
18313;Spygliukas;Boružėlės;1321926079;Taip;0;5;0;5
18314;Spygliukas;Boružėlės;9513387087;Ne;2;5;1;8
18315;Spygliukas;Boružėlės;1193015656;Taip;5;0;0;5
18316;Spygliukas;Ežiukai;1832756255;Taip;14;0;0;14
18317;Spygliukas;Ežiukai;9593700812;Taip;0;1;1;2
18318;Spygliukas;Ežiukai;2126162527;Taip;0;1;1;2
18319;Spygliukas;Ežiukai;1260920726;Taip;12;0;0;12
18320;Spygliukas;Ežiukai;42285404110;Taip;0;5;0;5
18321;Spygliukas;Ežiukai;2040903312;Taip;20;0;0;20
18322;Spygliukas;Ežiukai;3037648954;Taip;6;0;0;6
18323;Spygliukas;Ežiukai;1211969263;Taip;10;1;0;11
18324;Spygliukas;Ežiukai;1881745347;Taip;0;8;0;8
18325;Spygliukas;Ežiukai;4355472423;Taip;4;0;0;4
18326;Spygliukas;Ežiukai;53324066837;Ne;0;6;0;6
18327;Spygliukas;Ežiukai;9957292202;Taip;0;6;0;6
18328;Spygliukas;Ežiukai;1298381738;Taip;0;2;4;6
18329;Spygliukas;Ežiukai;7649832094;Taip;2;9;0;11
18330;Spygliukas;Ežiukai;5780485510;Taip;5;0;0;5
18331;Spygliukas;Ežiukai;8686118262;Taip;5;1;0;6
18332;Spygliukas;Ežiukai;5253108181;Taip;13;5;0;18
18333;Spygliukas;Ežiukai;3785469286;Taip;0;0;10;10
18334;Spygliukas;Ežiukai;29015391754;Taip;0;5;0;5
18335;Spygliukas;Ežiukai;84556142803;Taip;5;7;0;12
18336;Spygliukas;Geniukai;42786380899;Taip;5;1;0;6
18337;Spygliukas;Geniukai;52719709314;Taip;6;0;0;6
18338;Spygliukas;Geniukai;20248450562;Ne;10;0;0;10
18339;Spygliukas;Geniukai;35839138942;Taip;5;9;0;14
18340;Spygliukas;Geniukai;20458611180;Taip;5;4;0;9
18341;Spygliukas;Geniukai;45881077771;Taip;0;7;0;7
18342;Spygliukas;Geniukai;28639466275;Taip;5;4;0;9
18343;Spygliukas;Geniukai;15887839786;Taip;5;0;0;5
18344;Spygliukas;Geniukai;90555084491;Taip;3;2;0;5
18345;Spygliukas;Geniukai;88332181449;Taip;0;1;0;1
18346;Spygliukas;Geniukai;58880461920;Taip;1;1;0;2
18347;Spygliukas;Geniukai;80768950728;Ne;3;7;0;10
18348;Spygliukas;Geniukai;38040423877;Taip;0;7;0;7
18349;Spygliukas;Geniukai;53280907352;Taip;5;4;0;9
18350;Spygliukas;Geniukai;91727550789;Taip;0;11;0;11
18351;Spygliukas;Geniukai;1482370515;Taip;8;6;0;14
18352;Spygliukas;Geniukai;1908975286;Taip;0;1;3;4
18353;Spygliukas;Geniukai;1012592509;Taip;3;1;0;4
18354;Spygliukas;Geniukai;1847162482;Taip;9;0;1;10
18355;Spygliukas;Geniukai;1398592801;Taip;5;5;0;10
18356;Spygliukas;Riešutėliai;88173456147;Taip;0;8;0;8
18357;Spygliukas;Riešutėliai;72370650994;Taip;0;8;0;8
18358;Spygliukas;Riešutėliai;29046559255;Taip;6;0;0;6
18359;Spygliukas;Riešutėliai;80403876623;Taip;3;5;0;8
18360;Spygliukas;Riešutėliai;76913033601;Taip;0;1;0;1
18361;Spygliukas;Riešutėliai;15330844181;Taip;0;7;0;7
18362;Spygliukas;Riešutėliai;61168086526;Taip;0;1;1;2
18363;Spygliukas;Riešutėliai;42616212;Taip;8;6;0;14
18364;Spygliukas;Riešutėliai;80514549747;Taip;3;0;0;3
18365;Spygliukas;Riešutėliai;60381587208;Taip;2;5;5;12
18366;Spygliukas;Riešutėliai;40730123107;Taip;9;3;0;12
18367;Spygliukas;Riešutėliai;86636385350;Taip;4;0;0;4
18368;Spygliukas;Riešutėliai;43693898484;Taip;0;0;3;3
18369;Spygliukas;Riešutėliai;75872222695;Taip;0;1;0;1
18370;Spygliukas;Riešutėliai;14061921481;Taip;0;0;1;1
18371;Spygliukas;Riešutėliai;73975304558;Taip;0;5;0;5
18372;Spygliukas;Riešutėliai;77665543739;Taip;0;5;0;5
18373;Spygliukas;Riešutėliai;84487759175;Taip;2;4;1;7
18374;Spygliukas;Riešutėliai;1580382515;Taip;5;11;0;16
18375;Spygliukas;Riešutėliai;4219250715;Taip;5;0;0;5
18376;Spygliukas;Riešutėliai;1429385840;Taip;6;9;0;15
18377;Spygliukas;Pelėdžiukai;91102341053;Taip;0;5;0;5
18378;Spygliukas;Pelėdžiukai;6104639970;Taip;5;5;0;10
18379;Spygliukas;Pelėdžiukai;85751149838;Taip;6;5;0;11
18380;Spygliukas;Pelėdžiukai;17541702082;Ne;0;7;0;7
18381;Spygliukas;Pelėdžiukai;20304216159;Taip;0;5;1;6
18382;Spygliukas;Pelėdžiukai;7675515299;Taip;0;4;0;4
18383;Spygliukas;Pelėdžiukai;78680910249;Taip;4;4;0;8
18384;Spygliukas;Pelėdžiukai;88974807409;Taip;0;1;0;1
18385;Spygliukas;Pelėdžiukai;66170193369;Ne;0;8;0;8
18386;Spygliukas;Pelėdžiukai;95031107059;Taip;0;5;0;5
18387;Spygliukas;Pelėdžiukai;33559493599;Taip;2;1;2;5
18388;Spygliukas;Pelėdžiukai;41129167567;Taip;0;6;0;6
18389;Spygliukas;Pelėdžiukai;54932584770;Taip;20;0;0;20
18390;Spygliukas;Pelėdžiukai;31918025260;Taip;10;7;0;17
18391;Spygliukas;Pelėdžiukai;57098709793;Taip;0;6;0;6
18392;Spygliukas;Pelėdžiukai;96967766273;Taip;0;11;0;11
18393;Spygliukas;Pelėdžiukai;1447408559;Taip;0;5;0;5
18394;Spygliukas;Pelėdžiukai;63899991046;Taip;15;1;0;16
18395;Spygliukas;Pelėdžiukai;8252228033;Taip;4;5;0;9
18396;Spygliukas;Pelėdžiukai;67896776952;Taip;0;8;0;8
18397;Spygliukas;Zylutės;6242194100;Taip;7;0;1;8
18398;Spygliukas;Zylutės;5962360012;Taip;3;0;0;3
18399;Spygliukas;Zylutės;2739564216;Taip;16;0;0;16
18400;Spygliukas;Zylutės;2463585133;Taip;8;0;0;8
18401;Spygliukas;Zylutės;7900652746;Taip;4;0;0;4
18402;Spygliukas;Zylutės;4949371837;Taip;11;0;0;11
18403;Spygliukas;Zylutės;6457632191;Taip;20;0;0;20
18404;Spygliukas;Zylutės;4650693672;Taip;10;0;0;10
18405;Spygliukas;Zylutės;9178184431;Taip;5;0;0;5
18406;Spygliukas;Zylutės;1691209405;Taip;5;1;8;14
18407;Spygliukas;Zylutės;4577592862;Taip;20;0;0;20
18408;Spygliukas;Zylutės;4610504338;Taip;6;2;2;10
18409;Spygliukas;Zylutės;6835488489;Taip;0;0;3;3
18410;Spygliukas;Zylutės;3365209400;Taip;10;0;0;10
18411;Spygliukas;Zylutės;3658613027;Ne;0;1;1;2
18412;Spygliukas;Skruzdėliukai;2177856916;Taip;14;0;0;14
18413;Spygliukas;Skruzdėliukai;8825264090;Taip;12;1;2;15
18414;Spygliukas;Skruzdėliukai;8404929784;Taip;4;3;2;9
18415;Spygliukas;Skruzdėliukai;6931145017;Taip;11;0;0;11
18416;Spygliukas;Skruzdėliukai;3041184642;Taip;10;5;0;15
18417;Spygliukas;Skruzdėliukai;9070219319;Taip;0;8;0;8
18418;Spygliukas;Skruzdėliukai;9285259322;Taip;10;5;0;15
18419;Spygliukas;Skruzdėliukai;8806126755;Taip;2;8;0;10
18420;Spygliukas;Skruzdėliukai;8476882854;Taip;16;2;0;18
18421;Spygliukas;Skruzdėliukai;4245624629;Taip;11;0;0;11
18422;Spygliukas;Skruzdėliukai;6332646009;Taip;12;0;0;12
18423;Spygliukas;Skruzdėliukai;3706443395;Taip;0;0;1;1
18424;Spygliukas;Skruzdėliukai;9112172144;Taip;15;1;0;16
18425;Spygliukas;Skruzdėliukai;5765106914;Taip;0;1;0;1
18426;Spygliukas;Skruzdėliukai;2395961015;Taip;8;0;0;8
18427;Spygliukas;Voveraitės;5049529300;Taip;0;0;2;2
18428;Spygliukas;Voveraitės;1987926577;Taip;0;0;3;3
18429;Spygliukas;Voveraitės;1367964100;Taip;0;13;4;17
18430;Spygliukas;Voveraitės;1773639994;Taip;13;0;0;13
18431;Spygliukas;Voveraitės;2066739772;Taip;16;0;0;16
18432;Spygliukas;Voveraitės;8596667547;Taip;5;6;2;13
18433;Spygliukas;Voveraitės;1042495269;Taip;0;1;2;3
18434;Spygliukas;Voveraitės;1590677993;Taip;0;2;18;20
18435;Spygliukas;Voveraitės;1030973848;Taip;6;0;0;6
18436;Spygliukas;Voveraitės;1935233612;Taip;15;2;0;17
18437;Spygliukas;Voveraitės;8801225066;Taip;5;1;4;10
18438;Spygliukas;Voveraitės;8453683673;Ne;8;1;1;10
18439;Spygliukas;Voveraitės;4653108810;Taip;0;7;0;7
18440;Spygliukas;Voveraitės;1045253540;Taip;12;1;0;13
18441;Spygliukas;Voveraitės;2671842885;Taip;1;5;0;6
18442;Spygliukas;Voveraitės;6460911796;Taip;13;0;0;13
18443;Spygliukas;Giliukų;7271659513;Taip;16;1;0;17
18444;Spygliukas;Giliukų;8708083787;Taip;0;13;0;13
18445;Spygliukas;Giliukų;9413950200;Taip;5;6;0;11
18446;Spygliukas;Giliukų;1664878188;Taip;0;5;0;5
18447;Spygliukas;Giliukų;8604767396;Taip;10;0;1;11
18448;Spygliukas;Giliukų;4634660174;Taip;4;0;4;8
18449;Spygliukas;Giliukų;4368224847;Taip;2;0;4;6
18450;Spygliukas;Giliukų;1333556956;Taip;5;1;4;10
18451;Spygliukas;Giliukų;9316731983;Taip;0;0;5;5
18452;Spygliukas;Giliukų;5012876830;Taip;5;1;4;10
18453;Spygliukas;Giliukų;2315421636;Taip;0;0;2;2
18454;Spygliukas;Giliukų;7125425492;Taip;10;2;0;12
18455;Spygliukas;Giliukų;7928675053;Taip;11;0;0;11
18456;Spygliukas;Giliukų;1974541155;Taip;1;0;4;5
18457;Spygliukas;Giliukų;4505044604;Taip;12;0;0;12
18458;Spygliukas;Giliukų;2989701249;Taip;11;0;1;12
18459;Vieversys;Žirniukai;1149316471;Taip;0;8;0;8
18460;Vieversys;Žirniukai;1728554204;Taip;4;0;0;4
18461;Vieversys;Žirniukai;6787960120;Taip;10;0;1;11
18462;Vieversys;Žirniukai;9612415733;Taip;0;3;5;8
18463;Vieversys;Žirniukai;5917328379;Taip;8;0;1;9
18464;Vieversys;Žirniukai;53977164888;Taip;0;6;0;6
18465;Vieversys;Žirniukai;82594887399;Taip;5;5;0;10
18466;Vieversys;Žirniukai;7500147648;Taip;0;2;0;2
18467;Vieversys;Žirniukai;2621046003;Taip;0;3;1;4
18468;Vieversys;Žirniukai;9835682858;Taip;0;15;0;15
18469;Vieversys;Žirniukai;6596979763;Taip;0;1;0;1
18470;Vieversys;Žirniukai;5286521728;Taip;12;7;0;19
18471;Vieversys;Žirniukai;8038341998;Taip;0;4;0;4
18472;Vieversys;Žirniukai;1247565595;Taip;4;0;0;4
18473;Vieversys;Žirniukai;6720355390;Taip;4;2;1;7
18474;Vieversys;Žirniukai;4313822180;Taip;5;5;0;10
18475;Vieversys;Žirniukai;7812227428;Taip;0;12;1;13
18476;Vieversys;Žirniukai;5810605263;Taip;5;0;1;6
18477;Vieversys;Varpelių;38299255111;Taip;0;14;0;14
18478;Vieversys;Varpelių;62353706235;Taip;0;7;0;7
18479;Vieversys;Varpelių;45357053527;Taip;0;11;0;11
18480;Vieversys;Varpelių;34168958939;Taip;0;7;0;7
18481;Vieversys;Varpelių;14996772979;Taip;0;2;0;2
18482;Vieversys;Varpelių;23619480101;Taip;0;5;0;5
18483;Vieversys;Varpelių;35783466157;Taip;3;0;0;3
18484;Vieversys;Varpelių;44390886220;Taip;0;13;0;13
18485;Vieversys;Varpelių;46546501255;Taip;10;5;0;15
18486;Vieversys;Varpelių;82621820592;Ne;0;2;0;2
18487;Vieversys;Varpelių;34243919860;Taip;2;3;0;5
18488;Vieversys;Varpelių;19269924365;Taip;0;2;0;2
18489;Vieversys;Varpelių;22124989131;Taip;0;5;0;5
18490;Vieversys;Varpelių;47592438021;Taip;4;0;0;4
18491;Vieversys;Varpelių;99472642769;Taip;0;5;0;5
18492;Vieversys;Varpelių;33471460574;Taip;1;4;0;5
18493;Vieversys;Varpelių;69205152313;Taip;2;6;0;8
18494;Vieversys;Varpelių;24253818919;Taip;0;7;0;7
18495;Vieversys;Varpelių;12049674063;Taip;0;10;0;10
18496;Vieversys;Varpelių;27238159965;Taip;0;1;0;1
18497;Vieversys;Kiškučių;30327960835;Taip;0;7;0;7
18498;Vieversys;Kiškučių;39075572706;Taip;5;5;0;10
18499;Vieversys;Kiškučių;96715131735;Taip;0;0;1;1
18500;Vieversys;Kiškučių;64744067804;Taip;8;5;1;14
18501;Vieversys;Kiškučių;14962042306;Taip;0;12;0;12
18502;Vieversys;Kiškučių;66729897399;Taip;11;5;0;16
18503;Vieversys;Kiškučių;1718832864;Taip;0;5;0;5
18504;Vieversys;Kiškučių;1013523504;Taip;0;1;1;2
18505;Vieversys;Kiškučių;2880573300;Taip;5;6;0;11
18506;Vieversys;Kiškučių;27461921981;Taip;0;8;0;8
18507;Vieversys;Kiškučių;1239896208;Taip;0;6;0;6
18508;Vieversys;Kiškučių;1076420513;Taip;0;5;3;8
18509;Vieversys;Kiškučių;9869051482;Taip;0;0;1;1
18510;Vieversys;Kiškučių;1685871173;Taip;0;6;0;6
18511;Vieversys;Kiškučių;6589649248;Taip;15;5;0;20
18512;Vieversys;Kiškučių;6241670100;Taip;5;3;1;9
18513;Vieversys;Kiškučių;9050145547;Taip;0;5;2;7
18514;Vieversys;Kiškučių;9126904852;Taip;0;7;0;7
18515;Vieversys;Kiškučių;70851901929;Taip;0;7;0;7
18516;Vieversys;Kiškučių;81372830000;Taip;5;0;1;6
18517;Vieversys;Kiškučių;32507428250;Taip;0;5;0;5
18518;Vieversys;Kiškučių;55017305306;Taip;12;0;0;12
18519;Vieversys;Kiškučių;7445136223;Taip;8;2;0;10
18520;Vieversys;Pelėdžiukų;8421719030;Taip;10;0;0;10
18521;Vieversys;Pelėdžiukų;77272293257;Taip;10;1;0;11
18522;Vieversys;Pelėdžiukų;94463134058;Taip;0;11;0;11
18523;Vieversys;Pelėdžiukų;5434952733;Taip;15;1;0;16
18524;Vieversys;Pelėdžiukų;7578552471;Taip;10;0;0;10
18525;Vieversys;Pelėdžiukų;2193074123;Taip;0;0;3;3
18526;Vieversys;Pelėdžiukų;6314183312;Taip;5;8;0;13
18527;Vieversys;Pelėdžiukų;7007620994;Taip;8;1;0;9
18528;Vieversys;Pelėdžiukų;9499315463;Taip;11;0;0;11
18529;Vieversys;Pelėdžiukų;9774365819;Taip;0;5;0;5
18530;Vieversys;Pelėdžiukų;9494957750;Taip;10;0;0;10
18531;Vieversys;Pelėdžiukų;2521488728;Taip;6;0;0;6
18532;Vieversys;Pelėdžiukų;6473759470;Taip;0;6;0;6
18533;Vieversys;Pelėdžiukų;1120594293;Taip;0;1;0;1
18534;Vieversys;Pelėdžiukų;1273951001;Taip;0;0;7;7
18535;Vieversys;Pelėdžiukų;48430863473;Taip;0;9;0;9
18536;Vieversys;Pelėdžiukų;50181034746;Taip;8;0;1;9
18537;Vieversys;Pelėdžiukų;52420072025;Taip;9;0;0;9
18538;Vieversys;Pelėdžiukų;1027693153;Taip;8;0;0;8
18539;Vieversys;Pelėdžiukų;5871715452;Taip;0;0;1;1
18540;Vieversys;Pelėdžiukų;7676796264;Taip;0;10;0;10
18541;Vieversys;Pelėdžiukų;9659337657;Taip;4;0;1;5
18542;Vieversys;Pelėdžiukų;3458399180;Taip;5;6;0;11
18543;Vieversys;Saulučių;1541501314;Taip;0;8;0;8
18544;Vieversys;Saulučių;7570842283;Taip;0;9;0;9
18545;Vieversys;Saulučių;77521284935;Ne;0;2;2;4
18546;Vieversys;Saulučių;61390281978;Taip;0;2;1;3
18547;Vieversys;Saulučių;8356022906;Taip;0;4;0;4
18548;Vieversys;Saulučių;1061337795;Taip;4;0;0;4
18549;Vieversys;Saulučių;9504543902;Taip;0;4;2;6
18550;Vieversys;Saulučių;1015724611;Taip;0;4;2;6
18551;Vieversys;Saulučių;85223909900;Taip;0;15;0;15
18552;Vieversys;Saulučių;63958110408;Ne;0;11;0;11
18553;Vieversys;Saulučių;83781049461;Taip;0;1;0;1
18554;Vieversys;Saulučių;27991039593;Taip;10;0;0;10
18555;Vieversys;Saulučių;53189421149;Taip;0;4;0;4
18556;Vieversys;Saulučių;49209207608;Taip;0;1;0;1
18557;Vieversys;Saulučių;94076718641;Taip;0;6;0;6
18558;Vieversys;Saulučių;97077298066;Taip;13;4;0;17
18559;Vieversys;Saulučių;99897529822;Taip;0;5;0;5
18560;Vieversys;Saulučių;95352162960;Taip;10;1;0;11
18561;Vieversys;Saulučių;81494754248;Taip;2;7;0;9
18562;Vieversys;Saulučių;12419984038;Taip;0;5;0;5
18563;Vieversys;Saulučių;18608150261;Taip;0;8;0;8
18564;Vieversys;Saulučių;81766053731;Taip;0;2;0;2
18565;Vieversys;Kregždučių;55553505459;Taip;0;4;3;7
18566;Vieversys;Kregždučių;16002848795;Taip;0;4;3;7
18567;Vieversys;Kregždučių;1933907389;Taip;0;3;3;6
18568;Vieversys;Kregždučių;1462608187;Taip;8;0;0;8
18569;Vieversys;Kregždučių;2130449373;Taip;0;1;0;1
18570;Vieversys;Kregždučių;44086673096;Taip;0;5;0;5
18571;Vieversys;Kregždučių;89223502405;Taip;0;7;0;7
18572;Vieversys;Kregždučių;41215224179;Taip;1;5;3;9
18573;Vieversys;Kregždučių;938801303;Taip;0;5;0;5
18574;Vieversys;Kregždučių;2141967793;Taip;0;1;0;1
18575;Vieversys;Kregždučių;2128428329;Taip;0;1;0;1
18576;Vieversys;Kregždučių;1190396975;Taip;0;5;0;5
18577;Vieversys;Kregždučių;62465517391;Taip;0;1;0;1
18578;Vieversys;Kregždučių;5123994167;Taip;0;10;0;10
18579;Vieversys;Kregždučių;12524976076;Taip;0;4;0;4
18580;Vieversys;Kregždučių;1300013110;Taip;12;0;0;12
18581;Vieversys;Kregždučių;61101237391;Taip;3;8;0;11
18582;Vieversys;Kregždučių;1716198618;Taip;0;8;0;8
18583;Vieversys;Kregždučių;8213134622;Taip;15;5;0;20
18584;Vieversys;Kregždučių;3839507103;Taip;1;0;0;1
18585;Vieversys;Kregždučių;6077365803;Taip;0;3;0;3
18586;Vieversys;Kregždučių;46624143347;Taip;0;2;0;2
18587;Vieversys;Kregždučių;73657188876;Taip;2;0;0;2
18588;Vieversys;Boružėlių;6236703869;Taip;10;0;0;10
18589;Vieversys;Boružėlių;6116471730;Taip;10;0;0;10
18590;Vieversys;Boružėlių;1815073796;Taip;0;1;0;1
18591;Vieversys;Boružėlių;32630544785;Taip;0;2;1;3
18592;Vieversys;Boružėlių;20960056744;Taip;0;5;2;7
18593;Vieversys;Boružėlių;63262366859;Taip;0;11;0;11
18594;Vieversys;Boružėlių;58287759954;Taip;5;0;0;5
18595;Vieversys;Boružėlių;1580917200;Taip;0;11;0;11
18596;Vieversys;Boružėlių;86213464121;Taip;0;2;0;2
18597;Vieversys;Boružėlių;55764266970;Taip;20;0;0;20
18598;Vieversys;Boružėlių;86119860485;Taip;5;1;0;6
18599;Vieversys;Boružėlių;14574836082;Taip;0;2;0;2
18600;Vieversys;Boružėlių;95886969053;Taip;0;7;0;7
18601;Vieversys;Boružėlių;5197639355;Taip;3;5;3;11
18602;Vieversys;Boružėlių;15473504836;Taip;12;0;0;12
18603;Vieversys;Boružėlių;1700010494;Taip;0;9;0;9
18604;Vieversys;Boružėlių;1715902540;Taip;15;4;0;19
18605;Vieversys;Bitučių;75434941104;Taip;5;3;0;8
18606;Vieversys;Bitučių;25198979253;Taip;0;6;0;6
18607;Vieversys;Bitučių;2034386236;Taip;5;8;0;13
18608;Vieversys;Bitučių;83420473111;Taip;0;6;1;7
18609;Vieversys;Bitučių;22717987850;Taip;15;0;0;15
18610;Vieversys;Bitučių;26092685300;Taip;0;5;0;5
18611;Vieversys;Bitučių;56670426557;Taip;0;3;0;3
18612;Vieversys;Bitučių;93582609868;Taip;5;5;0;10
18613;Vieversys;Bitučių;72651951788;Taip;15;0;0;15
18614;Vieversys;Bitučių;22275121492;Taip;0;3;0;3
18615;Vieversys;Bitučių;35144734547;Taip;0;0;1;1
18616;Vieversys;Bitučių;34494816770;Taip;0;1;1;2
18617;Vieversys;Bitučių;27123496741;Taip;0;7;0;7
18618;Vieversys;Bitučių;63139698249;Taip;0;10;0;10
18619;Vieversys;Bitučių;66155667200;Taip;10;0;0;10
18620;Vieversys;Bitučių;68374560306;Taip;0;1;0;1
18621;Vieversys;Bitučių;7126970560;Taip;0;7;0;7
18622;Vieversys;Bitučių;61951858540;Taip;0;0;1;1
18623;Vieversys;Bitučių;5157022077;Taip;0;4;0;4
18624;Vieversys;Bitučių;1371669237;Taip;0;9;0;9
18625;Vieversys;Smalsučių;15665213757;Taip;0;6;0;6
18626;Vieversys;Smalsučių;89564962534;Taip;0;5;2;7
18627;Vieversys;Smalsučių;8966153890;Taip;0;4;0;4
18628;Vieversys;Smalsučių;65696183376;Taip;0;1;1;2
18629;Vieversys;Smalsučių;50929651251;Taip;0;8;0;8
18630;Vieversys;Smalsučių;65625227882;Taip;5;0;0;5
18631;Vieversys;Smalsučių;29002693436;Taip;0;5;4;9
18632;Vieversys;Smalsučių;84134333980;Taip;0;2;0;2
18633;Vieversys;Smalsučių;41282339758;Taip;4;2;0;6
18634;Vieversys;Smalsučių;2733479642;Taip;8;2;0;10
18635;Vieversys;Smalsučių;25843076066;Taip;0;1;0;1
18636;Vieversys;Smalsučių;72475350152;Taip;0;4;0;4
18637;Vieversys;Smalsučių;61074394922;Taip;1;0;0;1
18638;Vieversys;Smalsučių;11528430680;Taip;0;5;0;5
18639;Vieversys;Smalsučių;67471794738;Taip;0;5;0;5
18640;Vieversys;Smalsučių;13768739410;Taip;0;8;0;8
18641;Vieversys;Smalsučių;45707453869;Taip;4;1;0;5
18642;Vieversys;Smalsučių;79197759451;Taip;5;2;0;7
18643;Vieversys;Smalsučių;25507613416;Ne;0;3;0;3
18644;Vieversys;Smalsučių;6427430220;Taip;10;5;5;20
18645;Vieversys;Smalsučių;2010825247;Taip;0;7;7;14
18646;Vieversys;Smalsučių;2561825171;Taip;4;0;0;4
18647;Vieversys;Smalsučių;1025794194;Taip;9;0;0;9
18648;Vieversys;Kodėlčiukų;2006826758;Taip;6;2;0;8
18649;Vieversys;Kodėlčiukų;3907748584;Taip;0;1;0;1
18650;Vieversys;Kodėlčiukų;16928192553;Taip;8;7;0;15
18651;Vieversys;Kodėlčiukų;42562816168;Taip;3;0;0;3
18652;Vieversys;Kodėlčiukų;2756075736;Taip;0;2;0;2
18653;Vieversys;Kodėlčiukų;69275621813;Taip;9;9;0;18
18654;Vieversys;Kodėlčiukų;1455615413;Taip;0;3;3;6
18655;Vieversys;Kodėlčiukų;1970088958;Taip;6;4;0;10
18656;Vieversys;Kodėlčiukų;1586720551;Taip;10;0;0;10
18657;Vieversys;Kodėlčiukų;9012978017;Taip;1;8;0;9
18658;Vieversys;Kodėlčiukų;1738313365;Taip;0;4;1;5
18659;Vieversys;Kodėlčiukų;1766638116;Taip;0;13;1;14
18660;Vieversys;Kodėlčiukų;1599787985;Taip;0;3;0;3
18661;Vieversys;Kodėlčiukų;1491424075;Taip;7;0;2;9
18662;Vieversys;Kodėlčiukų;1361494430;Taip;0;5;3;8
18663;Vieversys;Kodėlčiukų;9829388743;Taip;0;13;0;13
18664;Vieversys;Kodėlčiukų;1878278158;Taip;10;0;0;10
18665;Vieversys;Kodėlčiukų;7315438787;Taip;0;8;0;8
18666;Vieversys;Kodėlčiukų;93675768307;Taip;5;4;0;9
18667;Vieversys;NYKŠTUKAI;5769453869;Taip;0;11;0;11
18668;Vieversys;NYKŠTUKAI;5922485482;Taip;15;3;1;19
18669;Vieversys;NYKŠTUKAI;9164615794;Taip;0;11;0;11
18670;Vieversys;NYKŠTUKAI;2096514775;Taip;5;0;0;5
18671;Vieversys;NYKŠTUKAI;3684937630;Taip;9;2;0;11
18672;Vieversys;NYKŠTUKAI;6563139211;Taip;5;2;0;7
18673;Vieversys;NYKŠTUKAI;4294676988;Taip;7;1;0;8
18674;Vieversys;NYKŠTUKAI;4835022593;Taip;0;2;0;2
18675;Vieversys;NYKŠTUKAI;4778339658;Taip;5;15;0;20
18676;Vieversys;NYKŠTUKAI;3249717073;Taip;10;5;0;15
18677;Vieversys;NYKŠTUKAI;7120329258;Taip;10;5;0;15
18678;Vieversys;NYKŠTUKAI;9387421639;Taip;13;1;0;14
18679;Vieversys;NYKŠTUKAI;8174124875;Taip;11;1;0;12
18680;Vieversys;NYKŠTUKAI;4187114865;Taip;1;0;0;1
18681;Vieversys;DRUGELIAI;4024758152;Taip;0;1;0;1
18682;Vieversys;DRUGELIAI;3405502715;Taip;12;0;0;12
18683;Vieversys;DRUGELIAI;6127272124;Taip;0;0;1;1
18684;Vieversys;DRUGELIAI;5654533451;Taip;0;5;0;5
18685;Vieversys;DRUGELIAI;9972526744;Taip;0;7;0;7
18686;Vieversys;DRUGELIAI;9985374057;Taip;3;0;0;3
18687;Vieversys;DRUGELIAI;7998100115;Taip;0;5;4;9
18688;Vieversys;DRUGELIAI;7048475906;Taip;0;0;2;2
18689;Vieversys;DRUGELIAI;6031200259;Taip;1;1;0;2
18690;Vieversys;DRUGELIAI;6110034652;Taip;4;2;1;7
18691;Vieversys;DRUGELIAI;7596355010;Taip;0;14;0;14
18692;Vieversys;DRUGELIAI;4072323869;Taip;8;6;0;14
18693;Vieversys;DRUGELIAI;1931955562;Taip;0;4;1;5
18694;Žirmūnėliai;SAULUTĖS;8030469722;Taip;9;2;1;12
18695;Žirmūnėliai;SAULUTĖS;1258769646;Taip;2;0;0;2
18696;Žirmūnėliai;SAULUTĖS;3166454638;Taip;2;0;0;2
18697;Žirmūnėliai;SAULUTĖS;73664204182;Taip;0;4;0;4
18698;Žirmūnėliai;SAULUTĖS;1725143117;Taip;10;5;0;15
18699;Žirmūnėliai;SAULUTĖS;1073135587;Taip;0;9;0;9
18700;Žirmūnėliai;SAULUTĖS;4598761492;Taip;0;14;0;14
18701;Žirmūnėliai;SAULUTĖS;3128190518;Taip;6;5;1;12
18702;Žirmūnėliai;SAULUTĖS;8317328771;Taip;0;5;0;5
18703;Žirmūnėliai;SAULUTĖS;7562464310;Taip;11;5;1;17
18704;Žirmūnėliai;SAULUTĖS;1478039469;Taip;18;0;0;18
18705;Žirmūnėliai;SAULUTĖS;6896145409;Taip;11;0;0;11
18706;Žirmūnėliai;SAULUTĖS;1255857051;Taip;3;0;0;3
18707;Žirmūnėliai;SAULUTĖS;72738770293;Taip;5;0;0;5
18708;Žirmūnėliai;SAULUTĖS;5009619812;Taip;7;2;0;9
18709;Žirmūnėliai;SAULUTĖS;4517290068;Taip;6;2;0;8
18710;Žirmūnėliai;SAULUTĖS;1582563837;Taip;4;1;2;7
18711;Žirmūnėliai;SAULUTĖS;1381923106;Taip;10;0;0;10
18712;Žirmūnėliai;SAULUTĖS;5037669167;Taip;15;0;3;18
18713;Žirmūnėliai;SAULUTĖS;1761284228;Taip;5;0;0;5
18714;Žirmūnėliai;SAULUTĖS;41018224936;Taip;5;0;0;5
18715;Žirmūnėliai;SAULUTĖS;1894070647;Taip;0;10;0;10
18716;Žirmūnėliai;SAULUTĖS;1347664230;Taip;5;2;0;7
18717;Žirmūnėliai;GILIUKAI;37231106844;Taip;5;0;0;5
18718;Žirmūnėliai;GILIUKAI;5673929155;Taip;0;7;0;7
18719;Žirmūnėliai;GILIUKAI;50829749038;Taip;0;5;0;5
18720;Žirmūnėliai;GILIUKAI;68678277635;Taip;9;5;0;14
18721;Žirmūnėliai;GILIUKAI;1818060330;Taip;0;10;0;10
18722;Žirmūnėliai;GILIUKAI;1963980356;Taip;0;4;0;4
18723;Žirmūnėliai;GILIUKAI;1302040861;Taip;0;2;0;2
18724;Žirmūnėliai;GILIUKAI;17294365627;Taip;8;0;0;8
18725;Žirmūnėliai;GILIUKAI;99546532431;Taip;0;10;0;10
18726;Žirmūnėliai;GILIUKAI;1816123753;Taip;0;6;0;6
18727;Žirmūnėliai;GILIUKAI;1308593517;Taip;0;2;0;2
18728;Žirmūnėliai;GILIUKAI;53028161711;Taip;0;9;2;11
18729;Žirmūnėliai;GILIUKAI;6578685370;Taip;7;1;0;8
18730;Žirmūnėliai;GILIUKAI;1493536049;Taip;0;5;0;5
18731;Žirmūnėliai;GILIUKAI;1626619024;Taip;6;2;0;8
18732;Žirmūnėliai;GILIUKAI;8824743884;Taip;0;2;0;2
18733;Žirmūnėliai;GILIUKAI;1039316424;Taip;0;5;0;5
18734;Žirmūnėliai;GILIUKAI;2117670819;Taip;20;0;0;20
18735;Žirmūnėliai;DAINORĖLIAI;31231655300;Taip;10;5;3;18
18736;Žirmūnėliai;DAINORĖLIAI;1563132542;Taip;0;0;13;13
18737;Žirmūnėliai;DAINORĖLIAI;1235090013;Taip;10;0;0;10
18738;Žirmūnėliai;DAINORĖLIAI;6274222785;Taip;2;5;1;8
18739;Žirmūnėliai;DAINORĖLIAI;1395294607;Taip;0;5;0;5
18740;Žirmūnėliai;DAINORĖLIAI;7777166572;Taip;0;2;2;4
18741;Žirmūnėliai;DAINORĖLIAI;4136421440;Taip;0;9;0;9
18742;Žirmūnėliai;DAINORĖLIAI;36822027549;Taip;0;0;13;13
18743;Žirmūnėliai;DAINORĖLIAI;33296480709;Taip;9;0;1;10
18744;Žirmūnėliai;DAINORĖLIAI;58158145123;Taip;0;2;1;3
18745;Žirmūnėliai;DAINORĖLIAI;1017903291;Taip;0;14;0;14
18746;Žirmūnėliai;DAINORĖLIAI;52524235797;Taip;7;0;0;7
18747;Žirmūnėliai;DAINORĖLIAI;5450253994;Taip;5;0;0;5
18748;Žirmūnėliai;DAINORĖLIAI;97123184267;Taip;5;0;2;7
18749;Žirmūnėliai;DAINORĖLIAI;81408646754;Taip;0;4;0;4
18750;Žirmūnėliai;DAINORĖLIAI;67024451309;Taip;0;0;2;2
18751;Žirmūnėliai;DAINORĖLIAI;87693490164;Taip;20;0;0;20
18752;Žirmūnėliai;DAINORĖLIAI;39347099487;Taip;10;4;0;14
18753;Žirmūnėliai;DAINORĖLIAI;6380354636;Taip;7;0;0;7
18754;Žirmūnėliai;DAINORĖLIAI;2548081116;Taip;0;0;16;16
18755;Žirmūnėliai;DRUGELIAI;5276699877;Taip;10;5;0;15
18756;Žirmūnėliai;DRUGELIAI;6531982232;Taip;0;5;0;5
18757;Žirmūnėliai;DRUGELIAI;57457297276;Taip;0;6;0;6
18758;Žirmūnėliai;DRUGELIAI;20851917855;Taip;0;11;0;11
18759;Žirmūnėliai;DRUGELIAI;26463655365;Taip;0;6;1;7
18760;Žirmūnėliai;DRUGELIAI;28826938550;Taip;0;0;7;7
18761;Žirmūnėliai;DRUGELIAI;12766765793;Taip;0;16;0;16
18762;Žirmūnėliai;DRUGELIAI;51268874840;Taip;0;9;0;9
18763;Žirmūnėliai;DRUGELIAI;45541156029;Taip;0;7;4;11
18764;Žirmūnėliai;DRUGELIAI;30933761145;Taip;0;5;0;5
18765;Žirmūnėliai;DRUGELIAI;20902834369;Taip;0;5;0;5
18766;Žirmūnėliai;DRUGELIAI;63972399637;Taip;0;2;0;2
18767;Žirmūnėliai;DRUGELIAI;33441696614;Taip;5;0;0;5
18768;Žirmūnėliai;DRUGELIAI;96121856269;Taip;0;1;0;1
18769;Žirmūnėliai;DRUGELIAI;86142962074;Taip;0;12;0;12
18770;Žirmūnėliai;DRUGELIAI;32213803056;Taip;0;8;0;8
18771;Žirmūnėliai;DRUGELIAI;61531418513;Taip;0;6;1;7
18772;Žirmūnėliai;DRUGELIAI;1157270725;Taip;0;12;0;12
18773;Žirmūnėliai;BORUŽIUKAI;78370998321;Taip;0;4;2;6
18774;Žirmūnėliai;BORUŽIUKAI;1829748362;Taip;4;0;0;4
18775;Žirmūnėliai;BORUŽIUKAI;1372276406;Taip;4;0;0;4
18776;Žirmūnėliai;BORUŽIUKAI;1035797918;Taip;0;3;3;6
18777;Žirmūnėliai;BORUŽIUKAI;18304538215;Taip;9;5;0;14
18778;Žirmūnėliai;BORUŽIUKAI;95773705800;Taip;0;4;3;7
18779;Žirmūnėliai;BORUŽIUKAI;8102425956;Taip;0;5;0;5
18780;Žirmūnėliai;BORUŽIUKAI;90766071337;Taip;0;16;0;16
18781;Žirmūnėliai;BORUŽIUKAI;15975463125;Taip;0;16;0;16
18782;Žirmūnėliai;BORUŽIUKAI;1657682030;Taip;0;2;0;2
18783;Žirmūnėliai;BORUŽIUKAI;19381396167;Taip;0;14;0;14
18784;Žirmūnėliai;BORUŽIUKAI;56898425468;Taip;0;8;0;8
18785;Žirmūnėliai;BORUŽIUKAI;50544167833;Taip;0;1;1;2
18786;Žirmūnėliai;BORUŽIUKAI;80136538031;Taip;0;8;0;8
18787;Žirmūnėliai;BORUŽIUKAI;21555650432;Taip;3;5;2;10
18788;Žirmūnėliai;BORUŽIUKAI;74577288891;Taip;10;0;0;10
18789;Žirmūnėliai;BORUŽIUKAI;66321657576;Taip;0;5;0;5
18790;Žirmūnėliai;BORUŽIUKAI;86703668087;Taip;0;8;0;8
18791;Žirmūnėliai;BORUŽIUKAI;53551605972;Taip;0;0;2;2
18792;Žirmūnėliai;BORUŽIUKAI;39102695648;Taip;0;15;0;15
18793;Žirmūnėliai;EŽIUKAI;92309760554;Taip;0;6;1;7
18794;Žirmūnėliai;EŽIUKAI;44456428269;Taip;0;0;3;3
18795;Žirmūnėliai;EŽIUKAI;35616673148;Taip;0;6;0;6
18796;Žirmūnėliai;EŽIUKAI;48862129796;Taip;0;3;0;3
18797;Žirmūnėliai;EŽIUKAI;54806598855;Taip;0;9;6;15
18798;Žirmūnėliai;EŽIUKAI;46197353715;Taip;0;11;0;11
18799;Žirmūnėliai;EŽIUKAI;17545423567;Taip;0;5;9;14
18800;Žirmūnėliai;EŽIUKAI;52242309849;Taip;0;1;1;2
18801;Žirmūnėliai;EŽIUKAI;3383950115;Taip;0;5;1;6
18802;Žirmūnėliai;EŽIUKAI;20369719665;Taip;0;3;0;3
18803;Žirmūnėliai;EŽIUKAI;33734698275;Taip;5;1;0;6
18804;Žirmūnėliai;EŽIUKAI;83168188715;Taip;0;20;0;20
18805;Žirmūnėliai;EŽIUKAI;61198138773;Taip;0;7;0;7
18806;Žirmūnėliai;EŽIUKAI;58752542772;Taip;0;5;0;5
18807;Žirmūnėliai;ŽVIRBLIUKAI;19423526288;Taip;0;7;0;7
18808;Žirmūnėliai;ŽVIRBLIUKAI;62973311453;Taip;0;12;0;12
18809;Žirmūnėliai;ŽVIRBLIUKAI;15705213099;Taip;3;0;0;3
18810;Žirmūnėliai;ŽVIRBLIUKAI;60871701395;Taip;8;1;0;9
18811;Žirmūnėliai;ŽVIRBLIUKAI;30822135334;Taip;0;7;1;8
18812;Žirmūnėliai;ŽVIRBLIUKAI;55413493068;Taip;5;9;0;14
18813;Žirmūnėliai;ŽVIRBLIUKAI;77610647849;Taip;2;2;0;4
18814;Žirmūnėliai;ŽVIRBLIUKAI;39786518345;Taip;3;1;0;4
18815;Žirmūnėliai;ŽVIRBLIUKAI;53003464638;Taip;5;2;0;7
18816;Žirmūnėliai;ŽVIRBLIUKAI;49856210236;Taip;0;10;0;10
18817;Žirmūnėliai;ŽVIRBLIUKAI;34535851773;Taip;5;0;0;5
18818;Žirmūnėliai;ŽVIRBLIUKAI;1150419333;Taip;0;1;0;1
18819;Žirmūnėliai;ŽVIRBLIUKAI;6262600436;Taip;0;1;3;4
18820;Žirmūnėliai;ŽVIRBLIUKAI;73552867802;Taip;0;7;0;7
18821;Žirmūnėliai;ŽVIRBLIUKAI;38316483993;Taip;4;1;0;5
18822;Žirmūnėliai;ŽVIRBLIUKAI;1250060420;Taip;10;5;0;15
18823;Žirmūnėliai;ŽVIRBLIUKAI;1477593223;Taip;0;5;0;5
18824;Žirmūnėliai;ŽVIRBLIUKAI;3896978775;Taip;5;0;1;6
18825;Žirmūnėliai;ŽVIRBLIUKAI;7165846395;Taip;14;1;0;15
18826;Žirmūnėliai;ŽVIRBLIUKAI;1049041500;Taip;10;0;0;10
18827;Žirmūnėliai;ŽVIRBLIUKAI;50088185187;Taip;0;10;0;10
18828;Žirmūnėliai;SPALVELĖS;88436070676;Taip;0;7;1;8
18829;Žirmūnėliai;SPALVELĖS;18266666204;Taip;0;4;0;4
18830;Žirmūnėliai;SPALVELĖS;2538608908;Taip;0;5;0;5
18831;Žirmūnėliai;SPALVELĖS;22592450568;Taip;0;7;0;7
18832;Žirmūnėliai;SPALVELĖS;66100956443;Taip;0;0;1;1
18833;Žirmūnėliai;SPALVELĖS;85286691926;Taip;0;9;0;9
18834;Žirmūnėliai;SPALVELĖS;4986702792;Taip;0;5;0;5
18835;Žirmūnėliai;SPALVELĖS;86501162211;Taip;2;1;0;3
18836;Žirmūnėliai;SPALVELĖS;3691651489;Taip;2;1;11;14
18837;Žirmūnėliai;SPALVELĖS;1120531178;Taip;4;0;0;4
18838;Žirmūnėliai;SPALVELĖS;1273301982;Taip;0;9;0;9
18839;Žirmūnėliai;SPALVELĖS;29952298800;Taip;10;0;8;18
18840;Žirmūnėliai;SPALVELĖS;8348616350;Taip;5;0;0;5
18841;Žirmūnėliai;SPALVELĖS;1080735912;Taip;0;13;0;13
18842;Žirmūnėliai;SPALVELĖS;2127930970;Taip;0;5;0;5
18843;Žirmūnėliai;SPALVELĖS;4710829908;Taip;0;2;0;2
18844;Žirmūnėliai;SPALVELĖS;7918747416;Taip;9;0;0;9
18845;Žirmūnėliai;SPALVELĖS;1865240339;Taip;11;1;0;12
18846;Žirmūnėliai;SPALVELĖS;8339819296;Taip;5;0;0;5
18847;Žirmūnėliai;SPALVELĖS;51723882387;Taip;3;0;0;3
18848;Žirmūnėliai;SPALVELĖS;8308074932;Taip;10;4;0;14
18849;Žirmūnėliai;DEBESĖLIAI;37429281370;Taip;5;5;0;10
18850;Žirmūnėliai;DEBESĖLIAI;19044383213;Taip;2;0;0;2
18851;Žirmūnėliai;DEBESĖLIAI;76779474158;Taip;20;0;0;20
18852;Žirmūnėliai;DEBESĖLIAI;18242077086;Taip;0;6;0;6
18853;Žirmūnėliai;DEBESĖLIAI;64969220116;Taip;0;18;0;18
18854;Žirmūnėliai;DEBESĖLIAI;1690539251;Taip;0;10;0;10
18855;Žirmūnėliai;DEBESĖLIAI;1542147528;Taip;5;0;0;5
18856;Žirmūnėliai;DEBESĖLIAI;5527904792;Taip;5;15;0;20
18857;Žirmūnėliai;DEBESĖLIAI;6161223611;Taip;2;0;0;2
18858;Žirmūnėliai;DEBESĖLIAI;2263604297;Taip;0;7;0;7
18859;Žirmūnėliai;DEBESĖLIAI;1885292520;Taip;3;0;0;3
18860;Žirmūnėliai;DEBESĖLIAI;1618573494;Taip;20;0;0;20
18861;Žirmūnėliai;DEBESĖLIAI;5611315994;Taip;10;0;5;15
18862;Žirmūnėliai;DEBESĖLIAI;6337036947;Taip;2;0;0;2
18863;Žirmūnėliai;DEBESĖLIAI;2739395691;Taip;8;5;3;16
18864;Žirmūnėliai;DEBESĖLIAI;7528704460;Taip;10;0;5;15
18865;Žirmūnėliai;DEBESĖLIAI;8623037038;Taip;0;0;1;1
18866;Žirmūnėliai;DEBESĖLIAI;3006508357;Taip;2;0;2;4
18867;Žirmūnėliai;DEBESĖLIAI;5125341440;Taip;0;6;1;7
18868;Žirmūnėliai;VIŠČIUKAI;6493142538;Taip;4;0;0;4
18869;Žirmūnėliai;VIŠČIUKAI;7892626521;Taip;5;5;0;10
18870;Žirmūnėliai;VIŠČIUKAI;1655437833;Taip;15;0;0;15
18871;Žirmūnėliai;VIŠČIUKAI;8999160836;Taip;6;2;0;8
18872;Žirmūnėliai;VIŠČIUKAI;8209309240;Taip;0;6;5;11
18873;Žirmūnėliai;VIŠČIUKAI;2693415717;Taip;0;0;3;3
18874;Žirmūnėliai;VIŠČIUKAI;8930536051;Taip;15;0;0;15
18875;Žirmūnėliai;VIŠČIUKAI;2837129621;Taip;14;0;1;15
18876;Žirmūnėliai;VIŠČIUKAI;2971175236;Taip;0;0;1;1
18877;Žirmūnėliai;VIŠČIUKAI;7953019230;Taip;11;5;0;16
18878;Žirmūnėliai;VIŠČIUKAI;6982109508;Taip;4;0;2;6
18879;Žirmūnėliai;VIŠČIUKAI;9478256549;Taip;15;1;4;20
18880;Žirmūnėliai;VIŠČIUKAI;5090067954;Taip;7;0;0;7
18881;Žirmūnėliai;VIŠČIUKAI;7422544482;Taip;5;0;0;5
18882;Žirmūnėliai;ZUIKUČIŲ;9378860669;Taip;10;0;0;10
18883;Žirmūnėliai;ZUIKUČIŲ;4218266688;Taip;5;0;0;5
18884;Žirmūnėliai;ZUIKUČIŲ;8607934394;Taip;0;1;2;3
18885;Žirmūnėliai;ZUIKUČIŲ;3449815783;Taip;5;1;0;6
18886;Žirmūnėliai;ZUIKUČIŲ;7996709950;Taip;0;8;0;8
18887;Žirmūnėliai;ZUIKUČIŲ;4638575301;Taip;3;5;2;10
18888;Žirmūnėliai;ZUIKUČIŲ;3562689670;Taip;1;8;0;9
18889;Žirmūnėliai;ZUIKUČIŲ;7020486370;Taip;5;0;0;5
18890;Žirmūnėliai;ZUIKUČIŲ;3274576752;Taip;12;2;4;18
18891;Žirmūnėliai;ZUIKUČIŲ;9541122034;Taip;0;3;0;3
18892;Žirmūnėliai;ZUIKUČIŲ;1571242696;Taip;6;0;0;6
18893;Žirmūnėliai;ZUIKUČIŲ;5736502380;Taip;5;2;1;8
18894;Žirmūnėliai;ZUIKUČIŲ;9154874729;Taip;6;2;1;9
18895;Žirmūnėliai;ZUIKUČIŲ;5723289396;Taip;6;0;4;10
18896;Žirmūnėliai;OBUOLIUKAI;9666769523;Taip;5;11;0;16
18897;Žirmūnėliai;OBUOLIUKAI;2349860704;Taip;0;0;19;19
18898;Žirmūnėliai;OBUOLIUKAI;24877884441;Taip;0;12;0;12
18899;Žirmūnėliai;OBUOLIUKAI;85408994677;Taip;0;5;0;5
18900;Žirmūnėliai;OBUOLIUKAI;2336720944;Taip;3;2;3;8
18901;Žirmūnėliai;OBUOLIUKAI;1110585472;Taip;0;0;2;2
18902;Žirmūnėliai;OBUOLIUKAI;93072181228;Taip;5;1;0;6
18903;Žirmūnėliai;OBUOLIUKAI;1259227112;Taip;5;0;0;5
18904;Žirmūnėliai;OBUOLIUKAI;155054610;Taip;0;0;1;1
18905;Žirmūnėliai;OBUOLIUKAI;89429083939;Taip;0;1;0;1
18906;Žirmūnėliai;OBUOLIUKAI;35353356752;Taip;5;0;0;5
18907;Žirmūnėliai;OBUOLIUKAI;4030572434;Taip;0;7;0;7
18908;Žirmūnėliai;OBUOLIUKAI;6758118659;Taip;0;7;0;7
18909;Žirmūnėliai;OBUOLIUKAI;24035212527;Taip;0;4;4;8
18910;Žirmūnėliai;OBUOLIUKAI;53081289792;Taip;0;5;0;5
18911;Žirmūnėliai;OBUOLIUKAI;65907675470;Taip;7;1;6;14
18912;Žirmūnėliai;OBUOLIUKAI;4675716163;Taip;5;5;6;16
18913;Žirmūnėliai;OBUOLIUKAI;2216383670;Taip;16;0;0;16
18914;Žirmūnėliai;OBUOLIUKAI;9232201424;Taip;7;2;0;9
18915;Žirmūnėliai;OBUOLIUKAI;9448136354;Taip;0;6;6;12
18916;Dainorėliai;SAULUTĖS;79461209783;Ne;0;5;0;5
18917;Dainorėliai;SAULUTĖS;18741625569;Ne;0;5;0;5
18918;Dainorėliai;SAULUTĖS;98830139164;Taip;0;6;1;7
18919;Dainorėliai;SAULUTĖS;8762386907;Taip;2;7;0;9
18920;Dainorėliai;SAULUTĖS;15654726109;Taip;2;6;0;8
18921;Dainorėliai;SAULUTĖS;10679627657;Taip;0;5;0;5
18922;Dainorėliai;SAULUTĖS;37708779599;Taip;5;1;1;7
18923;Dainorėliai;SAULUTĖS;84424772471;Taip;0;1;1;2
18924;Dainorėliai;SAULUTĖS;98796240124;Taip;0;3;0;3
18925;Dainorėliai;SAULUTĖS;69556449215;Taip;4;5;0;9
18926;Dainorėliai;SAULUTĖS;84084897419;Taip;0;6;0;6
18927;Dainorėliai;SAULUTĖS;34686211072;Taip;0;6;0;6
18928;Dainorėliai;SAULUTĖS;64977015444;Taip;5;4;0;9
18929;Dainorėliai;SAULUTĖS;47323045857;Taip;0;5;0;5
18930;Dainorėliai;SAULUTĖS;18744882489;Taip;0;5;0;5
18931;Dainorėliai;SAULUTĖS;25073134850;Taip;5;3;0;8
18932;Dainorėliai;SAULUTĖS;37660372564;Taip;0;2;2;4
18933;Dainorėliai;SAULUTĖS;84999972369;Taip;0;5;0;5
18934;Dainorėliai;SAULUTĖS;69732047046;Taip;11;0;0;11
18935;Dainorėliai;SAULUTĖS;42491409881;Taip;0;1;0;1
18936;Dainorėliai;SAULUTĖS;13138644060;Taip;4;1;0;5
18937;Dainorėliai;SAULUTĖS;5155175570;Taip;0;5;0;5
18938;Dainorėliai;SAULUTĖS;92644746397;Taip;0;6;0;6
18939;Dainorėliai;SAULUTĖS;2922026996;Taip;4;0;0;4
18940;Dainorėliai;SAULUTĖS;1889037823;Taip;8;1;0;9
18941;Dainorėliai;SAULUTĖS;2441164154;Taip;15;5;0;20
18942;Dainorėliai;VARPELIAI;11506295275;Taip;0;7;0;7
18943;Dainorėliai;VARPELIAI;87242570532;Taip;5;1;0;6
18944;Dainorėliai;VARPELIAI;18233813290;Taip;6;5;0;11
18945;Dainorėliai;VARPELIAI;6176171443;Taip;5;3;0;8
18946;Dainorėliai;VARPELIAI;88781762328;Taip;16;1;0;17
18947;Dainorėliai;VARPELIAI;9319771186;Taip;20;0;0;20
18948;Dainorėliai;VARPELIAI;8719834064;Taip;9;6;0;15
18949;Dainorėliai;VARPELIAI;5693385617;Taip;0;9;1;10
18950;Dainorėliai;VARPELIAI;8267213392;Taip;0;8;0;8
18951;Dainorėliai;VARPELIAI;5959380807;Taip;0;2;5;7
18952;Dainorėliai;VARPELIAI;2938732886;Taip;0;5;0;5
18953;Dainorėliai;VARPELIAI;3183793211;Taip;0;7;0;7
18954;Dainorėliai;VARPELIAI;2797544232;Taip;0;2;2;4
18955;Dainorėliai;VARPELIAI;65467351140;Taip;0;7;8;15
18956;Dainorėliai;VARPELIAI;8521878734;Taip;10;6;0;16
18957;Dainorėliai;VARPELIAI;1928369859;Taip;5;0;1;6
18958;Dainorėliai;VARPELIAI;6909583023;Taip;5;0;1;6
18959;Dainorėliai;VARPELIAI;6430425182;Taip;0;2;4;6
18960;Dainorėliai;VARPELIAI;4269946363;Taip;15;0;0;15
18961;Dainorėliai;VARPELIAI;1088248393;Taip;0;2;0;2
18962;Dainorėliai;ŽIOGELIAI;99597416067;Taip;3;5;0;8
18963;Dainorėliai;ŽIOGELIAI;88201007119;Taip;0;7;0;7
18964;Dainorėliai;ŽIOGELIAI;31267856584;Taip;0;5;0;5
18965;Dainorėliai;ŽIOGELIAI;87717571411;Taip;5;4;0;9
18966;Dainorėliai;ŽIOGELIAI;18936645521;Ne;0;8;2;10
18967;Dainorėliai;ŽIOGELIAI;35528654099;Taip;0;2;0;2
18968;Dainorėliai;ŽIOGELIAI;16780418740;Ne;9;2;0;11
18969;Dainorėliai;ŽIOGELIAI;29132059636;Taip;0;5;0;5
18970;Dainorėliai;ŽIOGELIAI;32573583030;Taip;0;5;1;6
18971;Dainorėliai;ŽIOGELIAI;1470784692;Taip;0;1;0;1
18972;Dainorėliai;ŽIOGELIAI;35134511946;Ne;0;0;1;1
18973;Dainorėliai;ŽIOGELIAI;67124516230;Taip;10;8;0;18
18974;Dainorėliai;ŽIOGELIAI;17358842027;Taip;5;1;0;6
18975;Dainorėliai;ŽIOGELIAI;54344466523;Taip;0;0;3;3
18976;Dainorėliai;ŽIOGELIAI;63211091321;Taip;0;5;0;5
18977;Dainorėliai;ŽIOGELIAI;45577031767;Taip;10;9;0;19
18978;Dainorėliai;ŽIOGELIAI;92157879830;Taip;5;3;0;8
18979;Dainorėliai;ŽIOGELIAI;80499999855;Taip;5;0;0;5
18980;Dainorėliai;ŽIOGELIAI;72073028506;Taip;0;9;0;9
18981;Dainorėliai;ŽIOGELIAI;78002267589;Taip;4;0;2;6
18982;Dainorėliai;ŽIOGELIAI;3761026792;Taip;0;5;2;7
18983;Dainorėliai;DRUGELIAI;65253606353;Taip;8;1;0;9
18984;Dainorėliai;DRUGELIAI;26916172990;Ne;4;2;1;7
18985;Dainorėliai;DRUGELIAI;6411939690;Taip;0;3;0;3
18986;Dainorėliai;DRUGELIAI;50432354832;Taip;0;5;0;5
18987;Dainorėliai;DRUGELIAI;19286303769;Taip;10;5;0;15
18988;Dainorėliai;DRUGELIAI;2483267929;Taip;20;0;0;20
18989;Dainorėliai;DRUGELIAI;1015870220;Taip;7;0;0;7
18990;Dainorėliai;DRUGELIAI;5212308610;Taip;9;0;0;9
18991;Dainorėliai;DRUGELIAI;6404337541;Taip;0;0;1;1
18992;Dainorėliai;DRUGELIAI;94480397292;Taip;0;1;5;6
18993;Dainorėliai;DRUGELIAI;53935690864;Taip;0;5;0;5
18994;Dainorėliai;DRUGELIAI;27521381629;Taip;11;0;1;12
18995;Dainorėliai;DRUGELIAI;86187568203;Taip;0;6;0;6
18996;Dainorėliai;DRUGELIAI;5238082419;Taip;7;3;0;10
18997;Dainorėliai;DRUGELIAI;49483881135;Taip;14;0;0;14
18998;Dainorėliai;DRUGELIAI;1626877066;Taip;7;0;2;9
18999;Dainorėliai;DRUGELIAI;1158895670;Taip;14;0;0;14
19000;Dainorėliai;DRUGELIAI;4087344015;Taip;5;0;0;5
19001;Dainorėliai;DRUGELIAI;3128897752;Taip;5;0;0;5
19002;Dainorėliai;DRUGELIAI;1357413314;Taip;1;3;2;6
19003;Dainorėliai;DRUGELIAI;1515552402;Taip;0;1;0;1
19004;Dainorėliai;DRUGELIAI;36313982965;Taip;0;3;1;4
19005;Dainorėliai;"1 klasė";48245075123;Taip;2;5;0;7
19006;Dainorėliai;"1 klasė";5010994621;Taip;0;5;0;5
19007;Dainorėliai;"1 klasė";57618865048;Taip;0;5;0;5
19008;Dainorėliai;"1 klasė";29726515194;Taip;1;5;0;6
19009;Dainorėliai;"1 klasė";26315465923;Taip;0;5;0;5
19010;Dainorėliai;"1 klasė";6203511535;Taip;0;5;0;5
19011;Dainorėliai;"1 klasė";93738984644;Taip;1;5;0;6
19012;Dainorėliai;"1 klasė";81956978417;Taip;2;5;0;7
19013;Dainorėliai;"1 klasė";24048489264;Taip;0;5;0;5
19014;Dainorėliai;"1 klasė";8562371599;Taip;0;5;0;5
19015;Dainorėliai;"1 klasė";19292860218;Taip;0;5;0;5
19016;Dainorėliai;"1 klasė";14664307658;Taip;5;5;0;10
19017;Dainorėliai;"1 klasė";23144978287;Taip;0;5;0;5
19018;Dainorėliai;"1 klasė";77907054102;Taip;0;5;0;5
19019;Dainorėliai;"1 klasė";9447513737;Taip;0;5;0;5
19020;Dainorėliai;"1 klasė";63052774196;Taip;0;5;0;5
19021;Dainorėliai;"1 klasė";65982869126;Taip;0;5;0;5
19022;Dainorėliai;"1 klasė";97182565649;Taip;0;5;0;5
19023;Dainorėliai;"1 klasė";91457137356;Taip;0;5;0;5
19024;Dainorėliai;"1 klasė";13846131820;Taip;1;5;0;6
19025;Dainorėliai;"1 klasė";69409530494;Taip;1;5;0;6
19026;Dainorėliai;"1 klasė";84749521489;Taip;0;5;0;5
19027;Dainorėliai;"1 klasė";57179351170;Taip;0;5;0;5
19028;Dainorėliai;"1 klasė";4773358825;Taip;0;5;0;5
19029;Dainorėliai;"1 klasė";3018657993;Taip;0;5;0;5
19030;Dainorėliai;"2 klasė";8014881349;Taip;0;5;0;5
19031;Dainorėliai;"2 klasė";4309610318;Taip;0;5;0;5
19032;Dainorėliai;"2 klasė";1629229178;Ne;0;5;0;5
19033;Dainorėliai;"2 klasė";7589862952;Taip;7;5;0;12
19034;Dainorėliai;"2 klasė";1734712911;Taip;0;5;0;5
19035;Dainorėliai;"2 klasė";1472986325;Taip;0;5;0;5
19036;Dainorėliai;"2 klasė";6898321145;Taip;6;5;0;11
19037;Dainorėliai;"2 klasė";4642369086;Taip;3;5;0;8
19038;Dainorėliai;"2 klasė";3713835329;Taip;2;5;0;7
19039;Dainorėliai;"2 klasė";5181789063;Taip;1;5;0;6
19040;Dainorėliai;"2 klasė";4792505132;Taip;0;5;0;5
19041;Dainorėliai;"2 klasė";4631981231;Taip;1;5;0;6
19042;Dainorėliai;"2 klasė";2685423821;Taip;0;5;0;5
19043;Dainorėliai;"2 klasė";2991348691;Taip;0;5;0;5
19044;Dainorėliai;"2 klasė";3109138914;Taip;5;5;0;10
19045;Dainorėliai;"2 klasė";6576505338;Ne;0;5;0;5
19046;Dainorėliai;"2 klasė";9028699114;Taip;0;5;0;5
19047;Dainorėliai;"2 klasė";1185255904;Taip;5;5;0;10
19048;Dainorėliai;"2 klasė";9691052273;Taip;6;5;0;11
19049;Dainorėliai;"2 klasė";2135997501;Taip;5;5;0;10
19050;Dainorėliai;"2 klasė";7013545705;Taip;0;5;0;5
19051;Dainorėliai;"2 klasė";6735081184;Taip;7;5;0;12
19052;Dainorėliai;"2 klasė";7332518731;Taip;0;5;0;5
19053;Dainorėliai;"2 klasė";6513001151;Taip;5;5;0;10
19054;Dainorėliai;"2 klasė";47031645815;Taip;0;5;0;5
19055;Dainorėliai;"3 klasė";5468429196;Taip;0;5;0;5
19056;Dainorėliai;"3 klasė";6497830034;Taip;0;5;0;5
19057;Dainorėliai;"3 klasė";4497264004;Taip;0;5;0;5
19058;Dainorėliai;"3 klasė";2704452184;Taip;0;5;0;5
19059;Dainorėliai;"3 klasė";5072041112;Taip;0;5;0;5
19060;Dainorėliai;"3 klasė";2164782968;Ne;5;5;0;10
19061;Dainorėliai;"3 klasė";4275023010;Taip;5;5;0;10
19062;Dainorėliai;"3 klasė";4490125789;Taip;0;5;0;5
19063;Dainorėliai;"3 klasė";1311444933;Taip;0;5;0;5
19064;Dainorėliai;"3 klasė";8569165891;Taip;0;5;0;5
19065;Dainorėliai;"3 klasė";9630477900;Taip;0;5;0;5
19066;Dainorėliai;"3 klasė";2519518637;Taip;0;5;0;5
19067;Dainorėliai;"3 klasė";5177714429;Taip;0;5;0;5
19068;Dainorėliai;"3 klasė";7309477306;Taip;0;5;0;5
19069;Dainorėliai;"3 klasė";3683531357;Taip;0;5;0;5
19070;Dainorėliai;"3 klasė";3053044929;Taip;0;5;0;5
19071;Dainorėliai;"3 klasė";1289801462;Taip;5;5;0;10
19072;Dainorėliai;"3 klasė";7327414673;Taip;5;5;0;10
19073;Dainorėliai;"3 klasė";1347410803;Taip;5;5;0;10
19074;Dainorėliai;"3 klasė";8916859571;Taip;0;5;0;5
19075;Dainorėliai;"4 klasė";8177540512;Taip;3;5;0;8
19076;Dainorėliai;"4 klasė";1682094268;Taip;2;5;0;7
19077;Dainorėliai;"4 klasė";8913783842;Taip;0;5;0;5
19078;Dainorėliai;"4 klasė";1689787684;Taip;0;5;0;5
19079;Dainorėliai;"4 klasė";4956275684;Taip;0;5;0;5
19080;Dainorėliai;"4 klasė";3140143126;Taip;0;5;0;5
19081;Dainorėliai;"4 klasė";7972267725;Taip;2;5;0;7
19082;Dainorėliai;"4 klasė";6647480988;Taip;0;5;0;5
19083;Dainorėliai;"4 klasė";9012668384;Taip;0;5;0;5
19084;Dainorėliai;"4 klasė";3707864997;Taip;1;5;0;6
19085;Dainorėliai;"4 klasė";4557048583;Taip;0;5;0;5
19086;Dainorėliai;"4 klasė";1744536400;Ne;0;5;0;5
19087;Dainorėliai;"4 klasė";2936271822;Taip;5;5;0;10
19088;Dainorėliai;"4 klasė";4825947023;Ne;1;5;0;6
19089;Dainorėliai;"4 klasė";7116837311;Taip;0;5;0;5
19090;Dainorėliai;"4 klasė";1676986825;Taip;0;5;0;5
19091;Dainorėliai;"4 klasė";4853813247;Taip;6;5;0;11
19092;Dainorėliai;"4 klasė";6181648900;Taip;0;5;0;5
19093;Dainorėliai;"4 klasė";7179140869;Taip;0;5;0;5
19094;Dainorėliai;"4 klasė";4182527951;Taip;1;5;0;6
19095;Dainorėliai;"4 klasė";6267160193;Taip;0;5;0;5
19096;Dainorėliai;"4 klasė";4684100461;Taip;1;5;0;6
19097;Dainorėliai;"4 klasė";1175747348;Taip;0;5;0;5
19098;Dainorėliai;"4 klasė";1593283963;Taip;2;5;0;7
19099;Dainorėliai;"4 klasė";8612758782;Taip;5;5;0;10
19100;Lokiukas;BITUTĖS;6758550653;Taip;10;9;0;19
19101;Lokiukas;BITUTĖS;1040288021;Taip;9;8;0;17
19102;Lokiukas;BITUTĖS;1733486244;Taip;15;0;0;15
19103;Lokiukas;BITUTĖS;6336140882;Taip;10;5;0;15
19104;Lokiukas;BITUTĖS;9142262360;Taip;14;0;0;14
19105;Lokiukas;BITUTĖS;8775608581;Taip;11;5;0;16
19106;Lokiukas;BITUTĖS;1752784666;Taip;8;1;0;9
19107;Lokiukas;BITUTĖS;34546519642;Taip;5;5;3;13
19108;Lokiukas;BITUTĖS;2166382346;Taip;6;2;0;8
19109;Lokiukas;BITUTĖS;7305062511;Taip;6;0;0;6
19110;Lokiukas;BITUTĖS;1025576053;Taip;9;0;0;9
19111;Lokiukas;BITUTĖS;6069516217;Taip;9;6;0;15
19112;Lokiukas;BITUTĖS;7943213321;Taip;6;6;0;12
19113;Lokiukas;BITUTĖS;8915504279;Taip;0;1;0;1
19114;Lokiukas;BITUTĖS;4007839265;Taip;10;5;0;15
19115;Lokiukas;BITUTĖS;8796640190;Taip;14;0;2;16
19116;Lokiukas;BITUTĖS;5943412920;Taip;7;5;0;12
19117;Lokiukas;BITUTĖS;2885398200;Taip;7;5;0;12
19118;Lokiukas;BITUTĖS;7261501131;Taip;11;5;0;16
19119;Lokiukas;BITUTĖS;4379238557;Taip;9;5;0;14
19120;Lokiukas;BITUTĖS;2052174669;Taip;5;4;4;13
19121;Lokiukas;BITUTĖS;8902619265;Taip;10;0;0;10
19122;Lokiukas;"1 B klasė";60370754283;Taip;4;5;0;9
19123;Lokiukas;"1 B klasė";3262579895;Taip;7;5;0;12
19124;Lokiukas;"1 B klasė";17034757778;Taip;3;5;0;8
19125;Lokiukas;"1 B klasė";79301547085;Taip;5;5;0;10
19126;Lokiukas;"1 B klasė";16889795010;Taip;0;20;0;20
19127;Lokiukas;"1 B klasė";18432518932;Taip;7;5;0;12
19128;Lokiukas;"1 B klasė";2004606839;Taip;0;20;0;20
19129;Lokiukas;"1 B klasė";88947878548;Taip;5;5;0;10
19130;Lokiukas;"1 B klasė";45805925058;Taip;5;5;0;10
19131;Lokiukas;"1 B klasė";70028115546;Taip;5;5;0;10
19132;Lokiukas;"1 B klasė";29198900240;Taip;3;5;0;8
19133;Lokiukas;"1 B klasė";10897713744;Taip;0;20;0;20
19134;Lokiukas;"1 B klasė";77441549037;Taip;6;5;0;11
19135;Lokiukas;"1 B klasė";69089214980;Taip;3;5;0;8
19136;Lokiukas;"1 B klasė";17622979450;Taip;5;5;0;10
19137;Lokiukas;"1 B klasė";98289469398;Taip;6;5;0;11
19138;Lokiukas;"1 B klasė";51554951703;Taip;6;5;0;11
19139;Lokiukas;"1 B klasė";45735190114;Taip;0;20;0;20
19140;Lokiukas;"1 B klasė";79597160668;Taip;4;5;0;9
19141;Lokiukas;"1 B klasė";37669645510;Taip;2;5;0;7
19142;Lokiukas;"1 B klasė";15004419516;Taip;5;5;0;10
19143;Lokiukas;"1 B klasė";10240586503;Taip;0;20;0;20
19144;Lokiukas;"1 B klasė";5067673212;Taip;6;5;0;11
19145;Lokiukas;"1 B klasė";66392613629;Taip;2;5;0;7
19146;Lokiukas;"1 B klasė";15445053855;Taip;6;5;0;11
19147;Lokiukas;"1 B klasė";1104333637;Taip;5;5;0;10
19148;Lokiukas;"1 B klasė";35018370441;Taip;1;5;0;6
19149;Lokiukas;"1 B klasė";1716358913;Taip;4;5;0;9
19150;Lokiukas;"1 A klasė";72167964645;Taip;10;5;0;15
19151;Lokiukas;"1 A klasė";67818191566;Taip;2;5;0;7
19152;Lokiukas;"1 A klasė";75613665040;Taip;10;5;0;15
19153;Lokiukas;"1 A klasė";23222644824;Taip;9;5;0;14
19154;Lokiukas;"1 A klasė";52296454506;Taip;9;5;0;14
19155;Lokiukas;"1 A klasė";25058082693;Taip;0;20;0;20
19156;Lokiukas;"1 A klasė";6702448475;Taip;9;5;0;14
19157;Lokiukas;"1 A klasė";42292408557;Taip;8;5;0;13
19158;Lokiukas;"1 A klasė";2143040924;Taip;15;5;0;20
19159;Lokiukas;"1 A klasė";45280536946;Taip;11;5;0;16
19160;Lokiukas;"1 A klasė";82966541165;Taip;0;20;0;20
19161;Lokiukas;"1 A klasė";80180114948;Taip;7;5;0;12
19162;Lokiukas;"1 A klasė";66999644935;Taip;0;20;0;20
19163;Lokiukas;"1 A klasė";43389930516;Taip;5;5;0;10
19164;Lokiukas;"1 A klasė";86623153797;Taip;0;5;0;5
19165;Lokiukas;"1 A klasė";53245573692;Taip;7;5;0;12
19166;Lokiukas;"1 A klasė";14341255985;Taip;8;5;0;13
19167;Lokiukas;"1 A klasė";3206276637;Taip;0;20;0;20
19168;Lokiukas;"1 A klasė";27050402360;Taip;6;5;0;11
19169;Lokiukas;"1 A klasė";38636200254;Ne;5;5;0;10
19170;Lokiukas;"1 A klasė";53544600623;Taip;0;20;0;20
19171;Lokiukas;"1 A klasė";53087036306;Taip;0;20;0;20
19172;Lokiukas;"1 A klasė";5775631777;Ne;4;5;0;9
19173;Lokiukas;"1 A klasė";1143130271;Taip;0;6;0;6
19174;Lokiukas;"1 A klasė";47410036889;Taip;2;5;0;7
19175;Lokiukas;"1 A klasė";79223457439;Taip;12;5;0;17
19176;Lokiukas;GUDRUČIAI;43070670534;Taip;0;6;0;6
19177;Lokiukas;GUDRUČIAI;5198408183;Taip;0;7;0;7
19178;Lokiukas;GUDRUČIAI;88415635113;Taip;6;5;0;11
19179;Lokiukas;GUDRUČIAI;1227430275;Taip;2;8;0;10
19180;Lokiukas;GUDRUČIAI;9747265775;Taip;0;7;1;8
19181;Lokiukas;GUDRUČIAI;7903535850;Taip;2;5;3;10
19182;Lokiukas;GUDRUČIAI;7497324442;Taip;6;5;1;12
19183;Lokiukas;GUDRUČIAI;93374754851;Taip;3;5;0;8
19184;Lokiukas;GUDRUČIAI;96046361641;Taip;0;5;0;5
19185;Lokiukas;GUDRUČIAI;6628530877;Taip;6;5;0;11
19186;Lokiukas;GUDRUČIAI;25170045140;Taip;9;5;0;14
19187;Lokiukas;GUDRUČIAI;84273668685;Taip;0;5;0;5
19188;Lokiukas;GUDRUČIAI;10948160841;Taip;0;7;0;7
19189;Lokiukas;GUDRUČIAI;4608275224;Taip;13;5;0;18
19190;Lokiukas;GUDRUČIAI;75296600945;Taip;4;5;0;9
19191;Lokiukas;GUDRUČIAI;59840033826;Taip;0;5;0;5
19192;Lokiukas;GUDRUČIAI;1855267362;Taip;4;5;1;10
19193;Lokiukas;BORUŽĖLĖS;1333650630;Ne;0;5;0;5
19194;Lokiukas;BORUŽĖLĖS;67133709394;Taip;7;5;0;12
19195;Lokiukas;BORUŽĖLĖS;4906784415;Taip;0;5;0;5
19196;Lokiukas;BORUŽĖLĖS;36677665098;Taip;0;5;0;5
19197;Lokiukas;BORUŽĖLĖS;1119814512;Taip;7;5;0;12
19198;Lokiukas;BORUŽĖLĖS;1056075876;Taip;0;1;0;1
19199;Lokiukas;BORUŽĖLĖS;52940830874;Taip;15;5;0;20
19200;Lokiukas;BORUŽĖLĖS;1201125655;Taip;7;5;0;12
19201;Lokiukas;BORUŽĖLĖS;82025637099;Taip;4;0;0;4
19202;Lokiukas;BORUŽĖLĖS;131300206;Taip;7;5;0;12
19203;Lokiukas;BORUŽĖLĖS;8846527481;Taip;0;9;0;9
19204;Lokiukas;BORUŽĖLĖS;24601126170;Taip;0;5;1;6
19205;Lokiukas;BORUŽĖLĖS;83528495608;Ne;0;14;0;14
19206;Lokiukas;BORUŽĖLĖS;83086633109;Taip;0;5;1;6
19207;Lokiukas;BORUŽĖLĖS;40082135876;Taip;0;2;2;4
19208;Lokiukas;BORUŽĖLĖS;29396361769;Taip;9;6;0;15
19209;Lokiukas;BORUŽĖLĖS;73515179103;Taip;7;2;1;10
19210;Lokiukas;BORUŽĖLĖS;8240261104;Taip;0;1;0;1
19211;Lokiukas;BORUŽĖLĖS;99183628764;Taip;4;5;2;11
19212;Lokiukas;BORUŽĖLĖS;61807094999;Taip;1;1;0;2
19213;Lokiukas;BORUŽĖLĖS;7495691956;Ne;0;5;0;5
19214;Lokiukas;BORUŽĖLĖS;51059574159;Taip;5;5;1;11
19215;Lokiukas;ANČIUKAI;4617372387;Taip;7;0;1;8
19216;Lokiukas;ANČIUKAI;8630112458;Taip;10;5;0;15
19217;Lokiukas;ANČIUKAI;5518041213;Taip;0;0;1;1
19218;Lokiukas;ANČIUKAI;8738488104;Taip;0;0;2;2
19219;Lokiukas;ANČIUKAI;3744484616;Taip;0;6;0;6
19220;Lokiukas;ANČIUKAI;2625981190;Taip;13;1;0;14
19221;Lokiukas;ANČIUKAI;4442073527;Taip;0;0;2;2
19222;Lokiukas;ANČIUKAI;9307491947;Taip;15;0;0;15
19223;Lokiukas;ANČIUKAI;4849031542;Taip;0;20;0;20
19224;Lokiukas;ANČIUKAI;8286358519;Taip;10;0;0;10
19225;Lokiukas;ANČIUKAI;4585621105;Taip;7;7;0;14
19226;Lokiukas;ANČIUKAI;5522089503;Taip;15;5;0;20
19227;Lokiukas;ANČIUKAI;8576418875;Taip;10;10;0;20
19228;Lokiukas;ANČIUKAI;4858829710;Taip;7;5;0;12
19229;Lokiukas;ANČIUKAI;6869785650;Taip;0;7;0;7
19230;Lokiukas;KODĖLČIUKAI;32506466236;Taip;6;5;0;11
19231;Lokiukas;KODĖLČIUKAI;15406362908;Taip;2;4;0;6
19232;Lokiukas;KODĖLČIUKAI;45122233067;Taip;2;2;0;4
19233;Lokiukas;KODĖLČIUKAI;21802863853;Taip;1;0;0;1
19234;Lokiukas;KODĖLČIUKAI;84682977618;Taip;2;1;0;3
19235;Lokiukas;KODĖLČIUKAI;22979689191;Taip;0;6;0;6
19236;Lokiukas;KODĖLČIUKAI;70730972654;Taip;0;20;0;20
19237;Lokiukas;KODĖLČIUKAI;80754592972;Taip;2;5;0;7
19238;Lokiukas;KODĖLČIUKAI;14903100496;Taip;0;5;0;5
19239;Lokiukas;KODĖLČIUKAI;99706061553;Taip;7;7;0;14
19240;Lokiukas;KODĖLČIUKAI;42138783794;Taip;7;5;0;12
19241;Lokiukas;KODĖLČIUKAI;7785940412;Taip;0;9;0;9
19242;Lokiukas;KODĖLČIUKAI;24099693663;Taip;0;8;0;8
19243;Lokiukas;KODĖLČIUKAI;72092394330;Taip;0;5;0;5
19244;Lokiukas;KODĖLČIUKAI;9413274607;Taip;3;0;0;3
19245;Lokiukas;KODĖLČIUKAI;7324496782;Taip;0;5;0;5
19246;Lokiukas;KODĖLČIUKAI;35769782473;Taip;2;3;0;5
19247;Lokiukas;KODĖLČIUKAI;10811780420;Taip;0;9;0;9
19248;Lokiukas;KODĖLČIUKAI;1151938436;Taip;8;2;0;10
19249;Lokiukas;KODĖLČIUKAI;91855230473;Taip;3;5;0;8
19250;Lokiukas;KODĖLČIUKAI;38531751377;Taip;2;6;0;8
19251;Lokiukas;KODĖLČIUKAI;28796727185;Taip;0;6;0;6
19252;Lokiukas;KODĖLČIUKAI;80793623068;Ne;0;6;0;6
19253;Lokiukas;DRUGELIAI;7942641594;Taip;5;5;1;11
19254;Lokiukas;DRUGELIAI;8568285232;Taip;0;7;0;7
19255;Lokiukas;DRUGELIAI;5453470660;Taip;5;8;0;13
19256;Lokiukas;DRUGELIAI;5879386524;Taip;3;5;3;11
19257;Lokiukas;DRUGELIAI;14605095801;Taip;0;5;0;5
19258;Lokiukas;DRUGELIAI;46838695582;Taip;12;1;0;13
19259;Lokiukas;DRUGELIAI;2642065594;Taip;0;6;0;6
19260;Lokiukas;DRUGELIAI;1626698185;Taip;0;5;0;5
19261;Lokiukas;DRUGELIAI;39222094073;Taip;5;2;0;7
19262;Lokiukas;DRUGELIAI;1695680881;Taip;5;5;0;10
19263;Lokiukas;DRUGELIAI;69364831994;Taip;5;5;0;10
19264;Lokiukas;DRUGELIAI;76969210386;Taip;3;5;0;8
19265;Lokiukas;DRUGELIAI;74169282323;Taip;1;6;0;7
19266;Lokiukas;DRUGELIAI;1625137322;Taip;0;13;0;13
19267;Lokiukas;DRUGELIAI;1381505711;Taip;20;0;0;20
19268;Lokiukas;DRUGELIAI;8452600632;Taip;11;5;0;16
19269;Lokiukas;DRUGELIAI;7386571822;Ne;2;17;0;19
19270;Lokiukas;DRUGELIAI;35890122494;Taip;5;5;0;10
19271;Lokiukas;DRUGELIAI;1210407640;Taip;6;6;0;12
19272;Lokiukas;DRUGELIAI;7591418969;Taip;0;20;0;20
19273;Lokiukas;DRUGELIAI;8270572748;Taip;0;4;0;4
19274;Lokiukas;DRUGELIAI;8036643654;Taip;5;5;0;10
19275;Lokiukas;"2 A klasė";7060929950;Taip;7;5;0;12
19276;Lokiukas;"2 A klasė";8499895935;Taip;0;20;0;20
19277;Lokiukas;"2 A klasė";5737714024;Ne;0;5;0;5
19278;Lokiukas;"2 A klasė";5889819809;Ne;0;5;0;5
19279;Lokiukas;"2 A klasė";6496662759;Taip;8;5;0;13
19280;Lokiukas;"2 A klasė";5700685872;Ne;6;5;0;11
19281;Lokiukas;"2 A klasė";1555365851;Ne;6;5;0;11
19282;Lokiukas;"2 A klasė";2374089307;Taip;6;5;0;11
19283;Lokiukas;"2 A klasė";2607988265;Taip;3;5;0;8
19284;Lokiukas;"2 A klasė";4992275038;Taip;1;5;0;6
19285;Lokiukas;"2 A klasė";1492303633;Taip;5;5;0;10
19286;Lokiukas;"2 A klasė";6856770462;Ne;0;5;0;5
19287;Lokiukas;"2 A klasė";8766212402;Ne;3;5;0;8
19288;Lokiukas;"2 A klasė";5559967651;Taip;4;5;0;9
19289;Lokiukas;"2 A klasė";3528533437;Taip;0;20;0;20
19290;Lokiukas;"2 A klasė";5465758477;Taip;1;5;0;6
19291;Lokiukas;"2 A klasė";7069020705;Taip;2;5;0;7
19292;Lokiukas;"2 A klasė";6129602024;Ne;5;5;0;10
19293;Lokiukas;"2 A klasė";9199283952;Taip;14;5;0;19
19294;Lokiukas;"2 A klasė";8378630091;Taip;2;5;0;7
19295;Lokiukas;"2 A klasė";3138145333;Ne;14;5;0;19
19296;Lokiukas;"2 A klasė";3506723678;Taip;0;20;0;20
19297;Lokiukas;"2 A klasė";4615481025;Ne;0;5;0;5
19298;Lokiukas;"2 A klasė";7553457572;Ne;6;5;0;11
19299;Lokiukas;"2 A klasė";1571404671;Taip;3;5;0;8
19300;Lokiukas;"2 A klasė";1729941577;Taip;0;5;0;5
19301;Lokiukas;"2 B klasė";9114504810;Taip;10;5;0;15
19302;Lokiukas;"2 B klasė";7595514531;Taip;6;5;0;11
19303;Lokiukas;"2 B klasė";7144013238;Taip;0;20;0;20
19304;Lokiukas;"2 B klasė";8235437961;Taip;2;5;0;7
19305;Lokiukas;"2 B klasė";2905935730;Taip;8;5;0;13
19306;Lokiukas;"2 B klasė";8304439625;Taip;0;5;0;5
19307;Lokiukas;"2 B klasė";8954484534;Taip;0;5;0;5
19308;Lokiukas;"2 B klasė";1388342336;Taip;0;5;0;5
19309;Lokiukas;"2 B klasė";4418425219;Taip;0;5;0;5
19310;Lokiukas;"2 B klasė";3364994110;Taip;6;5;0;11
19311;Lokiukas;"2 B klasė";6063796643;Taip;4;5;0;9
19312;Lokiukas;"2 B klasė";6663700618;Taip;0;5;0;5
19313;Lokiukas;"2 B klasė";6151885589;Taip;0;5;0;5
19314;Lokiukas;"2 B klasė";1440437389;Taip;0;5;0;5
19315;Lokiukas;"2 B klasė";2059112380;Taip;7;5;0;12
19316;Lokiukas;"2 B klasė";5745254234;Taip;1;5;0;6
19317;Lokiukas;"2 B klasė";8189433550;Taip;0;20;0;20
19318;Lokiukas;"2 B klasė";5918592397;Taip;3;5;0;8
19319;Lokiukas;"2 B klasė";7722830021;Taip;2;5;0;7
19320;Lokiukas;"2 B klasė";9681048306;Taip;0;5;0;5
19321;Lokiukas;"2 B klasė";1048772300;Taip;2;5;0;7
19322;Lokiukas;"2 B klasė";2021690274;Taip;6;5;0;11
19323;Lokiukas;"2 B klasė";6538311120;Taip;1;5;0;6
19324;Lokiukas;"2 B klasė";8395026474;Taip;6;5;0;11
19325;Lokiukas;"2 B klasė";7439047502;Taip;0;5;0;5
19326;Lokiukas;"2 B klasė";1746819279;Taip;5;5;0;10
19327;Lokiukas;"3 A klasė";2220223549;Taip;0;20;0;20
19328;Lokiukas;"3 A klasė";7349936354;Ne;0;5;0;5
19329;Lokiukas;"3 A klasė";8192834838;Taip;0;5;0;5
19330;Lokiukas;"3 A klasė";7086818828;Taip;0;5;0;5
19331;Lokiukas;"3 A klasė";8959417696;Taip;0;20;0;20
19332;Lokiukas;"3 A klasė";1362995666;Taip;0;5;0;5
19333;Lokiukas;"3 A klasė";4873942674;Taip;5;5;0;10
19334;Lokiukas;"3 A klasė";4229488670;Taip;0;20;0;20
19335;Lokiukas;"3 A klasė";2745780921;Taip;0;5;0;5
19336;Lokiukas;"3 A klasė";3007573139;Taip;0;5;0;5
19337;Lokiukas;"3 A klasė";5058488696;Taip;5;5;0;10
19338;Lokiukas;"3 A klasė";6008557035;Taip;1;5;0;6
19339;Lokiukas;"3 A klasė";1243245356;Taip;1;5;0;6
19340;Lokiukas;"3 A klasė";9322204885;Taip;1;5;0;6
19341;Lokiukas;"3 A klasė";1822055099;Taip;1;5;0;6
19342;Lokiukas;"3 A klasė";5199360470;Taip;3;5;0;8
19343;Lokiukas;"3 A klasė";5384844998;Taip;0;20;0;20
19344;Lokiukas;"3 A klasė";6353653831;Taip;0;20;0;20
19345;Lokiukas;"3 A klasė";3700837936;Taip;1;5;0;6
19346;Lokiukas;"3 A klasė";6022402998;Taip;3;5;0;8
19347;Lokiukas;"3 A klasė";5942416530;Taip;5;5;0;10
19348;Lokiukas;"3 A klasė";9743363133;Taip;3;5;0;8
19349;Lokiukas;"3 A klasė";2029507962;Taip;13;5;0;18
19350;Lokiukas;"3 A klasė";44496777103;Taip;0;5;0;5
19351;Lokiukas;"3 A klasė";94528954912;Taip;7;5;0;12
19352;Lokiukas;"3 B klasė";9922964495;Taip;9;5;0;14
19353;Lokiukas;"3 B klasė";5562737843;Taip;5;5;0;10
19354;Lokiukas;"3 B klasė";6110849113;Taip;0;20;0;20
19355;Lokiukas;"3 B klasė";8822883914;Taip;0;20;0;20
19356;Lokiukas;"3 B klasė";1860245985;Taip;0;20;0;20
19357;Lokiukas;"3 B klasė";1692231191;Taip;0;5;0;5
19358;Lokiukas;"3 B klasė";4160279615;Taip;1;5;0;6
19359;Lokiukas;"3 B klasė";4368235682;Taip;5;5;0;10
19360;Lokiukas;"3 B klasė";9376247296;Taip;0;5;0;5
19361;Lokiukas;"3 B klasė";7943448919;Taip;0;20;0;20
19362;Lokiukas;"3 B klasė";6270747705;Taip;4;5;0;9
19363;Lokiukas;"3 B klasė";9390626220;Taip;0;20;0;20
19364;Lokiukas;"3 B klasė";4467643205;Taip;1;5;0;6
19365;Lokiukas;"3 B klasė";8175005473;Taip;0;5;0;5
19366;Lokiukas;"3 B klasė";4504812769;Taip;0;5;0;5
19367;Lokiukas;"3 B klasė";6210160161;Taip;3;5;0;8
19368;Lokiukas;"3 B klasė";1727242060;Taip;0;20;0;20
19369;Lokiukas;"3 B klasė";8300861451;Taip;5;5;0;10
19370;Lokiukas;"3 B klasė";7692067948;Taip;3;5;0;8
19371;Lokiukas;"3 B klasė";7728788069;Taip;0;20;0;20
19372;Lokiukas;"3 B klasė";9985555940;Taip;13;5;0;18
19373;Lokiukas;"3 B klasė";4447860405;Taip;1;5;0;6
19374;Lokiukas;"3 B klasė";3823547337;Taip;4;5;0;9
19375;Lokiukas;"3 B klasė";5496591880;Taip;0;20;0;20
19376;Lokiukas;"3 B klasė";1491789191;Taip;5;5;0;10
19377;Lokiukas;"3 B klasė";1419846182;Taip;0;5;0;5
19378;Lokiukas;"3 B klasė";9310088026;Taip;6;5;0;11
19379;Lokiukas;"3 B klasė";1787800667;Taip;4;5;0;9
19380;Lokiukas;"3 B klasė";2284932363;Taip;4;5;0;9
19381;Lokiukas;"4 A klasė";8522739824;Taip;0;20;0;20
19382;Lokiukas;"4 A klasė";6642105064;Taip;3;5;0;8
19383;Lokiukas;"4 A klasė";5852545576;Taip;0;20;0;20
19384;Lokiukas;"4 A klasė";1179863043;Taip;0;20;0;20
19385;Lokiukas;"4 A klasė";4976080351;Taip;5;5;0;10
19386;Lokiukas;"4 A klasė";5300309689;Taip;0;20;0;20
19387;Lokiukas;"4 A klasė";3023836997;Taip;0;20;0;20
19388;Lokiukas;"4 A klasė";6539032697;Ne;0;20;0;20
19389;Lokiukas;"4 A klasė";8651567498;Taip;4;5;0;9
19390;Lokiukas;"4 A klasė";6880671721;Taip;0;20;0;20
19391;Lokiukas;"4 A klasė";2890728780;Taip;0;20;0;20
19392;Lokiukas;"4 A klasė";1275739989;Taip;0;20;0;20
19393;Lokiukas;"4 A klasė";5810597393;Ne;0;20;0;20
19394;Lokiukas;"4 A klasė";3297734813;Taip;0;20;0;20
19395;Lokiukas;"4 A klasė";3216247517;Taip;4;5;0;9
19396;Lokiukas;"4 A klasė";2946985384;Taip;0;20;0;20
19397;Lokiukas;"4 A klasė";4908935009;Taip;5;5;0;10
19398;Lokiukas;"4 A klasė";8585585715;Taip;7;5;0;12
19399;Lokiukas;"4 A klasė";8746221351;Taip;5;5;0;10
19400;Lokiukas;"4 A klasė";7385810354;Taip;3;5;0;8
19401;Lokiukas;"4 A klasė";7202328703;Taip;4;5;0;9
19402;Lokiukas;"4 B klasė";3253826820;Ne;10;5;0;15
19403;Lokiukas;"4 B klasė";8577804440;Taip;4;5;0;9
19404;Lokiukas;"4 B klasė";3401446820;Taip;7;5;0;12
19405;Lokiukas;"4 B klasė";3941060152;Taip;14;5;0;19
19406;Lokiukas;"4 B klasė";6034080022;Taip;5;5;0;10
19407;Lokiukas;"4 B klasė";7802721046;Taip;0;20;0;20
19408;Lokiukas;"4 B klasė";5579944645;Taip;12;5;0;17
19409;Lokiukas;"4 B klasė";1798330886;Taip;4;5;0;9
19410;Lokiukas;"4 B klasė";6827396461;Taip;7;5;0;12
19411;Lokiukas;"4 B klasė";2096424992;Taip;0;20;0;20
19412;Lokiukas;"4 B klasė";7221776688;Taip;0;20;0;20
19413;Lokiukas;"4 B klasė";7010375151;Taip;10;5;0;15
19414;Lokiukas;"4 B klasė";3862533006;Taip;9;5;0;14
19415;Lokiukas;"4 B klasė";8123166445;Ne;7;5;0;12
19416;Lokiukas;"4 B klasė";9742540759;Taip;0;20;0;20
19417;Lokiukas;"4 B klasė";5301990414;Taip;6;5;0;11
19418;Lokiukas;"4 B klasė";4755673524;Taip;12;5;0;17
19419;Lokiukas;"4 B klasė";7851458821;Taip;14;5;0;19
19420;Lokiukas;"4 B klasė";4537888646;Taip;7;5;0;12
19421;Lokiukas;"4 B klasė";9786431252;Taip;0;5;0;5
19422;Lokiukas;"4 B klasė";1956140793;Taip;0;20;0;20
19423;Lokiukas;"4 B klasė";6116726536;Taip;13;5;0;18
19424;Lokiukas;"4 B klasė";3276273861;Taip;9;5;0;14
19425;Lokiukas;"4 B klasė";4648324338;Taip;10;5;0;15
19426;Šaltinėlis;Ančiukų;3011747942;Taip;5;4;0;9
19427;Šaltinėlis;Ančiukų;1811886320;Taip;15;0;0;15
19428;Šaltinėlis;Ančiukų;9769491789;Taip;10;4;0;14
19429;Šaltinėlis;Ančiukų;56396772538;Taip;5;0;0;5
19430;Šaltinėlis;Ančiukų;6462738640;Taip;7;0;0;7
19431;Šaltinėlis;Ančiukų;3493429067;Taip;3;0;1;4
19432;Šaltinėlis;Ančiukų;77872075694;Taip;7;0;0;7
19433;Šaltinėlis;Ančiukų;9218883174;Taip;15;0;0;15
19434;Šaltinėlis;Ančiukų;7133143923;Taip;9;2;0;11
19435;Šaltinėlis;Ančiukų;9820788524;Taip;11;6;0;17
19436;Šaltinėlis;Ančiukų;3691635011;Taip;10;1;0;11
19437;Šaltinėlis;Ančiukų;2630875135;Taip;10;5;0;15
19438;Šaltinėlis;Ančiukų;2973820849;Taip;20;0;0;20
19439;Šaltinėlis;Ančiukų;6487378225;Taip;15;0;0;15
19440;Šaltinėlis;Ančiukų;1464992631;Taip;20;0;0;20
19441;Šaltinėlis;Ančiukų;9274165569;Taip;7;0;0;7
19442;Šaltinėlis;Ančiukų;8500790262;Taip;5;0;0;5
19443;Šaltinėlis;Ančiukų;4332884673;Taip;4;1;0;5
19444;Šaltinėlis;Ančiukų;9362495172;Taip;20;0;0;20
19445;Šaltinėlis;Ančiukų;7737797979;Taip;5;0;1;6
19446;Šaltinėlis;Bitučių;54025577281;Taip;0;10;0;10
19447;Šaltinėlis;Bitučių;6669392157;Taip;0;5;0;5
19448;Šaltinėlis;Bitučių;28956971978;Taip;10;3;0;13
19449;Šaltinėlis;Bitučių;14213856824;Taip;0;5;0;5
19450;Šaltinėlis;Bitučių;80649337160;Taip;0;5;1;6
19451;Šaltinėlis;Bitučių;92958012146;Taip;6;5;0;11
19452;Šaltinėlis;Bitučių;84656960510;Taip;0;5;0;5
19453;Šaltinėlis;Bitučių;83621946293;Taip;12;5;0;17
19454;Šaltinėlis;Bitučių;67808618878;Ne;0;5;1;6
19455;Šaltinėlis;Bitučių;1278910777;Taip;0;6;0;6
19456;Šaltinėlis;Bitučių;9647785988;Taip;0;6;0;6
19457;Šaltinėlis;Bitučių;82671662416;Taip;0;5;0;5
19458;Šaltinėlis;Bitučių;29482180151;Taip;5;6;0;11
19459;Šaltinėlis;Bitučių;54753218491;Taip;0;1;0;1
19460;Šaltinėlis;Bitučių;86029472773;Taip;0;1;0;1
19461;Šaltinėlis;Bitučių;64821172553;Taip;11;5;1;17
19462;Šaltinėlis;Bitučių;25459069972;Ne;0;5;2;7
19463;Šaltinėlis;Bitučių;5056986469;Taip;9;5;0;14
19464;Šaltinėlis;Bitučių;89358384113;Taip;13;5;0;18
19465;Šaltinėlis;Bitučių;4050444191;Taip;6;5;0;11
19466;Šaltinėlis;Bitučių;89093437170;Taip;0;14;0;14
19467;Šaltinėlis;Bitučių;51872331010;Taip;7;4;0;11
19468;Šaltinėlis;Bitučių;5744976843;Taip;0;11;0;11
19469;Šaltinėlis;Saulutės;72372808270;Taip;5;5;0;10
19470;Šaltinėlis;Saulutės;70315400705;Taip;14;5;0;19
19471;Šaltinėlis;Saulutės;57847832778;Taip;3;4;0;7
19472;Šaltinėlis;Saulutės;77194317310;Taip;5;5;0;10
19473;Šaltinėlis;Saulutės;74337710550;Taip;0;5;0;5
19474;Šaltinėlis;Saulutės;59164202996;Taip;0;9;0;9
19475;Šaltinėlis;Saulutės;3626545396;Ne;0;12;0;12
19476;Šaltinėlis;Saulutės;95542489944;Taip;0;5;0;5
19477;Šaltinėlis;Saulutės;39088869084;Taip;0;2;0;2
19478;Šaltinėlis;Saulutės;83173349544;Taip;0;12;0;12
19479;Šaltinėlis;Saulutės;19630605543;Taip;0;9;0;9
19480;Šaltinėlis;Saulutės;1220687492;Taip;0;1;0;1
19481;Šaltinėlis;Saulutės;93256161233;Taip;0;4;0;4
19482;Šaltinėlis;Saulutės;3072314714;Taip;10;5;0;15
19483;Šaltinėlis;Saulutės;35401075864;Taip;0;2;0;2
19484;Šaltinėlis;Saulutės;1924418657;Taip;11;5;0;16
19485;Šaltinėlis;Saulutės;23090033086;Taip;5;5;0;10
19486;Šaltinėlis;Meškiukų;3264138693;Taip;7;0;0;7
19487;Šaltinėlis;Meškiukų;66103457245;Taip;0;5;0;5
19488;Šaltinėlis;Meškiukų;2013810425;Taip;0;4;0;4
19489;Šaltinėlis;Meškiukų;46159500221;Taip;10;7;1;18
19490;Šaltinėlis;Meškiukų;1044723472;Taip;0;0;1;1
19491;Šaltinėlis;Meškiukų;1045163890;Taip;10;7;1;18
19492;Šaltinėlis;Meškiukų;7231645416;Ne;8;5;0;13
19493;Šaltinėlis;Meškiukų;8776976566;Taip;0;10;0;10
19494;Šaltinėlis;Meškiukų;5215769929;Taip;0;10;0;10
19495;Šaltinėlis;Meškiukų;8555517284;Taip;12;0;0;12
19496;Šaltinėlis;Meškiukų;29359826470;Taip;7;0;0;7
19497;Šaltinėlis;Meškiukų;1073305554;Taip;0;5;4;9
19498;Šaltinėlis;Meškiukų;1614411921;Ne;6;7;0;13
19499;Šaltinėlis;Meškiukų;77518622497;Taip;12;0;2;14
19500;Šaltinėlis;Meškiukų;6887838949;Taip;0;0;11;11
19501;Šaltinėlis;Meškiukų;7483928256;Taip;10;0;0;10
19502;Šaltinėlis;Nykštukai;1390316465;Taip;0;15;0;15
19503;Šaltinėlis;Nykštukai;1955018380;Ne;0;8;0;8
19504;Šaltinėlis;Nykštukai;1718488108;Taip;0;6;0;6
19505;Šaltinėlis;Nykštukai;7073644279;Taip;0;0;4;4
19506;Šaltinėlis;Nykštukai;37786438977;Taip;0;12;0;12
19507;Šaltinėlis;Nykštukai;48525545812;Taip;4;8;0;12
19508;Šaltinėlis;Nykštukai;1658370782;Ne;15;5;0;20
19509;Šaltinėlis;Nykštukai;32264290873;Taip;12;4;0;16
19510;Šaltinėlis;Nykštukai;66575684640;Taip;0;5;0;5
19511;Šaltinėlis;Nykštukai;13808708760;Taip;2;5;0;7
19512;Šaltinėlis;Nykštukai;10918276041;Taip;5;0;0;5
19513;Šaltinėlis;Nykštukai;1456486363;Taip;9;8;0;17
19514;Šaltinėlis;Nykštukai;79406746980;Taip;0;7;0;7
19515;Šaltinėlis;Nykštukai;32949623652;Taip;0;15;0;15
19516;Šaltinėlis;Nykštukai;1767635282;Taip;14;0;0;14
19517;Šaltinėlis;Nykštukai;1190394855;Taip;13;5;0;18
19518;Šaltinėlis;Nykštukai;6764006747;Taip;0;0;1;1
19519;Šaltinėlis;Nykštukai;3577137327;Taip;10;4;0;14
19520;Šaltinėlis;Nykštukai;1580090516;Taip;0;4;1;5
19521;Šaltinėlis;Nykštukai;2333071711;Taip;0;2;0;2
19522;Šaltinėlis;Nykštukai;4901977623;Taip;5;3;0;8
19523;Šaltinėlis;Nykštukai;5442943843;Taip;7;4;0;11
19524;Šaltinėlis;Perliukų;17147527171;Taip;5;6;0;11
19525;Šaltinėlis;Perliukų;11083638216;Taip;6;5;1;12
19526;Šaltinėlis;Perliukų;1091056386;Taip;0;1;0;1
19527;Šaltinėlis;Perliukų;52507085619;Taip;0;0;4;4
19528;Šaltinėlis;Perliukų;23301579810;Taip;6;0;0;6
19529;Šaltinėlis;Perliukų;2146141461;Taip;0;5;2;7
19530;Šaltinėlis;Perliukų;1958647188;Taip;10;7;0;17
19531;Šaltinėlis;Perliukų;2034838765;Taip;10;0;0;10
19532;Šaltinėlis;Perliukų;1935762293;Taip;7;0;1;8
19533;Šaltinėlis;Perliukų;1583520894;Taip;0;16;0;16
19534;Šaltinėlis;Perliukų;84494627465;Taip;0;4;0;4
19535;Šaltinėlis;Perliukų;1130153806;Taip;3;1;0;4
19536;Šaltinėlis;Perliukų;98941037508;Taip;0;2;4;6
19537;Šaltinėlis;Perliukų;2125176999;Ne;0;5;2;7
19538;Šaltinėlis;Perliukų;9425353041;Taip;0;8;0;8
19539;Šaltinėlis;Perliukų;526307704;Taip;15;5;0;20
19540;Šaltinėlis;Perliukų;7262120071;Ne;7;5;2;14
19541;Šaltinėlis;Perliukų;6068980312;Taip;4;0;1;5
19542;Šaltinėlis;Perliukų;5869977541;Taip;15;0;0;15
19543;Šaltinėlis;Perliukų;4416064304;Ne;0;9;0;9
19544;Šaltinėlis;BORUŽĖLĖS;9762392403;Taip;12;0;1;13
19545;Šaltinėlis;BORUŽĖLĖS;9522524163;Taip;15;5;0;20
19546;Šaltinėlis;BORUŽĖLĖS;7311831014;Taip;7;5;0;12
19547;Šaltinėlis;BORUŽĖLĖS;5854723120;Taip;5;9;0;14
19548;Šaltinėlis;BORUŽĖLĖS;5833136956;Taip;0;5;0;5
19549;Šaltinėlis;BORUŽĖLĖS;3483756240;Taip;0;0;7;7
19550;Šaltinėlis;BORUŽĖLĖS;6380346298;Taip;7;0;0;7
19551;Šaltinėlis;BORUŽĖLĖS;5799032398;Taip;10;8;0;18
19552;Šaltinėlis;BORUŽĖLĖS;5525740049;Taip;9;6;0;15
19553;Šaltinėlis;BORUŽĖLĖS;5382567842;Taip;6;0;0;6
19554;Šaltinėlis;BORUŽĖLĖS;4681460322;Taip;0;14;0;14
19555;Šaltinėlis;BORUŽĖLĖS;1978469605;Ne;16;0;0;16
19556;Šaltinėlis;BORUŽĖLĖS;7650840990;Taip;0;8;0;8
19557;Šaltinėlis;BORUŽĖLĖS;4430546695;Taip;11;5;0;16
19558;Šaltinėlis;BORUŽĖLĖS;4743907195;Taip;20;0;0;20
19559;Šaltinėlis;1A;86995081866;Taip;0;9;0;9
19560;Šaltinėlis;1A;4587186145;Taip;0;8;0;8
19561;Šaltinėlis;1A;89489007301;Taip;0;20;0;20
19562;Šaltinėlis;1A;66754907606;Taip;0;20;0;20
19563;Šaltinėlis;1A;50972894040;Ne;0;6;0;6
19564;Šaltinėlis;1A;9705941341;Taip;0;5;0;5
19565;Šaltinėlis;1A;36718328105;Taip;0;9;0;9
19566;Šaltinėlis;1A;47045578599;Taip;0;12;0;12
19567;Šaltinėlis;1A;35387543586;Taip;0;7;0;7
19568;Šaltinėlis;1A;40769315138;Taip;0;8;0;8
19569;Šaltinėlis;1A;83657465071;Taip;0;5;0;5
19570;Šaltinėlis;1A;70948186548;Taip;0;5;0;5
19571;Šaltinėlis;1A;62612067151;Taip;0;10;0;10
19572;Šaltinėlis;1A;38496350161;Taip;0;10;0;10
19573;Šaltinėlis;1A;86309198604;Taip;0;9;0;9
19574;Šaltinėlis;1A;29683761586;Ne;0;5;0;5
19575;Šaltinėlis;1A;2323456393;Taip;0;20;0;20
19576;Šaltinėlis;1A;9927833966;Ne;0;9;0;9
19577;Šaltinėlis;1A;56279691365;Taip;0;5;0;5
19578;Šaltinėlis;1A;96133834896;Taip;0;20;0;20
19579;Šaltinėlis;1A;7929809205;Ne;0;5;0;5
19580;Šaltinėlis;1A;7563879445;Taip;0;17;0;17
19581;Šaltinėlis;"2A klasė";4843823058;Ne;0;5;0;5
19582;Šaltinėlis;"2A klasė";7264810605;Ne;0;5;0;5
19583;Šaltinėlis;"2A klasė";6044895102;Ne;0;6;0;6
19584;Šaltinėlis;"2A klasė";8680271000;Ne;0;5;0;5
19585;Šaltinėlis;"2A klasė";1839665658;Ne;0;6;0;6
19586;Šaltinėlis;"2A klasė";2076892804;Ne;0;8;0;8
19587;Šaltinėlis;"2A klasė";7967108692;Ne;0;12;0;12
19588;Šaltinėlis;"2A klasė";7058348243;Ne;0;5;0;5
19589;Šaltinėlis;"2A klasė";5012608633;Ne;0;9;0;9
19590;Šaltinėlis;"2A klasė";8445115141;Ne;0;5;0;5
19591;Šaltinėlis;"2A klasė";7214517805;Ne;0;20;0;20
19592;Šaltinėlis;"2A klasė";6876036723;Ne;0;20;0;20
19593;Šaltinėlis;"2A klasė";9978493148;Ne;0;10;0;10
19594;Šaltinėlis;"2A klasė";6171441011;Ne;0;6;0;6
19595;Šaltinėlis;"2A klasė";1450894955;Ne;0;20;0;20
19596;Šaltinėlis;"2A klasė";8898225999;Ne;0;20;0;20
19597;Šaltinėlis;"2A klasė";92001008485;Taip;0;5;0;5
19598;Šaltinėlis;"2B klasė";3329317171;Ne;0;8;0;8
19599;Šaltinėlis;"2B klasė";2089316824;Ne;0;6;0;6
19600;Šaltinėlis;"2B klasė";5776007602;Ne;0;8;0;8
19601;Šaltinėlis;"2B klasė";7420737103;Ne;0;5;0;5
19602;Šaltinėlis;"2B klasė";4141263000;Ne;0;5;0;5
19603;Šaltinėlis;"2B klasė";5999279571;Ne;0;5;0;5
19604;Šaltinėlis;"2B klasė";7142082502;Ne;0;20;0;20
19605;Šaltinėlis;"2B klasė";3037854361;Ne;0;5;0;5
19606;Šaltinėlis;"2B klasė";8219291385;Ne;0;5;0;5
19607;Šaltinėlis;"2B klasė";3863654037;Ne;0;9;0;9
19608;Šaltinėlis;"2B klasė";8380122669;Ne;0;6;0;6
19609;Šaltinėlis;"2B klasė";6719801285;Ne;0;11;0;11
19610;Šaltinėlis;"2B klasė";49275031765;Taip;0;16;0;16
19611;Šaltinėlis;"2B klasė";82404351290;Taip;0;7;0;7
19612;Šaltinėlis;"2B klasė";1756003648;Taip;0;20;0;20
19613;Šaltinėlis;"2B klasė";2002711790;Taip;0;9;0;9
19614;Šaltinėlis;"3A klasė";2010277249;Ne;0;5;0;5
19615;Šaltinėlis;"3A klasė";3553168020;Ne;0;5;0;5
19616;Šaltinėlis;"3A klasė";9341104954;Ne;0;10;0;10
19617;Šaltinėlis;"3A klasė";8714253922;Ne;0;7;0;7
19618;Šaltinėlis;"3A klasė";6948074305;Ne;0;8;0;8
19619;Šaltinėlis;"3A klasė";6765467361;Ne;0;11;0;11
19620;Šaltinėlis;"3A klasė";9057225956;Ne;0;7;0;7
19621;Šaltinėlis;"3A klasė";8503985429;Ne;0;11;0;11
19622;Šaltinėlis;"3A klasė";6443537515;Ne;0;12;0;12
19623;Šaltinėlis;"3A klasė";2154195956;Ne;0;11;0;11
19624;Šaltinėlis;"3A klasė";3636296862;Ne;0;7;0;7
19625;Šaltinėlis;"3A klasė";4062628468;Ne;0;10;0;10
19626;Šaltinėlis;"3A klasė";4977611599;Ne;0;8;0;8
19627;Šaltinėlis;"3A klasė";47857916979;Taip;0;20;0;20
19628;Šaltinėlis;"3A klasė";57928407025;Ne;0;20;0;20
19629;Šaltinėlis;"3A klasė";24414070672;Ne;0;20;0;20
19630;Šaltinėlis;"3A klasė";4884745983;Taip;0;20;0;20
19631;Šaltinėlis;"4A klasė";9593691923;Ne;0;11;0;11
19632;Šaltinėlis;"4A klasė";6511702530;Ne;0;20;0;20
19633;Šaltinėlis;"4A klasė";4852664619;Ne;0;5;0;5
19634;Šaltinėlis;"4A klasė";5000390873;Ne;0;5;0;5
19635;Šaltinėlis;"4A klasė";4673345747;Ne;0;8;0;8
19636;Šaltinėlis;"4A klasė";2890127126;Ne;0;5;0;5
19637;Šaltinėlis;"4A klasė";6507364244;Ne;0;5;0;5
19638;Šaltinėlis;"4A klasė";6109577947;Ne;0;5;0;5
19639;Šaltinėlis;"4A klasė";7820579483;Ne;0;9;0;9
19640;Šaltinėlis;"4A klasė";6716488827;Ne;0;10;0;10
19641;Šaltinėlis;"4A klasė";8503609901;Ne;0;20;0;20
19642;Šaltinėlis;"4A klasė";5212176791;Ne;0;5;0;5
19643;Šaltinėlis;"4A klasė";6810655952;Ne;0;7;0;7
19644;Šaltinėlis;"4A klasė";4699743123;Ne;0;10;0;10
19645;Šaltinėlis;"4A klasė";4989298444;Ne;0;6;0;6
19646;Šaltinėlis;"4A klasė";5234879459;Ne;0;5;0;5
19647;Šaltinėlis;"4A klasė";7307538614;Ne;0;5;0;5
19648;Šaltinėlis;"4A klasė";1322088652;Ne;0;5;0;5
19649;Šaltinėlis;"4A klasė";9980670695;Ne;0;11;0;11
19650;Šaltinėlis;"4A klasė";5574115620;Ne;0;5;0;5
19651;Šaltinėlis;"4A klasė";1765082898;Taip;0;20;0;20
19652;Šaltinėlis;"4A klasė";5623289398;Taip;0;20;0;20
19653;Šaltinėlis;"4A klasė";2310958087;Taip;0;5;0;5
19654;Šaltinėlis;"4A klasė";8431234082;Taip;0;20;0;20
19655;Šaltinėlis;3B;7917468152;Taip;0;8;0;8
19656;Šaltinėlis;3B;5181754988;Ne;0;6;0;6
19657;Šaltinėlis;3B;2413295020;Ne;0;20;0;20
19658;Šaltinėlis;3B;3680528737;Ne;0;5;0;5
19659;Šaltinėlis;3B;7404225862;Ne;0;10;0;10
19660;Šaltinėlis;3B;4335720836;Ne;0;5;0;5
19661;Šaltinėlis;3B;7121732840;Ne;0;6;0;6
19662;Šaltinėlis;3B;5105961386;Ne;0;5;0;5
19663;Šaltinėlis;3B;7316939619;Ne;0;5;0;5
19664;Šaltinėlis;3B;4543101402;Ne;0;6;0;6
19665;Šaltinėlis;3B;4994088781;Ne;0;6;0;6
19666;Šaltinėlis;3B;1687964284;Ne;0;5;0;5
19667;Šaltinėlis;3B;6381956693;Ne;0;5;0;5
19668;Šaltinėlis;3B;3375856084;Ne;0;10;0;10
19669;Šaltinėlis;3B;9708038079;Ne;0;10;0;10
19670;Šaltinėlis;3B;2160937385;Ne;0;5;0;5
19671;Šaltinėlis;3B;8670777468;Ne;0;7;0;7
19672;Gabijėlė;GANDRIUKŲ;80074896113;Taip;0;5;2;7
19673;Gabijėlė;GANDRIUKŲ;57976186090;Taip;0;5;8;13
19674;Gabijėlė;GANDRIUKŲ;78228886019;Taip;0;6;0;6
19675;Gabijėlė;GANDRIUKŲ;65824488786;Taip;0;15;0;15
19676;Gabijėlė;GANDRIUKŲ;58145931856;Taip;0;18;0;18
19677;Gabijėlė;GANDRIUKŲ;92468615840;Taip;10;5;0;15
19678;Gabijėlė;GANDRIUKŲ;17501127436;Taip;0;1;0;1
19679;Gabijėlė;GANDRIUKŲ;54616199708;Taip;4;2;0;6
19680;Gabijėlė;GANDRIUKŲ;82760473229;Taip;10;5;0;15
19681;Gabijėlė;GANDRIUKŲ;54950294060;Taip;0;5;0;5
19682;Gabijėlė;GANDRIUKŲ;1606787727;Taip;0;8;0;8
19683;Gabijėlė;GANDRIUKŲ;38806631565;Taip;0;5;1;6
19684;Gabijėlė;GANDRIUKŲ;43769142642;Taip;0;4;2;6
19685;Gabijėlė;GANDRIUKŲ;54152752437;Taip;0;5;0;5
19686;Gabijėlė;GANDRIUKŲ;36611753307;Taip;0;5;2;7
19687;Gabijėlė;GANDRIUKŲ;99562533454;Taip;0;5;1;6
19688;Gabijėlė;GANDRIUKŲ;77966124767;Taip;0;6;0;6
19689;Gabijėlė;GANDRIUKŲ;96909582388;Taip;2;0;0;2
19690;Gabijėlė;GANDRIUKŲ;26666095358;Taip;0;14;0;14
19691;Gabijėlė;GANDRIUKŲ;53845659478;Taip;4;2;0;6
19692;Gabijėlė;GANDRIUKŲ;68031503463;Taip;5;5;2;12
19693;Gabijėlė;GANDRIUKŲ;27958163601;Taip;5;5;1;11
19694;Gabijėlė;GANDRIUKŲ;12305494453;Taip;2;6;0;8
19695;Gabijėlė;GANDRIUKŲ;3694438650;Taip;0;5;3;8
19696;Gabijėlė;GANDRIUKŲ;62369588485;Taip;0;5;2;7
19697;Gabijėlė;LAKŠTINGALIUKŲ;94564160237;Taip;0;7;4;11
19698;Gabijėlė;LAKŠTINGALIUKŲ;92624581275;Taip;2;5;0;7
19699;Gabijėlė;LAKŠTINGALIUKŲ;38094271521;Taip;0;19;1;20
19700;Gabijėlė;LAKŠTINGALIUKŲ;87667047750;Taip;0;7;2;9
19701;Gabijėlė;LAKŠTINGALIUKŲ;34977494652;Taip;0;10;0;10
19702;Gabijėlė;LAKŠTINGALIUKŲ;15974374755;Taip;0;7;0;7
19703;Gabijėlė;LAKŠTINGALIUKŲ;53325200270;Taip;0;7;1;8
19704;Gabijėlė;LAKŠTINGALIUKŲ;44723366493;Taip;0;5;2;7
19705;Gabijėlė;LAKŠTINGALIUKŲ;78764062355;Taip;0;3;2;5
19706;Gabijėlė;LAKŠTINGALIUKŲ;94096115282;Taip;0;6;5;11
19707;Gabijėlė;LAKŠTINGALIUKŲ;80865629865;Taip;0;6;2;8
19708;Gabijėlė;LAKŠTINGALIUKŲ;87107559087;Taip;0;5;0;5
19709;Gabijėlė;LAKŠTINGALIUKŲ;58162540225;Taip;0;10;0;10
19710;Gabijėlė;LAKŠTINGALIUKŲ;49652680743;Taip;0;6;0;6
19711;Gabijėlė;LAKŠTINGALIUKŲ;64279008849;Taip;0;3;0;3
19712;Gabijėlė;LAKŠTINGALIUKŲ;69244396670;Taip;0;5;2;7
19713;Gabijėlė;LAKŠTINGALIUKŲ;48032842307;Taip;0;2;0;2
19714;Gabijėlė;LAKŠTINGALIUKŲ;10026417844;Taip;0;5;0;5
19715;Gabijėlė;LAKŠTINGALIUKŲ;80650155819;Taip;0;9;0;9
19716;Gabijėlė;LAKŠTINGALIUKŲ;3114114973;Taip;0;16;0;16
19717;Gabijėlė;ŽVIRBLIUKŲ;7043775905;Taip;12;3;0;15
19718;Gabijėlė;ŽVIRBLIUKŲ;4475530177;Taip;0;3;8;11
19719;Gabijėlė;ŽVIRBLIUKŲ;5743861607;Taip;13;5;0;18
19720;Gabijėlė;ŽVIRBLIUKŲ;7410541320;Taip;9;9;0;18
19721;Gabijėlė;ŽVIRBLIUKŲ;8036572198;Taip;0;19;0;19
19722;Gabijėlė;ŽVIRBLIUKŲ;4493192224;Taip;10;0;0;10
19723;Gabijėlė;ŽVIRBLIUKŲ;3268231136;Taip;0;14;0;14
19724;Gabijėlė;ŽVIRBLIUKŲ;8879972953;Taip;12;0;5;17
19725;Gabijėlė;ŽVIRBLIUKŲ;5332825339;Taip;20;0;0;20
19726;Gabijėlė;ŽVIRBLIUKŲ;9627906252;Taip;0;0;2;2
19727;Gabijėlė;ŽVIRBLIUKŲ;1725665169;Taip;5;5;0;10
19728;Gabijėlė;ŽVIRBLIUKŲ;2264669298;Taip;0;6;2;8
19729;Gabijėlė;ŽVIRBLIUKŲ;5942625633;Taip;0;8;0;8
19730;Gabijėlė;ŽVIRBLIUKŲ;7417179112;Taip;5;0;0;5
19731;Gabijėlė;ŽVIRBLIUKŲ;5387026410;Taip;5;0;0;5
19732;Gabijėlė;ŽVIRBLIUKŲ;8292463617;Taip;11;0;1;12
19733;Gabijėlė;GENIUKŲ;3445433386;Taip;0;12;0;12
19734;Gabijėlė;GENIUKŲ;2980295345;Taip;6;5;0;11
19735;Gabijėlė;GENIUKŲ;1862655595;Taip;0;1;0;1
19736;Gabijėlė;GENIUKŲ;7312628876;Taip;0;9;0;9
19737;Gabijėlė;GENIUKŲ;1581688238;Taip;9;0;0;9
19738;Gabijėlė;GENIUKŲ;5301905117;Taip;0;9;0;9
19739;Gabijėlė;GENIUKŲ;3176075887;Taip;13;3;0;16
19740;Gabijėlė;GENIUKŲ;6866641272;Taip;7;2;8;17
19741;Gabijėlė;GENIUKŲ;9972967198;Taip;15;0;0;15
19742;Gabijėlė;GENIUKŲ;8305098808;Taip;11;0;0;11
19743;Gabijėlė;GENIUKŲ;4880174255;Taip;3;3;0;6
19744;Gabijėlė;GENIUKŲ;1589534853;Taip;0;2;10;12
19745;Gabijėlė;GENIUKŲ;3020599503;Taip;10;5;0;15
19746;Gabijėlė;GENIUKŲ;4234733280;Taip;5;0;1;6
19747;Gabijėlė;GENIUKŲ;1922979974;Taip;7;0;0;7
19748;Gabijėlė;GENIUKŲ;6482824000;Taip;0;2;0;2
19749;Gabijėlė;GENIUKŲ;5962852108;Taip;13;0;1;14
19750;Gabijėlė;GENIUKŲ;7178676049;Taip;10;0;0;10
19751;Gabijėlė;DAGILIUKŲ;9348393550;Taip;12;0;0;12
19752;Gabijėlė;DAGILIUKŲ;4264925447;Taip;12;0;0;12
19753;Gabijėlė;DAGILIUKŲ;9120107749;Taip;10;0;0;10
19754;Gabijėlė;DAGILIUKŲ;7426579018;Taip;20;0;0;20
19755;Gabijėlė;DAGILIUKŲ;9783343968;Taip;0;1;0;1
19756;Gabijėlė;DAGILIUKŲ;6438144206;Taip;0;0;3;3
19757;Gabijėlė;DAGILIUKŲ;3017939983;Taip;15;0;0;15
19758;Gabijėlė;DAGILIUKŲ;4462129182;Taip;13;0;0;13
19759;Gabijėlė;DAGILIUKŲ;8662914262;Taip;0;4;0;4
19760;Gabijėlė;DAGILIUKŲ;9280283478;Taip;15;0;0;15
19761;Gabijėlė;DAGILIUKŲ;1988597157;Taip;14;0;0;14
19762;Gabijėlė;PELEDŽIUKŲ;94478599707;Taip;0;5;1;6
19763;Gabijėlė;PELEDŽIUKŲ;2067646395;Taip;0;4;0;4
19764;Gabijėlė;PELEDŽIUKŲ;1068556799;Taip;0;6;0;6
19765;Gabijėlė;PELEDŽIUKŲ;1171257945;Taip;0;5;5;10
19766;Gabijėlė;PELEDŽIUKŲ;8044682830;Taip;0;12;0;12
19767;Gabijėlė;PELEDŽIUKŲ;43109352262;Taip;0;11;0;11
19768;Gabijėlė;PELEDŽIUKŲ;39679870094;Taip;0;3;0;3
19769;Gabijėlė;PELEDŽIUKŲ;36642141718;Taip;0;3;0;3
19770;Gabijėlė;PELEDŽIUKŲ;1608940997;Taip;0;1;0;1
19771;Gabijėlė;PELEDŽIUKŲ;3610392405;Taip;10;0;0;10
19772;Gabijėlė;PELEDŽIUKŲ;4916964663;Taip;3;5;0;8
19773;Gabijėlė;PELEDŽIUKŲ;17443601729;Taip;2;0;3;5
19774;Gabijėlė;PELEDŽIUKŲ;1286307671;Taip;10;4;0;14
19775;Gabijėlė;PELEDŽIUKŲ;8428069167;Taip;0;1;0;1
19776;Gabijėlė;PELEDŽIUKŲ;4726771205;Taip;0;4;1;5
19777;Gabijėlė;PELEDŽIUKŲ;24035160251;Taip;20;0;0;20
19778;Gabijėlė;PELEDŽIUKŲ;38497069329;Taip;0;5;3;8
19779;Gabijėlė;PELEDŽIUKŲ;54948441867;Taip;0;2;0;2
19780;Gabijėlė;PELEDŽIUKŲ;57559227292;Taip;10;0;0;10
19781;Gabijėlė;PELEDŽIUKŲ;65735862964;Taip;13;0;0;13
19782;Gabijėlė;PELEDŽIUKŲ;8746641978;Taip;0;0;3;3
19783;Gabijėlė;KREGZDŽIUKŲ;84945768423;Taip;0;5;3;8
19784;Gabijėlė;KREGZDŽIUKŲ;41661694634;Taip;0;5;3;8
19785;Gabijėlė;KREGZDŽIUKŲ;1743647754;Taip;0;7;2;9
19786;Gabijėlė;KREGZDŽIUKŲ;79544806044;Taip;0;3;1;4
19787;Gabijėlė;KREGZDŽIUKŲ;34683603878;Taip;0;4;2;6
19788;Gabijėlė;KREGZDŽIUKŲ;13013873198;Taip;0;6;0;6
19789;Gabijėlė;KREGZDŽIUKŲ;91643373754;Taip;6;5;1;12
19790;Gabijėlė;KREGZDŽIUKŲ;7298662616;Taip;0;8;1;9
19791;Gabijėlė;KREGZDŽIUKŲ;5884453557;Taip;0;5;0;5
19792;Gabijėlė;KREGZDŽIUKŲ;61217725255;Taip;5;0;0;5
19793;Gabijėlė;KREGZDŽIUKŲ;53576382572;Taip;0;4;0;4
19794;Gabijėlė;KREGZDŽIUKŲ;2958504770;Taip;2;0;1;3
19795;Gabijėlė;KREGZDŽIUKŲ;34998957585;Taip;15;0;1;16
19796;Gabijėlė;KREGZDŽIUKŲ;1770578935;Taip;0;13;0;13
19797;Gabijėlė;KREGZDŽIUKŲ;1937862725;Taip;0;1;4;5
19798;Gabijėlė;KREGZDŽIUKŲ;25732601952;Taip;0;5;1;6
19799;Gabijėlė;KREGZDŽIUKŲ;1217019582;Taip;0;0;2;2
19800;Gabijėlė;KREGZDŽIUKŲ;46552208567;Taip;11;4;0;15
19801;Gabijėlė;KREGZDŽIUKŲ;62457368692;Taip;0;5;0;5
19802;Gabijėlė;KREGZDŽIUKŲ;26058036933;Taip;9;0;0;9
19803;Gabijėlė;KREGZDŽIUKŲ;84120660883;Taip;9;0;0;9
19804;Gabijėlė;KREGZDŽIUKŲ;69294465170;Taip;0;12;0;12
19805;Gabijėlė;ZYLIUKŲ;41421082754;Taip;0;1;0;1
19806;Gabijėlė;ZYLIUKŲ;90540638931;Taip;0;1;0;1
19807;Gabijėlė;ZYLIUKŲ;20248530233;Taip;0;5;15;20
19808;Gabijėlė;ZYLIUKŲ;70110432877;Taip;0;1;0;1
19809;Gabijėlė;ZYLIUKŲ;84464214049;Taip;0;6;0;6
19810;Gabijėlė;ZYLIUKŲ;89100449385;Taip;0;5;0;5
19811;Gabijėlė;ZYLIUKŲ;1505873499;Taip;0;5;1;6
19812;Gabijėlė;ZYLIUKŲ;1523021309;Taip;0;5;0;5
19813;Gabijėlė;ZYLIUKŲ;1257150362;Taip;0;6;0;6
19814;Gabijėlė;ZYLIUKŲ;32203098792;Taip;0;5;0;5
19815;Gabijėlė;ZYLIUKŲ;1642361191;Taip;0;0;5;5
19816;Gabijėlė;ZYLIUKŲ;67189240970;Taip;0;15;0;15
19817;Gabijėlė;ZYLIUKŲ;1036201997;Taip;12;1;0;13
19818;Gabijėlė;ZYLIUKŲ;1240051312;Taip;0;2;11;13
19819;Gabijėlė;ZYLIUKŲ;60548215051;Taip;0;2;17;19
19820;Gabijėlė;ZYLIUKŲ;64168611850;Taip;7;5;0;12
19821;Gabijėlė;ZYLIUKŲ;1988838165;Taip;0;8;0;8
19822;Gabijėlė;ZYLIUKŲ;7778613039;Taip;0;5;0;5
19823;Gabijėlė;ZYLIUKŲ;1583728977;Taip;0;5;0;5
19824;Gabijėlė;ZYLIUKŲ;31458685084;Taip;0;3;0;3
19825;Gabijėlė;ZYLIUKŲ;16804922682;Taip;10;4;0;14
19826;Gabijėlė;ZYLIUKŲ;1213013384;Taip;0;0;3;3
19827;Gabijėlė;ZYLIUKŲ;2010619186;Taip;0;0;12;12
19828;Gabijėlė;ZYLIUKŲ;1145863002;Taip;9;0;0;9
19829;Gabijėlė;VOLUNGĖLIŲ;1779924073;Taip;0;2;12;14
19830;Gabijėlė;VOLUNGĖLIŲ;4166739739;Taip;0;14;3;17
19831;Gabijėlė;VOLUNGĖLIŲ;1492231030;Taip;0;14;3;17
19832;Gabijėlė;VOLUNGĖLIŲ;1317309811;Taip;0;14;0;14
19833;Gabijėlė;VOLUNGĖLIŲ;1523331860;Taip;8;1;0;9
19834;Gabijėlė;VOLUNGĖLIŲ;21740150080;Taip;0;9;0;9
19835;Gabijėlė;VOLUNGĖLIŲ;5558919097;Taip;10;0;0;10
19836;Gabijėlė;VOLUNGĖLIŲ;9683524530;Taip;9;0;3;12
19837;Gabijėlė;VOLUNGĖLIŲ;59837942520;Taip;0;5;0;5
19838;Gabijėlė;VOLUNGĖLIŲ;46021970332;Taip;5;0;4;9
19839;Gabijėlė;VOLUNGĖLIŲ;8480479946;Taip;0;6;0;6
19840;Gabijėlė;VOLUNGĖLIŲ;13265905500;Taip;0;0;7;7
19841;Gabijėlė;VOLUNGĖLIŲ;43737170074;Taip;13;0;0;13
19842;Gabijėlė;VOLUNGĖLIŲ;1480704497;Taip;0;11;0;11
19843;Gabijėlė;VOLUNGĖLIŲ;5704281727;Taip;0;5;3;8
19844;Gabijėlė;VOLUNGĖLIŲ;95685721388;Taip;10;10;0;20
19845;Gabijėlė;VOLUNGĖLIŲ;29328876924;Taip;0;9;0;9
19846;Gabijėlė;VOLUNGĖLIŲ;2102821834;Taip;0;5;0;5
19847;Gabijėlė;VOLUNGĖLIŲ;43869055555;Ne;0;0;1;1
19848;Gabijėlė;VOLUNGĖLIŲ;6271780003;Taip;0;5;0;5
19849;Gabijėlė;VOLUNGĖLIŲ;2051109865;Taip;0;12;0;12
19850;Gabijėlė;VOLUNGĖLIŲ;4662981914;Taip;20;0;0;20
19851;Gabijėlė;VOLUNGĖLIŲ;64252867351;Taip;0;20;0;20
19852;Gabijėlė;ANČIUKŲ;43123279348;Taip;0;14;0;14
19853;Gabijėlė;ANČIUKŲ;2036978425;Taip;0;5;4;9
19854;Gabijėlė;ANČIUKŲ;5219706067;Taip;12;1;0;13
19855;Gabijėlė;ANČIUKŲ;10796114623;Taip;0;3;0;3
19856;Gabijėlė;ANČIUKŲ;3454412432;Taip;5;0;0;5
19857;Gabijėlė;ANČIUKŲ;9822093084;Taip;0;5;2;7
19858;Gabijėlė;ANČIUKŲ;1415184607;Taip;0;5;4;9
19859;Gabijėlė;ANČIUKŲ;85836097485;Taip;0;0;10;10
19860;Gabijėlė;ANČIUKŲ;28017865889;Taip;0;14;0;14
19861;Gabijėlė;ANČIUKŲ;1917587420;Taip;0;13;0;13
19862;Gabijėlė;ANČIUKŲ;1465584524;Taip;12;0;0;12
19863;Gabijėlė;ANČIUKŲ;6198439092;Taip;8;0;0;8
19864;Gabijėlė;ANČIUKŲ;5783373671;Taip;0;11;0;11
19865;Gabijėlė;ANČIUKŲ;7948343328;Taip;5;0;7;12
19866;Gabijėlė;ANČIUKŲ;2052892422;Taip;0;0;3;3
19867;Gabijėlė;ANČIUKŲ;8111239476;Taip;20;0;0;20
19868;Gabijėlė;ANČIUKŲ;6766770793;Taip;0;1;1;2
19869;Gabijėlė;ANČIUKŲ;8778396292;Taip;5;5;4;14
19870;Gabijėlė;ANČIUKŲ;4085049535;Taip;0;18;0;18
19871;Gabijėlė;BALANDŽIUKŲ;6719097956;Taip;0;1;1;2
19872;Gabijėlė;BALANDŽIUKŲ;9157819780;Taip;0;4;0;4
19873;Gabijėlė;BALANDŽIUKŲ;1045338865;Taip;0;0;2;2
19874;Gabijėlė;BALANDŽIUKŲ;4330624300;Taip;15;0;0;15
19875;Gabijėlė;BALANDŽIUKŲ;33124420723;Taip;0;10;1;11
19876;Gabijėlė;BALANDŽIUKŲ;2097260657;Taip;5;5;0;10
19877;Gabijėlė;BALANDŽIUKŲ;8131229306;Taip;15;0;0;15
19878;Gabijėlė;BALANDŽIUKŲ;8525869648;Taip;0;7;0;7
19879;Gabijėlė;BALANDŽIUKŲ;1010721404;Taip;0;7;0;7
19880;Gabijėlė;BALANDŽIUKŲ;56914218692;Taip;0;0;1;1
19881;Gabijėlė;BALANDŽIUKŲ;2070050969;Taip;2;5;2;9
19882;Gabijėlė;BALANDŽIUKŲ;2260623869;Taip;14;5;0;19
19883;Gabijėlė;BALANDŽIUKŲ;7144977279;Taip;0;7;0;7
19884;Gabijėlė;BALANDŽIUKŲ;15049855022;Taip;0;8;0;8
19885;Gabijėlė;BALANDŽIUKŲ;2776579713;Taip;0;4;0;4
19886;Gabijėlė;BALANDŽIUKŲ;7977751362;Taip;5;0;0;5
19887;Gabijėlė;BALANDŽIUKŲ;5906952432;Taip;5;0;0;5
19888;Gabijėlė;BALANDŽIUKŲ;9197020006;Taip;0;3;0;3
19889;Gabijėlė;VYTURIUKŲ;2059859352;Taip;6;0;2;8
19890;Gabijėlė;VYTURIUKŲ;3484413830;Taip;0;5;0;5
19891;Gabijėlė;VYTURIUKŲ;1859288888;Taip;15;5;0;20
19892;Gabijėlė;VYTURIUKŲ;44322663690;Taip;0;2;7;9
19893;Gabijėlė;VYTURIUKŲ;1479311429;Taip;0;5;0;5
19894;Gabijėlė;VYTURIUKŲ;4765125810;Taip;0;5;1;6
19895;Gabijėlė;VYTURIUKŲ;1219257874;Taip;9;0;1;10
19896;Gabijėlė;VYTURIUKŲ;39269336820;Taip;5;4;0;9
19897;Gabijėlė;VYTURIUKŲ;1829866148;Taip;7;0;3;10
19898;Gabijėlė;VYTURIUKŲ;1949644078;Taip;0;1;0;1
19899;Gabijėlė;VYTURIUKŲ;47989272121;Taip;0;12;0;12
19900;Gabijėlė;VYTURIUKŲ;5736000160;Taip;6;4;0;10
19901;Gabijėlė;VYTURIUKŲ;9320327120;Taip;10;0;0;10
19902;Gabijėlė;VYTURIUKŲ;4632508075;Taip;0;3;2;5
19903;Gabijėlė;VYTURIUKŲ;1426802917;Taip;4;2;3;9
19904;Gabijėlė;VYTURIUKŲ;41212490042;Taip;4;0;1;5
19905;Gabijėlė;VYTURIUKŲ;1852597048;Taip;8;0;0;8
19906;Gabijėlė;VYTURIUKŲ;34609028374;Taip;0;4;0;4
19907;Gabijėlė;VYTURIUKŲ;48342584892;Taip;0;8;0;8
19908;Gabijėlė;VYTURIUKŲ;1185452849;Taip;0;5;0;5
19909;Gabijėlė;VYTURIUKŲ;90520726029;Taip;1;0;0;1
19910;Gabijėlė;VYTURIUKŲ;6492199649;Taip;10;1;0;11
19911;Pilaitukas;BITUTĖS;27134663020;Taip;13;4;1;18
19912;Pilaitukas;BITUTĖS;93292073339;Taip;13;4;1;18
19913;Pilaitukas;BITUTĖS;25872504305;Taip;0;5;0;5
19914;Pilaitukas;BITUTĖS;99558991322;Taip;0;10;3;13
19915;Pilaitukas;BITUTĖS;46467461875;Taip;0;11;0;11
19916;Pilaitukas;BITUTĖS;97868106590;Taip;0;2;1;3
19917;Pilaitukas;BITUTĖS;56237836622;Taip;0;6;0;6
19918;Pilaitukas;BITUTĖS;98123777614;Taip;0;6;0;6
19919;Pilaitukas;BITUTĖS;29035791508;Taip;0;2;1;3
19920;Pilaitukas;BITUTĖS;49882457703;Taip;20;0;0;20
19921;Pilaitukas;BITUTĖS;98876022289;Taip;10;0;0;10
19922;Pilaitukas;BITUTĖS;32580431386;Taip;6;0;0;6
19923;Pilaitukas;BITUTĖS;61458733284;Taip;0;0;4;4
19924;Pilaitukas;BITUTĖS;68262699910;Taip;0;0;1;1
19925;Pilaitukas;BITUTĖS;36677686051;Taip;0;1;0;1
19926;Pilaitukas;BITUTĖS;89335569661;Taip;10;1;0;11
19927;Pilaitukas;BITUTĖS;74933839730;Taip;5;2;0;7
19928;Pilaitukas;BITUTĖS;26318820010;Taip;0;7;1;8
19929;Pilaitukas;BITUTĖS;61725559703;Taip;0;0;1;1
19930;Pilaitukas;BITUTĖS;68819621853;Taip;0;5;0;5
19931;Pilaitukas;BITUTĖS;17314387753;Taip;0;3;0;3
19932;Pilaitukas;BITUTĖS;92116532227;Taip;0;0;2;2
19933;Pilaitukas;BITUTĖS;1854471823;Taip;0;1;0;1
19934;Pilaitukas;BITUTĖS;95753711905;Taip;0;2;0;2
19935;Pilaitukas;ZUIKUČIAI;66377321935;Taip;0;10;0;10
19936;Pilaitukas;ZUIKUČIAI;27233065857;Taip;0;0;1;1
19937;Pilaitukas;ZUIKUČIAI;74367577786;Taip;5;1;1;7
19938;Pilaitukas;ZUIKUČIAI;37415672544;Taip;12;0;0;12
19939;Pilaitukas;ZUIKUČIAI;50368168240;Taip;0;5;3;8
19940;Pilaitukas;ZUIKUČIAI;21795184411;Taip;6;5;0;11
19941;Pilaitukas;ZUIKUČIAI;63470473930;Taip;10;6;0;16
19942;Pilaitukas;ZUIKUČIAI;49728283339;Taip;9;0;0;9
19943;Pilaitukas;ZUIKUČIAI;45165187254;Taip;0;1;0;1
19944;Pilaitukas;ZUIKUČIAI;49542027658;Taip;3;5;1;9
19945;Pilaitukas;ZUIKUČIAI;62992423192;Taip;8;2;2;12
19946;Pilaitukas;ZUIKUČIAI;72753220553;Taip;10;0;0;10
19947;Pilaitukas;ZUIKUČIAI;86572852457;Taip;10;0;0;10
19948;Pilaitukas;ZUIKUČIAI;1707355162;Taip;2;0;0;2
19949;Pilaitukas;ZUIKUČIAI;6913383121;Ne;0;4;0;4
19950;Pilaitukas;ZUIKUČIAI;1824063553;Taip;1;0;1;2
19951;Pilaitukas;ZUIKUČIAI;44413072002;Taip;9;0;0;9
19952;Pilaitukas;ZUIKUČIAI;53049608654;Taip;0;2;16;18
19953;Pilaitukas;ZUIKUČIAI;79398058989;Taip;0;5;1;6
19954;Pilaitukas;ZUIKUČIAI;8441380474;Taip;4;5;1;10
19955;Pilaitukas;ZUIKUČIAI;1286286153;Taip;14;0;0;14
19956;Pilaitukas;ZUIKUČIAI;83886439719;Taip;18;0;0;18
19957;Pilaitukas;ZUIKUČIAI;3723836301;Taip;12;0;0;12
19958;Pilaitukas;ZUIKUČIAI;1896452184;Taip;18;0;0;18
19959;Pilaitukas;ZUIKUČIAI;81347327136;Taip;2;0;0;2
19960;Pilaitukas;ANČIUKAI;5949185075;Taip;0;5;0;5
19961;Pilaitukas;ANČIUKAI;92108889661;Taip;3;0;2;5
19962;Pilaitukas;ANČIUKAI;9724892897;Taip;5;0;0;5
19963;Pilaitukas;ANČIUKAI;36338976218;Taip;11;0;0;11
19964;Pilaitukas;ANČIUKAI;1114477688;Taip;9;0;0;9
19965;Pilaitukas;ANČIUKAI;1512181401;Taip;3;0;3;6
19966;Pilaitukas;ANČIUKAI;3821748678;Taip;10;0;0;10
19967;Pilaitukas;ANČIUKAI;6222888898;Taip;5;0;0;5
19968;Pilaitukas;ANČIUKAI;8319676743;Taip;0;5;0;5
19969;Pilaitukas;ANČIUKAI;4505384039;Taip;5;0;0;5
19970;Pilaitukas;ANČIUKAI;5206439753;Taip;0;6;5;11
19971;Pilaitukas;ANČIUKAI;79485847381;Taip;5;1;0;6
19972;Pilaitukas;ANČIUKAI;5211988291;Taip;15;1;0;16
19973;Pilaitukas;ANČIUKAI;2117570444;Taip;16;0;0;16
19974;Pilaitukas;ANČIUKAI;87760608710;Taip;5;2;11;18
19975;Pilaitukas;ANČIUKAI;7909465673;Taip;8;0;1;9
19976;Pilaitukas;ANČIUKAI;2298935154;Taip;15;0;0;15
19977;Pilaitukas;ANČIUKAI;4694691187;Taip;9;2;0;11
19978;Pilaitukas;ANČIUKAI;9224653856;Taip;5;2;0;7
19979;Pilaitukas;MEŠKIUKAI;57931719105;Taip;5;0;0;5
19980;Pilaitukas;MEŠKIUKAI;9015675095;Taip;0;1;3;4
19981;Pilaitukas;MEŠKIUKAI;2929868229;Taip;2;0;0;2
19982;Pilaitukas;MEŠKIUKAI;1135880899;Taip;0;5;0;5
19983;Pilaitukas;MEŠKIUKAI;4505147961;Taip;3;0;0;3
19984;Pilaitukas;MEŠKIUKAI;9618329726;Taip;10;0;0;10
19985;Pilaitukas;MEŠKIUKAI;6514784647;Taip;2;0;0;2
19986;Pilaitukas;MEŠKIUKAI;9732741366;Taip;8;0;0;8
19987;Pilaitukas;MEŠKIUKAI;4038320896;Taip;8;0;2;10
19988;Pilaitukas;MEŠKIUKAI;3794882532;Taip;5;1;0;6
19989;Pilaitukas;MEŠKIUKAI;18466900688;Taip;17;0;0;17
19990;Pilaitukas;MEŠKIUKAI;2736736697;Taip;5;0;2;7
19991;Pilaitukas;MEŠKIUKAI;3214740183;Taip;1;5;1;7
19992;Pilaitukas;MEŠKIUKAI;39600380611;Taip;14;0;0;14
19993;Pilaitukas;MEŠKIUKAI;5604992163;Taip;0;6;0;6
19994;Pilaitukas;MEŠKIUKAI;9450834035;Taip;0;6;0;6
19995;Pilaitukas;MEŠKIUKAI;5689385925;Taip;15;1;0;16
19996;Pilaitukas;MEŠKIUKAI;1003278169;Taip;7;0;0;7
19997;Pilaitukas;MEŠKIUKAI;5939557073;Taip;5;1;0;6
19998;Pilaitukas;MEŠKIUKAI;6117985788;Taip;11;0;1;12
19999;Pilaitukas;MEŠKIUKAI;9924612250;Taip;8;0;1;9
20000;Pilaitukas;ŽUVYTĖS;93589370424;Taip;7;0;0;7
20001;Pilaitukas;ŽUVYTĖS;49645077501;Taip;0;5;0;5
20002;Pilaitukas;ŽUVYTĖS;4068489824;Taip;1;0;0;1
20003;Pilaitukas;ŽUVYTĖS;87221246739;Taip;0;0;1;1
20004;Pilaitukas;ŽUVYTĖS;81748034503;Taip;0;3;0;3
20005;Pilaitukas;ŽUVYTĖS;44575161837;Taip;0;5;0;5
20006;Pilaitukas;ŽUVYTĖS;16099834356;Taip;0;7;3;10
20007;Pilaitukas;ŽUVYTĖS;83211068266;Taip;0;5;0;5
20008;Pilaitukas;ŽUVYTĖS;62503472334;Taip;0;0;1;1
20009;Pilaitukas;ŽUVYTĖS;7328603850;Taip;0;6;0;6
20010;Pilaitukas;ŽUVYTĖS;61755266054;Taip;0;5;0;5
20011;Pilaitukas;ŽUVYTĖS;63984542506;Taip;1;0;0;1
20012;Pilaitukas;ŽUVYTĖS;95470553230;Taip;3;3;0;6
20013;Pilaitukas;ŽUVYTĖS;7831679444;Taip;3;0;0;3
20014;Pilaitukas;ŽUVYTĖS;86867736047;Taip;0;5;1;6
20015;Pilaitukas;ŽUVYTĖS;26107492404;Taip;4;0;0;4
20016;Pilaitukas;ŽUVYTĖS;20697780436;Ne;0;1;1;2
20017;Pilaitukas;ŽUVYTĖS;54410118765;Taip;0;1;0;1
20018;Pilaitukas;PAUKŠTELIAI;9471549377;Taip;10;5;0;15
20019;Pilaitukas;PAUKŠTELIAI;76405230943;Taip;0;7;1;8
20020;Pilaitukas;PAUKŠTELIAI;63957573208;Taip;0;5;0;5
20021;Pilaitukas;PAUKŠTELIAI;15970261850;Taip;0;5;0;5
20022;Pilaitukas;PAUKŠTELIAI;67100267095;Taip;5;5;1;11
20023;Pilaitukas;PAUKŠTELIAI;98711809989;Taip;20;0;0;20
20024;Pilaitukas;PAUKŠTELIAI;59647179478;Taip;2;3;0;5
20025;Pilaitukas;PAUKŠTELIAI;18957334122;Taip;0;5;2;7
20026;Pilaitukas;PAUKŠTELIAI;50014639216;Taip;0;4;0;4
20027;Pilaitukas;PAUKŠTELIAI;46383254281;Taip;1;1;0;2
20028;Pilaitukas;PAUKŠTELIAI;70243036036;Taip;0;5;0;5
20029;Pilaitukas;PAUKŠTELIAI;61157601075;Taip;0;5;0;5
20030;Pilaitukas;PAUKŠTELIAI;1187929409;Taip;4;9;0;13
20031;Pilaitukas;PAUKŠTELIAI;97891667232;Taip;0;5;2;7
20032;Pilaitukas;PAUKŠTELIAI;41623603103;Taip;0;5;4;9
20033;Pilaitukas;PAUKŠTELIAI;67880125472;Taip;0;4;6;10
20034;Pilaitukas;PAUKŠTELIAI;8978245239;Taip;15;5;0;20
20035;Pilaitukas;PAUKŠTELIAI;1836597284;Ne;2;5;3;10
20036;Pilaitukas;PAUKŠTELIAI;86837043817;Taip;0;8;0;8
20037;Pilaitukas;PAUKŠTELIAI;51715261040;Taip;0;5;0;5
20038;Pilaitukas;PAUKŠTELIAI;94197429703;Taip;5;7;0;12
20039;Pilaitukas;BORUŽĖLĖS;98045145204;Taip;0;5;0;5
20040;Pilaitukas;BORUŽĖLĖS;26354100027;Taip;5;0;0;5
20041;Pilaitukas;BORUŽĖLĖS;2145561638;Taip;0;15;1;16
20042;Pilaitukas;BORUŽĖLĖS;14937983736;Taip;1;5;0;6
20043;Pilaitukas;BORUŽĖLĖS;1704733670;Ne;0;2;3;5
20044;Pilaitukas;BORUŽĖLĖS;8693280134;Taip;0;2;18;20
20045;Pilaitukas;BORUŽĖLĖS;2308673826;Taip;0;5;0;5
20046;Pilaitukas;BORUŽĖLĖS;1714711904;Taip;1;0;0;1
20047;Pilaitukas;BORUŽĖLĖS;2436416327;Taip;5;0;0;5
20048;Pilaitukas;BORUŽĖLĖS;2561804291;Taip;4;5;3;12
20049;Pilaitukas;BORUŽĖLĖS;9414846817;Taip;11;2;2;15
20050;Pilaitukas;BORUŽĖLĖS;56069293343;Taip;0;0;1;1
20051;Pilaitukas;BORUŽĖLĖS;7156205658;Taip;0;5;11;16
20052;Pilaitukas;BORUŽĖLĖS;1142014148;Taip;7;6;0;13
20053;Pilaitukas;BORUŽĖLĖS;95439358242;Ne;0;2;3;5
20054;Pilaitukas;BORUŽĖLĖS;6024861998;Taip;17;0;0;17
20055;Pilaitukas;BORUŽĖLĖS;58416972423;Taip;0;2;6;8
20056;Pilaitukas;BORUŽĖLĖS;1187805506;Taip;0;2;6;8
20057;Pilaitukas;BORUŽĖLĖS;1779631590;Taip;0;5;0;5
20058;Pilaitukas;BORUŽĖLĖS;3198896300;Taip;6;5;0;11
20059;Pilaitukas;DRUGELIAI;70499278669;Taip;5;5;0;10
20060;Pilaitukas;DRUGELIAI;86192743256;Taip;0;3;0;3
20061;Pilaitukas;DRUGELIAI;1126288017;Taip;5;0;2;7
20062;Pilaitukas;DRUGELIAI;89880758183;Taip;0;6;0;6
20063;Pilaitukas;DRUGELIAI;1726899445;Taip;1;0;2;3
20064;Pilaitukas;DRUGELIAI;2032732500;Taip;0;11;0;11
20065;Pilaitukas;DRUGELIAI;1586157196;Taip;5;2;0;7
20066;Pilaitukas;DRUGELIAI;7961518607;Taip;5;4;0;9
20067;Pilaitukas;DRUGELIAI;7082054458;Taip;5;4;0;9
20068;Pilaitukas;DRUGELIAI;1290119150;Taip;11;0;0;11
20069;Pilaitukas;DRUGELIAI;64601938351;Taip;0;4;0;4
20070;Pilaitukas;DRUGELIAI;64496490473;Taip;0;3;0;3
20071;Pilaitukas;DRUGELIAI;93217431744;Taip;0;5;4;9
20072;Pilaitukas;DRUGELIAI;62416017620;Taip;0;5;1;6
20073;Pilaitukas;DRUGELIAI;58250008277;Taip;16;0;0;16
20074;Pilaitukas;DRUGELIAI;38456484551;Taip;0;7;0;7
20075;Pilaitukas;DRUGELIAI;7838787153;Taip;10;0;0;10
20076;Pilaitukas;DRUGELIAI;2613078582;Taip;15;5;0;20
20077;Pilaitukas;DRUGELIAI;9246391309;Taip;1;0;2;3
20078;Pilaitukas;PELIUKAI;89730708991;Taip;3;2;7;12
20079;Pilaitukas;PELIUKAI;71302602535;Taip;7;0;0;7
20080;Pilaitukas;PELIUKAI;28559756114;Taip;0;5;0;5
20081;Pilaitukas;PELIUKAI;54387359229;Taip;10;5;0;15
20082;Pilaitukas;PELIUKAI;29229117661;Taip;0;5;0;5
20083;Pilaitukas;PELIUKAI;15303269615;Taip;1;5;0;6
20084;Pilaitukas;PELIUKAI;12327235652;Ne;2;1;0;3
20085;Pilaitukas;PELIUKAI;26063381713;Taip;0;9;0;9
20086;Pilaitukas;PELIUKAI;90148331957;Taip;8;5;0;13
20087;Pilaitukas;PELIUKAI;89719236172;Taip;0;9;0;9
20088;Pilaitukas;PELIUKAI;49084081967;Taip;12;3;0;15
20089;Pilaitukas;PELIUKAI;3685682772;Taip;12;5;0;17
20090;Pilaitukas;PELIUKAI;25608611239;Taip;3;5;0;8
20091;Pilaitukas;PELIUKAI;54706920576;Taip;9;0;0;9
20092;Pilaitukas;PELIUKAI;1168958446;Taip;1;0;0;1
20093;Pilaitukas;PELIUKAI;8152280709;Taip;7;5;0;12
20094;Pilaitukas;PELIUKAI;1613536796;Taip;3;0;0;3
20095;Pilaitukas;PELIUKAI;42514613325;Taip;6;0;1;7
20096;Pilaitukas;PELIUKAI;1509971492;Taip;5;0;0;5
20097;Pilaitukas;PELIUKAI;1611616941;Taip;3;0;2;5
20098;Pilaitukas;PELIUKAI;1726805610;Taip;5;1;1;7
20099;Pilaitukas;PELIUKAI;68571454940;Taip;6;0;0;6
20100;Pilaitukas;KAČIUKAI;74264627858;Taip;13;5;0;18
20101;Pilaitukas;KAČIUKAI;71072645939;Taip;2;6;0;8
20102;Pilaitukas;KAČIUKAI;70465651068;Taip;2;6;0;8
20103;Pilaitukas;KAČIUKAI;4283157555;Taip;1;15;0;16
20104;Pilaitukas;KAČIUKAI;78293798850;Taip;0;5;0;5
20105;Pilaitukas;KAČIUKAI;90472705680;Taip;0;5;0;5
20106;Pilaitukas;KAČIUKAI;58064353914;Taip;0;1;0;1
20107;Pilaitukas;KAČIUKAI;92823052045;Taip;5;5;0;10
20108;Pilaitukas;KAČIUKAI;82030031331;Taip;4;5;0;9
20109;Pilaitukas;KAČIUKAI;7032684121;Taip;0;5;0;5
20110;Pilaitukas;KAČIUKAI;28902841059;Taip;1;5;0;6
20111;Pilaitukas;KAČIUKAI;2045735700;Taip;1;5;0;6
20112;Pilaitukas;KAČIUKAI;82688660737;Taip;2;5;0;7
20113;Pilaitukas;KAČIUKAI;1508672511;Taip;4;3;0;7
20114;Pilaitukas;KAČIUKAI;4348058482;Taip;6;5;0;11
20115;Pilaitukas;KAČIUKAI;17571219106;Taip;5;9;0;14
20116;Pilaitukas;KAČIUKAI;34346418650;Taip;5;0;0;5
20117;Pilaitukas;KAČIUKAI;9496336005;Taip;0;9;0;9
20118;Pilaitukas;KAČIUKAI;6069797837;Taip;3;2;2;7
20119;Pilaitukas;SAULUTĖS;6646474196;Taip;16;0;0;16
20120;Pilaitukas;SAULUTĖS;9414051187;Taip;20;0;0;20
20121;Pilaitukas;SAULUTĖS;3037850837;Taip;3;0;0;3
20122;Pilaitukas;SAULUTĖS;4745358362;Taip;0;7;1;8
20123;Pilaitukas;SAULUTĖS;1677962644;Taip;0;7;1;8
20124;Pilaitukas;SAULUTĖS;7568744500;Taip;0;16;0;16
20125;Pilaitukas;SAULUTĖS;5407354218;Taip;12;5;0;17
20126;Pilaitukas;SAULUTĖS;6525191057;Taip;2;0;0;2
20127;Pilaitukas;SAULUTĖS;6838035491;Taip;2;0;0;2
20128;Pilaitukas;SAULUTĖS;3483758882;Taip;0;6;0;6
20129;Pilaitukas;SAULUTĖS;7853910193;Taip;0;2;4;6
20130;Pilaitukas;SAULUTĖS;5710747769;Taip;15;2;1;18
20131;Pilaitukas;SAULUTĖS;9974310580;Taip;9;5;0;14
20132;Pilaitukas;SAULUTĖS;9126553732;Taip;0;3;1;4
20133;Pilaitukas;SAULUTĖS;7438112270;Taip;7;2;7;16
20134;Pilaitukas;SAULUTĖS;7594484959;Taip;10;4;0;14
20135;Pilaitukas;MENULIUKAI;2406183145;Taip;0;6;4;10
20136;Pilaitukas;MENULIUKAI;2379660463;Taip;0;6;4;10
20137;Pilaitukas;MENULIUKAI;2862447956;Taip;0;2;0;2
20138;Pilaitukas;MENULIUKAI;8727175656;Taip;0;2;0;2
20139;Pilaitukas;MENULIUKAI;5353687011;Taip;20;0;0;20
20140;Pilaitukas;MENULIUKAI;9988041515;Taip;12;0;0;12
20141;Pilaitukas;MENULIUKAI;9108428738;Taip;12;0;0;12
20142;Pilaitukas;MENULIUKAI;1585341963;Taip;5;0;0;5
20143;Pilaitukas;MENULIUKAI;9260893320;Taip;5;0;0;5
20144;Pilaitukas;MENULIUKAI;4623818227;Taip;14;0;0;14
20145;Pilaitukas;MENULIUKAI;5640802570;Taip;12;0;0;12
20146;Pilaitukas;MENULIUKAI;7334494990;Taip;8;0;1;9
20147;Pilaitukas;MENULIUKAI;8207194955;Taip;6;0;0;6
20148;Pilaitukas;MENULIUKAI;1607454890;Taip;9;0;0;9
20149;Pilaitukas;MENULIUKAI;6102253106;Taip;0;3;0;3
20150;Pilaitukas;ĖŽIUKAI;9793278788;Taip;0;5;0;5
20151;Pilaitukas;ĖŽIUKAI;5740951665;Taip;5;5;4;14
20152;Pilaitukas;ĖŽIUKAI;6308557885;Taip;19;0;0;19
20153;Pilaitukas;ĖŽIUKAI;6514731102;Taip;19;0;0;19
20154;Pilaitukas;ĖŽIUKAI;4591799893;Taip;18;0;0;18
20155;Pilaitukas;ĖŽIUKAI;9653647227;Taip;15;5;0;20
20156;Pilaitukas;ĖŽIUKAI;5326689274;Taip;15;5;0;20
20157;Pilaitukas;ĖŽIUKAI;3541354283;Taip;0;4;0;4
20158;Pilaitukas;ĖŽIUKAI;5988165204;Taip;4;0;1;5
20159;Pilaitukas;ĖŽIUKAI;4082490488;Taip;10;0;2;12
20160;Pilaitukas;ĖŽIUKAI;1729494874;Taip;0;5;0;5
20161;Pilaitukas;ĖŽIUKAI;3345387791;Taip;12;0;0;12
20162;Pilaitukas;ĖŽIUKAI;3913169122;Taip;0;5;2;7
20163;Pilaitukas;ĖŽIUKAI;1253300093;Taip;0;0;1;1
20164;Pilaitukas;ĖŽIUKAI;9038324313;Taip;2;0;0;2
20165;"Naujųjų verkių";Lopšelinė;9840473841;Taip;0;3;0;3
20166;"Naujųjų verkių";Lopšelinė;63932903598;Taip;0;3;0;3
20167;"Naujųjų verkių";Lopšelinė;89540088936;Taip;0;8;0;8
20168;"Naujųjų verkių";Lopšelinė;3572188688;Taip;0;0;1;1
20169;"Naujųjų verkių";Lopšelinė;7872515649;Taip;20;0;0;20
20170;"Naujųjų verkių";Lopšelinė;9200073539;Taip;0;6;0;6
20171;"Naujųjų verkių";Lopšelinė;8429923120;Taip;0;20;0;20
20172;"Naujųjų verkių";Lopšelinė;1693323032;Taip;15;0;0;15
20173;"Naujųjų verkių";Lopšelinė;1536075084;Taip;4;2;0;6
20174;"Naujųjų verkių";Lopšelinė;7010430969;Taip;5;0;0;5
20175;"Naujųjų verkių";Lopšelinė;9462019924;Taip;0;2;0;2
20176;"Naujųjų verkių";Lopšelinė;7734802846;Taip;0;8;0;8
20177;"Naujųjų verkių";Darželinė;58681184744;Taip;0;4;0;4
20178;"Naujųjų verkių";Darželinė;31922817586;Taip;0;0;1;1
20179;"Naujųjų verkių";Darželinė;52116449181;Taip;0;12;0;12
20180;"Naujųjų verkių";Darželinė;31334483791;Taip;0;14;0;14
20181;"Naujųjų verkių";Darželinė;12970840107;Taip;4;0;0;4
20182;"Naujųjų verkių";Darželinė;91710448735;Taip;5;0;0;5
20183;"Naujųjų verkių";Darželinė;70974231925;Taip;0;9;0;9
20184;"Naujųjų verkių";Darželinė;96956603806;Taip;5;0;1;6
20185;"Naujųjų verkių";Darželinė;2636744220;Taip;0;10;0;10
20186;"Naujųjų verkių";Darželinė;1273331977;Taip;4;0;0;4
20187;"Naujųjų verkių";Darželinė;45101251137;Taip;0;4;0;4
20188;"Naujųjų verkių";Darželinė;1321551506;Taip;0;5;0;5
20189;"Naujųjų verkių";Darželinė;1061601585;Taip;0;13;0;13
20190;"Naujųjų verkių";Darželinė;4727762605;Taip;0;16;0;16
20191;"Naujųjų verkių";Darželinė;19360482785;Taip;0;15;0;15
20192;"Naujųjų verkių";Darželinė;49937307547;Taip;0;20;0;20
20193;Švelnukas;Pelėdžiukai;97312326369;Taip;0;3;0;3
20194;Švelnukas;Pelėdžiukai;35501839416;Taip;14;0;2;16
20195;Švelnukas;Pelėdžiukai;1102317067;Taip;0;0;2;2
20196;Švelnukas;Pelėdžiukai;54159329795;Taip;0;4;0;4
20197;Švelnukas;Pelėdžiukai;56353311492;Taip;10;5;5;20
20198;Švelnukas;Pelėdžiukai;73720184241;Taip;0;5;0;5
20199;Švelnukas;Pelėdžiukai;94832155557;Taip;0;5;7;12
20200;Švelnukas;Pelėdžiukai;1398812288;Taip;0;5;0;5
20201;Švelnukas;Pelėdžiukai;4006769867;Taip;0;6;0;6
20202;Švelnukas;Pelėdžiukai;72764312386;Taip;0;0;5;5
20203;Švelnukas;Pelėdžiukai;59229958089;Taip;5;5;0;10
20204;Švelnukas;Pelėdžiukai;57026029080;Taip;0;5;1;6
20205;Švelnukas;Pelėdžiukai;30679686753;Taip;4;5;0;9
20206;Švelnukas;Pelėdžiukai;32473329970;Taip;0;8;0;8
20207;Švelnukas;Pelėdžiukai;50326830712;Taip;0;0;3;3
20208;Švelnukas;Pelėdžiukai;16880708270;Taip;0;2;0;2
20209;Švelnukas;Pelėdžiukai;19279790066;Taip;5;0;0;5
20210;Švelnukas;Pelėdžiukai;76470453844;Taip;5;0;0;5
20211;Švelnukas;Pelėdžiukai;88430357193;Taip;17;0;0;17
20212;Švelnukas;Pelėdžiukai;52477782880;Taip;10;0;0;10
20213;Švelnukas;Pelėdžiukai;2123115761;Taip;13;0;0;13
20214;Švelnukas;Ežiukai;62376594516;Taip;5;5;0;10
20215;Švelnukas;Ežiukai;89383668208;Taip;5;0;0;5
20216;Švelnukas;Ežiukai;79306550532;Taip;0;2;0;2
20217;Švelnukas;Ežiukai;65123682919;Taip;0;5;0;5
20218;Švelnukas;Ežiukai;59113412340;Ne;0;5;0;5
20219;Švelnukas;Ežiukai;95227249637;Taip;0;8;0;8
20220;Švelnukas;Ežiukai;68248605297;Taip;5;5;0;10
20221;Švelnukas;Ežiukai;94799905208;Taip;5;0;0;5
20222;Švelnukas;Ežiukai;41867077386;Taip;5;0;1;6
20223;Švelnukas;Ežiukai;64192510147;Taip;4;0;0;4
20224;Švelnukas;Ežiukai;41365412569;Taip;0;6;0;6
20225;Švelnukas;Ežiukai;55258226673;Taip;0;10;2;12
20226;Švelnukas;Ežiukai;6670022613;Taip;0;0;1;1
20227;Švelnukas;Ežiukai;68667782880;Taip;10;0;0;10
20228;Švelnukas;Ežiukai;15308444101;Taip;11;0;2;13
20229;Švelnukas;Ežiukai;6282389058;Taip;0;5;0;5
20230;Švelnukas;Ežiukai;5175035623;Taip;15;0;0;15
20231;Švelnukas;Ežiukai;84293714890;Taip;5;1;1;7
20232;Švelnukas;Ežiukai;1755384216;Taip;6;8;0;14
20233;Švelnukas;Ežiukai;23795609183;Taip;5;0;2;7
20234;Švelnukas;Ežiukai;31881188589;Taip;5;5;0;10
20235;Švelnukas;Švelnukai;50827155608;Taip;0;5;0;5
20236;Švelnukas;Švelnukai;67100479000;Taip;0;5;0;5
20237;Švelnukas;Švelnukai;37816683435;Taip;0;1;1;2
20238;Švelnukas;Švelnukai;35140428714;Taip;0;6;0;6
20239;Švelnukas;Švelnukai;6143538084;Taip;0;0;2;2
20240;Švelnukas;Švelnukai;16527728167;Taip;0;8;0;8
20241;Švelnukas;Švelnukai;55308151865;Taip;0;1;0;1
20242;Švelnukas;Švelnukai;58209041919;Taip;0;1;0;1
20243;Švelnukas;Švelnukai;2637595842;Taip;7;3;0;10
20244;Švelnukas;Švelnukai;71561312482;Taip;0;5;0;5
20245;Švelnukas;Švelnukai;75449064275;Taip;0;5;1;6
20246;Švelnukas;Švelnukai;64875997364;Taip;0;12;0;12
20247;Švelnukas;Švelnukai;32133621075;Taip;0;5;1;6
20248;Švelnukas;Švelnukai;94946505347;Taip;0;2;0;2
20249;Švelnukas;Švelnukai;85650663405;Taip;0;1;0;1
20250;Švelnukas;Švelnukai;25672016811;Ne;0;11;0;11
20251;Švelnukas;Švelnukai;52909536851;Taip;0;2;4;6
20252;Švelnukas;Švelnukai;80109886791;Taip;0;3;4;7
20253;Švelnukas;Švelnukai;14616126488;Taip;4;0;0;4
20254;Švelnukas;Švelnukai;84455755281;Taip;0;3;0;3
20255;Švelnukas;Švelnukai;94117802668;Taip;0;2;0;2
20256;Švelnukas;Švelnukai;1795843646;Ne;0;5;5;10
20257;Švelnukas;Boružiukai;1951447127;Taip;0;20;0;20
20258;Švelnukas;Boružiukai;8681264696;Taip;7;5;0;12
20259;Švelnukas;Boružiukai;4711482287;Taip;10;0;3;13
20260;Švelnukas;Boružiukai;8510195634;Taip;7;0;1;8
20261;Švelnukas;Boružiukai;3849957906;Taip;7;0;1;8
20262;Švelnukas;Boružiukai;5550841477;Taip;19;0;0;19
20263;Švelnukas;Boružiukai;5974324302;Taip;13;0;0;13
20264;Švelnukas;Boružiukai;9722532034;Taip;0;0;2;2
20265;Švelnukas;Boružiukai;2400781175;Taip;0;0;2;2
20266;Švelnukas;Boružiukai;1264256177;Taip;2;5;13;20
20267;Švelnukas;Boružiukai;6607578153;Taip;0;0;3;3
20268;Švelnukas;Boružiukai;8847738918;Taip;1;19;0;20
20269;Švelnukas;Boružiukai;1332533332;Taip;12;0;1;13
20270;Švelnukas;Boružiukai;8787505507;Taip;0;3;0;3
20271;Švelnukas;Boružiukai;4134678301;Taip;10;0;1;11
20272;Švelnukas;Boružiukai;8458233793;Taip;0;0;1;1
20273;Švelnukas;Boružiukai;7967996032;Taip;9;0;0;9
20274;Švelnukas;Smalsučiai;82202942341;Taip;0;10;0;10
20275;Švelnukas;Smalsučiai;63394075248;Taip;0;5;0;5
20276;Švelnukas;Smalsučiai;1183982303;Taip;0;1;0;1
20277;Švelnukas;Smalsučiai;87770765141;Taip;8;0;6;14
20278;Švelnukas;Smalsučiai;47645479348;Taip;0;5;0;5
20279;Švelnukas;Smalsučiai;19117783391;Taip;0;0;3;3
20280;Švelnukas;Smalsučiai;26077395334;Taip;10;5;0;15
20281;Švelnukas;Smalsučiai;15711256627;Taip;13;2;0;15
20282;Švelnukas;Smalsučiai;95780894209;Taip;0;0;3;3
20283;Švelnukas;Smalsučiai;76563731138;Taip;0;6;0;6
20284;Švelnukas;Smalsučiai;3388721433;Taip;0;1;0;1
20285;Švelnukas;Smalsučiai;1742714140;Taip;5;0;3;8
20286;Švelnukas;Smalsučiai;54425041280;Taip;0;5;0;5
20287;Švelnukas;Smalsučiai;91569132037;Taip;0;9;0;9
20288;Švelnukas;Smalsučiai;34570338962;Taip;15;5;0;20
20289;Švelnukas;Smalsučiai;78611632021;Taip;0;3;0;3
20290;Švelnukas;Smalsučiai;15774114007;Taip;10;0;6;16
20291;Švelnukas;Smalsučiai;26312856720;Taip;7;0;3;10
20292;Švelnukas;Nykštukai;5518267134;Taip;1;5;0;6
20293;Švelnukas;Nykštukai;1293700097;Taip;3;0;1;4
20294;Švelnukas;Nykštukai;8221642452;Taip;5;0;0;5
20295;Švelnukas;Nykštukai;2141519946;Taip;9;6;0;15
20296;Švelnukas;Nykštukai;8771953161;Taip;0;0;2;2
20297;Švelnukas;Nykštukai;2282356211;Taip;2;0;0;2
20298;Švelnukas;Nykštukai;4697253853;Taip;0;5;3;8
20299;Švelnukas;Nykštukai;7387060610;Taip;0;5;0;5
20300;Švelnukas;Nykštukai;1762528313;Taip;0;5;1;6
20301;Švelnukas;Nykštukai;7380948648;Taip;0;2;1;3
20302;Švelnukas;Nykštukai;3473146893;Taip;0;2;1;3
20303;Švelnukas;Nykštukai;3370028567;Taip;3;1;0;4
20304;Švelnukas;Nykštukai;62969317035;Taip;7;0;0;7
20305;Švelnukas;Nykštukai;2106591525;Taip;15;0;0;15
20306;Švelnukas;Nykštukai;93497358197;Taip;0;3;0;3
20307;Švelnukas;Nykštukai;2971380970;Taip;0;1;2;3
20308;Švelnukas;Nykštukai;3389897065;Taip;0;1;2;3
20309;Švelnukas;Nykštukai;4302735157;Taip;8;5;1;14
20310;Švelnukas;Nykštukai;2785396019;Taip;0;5;5;10
20311;Švelnukas;Nykštukai;6195335543;Taip;0;0;2;2
20312;Boružėlė;"Nykštukai gudručiai";16750834044;Taip;4;1;0;5
20313;Boružėlė;"Nykštukai gudručiai";17133057179;Taip;5;9;0;14
20314;Boružėlė;"Nykštukai gudručiai";61157651941;Ne;5;0;0;5
20315;Boružėlė;"Nykštukai gudručiai";89164129422;Taip;7;1;0;8
20316;Boružėlė;"Nykštukai gudručiai";61086657300;Taip;0;5;1;6
20317;Boružėlė;"Nykštukai gudručiai";27819440058;Taip;0;6;0;6
20318;Boružėlė;"Nykštukai gudručiai";62849453206;Taip;0;6;4;10
20319;Boružėlė;"Nykštukai gudručiai";650307889;Taip;0;13;0;13
20320;Boružėlė;"Nykštukai gudručiai";90752643228;Taip;0;5;0;5
20321;Boružėlė;"Nykštukai gudručiai";91349343635;Taip;0;5;0;5
20322;Boružėlė;"Nykštukai gudručiai";52470353273;Taip;15;5;0;20
20323;Boružėlė;"Nykštukai gudručiai";38216036757;Taip;6;4;0;10
20324;Boružėlė;"Nykštukai gudručiai";28726593347;Taip;20;0;0;20
20325;Boružėlė;"Nykštukai gudručiai";13957276157;Taip;0;5;0;5
20326;Boružėlė;"Nykštukai gudručiai";29807061047;Taip;0;3;1;4
20327;Boružėlė;"Nykštukai gudručiai";55985459125;Ne;0;6;0;6
20328;Boružėlė;"Nykštukai gudručiai";68875252308;Taip;10;2;0;12
20329;Boružėlė;"Nykštukai gudručiai";22491205325;Taip;0;1;2;3
20330;Boružėlė;"Nykštukai gudručiai";229765248;Taip;0;3;0;3
20331;Boružėlė;"Nykštukai gudručiai";16899340397;Taip;0;7;2;9
20332;Boružėlė;"Nykštukai gudručiai";82591189080;Taip;5;4;0;9
20333;Boružėlė;"Nykštukai gudručiai";5105514215;Taip;0;9;0;9
20334;Boružėlė;"Nykštukai gudručiai";95194187600;Taip;4;5;0;9
20335;Boružėlė;"Nykštukai gudručiai";37447518757;Taip;1;11;0;12
20336;Boružėlė;"Saulės zuikučiai";85989907396;Taip;5;5;0;10
20337;Boružėlė;"Saulės zuikučiai";19859029063;Taip;0;9;1;10
20338;Boružėlė;"Saulės zuikučiai";92386016898;Taip;15;1;0;16
20339;Boružėlė;"Saulės zuikučiai";32378073529;Taip;0;7;0;7
20340;Boružėlė;"Saulės zuikučiai";69391016485;Taip;8;5;0;13
20341;Boružėlė;"Saulės zuikučiai";65182491064;Taip;0;1;0;1
20342;Boružėlė;"Saulės zuikučiai";31002497704;Taip;0;4;0;4
20343;Boružėlė;"Saulės zuikučiai";24149763183;Taip;5;5;0;10
20344;Boružėlė;"Saulės zuikučiai";8746617807;Taip;5;0;0;5
20345;Boružėlė;"Saulės zuikučiai";25311512878;Taip;5;0;0;5
20346;Boružėlė;"Saulės zuikučiai";34268210765;Taip;0;5;0;5
20347;Boružėlė;"Saulės zuikučiai";85800258410;Taip;0;14;0;14
20348;Boružėlė;"Saulės zuikučiai";5636816841;Taip;0;8;0;8
20349;Boružėlė;"Saulės zuikučiai";90270691161;Taip;0;1;0;1
20350;Boružėlė;"Saulės zuikučiai";92488927896;Taip;0;1;0;1
20351;Boružėlė;"Saulės zuikučiai";75865679477;Taip;0;4;13;17
20352;Boružėlė;"Saulės zuikučiai";52262961972;Taip;0;1;0;1
20353;Boružėlė;"Saulės zuikučiai";59772973857;Taip;6;5;0;11
20354;Boružėlė;"Saulės zuikučiai";44064549128;Taip;6;5;0;11
20355;Boružėlė;"Saulės zuikučiai";2322009943;Taip;0;5;0;5
20356;Boružėlė;"Saulės zuikučiai";39495849527;Ne;0;6;0;6
20357;Boružėlė;"Saulės zuikučiai";21573376804;Taip;5;5;0;10
20358;Boružėlė;"Saulės zuikučiai";44480055238;Taip;7;0;0;7
20359;Boružėlė;"Saulės zuikučiai";33333115262;Taip;0;0;1;1
20360;Boružėlė;Gėlytės;4023646693;Taip;8;1;0;9
20361;Boružėlė;Gėlytės;1259739396;Taip;5;0;0;5
20362;Boružėlė;Gėlytės;51321138507;Taip;5;1;0;6
20363;Boružėlė;Gėlytės;62298785353;Taip;16;0;0;16
20364;Boružėlė;Gėlytės;84087304104;Taip;17;0;0;17
20365;Boružėlė;Gėlytės;28968535453;Taip;0;7;0;7
20366;Boružėlė;Gėlytės;11785706048;Taip;11;0;0;11
20367;Boružėlė;Gėlytės;41726574939;Taip;5;4;0;9
20368;Boružėlė;Gėlytės;81433480408;Taip;0;7;0;7
20369;Boružėlė;Gėlytės;51923600458;Taip;0;0;2;2
20370;Boružėlė;Gėlytės;77207874939;Taip;0;7;1;8
20371;Boružėlė;Gėlytės;60999303687;Taip;0;2;0;2
20372;Boružėlė;Gėlytės;86742600111;Taip;0;2;0;2
20373;Boružėlė;Gėlytės;43579952892;Taip;5;4;0;9
20374;Boružėlė;Gėlytės;69393873241;Taip;4;6;0;10
20375;Boružėlė;Gėlytės;40388424785;Taip;5;1;0;6
20376;Boružėlė;Gėlytės;54530233692;Taip;0;9;0;9
20377;Boružėlė;Gėlytės;25443948372;Taip;3;0;0;3
20378;Boružėlė;Gėlytės;33266635443;Taip;15;1;0;16
20379;Boružėlė;Gėlytės;3118969668;Taip;0;6;3;9
20380;Boružėlė;Gėlytės;57842027470;Taip;8;3;0;11
20381;Boružėlė;Gėlytės;56693699464;Taip;0;5;1;6
20382;Boružėlė;Gėlytės;1010790194;Taip;6;5;0;11
20383;Boružėlė;Gėlytės;1813949172;Taip;4;6;0;10
20384;Boružėlė;Gėlytės;9148646597;Taip;4;4;0;8
20385;Boružėlė;Gėlytės;5306841409;Taip;6;0;0;6
20386;Boružėlė;Smalsutis;5129244830;Taip;5;1;0;6
20387;Boružėlė;Smalsutis;6927100979;Taip;11;2;0;13
20388;Boružėlė;Smalsutis;2887130633;Taip;10;0;0;10
20389;Boružėlė;Smalsutis;4947670606;Taip;0;5;0;5
20390;Boružėlė;Smalsutis;5267216044;Taip;0;8;0;8
20391;Boružėlė;Smalsutis;7263730692;Taip;10;0;0;10
20392;Boružėlė;Smalsutis;5708558321;Taip;0;7;0;7
20393;Boružėlė;Smalsutis;6484173786;Taip;0;1;0;1
20394;Boružėlė;Smalsutis;2132904457;Taip;0;6;0;6
20395;Boružėlė;Smalsutis;39553430808;Taip;0;5;0;5
20396;Boružėlė;Smalsutis;4958704459;Taip;10;3;0;13
20397;Boružėlė;Smalsutis;2447148171;Taip;15;0;0;15
20398;Boružėlė;Smalsutis;1391562352;Taip;5;0;0;5
20399;Boružėlė;Drugeliai;92489123105;Taip;8;5;0;13
20400;Boružėlė;Drugeliai;62673076395;Taip;12;1;0;13
20401;Boružėlė;Drugeliai;7846729818;Taip;8;5;0;13
20402;Boružėlė;Drugeliai;17934430709;Taip;0;6;0;6
20403;Boružėlė;Drugeliai;2832927610;Taip;0;2;3;5
20404;Boružėlė;Drugeliai;34848596097;Taip;0;5;0;5
20405;Boružėlė;Drugeliai;91514253954;Ne;0;3;4;7
20406;Boružėlė;Drugeliai;60850304458;Taip;7;6;0;13
20407;Boružėlė;Drugeliai;61687966416;Ne;0;8;0;8
20408;Boružėlė;Drugeliai;64005720465;Ne;5;1;0;6
20409;Boružėlė;Drugeliai;1317543345;Taip;5;7;0;12
20410;Boružėlė;Drugeliai;87323054466;Taip;5;0;1;6
20411;Boružėlė;Drugeliai;89040863632;Taip;4;1;0;5
20412;Boružėlė;Drugeliai;37727831095;Taip;0;0;3;3
20413;Boružėlė;Drugeliai;98019366092;Taip;0;6;0;6
20414;Boružėlė;Drugeliai;38702331698;Taip;0;1;8;9
20415;Boružėlė;Drugeliai;51684663458;Taip;0;5;1;6
20416;Boružėlė;Drugeliai;4219138834;Ne;0;5;0;5
20417;Boružėlė;Drugeliai;99456444940;Taip;8;5;0;13
20418;Boružėlė;Drugeliai;88659085306;Taip;0;7;0;7
20419;Boružėlė;Drugeliai;68002181211;Taip;0;7;0;7
20420;Boružėlė;Drugeliai;56479442138;Taip;10;4;0;14
20421;Boružėlė;Vyturėliai;1913540317;Taip;0;2;0;2
20422;Boružėlė;Vyturėliai;1950269258;Taip;0;15;0;15
20423;Boružėlė;Vyturėliai;1591582954;Taip;13;4;0;17
20424;Boružėlė;Vyturėliai;9180459278;Taip;0;5;8;13
20425;Boružėlė;Vyturėliai;3322567969;Taip;0;4;0;4
20426;Boružėlė;Vyturėliai;1718509953;Taip;0;4;0;4
20427;Boružėlė;Vyturėliai;8311383437;Taip;15;5;0;20
20428;Boružėlė;Vyturėliai;7534482245;Taip;0;6;14;20
20429;Boružėlė;Vyturėliai;3310676316;Taip;5;0;0;5
20430;Boružėlė;Vyturėliai;87834777247;Taip;5;1;0;6
20431;Boružėlė;Vyturėliai;50071056728;Taip;15;5;0;20
20432;Boružėlė;Vyturėliai;43300167107;Taip;0;6;0;6
20433;Boružėlė;Vyturėliai;2098408445;Taip;0;2;0;2
20434;Boružėlė;Vyturėliai;8706461730;Taip;0;10;0;10
20435;Boružėlė;Vyturėliai;5337704114;Taip;0;2;0;2
20436;Boružėlė;Vyturėliai;8146684259;Taip;0;12;0;12
20437;Boružėlė;Vyturėliai;8225622711;Taip;0;2;0;2
20438;Boružėlė;Vyturėliai;67504667512;Taip;6;5;0;11
20439;Boružėlė;Vyturėliai;9150703371;Taip;5;3;0;8
20440;Boružėlė;Žvaigždutės;44535075266;Taip;0;1;2;3
20441;Boružėlė;Žvaigždutės;38045035880;Taip;0;5;1;6
20442;Boružėlė;Žvaigždutės;43607170469;Taip;6;3;0;9
20443;Boružėlė;Žvaigždutės;52277326311;Taip;5;0;0;5
20444;Boružėlė;Žvaigždutės;59496159689;Taip;5;0;0;5
20445;Boružėlė;Žvaigždutės;45978328301;Taip;0;4;0;4
20446;Boružėlė;Žvaigždutės;57677692109;Taip;0;7;1;8
20447;Boružėlė;Žvaigždutės;11257181283;Taip;0;7;0;7
20448;Boružėlė;Žvaigždutės;55597294544;Taip;0;11;0;11
20449;Boružėlė;Žvaigždutės;56257835408;Taip;11;6;0;17
20450;Boružėlė;Žvaigždutės;14720838994;Taip;0;0;2;2
20451;Boružėlė;Žvaigždutės;24931251062;Taip;0;0;2;2
20452;Boružėlė;Žvaigždutės;75023176711;Taip;0;6;0;6
20453;Boružėlė;Žvaigždutės;73627228099;Taip;0;5;0;5
20454;Boružėlė;Žvaigždutės;53465974644;Taip;0;0;1;1
20455;Boružėlė;Žvaigždutės;18917842445;Taip;0;9;1;10
20456;Boružėlė;Ąžuoliukai;5774358876;Taip;0;8;0;8
20457;Boružėlė;Ąžuoliukai;4519645340;Taip;0;6;0;6
20458;Boružėlė;Ąžuoliukai;24315678618;Taip;10;0;2;12
20459;Boružėlė;Ąžuoliukai;4994696176;Taip;5;0;0;5
20460;Boružėlė;Ąžuoliukai;5138737297;Taip;0;5;0;5
20461;Boružėlė;Ąžuoliukai;2618814096;Taip;15;5;0;20
20462;Boružėlė;Ąžuoliukai;6439902117;Taip;0;3;0;3
20463;Boružėlė;Ąžuoliukai;3040376382;Taip;0;7;2;9
20464;Boružėlė;Ąžuoliukai;3912668735;Taip;11;0;0;11
20465;Boružėlė;Ąžuoliukai;3869817904;Taip;0;1;0;1
20466;Boružėlė;Ąžuoliukai;7722277859;Taip;0;5;0;5
20467;Boružėlė;Ąžuoliukai;6954794465;Taip;2;5;1;8
20468;Boružėlė;Ąžuoliukai;6545116373;Taip;0;5;0;5
20469;Boružėlė;Ąžuoliukai;5832223872;Taip;0;3;0;3
20470;Boružėlė;Ąžuoliukai;3695411422;Taip;10;1;0;11
20471;Boružėlė;Ąžuoliukai;1143453501;Taip;10;3;0;13
20472;Boružėlė;Ąžuoliukai;5490593122;Taip;11;0;0;11
20473;Boružėlė;Ąžuoliukai;5148410392;Taip;0;3;0;3
20474;Boružėlė;Ąžuoliukai;76222777017;Taip;5;0;0;5
20475;Boružėlė;Ąžuoliukai;45181369655;Taip;0;11;0;11
20476;Boružėlė;Ąžuoliukai;6022191251;Taip;2;0;0;2
20477;Boružėlė;Saulutės;55049551150;Taip;0;2;0;2
20478;Boružėlė;Saulutės;1311485296;Taip;9;2;0;11
20479;Boružėlė;Saulutės;46425201501;Taip;0;1;0;1
20480;Boružėlė;Saulutės;1399195259;Taip;5;9;0;14
20481;Boružėlė;Saulutės;72321159041;Taip;5;3;0;8
20482;Boružėlė;Saulutės;1247185819;Taip;6;1;0;7
20483;Boružėlė;Saulutės;1910653135;Taip;0;9;9;18
20484;Boružėlė;Saulutės;1527135537;Taip;9;6;0;15
20485;Boružėlė;Saulutės;8814486475;Taip;0;7;0;7
20486;Boružėlė;Saulutės;48414697489;Taip;6;2;0;8
20487;Boružėlė;Saulutės;3004650727;Taip;0;0;3;3
20488;Boružėlė;Saulutės;4567360023;Taip;10;1;0;11
20489;Boružėlė;Saulutės;96500755145;Ne;7;0;0;7
20490;Boružėlė;Saulutės;1506999888;Taip;0;4;0;4
20491;Boružėlė;Saulutės;2402968573;Taip;0;4;0;4
20492;Boružėlė;Saulutės;2690216341;Taip;15;0;0;15
20493;Boružėlė;Saulutės;1456577285;Taip;5;2;0;7
20494;Boružėlė;Saulutės;8659850691;Taip;5;2;0;7
20495;Boružėlė;Saulutės;4562962568;Taip;5;2;0;7
20496;Boružėlė;Saulutės;64347371263;Taip;0;7;2;9
20497;Boružėlė;Saulutės;28382049716;Taip;5;2;3;10
20498;Boružėlė;Saulutės;1750151078;Taip;10;2;3;15
20499;Boružėlė;Ežiukai;1637965530;Taip;4;0;0;4
20500;Boružėlė;Ežiukai;80490841186;Taip;0;5;2;7
20501;Boružėlė;Ežiukai;97765175729;Taip;3;3;0;6
20502;Boružėlė;Ežiukai;9436674675;Taip;0;2;1;3
20503;Boružėlė;Ežiukai;58923894463;Taip;13;2;0;15
20504;Boružėlė;Ežiukai;27456755162;Taip;0;7;2;9
20505;Boružėlė;Ežiukai;1339605077;Taip;4;8;0;12
20506;Boružėlė;Ežiukai;80239337645;Taip;3;1;0;4
20507;Boružėlė;Ežiukai;1007058344;Taip;9;5;0;14
20508;Boružėlė;Ežiukai;86859788504;Taip;0;7;0;7
20509;Boružėlė;Ežiukai;2138048547;Taip;8;1;0;9
20510;Boružėlė;Ežiukai;1431869021;Taip;13;2;0;15
20511;Boružėlė;Ežiukai;1474967056;Taip;2;7;0;9
20512;Boružėlė;Ežiukai;1732533643;Taip;0;7;0;7
20513;Boružėlė;Ežiukai;62548032852;Taip;0;6;0;6
20514;Boružėlė;Ežiukai;87991501724;Taip;0;5;0;5
20515;Boružėlė;Ežiukai;17258743024;Taip;0;6;0;6
20516;Boružėlė;Ežiukai;31109596405;Taip;0;13;0;13
20517;Boružėlė;Ežiukai;3702413611;Taip;10;0;0;10
20518;Boružėlė;Ežiukai;49403734292;Taip;0;19;0;19
20519;Boružėlė;Ežiukai;46486992436;Taip;0;1;0;1
20520;Boružėlė;Ežiukai;39704329817;Ne;0;7;0;7
20521;Boružėlė;Ežiukai;61932744418;Taip;8;6;0;14
20522;Boružėlė;Ežiukai;1459630343;Taip;3;5;0;8
20523;Boružėlė;Ežiukai;8266904750;Taip;5;4;0;9
20524;Boružėlė;Ežiukai;80378241169;Taip;10;5;0;15
20525;Boružėlė;Ežiukai;73347816357;Taip;5;7;0;12
20526;Boružėlė;Boružiukai;7901880926;Taip;8;2;0;10
20527;Boružėlė;Boružiukai;9720535449;Taip;13;2;1;16
20528;Boružėlė;Boružiukai;6435556131;Taip;13;2;1;16
20529;Boružėlė;Boružiukai;1583223569;Taip;5;0;0;5
20530;Boružėlė;Boružiukai;3955841578;Taip;5;3;0;8
20531;Boružėlė;Boružiukai;8259586236;Taip;5;2;0;7
20532;Boružėlė;Boružiukai;1663216529;Taip;11;0;0;11
20533;Boružėlė;Boružiukai;9271331800;Taip;5;9;0;14
20534;Boružėlė;Boružiukai;9838823214;Taip;10;2;0;12
20535;Boružėlė;Boružiukai;5298170118;Taip;0;7;0;7
20536;Boružėlė;Boružiukai;7825636053;Taip;0;2;0;2
20537;Boružėlė;Boružiukai;6293878183;Taip;0;6;0;6
20538;Boružėlė;Boružiukai;6242220139;Taip;5;2;0;7
20539;Boružėlė;Boružiukai;5274016839;Taip;10;0;0;10
20540;Boružėlė;Boružiukai;6972646373;Taip;2;2;0;4
20541;Boružėlė;Boružiukai;7216558291;Taip;3;1;0;4
20542;Boružėlė;Nykštukai;9913813461;Taip;0;13;4;17
20543;Boružėlė;Nykštukai;6049501362;Taip;10;2;0;12
20544;Boružėlė;Nykštukai;8683282162;Taip;3;2;0;5
20545;Boružėlė;Nykštukai;8141240094;Taip;5;1;3;9
20546;Boružėlė;Nykštukai;5187411500;Taip;8;0;0;8
20547;Boružėlė;Nykštukai;1130980139;Taip;5;3;0;8
20548;Boružėlė;Nykštukai;2087238951;Taip;6;0;0;6
20549;Boružėlė;Nykštukai;4999277693;Taip;15;0;0;15
20550;Boružėlė;Nykštukai;6463583187;Taip;10;2;0;12
20551;Boružėlė;Nykštukai;4509233532;Taip;11;2;0;13
20552;Boružėlė;Nykštukai;3136028536;Taip;13;2;0;15
20553;Boružėlė;Nykštukai;6724101421;Taip;0;4;0;4
20554;Boružėlė;Nykštukai;2211576663;Taip;11;0;0;11
20555;Boružėlė;Nykštukai;1559001916;Taip;11;5;0;16
20556;Boružėlė;Nykštukai;3952645542;Taip;13;0;0;13
20557;Boružėlė;Nykštukai;4233602822;Taip;7;0;0;7
20558;Boružėlė;Nykštukai;6990311896;Taip;15;0;0;15
20559;Žaliakalnio;Drugeliai;13682689553;Taip;0;5;1;6
20560;Žaliakalnio;Drugeliai;27904847662;Ne;0;7;0;7
20561;Žaliakalnio;Drugeliai;46069159390;Taip;0;5;0;5
20562;Žaliakalnio;Drugeliai;86878699666;Taip;10;6;0;16
20563;Žaliakalnio;Drugeliai;31358267062;Ne;12;5;0;17
20564;Žaliakalnio;Drugeliai;66587671546;Taip;0;3;0;3
20565;Žaliakalnio;Drugeliai;25885672997;Ne;6;5;0;11
20566;Žaliakalnio;Drugeliai;95162958789;Taip;0;5;0;5
20567;Žaliakalnio;Drugeliai;32706729925;Taip;0;3;0;3
20568;Žaliakalnio;Drugeliai;66150716129;Taip;0;6;0;6
20569;Žaliakalnio;Drugeliai;25938547290;Taip;0;5;0;5
20570;Žaliakalnio;Drugeliai;6781426791;Taip;10;5;0;15
20571;Žaliakalnio;Drugeliai;2049672202;Taip;0;6;0;6
20572;Žaliakalnio;Drugeliai;7563809721;Taip;0;5;0;5
20573;Žaliakalnio;Drugeliai;3711311672;Taip;0;5;0;5
20574;Žaliakalnio;Drugeliai;94833433433;Taip;0;4;0;4
20575;Žaliakalnio;Boružėlių;47810583989;Taip;7;0;0;7
20576;Žaliakalnio;Boružėlių;33301958715;Taip;0;8;0;8
20577;Žaliakalnio;Boružėlių;3965607452;Ne;7;6;0;13
20578;Žaliakalnio;Boružėlių;75317286407;Taip;0;2;0;2
20579;Žaliakalnio;Boružėlių;1743047570;Taip;0;5;0;5
20580;Žaliakalnio;Boružėlių;4250791818;Taip;0;10;0;10
20581;Žaliakalnio;Boružėlių;93570287071;Ne;6;4;1;11
20582;Žaliakalnio;Boružėlių;1083342257;Taip;0;15;0;15
20583;Žaliakalnio;Boružėlių;46244764767;Ne;0;12;0;12
20584;Žaliakalnio;Boružėlių;75758855114;Taip;0;5;1;6
20585;Žaliakalnio;Boružėlių;50460143975;Taip;10;0;0;10
20586;Žaliakalnio;Boružėlių;91780252395;Ne;5;7;0;12
20587;Žaliakalnio;Boružėlių;60736665152;Taip;0;8;0;8
20588;Žaliakalnio;Boružėlių;82839531225;Taip;0;7;0;7
20589;Žaliakalnio;Zuikučiai;1592051491;Taip;6;0;0;6
20590;Žaliakalnio;Zuikučiai;6088333997;Taip;15;5;0;20
20591;Žaliakalnio;Zuikučiai;2621828772;Taip;5;1;0;6
20592;Žaliakalnio;Zuikučiai;2673619031;Taip;0;5;0;5
20593;Žaliakalnio;Zuikučiai;5843314345;Taip;0;6;0;6
20594;Žaliakalnio;Zuikučiai;7447278960;Taip;0;11;0;11
20595;Žaliakalnio;Zuikučiai;2180165053;Taip;15;0;0;15
20596;Žaliakalnio;Zuikučiai;6823528666;Taip;13;2;0;15
20597;Žaliakalnio;Zuikučiai;3509064089;Taip;6;2;0;8
20598;Žaliakalnio;Zuikučiai;7000429934;Taip;0;12;0;12
20599;Žaliakalnio;Zuikučiai;5730610895;Taip;0;7;0;7
20600;Žaliakalnio;Zuikučiai;6881070397;Taip;0;7;0;7
20601;Žaliakalnio;Zuikučiai;8209559343;Taip;18;0;0;18
20602;Žaliakalnio;Zuikučiai;3835667120;Taip;5;6;0;11
20603;Žaliakalnio;Zuikučiai;5422289286;Taip;0;5;0;5
20604;Žaliakalnio;Zuikučiai;9799056285;Taip;0;6;0;6
20605;Žaliakalnio;Zuikučiai;1321592040;Taip;0;5;0;5
20606;Žaliakalnio;Zuikučiai;8298313285;Taip;0;1;0;1
20607;Žaliakalnio;Zuikučiai;9331287916;Taip;5;6;0;11
20608;Žaliakalnio;Zuikučiai;6726832258;Taip;0;2;0;2
20609;Žaliakalnio;Bitutė;23692122313;Ne;10;2;0;12
20610;Žaliakalnio;Bitutė;5761499050;Taip;11;6;0;17
20611;Žaliakalnio;Bitutė;47735728560;Taip;4;5;0;9
20612;Žaliakalnio;Bitutė;1581365258;Taip;0;5;0;5
20613;Žaliakalnio;Bitutė;1902477771;Taip;0;2;0;2
20614;Žaliakalnio;Bitutė;26003637304;Taip;5;14;0;19
20615;Žaliakalnio;Bitutė;1673236492;Taip;0;6;0;6
20616;Žaliakalnio;Bitutė;56222558457;Taip;5;6;0;11
20617;Žaliakalnio;Bitutė;46360583256;Taip;15;0;0;15
20618;Žaliakalnio;Bitutė;1027036769;Ne;10;7;0;17
20619;Žaliakalnio;Bitutė;2059763621;Taip;0;0;3;3
20620;Žaliakalnio;Bitutė;21032761681;Taip;15;0;0;15
20621;Žaliakalnio;Bitutė;1275007023;Taip;0;9;0;9
20622;Žaliakalnio;Bitutė;1142844672;Taip;0;20;0;20
20623;Žaliakalnio;Bitutė;1447567627;Taip;0;20;0;20
20624;Žaliakalnio;Bitutė;1919996835;Taip;7;8;0;15
20625;Žaliakalnio;Bitutė;1113616994;Taip;7;5;0;12
20626;Žaliakalnio;Bitutė;1824370122;Taip;0;12;0;12
20627;Žaliakalnio;Bitutė;64628389691;Taip;0;3;0;3
20628;Žaliakalnio;Bitutė;1909837418;Ne;0;5;0;5
20629;Žaliakalnio;Bitutė;56508324349;Taip;0;17;0;17
20630;Žaliakalnio;Bitutė;52109524827;Taip;15;3;0;18
20631;Žaliakalnio;Nykštukų;9057678671;Ne;0;2;0;2
20632;Žaliakalnio;Nykštukų;19192494119;Taip;0;5;0;5
20633;Žaliakalnio;Nykštukų;91524700281;Taip;5;6;0;11
20634;Žaliakalnio;Nykštukų;6560740320;Taip;0;8;0;8
20635;Žaliakalnio;Nykštukų;1932906021;Taip;0;5;0;5
20636;Žaliakalnio;Nykštukų;1753760382;Taip;0;11;0;11
20637;Žaliakalnio;Nykštukų;61215164827;Taip;0;7;0;7
20638;Žaliakalnio;Nykštukų;4936664829;Taip;6;1;0;7
20639;Žaliakalnio;Nykštukų;1657390839;Taip;5;2;0;7
20640;Žaliakalnio;Nykštukų;2655227703;Taip;10;5;0;15
20641;Žaliakalnio;Nykštukų;8085215871;Taip;0;10;0;10
20642;Žaliakalnio;Nykštukų;8469042778;Taip;14;6;0;20
20643;Žaliakalnio;Nykštukų;41844570217;Ne;5;4;0;9
20644;Žaliakalnio;Nykštukų;6638075273;Ne;8;11;0;19
20645;Žaliakalnio;Nykštukų;21744638321;Taip;10;6;0;16
20646;Žaliakalnio;Nykštukų;1514982516;Taip;20;0;0;20
20647;Žaliakalnio;Nykštukų;9918175249;Ne;5;9;0;14
20648;Žaliakalnio;Nykštukų;1497932659;Ne;0;3;0;3
20649;Žaliakalnio;Nykštukų;5946168564;Ne;6;5;0;11
20650;Žaliakalnio;ŽIOGELIAI;2607433844;Taip;5;0;0;5
20651;Žaliakalnio;ŽIOGELIAI;2432935088;Ne;5;11;0;16
20652;Žaliakalnio;ŽIOGELIAI;7862756576;Ne;15;0;0;15
20653;Žaliakalnio;ŽIOGELIAI;3058369504;Ne;0;7;0;7
20654;Žaliakalnio;ŽIOGELIAI;38025903441;Taip;0;3;0;3
20655;Žaliakalnio;ŽIOGELIAI;96127127960;Taip;5;6;0;11
20656;Žaliakalnio;ŽIOGELIAI;15344653714;Taip;7;5;0;12
20657;Žaliakalnio;ŽIOGELIAI;69892069029;Taip;1;5;0;6
20658;Žaliakalnio;ŽIOGELIAI;1589546605;Taip;11;2;0;13
20659;Žaliakalnio;ŽIOGELIAI;1012597457;Taip;15;4;0;19
20660;Žaliakalnio;ŽIOGELIAI;24900419959;Taip;0;10;0;10
20661;Žaliakalnio;ŽIOGELIAI;1357321617;Taip;0;7;0;7
20662;Žaliakalnio;ŽIOGELIAI;98394011032;Ne;0;7;0;7
20663;Žaliakalnio;ŽIOGELIAI;1967580906;Ne;16;0;0;16
20664;Žaliakalnio;ŽIOGELIAI;19165022144;Taip;0;4;0;4
20665;Žaliakalnio;ŽIOGELIAI;55967554391;Taip;0;3;0;3
20666;Žaliakalnio;ŽIOGELIAI;6919074533;Taip;0;7;0;7
20667;Žaliakalnio;ŽIOGELIAI;44058368949;Ne;5;5;0;10
20668;Giliukas;SMALSUČIAI;84750777858;Taip;0;12;0;12
20669;Giliukas;SMALSUČIAI;1869027087;Taip;0;5;0;5
20670;Giliukas;SMALSUČIAI;80254838594;Taip;0;20;0;20
20671;Giliukas;SMALSUČIAI;4163391813;Taip;0;20;0;20
20672;Giliukas;SMALSUČIAI;1431811346;Taip;9;1;0;10
20673;Giliukas;SMALSUČIAI;1910800137;Taip;10;4;0;14
20674;Giliukas;SMALSUČIAI;8284364049;Taip;3;2;0;5
20675;Giliukas;SMALSUČIAI;1733875411;Taip;0;3;0;3
20676;Giliukas;SMALSUČIAI;2617670085;Taip;0;6;0;6
20677;Giliukas;SMALSUČIAI;2099862126;Taip;5;0;0;5
20678;Giliukas;SMALSUČIAI;1771662094;Taip;7;5;0;12
20679;Giliukas;SMALSUČIAI;60766023175;Taip;4;0;0;4
20680;Giliukas;SMALSUČIAI;50289768374;Taip;0;20;0;20
20681;Giliukas;SMALSUČIAI;76716908362;Taip;6;0;0;6
20682;Giliukas;SMALSUČIAI;7223355423;Taip;0;8;0;8
20683;Giliukas;SMALSUČIAI;1649456516;Taip;7;1;1;9
20684;Giliukas;SMALSUČIAI;51723671912;Taip;0;20;0;20
20685;Giliukas;SMALSUČIAI;1624952768;Taip;0;2;6;8
20686;Giliukas;GUDRUČIAI;47667170356;Taip;0;4;0;4
20687;Giliukas;GUDRUČIAI;44324261160;Taip;0;20;0;20
20688;Giliukas;GUDRUČIAI;2051045114;Taip;0;20;0;20
20689;Giliukas;GUDRUČIAI;1524900421;Taip;0;5;0;5
20690;Giliukas;GUDRUČIAI;89442019220;Taip;0;7;0;7
20691;Giliukas;GUDRUČIAI;13047826874;Taip;0;4;0;4
20692;Giliukas;GUDRUČIAI;45976793843;Taip;0;2;0;2
20693;Giliukas;GUDRUČIAI;12968687849;Taip;4;5;0;9
20694;Giliukas;GUDRUČIAI;96391124646;Taip;0;6;0;6
20695;Giliukas;GUDRUČIAI;77697629121;Taip;9;2;0;11
20696;Giliukas;GUDRUČIAI;25587077047;Taip;0;1;0;1
20697;Giliukas;GUDRUČIAI;135044370;Taip;0;5;0;5
20698;Giliukas;GUDRUČIAI;41761163148;Taip;4;5;0;9
20699;Giliukas;GUDRUČIAI;9254755937;Ne;0;5;1;6
20700;Giliukas;GUDRUČIAI;34919241837;Taip;0;1;0;1
20701;Giliukas;GUDRUČIAI;13279159942;Taip;0;2;2;4
20702;Giliukas;GUDRUČIAI;65254984026;Taip;0;0;2;2
20703;Giliukas;GUDRUČIAI;13946513947;Taip;7;0;0;7
20704;Giliukas;GUDRUČIAI;41666529831;Ne;0;6;0;6
20705;Giliukas;GUDRUČIAI;26006763829;Taip;7;0;0;7
20706;Giliukas;GUDRUČIAI;9455477992;Taip;0;20;0;20
20707;Giliukas;GUDRUČIAI;1203715568;Taip;0;1;0;1
20708;Giliukas;GUDRUČIAI;2157057125;Taip;0;20;0;20
20709;Giliukas;ŠNEKUČIAI;1463748654;Taip;3;5;0;8
20710;Giliukas;ŠNEKUČIAI;1664239181;Taip;5;0;0;5
20711;Giliukas;ŠNEKUČIAI;1289574961;Taip;0;1;0;1
20712;Giliukas;ŠNEKUČIAI;9461909264;Taip;5;0;0;5
20713;Giliukas;ŠNEKUČIAI;34155615138;Taip;5;6;0;11
20714;Giliukas;ŠNEKUČIAI;14318411597;Taip;8;1;0;9
20715;Giliukas;ŠNEKUČIAI;2006450088;Taip;4;0;0;4
20716;Giliukas;ŠNEKUČIAI;89954209937;Taip;0;5;0;5
20717;Giliukas;ŠNEKUČIAI;40373221046;Taip;8;5;0;13
20718;Giliukas;ŠNEKUČIAI;8575067944;Taip;0;7;0;7
20719;Giliukas;ŠNEKUČIAI;1417138570;Taip;4;3;0;7
20720;Giliukas;ŠNEKUČIAI;4053376466;Taip;10;2;1;13
20721;Giliukas;ŠNEKUČIAI;10326073797;Taip;6;8;0;14
20722;Giliukas;ŠNEKUČIAI;7732836522;Taip;5;0;0;5
20723;Giliukas;ŠNEKUČIAI;5914236976;Taip;0;0;20;20
20724;Giliukas;ŠNEKUČIAI;9225515816;Taip;0;1;0;1
20725;Giliukas;ŠNEKUČIAI;6453425490;Taip;3;0;0;3
20726;Giliukas;ŠNEKUČIAI;1190611675;Taip;0;1;0;1
20727;Giliukas;ŠNEKUČIAI;9747155435;Taip;0;1;0;1
20728;Giliukas;ŠNEKUČIAI;6154379463;Taip;0;20;0;20
20729;Giliukas;PABIRUČIAI;9401247559;Taip;8;2;0;10
20730;Giliukas;PABIRUČIAI;6384202904;Taip;0;1;0;1
20731;Giliukas;PABIRUČIAI;3691791222;Taip;9;0;0;9
20732;Giliukas;PABIRUČIAI;24030146209;Taip;0;20;0;20
20733;Giliukas;PABIRUČIAI;3847358328;Taip;10;2;0;12
20734;Giliukas;PABIRUČIAI;9693949103;Taip;0;2;13;15
20735;Giliukas;PABIRUČIAI;1890147760;Taip;0;20;0;20
20736;Giliukas;PABIRUČIAI;1469477982;Taip;15;1;0;16
20737;Giliukas;PABIRUČIAI;3983555939;Taip;9;1;0;10
20738;Giliukas;PABIRUČIAI;7780118692;Taip;9;8;0;17
20739;Giliukas;PABIRUČIAI;2951628295;Taip;7;1;0;8
20740;Giliukas;PABIRUČIAI;5994213515;Taip;0;20;0;20
20741;Giliukas;PABIRUČIAI;5787041097;Taip;17;0;0;17
20742;Giliukas;PABIRUČIAI;4854370266;Taip;0;7;0;7
20743;Giliukas;PABIRUČIAI;4987348316;Taip;5;3;0;8
20744;Giliukas;PABIRUČIAI;7159681896;Taip;6;5;0;11
20745;Giliukas;PABIRUČIAI;4916844983;Taip;8;5;0;13
20746;"Lazdynų vid. m-kla";Drugeliai;10453975773;Taip;5;6;0;11
20747;"Lazdynų vid. m-kla";Drugeliai;1246702054;Taip;0;4;1;5
20748;"Lazdynų vid. m-kla";Drugeliai;93091209041;Taip;6;5;0;11
20749;"Lazdynų vid. m-kla";Drugeliai;89878430155;Taip;0;5;0;5
20750;"Lazdynų vid. m-kla";Drugeliai;43541072654;Taip;9;4;0;13
20751;"Lazdynų vid. m-kla";Drugeliai;1117304239;Taip;6;3;1;10
20752;"Lazdynų vid. m-kla";Drugeliai;9890308887;Taip;5;5;1;11
20753;"Lazdynų vid. m-kla";Drugeliai;2079967590;Taip;13;0;0;13
20754;"Lazdynų vid. m-kla";Drugeliai;9380814933;Taip;5;5;1;11
20755;"Lazdynų vid. m-kla";Drugeliai;6209271043;Taip;5;3;1;9
20756;"Lazdynų vid. m-kla";Drugeliai;7154882168;Taip;0;20;0;20
20757;"Lazdynų vid. m-kla";Drugeliai;28132502877;Taip;4;5;0;9
20758;"Lazdynų vid. m-kla";Drugeliai;6835150864;Taip;8;6;0;14
20759;"Lazdynų vid. m-kla";Drugeliai;7772177095;Taip;12;0;0;12
20760;"Lazdynų vid. m-kla";Drugeliai;9449948668;Taip;9;6;0;15
20761;"Lazdynų vid. m-kla";Drugeliai;4520091712;Taip;5;2;1;8
20762;"Lazdynų vid. m-kla";Drugeliai;3711708570;Ne;4;6;0;10
20763;"Lazdynų vid. m-kla";Zuikučiai;1837465174;Taip;5;12;0;17
20764;"Lazdynų vid. m-kla";Zuikučiai;1065999533;Taip;10;5;0;15
20765;"Lazdynų vid. m-kla";Zuikučiai;5613360688;Taip;10;3;2;15
20766;"Lazdynų vid. m-kla";Zuikučiai;40995112936;Taip;7;2;0;9
20767;"Lazdynų vid. m-kla";Zuikučiai;9591838054;Taip;5;5;0;10
20768;"Lazdynų vid. m-kla";Zuikučiai;8847547438;Ne;6;2;1;9
20769;"Lazdynų vid. m-kla";Zuikučiai;6615724604;Taip;5;11;0;16
20770;"Lazdynų vid. m-kla";Zuikučiai;9386629495;Taip;12;0;0;12
20771;"Lazdynų vid. m-kla";Zuikučiai;1817040419;Taip;0;2;0;2
20772;"Lazdynų vid. m-kla";Zuikučiai;1910670134;Taip;15;1;0;16
20773;"Lazdynų vid. m-kla";Zuikučiai;25106446270;Taip;4;10;0;14
20774;"Lazdynų vid. m-kla";Zuikučiai;9123178095;Taip;5;12;0;17
20775;"Lazdynų vid. m-kla";Zuikučiai;8152577445;Taip;4;0;1;5
20776;"Lazdynų vid. m-kla";Zuikučiai;6848743350;Taip;6;3;3;12
20777;"Lazdynų vid. m-kla";Zuikučiai;1365362641;Taip;8;0;0;8
20778;"Lazdynų vid. m-kla";Zuikučiai;3435025978;Taip;0;13;0;13
20779;"Lazdynų vid. m-kla";Zuikučiai;7549389699;Ne;7;2;1;10
20780;"Lazdynų vid. m-kla";PG;47639960564;Taip;0;2;0;2
20781;"Lazdynų vid. m-kla";PG;8081211948;Taip;5;5;3;13
20782;"Lazdynų vid. m-kla";PG;28609993291;Taip;4;10;0;14
20783;"Lazdynų vid. m-kla";PG;72136845605;Taip;5;5;0;10
20784;"Lazdynų vid. m-kla";PG;1422035829;Taip;0;5;1;6
20785;"Lazdynų vid. m-kla";PG;7042064449;Taip;5;0;2;7
20786;"Lazdynų vid. m-kla";PG;9770196122;Taip;4;0;3;7
20787;"Lazdynų vid. m-kla";PG;87269519104;Taip;0;5;4;9
20788;"Lazdynų vid. m-kla";PG;32859635045;Taip;0;16;0;16
20789;"„Atžalyno” mokykla-darželis";Giliukai;20731737855;Taip;0;5;1;6
20790;"„Atžalyno” mokykla-darželis";Giliukai;4689820608;Taip;0;5;4;9
20791;"„Atžalyno” mokykla-darželis";Giliukai;96760511860;Taip;0;5;0;5
20792;"„Atžalyno” mokykla-darželis";Giliukai;43653378110;Taip;0;5;0;5
20793;"„Atžalyno” mokykla-darželis";Giliukai;11283726979;Taip;0;5;0;5
20794;"„Atžalyno” mokykla-darželis";Giliukai;79370702446;Taip;0;5;0;5
20795;"„Atžalyno” mokykla-darželis";Giliukai;5473807824;Taip;0;5;0;5
20796;"„Atžalyno” mokykla-darželis";Giliukai;812540977;Taip;0;1;0;1
20797;"„Atžalyno” mokykla-darželis";Giliukai;16939194895;Taip;10;5;0;15
20798;"„Atžalyno” mokykla-darželis";Giliukai;72842885611;Taip;6;0;0;6
20799;"„Atžalyno” mokykla-darželis";Giliukai;1360239148;Taip;5;7;0;12
20800;"„Atžalyno” mokykla-darželis";Giliukai;2561427539;Ne;0;1;0;1
20801;"„Atžalyno” mokykla-darželis";Giliukai;21100054429;Taip;0;8;0;8
20802;"„Atžalyno” mokykla-darželis";Giliukai;75040764923;Taip;0;5;3;8
20803;"„Atžalyno” mokykla-darželis";Giliukai;9526480686;Taip;0;6;0;6
20804;"„Atžalyno” mokykla-darželis";Giliukai;24475539554;Taip;0;10;0;10
20805;"„Atžalyno” mokykla-darželis";Giliukai;24751884646;Taip;0;5;2;7
20806;"„Atžalyno” mokykla-darželis";Giliukai;1687257249;Taip;0;14;0;14
20807;"„Atžalyno” mokykla-darželis";Giliukai;8477084613;Taip;0;8;0;8
20808;"„Atžalyno” mokykla-darželis";Giliukai;9671080677;Taip;0;4;0;4
20809;"„Atžalyno” mokykla-darželis";Riešutėliai;62142172359;Taip;15;5;0;20
20810;"„Atžalyno” mokykla-darželis";Riešutėliai;3632328378;Taip;9;0;0;9
20811;"„Atžalyno” mokykla-darželis";Riešutėliai;31330839773;Taip;0;13;0;13
20812;"„Atžalyno” mokykla-darželis";Riešutėliai;1035650951;Taip;6;5;0;11
20813;"„Atžalyno” mokykla-darželis";Riešutėliai;46927762616;Ne;14;5;0;19
20814;"„Atžalyno” mokykla-darželis";Riešutėliai;74843613898;Ne;3;5;0;8
20815;"„Atžalyno” mokykla-darželis";Riešutėliai;27965090417;Ne;0;8;0;8
20816;"„Atžalyno” mokykla-darželis";Riešutėliai;4309031068;Ne;1;5;0;6
20817;"„Atžalyno” mokykla-darželis";Riešutėliai;6177714133;Taip;6;5;0;11
20818;"„Atžalyno” mokykla-darželis";Riešutėliai;1298900423;Taip;0;5;5;10
20819;"„Atžalyno” mokykla-darželis";Riešutėliai;64311414937;Taip;4;5;1;10
20820;"„Atžalyno” mokykla-darželis";Riešutėliai;2172405172;Ne;0;3;0;3
20821;"„Atžalyno” mokykla-darželis";Riešutėliai;23426260453;Taip;2;5;0;7
20822;"„Atžalyno” mokykla-darželis";Riešutėliai;9783561315;Taip;0;5;2;7
20823;"„Atžalyno” mokykla-darželis";Riešutėliai;79970541004;Taip;2;5;0;7
20824;"„Atžalyno” mokykla-darželis";Riešutėliai;94770065539;Taip;2;6;0;8
20825;"„Atžalyno” mokykla-darželis";Riešutėliai;79939366466;Taip;0;5;2;7
20826;"„Atžalyno” mokykla-darželis";Riešutėliai;78155776901;Taip;0;9;0;9
20827;"„Atžalyno” mokykla-darželis";Riešutėliai;10955918317;Taip;0;5;0;5
20828;"„Atžalyno” mokykla-darželis";Riešutėliai;19312623259;Taip;0;10;0;10
20829;"„Atžalyno” mokykla-darželis";Riešutėliai;5921479520;Taip;0;5;8;13
20830;"Vilniaus Emilijos Pliaterytės progimnazija";PELĖDŽIUKAI;1475766630;Taip;0;20;0;20
20831;"Vilniaus Emilijos Pliaterytės progimnazija";PELĖDŽIUKAI;1758561647;Taip;7;0;0;7
20832;"Vilniaus Emilijos Pliaterytės progimnazija";PELĖDŽIUKAI;11101488283;Taip;0;0;2;2
20833;"Vilniaus Emilijos Pliaterytės progimnazija";PELĖDŽIUKAI;1551926849;Taip;3;1;0;4
20834;"Vilniaus Emilijos Pliaterytės progimnazija";PELĖDŽIUKAI;1914464845;Taip;0;5;2;7
20835;"Vilniaus Emilijos Pliaterytės progimnazija";PELĖDŽIUKAI;9980215936;Ne;0;5;4;9
20836;"Vilniaus Emilijos Pliaterytės progimnazija";PELĖDŽIUKAI;6406833864;Taip;0;20;0;20
20837;"Vilniaus Emilijos Pliaterytės progimnazija";PELĖDŽIUKAI;3049460994;Taip;6;5;1;12
20838;"Vilniaus Emilijos Pliaterytės progimnazija";PELĖDŽIUKAI;2450382256;Taip;0;5;1;6
20839;"Vilniaus Emilijos Pliaterytės progimnazija";PELĖDŽIUKAI;7540156488;Taip;0;12;0;12
20840;"Vilniaus Emilijos Pliaterytės progimnazija";PELĖDŽIUKAI;4146983741;Taip;0;5;0;5
20841;"Vilniaus Emilijos Pliaterytės progimnazija";PELĖDŽIUKAI;9886869275;Taip;5;6;1;12
20842;"Vilniaus Emilijos Pliaterytės progimnazija";PELĖDŽIUKAI;63585262568;Taip;0;0;6;6
20843;"Vilniaus Emilijos Pliaterytės progimnazija";PELĖDŽIUKAI;8202177756;Taip;6;5;0;11
20844;"Vilniaus Emilijos Pliaterytės progimnazija";PELĖDŽIUKAI;1362468297;Ne;5;5;0;10
20845;"Vilniaus Emilijos Pliaterytės progimnazija";PELĖDŽIUKAI;96590022188;Taip;10;0;0;10
20846;"Vilniaus Emilijos Pliaterytės progimnazija";PELĖDŽIUKAI;2787942076;Taip;0;5;0;5
20847;"Vilniaus Emilijos Pliaterytės progimnazija";BITUTĖS;1266987365;Taip;6;5;0;11
20848;"Vilniaus Emilijos Pliaterytės progimnazija";BITUTĖS;1381033889;Taip;2;7;1;10
20849;"Vilniaus Emilijos Pliaterytės progimnazija";BITUTĖS;4569189295;Taip;1;4;0;5
20850;"Vilniaus Emilijos Pliaterytės progimnazija";BITUTĖS;48399220211;Taip;4;0;0;4
20851;"Vilniaus Emilijos Pliaterytės progimnazija";BITUTĖS;2514450574;Taip;0;9;1;10
20852;"Vilniaus Emilijos Pliaterytės progimnazija";BITUTĖS;16065326151;Taip;2;10;4;16
20853;"Vilniaus Emilijos Pliaterytės progimnazija";BITUTĖS;21354424968;Taip;0;24;0;24
20854;"Vilniaus Emilijos Pliaterytės progimnazija";BITUTĖS;9056362645;Taip;5;14;0;19
20855;"Vilniaus Emilijos Pliaterytės progimnazija";BITUTĖS;39510115701;Ne;19;5;0;24
20856;"Vilniaus Emilijos Pliaterytės progimnazija";BITUTĖS;6725344622;Taip;0;5;4;9
20857;"Vilniaus Emilijos Pliaterytės progimnazija";BITUTĖS;6010639117;Taip;14;5;0;19
20858;"Vilniaus Emilijos Pliaterytės progimnazija";BITUTĖS;9725646179;Taip;4;1;0;5
20859;"Vilniaus Emilijos Pliaterytės progimnazija";BITUTĖS;1601646622;Taip;7;3;0;10
20860;"Vilniaus Emilijos Pliaterytės progimnazija";BITUTĖS;4795999477;Ne;14;5;0;19
20861;"Vilniaus Emilijos Pliaterytės progimnazija";BITUTĖS;9872199634;Taip;0;5;0;5
20862;"Vilniaus Emilijos Pliaterytės progimnazija";BITUTĖS;6105675285;Ne;0;5;10;15
20863;"Vilniaus Emilijos Pliaterytės progimnazija";BITUTĖS;2149264761;Taip;0;5;3;8
20864;"Vilniaus Emilijos Pliaterytės progimnazija";BITUTĖS;9328626733;Taip;0;7;6;13
20865;"Vilniaus Emilijos Pliaterytės progimnazija";BITUTĖS;1212916505;Taip;11;5;0;16
20866;"Vilniaus Emilijos Pliaterytės progimnazija";BITUTĖS;61614055656;Taip;5;6;0;11
20867;"Vilniaus Emilijos Pliaterytės progimnazija";BITUTĖS;3740838674;Taip;2;9;5;16
20868;"Vilniaus Emilijos Pliaterytės progimnazija";BITUTĖS;2046056078;Taip;10;5;0;15
20869;"Vilniaus Emilijos Pliaterytės progimnazija";BITUTĖS;1323653656;Taip;0;5;0;5
20870;"Vilniaus Emilijos Pliaterytės progimnazija";BITUTĖS;5322173245;Taip;11;5;0;16
20871;"Vilniaus Emilijos Pliaterytės progimnazija";BITUTĖS;3416526776;Taip;2;5;5;12
20872;"Vilniaus Karaliaus Mindaugo pagrindinė mokykla";"NAUJA 1";1450039671;Taip;2;0;0;2
20873;"Vilniaus Karaliaus Mindaugo pagrindinė mokykla";"NAUJA 1";1823039323;Taip;2;0;3;5
20874;"Vilniaus Karaliaus Mindaugo pagrindinė mokykla";"NAUJA 1";7596203918;Taip;14;0;2;16
20875;"Vilniaus Karaliaus Mindaugo pagrindinė mokykla";"NAUJA 1";3680257542;Ne;0;0;10;10
20876;"Vilniaus Karaliaus Mindaugo pagrindinė mokykla";"NAUJA 1";10083948781;Taip;7;0;0;7
20877;"Vilniaus Karaliaus Mindaugo pagrindinė mokykla";"NAUJA 1";1401502095;Taip;6;0;2;8
20878;"Vilniaus Karaliaus Mindaugo pagrindinė mokykla";"NAUJA 1";1257750782;Taip;0;1;0;1
20879;"Vilniaus Karaliaus Mindaugo pagrindinė mokykla";"NAUJA 1";1969208564;Ne;0;2;2;4
20880;"Vilniaus Karaliaus Mindaugo pagrindinė mokykla";"NAUJA 1";1860540266;Taip;0;5;6;11
20881;"Vilniaus Karaliaus Mindaugo pagrindinė mokykla";"NAUJA 1";9555191234;Taip;0;5;8;13
20882;"Vilniaus Karaliaus Mindaugo pagrindinė mokykla";"NAUJA 1";18362159086;Taip;4;6;3;13
20883;"Vilniaus Karaliaus Mindaugo pagrindinė mokykla";"NAUJA 1";9136681731;Taip;3;0;4;7
20884;"Vilniaus Karaliaus Mindaugo pagrindinė mokykla";"NAUJA 2";6139759777;Taip;0;11;0;11
20885;"Vilniaus Karaliaus Mindaugo pagrindinė mokykla";"NAUJA 2";1244335689;Ne;0;5;5;10
20886;"Vilniaus Karaliaus Mindaugo pagrindinė mokykla";"NAUJA 2";30247081871;Taip;10;1;0;11
20887;"Vilniaus Karaliaus Mindaugo pagrindinė mokykla";"NAUJA 2";22190489474;Taip;0;2;0;2
20888;"Vilniaus Karaliaus Mindaugo pagrindinė mokykla";"NAUJA 2";52007245002;Taip;0;1;3;4
20889;"Vilniaus Karaliaus Mindaugo pagrindinė mokykla";"NAUJA 2";1739513728;Taip;0;0;3;3
20890;"Vilniaus Karaliaus Mindaugo pagrindinė mokykla";"NAUJA 2";1109246994;Taip;0;0;5;5
20891;"Vilniaus Karaliaus Mindaugo pagrindinė mokykla";"NAUJA 2";42856875754;Taip;10;0;1;11
20892;"Vilniaus Karaliaus Mindaugo pagrindinė mokykla";"NAUJA 2";66357034848;Taip;0;5;7;12
20893;"Vilniaus Karaliaus Mindaugo pagrindinė mokykla";"NAUJA 2";9926365944;Taip;6;3;6;15
20894;"Vilniaus Karaliaus Mindaugo pagrindinė mokykla";"NAUJA 2";1929070821;Taip;5;0;0;5
20895;"Vilniaus Karaliaus Mindaugo pagrindinė mokykla";"NAUJA 2";34474268952;Taip;7;5;0;12
20896;"Vilniaus Karaliaus Mindaugo pagrindinė mokykla";"NAUJA 2";51014054575;Taip;0;4;1;5
20897;"Vilniaus Karaliaus Mindaugo pagrindinė mokykla";"NAUJA 2";1774272972;Taip;8;0;0;8
20898;"Vilniaus Karaliaus Mindaugo pagrindinė mokykla";"NAUJA 2";6408313774;Taip;0;5;1;6
20899;"Vilniaus Karaliaus Mindaugo pagrindinė mokykla";"NAUJA 2";1161763218;Taip;0;3;0;3
20900;"Vilniaus Karaliaus Mindaugo pagrindinė mokykla";"NAUJA 2";2941071757;Taip;0;5;0;5
20901;"Vilniaus Karaliaus Mindaugo pagrindinė mokykla";"NAUJA 2";7501280559;Taip;0;5;5;10
20902;"Vilniaus Karaliaus Mindaugo pagrindinė mokykla";"NAUJA 2";66035912812;Ne;5;4;2;11
20903;"Vilniaus Karaliaus Mindaugo pagrindinė mokykla";"NAUJA 2";45248429076;Taip;4;0;0;4
20904;"Vilniaus Karaliaus Mindaugo pagrindinė mokykla";"NAUJA 2";3763454607;Taip;5;0;0;5
20905;"Vilniaus Karaliaus Mindaugo pagrindinė mokykla";"NAUJA 3";76067902652;Taip;0;3;3;6
20906;"Vilniaus Karaliaus Mindaugo pagrindinė mokykla";"NAUJA 3";22824695222;Taip;0;8;0;8
20907;"Vilniaus Karaliaus Mindaugo pagrindinė mokykla";"NAUJA 3";15620943297;Taip;0;6;0;6
20908;"Vilniaus Karaliaus Mindaugo pagrindinė mokykla";"NAUJA 3";29462854972;Ne;0;4;0;4
20909;"Vilniaus Karaliaus Mindaugo pagrindinė mokykla";"NAUJA 3";46789173270;Ne;0;5;3;8
20910;"Vilniaus Karaliaus Mindaugo pagrindinė mokykla";"NAUJA 3";93362540292;Taip;12;0;0;12
20911;"Vilniaus Karaliaus Mindaugo pagrindinė mokykla";"NAUJA 3";39314644760;Taip;5;7;0;12
20912;"Vilniaus Karaliaus Mindaugo pagrindinė mokykla";"NAUJA 3";63005020529;Taip;5;0;0;5
20913;"Vilniaus Karaliaus Mindaugo pagrindinė mokykla";"NAUJA 3";69875233191;Taip;10;4;1;15
20914;"Vilniaus Karaliaus Mindaugo pagrindinė mokykla";"NAUJA 3";81435594438;Taip;0;5;2;7
20915;"Vilniaus Karaliaus Mindaugo pagrindinė mokykla";"NAUJA 3";1933781186;Ne;0;4;0;4
20916;"Vilniaus Karaliaus Mindaugo pagrindinė mokykla";"NAUJA 3";5728013837;Taip;0;5;8;13
20917;"Vilniaus Karaliaus Mindaugo pagrindinė mokykla";"NAUJA 3";14289501964;Taip;0;3;0;3
20918;"Vilniaus Karaliaus Mindaugo pagrindinė mokykla";"NAUJA 3";23714493433;Taip;0;5;7;12
20919;"Vilniaus Karaliaus Mindaugo pagrindinė mokykla";"NAUJA 3";1480855516;Taip;5;2;3;10
20920;"Vilniaus Karaliaus Mindaugo pagrindinė mokykla";"NAUJA 3";82128363155;Taip;0;1;0;1
20921;"Vilniaus Karaliaus Mindaugo pagrindinė mokykla";"NAUJA 3";3974287828;Ne;0;0;5;5
20922;"Vilniaus Baltupių progimnazija";Kodėlčiukai;39367902407;Taip;0;5;0;5
20923;"Vilniaus Baltupių progimnazija";Kodėlčiukai;14007025976;Taip;0;5;0;5
20924;"Vilniaus Baltupių progimnazija";Kodėlčiukai;71242132208;Taip;0;6;0;6
20925;"Vilniaus Baltupių progimnazija";Kodėlčiukai;32755901956;Taip;0;6;0;6
20926;"Vilniaus Baltupių progimnazija";Kodėlčiukai;85383004980;Taip;5;5;0;10
20927;"Vilniaus Baltupių progimnazija";Kodėlčiukai;39643159605;Taip;3;5;0;8
20928;"Vilniaus Baltupių progimnazija";Kodėlčiukai;44658552984;Taip;1;5;0;6
20929;"Vilniaus Baltupių progimnazija";Kodėlčiukai;55625325952;Taip;5;5;0;10
20930;"Vilniaus Baltupių progimnazija";Kodėlčiukai;29812449566;Taip;0;1;0;1
20931;"Vilniaus Baltupių progimnazija";Kodėlčiukai;16355778437;Taip;2;5;0;7
20932;"Vilniaus Baltupių progimnazija";Kodėlčiukai;41941052897;Taip;2;5;0;7
20933;"Vilniaus Baltupių progimnazija";Kodėlčiukai;43948925208;Taip;0;5;0;5
20934;"Vilniaus Baltupių progimnazija";Kodėlčiukai;9561915342;Taip;0;6;0;6
20935;"Vilniaus Baltupių progimnazija";Kodėlčiukai;41791737317;Taip;0;7;0;7
20936;"Vilniaus Baltupių progimnazija";Kodėlčiukai;69400709859;Taip;0;5;0;5
20937;"Vilniaus Baltupių progimnazija";Kodėlčiukai;43266943346;Taip;0;6;1;7
20938;"Vilniaus Baltupių progimnazija";Smalsučiai;6378279947;Taip;0;7;0;7
20939;"Vilniaus Baltupių progimnazija";Smalsučiai;98879417665;Taip;0;2;1;3
20940;"Vilniaus Baltupių progimnazija";Smalsučiai;72920136125;Taip;0;5;5;10
20941;"Vilniaus Baltupių progimnazija";Smalsučiai;6691656559;Taip;0;4;0;4
20942;"Vilniaus Baltupių progimnazija";Smalsučiai;26377121363;Taip;3;5;1;9
20943;"Vilniaus Baltupių progimnazija";Smalsučiai;54374237984;Taip;0;0;2;2
20944;"Vilniaus Baltupių progimnazija";Smalsučiai;44112608775;Taip;0;5;1;6
20945;"Vilniaus Baltupių progimnazija";Smalsučiai;14961029346;Taip;0;6;0;6
20946;"Vilniaus Baltupių progimnazija";Smalsučiai;55042661269;Taip;0;5;0;5
20947;"Vilniaus Baltupių progimnazija";Smalsučiai;34661197670;Taip;0;6;0;6
20948;"Vilniaus Baltupių progimnazija";Smalsučiai;85563395776;Taip;0;7;0;7
20949;"Vilniaus Baltupių progimnazija";Smalsučiai;88349018506;Taip;0;5;0;5
20950;"Vilniaus Baltupių progimnazija";Smalsučiai;1474110400;Taip;7;5;0;12
20951;"Vilniaus Baltupių progimnazija";Smalsučiai;58618032928;Taip;9;5;1;15
20952;"Vilniaus Baltupių progimnazija";Smalsučiai;29830293532;Taip;0;0;1;1
20953;"Vilniaus Baltupių progimnazija";Smalsučiai;8033817151;Taip;3;5;0;8
20954;"Vilniaus Baltupių progimnazija";Smalsučiai;1377633427;Ne;2;5;3;10
20955;"Vilniaus Baltupių progimnazija";Svajokliai;77443527742;Taip;0;5;1;6
20956;"Vilniaus Baltupių progimnazija";Svajokliai;1124861465;Taip;0;3;0;3
20957;"Vilniaus Baltupių progimnazija";Svajokliai;2783585739;Taip;0;5;0;5
20958;"Vilniaus Baltupių progimnazija";Svajokliai;84147129210;Taip;5;2;2;9
20959;"Vilniaus Baltupių progimnazija";Svajokliai;99951182202;Taip;4;5;0;9
20960;"Vilniaus Baltupių progimnazija";Svajokliai;44197089077;Taip;10;5;1;16
20961;"Vilniaus Baltupių progimnazija";Svajokliai;10296915277;Taip;0;3;0;3
20962;"Vilniaus Baltupių progimnazija";Svajokliai;6141821323;Taip;0;5;2;7
20963;"Vilniaus Baltupių progimnazija";Svajokliai;9897957182;Taip;0;5;0;5
20964;"Vilniaus Baltupių progimnazija";Svajokliai;6836526948;Taip;0;9;11;20
20965;"Vilniaus Baltupių progimnazija";Svajokliai;86159748827;Taip;0;1;2;3
20966;"Vilniaus Baltupių progimnazija";Svajokliai;7315821989;Taip;0;5;1;6
20967;"Vilniaus Baltupių progimnazija";Svajokliai;85006202845;Taip;0;5;3;8
20968;"Vilniaus Baltupių progimnazija";Svajokliai;73329089772;Taip;0;5;0;5
20969;"Vilniaus Baltupių progimnazija";Svajokliai;53079636572;Ne;0;5;0;5
20970;"Vilniaus Baltupių progimnazija";Svajokliai;5165936773;Taip;0;5;0;5
20971;"Vilniaus Baltupių progimnazija";Svajokliai;3555057263;Taip;5;15;0;20
20972;"Vilniaus Baltupių progimnazija";Žiniukai;4438092778;Taip;0;1;0;1
20973;"Vilniaus Baltupių progimnazija";Žiniukai;49864549520;Ne;0;5;0;5
20974;"Vilniaus Baltupių progimnazija";Žiniukai;45338766326;Taip;1;5;0;6
20975;"Vilniaus Baltupių progimnazija";Žiniukai;7172910408;Taip;0;2;6;8
20976;"Vilniaus Baltupių progimnazija";Žiniukai;83439477631;Taip;0;0;1;1
20977;"Vilniaus Baltupių progimnazija";Žiniukai;96970348855;Taip;3;0;0;3
20978;"Vilniaus Baltupių progimnazija";Žiniukai;22749485803;Taip;1;3;3;7
20979;"Vilniaus Baltupių progimnazija";Žiniukai;21356492489;Taip;0;5;0;5
20980;"Vilniaus Baltupių progimnazija";Žiniukai;66442714295;Taip;3;5;0;8
20981;"Vilniaus Baltupių progimnazija";Žiniukai;69737288391;Taip;0;6;0;6
20982;"Vilniaus Baltupių progimnazija";Žiniukai;23763005302;Taip;2;4;1;7
20983;"Vilniaus Baltupių progimnazija";Žiniukai;5703301527;Taip;4;5;0;9
20984;"Vilniaus Baltupių progimnazija";Žiniukai;59153301160;Taip;0;5;1;6
20985;"Vilniaus Baltupių progimnazija";Žiniukai;7935037685;Taip;5;4;0;9
20986;"Vilniaus Baltupių progimnazija";Žiniukai;3909042390;Taip;3;5;5;13
20987;"Vilniaus Baltupių progimnazija";Žiniukai;6434969626;Taip;13;5;0;18
20988;"Vilniaus Baltupių progimnazija";Žiniukai;52985512945;Taip;0;5;0;5
20989;"Vilniaus Levo Karsavimo vidurinė mokykla";"Priešmokyklinukai A";14440714117;Taip;4;5;2;11
20990;"Vilniaus Levo Karsavimo vidurinė mokykla";"Priešmokyklinukai A";82502598495;Taip;0;10;0;10
20991;"Vilniaus Levo Karsavimo vidurinė mokykla";"Priešmokyklinukai A";93157311332;Taip;5;5;0;10
20992;"Vilniaus Levo Karsavimo vidurinė mokykla";"Priešmokyklinukai A";28093592809;Taip;0;5;0;5
20993;"Vilniaus Levo Karsavimo vidurinė mokykla";"Priešmokyklinukai A";70364015727;Taip;8;5;0;13
20994;"Vilniaus Levo Karsavimo vidurinė mokykla";"Priešmokyklinukai A";4273890878;Taip;0;5;0;5
20995;"Vilniaus Levo Karsavimo vidurinė mokykla";"Priešmokyklinukai A";77019635269;Taip;0;8;0;8
20996;"Vilniaus Levo Karsavimo vidurinė mokykla";"Priešmokyklinukai A";57354627123;Taip;0;5;0;5
20997;"Vilniaus Levo Karsavimo vidurinė mokykla";"Priešmokyklinukai A";15574258138;Taip;0;5;0;5
20998;"Vilniaus Levo Karsavimo vidurinė mokykla";"Priešmokyklinukai A";7147965267;Taip;0;20;0;20
20999;"Vilniaus Levo Karsavimo vidurinė mokykla";"Priešmokyklinukai A";58496565193;Taip;1;5;1;7
21000;"Vilniaus Levo Karsavimo vidurinė mokykla";"Priešmokyklinukai A";25498748126;Ne;0;5;0;5
21001;"Vilniaus Levo Karsavimo vidurinė mokykla";"Priešmokyklinukai A";77438050638;Taip;4;5;0;9
21002;"Vilniaus Levo Karsavimo vidurinė mokykla";"Priešmokyklinukai A";36430214688;Taip;0;8;0;8
21003;"Vilniaus Levo Karsavimo vidurinė mokykla";"Priešmokyklinukai A";94004273598;Taip;0;5;0;5
21004;"Vilniaus Levo Karsavimo vidurinė mokykla";"Priešmokyklinukai A";1371307111;Taip;10;5;0;15
21005;"Vilniaus Levo Karsavimo vidurinė mokykla";"Priešmokyklinukai b";90184376409;Taip;0;6;0;6
21006;"Vilniaus Levo Karsavimo vidurinė mokykla";"Priešmokyklinukai b";6151061931;Taip;5;5;1;11
21007;"Vilniaus Levo Karsavimo vidurinė mokykla";"Priešmokyklinukai b";1938391715;Taip;0;7;0;7
21008;"Vilniaus Levo Karsavimo vidurinė mokykla";"Priešmokyklinukai b";66160874700;Taip;0;5;0;5
21009;"Vilniaus Levo Karsavimo vidurinė mokykla";"Priešmokyklinukai b";38820365517;Taip;0;6;0;6
21010;"Vilniaus Levo Karsavimo vidurinė mokykla";"Priešmokyklinukai b";22149054613;Taip;0;7;0;7
21011;"Vilniaus Levo Karsavimo vidurinė mokykla";"Priešmokyklinukai b";2531327145;Taip;0;5;0;5
21012;"Vilniaus Levo Karsavimo vidurinė mokykla";"Priešmokyklinukai b";78913604764;Taip;0;7;0;7
21013;"Vilniaus Levo Karsavimo vidurinė mokykla";"Priešmokyklinukai b";89656947611;Taip;1;5;4;10
21014;"Vilniaus Levo Karsavimo vidurinė mokykla";"Priešmokyklinukai b";56625898576;Taip;0;5;0;5
21015;"Vilniaus Levo Karsavimo vidurinė mokykla";"Priešmokyklinukai b";66998252884;Taip;0;11;0;11
21016;"Vilniaus Levo Karsavimo vidurinė mokykla";"Priešmokyklinukai b";30728353672;Ne;0;5;1;6
21017;"Vilniaus Levo Karsavimo vidurinė mokykla";"Priešmokyklinukai b";31278810938;Taip;0;5;0;5
21018;"Vilniaus Levo Karsavimo vidurinė mokykla";"Priešmokyklinukai b";3893943727;Ne;1;5;0;6
21019;"Vilniaus Levo Karsavimo vidurinė mokykla";"Priešmokyklinukai b";51125720677;Taip;0;11;0;11
21020;"Vilniaus Liepkalnio Pagrindinė Mokykla";Bitutės;85942649944;Taip;0;5;4;9
21021;"Vilniaus Liepkalnio Pagrindinė Mokykla";Bitutės;15384883293;Taip;0;5;0;5
21022;"Vilniaus Liepkalnio Pagrindinė Mokykla";Bitutės;41301452936;Ne;0;5;1;6
21023;"Vilniaus Liepkalnio Pagrindinė Mokykla";Bitutės;68347661358;Taip;1;5;0;6
21024;"Vilniaus Liepkalnio Pagrindinė Mokykla";Bitutės;4437933849;Taip;0;5;2;7
21025;"Vilniaus Liepkalnio Pagrindinė Mokykla";Bitutės;4760866352;Taip;0;5;0;5
21026;"Vilniaus Liepkalnio Pagrindinė Mokykla";Bitutės;70408565216;Ne;0;5;3;8
21027;"Vilniaus Liepkalnio Pagrindinė Mokykla";Bitutės;11323385715;Taip;5;5;0;10
21028;"Vilniaus Liepkalnio Pagrindinė Mokykla";Bitutės;2118993423;Taip;5;5;0;10
21029;"Vilniaus Liepkalnio Pagrindinė Mokykla";Bitutės;53619465080;Taip;3;5;0;8
21030;"Vilniaus Liepkalnio Pagrindinė Mokykla";Bitutės;5991259497;Taip;0;5;3;8
21031;"Vilniaus Liepkalnio Pagrindinė Mokykla";Bitutės;52218753980;Taip;0;5;1;6
21032;"Vilniaus Liepkalnio Pagrindinė Mokykla";Bitutės;3007372384;Taip;0;20;0;20
21033;"Vilniaus Liepkalnio Pagrindinė Mokykla";Bitutės;4972232696;Taip;0;20;0;20
21034;"Vilniaus Liepkalnio Pagrindinė Mokykla";Bitutės;7760450278;Ne;0;5;4;9
21035;"Vilniaus Pranciškaus Skorinos gimnazija";Saulytė;8111363055;Taip;2;9;0;11
21036;"Vilniaus Pranciškaus Skorinos gimnazija";Saulytė;2930371388;Taip;0;5;2;7
21037;"Vilniaus Pranciškaus Skorinos gimnazija";Saulytė;70791039097;Ne;0;7;0;7
21038;"Vilniaus Pranciškaus Skorinos gimnazija";Saulytė;8632571006;Taip;0;6;1;7
21039;"Vilniaus Pranciškaus Skorinos gimnazija";Saulytė;66664410121;Taip;0;5;0;5
21040;"Vilniaus Pranciškaus Skorinos gimnazija";Saulytė;3790508177;Taip;0;9;0;9
21041;"Vilniaus Pranciškaus Skorinos gimnazija";Saulytė;27125411489;Taip;5;5;0;10
21042;"Vilniaus Pranciškaus Skorinos gimnazija";Saulytė;72738955088;Taip;0;12;0;12
21043;"Vilniaus Pranciškaus Skorinos gimnazija";Saulytė;67729297941;Ne;8;6;0;14
21044;"Vilniaus Pranciškaus Skorinos gimnazija";Saulytė;2386940016;Taip;7;5;4;16
21045;"Vilniaus Pranciškaus Skorinos gimnazija";Saulytė;1483885253;Taip;8;5;0;13
21046;"Vilniaus Pranciškaus Skorinos gimnazija";Saulytė;4909904794;Taip;16;5;0;21
21047;"Vilniaus Pranciškaus Skorinos gimnazija";Saulytė;4666237893;Taip;0;7;0;7
21048;"Vilniaus Pranciškaus Skorinos gimnazija";Saulytė;87925810917;Taip;5;5;0;10
21049;"Vilniaus Pranciškaus Skorinos gimnazija";Saulytė;9701472893;Taip;5;9;0;14
21050;"Vilniaus Pranciškaus Skorinos gimnazija";Saulytė;31343765777;Taip;3;5;0;8
21051;"Vilniaus Pranciškaus Skorinos gimnazija";Saulytė;55421475688;Taip;11;5;0;16
21052;"Vilniaus Pranciškaus Skorinos gimnazija";Saulytė;55086628871;Taip;11;0;0;11
21053;"Vilniaus Simono Konarskio vidurinės mokykla";"1 gr.";9759567795;Taip;0;5;0;5
21054;"Vilniaus Simono Konarskio vidurinės mokykla";"1 gr.";40561567890;Taip;0;5;0;5
21055;"Vilniaus Simono Konarskio vidurinės mokykla";"1 gr.";5884520114;Ne;0;5;0;5
21056;"Vilniaus Simono Konarskio vidurinės mokykla";"1 gr.";3165852410;Ne;10;5;0;15
21057;"Vilniaus Simono Konarskio vidurinės mokykla";"1 gr.";9585599736;Taip;0;5;0;5
21058;"Vilniaus Simono Konarskio vidurinės mokykla";"1 gr.";38075556139;Taip;0;5;0;5
21059;"Vilniaus Simono Konarskio vidurinės mokykla";"1 gr.";90764462777;Taip;0;5;0;5
21060;"Vilniaus Simono Konarskio vidurinės mokykla";"1 gr.";15628069778;Taip;0;5;0;5
21061;"Vilniaus Simono Konarskio vidurinės mokykla";"1 gr.";59785459193;Taip;0;5;0;5
21062;"Vilniaus Simono Konarskio vidurinės mokykla";"1 gr.";8708972546;Taip;0;5;0;5
21063;"Vilniaus Simono Konarskio vidurinės mokykla";"1 gr.";78809378214;Taip;0;5;0;5
21064;"Vilniaus Simono Konarskio vidurinės mokykla";"1 gr.";5553972538;Taip;6;5;0;11
21065;"Vilniaus Simono Konarskio vidurinės mokykla";"1 gr.";37201396276;Taip;0;5;0;5
21066;"Vilniaus Simono Konarskio vidurinės mokykla";"1 gr.";77024512167;Taip;3;5;0;8
21067;"Vilniaus Simono Konarskio vidurinės mokykla";"1 gr.";8786280855;Taip;3;5;0;8
21068;"Vilniaus Simono Konarskio vidurinės mokykla";"1 gr.";7881088760;Taip;3;5;0;8
21069;"Vilniaus Trakų Vokės gimnazija";Priešmokyklinė;86951309976;Taip;0;0;4;4
21070;"Vilniaus Trakų Vokės gimnazija";Priešmokyklinė;58787126706;Taip;5;0;0;5
21071;"Vilniaus Trakų Vokės gimnazija";Priešmokyklinė;68332465021;Taip;0;5;4;9
21072;"Vilniaus Trakų Vokės gimnazija";Priešmokyklinė;98279169682;Ne;0;0;4;4
21073;"Vilniaus Trakų Vokės gimnazija";Priešmokyklinė;89375639444;Taip;0;5;10;15
21074;"Vilniaus Trakų Vokės gimnazija";Priešmokyklinė;1680721429;Taip;0;2;2;4
21075;"Vilniaus Trakų Vokės gimnazija";Priešmokyklinė;49306819367;Taip;0;1;6;7
21076;"Vilniaus Trakų Vokės gimnazija";Priešmokyklinė;86317439855;Taip;12;5;0;17
21077;"Vilniaus Trakų Vokės gimnazija";Priešmokyklinė;5104422489;Taip;10;5;4;19
21078;"Vilniaus Trakų Vokės gimnazija";Priešmokyklinė;80454463606;Taip;0;5;2;7
21079;"Vilniaus Trakų Vokės gimnazija";Priešmokyklinė;63420742280;Taip;15;0;0;15
21080;"Vilniaus Trakų Vokės gimnazija";Priešmokyklinė;3795096854;Taip;0;5;2;7
21081;"Vilniaus Trakų Vokės gimnazija";Priešmokyklinė;94248843596;Taip;0;5;0;5
21082;"Vilniaus Trakų Vokės gimnazija";Priešmokyklinė;55269223931;Taip;9;0;2;11
21083;"Vilniaus Trakų Vokės gimnazija";Priešmokyklinė;30728775392;Taip;13;5;3;21
21084;"Vilniaus Trakų Vokės gimnazija";Priešmokyklinė;93253698828;Taip;0;12;1;13
21085;"Vilniaus Trakų Vokės gimnazija";Priešmokyklinė;13225336236;Ne;13;5;0;18
21086;"Vilniaus Trakų Vokės gimnazija";Priešmokyklinė;28771899278;Taip;15;1;0;16
21087;"Vilniaus Trakų Vokės gimnazija";Priešmokyklinė;98169988178;Taip;10;5;1;16
21088;"Vilniaus Trakų Vokės gimnazija";Priešmokyklinė;6066619225;Taip;10;2;3;15
21089;"Vilniaus Trakų Vokės gimnazija";Priešmokyklinė;45478578368;Taip;0;2;13;15
21090;"Vilniaus Trakų Vokės gimnazija";Priešmokyklinė;1591065244;Ne;20;0;5;25
21091;"Vilniaus Trakų Vokės gimnazija";Priešmokyklinė;50146560386;Taip;10;0;0;10
21092;"Vilniaus Trakų Vokės gimnazija";Priešmokyklinė;1442702945;Ne;5;10;5;20
21093;"Vilniaus Trakų Vokės gimnazija";Priešmokyklinė;53040741124;Taip;12;5;0;17
21094;"Vilniaus Trakų Vokės gimnazija";Priešmokyklinė;2981889811;Taip;0;13;5;18
21095;"Vilniaus Trakų Vokės gimnazija";Priešmokyklinė;3385439676;Ne;0;12;3;15
21096;"Vilniaus Trakų Vokės gimnazija";Priešmokyklinė;1007914987;Taip;15;2;5;22
21097;"Vilniaus Ryto progimnazija";Pelėdžiukai;77616936203;Taip;0;12;0;12
21098;"Vilniaus Ryto progimnazija";Pelėdžiukai;46769165231;Taip;0;5;1;6
21099;"Vilniaus Ryto progimnazija";Pelėdžiukai;28398691896;Taip;15;0;0;15
21100;"Vilniaus Ryto progimnazija";Pelėdžiukai;2996573491;Taip;0;7;0;7
21101;"Vilniaus Ryto progimnazija";Pelėdžiukai;93318150080;Taip;3;0;0;3
21102;"Vilniaus Ryto progimnazija";Pelėdžiukai;74152625458;Taip;5;6;0;11
21103;"Vilniaus Ryto progimnazija";Pelėdžiukai;70966482681;Taip;5;5;0;10
21104;"Vilniaus Ryto progimnazija";Pelėdžiukai;25811599893;Taip;3;5;0;8
21105;"Vilniaus Ryto progimnazija";Pelėdžiukai;1111912449;Taip;0;7;2;9
21106;"Vilniaus Ryto progimnazija";Pelėdžiukai;35385279640;Taip;1;2;0;3
21107;"Vilniaus Ryto progimnazija";Pelėdžiukai;21161267468;Taip;1;0;0;1
21108;"Vilniaus Ryto progimnazija";Pelėdžiukai;52832815165;Taip;0;5;0;5
21109;"Vilniaus Ryto progimnazija";Pelėdžiukai;9806997402;Taip;0;0;2;2
21110;"Vilniaus Ryto progimnazija";Pelėdžiukai;45286443222;Taip;1;5;0;6
21111;"Vilniaus Ryto progimnazija";Pelėdžiukai;77347859694;Taip;12;5;0;17
21112;"Vilniaus Ryto progimnazija";Pelėdžiukai;3654128216;Taip;0;9;0;9
21113;"Vilniaus Ryto progimnazija";Pelėdžiukai;69867478315;Taip;0;13;0;13
21114;"Vilniaus Ryto progimnazija";Pelėdžiukai;22781042300;Taip;0;6;0;6
21115;"Vilniaus Ryto progimnazija";Vyturiukai;88850680591;Taip;0;4;0;4
21116;"Vilniaus Ryto progimnazija";Vyturiukai;76876906010;Taip;0;5;0;5
21117;"Vilniaus Ryto progimnazija";Vyturiukai;93229412501;Taip;0;3;1;4
21118;"Vilniaus Ryto progimnazija";Vyturiukai;1569308516;Taip;10;5;1;16
21119;"Vilniaus Ryto progimnazija";Vyturiukai;9684466213;Taip;4;5;0;9
21120;"Vilniaus Ryto progimnazija";Vyturiukai;3531551821;Taip;0;5;0;5
21121;"Vilniaus Ryto progimnazija";Vyturiukai;52025315387;Taip;0;5;0;5
21122;"Vilniaus Ryto progimnazija";Vyturiukai;63440682549;Taip;0;1;0;1
21123;"Vilniaus Ryto progimnazija";Vyturiukai;23575981998;Taip;0;2;0;2
21124;"Vilniaus Ryto progimnazija";Vyturiukai;64443694200;Taip;6;5;2;13
21125;"Vilniaus Ryto progimnazija";Vyturiukai;65743534690;Taip;5;5;0;10
21126;"Vilniaus Ryto progimnazija";Vyturiukai;6241260549;Taip;5;4;0;9
21127;"Vilniaus Ryto progimnazija";Vyturiukai;78249737276;Taip;5;4;0;9
21128;"Vilniaus Ryto progimnazija";Vyturiukai;84747932868;Taip;5;7;1;13
21129;"Vilniaus Ryto progimnazija";Vyturiukai;71805402170;Taip;0;3;1;4
21130;"Vilniaus Ryto progimnazija";Vyturiukai;45446691980;Taip;0;6;0;6
21131;"Vilniaus Ryto progimnazija";Vyturiukai;41252762898;Taip;5;7;0;12
21132;"Vilniaus Ryto progimnazija";Vyturiukai;53270629693;Taip;0;12;0;12
21133;"Vilniaus Ryto progimnazija";Vyturiukai;51289084357;Taip;0;5;3;8
21134;"Vilniaus Ryto progimnazija";Geniukai;5924137896;Taip;0;5;5;10
21135;"Vilniaus Ryto progimnazija";Geniukai;31810296440;Taip;0;6;0;6
21136;"Vilniaus Ryto progimnazija";Geniukai;94678313037;Taip;0;5;9;14
21137;"Vilniaus Ryto progimnazija";Geniukai;6335949785;Taip;0;5;0;5
21138;"Vilniaus Ryto progimnazija";Geniukai;5424411985;Taip;0;5;2;7
21139;"Vilniaus Ryto progimnazija";Geniukai;1600034296;Taip;0;5;0;5
21140;"Vilniaus Ryto progimnazija";Geniukai;7732952505;Taip;0;5;3;8
21141;"Vilniaus Ryto progimnazija";Geniukai;8318898575;Ne;0;5;1;6
21142;"Vilniaus Ryto progimnazija";Geniukai;1865302246;Taip;0;5;3;8
21143;"Vilniaus Ryto progimnazija";Geniukai;4177104288;Taip;10;0;0;10
21144;"Vilniaus Ryto progimnazija";Geniukai;46953361076;Taip;0;5;4;9
21145;"Vilniaus Salininkų gimnazija";"Priešmokyklinė A";1394788152;Taip;0;6;0;6
21146;"Vilniaus Salininkų gimnazija";"Priešmokyklinė A";70212262471;Taip;9;3;0;12
21147;"Vilniaus Salininkų gimnazija";"Priešmokyklinė A";77895776678;Taip;0;1;2;3
21148;"Vilniaus Salininkų gimnazija";"Priešmokyklinė A";92807961547;Taip;11;1;0;12
21149;"Vilniaus Salininkų gimnazija";"Priešmokyklinė A";1263382031;Taip;0;5;3;8
21150;"Vilniaus Salininkų gimnazija";"Priešmokyklinė A";50041849206;Taip;0;5;0;5
21151;"Vilniaus Salininkų gimnazija";"Priešmokyklinė A";9898078093;Taip;0;5;0;5
21152;"Vilniaus Salininkų gimnazija";"Priešmokyklinė A";1540549473;Taip;8;5;0;13
21153;"Vilniaus Salininkų gimnazija";"Priešmokyklinė A";72769378676;Taip;0;6;0;6
21154;"Vilniaus Salininkų gimnazija";"Priešmokyklinė A";12284569395;Taip;6;5;0;11
21155;"Vilniaus Salininkų gimnazija";"Priešmokyklinė A";67687224119;Taip;10;5;0;15
21156;"Vilniaus Salininkų gimnazija";"Priešmokyklinė A";49134796971;Ne;0;5;0;5
21157;"Vilniaus Salininkų gimnazija";"Priešmokyklinė A";18097700548;Taip;0;5;2;7
21158;"Vilniaus Salininkų gimnazija";"Priešmokyklinė A";85552015560;Taip;0;7;0;7
21159;"Vilniaus Salininkų gimnazija";"Priešmokyklinė A";18610156473;Taip;0;5;0;5
21160;"Vilniaus Salininkų gimnazija";"Priešmokyklinė A";43805658510;Taip;5;5;0;10
21161;"Vilniaus Salininkų gimnazija";"Priešmokyklinė A";20709806421;Taip;0;5;0;5
21162;"Vilniaus Salininkų gimnazija";"Priešmokyklinė A";1011097163;Taip;10;5;0;15
21163;"Vilniaus Salininkų gimnazija";"Priešmokyklinė A";43256013546;Taip;0;5;0;5
21164;"Vilniaus Salininkų gimnazija";"Priešmokyklinė A";7344435191;Taip;0;5;0;5
21165;"Vilniaus Salininkų gimnazija";"Priešmokyklinė A";34881195086;Taip;15;5;0;20
21166;"Vilniaus Spindulio pagrindinė mokykla";PM3;22030335700;Taip;2;5;0;7
21167;"Vilniaus Spindulio pagrindinė mokykla";PM3;8795608401;Taip;1;5;0;6
21168;"Vilniaus Spindulio pagrindinė mokykla";PM3;6726572241;Taip;5;0;0;5
21169;"Vilniaus Spindulio pagrindinė mokykla";PM3;2103735244;Ne;0;5;5;10
21170;"Vilniaus Spindulio pagrindinė mokykla";PM3;50072501914;Taip;6;3;0;9
21171;"Vilniaus Spindulio pagrindinė mokykla";PM3;41136453710;Taip;0;20;0;20
21172;"Vilniaus Spindulio pagrindinė mokykla";PM3;70574764659;Taip;0;3;0;3
21173;"Vilniaus Spindulio pagrindinė mokykla";PM3;17630756294;Taip;0;5;0;5
21174;"Vilniaus Spindulio pagrindinė mokykla";PM3;54486099400;Ne;0;5;1;6
21175;"Vilniaus Spindulio pagrindinė mokykla";PM3;7514187959;Taip;0;2;0;2
21176;"Vilniaus Spindulio pagrindinė mokykla";PM3;5781921709;Taip;0;20;0;20
21177;"Vilniaus Spindulio pagrindinė mokykla";PM3;8810423103;Ne;0;5;0;5
21178;"Vilniaus Spindulio pagrindinė mokykla";PM3;99658181383;Taip;0;20;0;20
21179;"Vilniaus Spindulio pagrindinė mokykla";PM3;1284623590;Taip;0;5;1;6
21180;"Vilniaus Spindulio pagrindinė mokykla";PM3;17822017066;Taip;0;5;5;10
21181;"Vilniaus Spindulio pagrindinė mokykla";PM3;33144992509;Taip;0;5;0;5
21182;"Vilniaus Spindulio pagrindinė mokykla";PM3;2987981987;Taip;0;2;0;2
21183;"Vilniaus Spindulio pagrindinė mokykla";PM3;2917212490;Taip;0;5;0;5
21184;"Vilniaus Spindulio pagrindinė mokykla";PM3;88363839374;Taip;0;20;0;20
21185;"Vilniaus Spindulio pagrindinė mokykla";PM3;1894317616;Taip;5;5;1;11
21186;"Vilniaus Spindulio pagrindinė mokykla";PM3;8898033177;Taip;0;5;1;6
21187;"Vilniaus Spindulio pagrindinė mokykla";PM3;14135715855;Taip;0;5;0;5
21188;"Vilniaus Spindulio pagrindinė mokykla";PM2;27440263748;Taip;0;6;0;6
21189;"Vilniaus Spindulio pagrindinė mokykla";PM2;51690968594;Taip;0;5;2;7
21190;"Vilniaus Spindulio pagrindinė mokykla";PM2;43845081378;Taip;2;5;0;7
21191;"Vilniaus Spindulio pagrindinė mokykla";PM2;27893322293;Taip;0;5;0;5
21192;"Vilniaus Spindulio pagrindinė mokykla";PM2;5161772691;Taip;0;4;0;4
21193;"Vilniaus Spindulio pagrindinė mokykla";PM2;48405198914;Taip;0;5;6;11
21194;"Vilniaus Spindulio pagrindinė mokykla";PM2;18833749556;Ne;1;5;0;6
21195;"Vilniaus Spindulio pagrindinė mokykla";PM2;1848422504;Taip;9;5;3;17
21196;"Vilniaus Spindulio pagrindinė mokykla";PM2;79405143301;Taip;0;1;1;2
21197;"Vilniaus Spindulio pagrindinė mokykla";PM2;52558402241;Ne;1;1;1;3
21198;"Vilniaus Spindulio pagrindinė mokykla";PM2;1681147196;Taip;0;4;0;4
21199;"Vilniaus Spindulio pagrindinė mokykla";PM2;3743948734;Taip;0;6;6;12
21200;"Vilniaus Spindulio pagrindinė mokykla";PM2;522862985;Taip;5;4;1;10
21201;"Vilniaus Spindulio pagrindinė mokykla";PM2;1973616698;Taip;6;0;2;8
21202;"Vilniaus Spindulio pagrindinė mokykla";PM2;98043756261;Taip;0;8;0;8
21203;"Vilniaus Spindulio pagrindinė mokykla";PM2;22505400502;Taip;0;5;1;6
21204;"Vilniaus Spindulio pagrindinė mokykla";PM2;73482318690;Taip;0;7;0;7
21205;"Vilniaus Spindulio pagrindinė mokykla";PM2;87635746750;Taip;2;5;1;8
21206;"Vilniaus Spindulio pagrindinė mokykla";PM2;67686277420;Taip;3;5;0;8
21207;"Vilniaus Spindulio pagrindinė mokykla";PM1;98100269824;Taip;0;6;0;6
21208;"Vilniaus Spindulio pagrindinė mokykla";PM1;58307494214;Taip;0;1;0;1
21209;"Vilniaus Spindulio pagrindinė mokykla";PM1;41169357305;Taip;4;5;0;9
21210;"Vilniaus Spindulio pagrindinė mokykla";PM1;57584604376;Taip;0;2;0;2
21211;"Vilniaus Spindulio pagrindinė mokykla";PM1;58599577293;Taip;0;9;0;9
21212;"Vilniaus Spindulio pagrindinė mokykla";PM1;11041001881;Taip;9;0;0;9
21213;"Vilniaus Spindulio pagrindinė mokykla";PM1;87462575095;Ne;0;6;0;6
21214;"Vilniaus Spindulio pagrindinė mokykla";PM1;84379794486;Taip;0;9;0;9
21215;"Vilniaus Spindulio pagrindinė mokykla";PM1;56969518152;Taip;0;5;0;5
21216;"Vilniaus Spindulio pagrindinė mokykla";PM1;58418836409;Taip;3;0;0;3
21217;"Vilniaus Spindulio pagrindinė mokykla";PM1;5245636522;Ne;3;0;0;3
21218;"Vilniaus Spindulio pagrindinė mokykla";PM1;96702943483;Taip;0;13;0;13
21219;"Vilniaus Spindulio pagrindinė mokykla";PM1;1365783673;Taip;0;7;0;7
21220;"Vilniaus Spindulio pagrindinė mokykla";PM1;4290344470;Taip;0;5;0;5
21221;"Vilniaus Spindulio pagrindinė mokykla";PM1;88078071669;Taip;0;3;0;3
21222;"Vilniaus Spindulio pagrindinė mokykla";PM1;48909433610;Taip;0;2;0;2
21223;"Vilniaus Spindulio pagrindinė mokykla";PM1;35360386686;Taip;0;5;0;5
21224;"Vilniaus Spindulio pagrindinė mokykla";PM1;22999687853;Taip;0;1;0;1
21225;"Vilniaus Spindulio pagrindinė mokykla";PM1;66762368813;Taip;6;5;0;11
21226;"Vilniaus Spindulio pagrindinė mokykla";PM1;64966809812;Taip;0;1;0;1
21227;"Vilniaus Vladislavo Sirokomlės vidurinė mokykla";Nykštukai;5907733019;Taip;10;5;0;15
21228;"Vilniaus Vladislavo Sirokomlės vidurinė mokykla";Nykštukai;55996765657;Taip;0;5;1;6
21229;"Vilniaus Vladislavo Sirokomlės vidurinė mokykla";Nykštukai;29678276716;Taip;0;5;1;6
21230;"Vilniaus Vladislavo Sirokomlės vidurinė mokykla";Nykštukai;33995576904;Taip;0;5;1;6
21231;"Vilniaus Vladislavo Sirokomlės vidurinė mokykla";Nykštukai;1147411049;Taip;0;5;0;5
21232;"Vilniaus Vladislavo Sirokomlės vidurinė mokykla";Nykštukai;24628844486;Taip;0;25;0;25
21233;"Vilniaus Vladislavo Sirokomlės vidurinė mokykla";Nykštukai;67322017045;Taip;0;5;1;6
21234;"Vilniaus Vladislavo Sirokomlės vidurinė mokykla";Nykštukai;1288513624;Taip;5;5;0;10
21235;"Vilniaus Vladislavo Sirokomlės vidurinė mokykla";Nykštukai;75293895773;Taip;0;5;0;5
21236;"Vilniaus Vladislavo Sirokomlės vidurinė mokykla";Nykštukai;19225308100;Taip;0;25;0;25
21237;"Vilniaus Vladislavo Sirokomlės vidurinė mokykla";Nykštukai;54815489159;Taip;0;5;0;5
21238;"Vilniaus Vladislavo Sirokomlės vidurinė mokykla";Nykštukai;78888983611;Taip;0;10;3;13
21239;"Vilniaus Vladislavo Sirokomlės vidurinė mokykla";Nykštukai;95872052773;Taip;0;5;1;6
21240;"Vilniaus Vladislavo Sirokomlės vidurinė mokykla";Nykštukai;9991093616;Taip;11;5;1;17
21241;"Vilniaus Vladislavo Sirokomlės vidurinė mokykla";Nykštukai;86336781386;Taip;0;25;0;25
21242;"Vilniaus Vladislavo Sirokomlės vidurinė mokykla";Smurfai;2896777542;Taip;0;25;0;25
21243;"Vilniaus Vladislavo Sirokomlės vidurinė mokykla";Smurfai;1649779105;Taip;0;5;0;5
21244;"Vilniaus Vladislavo Sirokomlės vidurinė mokykla";Smurfai;23540725045;Taip;9;5;0;14
21245;"Vilniaus Vladislavo Sirokomlės vidurinė mokykla";Smurfai;94242891208;Taip;0;25;0;25
21246;"Vilniaus Vladislavo Sirokomlės vidurinė mokykla";Smurfai;42097592326;Ne;0;10;0;10
21247;"Vilniaus Vladislavo Sirokomlės vidurinė mokykla";Smurfai;5042045981;Taip;5;5;0;10
21248;"Vilniaus Vladislavo Sirokomlės vidurinė mokykla";Smurfai;9509140514;Taip;0;9;5;14
21249;"Vilniaus Vladislavo Sirokomlės vidurinė mokykla";Smurfai;86662025175;Taip;0;8;0;8
21250;"Vilniaus Vladislavo Sirokomlės vidurinė mokykla";Smurfai;4227711744;Taip;0;25;0;25
21251;"Vilniaus Vladislavo Sirokomlės vidurinė mokykla";Smurfai;1464969756;Taip;0;9;1;10
21252;"Vilniaus Vladislavo Sirokomlės vidurinė mokykla";Smurfai;1087544768;Taip;0;25;0;25
21253;"Vilniaus Vladislavo Sirokomlės vidurinė mokykla";Smurfai;2272950944;Taip;0;9;5;14
21254;"Vilniaus Vladislavo Sirokomlės vidurinė mokykla";Smurfai;1804439867;Ne;0;5;0;5
21255;"Vilniaus Vladislavo Sirokomlės vidurinė mokykla";Smurfai;4742282433;Taip;0;5;9;14
21256;"Vilniaus „Pelėdos” pradinė mokykla";Bitutės;2071487643;Taip;0;6;0;6
21257;"Vilniaus „Pelėdos” pradinė mokykla";Bitutės;6832201394;Taip;0;6;0;6
21258;"Vilniaus „Pelėdos” pradinė mokykla";Bitutės;65445450194;Taip;0;1;0;1
21259;"Vilniaus „Pelėdos” pradinė mokykla";Bitutės;6652853494;Ne;0;3;5;8
21260;"Vilniaus „Pelėdos” pradinė mokykla";Bitutės;22352755573;Taip;0;1;0;1
21261;"Vilniaus „Pelėdos” pradinė mokykla";Bitutės;41693125052;Taip;0;11;0;11
21262;"Vilniaus „Pelėdos” pradinė mokykla";Bitutės;4748207005;Taip;0;6;0;6
21263;"Vilniaus „Pelėdos” pradinė mokykla";Bitutės;95143505795;Taip;4;1;2;7
21264;"Vilniaus „Pelėdos” pradinė mokykla";Bitutės;35501298377;Taip;10;0;0;10
21265;"Vilniaus „Pelėdos” pradinė mokykla";Bitutės;96374638070;Taip;0;1;0;1
21266;"Vilniaus „Pelėdos” pradinė mokykla";Bitutės;33465555087;Taip;0;1;0;1
21267;"Vilniaus „Pelėdos” pradinė mokykla";Bitutės;42360927832;Taip;0;9;0;9
21268;"Vilniaus „Pelėdos” pradinė mokykla";Bitutės;6900693954;Taip;9;0;0;9
21269;"Vilniaus „Pelėdos” pradinė mokykla";Bitutės;42778766894;Taip;0;1;1;2
21270;"Vilniaus „Pelėdos” pradinė mokykla";Bitutės;1269674740;Taip;9;6;0;15
21271;"Vilniaus „Pelėdos” pradinė mokykla";Bitutės;54002272670;Taip;0;9;0;9
21272;"Vilniaus „Pelėdos” pradinė mokykla";Bitutės;45993070238;Taip;0;1;0;1
21273;"Vilniaus „Pelėdos” pradinė mokykla";Bitutės;9108397707;Taip;0;5;0;5
21274;"Vilniaus „Pelėdos” pradinė mokykla";Bitutės;59056959064;Taip;0;19;0;19
21275;"Vilniaus „Pelėdos” pradinė mokykla";Bitutės;96481283521;Taip;0;3;0;3
21276;"Vilniaus „Pelėdos” pradinė mokykla";Boružėlės;30916402061;Taip;0;10;5;15
21277;"Vilniaus „Pelėdos” pradinė mokykla";Boružėlės;4489830831;Ne;0;2;2;4
21278;"Vilniaus „Pelėdos” pradinė mokykla";Boružėlės;53188954130;Taip;0;0;5;5
21279;"Vilniaus „Pelėdos” pradinė mokykla";Boružėlės;22444416208;Taip;10;0;0;10
21280;"Vilniaus „Pelėdos” pradinė mokykla";Boružėlės;12734259561;Taip;10;5;0;15
21281;"Vilniaus „Pelėdos” pradinė mokykla";Boružėlės;79520961509;Taip;9;0;0;9
21282;"Vilniaus „Pelėdos” pradinė mokykla";Boružėlės;7162837286;Taip;9;5;2;16
21283;"Vilniaus „Pelėdos” pradinė mokykla";Boružėlės;46876861220;Taip;2;5;3;10
21284;"Vilniaus „Pelėdos” pradinė mokykla";Boružėlės;1602745529;Taip;0;5;0;5
21285;"Vilniaus „Pelėdos” pradinė mokykla";Boružėlės;71191048199;Taip;0;5;0;5
21286;"Vilniaus „Pelėdos” pradinė mokykla";Boružėlės;48135022147;Taip;0;2;0;2
21287;"Vilniaus „Pelėdos” pradinė mokykla";Boružėlės;78123951465;Taip;0;0;2;2
21288;"Vilniaus „Pelėdos” pradinė mokykla";Boružėlės;85217089151;Taip;0;0;4;4
21289;"Vilniaus „Pelėdos” pradinė mokykla";Boružėlės;21037883651;Taip;0;5;1;6
21290;"Vilniaus „Pelėdos” pradinė mokykla";Boružėlės;4532680677;Taip;5;0;0;5
21291;"Vilniaus „Pelėdos” pradinė mokykla";Boružėlės;4103101479;Taip;0;5;2;7
21292;"Vilniaus „Pelėdos” pradinė mokykla";Boružėlės;89825498541;Taip;0;5;0;5
21293;"Vilniaus „Pelėdos” pradinė mokykla";Boružėlės;91937671865;Taip;5;1;5;11
21294;"Vilniaus „Pelėdos” pradinė mokykla";Boružėlės;10329586004;Taip;5;3;0;8
21295;"Vilniaus „Pelėdos” pradinė mokykla";Boružėlės;14503455095;Taip;0;0;2;2
21296;"Vilniaus Joachimo Lelevelio vidurinė mokykla";0A;48625188486;Taip;4;5;0;9
21297;"Vilniaus Joachimo Lelevelio vidurinė mokykla";0A;30530145422;Taip;6;5;3;14
21298;"Vilniaus Joachimo Lelevelio vidurinė mokykla";0A;77637136134;Taip;5;8;2;15
21299;"Vilniaus Joachimo Lelevelio vidurinė mokykla";0A;22182253769;Taip;6;6;0;12
21300;"Vilniaus Joachimo Lelevelio vidurinė mokykla";0A;22490145919;Taip;10;6;0;16
21301;"Vilniaus Joachimo Lelevelio vidurinė mokykla";0A;79489468964;Ne;0;10;1;11
21302;"Vilniaus Joachimo Lelevelio vidurinė mokykla";0A;1139560173;Taip;6;5;3;14
21303;"Vilniaus Joachimo Lelevelio vidurinė mokykla";0A;29594212376;Taip;0;5;2;7
21304;"Vilniaus Joachimo Lelevelio vidurinė mokykla";0A;37558958175;Taip;5;5;6;16
21305;"Vilniaus Joachimo Lelevelio vidurinė mokykla";0A;37117140680;Taip;3;6;0;9
21306;"Vilniaus Joachimo Lelevelio vidurinė mokykla";0A;1387685923;Ne;8;5;3;16
21307;"Vilniaus Joachimo Lelevelio vidurinė mokykla";0A;2854451964;Taip;0;7;0;7
21308;"Vilniaus Joachimo Lelevelio vidurinė mokykla";0A;2628030884;Ne;11;5;0;16
21309;"Vilniaus Joachimo Lelevelio vidurinė mokykla";0A;6690564929;Taip;0;5;1;6
21310;"Vilniaus Joachimo Lelevelio vidurinė mokykla";0A;87447355522;Taip;0;5;0;5
21311;"Vilniaus Joachimo Lelevelio vidurinė mokykla";0A;9406527428;Ne;6;5;2;13
21312;"Vilniaus Joachimo Lelevelio vidurinė mokykla";0A;82446674090;Taip;4;5;0;9
21313;"Vilniaus Joachimo Lelevelio vidurinė mokykla";0A;6764953389;Taip;4;5;1;10
21314;"Vilniaus Joachimo Lelevelio vidurinė mokykla";0A;6406533101;Taip;11;5;0;16
21315;"Vilniaus Joachimo Lelevelio vidurinė mokykla";0B;38745665842;Taip;9;7;0;16
21316;"Vilniaus Joachimo Lelevelio vidurinė mokykla";0B;8972073812;Taip;1;5;3;9
21317;"Vilniaus Joachimo Lelevelio vidurinė mokykla";0B;83279104490;Taip;15;5;0;20
21318;"Vilniaus Joachimo Lelevelio vidurinė mokykla";0B;23254881487;Taip;0;5;1;6
21319;"Vilniaus Joachimo Lelevelio vidurinė mokykla";0B;67336376881;Taip;12;6;0;18
21320;"Vilniaus Joachimo Lelevelio vidurinė mokykla";0B;9032277414;Taip;10;5;1;16
21321;"Vilniaus Joachimo Lelevelio vidurinė mokykla";0B;1228880375;Taip;10;5;0;15
21322;"Vilniaus Joachimo Lelevelio vidurinė mokykla";0B;3392530766;Taip;0;12;0;12
21323;"Vilniaus Joachimo Lelevelio vidurinė mokykla";0B;52675265822;Taip;0;5;2;7
21324;"Vilniaus Joachimo Lelevelio vidurinė mokykla";0B;80290130560;Taip;0;9;0;9
21325;"Vilniaus Joachimo Lelevelio vidurinė mokykla";0B;37365823648;Ne;10;9;1;20
21326;"Vilniaus Joachimo Lelevelio vidurinė mokykla";0B;20323559123;Taip;9;5;0;14
21327;"Vilniaus Joachimo Lelevelio vidurinė mokykla";0B;1992741773;Taip;0;8;0;8
21328;"Vilniaus Joachimo Lelevelio vidurinė mokykla";0B;94980538706;Taip;0;15;1;16
21329;"Vilniaus Joachimo Lelevelio vidurinė mokykla";0B;9917295097;Taip;6;11;2;19
21330;"Vilniaus Joachimo Lelevelio vidurinė mokykla";0B;3385391317;Taip;0;25;0;25
21331;"Vilniaus Joachimo Lelevelio vidurinė mokykla";0B;6777530638;Taip;0;5;8;13
21332;"Vilniaus Joachimo Lelevelio vidurinė mokykla";0B;3507030971;Taip;4;5;5;14
21333;"Vilniaus Joachimo Lelevelio vidurinė mokykla";0B;8900287515;Taip;5;5;3;13
21334;"Vilniaus Joachimo Lelevelio vidurinė mokykla";0B;78820258664;Taip;8;6;0;14
21335;"Vilniaus Joachimo Lelevelio vidurinė mokykla";0B;32468645385;Taip;0;25;0;25
21336;"Vilniaus Joachimo Lelevelio vidurinė mokykla";0B;46936589086;Taip;0;5;0;5
21337;"Vilniaus Joachimo Lelevelio vidurinė mokykla";0C;7785594191;Taip;0;9;0;9
21338;"Vilniaus Joachimo Lelevelio vidurinė mokykla";0C;543596002;Taip;0;5;1;6
21339;"Vilniaus Joachimo Lelevelio vidurinė mokykla";0C;64132212674;Taip;8;5;0;13
21340;"Vilniaus Joachimo Lelevelio vidurinė mokykla";0C;63270263063;Taip;0;7;0;7
21341;"Vilniaus Joachimo Lelevelio vidurinė mokykla";0C;77834846979;Taip;0;25;0;25
21342;"Vilniaus Joachimo Lelevelio vidurinė mokykla";0C;86242023109;Taip;0;5;0;5
21343;"Vilniaus Joachimo Lelevelio vidurinė mokykla";0C;10836076854;Taip;0;5;0;5
21344;"Vilniaus Joachimo Lelevelio vidurinė mokykla";0C;4064562873;Taip;0;5;1;6
21345;"Vilniaus Joachimo Lelevelio vidurinė mokykla";0C;7474239709;Taip;0;25;0;25
21346;"Vilniaus Juzefo Ignacijaus Kraševskio gimnazija";Priešmokyklinė;3992602769;Ne;9;5;1;15
21347;"Vilniaus Juzefo Ignacijaus Kraševskio gimnazija";Priešmokyklinė;1636593104;Taip;4;5;1;10
21348;"Vilniaus Juzefo Ignacijaus Kraševskio gimnazija";Priešmokyklinė;96528175390;Taip;5;5;0;10
21349;"Vilniaus Juzefo Ignacijaus Kraševskio gimnazija";Priešmokyklinė;2386972224;Taip;0;5;0;5
21350;"Vilniaus Juzefo Ignacijaus Kraševskio gimnazija";Priešmokyklinė;87397764928;Taip;0;5;0;5
21351;"Vilniaus Juzefo Ignacijaus Kraševskio gimnazija";Priešmokyklinė;7947779677;Taip;11;5;1;17
21352;"Vilniaus Juzefo Ignacijaus Kraševskio gimnazija";Priešmokyklinė;7348967815;Taip;13;5;0;18
21353;"Vilniaus Juzefo Ignacijaus Kraševskio gimnazija";Priešmokyklinė;91109920216;Taip;0;5;7;12
21354;"Vilniaus Juzefo Ignacijaus Kraševskio gimnazija";Priešmokyklinė;18683776970;Taip;7;5;1;13
21355;"Vilniaus Juzefo Ignacijaus Kraševskio gimnazija";Priešmokyklinė;45246620717;Taip;6;6;0;12
21356;"Vilniaus Juzefo Ignacijaus Kraševskio gimnazija";Priešmokyklinė;3286294868;Ne;11;5;0;16
21357;"Vilniaus Juzefo Ignacijaus Kraševskio gimnazija";Priešmokyklinė;3025885967;Ne;10;5;0;15
21358;"Vilniaus Juzefo Ignacijaus Kraševskio gimnazija";Priešmokyklinė;13035175969;Taip;4;8;0;12
21359;"Vilniaus Juzefo Ignacijaus Kraševskio gimnazija";Priešmokyklinė;1744052084;Ne;0;5;4;9
21360;"Vilniaus Juzefo Ignacijaus Kraševskio gimnazija";Priešmokyklinė;3454973035;Taip;0;9;0;9
21361;"Vilniaus Juzefo Ignacijaus Kraševskio gimnazija";Priešmokyklinė;9640287886;Ne;9;5;3;17
21362;"Vilniaus Juzefo Ignacijaus Kraševskio gimnazija";Priešmokyklinė;17989172493;Ne;0;11;0;11
21363;"Vilniaus Juzefo Ignacijaus Kraševskio gimnazija";Priešmokyklinė;7866325130;Taip;0;10;0;10
21364;"Vilniaus Jono Pauliaus II progimnazija";Bitutės;2221329657;Taip;5;5;0;10
21365;"Vilniaus Jono Pauliaus II progimnazija";Bitutės;1787688071;Taip;0;5;4;9
21366;"Vilniaus Jono Pauliaus II progimnazija";Bitutės;74095271790;Taip;0;5;2;7
21367;"Vilniaus Jono Pauliaus II progimnazija";Bitutės;75018613955;Taip;0;5;2;7
21368;"Vilniaus Jono Pauliaus II progimnazija";Bitutės;41958962804;Taip;4;5;0;9
21369;"Vilniaus Jono Pauliaus II progimnazija";Bitutės;5290505392;Taip;6;5;0;11
21370;"Vilniaus Jono Pauliaus II progimnazija";Bitutės;62687105812;Taip;7;6;0;13
21371;"Vilniaus Jono Pauliaus II progimnazija";Bitutės;50802361323;Ne;0;5;0;5
21372;"Vilniaus Jono Pauliaus II progimnazija";Bitutės;1051397178;Taip;0;5;0;5
21373;"Vilniaus Jono Pauliaus II progimnazija";Bitutės;18366436287;Taip;0;5;0;5
21374;"Vilniaus Jono Pauliaus II progimnazija";Bitutės;98525894524;Taip;0;12;0;12
21375;"Vilniaus Jono Pauliaus II progimnazija";Bitutės;66886951759;Taip;5;5;0;10
21376;"Vilniaus Jono Pauliaus II progimnazija";Bitutės;1678282458;Taip;0;5;0;5
21377;"Vilniaus Jono Pauliaus II progimnazija";Bitutės;23410902042;Taip;0;6;0;6
21378;"Vilniaus Jono Pauliaus II progimnazija";Bitutės;38208558755;Taip;0;9;0;9
21379;"Vilniaus Jono Pauliaus II progimnazija";Bitutės;1498711260;Taip;0;9;0;9
21380;"Vilniaus Jono Pauliaus II progimnazija";Bitutės;94323422162;Taip;9;5;0;14
21381;"Vilniaus Jono Pauliaus II progimnazija";Bitutės;6373945450;Taip;0;9;0;9
21382;"Vilniaus Jono Pauliaus II progimnazija";Bitutės;1834961037;Taip;3;5;1;9
21383;"Vilniaus Jono Pauliaus II progimnazija";Bitutės;7289945805;Ne;0;5;0;5
21384;"Vilniaus Jono Pauliaus II progimnazija";Bitutės;52202199212;Taip;6;5;0;11
21385;"Vilniaus Jono Pauliaus II progimnazija";Nykštukai;56882212708;Taip;1;5;0;6
21386;"Vilniaus Jono Pauliaus II progimnazija";Nykštukai;84864692736;Taip;0;8;0;8
21387;"Vilniaus Jono Pauliaus II progimnazija";Nykštukai;19330722623;Taip;0;5;0;5
21388;"Vilniaus Jono Pauliaus II progimnazija";Nykštukai;41798150203;Taip;0;20;0;20
21389;"Vilniaus Jono Pauliaus II progimnazija";Nykštukai;1497044775;Taip;0;20;0;20
21390;"Vilniaus Jono Pauliaus II progimnazija";Nykštukai;18174475384;Taip;6;5;0;11
21391;"Vilniaus Jono Pauliaus II progimnazija";Nykštukai;29793632667;Taip;0;6;0;6
21392;"Vilniaus Jono Pauliaus II progimnazija";Nykštukai;2067239710;Taip;0;7;0;7
21393;"Vilniaus Jono Pauliaus II progimnazija";Nykštukai;95238329605;Taip;10;5;0;15
21394;"Vilniaus Jono Pauliaus II progimnazija";Nykštukai;66947843128;Taip;0;5;0;5
21395;"Vilniaus Jono Pauliaus II progimnazija";Nykštukai;96241985330;Taip;0;5;1;6
21396;"Vilniaus Jono Pauliaus II progimnazija";Nykštukai;98624493006;Taip;0;5;1;6
21397;"Vilniaus Jono Pauliaus II progimnazija";Nykštukai;1538884930;Taip;0;5;2;7
21398;"Vilniaus Jono Pauliaus II progimnazija";Nykštukai;97057444920;Taip;0;5;3;8
21399;"Vilniaus Jono Pauliaus II progimnazija";Nykštukai;58033050070;Taip;0;6;0;6
21400;"Vilniaus Jono Pauliaus II progimnazija";Nykštukai;5744439022;Taip;0;5;2;7
21401;"Vilniaus Jono Pauliaus II progimnazija";Nykštukai;30095924180;Taip;0;5;0;5
21402;"Vilniaus Jono Pauliaus II progimnazija";Nykštukai;17663780748;Taip;7;5;0;12
21403;"Vilniaus Jono Pauliaus II progimnazija";Nykštukai;33970738232;Taip;0;5;1;6
21404;"Vilniaus Jono Pauliaus II progimnazija";Nykštukai;28504232181;Taip;0;6;0;6
21405;"Vilniaus Jono Pauliaus II progimnazija";Nykštukai;65927108137;Taip;4;5;0;9
21406;"Vilniaus Jono Pauliaus II progimnazija";Nykštukai;5282646148;Ne;15;5;0;20
21407;"Vilniaus Jono Pauliaus II progimnazija";Nykštukai;29750547072;Taip;0;6;0;6
21408;"Vilniaus Jono Pauliaus II progimnazija";Nykštukai;6636967120;Taip;0;5;1;6
21409;"Vilniaus Jono Pauliaus II progimnazija";Nykštukai;76004865730;Taip;10;8;0;18
21410;"Vilniaus Jono Pauliaus II progimnazija";Nykštukai;1681910702;Taip;0;20;0;20
21411;"Vilniaus Jono Pauliaus II progimnazija";Spindulėlis;86349879099;Taip;0;14;1;15
21412;"Vilniaus Jono Pauliaus II progimnazija";Spindulėlis;71621781260;Taip;8;5;0;13
21413;"Vilniaus Jono Pauliaus II progimnazija";Spindulėlis;40232303318;Taip;0;5;0;5
21414;"Vilniaus Jono Pauliaus II progimnazija";Spindulėlis;18772270293;Taip;0;5;0;5
21415;"Vilniaus Jono Pauliaus II progimnazija";Spindulėlis;2092126666;Taip;6;5;0;11
21416;"Vilniaus Jono Pauliaus II progimnazija";Spindulėlis;18296155488;Taip;0;11;0;11
21417;"Vilniaus Jono Pauliaus II progimnazija";Spindulėlis;82826774977;Taip;0;8;0;8
21418;"Vilniaus Jono Pauliaus II progimnazija";Spindulėlis;13277721739;Taip;9;5;0;14
21419;"Vilniaus Jono Pauliaus II progimnazija";Spindulėlis;27320886907;Taip;5;5;0;10
21420;"Vilniaus Jono Pauliaus II progimnazija";Spindulėlis;90544626686;Ne;0;5;0;5
21421;"Vilniaus Jono Pauliaus II progimnazija";Spindulėlis;50461103065;Taip;11;10;0;21
21422;"Vilniaus Jono Pauliaus II progimnazija";Spindulėlis;23815562807;Taip;6;5;0;11
21423;"Vilniaus Jono Pauliaus II progimnazija";Spindulėlis;9433070239;Taip;0;5;0;5
21424;"Vilniaus Jono Pauliaus II progimnazija";Spindulėlis;14763149919;Taip;10;5;0;15
21425;"Vilniaus Jono Pauliaus II progimnazija";Spindulėlis;13620421173;Ne;0;5;3;8
21426;"Vilniaus Jono Pauliaus II progimnazija";Spindulėlis;68654751373;Taip;0;5;0;5
21427;"Vilniaus Jono Pauliaus II progimnazija";Spindulėlis;71644061437;Taip;13;5;0;18
21428;"Vilniaus Jono Pauliaus II progimnazija";Spindulėlis;9413926262;Ne;0;25;0;25
21429;"Vilniaus Jono Pauliaus II progimnazija";Spindulėlis;1881484420;Ne;6;5;0;11
21430;"Vilniaus Jono Pauliaus II progimnazija";Žiniukai;18666752189;Taip;0;5;1;6
21431;"Vilniaus Jono Pauliaus II progimnazija";Žiniukai;85578252258;Ne;11;5;0;16
21432;"Vilniaus Jono Pauliaus II progimnazija";Žiniukai;16243269254;Taip;0;13;0;13
21433;"Vilniaus Jono Pauliaus II progimnazija";Žiniukai;2268141397;Taip;0;8;0;8
21434;"Vilniaus Jono Pauliaus II progimnazija";Žiniukai;15095928335;Taip;4;5;0;9
21435;"Vilniaus Jono Pauliaus II progimnazija";Žiniukai;97421699352;Taip;0;5;0;5
21436;"Vilniaus Jono Pauliaus II progimnazija";Žiniukai;87167492911;Taip;7;7;0;14
21437;"Vilniaus Jono Pauliaus II progimnazija";Žiniukai;86166153049;Ne;0;8;0;8
21438;"Vilniaus Jono Pauliaus II progimnazija";Žiniukai;23756278273;Taip;0;9;0;9
21439;"Vilniaus Jono Pauliaus II progimnazija";Žiniukai;76860078254;Taip;10;6;0;16
21440;"Vilniaus Jono Pauliaus II progimnazija";Žiniukai;59698476683;Taip;14;5;0;19
21441;"Vilniaus Jono Pauliaus II progimnazija";Žiniukai;1265276800;Taip;8;5;0;13
21442;"Vilniaus Jono Pauliaus II progimnazija";Žiniukai;52145954352;Taip;0;5;0;5
21443;"Vilniaus Jono Pauliaus II progimnazija";Žiniukai;13144507021;Taip;10;5;0;15
21444;"Vilniaus Jono Pauliaus II progimnazija";Žiniukai;2145527582;Ne;0;8;0;8
21445;"Vilniaus Jono Pauliaus II progimnazija";Žiniukai;74531978509;Taip;0;5;0;5
21446;"Vilniaus Jono Pauliaus II progimnazija";Žiniukai;45823285175;Taip;10;5;0;15
21447;"Vilniaus Jono Pauliaus II progimnazija";Žiniukai;63967215708;Taip;10;5;0;15
21448;"Vilniaus Jono Pauliaus II progimnazija";Žiniukai;88089833901;Ne;5;5;2;12
21449;"Vilniaus Jono Pauliaus II progimnazija";Žiniukai;71421862891;Taip;5;5;0;10
21450;"Vilniaus Jono Pauliaus II progimnazija";Žiniukai;94546685371;Taip;0;9;0;9
21451;"Vilniaus Jono Pauliaus II progimnazija";Žiniukai;1883620780;Taip;5;5;0;10
21452;"Vilniaus Jono Pauliaus II progimnazija";Žiniukai;64083158642;Taip;0;5;3;8
21453;"Vilniaus Senamiesčio vidurinė mokykla";PG1;1059396976;Taip;0;7;0;7
21454;"Vilniaus Senamiesčio vidurinė mokykla";PG1;2094485999;Taip;0;5;2;7
21455;"Vilniaus Senamiesčio vidurinė mokykla";PG1;4793402013;Taip;0;5;0;5
21456;"Vilniaus Senamiesčio vidurinė mokykla";PG1;30428486005;Ne;0;5;0;5
21457;"Vilniaus Senamiesčio vidurinė mokykla";PG1;1369622524;Taip;0;22;0;22
21458;"Vilniaus Senamiesčio vidurinė mokykla";PG1;56224529599;Ne;0;5;0;5
21459;"Vilniaus Senamiesčio vidurinė mokykla";PG1;65977368065;Taip;0;12;0;12
21460;"Vilniaus Senamiesčio vidurinė mokykla";PG1;54923779499;Taip;0;10;0;10
21461;"Vilniaus Senamiesčio vidurinė mokykla";PG1;5575633653;Taip;0;5;0;5
21462;"Vilniaus Senamiesčio vidurinė mokykla";PG1;1813072867;Taip;10;5;0;15
21463;"Vilniaus Senamiesčio vidurinė mokykla";PG1;7764171885;Taip;7;5;1;13
21464;"Vilniaus Senamiesčio vidurinė mokykla";PG1;152363521;Taip;0;14;0;14
